SN,TestID,FileName,OriginalFileSize,CompressedBinSize,FileSizeDifference,CompressionRate,CompressionTime,DecompressionTime,UniquePixelCountBefore,UniquePixelCountAfter,UniquePixelCountReduction,UniquePixelCountReductionRate,MAE,MSE,PSNR,QuadtreeThreshold,AllowedExceedingThresholdFactor
1,test_20231031_152201,10404007.png,502730,44612,458118,0.9112605175740457,31,18,61265,6320,54945,0.8968415898147393,23.988469333333335,2977.2318826666665,13.392676997378985,110,1.0E-4
2,test_20231031_152201,1254659.png,342646,104222,238424,0.6958318497808234,6,11,80080,14168,65912,0.823076923076923,17.388291555555554,2285.3256426666667,14.541322681746403,110,1.0E-4
3,test_20231031_152201,10188041.png,221231,13599,207632,0.9385303144676831,4,10,41731,1913,39818,0.9541587788454626,9.578883555555555,813.1110293333334,19.029305088353503,110,1.0E-4
4,test_20231031_152201,10287332.png,216980,16302,200678,0.9248686514886164,3,7,22337,2218,20119,0.9007028696781125,8.782759111111112,632.8933973333334,20.117497959512352,110,1.0E-4
5,test_20231031_152201,11610969.png,368720,42309,326411,0.8852543935777826,5,8,84111,6125,77986,0.9271795603428803,17.662497777777777,2100.2251573333333,14.90814504540811,110,1.0E-4
6,test_20231031_152201,10350842.png,212614,10444,202170,0.9508781171512695,5,11,42529,1529,41000,0.964048061322862,16.570321777777778,1764.44336,15.664726391377854,110,1.0E-4
7,test_20231031_152201,10863862.png,317432,23577,293855,0.9257258247435671,5,9,66058,3275,62783,0.9504223561112961,20.08175111111111,2404.3288693333334,14.320864897301146,110,1.0E-4
8,test_20231031_152201,11382381.png,312486,2457,310029,0.9921372477486992,4,8,46745,341,46404,0.9927051021499625,16.771829333333333,1637.4903786666666,15.989016039624108,110,1.0E-4
9,test_20231031_152201,11079715.png,443815,156082,287733,0.6483174295596138,8,10,124136,21528,102608,0.8265773023135916,14.749011555555555,1614.264208,16.05105743315916,110,1.0E-4
10,test_20231031_152201,11551286.png,271883,2347,269536,0.9913676103323856,3,6,40092,342,39750,0.9914696198742892,15.438896,1429.8152693333334,16.57800430180194,110,1.0E-4
1,test_20231031_152202,10404007.png,502730,44612,458118,0.9112605175740457,5,6,61265,6320,54945,0.8968415898147393,23.988469333333335,2977.2318826666665,13.392676997378985,110,2.0E-4
2,test_20231031_152202,1254659.png,342646,104222,238424,0.6958318497808234,6,8,80080,14168,65912,0.823076923076923,17.388291555555554,2285.3256426666667,14.541322681746403,110,2.0E-4
3,test_20231031_152202,10188041.png,221231,13599,207632,0.9385303144676831,4,7,41731,1913,39818,0.9541587788454626,9.578883555555555,813.1110293333334,19.029305088353503,110,2.0E-4
4,test_20231031_152202,10287332.png,216980,16052,200928,0.9260208314130335,8,14,22337,2188,20149,0.9020459327573085,8.913809777777777,659.944448,19.935729812994534,110,2.0E-4
5,test_20231031_152202,11610969.png,368720,42309,326411,0.8852543935777826,6,9,84111,6125,77986,0.9271795603428803,17.662497777777777,2100.2251573333333,14.90814504540811,110,2.0E-4
6,test_20231031_152202,10350842.png,212614,10444,202170,0.9508781171512695,4,8,42529,1529,41000,0.964048061322862,16.570321777777778,1764.44336,15.664726391377854,110,2.0E-4
7,test_20231031_152202,10863862.png,317432,23577,293855,0.9257258247435671,5,9,66058,3275,62783,0.9504223561112961,20.08175111111111,2404.3288693333334,14.320864897301146,110,2.0E-4
8,test_20231031_152202,11382381.png,312486,2347,310139,0.9924892635190057,3,8,46745,325,46420,0.9930473847470318,17.82406577777778,1777.1764213333333,15.633498182576378,110,2.0E-4
9,test_20231031_152202,11079715.png,443815,156082,287733,0.6483174295596138,8,9,124136,21528,102608,0.8265773023135916,14.749011555555555,1614.264208,16.05105743315916,110,2.0E-4
10,test_20231031_152202,11551286.png,271883,2144,269739,0.9921142550288176,5,9,40092,312,39780,0.9922178988326849,15.528675555555555,1436.6126613333333,16.557406711756357,110,2.0E-4
1,test_20231031_152204,10404007.png,502730,44612,458118,0.9112605175740457,7,11,61265,6320,54945,0.8968415898147393,23.988469333333335,2977.2318826666665,13.392676997378985,110,3.0000000000000003E-4
2,test_20231031_152204,1254659.png,342646,104139,238507,0.6960740822890097,6,8,80080,14161,65919,0.8231643356643357,17.40023822222222,2286.743573333333,14.538628936508067,110,3.0000000000000003E-4
3,test_20231031_152204,10188041.png,221231,13459,207772,0.9391631371733618,3,5,41731,1894,39837,0.9546140758668615,9.73372088888889,834.3248426666667,18.917451856378918,110,3.0000000000000003E-4
4,test_20231031_152204,10287332.png,216980,16012,200968,0.9262051802009402,3,6,22337,2182,20155,0.9023145453731477,9.015146666666666,678.0014826666667,19.818497172762928,110,3.0000000000000003E-4
5,test_20231031_152204,11610969.png,368720,42309,326411,0.8852543935777826,4,6,84111,6125,77986,0.9271795603428803,17.662497777777777,2100.2251573333333,14.90814504540811,110,3.0000000000000003E-4
6,test_20231031_152204,10350842.png,212614,10444,202170,0.9508781171512695,3,6,42529,1529,41000,0.964048061322862,16.570321777777778,1764.44336,15.664726391377854,110,3.0000000000000003E-4
7,test_20231031_152204,10863862.png,317432,23337,294095,0.9264818921847828,3,5,66058,3242,62816,0.9509219171031518,20.539557333333335,2460.170330666667,14.22115184208524,110,3.0000000000000003E-4
8,test_20231031_152204,11382381.png,312486,2347,310139,0.9924892635190057,3,5,46745,325,46420,0.9930473847470318,17.82406577777778,1777.1764213333333,15.633498182576378,110,3.0000000000000003E-4
9,test_20231031_152204,11079715.png,443815,156082,287733,0.6483174295596138,6,7,124136,21528,102608,0.8265773023135916,14.749011555555555,1614.264208,16.05105743315916,110,3.0000000000000003E-4
10,test_20231031_152204,11551286.png,271883,2144,269739,0.9921142550288176,2,5,40092,312,39780,0.9922178988326849,15.528675555555555,1436.6126613333333,16.557406711756357,110,3.0000000000000003E-4
1,test_20231031_152205,10404007.png,502730,44612,458118,0.9112605175740457,4,6,61265,6320,54945,0.8968415898147393,23.988469333333335,2977.2318826666665,13.392676997378985,110,4.0E-4
2,test_20231031_152205,1254659.png,342646,104139,238507,0.6960740822890097,6,7,80080,14161,65919,0.8231643356643357,17.40023822222222,2286.743573333333,14.538628936508067,110,4.0E-4
3,test_20231031_152205,10188041.png,221231,13459,207772,0.9391631371733618,4,6,41731,1894,39837,0.9546140758668615,9.73372088888889,834.3248426666667,18.917451856378918,110,4.0E-4
4,test_20231031_152205,10287332.png,216980,16012,200968,0.9262051802009402,5,12,22337,2182,20155,0.9023145453731477,9.015146666666666,678.0014826666667,19.818497172762928,110,4.0E-4
5,test_20231031_152205,11610969.png,368720,42309,326411,0.8852543935777826,10,14,84111,6125,77986,0.9271795603428803,17.662497777777777,2100.2251573333333,14.90814504540811,110,4.0E-4
6,test_20231031_152205,10350842.png,212614,10444,202170,0.9508781171512695,4,7,42529,1529,41000,0.964048061322862,16.570321777777778,1764.44336,15.664726391377854,110,4.0E-4
7,test_20231031_152205,10863862.png,317432,23337,294095,0.9264818921847828,4,7,66058,3242,62816,0.9509219171031518,20.539557333333335,2460.170330666667,14.22115184208524,110,4.0E-4
8,test_20231031_152205,11382381.png,312486,2042,310444,0.9934653072457647,3,5,46745,280,46465,0.9940100545512889,18.51503111111111,1892.3000693333333,15.360903555872536,110,4.0E-4
9,test_20231031_152205,11079715.png,443815,156082,287733,0.6483174295596138,7,7,124136,21528,102608,0.8265773023135916,14.749011555555555,1614.264208,16.05105743315916,110,4.0E-4
10,test_20231031_152205,11551286.png,271883,2144,269739,0.9921142550288176,3,5,40092,312,39780,0.9922178988326849,15.528675555555555,1436.6126613333333,16.557406711756357,110,4.0E-4
1,test_20231031_152206,10404007.png,502730,44612,458118,0.9112605175740457,4,6,61265,6320,54945,0.8968415898147393,23.988469333333335,2977.2318826666665,13.392676997378985,110,5.0E-4
2,test_20231031_152206,1254659.png,342646,104139,238507,0.6960740822890097,5,6,80080,14161,65919,0.8231643356643357,17.40023822222222,2286.743573333333,14.538628936508067,110,5.0E-4
3,test_20231031_152206,10188041.png,221231,13459,207772,0.9391631371733618,3,6,41731,1894,39837,0.9546140758668615,9.73372088888889,834.3248426666667,18.917451856378918,110,5.0E-4
4,test_20231031_152206,10287332.png,216980,16012,200968,0.9262051802009402,2,6,22337,2182,20155,0.9023145453731477,9.015146666666666,678.0014826666667,19.818497172762928,110,5.0E-4
5,test_20231031_152206,11610969.png,368720,42309,326411,0.8852543935777826,5,6,84111,6125,77986,0.9271795603428803,17.662497777777777,2100.2251573333333,14.90814504540811,110,5.0E-4
6,test_20231031_152206,10350842.png,212614,10444,202170,0.9508781171512695,3,7,42529,1529,41000,0.964048061322862,16.570321777777778,1764.44336,15.664726391377854,110,5.0E-4
7,test_20231031_152206,10863862.png,317432,23337,294095,0.9264818921847828,4,7,66058,3242,62816,0.9509219171031518,20.539557333333335,2460.170330666667,14.22115184208524,110,5.0E-4
8,test_20231031_152206,11382381.png,312486,1692,310794,0.9945853574240126,3,7,46745,230,46515,0.9950796876671302,19.014094222222223,1971.496704,15.182843055229895,110,5.0E-4
9,test_20231031_152206,11079715.png,443815,156082,287733,0.6483174295596138,6,7,124136,21528,102608,0.8265773023135916,14.749011555555555,1614.264208,16.05105743315916,110,5.0E-4
10,test_20231031_152206,11551286.png,271883,2144,269739,0.9921142550288176,3,5,40092,312,39780,0.9922178988326849,15.528675555555555,1436.6126613333333,16.557406711756357,110,5.0E-4
1,test_20231031_152208,10404007.png,502730,44612,458118,0.9112605175740457,5,7,61265,6320,54945,0.8968415898147393,23.988469333333335,2977.2318826666665,13.392676997378985,110,6.000000000000001E-4
2,test_20231031_152208,1254659.png,342646,104139,238507,0.6960740822890097,5,7,80080,14161,65919,0.8231643356643357,17.40023822222222,2286.743573333333,14.538628936508067,110,6.000000000000001E-4
3,test_20231031_152208,10188041.png,221231,13459,207772,0.9391631371733618,4,6,41731,1894,39837,0.9546140758668615,9.73372088888889,834.3248426666667,18.917451856378918,110,6.000000000000001E-4
4,test_20231031_152208,10287332.png,216980,15932,201048,0.9265738777767536,3,5,22337,2170,20167,0.902851770604826,9.076064,685.2587413333333,19.77225776651095,110,6.000000000000001E-4
5,test_20231031_152208,11610969.png,368720,42309,326411,0.8852543935777826,5,6,84111,6125,77986,0.9271795603428803,17.662497777777777,2100.2251573333333,14.90814504540811,110,6.000000000000001E-4
6,test_20231031_152208,10350842.png,212614,10444,202170,0.9508781171512695,3,6,42529,1529,41000,0.964048061322862,16.570321777777778,1764.44336,15.664726391377854,110,6.000000000000001E-4
7,test_20231031_152208,10863862.png,317432,23237,294195,0.9267969202852895,4,6,66058,3230,62828,0.9511035756456447,20.549978666666668,2461.8056373333334,14.218265990174125,110,6.000000000000001E-4
8,test_20231031_152208,11382381.png,312486,1692,310794,0.9945853574240126,2,6,46745,230,46515,0.9950796876671302,19.014094222222223,1971.496704,15.182843055229895,110,6.000000000000001E-4
9,test_20231031_152208,11079715.png,443815,156082,287733,0.6483174295596138,8,10,124136,21528,102608,0.8265773023135916,14.749011555555555,1614.264208,16.05105743315916,110,6.000000000000001E-4
10,test_20231031_152208,11551286.png,271883,1732,270151,0.9936296127378321,3,7,40092,251,39841,0.9937393993814227,15.888540444444445,1491.6687146666666,16.39407979666711,110,6.000000000000001E-4
1,test_20231031_152209,10404007.png,502730,44612,458118,0.9112605175740457,5,8,61265,6320,54945,0.8968415898147393,23.988469333333335,2977.2318826666665,13.392676997378985,110,7.000000000000001E-4
2,test_20231031_152209,1254659.png,342646,104139,238507,0.6960740822890097,6,8,80080,14161,65919,0.8231643356643357,17.40023822222222,2286.743573333333,14.538628936508067,110,7.000000000000001E-4
3,test_20231031_152209,10188041.png,221231,13459,207772,0.9391631371733618,4,7,41731,1894,39837,0.9546140758668615,9.73372088888889,834.3248426666667,18.917451856378918,110,7.000000000000001E-4
4,test_20231031_152209,10287332.png,216980,15932,201048,0.9265738777767536,3,6,22337,2170,20167,0.902851770604826,9.076064,685.2587413333333,19.77225776651095,110,7.000000000000001E-4
5,test_20231031_152209,11610969.png,368720,42309,326411,0.8852543935777826,5,7,84111,6125,77986,0.9271795603428803,17.662497777777777,2100.2251573333333,14.90814504540811,110,7.000000000000001E-4
6,test_20231031_152209,10350842.png,212614,10444,202170,0.9508781171512695,2,5,42529,1529,41000,0.964048061322862,16.570321777777778,1764.44336,15.664726391377854,110,7.000000000000001E-4
7,test_20231031_152209,10863862.png,317432,23237,294195,0.9267969202852895,3,6,66058,3230,62828,0.9511035756456447,20.549978666666668,2461.8056373333334,14.218265990174125,110,7.000000000000001E-4
8,test_20231031_152209,11382381.png,312486,1692,310794,0.9945853574240126,3,7,46745,230,46515,0.9950796876671302,19.014094222222223,1971.496704,15.182843055229895,110,7.000000000000001E-4
9,test_20231031_152209,11079715.png,443815,156082,287733,0.6483174295596138,5,7,124136,21528,102608,0.8265773023135916,14.749011555555555,1614.264208,16.05105743315916,110,7.000000000000001E-4
10,test_20231031_152209,11551286.png,271883,1732,270151,0.9936296127378321,2,5,40092,251,39841,0.9937393993814227,15.888540444444445,1491.6687146666666,16.39407979666711,110,7.000000000000001E-4
1,test_20231031_152210,10404007.png,502730,44469,458261,0.9115449644938635,5,7,61265,6300,54965,0.8971680404798825,24.026336,2983.887328,13.382979407776372,110,8.000000000000001E-4
2,test_20231031_152210,1254659.png,342646,104019,238627,0.6964242979634958,6,8,80080,14146,65934,0.8233516483516483,17.73601777777778,2338.304864,14.441792278139156,110,8.000000000000001E-4
3,test_20231031_152210,10188041.png,221231,13317,207914,0.9398050002034073,4,6,41731,1876,39855,0.9550454098871343,9.860412444444444,850.507136,18.834023990481626,110,8.000000000000001E-4
4,test_20231031_152210,10287332.png,216980,15932,201048,0.9265738777767536,3,5,22337,2170,20167,0.902851770604826,9.076064,685.2587413333333,19.77225776651095,110,8.000000000000001E-4
5,test_20231031_152210,11610969.png,368720,42309,326411,0.8852543935777826,5,6,84111,6125,77986,0.9271795603428803,17.662497777777777,2100.2251573333333,14.90814504540811,110,8.000000000000001E-4
6,test_20231031_152210,10350842.png,212614,10444,202170,0.9508781171512695,3,6,42529,1529,41000,0.964048061322862,16.570321777777778,1764.44336,15.664726391377854,110,8.000000000000001E-4
7,test_20231031_152210,10863862.png,317432,22997,294435,0.9275529877265052,4,6,66058,3194,62864,0.9516485512731236,20.60872,2472.5420106666666,14.199366814902143,110,8.000000000000001E-4
8,test_20231031_152210,11382381.png,312486,1692,310794,0.9945853574240126,3,6,46745,230,46515,0.9950796876671302,19.014094222222223,1971.496704,15.182843055229895,110,8.000000000000001E-4
9,test_20231031_152210,11079715.png,443815,156082,287733,0.6483174295596138,14,17,124136,21528,102608,0.8265773023135916,14.749011555555555,1614.264208,16.05105743315916,110,8.000000000000001E-4
10,test_20231031_152210,11551286.png,271883,1592,270291,0.9941445401146817,2,6,40092,230,39862,0.9942631946522997,16.121671111111112,1534.706784,16.270549479959495,110,8.000000000000001E-4
1,test_20231031_152211,10404007.png,502730,44469,458261,0.9115449644938635,5,7,61265,6300,54965,0.8971680404798825,24.026336,2983.887328,13.382979407776372,110,9.000000000000002E-4
2,test_20231031_152211,1254659.png,342646,104019,238627,0.6964242979634958,5,7,80080,14146,65934,0.8233516483516483,17.73601777777778,2338.304864,14.441792278139156,110,9.000000000000002E-4
3,test_20231031_152211,10188041.png,221231,13317,207914,0.9398050002034073,4,6,41731,1876,39855,0.9550454098871343,9.860412444444444,850.507136,18.834023990481626,110,9.000000000000002E-4
4,test_20231031_152211,10287332.png,216980,15932,201048,0.9265738777767536,2,6,22337,2170,20167,0.902851770604826,9.076064,685.2587413333333,19.77225776651095,110,9.000000000000002E-4
5,test_20231031_152211,11610969.png,368720,42309,326411,0.8852543935777826,4,6,84111,6125,77986,0.9271795603428803,17.662497777777777,2100.2251573333333,14.90814504540811,110,9.000000000000002E-4
6,test_20231031_152211,10350842.png,212614,10444,202170,0.9508781171512695,3,5,42529,1529,41000,0.964048061322862,16.570321777777778,1764.44336,15.664726391377854,110,9.000000000000002E-4
7,test_20231031_152211,10863862.png,317432,22997,294435,0.9275529877265052,3,6,66058,3194,62864,0.9516485512731236,20.60872,2472.5420106666666,14.199366814902143,110,9.000000000000002E-4
8,test_20231031_152211,11382381.png,312486,1692,310794,0.9945853574240126,3,6,46745,230,46515,0.9950796876671302,19.014094222222223,1971.496704,15.182843055229895,110,9.000000000000002E-4
9,test_20231031_152211,11079715.png,443815,156082,287733,0.6483174295596138,6,7,124136,21528,102608,0.8265773023135916,14.749011555555555,1614.264208,16.05105743315916,110,9.000000000000002E-4
10,test_20231031_152211,11551286.png,271883,1592,270291,0.9941445401146817,3,6,40092,230,39862,0.9942631946522997,16.121671111111112,1534.706784,16.270549479959495,110,9.000000000000002E-4
1,test_20231031_152212,10404007.png,502730,43567,459163,0.9133391681419449,4,6,61265,6190,55075,0.8989635191381702,24.104625777777777,2998.838688,13.361272558271775,110,0.0010000000000000002
2,test_20231031_152212,1254659.png,342646,103597,239049,0.6976558897521057,5,7,80080,14101,65979,0.8239135864135865,18.053664,2408.430272,14.31346283571825,110,0.0010000000000000002
3,test_20231031_152212,10188041.png,221231,13137,208094,0.9406186293964227,3,6,41731,1853,39878,0.9555965589130383,9.965080888888888,868.677536,18.742217700644726,110,0.0010000000000000002
4,test_20231031_152212,10287332.png,216980,15932,201048,0.9265738777767536,3,6,22337,2170,20167,0.902851770604826,9.076064,685.2587413333333,19.77225776651095,110,0.0010000000000000002
5,test_20231031_152212,11610969.png,368720,41947,326773,0.88623616836624,4,6,84111,6076,78035,0.9277621238601372,17.722387555555557,2108.2881013333335,14.891504031557151,110,0.0010000000000000002
6,test_20231031_152212,10350842.png,212614,10282,202332,0.9516400613318031,3,6,42529,1505,41024,0.9646123821392462,16.577134222222224,1766.8085333333333,15.658908727206391,110,0.0010000000000000002
7,test_20231031_152212,10863862.png,317432,22794,294638,0.9281924947705336,3,6,66058,3166,62892,0.9520724212056072,20.663123555555554,2482.51064,14.181892423174563,110,0.0010000000000000002
8,test_20231031_152212,11382381.png,312486,1472,311014,0.9952893889646256,2,6,46745,199,46546,0.9957428601989518,19.922248888888888,2126.2597386666666,14.854640450929011,110,0.0010000000000000002
9,test_20231031_152212,11079715.png,443815,156022,287793,0.648452621024526,6,7,124136,21524,102612,0.8266095250370561,14.752165333333334,1614.4291466666666,16.05061371215515,110,0.0010000000000000002
10,test_20231031_152212,11551286.png,271883,1512,270371,0.9944387843300243,3,6,40092,218,39874,0.994562506235658,16.194019555555556,1548.9073813333334,16.230549114614764,110,0.0010000000000000002
1,test_20231031_152213,10404007.png,502730,43464,459266,0.9135440494897857,4,6,61265,6175,55090,0.8992083571370276,24.113157333333334,3000.2240053333335,13.359266792654708,110,0.0011000000000000003
2,test_20231031_152213,1254659.png,342646,103597,239049,0.6976558897521057,5,7,80080,14101,65979,0.8239135864135865,18.053664,2408.430272,14.31346283571825,110,0.0011000000000000003
3,test_20231031_152213,10188041.png,221231,13037,208194,0.9410706456147646,4,5,41731,1840,39891,0.9559080779276796,10.092725333333334,879.8259413333334,18.686835980306252,110,0.0011000000000000003
4,test_20231031_152213,10287332.png,216980,15932,201048,0.9265738777767536,3,5,22337,2170,20167,0.902851770604826,9.076064,685.2587413333333,19.77225776651095,110,0.0011000000000000003
5,test_20231031_152213,11610969.png,368720,41947,326773,0.88623616836624,4,6,84111,6076,78035,0.9277621238601372,17.722387555555557,2108.2881013333335,14.891504031557151,110,0.0011000000000000003
6,test_20231031_152213,10350842.png,212614,10282,202332,0.9516400613318031,2,5,42529,1505,41024,0.9646123821392462,16.577134222222224,1766.8085333333333,15.658908727206391,110,0.0011000000000000003
7,test_20231031_152213,10863862.png,317432,22794,294638,0.9281924947705336,3,6,66058,3166,62892,0.9520724212056072,20.663123555555554,2482.51064,14.181892423174563,110,0.0011000000000000003
8,test_20231031_152213,11382381.png,312486,1472,311014,0.9952893889646256,2,5,46745,199,46546,0.9957428601989518,19.922248888888888,2126.2597386666666,14.854640450929011,110,0.0011000000000000003
9,test_20231031_152213,11079715.png,443815,156022,287793,0.648452621024526,7,7,124136,21524,102612,0.8266095250370561,14.752165333333334,1614.4291466666666,16.05061371215515,110,0.0011000000000000003
10,test_20231031_152213,11551286.png,271883,1492,270391,0.99451234538386,2,6,40092,215,39877,0.9946373341314976,16.231744,1556.848,16.20834147775488,110,0.0011000000000000003
1,test_20231031_152214,10404007.png,502730,43464,459266,0.9135440494897857,5,6,61265,6175,55090,0.8992083571370276,24.113157333333334,3000.2240053333335,13.359266792654708,110,0.0012000000000000003
2,test_20231031_152214,1254659.png,342646,103597,239049,0.6976558897521057,6,7,80080,14101,65979,0.8239135864135865,18.053664,2408.430272,14.31346283571825,110,0.0012000000000000003
3,test_20231031_152214,10188041.png,221231,13037,208194,0.9410706456147646,4,6,41731,1840,39891,0.9559080779276796,10.092725333333334,879.8259413333334,18.686835980306252,110,0.0012000000000000003
4,test_20231031_152214,10287332.png,216980,15932,201048,0.9265738777767536,2,5,22337,2170,20167,0.902851770604826,9.076064,685.2587413333333,19.77225776651095,110,0.0012000000000000003
5,test_20231031_152214,11610969.png,368720,41947,326773,0.88623616836624,4,6,84111,6076,78035,0.9277621238601372,17.722387555555557,2108.2881013333335,14.891504031557151,110,0.0012000000000000003
6,test_20231031_152214,10350842.png,212614,10282,202332,0.9516400613318031,3,5,42529,1505,41024,0.9646123821392462,16.577134222222224,1766.8085333333333,15.658908727206391,110,0.0012000000000000003
7,test_20231031_152214,10863862.png,317432,22794,294638,0.9281924947705336,4,6,66058,3166,62892,0.9520724212056072,20.663123555555554,2482.51064,14.181892423174563,110,0.0012000000000000003
8,test_20231031_152214,11382381.png,312486,1472,311014,0.9952893889646256,2,6,46745,199,46546,0.9957428601989518,19.922248888888888,2126.2597386666666,14.854640450929011,110,0.0012000000000000003
9,test_20231031_152214,11079715.png,443815,156022,287793,0.648452621024526,6,7,124136,21524,102612,0.8266095250370561,14.752165333333334,1614.4291466666666,16.05061371215515,110,0.0012000000000000003
10,test_20231031_152214,11551286.png,271883,1492,270391,0.99451234538386,2,6,40092,215,39877,0.9946373341314976,16.231744,1556.848,16.20834147775488,110,0.0012000000000000003
1,test_20231031_152216,10404007.png,502730,43464,459266,0.9135440494897857,4,6,61265,6175,55090,0.8992083571370276,24.113157333333334,3000.2240053333335,13.359266792654708,110,0.0013000000000000004
2,test_20231031_152216,1254659.png,342646,103597,239049,0.6976558897521057,5,6,80080,14101,65979,0.8239135864135865,18.053664,2408.430272,14.31346283571825,110,0.0013000000000000004
3,test_20231031_152216,10188041.png,221231,12917,208314,0.941613065076775,3,6,41731,1827,39904,0.9562195969423211,10.140309333333333,885.0548053333333,18.66110196478679,110,0.0013000000000000004
4,test_20231031_152216,10287332.png,216980,15932,201048,0.9265738777767536,3,6,22337,2170,20167,0.902851770604826,9.076064,685.2587413333333,19.77225776651095,110,0.0013000000000000004
5,test_20231031_152216,11610969.png,368720,41867,326853,0.886453135170319,4,6,84111,6064,78047,0.9279047924766083,17.757690666666665,2111.962576,14.88394142640933,110,0.0013000000000000004
6,test_20231031_152216,10350842.png,212614,10262,202352,0.9517341285145852,3,6,42529,1502,41027,0.9646829222412941,16.644469333333333,1771.9864426666666,15.646199660581763,110,0.0013000000000000004
7,test_20231031_152216,10863862.png,317432,22794,294638,0.9281924947705336,4,6,66058,3166,62892,0.9520724212056072,20.663123555555554,2482.51064,14.181892423174563,110,0.0013000000000000004
8,test_20231031_152216,11382381.png,312486,1472,311014,0.9952893889646256,3,6,46745,199,46546,0.9957428601989518,19.922248888888888,2126.2597386666666,14.854640450929011,110,0.0013000000000000004
9,test_20231031_152216,11079715.png,443815,155802,288013,0.6489483230625372,6,7,124136,21496,102640,0.8268350841013082,15.085107555555556,1670.34056,15.902753338820148,110,0.0013000000000000004
10,test_20231031_152216,11551286.png,271883,1492,270391,0.99451234538386,2,6,40092,215,39877,0.9946373341314976,16.231744,1556.848,16.20834147775488,110,0.0013000000000000004
1,test_20231031_152217,10404007.png,502730,43464,459266,0.9135440494897857,4,6,61265,6175,55090,0.8992083571370276,24.113157333333334,3000.2240053333335,13.359266792654708,110,0.0014000000000000004
2,test_20231031_152217,1254659.png,342646,103597,239049,0.6976558897521057,6,7,80080,14101,65979,0.8239135864135865,18.053664,2408.430272,14.31346283571825,110,0.0014000000000000004
3,test_20231031_152217,10188041.png,221231,12917,208314,0.941613065076775,3,6,41731,1827,39904,0.9562195969423211,10.140309333333333,885.0548053333333,18.66110196478679,110,0.0014000000000000004
4,test_20231031_152217,10287332.png,216980,15932,201048,0.9265738777767536,2,6,22337,2170,20167,0.902851770604826,9.076064,685.2587413333333,19.77225776651095,110,0.0014000000000000004
5,test_20231031_152217,11610969.png,368720,41867,326853,0.886453135170319,4,6,84111,6064,78047,0.9279047924766083,17.757690666666665,2111.962576,14.88394142640933,110,0.0014000000000000004
6,test_20231031_152217,10350842.png,212614,10262,202352,0.9517341285145852,3,6,42529,1502,41027,0.9646829222412941,16.644469333333333,1771.9864426666666,15.646199660581763,110,0.0014000000000000004
7,test_20231031_152217,10863862.png,317432,22794,294638,0.9281924947705336,3,6,66058,3166,62892,0.9520724212056072,20.663123555555554,2482.51064,14.181892423174563,110,0.0014000000000000004
8,test_20231031_152217,11382381.png,312486,1472,311014,0.9952893889646256,2,5,46745,199,46546,0.9957428601989518,19.922248888888888,2126.2597386666666,14.854640450929011,110,0.0014000000000000004
9,test_20231031_152217,11079715.png,443815,155802,288013,0.6489483230625372,6,7,124136,21496,102640,0.8268350841013082,15.085107555555556,1670.34056,15.902753338820148,110,0.0014000000000000004
10,test_20231031_152217,11551286.png,271883,1492,270391,0.99451234538386,2,5,40092,215,39877,0.9946373341314976,16.231744,1556.848,16.20834147775488,110,0.0014000000000000004
1,test_20231031_152218,10404007.png,502730,42562,460168,0.9153382531378672,4,6,61265,6051,55214,0.9012323512609157,24.086816,3002.6337066666665,13.355780053176534,111,1.0E-4
2,test_20231031_152218,1254659.png,342646,102352,240294,0.7012893773749,5,6,80080,13934,66146,0.825999000999001,17.548469333333333,2326.5860053333336,14.46361249431121,111,1.0E-4
3,test_20231031_152218,10188041.png,221231,13479,207752,0.9390727339296934,3,5,41731,1895,39836,0.9545901128657353,9.615207111111111,818.3408213333333,19.001461452195805,111,1.0E-4
4,test_20231031_152218,10287332.png,216980,16082,200898,0.9258825698221034,3,6,22337,2189,20148,0.902001163988002,8.817786666666667,639.4181706666667,20.072953871928956,111,1.0E-4
5,test_20231031_152218,11610969.png,368720,41072,327648,0.8886092427858537,3,6,84111,5950,78161,0.9292601443330837,17.776954666666665,2128.4956853333333,14.850075867107916,111,1.0E-4
6,test_20231031_152218,10350842.png,212614,10102,202512,0.9524866659768406,2,5,42529,1480,41049,0.9652002163229796,16.596364444444443,1770.9004426666668,15.648862143677517,111,1.0E-4
7,test_20231031_152218,10863862.png,317432,23097,294335,0.9272379596259986,3,5,66058,3209,62849,0.9514214780950074,20.177452444444445,2431.6214666666665,14.271843921311088,111,1.0E-4
8,test_20231031_152218,11382381.png,312486,2397,310089,0.9923292563506845,3,6,46745,332,46413,0.9928976361108139,16.784181333333333,1639.3545173333334,15.984074791261948,111,1.0E-4
9,test_20231031_152218,11079715.png,443815,153702,290113,0.6536800243344637,6,7,124136,21226,102910,0.8290101179351679,14.857429333333334,1638.0351146666667,15.987571533442999,111,1.0E-4
10,test_20231031_152218,11551286.png,271883,2304,269579,0.9915257665981323,2,5,40092,336,39756,0.9916192756659683,15.449232,1431.308656,16.57347063136679,111,1.0E-4
1,test_20231031_152219,10404007.png,502730,42562,460168,0.9153382531378672,4,6,61265,6051,55214,0.9012323512609157,24.086816,3002.6337066666665,13.355780053176534,111,2.0E-4
2,test_20231031_152219,1254659.png,342646,102352,240294,0.7012893773749,5,7,80080,13934,66146,0.825999000999001,17.548469333333333,2326.5860053333336,14.46361249431121,111,2.0E-4
3,test_20231031_152219,10188041.png,221231,13479,207752,0.9390727339296934,3,5,41731,1895,39836,0.9545901128657353,9.615207111111111,818.3408213333333,19.001461452195805,111,2.0E-4
4,test_20231031_152219,10287332.png,216980,15832,201148,0.9270347497465204,3,6,22337,2159,20178,0.903344227067198,8.948837333333334,666.4692213333333,19.893002631026448,111,2.0E-4
5,test_20231031_152219,11610969.png,368720,41072,327648,0.8886092427858537,3,6,84111,5950,78161,0.9292601443330837,17.776954666666665,2128.4956853333333,14.850075867107916,111,2.0E-4
6,test_20231031_152219,10350842.png,212614,10102,202512,0.9524866659768406,3,6,42529,1480,41049,0.9652002163229796,16.596364444444443,1770.9004426666668,15.648862143677517,111,2.0E-4
7,test_20231031_152219,10863862.png,317432,23097,294335,0.9272379596259986,4,6,66058,3209,62849,0.9514214780950074,20.177452444444445,2431.6214666666665,14.271843921311088,111,2.0E-4
8,test_20231031_152219,11382381.png,312486,2284,310202,0.9926908725510903,3,5,46745,316,46429,0.9932399187078832,17.83641777777778,1779.04056,15.628945112756188,111,2.0E-4
9,test_20231031_152219,11079715.png,443815,153702,290113,0.6536800243344637,6,7,124136,21226,102910,0.8290101179351679,14.857429333333334,1638.0351146666667,15.987571533442999,111,2.0E-4
10,test_20231031_152219,11551286.png,271883,2104,269779,0.9922613771364889,2,5,40092,306,39786,0.992367554624364,15.539011555555556,1438.106048,16.55289448142983,111,2.0E-4
1,test_20231031_152220,10404007.png,502730,42562,460168,0.9153382531378672,4,6,61265,6051,55214,0.9012323512609157,24.086816,3002.6337066666665,13.355780053176534,111,3.0000000000000003E-4
2,test_20231031_152220,1254659.png,342646,102272,240374,0.7015228544912242,5,6,80080,13927,66153,0.8260864135864135,17.560416,2328.003936,14.460966506195977,111,3.0000000000000003E-4
3,test_20231031_152220,10188041.png,221231,13337,207894,0.9397145969597389,3,6,41731,1876,39855,0.9550454098871343,9.770044444444444,839.5546346666666,18.89031397425179,111,3.0000000000000003E-4
4,test_20231031_152220,10287332.png,216980,15792,201188,0.9272190985344271,3,6,22337,2153,20184,0.9036128396830371,9.050174222222223,684.526256,19.776902500820096,111,3.0000000000000003E-4
5,test_20231031_152220,11610969.png,368720,41072,327648,0.8886092427858537,4,6,84111,5950,78161,0.9292601443330837,17.776954666666665,2128.4956853333333,14.850075867107916,111,3.0000000000000003E-4
6,test_20231031_152220,10350842.png,212614,10102,202512,0.9524866659768406,3,6,42529,1480,41049,0.9652002163229796,16.596364444444443,1770.9004426666668,15.648862143677517,111,3.0000000000000003E-4
7,test_20231031_152220,10863862.png,317432,22854,294578,0.9280034779102296,4,6,66058,3176,62882,0.9519210390868631,20.635258666666665,2487.462928,14.173237439265321,111,3.0000000000000003E-4
8,test_20231031_152220,11382381.png,312486,2284,310202,0.9926908725510903,3,6,46745,316,46429,0.9932399187078832,17.83641777777778,1779.04056,15.628945112756188,111,3.0000000000000003E-4
9,test_20231031_152220,11079715.png,443815,153702,290113,0.6536800243344637,5,7,124136,21226,102910,0.8290101179351679,14.857429333333334,1638.0351146666667,15.987571533442999,111,3.0000000000000003E-4
10,test_20231031_152220,11551286.png,271883,2104,269779,0.9922613771364889,3,6,40092,306,39786,0.992367554624364,15.539011555555556,1438.106048,16.55289448142983,111,3.0000000000000003E-4
1,test_20231031_152221,10404007.png,502730,42562,460168,0.9153382531378672,5,6,61265,6051,55214,0.9012323512609157,24.086816,3002.6337066666665,13.355780053176534,111,4.0E-4
2,test_20231031_152221,1254659.png,342646,102272,240374,0.7015228544912242,5,6,80080,13927,66153,0.8260864135864135,17.560416,2328.003936,14.460966506195977,111,4.0E-4
3,test_20231031_152221,10188041.png,221231,13337,207894,0.9397145969597389,4,6,41731,1876,39855,0.9550454098871343,9.770044444444444,839.5546346666666,18.89031397425179,111,4.0E-4
4,test_20231031_152221,10287332.png,216980,15792,201188,0.9272190985344271,2,5,22337,2153,20184,0.9036128396830371,9.050174222222223,684.526256,19.776902500820096,111,4.0E-4
5,test_20231031_152221,11610969.png,368720,41072,327648,0.8886092427858537,4,6,84111,5950,78161,0.9292601443330837,17.776954666666665,2128.4956853333333,14.850075867107916,111,4.0E-4
6,test_20231031_152221,10350842.png,212614,10102,202512,0.9524866659768406,2,6,42529,1480,41049,0.9652002163229796,16.596364444444443,1770.9004426666668,15.648862143677517,111,4.0E-4
7,test_20231031_152221,10863862.png,317432,22854,294578,0.9280034779102296,3,6,66058,3176,62882,0.9519210390868631,20.635258666666665,2487.462928,14.173237439265321,111,4.0E-4
8,test_20231031_152221,11382381.png,312486,1982,310504,0.99365731584775,2,5,46745,271,46474,0.9942025885121404,18.52738311111111,1894.164208,15.356627349139568,111,4.0E-4
9,test_20231031_152221,11079715.png,443815,153702,290113,0.6536800243344637,6,7,124136,21226,102910,0.8290101179351679,14.857429333333334,1638.0351146666667,15.987571533442999,111,4.0E-4
10,test_20231031_152221,11551286.png,271883,2104,269779,0.9922613771364889,2,5,40092,306,39786,0.992367554624364,15.539011555555556,1438.106048,16.55289448142983,111,4.0E-4
1,test_20231031_152222,10404007.png,502730,42562,460168,0.9153382531378672,4,6,61265,6051,55214,0.9012323512609157,24.086816,3002.6337066666665,13.355780053176534,111,5.0E-4
2,test_20231031_152222,1254659.png,342646,102272,240374,0.7015228544912242,5,6,80080,13927,66153,0.8260864135864135,17.560416,2328.003936,14.460966506195977,111,5.0E-4
3,test_20231031_152222,10188041.png,221231,13337,207894,0.9397145969597389,3,6,41731,1876,39855,0.9550454098871343,9.770044444444444,839.5546346666666,18.89031397425179,111,5.0E-4
4,test_20231031_152222,10287332.png,216980,15792,201188,0.9272190985344271,3,6,22337,2153,20184,0.9036128396830371,9.050174222222223,684.526256,19.776902500820096,111,5.0E-4
5,test_20231031_152222,11610969.png,368720,41072,327648,0.8886092427858537,4,6,84111,5950,78161,0.9292601443330837,17.776954666666665,2128.4956853333333,14.850075867107916,111,5.0E-4
6,test_20231031_152222,10350842.png,212614,10102,202512,0.9524866659768406,3,6,42529,1480,41049,0.9652002163229796,16.596364444444443,1770.9004426666668,15.648862143677517,111,5.0E-4
7,test_20231031_152222,10863862.png,317432,22854,294578,0.9280034779102296,3,5,66058,3176,62882,0.9519210390868631,20.635258666666665,2487.462928,14.173237439265321,111,5.0E-4
8,test_20231031_152222,11382381.png,312486,1692,310794,0.9945853574240126,2,6,46745,230,46515,0.9950796876671302,19.014094222222223,1971.496704,15.182843055229895,111,5.0E-4
9,test_20231031_152222,11079715.png,443815,153702,290113,0.6536800243344637,6,7,124136,21226,102910,0.8290101179351679,14.857429333333334,1638.0351146666667,15.987571533442999,111,5.0E-4
10,test_20231031_152222,11551286.png,271883,2104,269779,0.9922613771364889,3,6,40092,306,39786,0.992367554624364,15.539011555555556,1438.106048,16.55289448142983,111,5.0E-4
1,test_20231031_152223,10404007.png,502730,42482,460248,0.9154973842818213,5,6,61265,6039,55226,0.9014282216600016,24.120597333333333,3008.5279466666666,13.347263107950143,111,6.000000000000001E-4
2,test_20231031_152223,1254659.png,342646,102212,240434,0.7016979623284673,5,7,80080,13921,66159,0.8261613386613387,17.583310222222224,2329.983584,14.457274996716468,111,6.000000000000001E-4
3,test_20231031_152223,10188041.png,221231,13337,207894,0.9397145969597389,4,6,41731,1876,39855,0.9550454098871343,9.770044444444444,839.5546346666666,18.89031397425179,111,6.000000000000001E-4
4,test_20231031_152223,10287332.png,216980,15712,201268,0.9275877961102406,3,5,22337,2141,20196,0.9041500649147155,9.111091555555555,691.7835146666666,19.73110152386741,111,6.000000000000001E-4
5,test_20231031_152223,11610969.png,368720,41072,327648,0.8886092427858537,4,6,84111,5950,78161,0.9292601443330837,17.776954666666665,2128.4956853333333,14.850075867107916,111,6.000000000000001E-4
6,test_20231031_152223,10350842.png,212614,10102,202512,0.9524866659768406,3,6,42529,1480,41049,0.9652002163229796,16.596364444444443,1770.9004426666668,15.648862143677517,111,6.000000000000001E-4
7,test_20231031_152223,10863862.png,317432,22512,294920,0.929080874013962,3,6,66058,3128,62930,0.9526476732568349,20.704421333333332,2499.834608,14.151690846794882,111,6.000000000000001E-4
8,test_20231031_152223,11382381.png,312486,1692,310794,0.9945853574240126,2,5,46745,230,46515,0.9950796876671302,19.014094222222223,1971.496704,15.182843055229895,111,6.000000000000001E-4
9,test_20231031_152223,11079715.png,443815,153702,290113,0.6536800243344637,6,7,124136,21226,102910,0.8290101179351679,14.857429333333334,1638.0351146666667,15.987571533442999,111,6.000000000000001E-4
10,test_20231031_152223,11551286.png,271883,1672,270211,0.993850295899339,3,6,40092,242,39850,0.9939638830689415,15.980974222222223,1516.8482986666668,16.321382120827387,111,6.000000000000001E-4
1,test_20231031_152224,10404007.png,502730,42482,460248,0.9154973842818213,4,6,61265,6039,55226,0.9014282216600016,24.120597333333333,3008.5279466666666,13.347263107950143,111,7.000000000000001E-4
2,test_20231031_152224,1254659.png,342646,102212,240434,0.7016979623284673,5,6,80080,13921,66159,0.8261613386613387,17.583310222222224,2329.983584,14.457274996716468,111,7.000000000000001E-4
3,test_20231031_152224,10188041.png,221231,13337,207894,0.9397145969597389,3,5,41731,1876,39855,0.9550454098871343,9.770044444444444,839.5546346666666,18.89031397425179,111,7.000000000000001E-4
4,test_20231031_152224,10287332.png,216980,15712,201268,0.9275877961102406,2,5,22337,2141,20196,0.9041500649147155,9.111091555555555,691.7835146666666,19.73110152386741,111,7.000000000000001E-4
5,test_20231031_152224,11610969.png,368720,41072,327648,0.8886092427858537,4,6,84111,5950,78161,0.9292601443330837,17.776954666666665,2128.4956853333333,14.850075867107916,111,7.000000000000001E-4
6,test_20231031_152224,10350842.png,212614,10102,202512,0.9524866659768406,2,7,42529,1480,41049,0.9652002163229796,16.596364444444443,1770.9004426666668,15.648862143677517,111,7.000000000000001E-4
7,test_20231031_152224,10863862.png,317432,22512,294920,0.929080874013962,3,6,66058,3128,62930,0.9526476732568349,20.704421333333332,2499.834608,14.151690846794882,111,7.000000000000001E-4
8,test_20231031_152224,11382381.png,312486,1692,310794,0.9945853574240126,2,10,46745,230,46515,0.9950796876671302,19.014094222222223,1971.496704,15.182843055229895,111,7.000000000000001E-4
9,test_20231031_152224,11079715.png,443815,153702,290113,0.6536800243344637,6,7,124136,21226,102910,0.8290101179351679,14.857429333333334,1638.0351146666667,15.987571533442999,111,7.000000000000001E-4
10,test_20231031_152224,11551286.png,271883,1672,270211,0.993850295899339,2,13,40092,242,39850,0.9939638830689415,15.980974222222223,1516.8482986666668,16.321382120827387,111,7.000000000000001E-4
1,test_20231031_152225,10404007.png,502730,42259,460471,0.9159409623455931,5,6,61265,6010,55255,0.9019015751244593,24.133996444444445,3010.824688,13.343948923863012,111,8.000000000000001E-4
2,test_20231031_152225,1254659.png,342646,102152,240494,0.7018730701657103,5,7,80080,13912,66168,0.8262737262737263,17.896195555555554,2379.5652266666666,14.365827470501518,111,8.000000000000001E-4
3,test_20231031_152225,10188041.png,221231,13217,208014,0.9402570164217492,3,6,41731,1861,39870,0.9554048549040282,9.895552,855.5378666666667,18.808411244069966,111,8.000000000000001E-4
4,test_20231031_152225,10287332.png,216980,15712,201268,0.9275877961102406,3,6,22337,2141,20196,0.9041500649147155,9.111091555555555,691.7835146666666,19.73110152386741,111,8.000000000000001E-4
5,test_20231031_152225,11610969.png,368720,41072,327648,0.8886092427858537,4,6,84111,5950,78161,0.9292601443330837,17.776954666666665,2128.4956853333333,14.850075867107916,111,8.000000000000001E-4
6,test_20231031_152225,10350842.png,212614,10102,202512,0.9524866659768406,2,5,42529,1480,41049,0.9652002163229796,16.596364444444443,1770.9004426666668,15.648862143677517,111,8.000000000000001E-4
7,test_20231031_152225,10863862.png,317432,22512,294920,0.929080874013962,3,5,66058,3128,62930,0.9526476732568349,20.704421333333332,2499.834608,14.151690846794882,111,8.000000000000001E-4
8,test_20231031_152225,11382381.png,312486,1492,310994,0.9952253860972972,2,6,46745,201,46544,0.9957000748743181,19.88124977777778,2121.948410666667,14.863455398488405,111,8.000000000000001E-4
9,test_20231031_152225,11079715.png,443815,153702,290113,0.6536800243344637,7,7,124136,21226,102910,0.8290101179351679,14.857429333333334,1638.0351146666667,15.987571533442999,111,8.000000000000001E-4
10,test_20231031_152225,11551286.png,271883,1552,270331,0.994291662222353,3,7,40092,224,39868,0.9944128504439789,16.13200711111111,1536.2001706666667,16.266325518443356,111,8.000000000000001E-4
1,test_20231031_152226,10404007.png,502730,42259,460471,0.9159409623455931,4,7,61265,6010,55255,0.9019015751244593,24.133996444444445,3010.824688,13.343948923863012,111,9.000000000000002E-4
2,test_20231031_152226,1254659.png,342646,102152,240494,0.7018730701657103,6,6,80080,13912,66168,0.8262737262737263,17.896195555555554,2379.5652266666666,14.365827470501518,111,9.000000000000002E-4
3,test_20231031_152226,10188041.png,221231,13217,208014,0.9402570164217492,3,5,41731,1861,39870,0.9554048549040282,9.895552,855.5378666666667,18.808411244069966,111,9.000000000000002E-4
4,test_20231031_152226,10287332.png,216980,15712,201268,0.9275877961102406,3,6,22337,2141,20196,0.9041500649147155,9.111091555555555,691.7835146666666,19.73110152386741,111,9.000000000000002E-4
5,test_20231031_152226,11610969.png,368720,41072,327648,0.8886092427858537,4,7,84111,5950,78161,0.9292601443330837,17.776954666666665,2128.4956853333333,14.850075867107916,111,9.000000000000002E-4
6,test_20231031_152226,10350842.png,212614,10102,202512,0.9524866659768406,3,6,42529,1480,41049,0.9652002163229796,16.596364444444443,1770.9004426666668,15.648862143677517,111,9.000000000000002E-4
7,test_20231031_152226,10863862.png,317432,22512,294920,0.929080874013962,4,6,66058,3128,62930,0.9526476732568349,20.704421333333332,2499.834608,14.151690846794882,111,9.000000000000002E-4
8,test_20231031_152226,11382381.png,312486,1492,310994,0.9952253860972972,3,6,46745,201,46544,0.9957000748743181,19.88124977777778,2121.948410666667,14.863455398488405,111,9.000000000000002E-4
9,test_20231031_152226,11079715.png,443815,153702,290113,0.6536800243344637,6,7,124136,21226,102910,0.8290101179351679,14.857429333333334,1638.0351146666667,15.987571533442999,111,9.000000000000002E-4
10,test_20231031_152226,11551286.png,271883,1552,270331,0.994291662222353,2,6,40092,224,39868,0.9944128504439789,16.13200711111111,1536.2001706666667,16.266325518443356,111,9.000000000000002E-4
1,test_20231031_152227,10404007.png,502730,41394,461336,0.9176615678395958,4,6,61265,5900,55365,0.9036970537827471,24.200389333333334,3023.867333333333,13.325176274994408,111,0.0010000000000000002
2,test_20231031_152227,1254659.png,342646,101667,240979,0.7032885251834254,5,7,80080,13862,66218,0.8268981018981019,18.23960888888889,2453.5297173333333,14.232890383122463,111,0.0010000000000000002
3,test_20231031_152227,10188041.png,221231,13037,208194,0.9410706456147646,3,5,41731,1838,39893,0.9559560039299322,10.000220444444444,873.7082666666666,18.717139160217407,111,0.0010000000000000002
4,test_20231031_152227,10287332.png,216980,15689,201291,0.927693796663287,2,6,22337,2138,20199,0.904284371222635,9.112368,692.278672,19.727994089695926,111,0.0010000000000000002
5,test_20231031_152227,11610969.png,368720,40752,327968,0.8894771100021697,4,6,84111,5906,78205,0.9297832625934777,17.835607111111113,2136.139856,14.83450677726422,111,0.0010000000000000002
6,test_20231031_152227,10350842.png,212614,9802,202812,0.9538976737185698,3,6,42529,1435,41094,0.9662583178536999,16.635575111111113,1778.8767413333333,15.629345040787058,111,0.0010000000000000002
7,test_20231031_152227,10863862.png,317432,22052,295380,0.9305300032762922,3,6,66058,3069,62989,0.9535408277574253,20.888218666666667,2539.10744,14.08399282833132,111,0.0010000000000000002
8,test_20231031_152227,11382381.png,312486,1472,311014,0.9952893889646256,2,6,46745,199,46546,0.9957428601989518,19.922248888888888,2126.2597386666666,14.854640450929011,111,0.0010000000000000002
9,test_20231031_152227,11079715.png,443815,153642,290173,0.6538152157993758,5,7,124136,21222,102914,0.8290423406586325,14.860583111111112,1638.2000533333332,15.9871342513239,111,0.0010000000000000002
10,test_20231031_152227,11551286.png,271883,1492,270391,0.99451234538386,2,5,40092,215,39877,0.9946373341314976,16.19445688888889,1548.9830613333334,16.230336922434276,111,0.0010000000000000002
1,test_20231031_152228,10404007.png,502730,41394,461336,0.9176615678395958,4,6,61265,5900,55365,0.9036970537827471,24.200389333333334,3023.867333333333,13.325176274994408,111,0.0011000000000000003
2,test_20231031_152228,1254659.png,342646,101667,240979,0.7032885251834254,5,7,80080,13862,66218,0.8268981018981019,18.23960888888889,2453.5297173333333,14.232890383122463,111,0.0011000000000000003
3,test_20231031_152228,10188041.png,221231,12937,208294,0.9415226618331066,3,6,41731,1825,39906,0.9562675229445736,10.127864888888888,884.856672,18.662074309616564,111,0.0011000000000000003
4,test_20231031_152228,10287332.png,216980,15689,201291,0.927693796663287,2,6,22337,2138,20199,0.904284371222635,9.112368,692.278672,19.727994089695926,111,0.0011000000000000003
5,test_20231031_152228,11610969.png,368720,40752,327968,0.8894771100021697,5,11,84111,5906,78205,0.9297832625934777,17.835607111111113,2136.139856,14.83450677726422,111,0.0011000000000000003
6,test_20231031_152228,10350842.png,212614,9802,202812,0.9538976737185698,3,6,42529,1435,41094,0.9662583178536999,16.635575111111113,1778.8767413333333,15.629345040787058,111,0.0011000000000000003
7,test_20231031_152228,10863862.png,317432,22052,295380,0.9305300032762922,3,5,66058,3069,62989,0.9535408277574253,20.888218666666667,2539.10744,14.08399282833132,111,0.0011000000000000003
8,test_20231031_152228,11382381.png,312486,1472,311014,0.9952893889646256,2,6,46745,199,46546,0.9957428601989518,19.922248888888888,2126.2597386666666,14.854640450929011,111,0.0011000000000000003
9,test_20231031_152228,11079715.png,443815,153642,290173,0.6538152157993758,9,7,124136,21222,102914,0.8290423406586325,14.860583111111112,1638.2000533333332,15.9871342513239,111,0.0011000000000000003
10,test_20231031_152228,11551286.png,271883,1472,270411,0.9945859064376956,2,6,40092,212,39880,0.9947121620273371,16.232181333333333,1556.92368,16.208130367822783,111,0.0011000000000000003
1,test_20231031_152229,10404007.png,502730,41394,461336,0.9176615678395958,4,6,61265,5900,55365,0.9036970537827471,24.200389333333334,3023.867333333333,13.325176274994408,111,0.0012000000000000003
2,test_20231031_152229,1254659.png,342646,101667,240979,0.7032885251834254,5,7,80080,13862,66218,0.8268981018981019,18.23960888888889,2453.5297173333333,14.232890383122463,111,0.0012000000000000003
3,test_20231031_152229,10188041.png,221231,12937,208294,0.9415226618331066,3,5,41731,1825,39906,0.9562675229445736,10.127864888888888,884.856672,18.662074309616564,111,0.0012000000000000003
4,test_20231031_152229,10287332.png,216980,15689,201291,0.927693796663287,3,6,22337,2138,20199,0.904284371222635,9.112368,692.278672,19.727994089695926,111,0.0012000000000000003
5,test_20231031_152229,11610969.png,368720,40752,327968,0.8894771100021697,6,6,84111,5906,78205,0.9297832625934777,17.835607111111113,2136.139856,14.83450677726422,111,0.0012000000000000003
6,test_20231031_152229,10350842.png,212614,9802,202812,0.9538976737185698,2,5,42529,1435,41094,0.9662583178536999,16.635575111111113,1778.8767413333333,15.629345040787058,111,0.0012000000000000003
7,test_20231031_152229,10863862.png,317432,22052,295380,0.9305300032762922,3,5,66058,3069,62989,0.9535408277574253,20.888218666666667,2539.10744,14.08399282833132,111,0.0012000000000000003
8,test_20231031_152229,11382381.png,312486,1472,311014,0.9952893889646256,3,5,46745,199,46546,0.9957428601989518,19.922248888888888,2126.2597386666666,14.854640450929011,111,0.0012000000000000003
9,test_20231031_152229,11079715.png,443815,153642,290173,0.6538152157993758,6,7,124136,21222,102914,0.8290423406586325,14.860583111111112,1638.2000533333332,15.9871342513239,111,0.0012000000000000003
10,test_20231031_152229,11551286.png,271883,1472,270411,0.9945859064376956,3,6,40092,212,39880,0.9947121620273371,16.232181333333333,1556.92368,16.208130367822783,111,0.0012000000000000003
1,test_20231031_152230,10404007.png,502730,41214,461516,0.9180196129134923,4,6,61265,5877,55388,0.9040724720476618,24.204300444444446,3024.850234666667,13.32376483984545,111,0.0013000000000000004
2,test_20231031_152230,1254659.png,342646,101667,240979,0.7032885251834254,5,7,80080,13862,66218,0.8268981018981019,18.23960888888889,2453.5297173333333,14.232890383122463,111,0.0013000000000000004
3,test_20231031_152230,10188041.png,221231,12817,208414,0.9420650812951169,3,6,41731,1812,39919,0.956579041959215,10.175448888888889,890.085536,18.636486171130876,111,0.0013000000000000004
4,test_20231031_152230,10287332.png,216980,15509,201471,0.9285233662088672,2,6,22337,2113,20224,0.9054035904552984,9.182336,703.874304,19.655852499546242,111,0.0013000000000000004
5,test_20231031_152230,11610969.png,368720,40672,328048,0.8896940768062487,4,6,84111,5894,78217,0.9299259312099488,17.87091022222222,2139.8143306666666,14.827042691379422,111,0.0013000000000000004
6,test_20231031_152230,10350842.png,212614,9662,202952,0.9545561439980434,3,6,42529,1414,41115,0.9667520985680359,17.178622222222224,1895.296016,15.354033111678111,111,0.0013000000000000004
7,test_20231031_152230,10863862.png,317432,22052,295380,0.9305300032762922,3,5,66058,3069,62989,0.9535408277574253,20.888218666666667,2539.10744,14.08399282833132,111,0.0013000000000000004
8,test_20231031_152230,11382381.png,312486,1472,311014,0.9952893889646256,2,5,46745,199,46546,0.9957428601989518,19.922248888888888,2126.2597386666666,14.854640450929011,111,0.0013000000000000004
9,test_20231031_152230,11079715.png,443815,153419,290396,0.6543176774106327,6,8,124136,21194,102942,0.8292678997228846,15.193525333333334,1694.1114666666667,15.841383788604533,111,0.0013000000000000004
10,test_20231031_152230,11551286.png,271883,1412,270471,0.9948065895992027,3,6,40092,203,39889,0.9949366457148558,16.43616,1592.6045973333332,16.109723958084437,111,0.0013000000000000004
1,test_20231031_152231,10404007.png,502730,41214,461516,0.9180196129134923,4,6,61265,5877,55388,0.9040724720476618,24.204300444444446,3024.850234666667,13.32376483984545,111,0.0014000000000000004
2,test_20231031_152231,1254659.png,342646,101667,240979,0.7032885251834254,5,6,80080,13862,66218,0.8268981018981019,18.23960888888889,2453.5297173333333,14.232890383122463,111,0.0014000000000000004
3,test_20231031_152231,10188041.png,221231,12817,208414,0.9420650812951169,3,5,41731,1812,39919,0.956579041959215,10.175448888888889,890.085536,18.636486171130876,111,0.0014000000000000004
4,test_20231031_152231,10287332.png,216980,15509,201471,0.9285233662088672,2,6,22337,2113,20224,0.9054035904552984,9.182336,703.874304,19.655852499546242,111,0.0014000000000000004
5,test_20231031_152231,11610969.png,368720,40672,328048,0.8896940768062487,4,6,84111,5894,78217,0.9299259312099488,17.87091022222222,2139.8143306666666,14.827042691379422,111,0.0014000000000000004
6,test_20231031_152231,10350842.png,212614,9662,202952,0.9545561439980434,3,5,42529,1414,41115,0.9667520985680359,17.178622222222224,1895.296016,15.354033111678111,111,0.0014000000000000004
7,test_20231031_152231,10863862.png,317432,22052,295380,0.9305300032762922,3,6,66058,3069,62989,0.9535408277574253,20.888218666666667,2539.10744,14.08399282833132,111,0.0014000000000000004
8,test_20231031_152231,11382381.png,312486,1472,311014,0.9952893889646256,3,6,46745,199,46546,0.9957428601989518,19.922248888888888,2126.2597386666666,14.854640450929011,111,0.0014000000000000004
9,test_20231031_152231,11079715.png,443815,153419,290396,0.6543176774106327,7,7,124136,21194,102942,0.8292678997228846,15.193525333333334,1694.1114666666667,15.841383788604533,111,0.0014000000000000004
10,test_20231031_152231,11551286.png,271883,1007,270876,0.9962962009393747,2,6,40092,146,39946,0.9963583757358077,16.677626666666665,1642.5195146666667,15.975698227811737,111,0.0014000000000000004
1,test_20231031_152232,10404007.png,502730,40562,462168,0.9193165317367176,4,6,61265,5781,55484,0.9056394352403493,24.198807111111112,3032.4103626666665,13.312923887817647,112,1.0E-4
2,test_20231031_152232,1254659.png,342646,100322,242324,0.707213859201625,5,6,80080,13688,66392,0.829070929070929,17.702723555555554,2370.512362666667,14.382381362798345,112,1.0E-4
3,test_20231031_152232,10188041.png,221231,13357,207874,0.9396241937160705,3,6,41731,1877,39854,0.955021446886008,9.619735111111112,819.4404426666666,18.99562966550357,112,1.0E-4
4,test_20231031_152232,10287332.png,216980,15639,201341,0.9279242326481704,3,6,22337,2128,20209,0.9047320589157004,8.884620444444444,655.7799306666667,19.96322239376424,112,1.0E-4
5,test_20231031_152232,11610969.png,368720,39927,328793,0.8917145801692341,4,6,84111,5787,78324,0.931198059706816,17.871916444444444,2153.556826666667,14.799240247357917,112,1.0E-4
6,test_20231031_152232,10350842.png,212614,9822,202792,0.9538036065357879,2,6,42529,1443,41086,0.9660702109149051,16.63639111111111,1781.0150933333334,15.624127609309976,112,1.0E-4
7,test_20231031_152232,10863862.png,317432,22312,295120,0.9297109302149752,3,6,66058,3109,62949,0.9529352992824488,20.32387911111111,2472.4010453333335,14.199614423279954,112,1.0E-4
8,test_20231031_152232,11382381.png,312486,2234,310252,0.9928508797194114,3,5,46745,309,46436,0.993389667344101,16.840869333333334,1653.1444533333333,15.947695565738101,112,1.0E-4
9,test_20231031_152232,11079715.png,443815,151127,292688,0.6594819913702781,5,7,124136,20873,103263,0.8318537732809177,14.988039111111112,1666.828928,15.911893317886015,112,1.0E-4
10,test_20231031_152232,11551286.png,271883,2224,269659,0.9918200108134749,3,6,40092,324,39768,0.9919185872493266,15.456133333333334,1432.7616906666667,16.56906400083397,112,1.0E-4
1,test_20231031_152233,10404007.png,502730,40562,462168,0.9193165317367176,3,6,61265,5781,55484,0.9056394352403493,24.198807111111112,3032.4103626666665,13.312923887817647,112,2.0E-4
2,test_20231031_152233,1254659.png,342646,100322,242324,0.707213859201625,5,6,80080,13688,66392,0.829070929070929,17.702723555555554,2370.512362666667,14.382381362798345,112,2.0E-4
3,test_20231031_152233,10188041.png,221231,13357,207874,0.9396241937160705,3,6,41731,1877,39854,0.955021446886008,9.619735111111112,819.4404426666666,18.99562966550357,112,2.0E-4
4,test_20231031_152233,10287332.png,216980,15387,201593,0.9290856300119826,3,6,22337,2098,20239,0.9060751219948964,9.01567111111111,682.8309813333333,19.78767143215982,112,2.0E-4
5,test_20231031_152233,11610969.png,368720,39927,328793,0.8917145801692341,4,6,84111,5787,78324,0.931198059706816,17.871916444444444,2153.556826666667,14.799240247357917,112,2.0E-4
6,test_20231031_152233,10350842.png,212614,9822,202792,0.9538036065357879,3,6,42529,1443,41086,0.9660702109149051,16.63639111111111,1781.0150933333334,15.624127609309976,112,2.0E-4
7,test_20231031_152233,10863862.png,317432,22312,295120,0.9297109302149752,3,5,66058,3109,62949,0.9529352992824488,20.32387911111111,2472.4010453333335,14.199614423279954,112,2.0E-4
8,test_20231031_152233,11382381.png,312486,2124,310362,0.993202895489718,2,5,46745,293,46452,0.9937319499411702,17.893105777777777,1792.830496,15.595411299402599,112,2.0E-4
9,test_20231031_152233,11079715.png,443815,151127,292688,0.6594819913702781,7,7,124136,20873,103263,0.8318537732809177,14.988039111111112,1666.828928,15.911893317886015,112,2.0E-4
10,test_20231031_152233,11551286.png,271883,2022,269861,0.992562977457215,3,6,40092,294,39798,0.9926668662077223,15.54591288888889,1439.5590826666667,16.548508668885816,112,2.0E-4
1,test_20231031_152234,10404007.png,502730,40562,462168,0.9193165317367176,4,6,61265,5781,55484,0.9056394352403493,24.198807111111112,3032.4103626666665,13.312923887817647,112,3.0000000000000003E-4
2,test_20231031_152234,1254659.png,342646,100242,242404,0.7074473363179492,5,7,80080,13681,66399,0.8291583416583417,17.71467022222222,2371.9302933333333,14.379784391038125,112,3.0000000000000003E-4
3,test_20231031_152234,10188041.png,221231,13217,208014,0.9402570164217492,3,6,41731,1858,39873,0.955476743907407,9.774572444444445,840.654256,18.884629448380224,112,3.0000000000000003E-4
4,test_20231031_152234,10287332.png,216980,15347,201633,0.9292699787998894,2,5,22337,2092,20245,0.9063437346107356,9.117008,700.888016,19.67431726522211,112,3.0000000000000003E-4
5,test_20231031_152234,11610969.png,368720,39927,328793,0.8917145801692341,4,6,84111,5787,78324,0.931198059706816,17.871916444444444,2153.556826666667,14.799240247357917,112,3.0000000000000003E-4
6,test_20231031_152234,10350842.png,212614,9822,202792,0.9538036065357879,2,6,42529,1443,41086,0.9660702109149051,16.63639111111111,1781.0150933333334,15.624127609309976,112,3.0000000000000003E-4
7,test_20231031_152234,10863862.png,317432,21829,295603,0.9312325159404219,3,6,66058,3040,63018,0.9539798359017833,20.840426666666666,2538.97888,14.084212725730012,112,3.0000000000000003E-4
8,test_20231031_152234,11382381.png,312486,2124,310362,0.993202895489718,2,6,46745,293,46452,0.9937319499411702,17.893105777777777,1792.830496,15.595411299402599,112,3.0000000000000003E-4
9,test_20231031_152234,11079715.png,443815,151127,292688,0.6594819913702781,6,7,124136,20873,103263,0.8318537732809177,14.988039111111112,1666.828928,15.911893317886015,112,3.0000000000000003E-4
10,test_20231031_152234,11551286.png,271883,2022,269861,0.992562977457215,2,5,40092,294,39798,0.9926668662077223,15.54591288888889,1439.5590826666667,16.548508668885816,112,3.0000000000000003E-4
1,test_20231031_152236,10404007.png,502730,40562,462168,0.9193165317367176,5,6,61265,5781,55484,0.9056394352403493,24.198807111111112,3032.4103626666665,13.312923887817647,112,4.0E-4
2,test_20231031_152236,1254659.png,342646,100242,242404,0.7074473363179492,6,6,80080,13681,66399,0.8291583416583417,17.71467022222222,2371.9302933333333,14.379784391038125,112,4.0E-4
3,test_20231031_152236,10188041.png,221231,13217,208014,0.9402570164217492,3,6,41731,1858,39873,0.955476743907407,9.774572444444445,840.654256,18.884629448380224,112,4.0E-4
4,test_20231031_152236,10287332.png,216980,15347,201633,0.9292699787998894,3,5,22337,2092,20245,0.9063437346107356,9.117008,700.888016,19.67431726522211,112,4.0E-4
5,test_20231031_152236,11610969.png,368720,39927,328793,0.8917145801692341,4,6,84111,5787,78324,0.931198059706816,17.871916444444444,2153.556826666667,14.799240247357917,112,4.0E-4
6,test_20231031_152236,10350842.png,212614,9822,202792,0.9538036065357879,3,5,42529,1443,41086,0.9660702109149051,16.63639111111111,1781.0150933333334,15.624127609309976,112,4.0E-4
7,test_20231031_152236,10863862.png,317432,21829,295603,0.9312325159404219,5,6,66058,3040,63018,0.9539798359017833,20.840426666666666,2538.97888,14.084212725730012,112,4.0E-4
8,test_20231031_152236,11382381.png,312486,1612,310874,0.9948413688933264,3,6,46745,219,46526,0.9953150069526152,19.040750222222222,1976.613024,15.171587082419844,112,4.0E-4
9,test_20231031_152236,11079715.png,443815,151127,292688,0.6594819913702781,6,8,124136,20873,103263,0.8318537732809177,14.988039111111112,1666.828928,15.911893317886015,112,4.0E-4
10,test_20231031_152236,11551286.png,271883,2022,269861,0.992562977457215,3,7,40092,294,39798,0.9926668662077223,15.54591288888889,1439.5590826666667,16.548508668885816,112,4.0E-4
1,test_20231031_152237,10404007.png,502730,40562,462168,0.9193165317367176,4,6,61265,5781,55484,0.9056394352403493,24.198807111111112,3032.4103626666665,13.312923887817647,112,5.0E-4
2,test_20231031_152237,1254659.png,342646,100242,242404,0.7074473363179492,5,7,80080,13681,66399,0.8291583416583417,17.71467022222222,2371.9302933333333,14.379784391038125,112,5.0E-4
3,test_20231031_152237,10188041.png,221231,13217,208014,0.9402570164217492,3,6,41731,1858,39873,0.955476743907407,9.774572444444445,840.654256,18.884629448380224,112,5.0E-4
4,test_20231031_152237,10287332.png,216980,15347,201633,0.9292699787998894,3,6,22337,2092,20245,0.9063437346107356,9.117008,700.888016,19.67431726522211,112,5.0E-4
5,test_20231031_152237,11610969.png,368720,39927,328793,0.8917145801692341,4,6,84111,5787,78324,0.931198059706816,17.871916444444444,2153.556826666667,14.799240247357917,112,5.0E-4
6,test_20231031_152237,10350842.png,212614,9822,202792,0.9538036065357879,3,6,42529,1443,41086,0.9660702109149051,16.63639111111111,1781.0150933333334,15.624127609309976,112,5.0E-4
7,test_20231031_152237,10863862.png,317432,21829,295603,0.9312325159404219,3,6,66058,3040,63018,0.9539798359017833,20.840426666666666,2538.97888,14.084212725730012,112,5.0E-4
8,test_20231031_152237,11382381.png,312486,1612,310874,0.9948413688933264,2,6,46745,219,46526,0.9953150069526152,19.040750222222222,1976.613024,15.171587082419844,112,5.0E-4
9,test_20231031_152237,11079715.png,443815,151127,292688,0.6594819913702781,6,15,124136,20873,103263,0.8318537732809177,14.988039111111112,1666.828928,15.911893317886015,112,5.0E-4
10,test_20231031_152237,11551286.png,271883,1652,270231,0.9939238569531748,2,6,40092,239,39853,0.994038710964781,15.832826666666667,1484.6633013333333,16.414523873174964,112,5.0E-4
1,test_20231031_152238,10404007.png,502730,40482,462248,0.9194756628806715,5,6,61265,5769,55496,0.9058353056394353,24.232588444444445,3038.3046026666666,13.304490493312972,112,6.000000000000001E-4
2,test_20231031_152238,1254659.png,342646,100182,242464,0.7076224441551923,14,6,80080,13675,66405,0.8292332667332667,17.737564444444445,2373.9099413333333,14.376161217016818,112,6.000000000000001E-4
3,test_20231031_152238,10188041.png,221231,13217,208014,0.9402570164217492,3,6,41731,1858,39873,0.955476743907407,9.774572444444445,840.654256,18.884629448380224,112,6.000000000000001E-4
4,test_20231031_152238,10287332.png,216980,15267,201713,0.9296386763757029,4,6,22337,2080,20257,0.9068809598424139,9.177925333333333,708.1452746666666,19.629579993447372,112,6.000000000000001E-4
5,test_20231031_152238,11610969.png,368720,39927,328793,0.8917145801692341,4,6,84111,5787,78324,0.931198059706816,17.871916444444444,2153.556826666667,14.799240247357917,112,6.000000000000001E-4
6,test_20231031_152238,10350842.png,212614,9822,202792,0.9538036065357879,2,5,42529,1443,41086,0.9660702109149051,16.63639111111111,1781.0150933333334,15.624127609309976,112,6.000000000000001E-4
7,test_20231031_152238,10863862.png,317432,21729,295703,0.9315475440409284,3,5,66058,3028,63030,0.9541614944442762,20.850848,2540.6141866666667,14.081416420290706,112,6.000000000000001E-4
8,test_20231031_152238,11382381.png,312486,1472,311014,0.9952893889646256,2,5,46745,198,46547,0.9957642528612686,19.881477333333333,2121.993936,14.86336222379639,112,6.000000000000001E-4
9,test_20231031_152238,11079715.png,443815,151127,292688,0.6594819913702781,6,16,124136,20873,103263,0.8318537732809177,14.988039111111112,1666.828928,15.911893317886015,112,6.000000000000001E-4
10,test_20231031_152238,11551286.png,271883,1592,270291,0.9941445401146817,3,6,40092,230,39862,0.9942631946522997,15.987875555555556,1518.3013333333333,16.31722387453005,112,6.000000000000001E-4
1,test_20231031_152239,10404007.png,502730,40482,462248,0.9194756628806715,4,5,61265,5769,55496,0.9058353056394353,24.232588444444445,3038.3046026666666,13.304490493312972,112,7.000000000000001E-4
2,test_20231031_152239,1254659.png,342646,100182,242464,0.7076224441551923,5,7,80080,13675,66405,0.8292332667332667,17.737564444444445,2373.9099413333333,14.376161217016818,112,7.000000000000001E-4
3,test_20231031_152239,10188041.png,221231,13217,208014,0.9402570164217492,4,6,41731,1858,39873,0.955476743907407,9.774572444444445,840.654256,18.884629448380224,112,7.000000000000001E-4
4,test_20231031_152239,10287332.png,216980,15267,201713,0.9296386763757029,2,5,22337,2080,20257,0.9068809598424139,9.177925333333333,708.1452746666666,19.629579993447372,112,7.000000000000001E-4
5,test_20231031_152239,11610969.png,368720,39927,328793,0.8917145801692341,4,6,84111,5787,78324,0.931198059706816,17.871916444444444,2153.556826666667,14.799240247357917,112,7.000000000000001E-4
6,test_20231031_152239,10350842.png,212614,9822,202792,0.9538036065357879,2,5,42529,1443,41086,0.9660702109149051,16.63639111111111,1781.0150933333334,15.624127609309976,112,7.000000000000001E-4
7,test_20231031_152239,10863862.png,317432,21729,295703,0.9315475440409284,3,5,66058,3028,63030,0.9541614944442762,20.850848,2540.6141866666667,14.081416420290706,112,7.000000000000001E-4
8,test_20231031_152239,11382381.png,312486,1472,311014,0.9952893889646256,2,6,46745,198,46547,0.9957642528612686,19.881477333333333,2121.993936,14.86336222379639,112,7.000000000000001E-4
9,test_20231031_152239,11079715.png,443815,151127,292688,0.6594819913702781,6,7,124136,20873,103263,0.8318537732809177,14.988039111111112,1666.828928,15.911893317886015,112,7.000000000000001E-4
10,test_20231031_152239,11551286.png,271883,1592,270291,0.9941445401146817,2,5,40092,230,39862,0.9942631946522997,15.987875555555556,1518.3013333333333,16.31722387453005,112,7.000000000000001E-4
1,test_20231031_152240,10404007.png,502730,40259,462471,0.9199192409444433,4,6,61265,5739,55526,0.9063249816371501,24.245987555555555,3040.601344,13.301208777347501,112,8.000000000000001E-4
2,test_20231031_152240,1254659.png,342646,100122,242524,0.7077975519924353,5,6,80080,13666,66414,0.8293456543456543,18.05044977777778,2423.491584,14.28638844970348,112,8.000000000000001E-4
3,test_20231031_152240,10188041.png,221231,13097,208134,0.9407994358837595,3,6,41731,1843,39888,0.9558361889243009,9.90008,856.637488,18.80283284882432,112,8.000000000000001E-4
4,test_20231031_152240,10287332.png,216980,15267,201713,0.9296386763757029,3,6,22337,2080,20257,0.9068809598424139,9.177925333333333,708.1452746666666,19.629579993447372,112,8.000000000000001E-4
5,test_20231031_152240,11610969.png,368720,39927,328793,0.8917145801692341,4,6,84111,5787,78324,0.931198059706816,17.871916444444444,2153.556826666667,14.799240247357917,112,8.000000000000001E-4
6,test_20231031_152240,10350842.png,212614,9822,202792,0.9538036065357879,3,6,42529,1443,41086,0.9660702109149051,16.63639111111111,1781.0150933333334,15.624127609309976,112,8.000000000000001E-4
7,test_20231031_152240,10863862.png,317432,21729,295703,0.9315475440409284,3,6,66058,3028,63030,0.9541614944442762,20.850848,2540.6141866666667,14.081416420290706,112,8.000000000000001E-4
8,test_20231031_152240,11382381.png,312486,1472,311014,0.9952893889646256,2,5,46745,198,46547,0.9957642528612686,19.881477333333333,2121.993936,14.86336222379639,112,8.000000000000001E-4
9,test_20231031_152240,11079715.png,443815,150927,292888,0.6599326295866521,6,7,124136,20848,103288,0.8320551653025714,15.302609777777779,1719.655104,15.776390078262308,112,8.000000000000001E-4
10,test_20231031_152240,11551286.png,271883,1452,270431,0.9946594674915313,3,6,40092,209,39883,0.9947869899231767,16.17663288888889,1545.593824,16.239849871795663,112,8.000000000000001E-4
1,test_20231031_152241,10404007.png,502730,40259,462471,0.9199192409444433,4,6,61265,5739,55526,0.9063249816371501,24.245987555555555,3040.601344,13.301208777347501,112,9.000000000000002E-4
2,test_20231031_152241,1254659.png,342646,100122,242524,0.7077975519924353,5,6,80080,13666,66414,0.8293456543456543,18.05044977777778,2423.491584,14.28638844970348,112,9.000000000000002E-4
3,test_20231031_152241,10188041.png,221231,13097,208134,0.9407994358837595,3,5,41731,1843,39888,0.9558361889243009,9.90008,856.637488,18.80283284882432,112,9.000000000000002E-4
4,test_20231031_152241,10287332.png,216980,15267,201713,0.9296386763757029,2,5,22337,2080,20257,0.9068809598424139,9.177925333333333,708.1452746666666,19.629579993447372,112,9.000000000000002E-4
5,test_20231031_152241,11610969.png,368720,39927,328793,0.8917145801692341,4,6,84111,5787,78324,0.931198059706816,17.871916444444444,2153.556826666667,14.799240247357917,112,9.000000000000002E-4
6,test_20231031_152241,10350842.png,212614,9822,202792,0.9538036065357879,3,6,42529,1443,41086,0.9660702109149051,16.63639111111111,1781.0150933333334,15.624127609309976,112,9.000000000000002E-4
7,test_20231031_152241,10863862.png,317432,21729,295703,0.9315475440409284,4,6,66058,3028,63030,0.9541614944442762,20.850848,2540.6141866666667,14.081416420290706,112,9.000000000000002E-4
8,test_20231031_152241,11382381.png,312486,1472,311014,0.9952893889646256,3,6,46745,198,46547,0.9957642528612686,19.881477333333333,2121.993936,14.86336222379639,112,9.000000000000002E-4
9,test_20231031_152241,11079715.png,443815,150927,292888,0.6599326295866521,6,7,124136,20848,103288,0.8320551653025714,15.302609777777779,1719.655104,15.776390078262308,112,9.000000000000002E-4
10,test_20231031_152241,11551286.png,271883,1452,270431,0.9946594674915313,2,5,40092,209,39883,0.9947869899231767,16.17663288888889,1545.593824,16.239849871795663,112,9.000000000000002E-4
1,test_20231031_152242,10404007.png,502730,39194,463536,0.9220376742983312,4,6,61265,5605,55660,0.9085122010936098,24.323216,3056.6435893333332,13.278355587822269,112,0.0010000000000000002
2,test_20231031_152242,1254659.png,342646,99657,242989,0.7091546377310693,5,6,80080,13619,66461,0.8299325674325675,18.39381688888889,2497.263008,14.156160768633821,112,0.0010000000000000002
3,test_20231031_152242,10188041.png,221231,12917,208314,0.941613065076775,3,6,41731,1820,39911,0.9563873379502049,10.004748444444445,874.807888,18.711676705221684,112,0.0010000000000000002
4,test_20231031_152242,10287332.png,216980,15207,201773,0.929915199557563,3,7,22337,2071,20266,0.9072838787661728,9.180673777777777,709.5857013333333,19.620755053049475,112,0.0010000000000000002
5,test_20231031_152242,11610969.png,368720,39547,329173,0.8927451724886093,5,7,84111,5739,78372,0.9317687341727003,17.951998222222223,2163.9034613333333,14.778424792695342,112,0.0010000000000000002
6,test_20231031_152242,10350842.png,212614,9542,203072,0.955120547094735,2,5,42529,1401,41128,0.9670577723435774,16.675712,1788.9463466666666,15.604830452843391,112,0.0010000000000000002
7,test_20231031_152242,10863862.png,317432,20967,296465,0.9339480581667885,3,6,66058,2934,63124,0.9555844863604711,21.15429688888889,2609.8735786666666,13.964608900879465,112,0.0010000000000000002
8,test_20231031_152242,11382381.png,312486,1452,311034,0.995353391831954,2,5,46745,196,46549,0.9958070381859022,19.922476444444445,2126.305264,14.854547465161401,112,0.0010000000000000002
9,test_20231031_152242,11079715.png,443815,150807,293008,0.6602030125164764,6,7,124136,20835,103301,0.8321598891538313,15.323121777777779,1722.38976,15.769489260245617,112,0.0010000000000000002
10,test_20231031_152242,11551286.png,271883,1392,270491,0.9948801506530383,2,6,40092,200,39892,0.9950114736106954,16.23908266666667,1558.3767146666667,16.204079105321174,112,0.0010000000000000002
1,test_20231031_152243,10404007.png,502730,39194,463536,0.9220376742983312,4,6,61265,5605,55660,0.9085122010936098,24.323216,3056.6435893333332,13.278355587822269,112,0.0011000000000000003
2,test_20231031_152243,1254659.png,342646,99657,242989,0.7091546377310693,6,6,80080,13619,66461,0.8299325674325675,18.39381688888889,2497.263008,14.156160768633821,112,0.0011000000000000003
3,test_20231031_152243,10188041.png,221231,12817,208414,0.9420650812951169,3,6,41731,1807,39924,0.9566988569648462,10.132392888888889,885.9562933333333,18.656680633966097,112,0.0011000000000000003
4,test_20231031_152243,10287332.png,216980,15207,201773,0.929915199557563,3,6,22337,2071,20266,0.9072838787661728,9.180673777777777,709.5857013333333,19.620755053049475,112,0.0011000000000000003
5,test_20231031_152243,11610969.png,368720,39547,329173,0.8927451724886093,3,6,84111,5739,78372,0.9317687341727003,17.951998222222223,2163.9034613333333,14.778424792695342,112,0.0011000000000000003
6,test_20231031_152243,10350842.png,212614,8997,203617,0.957683877825543,2,6,42529,1321,41208,0.9689388417315243,18.14122311111111,2118.729312,14.870048859003901,112,0.0011000000000000003
7,test_20231031_152243,10863862.png,317432,20967,296465,0.9339480581667885,3,6,66058,2934,63124,0.9555844863604711,21.15429688888889,2609.8735786666666,13.964608900879465,112,0.0011000000000000003
8,test_20231031_152243,11382381.png,312486,1452,311034,0.995353391831954,2,5,46745,196,46549,0.9958070381859022,19.922476444444445,2126.305264,14.854547465161401,112,0.0011000000000000003
9,test_20231031_152243,11079715.png,443815,150807,293008,0.6602030125164764,5,7,124136,20835,103301,0.8321598891538313,15.323121777777779,1722.38976,15.769489260245617,112,0.0011000000000000003
10,test_20231031_152243,11551286.png,271883,1392,270491,0.9948801506530383,2,6,40092,200,39892,0.9950114736106954,16.23908266666667,1558.3767146666667,16.204079105321174,112,0.0011000000000000003
1,test_20231031_152244,10404007.png,502730,39194,463536,0.9220376742983312,4,6,61265,5605,55660,0.9085122010936098,24.323216,3056.6435893333332,13.278355587822269,112,0.0012000000000000003
2,test_20231031_152244,1254659.png,342646,99657,242989,0.7091546377310693,5,7,80080,13619,66461,0.8299325674325675,18.39381688888889,2497.263008,14.156160768633821,112,0.0012000000000000003
3,test_20231031_152244,10188041.png,221231,12817,208414,0.9420650812951169,3,6,41731,1807,39924,0.9566988569648462,10.132392888888889,885.9562933333333,18.656680633966097,112,0.0012000000000000003
4,test_20231031_152244,10287332.png,216980,15207,201773,0.929915199557563,3,6,22337,2071,20266,0.9072838787661728,9.180673777777777,709.5857013333333,19.620755053049475,112,0.0012000000000000003
5,test_20231031_152244,11610969.png,368720,39547,329173,0.8927451724886093,4,6,84111,5739,78372,0.9317687341727003,17.951998222222223,2163.9034613333333,14.778424792695342,112,0.0012000000000000003
6,test_20231031_152244,10350842.png,212614,8997,203617,0.957683877825543,3,6,42529,1321,41208,0.9689388417315243,18.14122311111111,2118.729312,14.870048859003901,112,0.0012000000000000003
7,test_20231031_152244,10863862.png,317432,20967,296465,0.9339480581667885,3,6,66058,2934,63124,0.9555844863604711,21.15429688888889,2609.8735786666666,13.964608900879465,112,0.0012000000000000003
8,test_20231031_152244,11382381.png,312486,1452,311034,0.995353391831954,3,6,46745,196,46549,0.9958070381859022,19.922476444444445,2126.305264,14.854547465161401,112,0.0012000000000000003
9,test_20231031_152244,11079715.png,443815,150807,293008,0.6602030125164764,8,7,124136,20835,103301,0.8321598891538313,15.323121777777779,1722.38976,15.769489260245617,112,0.0012000000000000003
10,test_20231031_152244,11551286.png,271883,1392,270491,0.9948801506530383,2,5,40092,200,39892,0.9950114736106954,16.23908266666667,1558.3767146666667,16.204079105321174,112,0.0012000000000000003
1,test_20231031_152245,10404007.png,502730,39092,463638,0.9222405665068725,4,6,61265,5593,55672,0.9087080714926956,24.32588977777778,3057.125072,13.27767154078915,112,0.0013000000000000004
2,test_20231031_152245,1254659.png,342646,99657,242989,0.7091546377310693,5,7,80080,13619,66461,0.8299325674325675,18.39381688888889,2497.263008,14.156160768633821,112,0.0013000000000000004
3,test_20231031_152245,10188041.png,221231,12637,208594,0.9428787104881323,3,5,41731,1785,39946,0.957226042989624,10.300368,914.827536,18.51741132619169,112,0.0013000000000000004
4,test_20231031_152245,10287332.png,216980,15047,201933,0.9306525947091898,3,6,22337,2049,20288,0.9082687916909165,9.248695111111111,720.6361333333333,19.55364326625831,112,0.0013000000000000004
5,test_20231031_152245,11610969.png,368720,39487,329233,0.8929078975916684,4,5,84111,5730,78381,0.9318757356350537,17.98695288888889,2167.467354666667,14.771277958015055,112,0.0013000000000000004
6,test_20231031_152245,10350842.png,212614,8997,203617,0.957683877825543,2,5,42529,1321,41208,0.9689388417315243,18.14122311111111,2118.729312,14.870048859003901,112,0.0013000000000000004
7,test_20231031_152245,10863862.png,317432,20867,296565,0.934263086267295,3,5,66058,2919,63139,0.9558115595385873,21.526670222222222,2658.234432,13.884870817651917,112,0.0013000000000000004
8,test_20231031_152245,11382381.png,312486,1392,311094,0.9955454004339395,3,5,46745,187,46558,0.9959995721467536,20.249420444444443,2192.719984,14.72097186175445,112,0.0013000000000000004
9,test_20231031_152245,11079715.png,443815,150807,293008,0.6602030125164764,6,7,124136,20835,103301,0.8321598891538313,15.323121777777779,1722.38976,15.769489260245617,112,0.0013000000000000004
10,test_20231031_152245,11551286.png,271883,1007,270876,0.9962962009393747,2,6,40092,146,39946,0.9963583757358077,16.677626666666665,1642.5195146666667,15.975698227811737,112,0.0013000000000000004
1,test_20231031_152246,10404007.png,502730,39092,463638,0.9222405665068725,5,6,61265,5593,55672,0.9087080714926956,24.32588977777778,3057.125072,13.27767154078915,112,0.0014000000000000004
2,test_20231031_152246,1254659.png,342646,99657,242989,0.7091546377310693,6,6,80080,13619,66461,0.8299325674325675,18.39381688888889,2497.263008,14.156160768633821,112,0.0014000000000000004
3,test_20231031_152246,10188041.png,221231,12637,208594,0.9428787104881323,3,6,41731,1785,39946,0.957226042989624,10.300368,914.827536,18.51741132619169,112,0.0014000000000000004
4,test_20231031_152246,10287332.png,216980,15047,201933,0.9306525947091898,3,6,22337,2049,20288,0.9082687916909165,9.248695111111111,720.6361333333333,19.55364326625831,112,0.0014000000000000004
5,test_20231031_152246,11610969.png,368720,39487,329233,0.8929078975916684,4,6,84111,5730,78381,0.9318757356350537,17.98695288888889,2167.467354666667,14.771277958015055,112,0.0014000000000000004
6,test_20231031_152246,10350842.png,212614,8997,203617,0.957683877825543,2,6,42529,1321,41208,0.9689388417315243,18.14122311111111,2118.729312,14.870048859003901,112,0.0014000000000000004
7,test_20231031_152246,10863862.png,317432,20867,296565,0.934263086267295,4,6,66058,2919,63139,0.9558115595385873,21.526670222222222,2658.234432,13.884870817651917,112,0.0014000000000000004
8,test_20231031_152246,11382381.png,312486,1392,311094,0.9955454004339395,2,5,46745,187,46558,0.9959995721467536,20.249420444444443,2192.719984,14.72097186175445,112,0.0014000000000000004
9,test_20231031_152246,11079715.png,443815,150807,293008,0.6602030125164764,5,7,124136,20835,103301,0.8321598891538313,15.323121777777779,1722.38976,15.769489260245617,112,0.0014000000000000004
10,test_20231031_152246,11551286.png,271883,807,271076,0.9970318114777312,2,6,40092,118,39974,0.9970567694303103,17.237834666666668,1739.1554773333332,15.72741951993649,112,0.0014000000000000004
1,test_20231031_152247,10404007.png,502730,38309,464421,0.9237980625783224,3,6,61265,5477,55788,0.9106014853505264,24.299555555555557,3059.95504,13.273653154397136,113,1.0E-4
2,test_20231031_152247,1254659.png,342646,97949,244697,0.7141393741645896,18,7,80080,13389,66691,0.8328046953046953,17.939141333333332,2430.0163893333333,14.274711581448962,113,1.0E-4
3,test_20231031_152247,10188041.png,221231,13097,208134,0.9407994358837595,3,6,41731,1839,39892,0.9559320409288059,9.643754666666666,825.0689813333333,18.9659010085128,113,1.0E-4
4,test_20231031_152247,10287332.png,216980,15437,201543,0.9288551940270993,3,6,22337,2101,20236,0.9059408156869768,8.90352888888889,660.6031946666667,19.93139691266148,113,1.0E-4
5,test_20231031_152247,11610969.png,368720,38862,329858,0.8946029507485355,3,6,84111,5636,78475,0.9329933064640772,17.97388266666667,2180.6100426666667,14.74502352996726,113,1.0E-4
6,test_20231031_152247,10350842.png,212614,9562,203052,0.9550264799119531,3,6,42529,1405,41124,0.96696371887418,16.672387555555556,1788.2648106666666,15.60648530247111,113,1.0E-4
7,test_20231031_152247,10863862.png,317432,21557,295875,0.9320893923737997,3,6,66058,3017,63041,0.9543280147748948,20.426,2499.7040053333335,14.151917747802575,113,1.0E-4
8,test_20231031_152247,11382381.png,312486,2094,310392,0.9932988997907106,3,6,46745,288,46457,0.9938389132527543,16.922416,1674.8856053333334,15.890952107900066,113,1.0E-4
9,test_20231031_152247,11079715.png,443815,148394,295421,0.6656399625970281,5,7,124136,20523,103613,0.8346732615840691,15.116928,1694.7479573333333,15.839752417379106,113,1.0E-4
10,test_20231031_152247,11551286.png,271883,2002,269881,0.9926365385110507,3,6,40092,291,39801,0.9927416941035618,15.464648888888888,1434.9022773333334,16.56258036006986,113,1.0E-4
1,test_20231031_152248,10404007.png,502730,38309,464421,0.9237980625783224,4,5,61265,5477,55788,0.9106014853505264,24.299555555555557,3059.95504,13.273653154397136,113,2.0E-4
2,test_20231031_152248,1254659.png,342646,97949,244697,0.7141393741645896,4,6,80080,13389,66691,0.8328046953046953,17.939141333333332,2430.0163893333333,14.274711581448962,113,2.0E-4
3,test_20231031_152248,10188041.png,221231,13097,208134,0.9407994358837595,6,6,41731,1839,39892,0.9559320409288059,9.643754666666666,825.0689813333333,18.9659010085128,113,2.0E-4
4,test_20231031_152248,10287332.png,216980,15187,201793,0.9300073739515162,3,5,22337,2071,20266,0.9072838787661728,9.034579555555556,687.6542453333333,19.757102323530237,113,2.0E-4
5,test_20231031_152248,11610969.png,368720,38862,329858,0.8946029507485355,4,6,84111,5636,78475,0.9329933064640772,17.97388266666667,2180.6100426666667,14.74502352996726,113,2.0E-4
6,test_20231031_152248,10350842.png,212614,9562,203052,0.9550264799119531,3,6,42529,1405,41124,0.96696371887418,16.672387555555556,1788.2648106666666,15.60648530247111,113,2.0E-4
7,test_20231031_152248,10863862.png,317432,21557,295875,0.9320893923737997,3,6,66058,3017,63041,0.9543280147748948,20.426,2499.7040053333335,14.151917747802575,113,2.0E-4
8,test_20231031_152248,11382381.png,312486,1982,310504,0.99365731584775,3,5,46745,272,46473,0.9941811958498236,17.974652444444445,1814.571648,15.543062399616902,113,2.0E-4
9,test_20231031_152248,11079715.png,443815,148394,295421,0.6656399625970281,6,7,124136,20523,103613,0.8346732615840691,15.116928,1694.7479573333333,15.839752417379106,113,2.0E-4
10,test_20231031_152248,11551286.png,271883,1822,270061,0.9932985879955716,2,6,40092,264,39828,0.993415145166118,15.554140444444444,1441.559232,16.54247869119572,113,2.0E-4
1,test_20231031_152249,10404007.png,502730,38309,464421,0.9237980625783224,4,5,61265,5477,55788,0.9106014853505264,24.299555555555557,3059.95504,13.273653154397136,113,3.0000000000000003E-4
2,test_20231031_152249,1254659.png,342646,97869,244777,0.7143728512809138,5,6,80080,13382,66698,0.8328921078921079,17.951088,2431.43432,14.272178183422177,113,3.0000000000000003E-4
3,test_20231031_152249,10188041.png,221231,12977,208254,0.9413418553457698,3,6,41731,1822,39909,0.9563394119479524,9.79904,846.0947946666666,18.856613376701063,113,3.0000000000000003E-4
4,test_20231031_152249,10287332.png,216980,15147,201833,0.930191722739423,2,5,22337,2065,20272,0.9075524913820119,9.135916444444444,705.71128,19.64453301670131,113,3.0000000000000003E-4
5,test_20231031_152249,11610969.png,368720,38862,329858,0.8946029507485355,4,6,84111,5636,78475,0.9329933064640772,17.97388266666667,2180.6100426666667,14.74502352996726,113,3.0000000000000003E-4
6,test_20231031_152249,10350842.png,212614,9562,203052,0.9550264799119531,3,6,42529,1405,41124,0.96696371887418,16.672387555555556,1788.2648106666666,15.60648530247111,113,3.0000000000000003E-4
7,test_20231031_152249,10863862.png,317432,21077,296355,0.9336015272562312,4,6,66058,2948,63110,0.9553725513942293,20.942547555555556,2566.28184,14.037760101403007,113,3.0000000000000003E-4
8,test_20231031_152249,11382381.png,312486,1982,310504,0.99365731584775,3,6,46745,272,46473,0.9941811958498236,17.974652444444445,1814.571648,15.543062399616902,113,3.0000000000000003E-4
9,test_20231031_152249,11079715.png,443815,148394,295421,0.6656399625970281,6,7,124136,20523,103613,0.8346732615840691,15.116928,1694.7479573333333,15.839752417379106,113,3.0000000000000003E-4
10,test_20231031_152249,11551286.png,271883,1822,270061,0.9932985879955716,3,5,40092,264,39828,0.993415145166118,15.554140444444444,1441.559232,16.54247869119572,113,3.0000000000000003E-4
1,test_20231031_152250,10404007.png,502730,38309,464421,0.9237980625783224,4,6,61265,5477,55788,0.9106014853505264,24.299555555555557,3059.95504,13.273653154397136,113,4.0E-4
2,test_20231031_152250,1254659.png,342646,97869,244777,0.7143728512809138,5,6,80080,13382,66698,0.8328921078921079,17.951088,2431.43432,14.272178183422177,113,4.0E-4
3,test_20231031_152250,10188041.png,221231,12977,208254,0.9413418553457698,3,5,41731,1822,39909,0.9563394119479524,9.79904,846.0947946666666,18.856613376701063,113,4.0E-4
4,test_20231031_152250,10287332.png,216980,15147,201833,0.930191722739423,3,6,22337,2065,20272,0.9075524913820119,9.135916444444444,705.71128,19.64453301670131,113,4.0E-4
5,test_20231031_152250,11610969.png,368720,38862,329858,0.8946029507485355,4,6,84111,5636,78475,0.9329933064640772,17.97388266666667,2180.6100426666667,14.74502352996726,113,4.0E-4
6,test_20231031_152250,10350842.png,212614,9562,203052,0.9550264799119531,3,6,42529,1405,41124,0.96696371887418,16.672387555555556,1788.2648106666666,15.60648530247111,113,4.0E-4
7,test_20231031_152250,10863862.png,317432,21077,296355,0.9336015272562312,3,5,66058,2948,63110,0.9553725513942293,20.942547555555556,2566.28184,14.037760101403007,113,4.0E-4
8,test_20231031_152250,11382381.png,312486,1472,311014,0.9952893889646256,2,6,46745,198,46547,0.9957642528612686,19.12229688888889,1998.354176,15.124078984740148,113,4.0E-4
9,test_20231031_152250,11079715.png,443815,148394,295421,0.6656399625970281,5,7,124136,20523,103613,0.8346732615840691,15.116928,1694.7479573333333,15.839752417379106,113,4.0E-4
10,test_20231031_152250,11551286.png,271883,1822,270061,0.9932985879955716,2,5,40092,264,39828,0.993415145166118,15.554140444444444,1441.559232,16.54247869119572,113,4.0E-4
1,test_20231031_152251,10404007.png,502730,38309,464421,0.9237980625783224,4,7,61265,5477,55788,0.9106014853505264,24.299555555555557,3059.95504,13.273653154397136,113,5.0E-4
2,test_20231031_152251,1254659.png,342646,97869,244777,0.7143728512809138,5,7,80080,13382,66698,0.8328921078921079,17.951088,2431.43432,14.272178183422177,113,5.0E-4
3,test_20231031_152251,10188041.png,221231,12977,208254,0.9413418553457698,4,6,41731,1822,39909,0.9563394119479524,9.79904,846.0947946666666,18.856613376701063,113,5.0E-4
4,test_20231031_152251,10287332.png,216980,15147,201833,0.930191722739423,2,6,22337,2065,20272,0.9075524913820119,9.135916444444444,705.71128,19.64453301670131,113,5.0E-4
5,test_20231031_152251,11610969.png,368720,38862,329858,0.8946029507485355,4,6,84111,5636,78475,0.9329933064640772,17.97388266666667,2180.6100426666667,14.74502352996726,113,5.0E-4
6,test_20231031_152251,10350842.png,212614,9562,203052,0.9550264799119531,2,5,42529,1405,41124,0.96696371887418,16.672387555555556,1788.2648106666666,15.60648530247111,113,5.0E-4
7,test_20231031_152251,10863862.png,317432,21077,296355,0.9336015272562312,3,10,66058,2948,63110,0.9553725513942293,20.942547555555556,2566.28184,14.037760101403007,113,5.0E-4
8,test_20231031_152251,11382381.png,312486,1472,311014,0.9952893889646256,2,5,46745,198,46547,0.9957642528612686,19.12229688888889,1998.354176,15.124078984740148,113,5.0E-4
9,test_20231031_152251,11079715.png,443815,148394,295421,0.6656399625970281,5,7,124136,20523,103613,0.8346732615840691,15.116928,1694.7479573333333,15.839752417379106,113,5.0E-4
10,test_20231031_152251,11551286.png,271883,1492,270391,0.99451234538386,2,6,40092,215,39877,0.9946373341314976,15.83781511111111,1486.2257546666667,16.4099557798489,113,5.0E-4
1,test_20231031_152252,10404007.png,502730,38229,464501,0.9239571937222764,9,5,61265,5465,55800,0.9107973557496123,24.33333688888889,3065.84928,13.265295601451335,113,6.000000000000001E-4
2,test_20231031_152252,1254659.png,342646,97809,244837,0.7145479591181569,5,6,80080,13376,66704,0.832967032967033,17.973982222222222,2433.413968,14.26864364257293,113,6.000000000000001E-4
3,test_20231031_152252,10188041.png,221231,12977,208254,0.9413418553457698,4,6,41731,1822,39909,0.9563394119479524,9.79904,846.0947946666666,18.856613376701063,113,6.000000000000001E-4
4,test_20231031_152252,10287332.png,216980,15067,201913,0.9305604203152364,3,6,22337,2053,20284,0.9080897166136903,9.196833777777778,712.9685386666666,19.600099948097636,113,6.000000000000001E-4
5,test_20231031_152252,11610969.png,368720,38862,329858,0.8946029507485355,4,6,84111,5636,78475,0.9329933064640772,17.97388266666667,2180.6100426666667,14.74502352996726,113,6.000000000000001E-4
6,test_20231031_152252,10350842.png,212614,9459,203155,0.9555109259032801,3,6,42529,1390,41139,0.96731641938442,17.136657777777778,1896.4858453333334,15.351307552298746,113,6.000000000000001E-4
7,test_20231031_152252,10863862.png,317432,20977,296455,0.9339165553567378,3,8,66058,2936,63122,0.9555542099367222,20.95296888888889,2567.9171466666667,14.034993536696753,113,6.000000000000001E-4
8,test_20231031_152252,11382381.png,312486,1332,311154,0.9957374090359248,3,6,46745,177,46568,0.9962134987699219,19.963024,2143.735088,14.819092444591817,113,6.000000000000001E-4
9,test_20231031_152252,11079715.png,443815,148394,295421,0.6656399625970281,6,7,124136,20523,103613,0.8346732615840691,15.116928,1694.7479573333333,15.839752417379106,113,6.000000000000001E-4
10,test_20231031_152252,11551286.png,271883,1432,270451,0.9947330285453669,2,5,40092,206,39886,0.9948618178190163,15.992864,1519.8637866666666,16.31275693548021,113,6.000000000000001E-4
1,test_20231031_152253,10404007.png,502730,38229,464501,0.9239571937222764,4,6,61265,5465,55800,0.9107973557496123,24.33333688888889,3065.84928,13.265295601451335,113,7.000000000000001E-4
2,test_20231031_152253,1254659.png,342646,97809,244837,0.7145479591181569,5,6,80080,13376,66704,0.832967032967033,17.973982222222222,2433.413968,14.26864364257293,113,7.000000000000001E-4
3,test_20231031_152253,10188041.png,221231,12977,208254,0.9413418553457698,4,6,41731,1822,39909,0.9563394119479524,9.79904,846.0947946666666,18.856613376701063,113,7.000000000000001E-4
4,test_20231031_152253,10287332.png,216980,15067,201913,0.9305604203152364,3,6,22337,2053,20284,0.9080897166136903,9.196833777777778,712.9685386666666,19.600099948097636,113,7.000000000000001E-4
5,test_20231031_152253,11610969.png,368720,38862,329858,0.8946029507485355,4,6,84111,5636,78475,0.9329933064640772,17.97388266666667,2180.6100426666667,14.74502352996726,113,7.000000000000001E-4
6,test_20231031_152253,10350842.png,212614,9459,203155,0.9555109259032801,2,5,42529,1390,41139,0.96731641938442,17.136657777777778,1896.4858453333334,15.351307552298746,113,7.000000000000001E-4
7,test_20231031_152253,10863862.png,317432,20977,296455,0.9339165553567378,4,6,66058,2936,63122,0.9555542099367222,20.95296888888889,2567.9171466666667,14.034993536696753,113,7.000000000000001E-4
8,test_20231031_152253,11382381.png,312486,1332,311154,0.9957374090359248,2,5,46745,177,46568,0.9962134987699219,19.963024,2143.735088,14.819092444591817,113,7.000000000000001E-4
9,test_20231031_152253,11079715.png,443815,148394,295421,0.6656399625970281,6,7,124136,20523,103613,0.8346732615840691,15.116928,1694.7479573333333,15.839752417379106,113,7.000000000000001E-4
10,test_20231031_152253,11551286.png,271883,1432,270451,0.9947330285453669,2,6,40092,206,39886,0.9948618178190163,15.992864,1519.8637866666666,16.31275693548021,113,7.000000000000001E-4
1,test_20231031_152254,10404007.png,502730,38007,464723,0.9243987826467488,5,6,61265,5435,55830,0.9112870317473272,24.346736,3068.1460213333335,13.26204335854915,113,8.000000000000001E-4
2,test_20231031_152254,1254659.png,342646,97747,244899,0.7147289038833081,5,7,80080,13367,66713,0.8330794205794205,18.286867555555556,2482.995610666667,14.181044090398585,113,8.000000000000001E-4
3,test_20231031_152254,10188041.png,221231,12857,208374,0.9418842748077801,3,6,41731,1807,39924,0.9566988569648462,9.924547555555556,862.0780266666667,18.775337852784727,113,8.000000000000001E-4
4,test_20231031_152254,10287332.png,216980,15067,201913,0.9305604203152364,3,6,22337,2053,20284,0.9080897166136903,9.196833777777778,712.9685386666666,19.600099948097636,113,8.000000000000001E-4
5,test_20231031_152254,11610969.png,368720,38862,329858,0.8946029507485355,4,6,84111,5636,78475,0.9329933064640772,17.97388266666667,2180.6100426666667,14.74502352996726,113,8.000000000000001E-4
6,test_20231031_152254,10350842.png,212614,9459,203155,0.9555109259032801,3,6,42529,1390,41139,0.96731641938442,17.136657777777778,1896.4858453333334,15.351307552298746,113,8.000000000000001E-4
7,test_20231031_152254,10863862.png,317432,20977,296455,0.9339165553567378,3,6,66058,2936,63122,0.9555542099367222,20.95296888888889,2567.9171466666667,14.034993536696753,113,8.000000000000001E-4
8,test_20231031_152254,11382381.png,312486,1332,311154,0.9957374090359248,2,6,46745,177,46568,0.9962134987699219,19.963024,2143.735088,14.819092444591817,113,8.000000000000001E-4
9,test_20231031_152254,11079715.png,443815,148194,295621,0.666090600813402,5,7,124136,20498,103638,0.8348746536057228,15.431498666666666,1747.5741333333333,15.706447529796908,113,8.000000000000001E-4
10,test_20231031_152254,11551286.png,271883,1312,270571,0.9951743948683809,2,6,40092,188,39904,0.9953107851940537,16.181056,1546.6630293333333,16.23684656374709,113,8.000000000000001E-4
1,test_20231031_152255,10404007.png,502730,38007,464723,0.9243987826467488,4,6,61265,5435,55830,0.9112870317473272,24.346736,3068.1460213333335,13.26204335854915,113,9.000000000000002E-4
2,test_20231031_152255,1254659.png,342646,97747,244899,0.7147289038833081,5,7,80080,13367,66713,0.8330794205794205,18.286867555555556,2482.995610666667,14.181044090398585,113,9.000000000000002E-4
3,test_20231031_152255,10188041.png,221231,12857,208374,0.9418842748077801,3,5,41731,1807,39924,0.9566988569648462,9.924547555555556,862.0780266666667,18.775337852784727,113,9.000000000000002E-4
4,test_20231031_152255,10287332.png,216980,15067,201913,0.9305604203152364,3,6,22337,2053,20284,0.9080897166136903,9.196833777777778,712.9685386666666,19.600099948097636,113,9.000000000000002E-4
5,test_20231031_152255,11610969.png,368720,38862,329858,0.8946029507485355,4,6,84111,5636,78475,0.9329933064640772,17.97388266666667,2180.6100426666667,14.74502352996726,113,9.000000000000002E-4
6,test_20231031_152255,10350842.png,212614,9459,203155,0.9555109259032801,3,6,42529,1390,41139,0.96731641938442,17.136657777777778,1896.4858453333334,15.351307552298746,113,9.000000000000002E-4
7,test_20231031_152255,10863862.png,317432,20977,296455,0.9339165553567378,3,5,66058,2936,63122,0.9555542099367222,20.95296888888889,2567.9171466666667,14.034993536696753,113,9.000000000000002E-4
8,test_20231031_152255,11382381.png,312486,1332,311154,0.9957374090359248,3,5,46745,177,46568,0.9962134987699219,19.963024,2143.735088,14.819092444591817,113,9.000000000000002E-4
9,test_20231031_152255,11079715.png,443815,148194,295621,0.666090600813402,6,7,124136,20498,103638,0.8348746536057228,15.431498666666666,1747.5741333333333,15.706447529796908,113,9.000000000000002E-4
10,test_20231031_152255,11551286.png,271883,1312,270571,0.9951743948683809,3,5,40092,188,39904,0.9953107851940537,16.181056,1546.6630293333333,16.23684656374709,113,9.000000000000002E-4
1,test_20231031_152257,10404007.png,502730,36802,465928,0.926795695502556,4,6,61265,5277,55988,0.9138659920019587,24.547050666666667,3112.0415146666664,13.200349790186417,113,0.0010000000000000002
2,test_20231031_152257,1254659.png,342646,97087,245559,0.7166550900929822,6,7,80080,13293,66787,0.8340034965034965,18.723420444444443,2580.4289813333335,14.013884499670638,113,0.0010000000000000002
3,test_20231031_152257,10188041.png,221231,12677,208554,0.9426979040007956,4,6,41731,1784,39947,0.9572500059907503,10.029216,880.2484266666667,18.684751033717497,113,0.0010000000000000002
4,test_20231031_152257,10287332.png,216980,15007,201973,0.9308369434970964,2,5,22337,2044,20293,0.9084926355374491,9.199582222222222,714.4089653333333,19.59133464860931,113,0.0010000000000000002
5,test_20231031_152257,11610969.png,368720,38362,330358,0.8959589932740291,3,6,84111,5571,78540,0.9337660948032956,18.082366222222223,2195.624218666667,14.715223482795194,113,0.0010000000000000002
6,test_20231031_152257,10350842.png,212614,9177,203437,0.9568372731805055,2,5,42529,1348,41181,0.9683039808130922,17.175978666666666,1904.4170986666666,15.33318288767367,113,0.0010000000000000002
7,test_20231031_152257,10863862.png,317432,20072,297360,0.9367675596663222,4,6,66058,2819,63239,0.9573253807260287,21.40184711111111,2665.640058666667,13.87278854607917,113,0.0010000000000000002
8,test_20231031_152257,11382381.png,312486,1312,311174,0.9958014119032532,2,5,46745,175,46570,0.9962562840945556,20.00402311111111,2148.046416,14.810366992990161,113,0.0010000000000000002
9,test_20231031_152257,11079715.png,443815,148132,295683,0.6662302986604779,6,7,124136,20494,103642,0.8349068763291874,15.434652444444444,1747.739072,15.706037655495917,113,0.0010000000000000002
10,test_20231031_152257,11551286.png,271883,1249,270634,0.9954061121879632,2,5,40092,179,39913,0.9955352688815724,16.243505777777777,1559.44592,16.201100424049645,113,0.0010000000000000002
1,test_20231031_152258,10404007.png,502730,36802,465928,0.926795695502556,4,5,61265,5277,55988,0.9138659920019587,24.547050666666667,3112.0415146666664,13.200349790186417,113,0.0011000000000000003
2,test_20231031_152258,1254659.png,342646,97087,245559,0.7166550900929822,4,6,80080,13293,66787,0.8340034965034965,18.723420444444443,2580.4289813333335,14.013884499670638,113,0.0011000000000000003
3,test_20231031_152258,10188041.png,221231,12394,208837,0.9439771098987032,3,6,41731,1749,39982,0.9580887110301695,10.324835555555556,920.2680746666666,18.491660048378687,113,0.0011000000000000003
4,test_20231031_152258,10287332.png,216980,15007,201973,0.9308369434970964,3,5,22337,2044,20293,0.9084926355374491,9.199582222222222,714.4089653333333,19.59133464860931,113,0.0011000000000000003
5,test_20231031_152258,11610969.png,368720,38362,330358,0.8959589932740291,4,6,84111,5571,78540,0.9337660948032956,18.082366222222223,2195.624218666667,14.715223482795194,113,0.0011000000000000003
6,test_20231031_152258,10350842.png,212614,8757,203857,0.9588126840189263,2,5,42529,1286,41243,0.9697618095887512,18.174912,2125.438208,14.856318774479572,113,0.0011000000000000003
7,test_20231031_152258,10863862.png,317432,20052,297380,0.9368305652864235,4,5,66058,2816,63242,0.9573707953616519,21.732311111111112,2712.290213333333,13.797442039523812,113,0.0011000000000000003
8,test_20231031_152258,11382381.png,312486,1249,311237,0.9960030209353379,2,6,46745,166,46579,0.996448818055407,20.33096711111111,2214.461136,14.678122980890171,113,0.0011000000000000003
9,test_20231031_152258,11079715.png,443815,148132,295683,0.6662302986604779,6,7,124136,20494,103642,0.8349068763291874,15.434652444444444,1747.739072,15.706037655495917,113,0.0011000000000000003
10,test_20231031_152258,11551286.png,271883,987,270896,0.9963697619932104,2,5,40092,143,39949,0.9964332036316472,17.007692444444444,1691.7628,15.847408897964359,113,0.0011000000000000003
1,test_20231031_152259,10404007.png,502730,36802,465928,0.926795695502556,4,6,61265,5277,55988,0.9138659920019587,24.547050666666667,3112.0415146666664,13.200349790186417,113,0.0012000000000000003
2,test_20231031_152259,1254659.png,342646,97087,245559,0.7166550900929822,5,7,80080,13293,66787,0.8340034965034965,18.723420444444443,2580.4289813333335,14.013884499670638,113,0.0012000000000000003
3,test_20231031_152259,10188041.png,221231,12394,208837,0.9439771098987032,3,5,41731,1749,39982,0.9580887110301695,10.324835555555556,920.2680746666666,18.491660048378687,113,0.0012000000000000003
4,test_20231031_152259,10287332.png,216980,15007,201973,0.9308369434970964,2,5,22337,2044,20293,0.9084926355374491,9.199582222222222,714.4089653333333,19.59133464860931,113,0.0012000000000000003
5,test_20231031_152259,11610969.png,368720,38362,330358,0.8959589932740291,4,6,84111,5571,78540,0.9337660948032956,18.082366222222223,2195.624218666667,14.715223482795194,113,0.0012000000000000003
6,test_20231031_152259,10350842.png,212614,8757,203857,0.9588126840189263,3,6,42529,1286,41243,0.9697618095887512,18.174912,2125.438208,14.856318774479572,113,0.0012000000000000003
7,test_20231031_152259,10863862.png,317432,20052,297380,0.9368305652864235,3,6,66058,2816,63242,0.9573707953616519,21.732311111111112,2712.290213333333,13.797442039523812,113,0.0012000000000000003
8,test_20231031_152259,11382381.png,312486,1249,311237,0.9960030209353379,2,5,46745,166,46579,0.996448818055407,20.33096711111111,2214.461136,14.678122980890171,113,0.0012000000000000003
9,test_20231031_152259,11079715.png,443815,148132,295683,0.6662302986604779,6,7,124136,20494,103642,0.8349068763291874,15.434652444444444,1747.739072,15.706037655495917,113,0.0012000000000000003
10,test_20231031_152259,11551286.png,271883,987,270896,0.9963697619932104,2,5,40092,143,39949,0.9964332036316472,17.007692444444444,1691.7628,15.847408897964359,113,0.0012000000000000003
1,test_20231031_152300,10404007.png,502730,36602,466128,0.9271935233624411,3,6,61265,5249,56016,0.9143230229331593,24.560896,3115.0617493333334,13.196137008425685,113,0.0013000000000000004
2,test_20231031_152300,1254659.png,342646,97087,245559,0.7166550900929822,5,6,80080,13293,66787,0.8340034965034965,18.723420444444443,2580.4289813333335,14.013884499670638,113,0.0013000000000000004
3,test_20231031_152300,10188041.png,221231,12212,209019,0.9447997794160854,4,5,41731,1722,40009,0.9587357120605785,10.429539555555555,946.9385706666667,18.367585542889344,113,0.0013000000000000004
4,test_20231031_152300,10287332.png,216980,14847,202133,0.9315743386487234,3,6,22337,2022,20315,0.9094775484621928,9.267603555555555,725.4593973333333,19.524672501004034,113,0.0013000000000000004
5,test_20231031_152300,11610969.png,368720,38119,330601,0.8966180299414189,4,6,84111,5537,78574,0.9341703225499638,18.54344,2293.882330666667,14.525092247450559,113,0.0013000000000000004
6,test_20231031_152300,10350842.png,212614,8757,203857,0.9588126840189263,3,6,42529,1286,41243,0.9697618095887512,18.174912,2125.438208,14.856318774479572,113,0.0013000000000000004
7,test_20231031_152300,10863862.png,317432,19972,297460,0.9370825877668288,4,6,66058,2804,63254,0.9575524539041449,21.774220444444445,2714.000912,13.794703716059086,113,0.0013000000000000004
8,test_20231031_152300,11382381.png,312486,1249,311237,0.9960030209353379,3,5,46745,166,46579,0.996448818055407,20.33096711111111,2214.461136,14.678122980890171,113,0.0013000000000000004
9,test_20231031_152300,11079715.png,443815,148132,295683,0.6662302986604779,6,7,124136,20494,103642,0.8349068763291874,15.434652444444444,1747.739072,15.706037655495917,113,0.0013000000000000004
10,test_20231031_152300,11551286.png,271883,667,271216,0.9975467388545808,2,6,40092,97,39995,0.9975805647011873,17.242257777777777,1740.2246826666667,15.724750366411717,113,0.0013000000000000004
1,test_20231031_152301,10404007.png,502730,36602,466128,0.9271935233624411,4,6,61265,5249,56016,0.9143230229331593,24.560896,3115.0617493333334,13.196137008425685,113,0.0014000000000000004
2,test_20231031_152301,1254659.png,342646,97087,245559,0.7166550900929822,5,7,80080,13293,66787,0.8340034965034965,18.723420444444443,2580.4289813333335,14.013884499670638,113,0.0014000000000000004
3,test_20231031_152301,10188041.png,221231,12212,209019,0.9447997794160854,3,6,41731,1722,40009,0.9587357120605785,10.429539555555555,946.9385706666667,18.367585542889344,113,0.0014000000000000004
4,test_20231031_152301,10287332.png,216980,14847,202133,0.9315743386487234,3,14,22337,2022,20315,0.9094775484621928,9.267603555555555,725.4593973333333,19.524672501004034,113,0.0014000000000000004
5,test_20231031_152301,11610969.png,368720,38119,330601,0.8966180299414189,4,6,84111,5537,78574,0.9341703225499638,18.54344,2293.882330666667,14.525092247450559,113,0.0014000000000000004
6,test_20231031_152301,10350842.png,212614,8757,203857,0.9588126840189263,2,5,42529,1286,41243,0.9697618095887512,18.174912,2125.438208,14.856318774479572,113,0.0014000000000000004
7,test_20231031_152301,10863862.png,317432,19972,297460,0.9370825877668288,3,5,66058,2804,63254,0.9575524539041449,21.774220444444445,2714.000912,13.794703716059086,113,0.0014000000000000004
8,test_20231031_152301,11382381.png,312486,1249,311237,0.9960030209353379,3,6,46745,166,46579,0.996448818055407,20.33096711111111,2214.461136,14.678122980890171,113,0.0014000000000000004
9,test_20231031_152301,11079715.png,443815,148132,295683,0.6662302986604779,5,6,124136,20494,103642,0.8349068763291874,15.434652444444444,1747.739072,15.706037655495917,113,0.0014000000000000004
10,test_20231031_152301,11551286.png,271883,667,271216,0.9975467388545808,2,6,40092,97,39995,0.9975805647011873,17.242257777777777,1740.2246826666667,15.724750366411717,113,0.0014000000000000004
1,test_20231031_152302,10404007.png,502730,36462,466268,0.9274720028643606,3,5,61265,5229,56036,0.9146494735983024,24.503027555555555,3109.0042933333334,13.204590390917856,114,1.0E-4
2,test_20231031_152302,1254659.png,342646,96222,246424,0.719179561413237,5,7,80080,13169,66911,0.835551948051948,18.056108444444444,2461.5509386666668,14.21871533494074,114,1.0E-4
3,test_20231031_152302,10188041.png,221231,12757,208474,0.942336291026122,3,6,41731,1791,39940,0.9570822649828664,9.674622222222222,833.442768,18.922045784137556,114,1.0E-4
4,test_20231031_152302,10287332.png,216980,15167,201813,0.9300995483454696,2,5,22337,2062,20275,0.9076867976899315,8.98130488888889,672.0541653333333,19.85676083710833,114,1.0E-4
5,test_20231031_152302,11610969.png,368720,37707,331013,0.8977354089824257,4,6,84111,5474,78637,0.934919332786437,18.07580088888889,2206.0875413333333,14.694576188726817,114,1.0E-4
6,test_20231031_152302,10350842.png,212614,9299,203315,0.9562634633655357,2,5,42529,1366,41163,0.9678807402008042,16.69799822222222,1795.5919786666666,15.588727042299553,114,1.0E-4
7,test_20231031_152302,10863862.png,317432,20142,297290,0.9365470399959677,3,6,66058,2826,63232,0.9572194132429077,20.84991822222222,2593.607397333333,13.991761246927172,114,1.0E-4
8,test_20231031_152302,11382381.png,312486,2052,310434,0.9934333058121004,3,6,46745,282,46463,0.9939672692266552,16.950384,1682.572176,15.871066579771194,114,1.0E-4
9,test_20231031_152302,11079715.png,443815,146184,297631,0.6706195148879601,5,7,124136,20226,103910,0.8370657988013147,15.24816,1722.6300906666668,15.768883317249298,114,1.0E-4
10,test_20231031_152302,11551286.png,271883,1962,269921,0.992783660618722,3,5,40092,285,39807,0.992891349895241,15.465232,1435.0973066666666,16.561990114943146,114,1.0E-4
1,test_20231031_152303,10404007.png,502730,36462,466268,0.9274720028643606,4,6,61265,5229,56036,0.9146494735983024,24.503027555555555,3109.0042933333334,13.204590390917856,114,2.0E-4
2,test_20231031_152303,1254659.png,342646,96222,246424,0.719179561413237,6,6,80080,13169,66911,0.835551948051948,18.056108444444444,2461.5509386666668,14.21871533494074,114,2.0E-4
3,test_20231031_152303,10188041.png,221231,12757,208474,0.942336291026122,4,6,41731,1791,39940,0.9570822649828664,9.674622222222222,833.442768,18.922045784137556,114,2.0E-4
4,test_20231031_152303,10287332.png,216980,14917,202063,0.9312517282698867,3,6,22337,2032,20305,0.9090298607691274,9.112355555555556,699.105216,19.685378184706046,114,2.0E-4
5,test_20231031_152303,11610969.png,368720,37707,331013,0.8977354089824257,4,6,84111,5474,78637,0.934919332786437,18.07580088888889,2206.0875413333333,14.694576188726817,114,2.0E-4
6,test_20231031_152303,10350842.png,212614,9299,203315,0.9562634633655357,2,6,42529,1366,41163,0.9678807402008042,16.69799822222222,1795.5919786666666,15.588727042299553,114,2.0E-4
7,test_20231031_152303,10863862.png,317432,20142,297290,0.9365470399959677,3,11,66058,2826,63232,0.9572194132429077,20.84991822222222,2593.607397333333,13.991761246927172,114,2.0E-4
8,test_20231031_152303,11382381.png,312486,1942,310544,0.9937853215824068,3,5,46745,266,46479,0.9943095518237245,18.002620444444446,1822.2582186666666,15.524704432275218,114,2.0E-4
9,test_20231031_152303,11079715.png,443815,146184,297631,0.6706195148879601,6,7,124136,20226,103910,0.8370657988013147,15.24816,1722.6300906666668,15.768883317249298,114,2.0E-4
10,test_20231031_152303,11551286.png,271883,1782,270101,0.9934457101032429,2,5,40092,258,39834,0.9935648009577971,15.554723555555556,1441.7542613333333,16.541891171568725,114,2.0E-4
1,test_20231031_152304,10404007.png,502730,36382,466348,0.9276311340083147,5,14,61265,5217,56048,0.9148453439973884,24.53680888888889,3114.8985333333335,13.196364566242938,114,3.0000000000000003E-4
2,test_20231031_152304,1254659.png,342646,96142,246504,0.7194130385295612,5,6,80080,13162,66918,0.8356393606393606,18.06805511111111,2462.9688693333333,14.216214382542205,114,3.0000000000000003E-4
3,test_20231031_152304,10188041.png,221231,12677,208554,0.9426979040007956,3,5,41731,1779,39952,0.9573698209963816,9.827824,854.058224,18.815928818651265,114,3.0000000000000003E-4
4,test_20231031_152304,10287332.png,216980,14877,202103,0.9314360770577933,3,6,22337,2026,20311,0.9092984733849666,9.213692444444444,717.1622506666666,19.574629393735115,114,3.0000000000000003E-4
5,test_20231031_152304,11610969.png,368720,37707,331013,0.8977354089824257,5,6,84111,5474,78637,0.934919332786437,18.07580088888889,2206.0875413333333,14.694576188726817,114,3.0000000000000003E-4
6,test_20231031_152304,10350842.png,212614,9299,203315,0.9562634633655357,3,6,42529,1366,41163,0.9678807402008042,16.69799822222222,1795.5919786666666,15.588727042299553,114,3.0000000000000003E-4
7,test_20231031_152304,10863862.png,317432,19799,297633,0.9376275863807052,4,6,66058,2781,63277,0.9579006327772563,21.31814577777778,2651.084165333333,13.896568451455291,114,3.0000000000000003E-4
8,test_20231031_152304,11382381.png,312486,1822,310664,0.9941693387863776,3,5,46745,248,46497,0.9946946197454273,18.17149688888889,1859.4476533333334,15.436964041414456,114,3.0000000000000003E-4
9,test_20231031_152304,11079715.png,443815,146002,297813,0.6710295956648604,6,7,124136,20203,103933,0.837251079461236,15.561493333333333,1775.296672,15.638094219295418,114,3.0000000000000003E-4
10,test_20231031_152304,11551286.png,271883,1782,270101,0.9934457101032429,2,5,40092,258,39834,0.9935648009577971,15.554723555555556,1441.7542613333333,16.541891171568725,114,3.0000000000000003E-4
1,test_20231031_152305,10404007.png,502730,36382,466348,0.9276311340083147,4,6,61265,5217,56048,0.9148453439973884,24.53680888888889,3114.8985333333335,13.196364566242938,114,4.0E-4
2,test_20231031_152305,1254659.png,342646,96142,246504,0.7194130385295612,6,6,80080,13162,66918,0.8356393606393606,18.06805511111111,2462.9688693333333,14.216214382542205,114,4.0E-4
3,test_20231031_152305,10188041.png,221231,12677,208554,0.9426979040007956,4,6,41731,1779,39952,0.9573698209963816,9.827824,854.058224,18.815928818651265,114,4.0E-4
4,test_20231031_152305,10287332.png,216980,14877,202103,0.9314360770577933,3,6,22337,2026,20311,0.9092984733849666,9.213692444444444,717.1622506666666,19.574629393735115,114,4.0E-4
5,test_20231031_152305,11610969.png,368720,37707,331013,0.8977354089824257,4,6,84111,5474,78637,0.934919332786437,18.07580088888889,2206.0875413333333,14.694576188726817,114,4.0E-4
6,test_20231031_152305,10350842.png,212614,9299,203315,0.9562634633655357,3,6,42529,1366,41163,0.9678807402008042,16.69799822222222,1795.5919786666666,15.588727042299553,114,4.0E-4
7,test_20231031_152305,10863862.png,317432,19799,297633,0.9376275863807052,3,7,66058,2781,63277,0.9579006327772563,21.31814577777778,2651.084165333333,13.896568451455291,114,4.0E-4
8,test_20231031_152305,11382381.png,312486,1289,311197,0.995875015200681,3,6,46745,171,46574,0.9963418547438229,19.990992,2151.4216586666666,14.80354824452692,114,4.0E-4
9,test_20231031_152305,11079715.png,443815,146002,297813,0.6710295956648604,6,8,124136,20203,103933,0.837251079461236,15.561493333333333,1775.296672,15.638094219295418,114,4.0E-4
10,test_20231031_152305,11551286.png,271883,1782,270101,0.9934457101032429,2,6,40092,258,39834,0.9935648009577971,15.554723555555556,1441.7542613333333,16.541891171568725,114,4.0E-4
1,test_20231031_152306,10404007.png,502730,36382,466348,0.9276311340083147,4,5,61265,5217,56048,0.9148453439973884,24.53680888888889,3114.8985333333335,13.196364566242938,114,5.0E-4
2,test_20231031_152306,1254659.png,342646,96142,246504,0.7194130385295612,6,7,80080,13162,66918,0.8356393606393606,18.06805511111111,2462.9688693333333,14.216214382542205,114,5.0E-4
3,test_20231031_152306,10188041.png,221231,12677,208554,0.9426979040007956,4,6,41731,1779,39952,0.9573698209963816,9.827824,854.058224,18.815928818651265,114,5.0E-4
4,test_20231031_152306,10287332.png,216980,14877,202103,0.9314360770577933,3,6,22337,2026,20311,0.9092984733849666,9.213692444444444,717.1622506666666,19.574629393735115,114,5.0E-4
5,test_20231031_152306,11610969.png,368720,37707,331013,0.8977354089824257,3,6,84111,5474,78637,0.934919332786437,18.07580088888889,2206.0875413333333,14.694576188726817,114,5.0E-4
6,test_20231031_152306,10350842.png,212614,9299,203315,0.9562634633655357,3,6,42529,1366,41163,0.9678807402008042,16.69799822222222,1795.5919786666666,15.588727042299553,114,5.0E-4
7,test_20231031_152306,10863862.png,317432,19799,297633,0.9376275863807052,3,5,66058,2781,63277,0.9579006327772563,21.31814577777778,2651.084165333333,13.896568451455291,114,5.0E-4
8,test_20231031_152306,11382381.png,312486,1289,311197,0.995875015200681,2,5,46745,171,46574,0.9963418547438229,19.990992,2151.4216586666666,14.80354824452692,114,5.0E-4
9,test_20231031_152306,11079715.png,443815,146002,297813,0.6710295956648604,6,7,124136,20203,103933,0.837251079461236,15.561493333333333,1775.296672,15.638094219295418,114,5.0E-4
10,test_20231031_152306,11551286.png,271883,1452,270431,0.9946594674915313,2,6,40092,209,39883,0.9947869899231767,15.838398222222223,1486.420784,16.409385916178287,114,5.0E-4
1,test_20231031_152307,10404007.png,502730,36382,466348,0.9276311340083147,4,6,61265,5217,56048,0.9148453439973884,24.53680888888889,3114.8985333333335,13.196364566242938,114,6.000000000000001E-4
2,test_20231031_152307,1254659.png,342646,96022,246624,0.7197632542040473,5,6,80080,13147,66933,0.8358266733266733,18.40383466666667,2514.53016,14.12623511826446,114,6.000000000000001E-4
3,test_20231031_152307,10188041.png,221231,12677,208554,0.9426979040007956,3,6,41731,1779,39952,0.9573698209963816,9.827824,854.058224,18.815928818651265,114,6.000000000000001E-4
4,test_20231031_152307,10287332.png,216980,14877,202103,0.9314360770577933,2,5,22337,2026,20311,0.9092984733849666,9.213692444444444,717.1622506666666,19.574629393735115,114,6.000000000000001E-4
5,test_20231031_152307,11610969.png,368720,37707,331013,0.8977354089824257,4,15,84111,5474,78637,0.934919332786437,18.07580088888889,2206.0875413333333,14.694576188726817,114,6.000000000000001E-4
6,test_20231031_152307,10350842.png,212614,9197,203417,0.9567432059977236,2,5,42529,1351,41178,0.9682334407110442,17.162268444444443,1903.8130133333334,15.334560697949573,114,6.000000000000001E-4
7,test_20231031_152307,10863862.png,317432,19799,297633,0.9376275863807052,3,5,66058,2781,63277,0.9579006327772563,21.31814577777778,2651.084165333333,13.896568451455291,114,6.000000000000001E-4
8,test_20231031_152307,11382381.png,312486,1289,311197,0.995875015200681,2,5,46745,171,46574,0.9963418547438229,19.990992,2151.4216586666666,14.80354824452692,114,6.000000000000001E-4
9,test_20231031_152307,11079715.png,443815,146002,297813,0.6710295956648604,6,7,124136,20203,103933,0.837251079461236,15.561493333333333,1775.296672,15.638094219295418,114,6.000000000000001E-4
10,test_20231031_152307,11551286.png,271883,1289,270594,0.9952589900802918,2,6,40092,185,39907,0.9953856130898933,16.143914666666667,1538.91744,16.258650394862006,114,6.000000000000001E-4
1,test_20231031_152308,10404007.png,502730,36382,466348,0.9276311340083147,4,6,61265,5217,56048,0.9148453439973884,24.53680888888889,3114.8985333333335,13.196364566242938,114,7.000000000000001E-4
2,test_20231031_152308,1254659.png,342646,96022,246624,0.7197632542040473,6,6,80080,13147,66933,0.8358266733266733,18.40383466666667,2514.53016,14.12623511826446,114,7.000000000000001E-4
3,test_20231031_152308,10188041.png,221231,12677,208554,0.9426979040007956,3,6,41731,1779,39952,0.9573698209963816,9.827824,854.058224,18.815928818651265,114,7.000000000000001E-4
4,test_20231031_152308,10287332.png,216980,14877,202103,0.9314360770577933,2,6,22337,2026,20311,0.9092984733849666,9.213692444444444,717.1622506666666,19.574629393735115,114,7.000000000000001E-4
5,test_20231031_152308,11610969.png,368720,37707,331013,0.8977354089824257,4,6,84111,5474,78637,0.934919332786437,18.07580088888889,2206.0875413333333,14.694576188726817,114,7.000000000000001E-4
6,test_20231031_152308,10350842.png,212614,9197,203417,0.9567432059977236,2,5,42529,1351,41178,0.9682334407110442,17.162268444444443,1903.8130133333334,15.334560697949573,114,7.000000000000001E-4
7,test_20231031_152308,10863862.png,317432,19799,297633,0.9376275863807052,3,5,66058,2781,63277,0.9579006327772563,21.31814577777778,2651.084165333333,13.896568451455291,114,7.000000000000001E-4
8,test_20231031_152308,11382381.png,312486,1289,311197,0.995875015200681,2,6,46745,171,46574,0.9963418547438229,19.990992,2151.4216586666666,14.80354824452692,114,7.000000000000001E-4
9,test_20231031_152308,11079715.png,443815,146002,297813,0.6710295956648604,5,7,124136,20203,103933,0.837251079461236,15.561493333333333,1775.296672,15.638094219295418,114,7.000000000000001E-4
10,test_20231031_152308,11551286.png,271883,1289,270594,0.9952589900802918,3,6,40092,185,39907,0.9953856130898933,16.143914666666667,1538.91744,16.258650394862006,114,7.000000000000001E-4
1,test_20231031_152309,10404007.png,502730,36159,466571,0.9280747120720864,5,6,61265,5187,56078,0.9153350199951032,24.550208,3117.1952746666666,13.193163516440693,114,8.000000000000001E-4
2,test_20231031_152309,1254659.png,342646,96022,246624,0.7197632542040473,6,7,80080,13147,66933,0.8358266733266733,18.40383466666667,2514.53016,14.12623511826446,114,8.000000000000001E-4
3,test_20231031_152309,10188041.png,221231,12394,208837,0.9439771098987032,3,5,41731,1742,39989,0.9582564520380532,10.20136711111111,904.83224,18.56512294365357,114,8.000000000000001E-4
4,test_20231031_152309,10287332.png,216980,14877,202103,0.9314360770577933,3,6,22337,2026,20311,0.9092984733849666,9.213692444444444,717.1622506666666,19.574629393735115,114,8.000000000000001E-4
5,test_20231031_152309,11610969.png,368720,37707,331013,0.8977354089824257,4,6,84111,5474,78637,0.934919332786437,18.07580088888889,2206.0875413333333,14.694576188726817,114,8.000000000000001E-4
6,test_20231031_152309,10350842.png,212614,9097,203517,0.9572135419116333,3,6,42529,1336,41193,0.9685861412212843,17.231882666666667,1909.825984,15.320865630607445,114,8.000000000000001E-4
7,test_20231031_152309,10863862.png,317432,19779,297653,0.9376905920008065,3,5,66058,2778,63280,0.9579460474128796,21.64860977777778,2697.73432,13.820811838935498,114,8.000000000000001E-4
8,test_20231031_152309,11382381.png,312486,1229,311257,0.9960670238026663,3,5,46745,162,46583,0.9965343887046743,20.317936,2217.836378666667,14.671508580373438,114,8.000000000000001E-4
9,test_20231031_152309,11079715.png,443815,146002,297813,0.6710295956648604,5,7,124136,20203,103933,0.837251079461236,15.561493333333333,1775.296672,15.638094219295418,114,8.000000000000001E-4
10,test_20231031_152309,11551286.png,271883,1007,270876,0.9962962009393747,2,5,40092,146,39946,0.9963583757358077,16.945825777777777,1679.1749386666668,15.87984416999138,114,8.000000000000001E-4
1,test_20231031_152310,10404007.png,502730,36159,466571,0.9280747120720864,4,7,61265,5187,56078,0.9153350199951032,24.550208,3117.1952746666666,13.193163516440693,114,9.000000000000002E-4
2,test_20231031_152310,1254659.png,342646,96022,246624,0.7197632542040473,5,6,80080,13147,66933,0.8358266733266733,18.40383466666667,2514.53016,14.12623511826446,114,9.000000000000002E-4
3,test_20231031_152310,10188041.png,221231,12394,208837,0.9439771098987032,3,6,41731,1742,39989,0.9582564520380532,10.20136711111111,904.83224,18.56512294365357,114,9.000000000000002E-4
4,test_20231031_152310,10287332.png,216980,14877,202103,0.9314360770577933,3,6,22337,2026,20311,0.9092984733849666,9.213692444444444,717.1622506666666,19.574629393735115,114,9.000000000000002E-4
5,test_20231031_152310,11610969.png,368720,37707,331013,0.8977354089824257,4,6,84111,5474,78637,0.934919332786437,18.07580088888889,2206.0875413333333,14.694576188726817,114,9.000000000000002E-4
6,test_20231031_152310,10350842.png,212614,9097,203517,0.9572135419116333,4,6,42529,1336,41193,0.9685861412212843,17.231882666666667,1909.825984,15.320865630607445,114,9.000000000000002E-4
7,test_20231031_152310,10863862.png,317432,19779,297653,0.9376905920008065,4,6,66058,2778,63280,0.9579460474128796,21.64860977777778,2697.73432,13.820811838935498,114,9.000000000000002E-4
8,test_20231031_152310,11382381.png,312486,1229,311257,0.9960670238026663,2,5,46745,162,46583,0.9965343887046743,20.317936,2217.836378666667,14.671508580373438,114,9.000000000000002E-4
9,test_20231031_152310,11079715.png,443815,146002,297813,0.6710295956648604,6,7,124136,20203,103933,0.837251079461236,15.561493333333333,1775.296672,15.638094219295418,114,9.000000000000002E-4
10,test_20231031_152310,11551286.png,271883,1007,270876,0.9962962009393747,2,6,40092,146,39946,0.9963583757358077,16.945825777777777,1679.1749386666668,15.87984416999138,114,9.000000000000002E-4
1,test_20231031_152311,10404007.png,502730,35234,467496,0.9299146659240547,4,6,61265,5066,56199,0.9173100465192198,24.617792,3131.590368,13.173154122559483,114,0.0010000000000000002
2,test_20231031_152311,1254659.png,342646,95357,247289,0.7217040327334917,5,7,80080,13072,67008,0.8367632367632367,18.840387555555555,2611.963530666667,13.961132520247501,114,0.0010000000000000002
3,test_20231031_152311,10188041.png,221231,12232,208999,0.944709376172417,5,5,41731,1720,40011,0.958783638062831,10.305470222222223,922.8201866666667,18.479632747348795,114,0.0010000000000000002
4,test_20231031_152311,10287332.png,216980,14817,202163,0.9317126002396534,2,5,22337,2017,20320,0.9097013923087254,9.216440888888888,718.6026773333333,19.56591529923957,114,0.0010000000000000002
5,test_20231031_152311,11610969.png,368720,37164,331556,0.8992080711651117,4,7,84111,5403,78708,0.935763455433891,18.189429333333333,2221.5940373333333,14.664156597526024,114,0.0010000000000000002
6,test_20231031_152311,10350842.png,212614,8797,203817,0.9586245496533624,3,6,42529,1292,41237,0.9696207293846552,17.352725333333332,1928.764928,15.278010604886372,114,0.0010000000000000002
7,test_20231031_152311,10863862.png,317432,19257,298175,0.9393350386854508,3,6,66058,2707,63351,0.9590208604559629,21.83426311111111,2738.593104,13.755528506346534,114,0.0010000000000000002
8,test_20231031_152311,11382381.png,312486,1209,311277,0.9961310266699949,2,5,46745,160,46585,0.9965771740293079,20.358935111111112,2222.1477066666666,14.66307437649986,114,0.0010000000000000002
9,test_20231031_152311,11079715.png,443815,145922,297893,0.67120985095141,6,7,124136,20196,103940,0.837307469227299,15.574552888888888,1776.5390186666666,15.635056103960494,114,0.0010000000000000002
10,test_20231031_152311,11551286.png,271883,947,270936,0.9965168841008817,2,6,40092,137,39955,0.9965828594233264,17.008275555555556,1691.9578293333334,15.846908264651812,114,0.0010000000000000002
1,test_20231031_152312,10404007.png,502730,35014,467716,0.9303522765699281,3,6,61265,5036,56229,0.9177997225169346,24.63626488888889,3134.972570666667,13.168466155289973,114,0.0011000000000000003
2,test_20231031_152312,1254659.png,342646,95357,247289,0.7217040327334917,5,7,80080,13072,67008,0.8367632367632367,18.840387555555555,2611.963530666667,13.961132520247501,114,0.0011000000000000003
3,test_20231031_152312,10188041.png,221231,12112,209119,0.9452517956344274,3,6,41731,1707,40024,0.9590951570774724,10.353054222222223,928.0490506666666,18.455094300467824,114,0.0011000000000000003
4,test_20231031_152312,10287332.png,216980,14817,202163,0.9317126002396534,2,5,22337,2017,20320,0.9097013923087254,9.216440888888888,718.6026773333333,19.56591529923957,114,0.0011000000000000003
5,test_20231031_152312,11610969.png,368720,37164,331556,0.8992080711651117,4,6,84111,5403,78708,0.935763455433891,18.189429333333333,2221.5940373333333,14.664156597526024,114,0.0011000000000000003
6,test_20231031_152312,10350842.png,212614,8394,204220,0.9605200033864186,3,5,42529,1233,41296,0.9710080180582661,18.284323555555556,2144.608128,14.817324132492617,114,0.0011000000000000003
7,test_20231031_152312,10863862.png,317432,19177,298255,0.939587061165856,4,6,66058,2695,63363,0.9592025189984559,21.876172444444446,2740.303802666667,13.752816474972585,114,0.0011000000000000003
8,test_20231031_152312,11382381.png,312486,1209,311277,0.9961310266699949,2,6,46745,160,46585,0.9965771740293079,20.358935111111112,2222.1477066666666,14.66307437649986,114,0.0011000000000000003
9,test_20231031_152312,11079715.png,443815,145922,297893,0.67120985095141,5,8,124136,20196,103940,0.837307469227299,15.574552888888888,1776.5390186666666,15.635056103960494,114,0.0011000000000000003
10,test_20231031_152312,11551286.png,271883,947,270936,0.9965168841008817,2,5,40092,137,39955,0.9965828594233264,17.008275555555556,1691.9578293333334,15.846908264651812,114,0.0011000000000000003
1,test_20231031_152313,10404007.png,502730,35014,467716,0.9303522765699281,4,6,61265,5036,56229,0.9177997225169346,24.63626488888889,3134.972570666667,13.168466155289973,114,0.0012000000000000003
2,test_20231031_152313,1254659.png,342646,95357,247289,0.7217040327334917,6,7,80080,13072,67008,0.8367632367632367,18.840387555555555,2611.963530666667,13.961132520247501,114,0.0012000000000000003
3,test_20231031_152313,10188041.png,221231,12112,209119,0.9452517956344274,3,5,41731,1707,40024,0.9590951570774724,10.353054222222223,928.0490506666666,18.455094300467824,114,0.0012000000000000003
4,test_20231031_152313,10287332.png,216980,14817,202163,0.9317126002396534,3,5,22337,2017,20320,0.9097013923087254,9.216440888888888,718.6026773333333,19.56591529923957,114,0.0012000000000000003
5,test_20231031_152313,11610969.png,368720,37164,331556,0.8992080711651117,4,7,84111,5403,78708,0.935763455433891,18.189429333333333,2221.5940373333333,14.664156597526024,114,0.0012000000000000003
6,test_20231031_152313,10350842.png,212614,8394,204220,0.9605200033864186,3,7,42529,1233,41296,0.9710080180582661,18.284323555555556,2144.608128,14.817324132492617,114,0.0012000000000000003
7,test_20231031_152313,10863862.png,317432,19177,298255,0.939587061165856,4,7,66058,2695,63363,0.9592025189984559,21.876172444444446,2740.303802666667,13.752816474972585,114,0.0012000000000000003
8,test_20231031_152313,11382381.png,312486,1209,311277,0.9961310266699949,2,6,46745,160,46585,0.9965771740293079,20.358935111111112,2222.1477066666666,14.66307437649986,114,0.0012000000000000003
9,test_20231031_152313,11079715.png,443815,145922,297893,0.67120985095141,6,8,124136,20196,103940,0.837307469227299,15.574552888888888,1776.5390186666666,15.635056103960494,114,0.0012000000000000003
10,test_20231031_152313,11551286.png,271883,647,271236,0.9976202999084165,2,6,40092,94,39998,0.9976553925970268,17.242940444444443,1740.3629333333333,15.724405358566443,114,0.0012000000000000003
1,test_20231031_152314,10404007.png,502730,34752,467978,0.9308734310663775,4,5,61265,4998,56267,0.9184199787807068,24.655937777777776,3139.3587893333333,13.162394079193351,114,0.0013000000000000004
2,test_20231031_152314,1254659.png,342646,95357,247289,0.7217040327334917,6,7,80080,13072,67008,0.8367632367632367,18.840387555555555,2611.963530666667,13.961132520247501,114,0.0013000000000000004
3,test_20231031_152314,10188041.png,221231,11972,209259,0.9458846183401061,4,6,41731,1686,40045,0.9595983801011239,10.448133333333333,952.0991946666667,18.343981630589028,114,0.0013000000000000004
4,test_20231031_152314,10287332.png,216980,14654,202326,0.9324638215503733,2,6,22337,1995,20342,0.9106863052334692,9.284462222222222,729.6531093333333,19.499639233614715,114,0.0013000000000000004
5,test_20231031_152314,11610969.png,368720,36962,331758,0.8997559123454112,3,6,84111,5375,78736,0.9360963488723235,18.64535822222222,2319.3598293333334,14.477122298361644,114,0.0013000000000000004
6,test_20231031_152314,10350842.png,212614,8394,204220,0.9605200033864186,2,5,42529,1233,41296,0.9710080180582661,18.284323555555556,2144.608128,14.817324132492617,114,0.0013000000000000004
7,test_20231031_152314,10863862.png,317432,19177,298255,0.939587061165856,3,5,66058,2695,63363,0.9592025189984559,21.876172444444446,2740.303802666667,13.752816474972585,114,0.0013000000000000004
8,test_20231031_152314,11382381.png,312486,1209,311277,0.9961310266699949,3,6,46745,160,46585,0.9965771740293079,20.358935111111112,2222.1477066666666,14.66307437649986,114,0.0013000000000000004
9,test_20231031_152314,11079715.png,443815,145922,297893,0.67120985095141,6,7,124136,20196,103940,0.837307469227299,15.574552888888888,1776.5390186666666,15.635056103960494,114,0.0013000000000000004
10,test_20231031_152314,11551286.png,271883,647,271236,0.9976202999084165,3,5,40092,94,39998,0.9976553925970268,17.242940444444443,1740.3629333333333,15.724405358566443,114,0.0013000000000000004
1,test_20231031_152315,10404007.png,502730,34752,467978,0.9308734310663775,4,6,61265,4998,56267,0.9184199787807068,24.655937777777776,3139.3587893333333,13.162394079193351,114,0.0014000000000000004
2,test_20231031_152315,1254659.png,342646,95357,247289,0.7217040327334917,4,6,80080,13072,67008,0.8367632367632367,18.840387555555555,2611.963530666667,13.961132520247501,114,0.0014000000000000004
3,test_20231031_152315,10188041.png,221231,11972,209259,0.9458846183401061,3,5,41731,1686,40045,0.9595983801011239,10.448133333333333,952.0991946666667,18.343981630589028,114,0.0014000000000000004
4,test_20231031_152315,10287332.png,216980,14654,202326,0.9324638215503733,2,5,22337,1995,20342,0.9106863052334692,9.284462222222222,729.6531093333333,19.499639233614715,114,0.0014000000000000004
5,test_20231031_152315,11610969.png,368720,36962,331758,0.8997559123454112,4,6,84111,5375,78736,0.9360963488723235,18.64535822222222,2319.3598293333334,14.477122298361644,114,0.0014000000000000004
6,test_20231031_152315,10350842.png,212614,8394,204220,0.9605200033864186,3,6,42529,1233,41296,0.9710080180582661,18.284323555555556,2144.608128,14.817324132492617,114,0.0014000000000000004
7,test_20231031_152315,10863862.png,317432,19177,298255,0.939587061165856,4,6,66058,2695,63363,0.9592025189984559,21.876172444444446,2740.303802666667,13.752816474972585,114,0.0014000000000000004
8,test_20231031_152315,11382381.png,312486,1209,311277,0.9961310266699949,2,5,46745,160,46585,0.9965771740293079,20.358935111111112,2222.1477066666666,14.66307437649986,114,0.0014000000000000004
9,test_20231031_152315,11079715.png,443815,145922,297893,0.67120985095141,6,7,124136,20196,103940,0.837307469227299,15.574552888888888,1776.5390186666666,15.635056103960494,114,0.0014000000000000004
10,test_20231031_152315,11551286.png,271883,647,271236,0.9976202999084165,2,5,40092,94,39998,0.9976553925970268,17.242940444444443,1740.3629333333333,15.724405358566443,114,0.0014000000000000004
1,test_20231031_152317,10404007.png,502730,35034,467696,0.9303124937839397,4,6,61265,5027,56238,0.917946625316249,24.568979555555554,3128.3709813333335,13.177621121346494,115,1.0E-4
2,test_20231031_152317,1254659.png,342646,94122,248524,0.7253083357167456,5,7,80080,12902,67178,0.8388861138861139,18.284115555555555,2522.058832,14.113251477367356,115,1.0E-4
3,test_20231031_152317,10188041.png,221231,12374,208857,0.9440675131423716,3,6,41731,1736,39995,0.9584002300448108,9.829038222222222,868.066848,18.74527190300103,115,1.0E-4
4,test_20231031_152317,10287332.png,216980,15067,201913,0.9305604203152364,3,6,22337,2049,20288,0.9082687916909165,9.019194666666667,678.6627893333333,19.814263231251328,115,1.0E-4
5,test_20231031_152317,11610969.png,368720,36682,332038,0.9005152961596876,4,7,84111,5328,78783,0.9366551342868352,18.225370666666667,2241.4289226666665,14.62555389240082,115,1.0E-4
6,test_20231031_152317,10350842.png,212614,9037,203577,0.9574957434599791,2,6,42529,1328,41201,0.968774248160079,16.729114666666668,1801.6705333333334,15.574049852333808,115,1.0E-4
7,test_20231031_152317,10863862.png,317432,19157,298275,0.9396500667859573,3,6,66058,2693,63365,0.9592327954222047,21.396314666666665,2685.50504,13.840543890969485,115,1.0E-4
8,test_20231031_152317,11382381.png,312486,2012,310474,0.9935613115467573,3,12,46745,276,46469,0.9940956252005562,17.15296888888889,1710.0382133333333,15.800745454147208,115,1.0E-4
9,test_20231031_152317,11079715.png,443815,144084,299731,0.6753512161598865,5,7,124136,19946,104190,0.8393213894438358,15.334839111111112,1742.9790133333333,15.717882029308365,115,1.0E-4
10,test_20231031_152317,11551286.png,271883,1922,269961,0.9929307827263933,2,5,40092,279,39813,0.9930410056869201,15.46832888888889,1435.6707573333333,16.56025506384924,115,1.0E-4
1,test_20231031_152318,10404007.png,502730,35034,467696,0.9303124937839397,4,6,61265,5027,56238,0.917946625316249,24.568979555555554,3128.3709813333335,13.177621121346494,115,2.0E-4
2,test_20231031_152318,1254659.png,342646,94122,248524,0.7253083357167456,5,7,80080,12902,67178,0.8388861138861139,18.284115555555555,2522.058832,14.113251477367356,115,2.0E-4
3,test_20231031_152318,10188041.png,221231,12374,208857,0.9440675131423716,4,6,41731,1736,39995,0.9584002300448108,9.829038222222222,868.066848,18.74527190300103,115,2.0E-4
4,test_20231031_152318,10287332.png,216980,14817,202163,0.9317126002396534,3,6,22337,2019,20318,0.9096118547701124,9.150245333333332,705.71384,19.644517262498585,115,2.0E-4
5,test_20231031_152318,11610969.png,368720,36682,332038,0.9005152961596876,4,6,84111,5328,78783,0.9366551342868352,18.225370666666667,2241.4289226666665,14.62555389240082,115,2.0E-4
6,test_20231031_152318,10350842.png,212614,9037,203577,0.9574957434599791,2,6,42529,1328,41201,0.968774248160079,16.729114666666668,1801.6705333333334,15.574049852333808,115,2.0E-4
7,test_20231031_152318,10863862.png,317432,19157,298275,0.9396500667859573,3,6,66058,2693,63365,0.9592327954222047,21.396314666666665,2685.50504,13.840543890969485,115,2.0E-4
8,test_20231031_152318,11382381.png,312486,1922,310564,0.9938493244497354,2,5,46745,263,46482,0.994373729810675,18.026890666666667,1828.99472,15.508679091247764,115,2.0E-4
9,test_20231031_152318,11079715.png,443815,144084,299731,0.6753512161598865,6,7,124136,19946,104190,0.8393213894438358,15.334839111111112,1742.9790133333333,15.717882029308365,115,2.0E-4
10,test_20231031_152318,11551286.png,271883,1742,270141,0.9935928322109142,3,6,40092,252,39840,0.9937144567494762,15.557820444444445,1442.327712,16.540164130064625,115,2.0E-4
1,test_20231031_152319,10404007.png,502730,34952,467778,0.9304756032064926,4,6,61265,5015,56250,0.918142495715335,24.602760888888888,3134.2652213333336,13.169446172075874,115,3.0000000000000003E-4
2,test_20231031_152319,1254659.png,342646,94042,248604,0.7255418128330697,4,6,80080,12895,67185,0.8389735264735265,18.296062222222222,2523.4767626666667,14.110810509629,115,3.0000000000000003E-4
3,test_20231031_152319,10188041.png,221231,12292,208939,0.9444381664414119,3,6,41731,1724,40007,0.9586877860583259,9.98224,888.682304,18.64333828557937,115,3.0000000000000003E-4
4,test_20231031_152319,10287332.png,216980,14797,202183,0.9318047746336068,3,6,22337,2016,20321,0.909746161078032,9.221587555555555,718.468656,19.56672534567697,115,3.0000000000000003E-4
5,test_20231031_152319,11610969.png,368720,36682,332038,0.9005152961596876,4,15,84111,5328,78783,0.9366551342868352,18.225370666666667,2241.4289226666665,14.62555389240082,115,3.0000000000000003E-4
6,test_20231031_152319,10350842.png,212614,9037,203577,0.9574957434599791,3,6,42529,1328,41201,0.968774248160079,16.729114666666668,1801.6705333333334,15.574049852333808,115,3.0000000000000003E-4
7,test_20231031_152319,10863862.png,317432,18917,298515,0.940406134227173,3,6,66058,2662,63396,0.9597020799903115,21.97788088888889,2776.3364373333334,13.696082679525237,115,3.0000000000000003E-4
8,test_20231031_152319,11382381.png,312486,1802,310684,0.9942333416537061,3,6,46745,245,46500,0.9947587977323777,18.19576711111111,1866.1841546666667,15.421258632530638,115,3.0000000000000003E-4
9,test_20231031_152319,11079715.png,443815,143902,299913,0.6757612969367868,6,7,124136,19923,104213,0.8395066701037572,15.648172444444445,1795.6455946666667,15.588597364813907,115,3.0000000000000003E-4
10,test_20231031_152319,11551286.png,271883,1722,270161,0.9936663932647499,3,6,40092,249,39843,0.9937892846453158,15.639918222222223,1466.0139093333332,16.469422700184243,115,3.0000000000000003E-4
1,test_20231031_152320,10404007.png,502730,34952,467778,0.9304756032064926,4,6,61265,5015,56250,0.918142495715335,24.602760888888888,3134.2652213333336,13.169446172075874,115,4.0E-4
2,test_20231031_152320,1254659.png,342646,94042,248604,0.7255418128330697,5,6,80080,12895,67185,0.8389735264735265,18.296062222222222,2523.4767626666667,14.110810509629,115,4.0E-4
3,test_20231031_152320,10188041.png,221231,12292,208939,0.9444381664414119,3,5,41731,1724,40007,0.9586877860583259,9.98224,888.682304,18.64333828557937,115,4.0E-4
4,test_20231031_152320,10287332.png,216980,14797,202183,0.9318047746336068,3,6,22337,2016,20321,0.909746161078032,9.221587555555555,718.468656,19.56672534567697,115,4.0E-4
5,test_20231031_152320,11610969.png,368720,36682,332038,0.9005152961596876,4,6,84111,5328,78783,0.9366551342868352,18.225370666666667,2241.4289226666665,14.62555389240082,115,4.0E-4
6,test_20231031_152320,10350842.png,212614,9037,203577,0.9574957434599791,3,6,42529,1328,41201,0.968774248160079,16.729114666666668,1801.6705333333334,15.574049852333808,115,4.0E-4
7,test_20231031_152320,10863862.png,317432,18917,298515,0.940406134227173,3,6,66058,2662,63396,0.9597020799903115,21.97788088888889,2776.3364373333334,13.696082679525237,115,4.0E-4
8,test_20231031_152320,11382381.png,312486,1269,311217,0.9959390180680094,3,6,46745,168,46577,0.9964060327307733,20.015262222222223,2158.15816,14.789970922085507,115,4.0E-4
9,test_20231031_152320,11079715.png,443815,143902,299913,0.6757612969367868,6,7,124136,19923,104213,0.8395066701037572,15.648172444444445,1795.6455946666667,15.588597364813907,115,4.0E-4
10,test_20231031_152320,11551286.png,271883,1722,270161,0.9936663932647499,3,5,40092,249,39843,0.9937892846453158,15.639918222222223,1466.0139093333332,16.469422700184243,115,4.0E-4
1,test_20231031_152321,10404007.png,502730,34952,467778,0.9304756032064926,4,6,61265,5015,56250,0.918142495715335,24.602760888888888,3134.2652213333336,13.169446172075874,115,5.0E-4
2,test_20231031_152321,1254659.png,342646,94042,248604,0.7255418128330697,5,7,80080,12895,67185,0.8389735264735265,18.296062222222222,2523.4767626666667,14.110810509629,115,5.0E-4
3,test_20231031_152321,10188041.png,221231,12292,208939,0.9444381664414119,4,5,41731,1724,40007,0.9586877860583259,9.98224,888.682304,18.64333828557937,115,5.0E-4
4,test_20231031_152321,10287332.png,216980,14797,202183,0.9318047746336068,3,6,22337,2016,20321,0.909746161078032,9.221587555555555,718.468656,19.56672534567697,115,5.0E-4
5,test_20231031_152321,11610969.png,368720,36682,332038,0.9005152961596876,5,6,84111,5328,78783,0.9366551342868352,18.225370666666667,2241.4289226666665,14.62555389240082,115,5.0E-4
6,test_20231031_152321,10350842.png,212614,9037,203577,0.9574957434599791,2,5,42529,1328,41201,0.968774248160079,16.729114666666668,1801.6705333333334,15.574049852333808,115,5.0E-4
7,test_20231031_152321,10863862.png,317432,18917,298515,0.940406134227173,3,5,66058,2662,63396,0.9597020799903115,21.97788088888889,2776.3364373333334,13.696082679525237,115,5.0E-4
8,test_20231031_152321,11382381.png,312486,1269,311217,0.9959390180680094,3,5,46745,168,46577,0.9964060327307733,20.015262222222223,2158.15816,14.789970922085507,115,5.0E-4
9,test_20231031_152321,11079715.png,443815,143902,299913,0.6757612969367868,5,7,124136,19923,104213,0.8395066701037572,15.648172444444445,1795.6455946666667,15.588597364813907,115,5.0E-4
10,test_20231031_152321,11551286.png,271883,1189,270694,0.9956267953494702,2,6,40092,173,39919,0.9956849246732515,16.48380088888889,1607.3163946666666,16.06978986324379,115,5.0E-4
1,test_20231031_152322,10404007.png,502730,34952,467778,0.9304756032064926,4,6,61265,5015,56250,0.918142495715335,24.602760888888888,3134.2652213333336,13.169446172075874,115,6.000000000000001E-4
2,test_20231031_152322,1254659.png,342646,93922,248724,0.7258920285075559,5,8,80080,12880,67200,0.8391608391608392,18.631841777777776,2575.038053333333,14.022967095370802,115,6.000000000000001E-4
3,test_20231031_152322,10188041.png,221231,12232,208999,0.944709376172417,3,5,41731,1715,40016,0.9589034530684623,10.10263111111111,912.3246826666667,18.529309361401197,115,6.000000000000001E-4
4,test_20231031_152322,10287332.png,216980,14797,202183,0.9318047746336068,2,5,22337,2016,20321,0.909746161078032,9.221587555555555,718.468656,19.56672534567697,115,6.000000000000001E-4
5,test_20231031_152322,11610969.png,368720,36682,332038,0.9005152961596876,4,6,84111,5328,78783,0.9366551342868352,18.225370666666667,2241.4289226666665,14.62555389240082,115,6.000000000000001E-4
6,test_20231031_152322,10350842.png,212614,8837,203777,0.9584364152877985,2,5,42529,1298,41231,0.9694796491805592,17.26299911111111,1915.9045386666667,15.30706494623887,115,6.000000000000001E-4
7,test_20231031_152322,10863862.png,317432,18917,298515,0.940406134227173,3,6,66058,2662,63396,0.9597020799903115,21.97788088888889,2776.3364373333334,13.696082679525237,115,6.000000000000001E-4
8,test_20231031_152322,11382381.png,312486,1269,311217,0.9959390180680094,2,5,46745,168,46577,0.9964060327307733,20.015262222222223,2158.15816,14.789970922085507,115,6.000000000000001E-4
9,test_20231031_152322,11079715.png,443815,143902,299913,0.6757612969367868,6,7,124136,19923,104213,0.8395066701037572,15.648172444444445,1795.6455946666667,15.588597364813907,115,6.000000000000001E-4
10,test_20231031_152322,11551286.png,271883,1027,270856,0.996222639885539,2,5,40092,149,39943,0.9962835478399681,16.744944,1644.067472,15.971607239923532,115,6.000000000000001E-4
1,test_20231031_152323,10404007.png,502730,34952,467778,0.9304756032064926,4,6,61265,5015,56250,0.918142495715335,24.602760888888888,3134.2652213333336,13.169446172075874,115,7.000000000000001E-4
2,test_20231031_152323,1254659.png,342646,93922,248724,0.7258920285075559,5,7,80080,12880,67200,0.8391608391608392,18.631841777777776,2575.038053333333,14.022967095370802,115,7.000000000000001E-4
3,test_20231031_152323,10188041.png,221231,12232,208999,0.944709376172417,3,5,41731,1715,40016,0.9589034530684623,10.10263111111111,912.3246826666667,18.529309361401197,115,7.000000000000001E-4
4,test_20231031_152323,10287332.png,216980,14797,202183,0.9318047746336068,3,6,22337,2016,20321,0.909746161078032,9.221587555555555,718.468656,19.56672534567697,115,7.000000000000001E-4
5,test_20231031_152323,11610969.png,368720,36682,332038,0.9005152961596876,4,6,84111,5328,78783,0.9366551342868352,18.225370666666667,2241.4289226666665,14.62555389240082,115,7.000000000000001E-4
6,test_20231031_152323,10350842.png,212614,8837,203777,0.9584364152877985,3,6,42529,1298,41231,0.9694796491805592,17.26299911111111,1915.9045386666667,15.30706494623887,115,7.000000000000001E-4
7,test_20231031_152323,10863862.png,317432,18917,298515,0.940406134227173,3,6,66058,2662,63396,0.9597020799903115,21.97788088888889,2776.3364373333334,13.696082679525237,115,7.000000000000001E-4
8,test_20231031_152323,11382381.png,312486,1269,311217,0.9959390180680094,3,6,46745,168,46577,0.9964060327307733,20.015262222222223,2158.15816,14.789970922085507,115,7.000000000000001E-4
9,test_20231031_152323,11079715.png,443815,143902,299913,0.6757612969367868,5,7,124136,19923,104213,0.8395066701037572,15.648172444444445,1795.6455946666667,15.588597364813907,115,7.000000000000001E-4
10,test_20231031_152323,11551286.png,271883,1027,270856,0.996222639885539,3,6,40092,149,39943,0.9962835478399681,16.744944,1644.067472,15.971607239923532,115,7.000000000000001E-4
1,test_20231031_152324,10404007.png,502730,34732,467998,0.9309132138523661,4,6,61265,4985,56280,0.9186321717130499,24.61616,3136.5619626666667,13.166264894382326,115,8.000000000000001E-4
2,test_20231031_152324,1254659.png,342646,93922,248724,0.7258920285075559,5,6,80080,12880,67200,0.8391608391608392,18.631841777777776,2575.038053333333,14.022967095370802,115,8.000000000000001E-4
3,test_20231031_152324,10188041.png,221231,12012,209219,0.9457038118527693,4,5,41731,1687,40044,0.9595744170999976,10.35578311111111,939.45632,18.402037684739067,115,8.000000000000001E-4
4,test_20231031_152324,10287332.png,216980,14797,202183,0.9318047746336068,3,6,22337,2016,20321,0.909746161078032,9.221587555555555,718.468656,19.56672534567697,115,8.000000000000001E-4
5,test_20231031_152324,11610969.png,368720,36682,332038,0.9005152961596876,3,13,84111,5328,78783,0.9366551342868352,18.225370666666667,2241.4289226666665,14.62555389240082,115,8.000000000000001E-4
6,test_20231031_152324,10350842.png,212614,8474,204140,0.9601437346552908,2,5,42529,1245,41284,0.970725857650074,18.19317511111111,2131.319248,14.844318537814418,115,8.000000000000001E-4
7,test_20231031_152324,10863862.png,317432,18837,298595,0.9406581567075784,3,6,66058,2650,63408,0.9598837385328045,22.019790222222223,2778.047136,13.693407505926526,115,8.000000000000001E-4
8,test_20231031_152324,11382381.png,312486,1209,311277,0.9961310266699949,3,9,46745,159,46586,0.9965985666916247,20.342206222222224,2224.57288,14.658337224793453,115,8.000000000000001E-4
9,test_20231031_152324,11079715.png,443815,143902,299913,0.6757612969367868,7,7,124136,19923,104213,0.8395066701037572,15.648172444444445,1795.6455946666667,15.588597364813907,115,8.000000000000001E-4
10,test_20231031_152324,11551286.png,271883,967,270916,0.996443323047046,3,6,40092,140,39952,0.9965080315274868,16.948922666666668,1679.7483893333333,15.878361275395243,115,8.000000000000001E-4
1,test_20231031_152325,10404007.png,502730,34732,467998,0.9309132138523661,4,6,61265,4985,56280,0.9186321717130499,24.61616,3136.5619626666667,13.166264894382326,115,9.000000000000002E-4
2,test_20231031_152325,1254659.png,342646,93922,248724,0.7258920285075559,5,6,80080,12880,67200,0.8391608391608392,18.631841777777776,2575.038053333333,14.022967095370802,115,9.000000000000002E-4
3,test_20231031_152325,10188041.png,221231,12012,209219,0.9457038118527693,3,6,41731,1687,40044,0.9595744170999976,10.35578311111111,939.45632,18.402037684739067,115,9.000000000000002E-4
4,test_20231031_152325,10287332.png,216980,14797,202183,0.9318047746336068,2,5,22337,2016,20321,0.909746161078032,9.221587555555555,718.468656,19.56672534567697,115,9.000000000000002E-4
5,test_20231031_152325,11610969.png,368720,36682,332038,0.9005152961596876,4,6,84111,5328,78783,0.9366551342868352,18.225370666666667,2241.4289226666665,14.62555389240082,115,9.000000000000002E-4
6,test_20231031_152325,10350842.png,212614,8474,204140,0.9601437346552908,2,6,42529,1245,41284,0.970725857650074,18.19317511111111,2131.319248,14.844318537814418,115,9.000000000000002E-4
7,test_20231031_152325,10863862.png,317432,18837,298595,0.9406581567075784,3,8,66058,2650,63408,0.9598837385328045,22.019790222222223,2778.047136,13.693407505926526,115,9.000000000000002E-4
8,test_20231031_152325,11382381.png,312486,1209,311277,0.9961310266699949,2,7,46745,159,46586,0.9965985666916247,20.342206222222224,2224.57288,14.658337224793453,115,9.000000000000002E-4
9,test_20231031_152325,11079715.png,443815,143902,299913,0.6757612969367868,6,7,124136,19923,104213,0.8395066701037572,15.648172444444445,1795.6455946666667,15.588597364813907,115,9.000000000000002E-4
10,test_20231031_152325,11551286.png,271883,967,270916,0.996443323047046,3,6,40092,140,39952,0.9965080315274868,16.948922666666668,1679.7483893333333,15.878361275395243,115,9.000000000000002E-4
1,test_20231031_152326,10404007.png,502730,33867,468863,0.9326338193463688,6,6,61265,4871,56394,0.9204929405043663,24.675075555555555,3148.5785386666666,13.149658299809365,115,0.0010000000000000002
2,test_20231031_152326,1254659.png,342646,93537,249109,0.7270156371298658,5,7,80080,12840,67240,0.8396603396603397,18.977285333333334,2648.892912,13.900159596365757,115,0.0010000000000000002
3,test_20231031_152326,10188041.png,221231,11872,209359,0.946336634558448,3,6,41731,1668,40063,0.9600297141213966,10.438599111111111,954.93472,18.331066769415408,115,0.0010000000000000002
4,test_20231031_152326,10287332.png,216980,14737,202243,0.9320812978154669,2,5,22337,2007,20330,0.9101490800017907,9.224336,719.9090826666667,19.55802708032955,115,0.0010000000000000002
5,test_20231031_152326,11610969.png,368720,36059,332661,0.9022049251464526,4,6,84111,5246,78865,0.9376300364993877,18.403898666666667,2271.945178666667,14.566825130938067,115,0.0010000000000000002
6,test_20231031_152326,10350842.png,212614,8232,204382,0.9612819475669523,2,6,42529,1209,41320,0.9715723388746502,18.298899555555554,2148.356112,14.809740891207452,115,0.0010000000000000002
7,test_20231031_152326,10863862.png,317432,17992,299440,0.9433201441568588,4,6,66058,2530,63528,0.9617003239577341,22.356796444444445,2864.82896,13.559816626432365,115,0.0010000000000000002
8,test_20231031_152326,11382381.png,312486,1189,311297,0.9961950295373233,2,11,46745,157,46588,0.9966413520162585,20.383205333333333,2228.884208,14.649928536855052,115,0.0010000000000000002
9,test_20231031_152326,11079715.png,443815,143822,299993,0.6759415522233363,5,7,124136,19916,104220,0.8395630598698202,15.661232,1796.8879413333334,15.585593666626849,115,0.0010000000000000002
10,test_20231031_152326,11551286.png,271883,567,271316,0.9979145441237591,2,6,40092,82,40010,0.9979547041803851,17.276152888888888,1748.0048746666666,15.705377214494561,115,0.0010000000000000002
1,test_20231031_152327,10404007.png,502730,33647,469083,0.9330714299922424,4,6,61265,4841,56424,0.9209826165020811,24.693548444444446,3151.9607413333333,13.144995612916619,115,0.0011000000000000003
2,test_20231031_152327,1254659.png,342646,93537,249109,0.7270156371298658,5,6,80080,12840,67240,0.8396603396603397,18.977285333333334,2648.892912,13.900159596365757,115,0.0011000000000000003
3,test_20231031_152327,10188041.png,221231,11752,209479,0.9468790540204582,3,6,41731,1654,40077,0.9603651961371642,10.486183111111112,960.163584,18.30735130353031,115,0.0011000000000000003
4,test_20231031_152327,10287332.png,216980,14737,202243,0.9320812978154669,3,6,22337,2007,20330,0.9101490800017907,9.224336,719.9090826666667,19.55802708032955,115,0.0011000000000000003
5,test_20231031_152327,11610969.png,368720,35997,332723,0.9023730744196138,4,16,84111,5239,78872,0.9377132598589959,18.736147555555554,2346.3134133333333,14.426943374916423,115,0.0011000000000000003
6,test_20231031_152327,10350842.png,212614,8232,204382,0.9612819475669523,3,6,42529,1209,41320,0.9715723388746502,18.298899555555554,2148.356112,14.809740891207452,115,0.0011000000000000003
7,test_20231031_152327,10863862.png,317432,17992,299440,0.9433201441568588,3,6,66058,2530,63528,0.9617003239577341,22.356796444444445,2864.82896,13.559816626432365,115,0.0011000000000000003
8,test_20231031_152327,11382381.png,312486,1189,311297,0.9961950295373233,3,5,46745,157,46588,0.9966413520162585,20.383205333333333,2228.884208,14.649928536855052,115,0.0011000000000000003
9,test_20231031_152327,11079715.png,443815,143822,299993,0.6759415522233363,6,7,124136,19916,104220,0.8395630598698202,15.661232,1796.8879413333334,15.585593666626849,115,0.0011000000000000003
10,test_20231031_152327,11551286.png,271883,567,271316,0.9979145441237591,2,6,40092,82,40010,0.9979547041803851,17.276152888888888,1748.0048746666666,15.705377214494561,115,0.0011000000000000003
1,test_20231031_152328,10404007.png,502730,33647,469083,0.9330714299922424,4,6,61265,4841,56424,0.9209826165020811,24.693548444444446,3151.9607413333333,13.144995612916619,115,0.0012000000000000003
2,test_20231031_152328,1254659.png,342646,93537,249109,0.7270156371298658,4,6,80080,12840,67240,0.8396603396603397,18.977285333333334,2648.892912,13.900159596365757,115,0.0012000000000000003
3,test_20231031_152328,10188041.png,221231,11752,209479,0.9468790540204582,3,5,41731,1654,40077,0.9603651961371642,10.486183111111112,960.163584,18.30735130353031,115,0.0012000000000000003
4,test_20231031_152328,10287332.png,216980,14737,202243,0.9320812978154669,2,5,22337,2007,20330,0.9101490800017907,9.224336,719.9090826666667,19.55802708032955,115,0.0012000000000000003
5,test_20231031_152328,11610969.png,368720,35997,332723,0.9023730744196138,4,6,84111,5239,78872,0.9377132598589959,18.736147555555554,2346.3134133333333,14.426943374916423,115,0.0012000000000000003
6,test_20231031_152328,10350842.png,212614,8232,204382,0.9612819475669523,3,6,42529,1209,41320,0.9715723388746502,18.298899555555554,2148.356112,14.809740891207452,115,0.0012000000000000003
7,test_20231031_152328,10863862.png,317432,17992,299440,0.9433201441568588,3,6,66058,2530,63528,0.9617003239577341,22.356796444444445,2864.82896,13.559816626432365,115,0.0012000000000000003
8,test_20231031_152328,11382381.png,312486,1189,311297,0.9961950295373233,3,5,46745,157,46588,0.9966413520162585,20.383205333333333,2228.884208,14.649928536855052,115,0.0012000000000000003
9,test_20231031_152328,11079715.png,443815,143822,299993,0.6759415522233363,6,7,124136,19916,104220,0.8395630598698202,15.661232,1796.8879413333334,15.585593666626849,115,0.0012000000000000003
10,test_20231031_152328,11551286.png,271883,567,271316,0.9979145441237591,3,5,40092,82,40010,0.9979547041803851,17.276152888888888,1748.0048746666666,15.705377214494561,115,0.0012000000000000003
1,test_20231031_152329,10404007.png,502730,33207,469523,0.9339466512839895,4,6,61265,4779,56486,0.9219946135640251,24.726805333333335,3159.321792,13.134864977445119,115,0.0013000000000000004
2,test_20231031_152329,1254659.png,342646,93537,249109,0.7270156371298658,5,6,80080,12840,67240,0.8396603396603397,18.977285333333334,2648.892912,13.900159596365757,115,0.0013000000000000004
3,test_20231031_152329,10188041.png,221231,11612,209619,0.9475118767261369,4,7,41731,1633,40098,0.9608684191608157,10.581262222222222,984.213728,18.19990942505687,115,0.0013000000000000004
4,test_20231031_152329,10287332.png,216980,14574,202406,0.9328325191261867,2,6,22337,1985,20352,0.9111339929265344,9.292357333333333,730.9595146666667,19.491870373215058,115,0.0013000000000000004
5,test_20231031_152329,11610969.png,368720,35977,332743,0.9024273161206335,4,6,84111,5236,78875,0.9377489270131136,18.765957333333333,2349.3849866666665,14.421261717254223,115,0.0013000000000000004
6,test_20231031_152329,10350842.png,212614,8052,204562,0.9621285522119898,2,6,42529,1182,41347,0.9722071997930823,18.671980444444443,2217.851376,14.67147921284592,115,0.0013000000000000004
7,test_20231031_152329,10863862.png,317432,17992,299440,0.9433201441568588,3,5,66058,2530,63528,0.9617003239577341,22.356796444444445,2864.82896,13.559816626432365,115,0.0013000000000000004
8,test_20231031_152329,11382381.png,312486,1189,311297,0.9961950295373233,3,6,46745,157,46588,0.9966413520162585,20.383205333333333,2228.884208,14.649928536855052,115,0.0013000000000000004
9,test_20231031_152329,11079715.png,443815,143822,299993,0.6759415522233363,5,7,124136,19916,104220,0.8395630598698202,15.661232,1796.8879413333334,15.585593666626849,115,0.0013000000000000004
10,test_20231031_152329,11551286.png,271883,567,271316,0.9979145441237591,2,5,40092,82,40010,0.9979547041803851,17.276152888888888,1748.0048746666666,15.705377214494561,115,0.0013000000000000004
1,test_20231031_152330,10404007.png,502730,33184,469546,0.9339924014878762,3,5,61265,4777,56488,0.9220272586305395,24.791936,3173.7618986666666,13.115060187811412,115,0.0014000000000000004
2,test_20231031_152330,1254659.png,342646,93537,249109,0.7270156371298658,5,7,80080,12840,67240,0.8396603396603397,18.977285333333334,2648.892912,13.900159596365757,115,0.0014000000000000004
3,test_20231031_152330,10188041.png,221231,11612,209619,0.9475118767261369,3,5,41731,1633,40098,0.9608684191608157,10.581262222222222,984.213728,18.19990942505687,115,0.0014000000000000004
4,test_20231031_152330,10287332.png,216980,14574,202406,0.9328325191261867,3,6,22337,1985,20352,0.9111339929265344,9.292357333333333,730.9595146666667,19.491870373215058,115,0.0014000000000000004
5,test_20231031_152330,11610969.png,368720,35977,332743,0.9024273161206335,4,6,84111,5236,78875,0.9377489270131136,18.765957333333333,2349.3849866666665,14.421261717254223,115,0.0014000000000000004
6,test_20231031_152330,10350842.png,212614,8052,204562,0.9621285522119898,3,19,42529,1182,41347,0.9722071997930823,18.671980444444443,2217.851376,14.67147921284592,115,0.0014000000000000004
7,test_20231031_152330,10863862.png,317432,17992,299440,0.9433201441568588,4,6,66058,2530,63528,0.9617003239577341,22.356796444444445,2864.82896,13.559816626432365,115,0.0014000000000000004
8,test_20231031_152330,11382381.png,312486,1049,311437,0.9966430496086225,2,6,46745,136,46609,0.9970905979249117,21.32126577777778,2423.943648,14.28557841762738,115,0.0014000000000000004
9,test_20231031_152330,11079715.png,443815,143822,299993,0.6759415522233363,6,7,124136,19916,104220,0.8395630598698202,15.661232,1796.8879413333334,15.585593666626849,115,0.0014000000000000004
10,test_20231031_152330,11551286.png,271883,567,271316,0.9979145441237591,2,6,40092,82,40010,0.9979547041803851,17.276152888888888,1748.0048746666666,15.705377214494561,115,0.0014000000000000004
1,test_20231031_152331,10404007.png,502730,33867,468863,0.9326338193463688,3,6,61265,4864,56401,0.9206071982371664,24.629676444444446,3146.2855093333333,13.152822307872965,116,1.0E-4
2,test_20231031_152331,1254659.png,342646,91799,250847,0.7320879274820077,4,6,80080,12601,67479,0.8426448551448551,18.810426666666668,2627.3261706666667,13.935663690382661,116,1.0E-4
3,test_20231031_152331,10188041.png,221231,11972,209259,0.9458846183401061,3,5,41731,1678,40053,0.959790084110134,9.876396444444444,878.3562293333333,18.694096751924906,116,1.0E-4
4,test_20231031_152331,10287332.png,216980,14797,202183,0.9318047746336068,2,5,22337,2014,20323,0.909835698616645,9.057381333333334,687.1478773333333,19.760301516119938,116,1.0E-4
5,test_20231031_152331,11610969.png,368720,35727,332993,0.9031053373833804,4,6,84111,5190,78921,0.9382958233762528,18.311834666666666,2264.81592,14.580474517274604,116,1.0E-4
6,test_20231031_152331,10350842.png,212614,8637,203977,0.959377087115618,2,5,42529,1270,41259,0.9701380234663406,16.81530311111111,1819.8883306666667,15.530356206098393,116,1.0E-4
7,test_20231031_152331,10863862.png,317432,18352,299080,0.9421860429950352,3,5,66058,2586,63472,0.960852584092767,21.802058666666667,2790.8487466666666,13.673440608422089,116,1.0E-4
8,test_20231031_152331,11382381.png,312486,1802,310684,0.9942333416537061,2,5,46745,245,46500,0.9947587977323777,18.117850666666666,1846.9126346666667,15.466340085676595,116,1.0E-4
9,test_20231031_152331,11079715.png,443815,141952,301863,0.6801550195464326,5,7,124136,19664,104472,0.8415930914480891,15.445934222222222,1768.086976,15.655767357860086,116,1.0E-4
10,test_20231031_152331,11551286.png,271883,1582,270301,0.9941813206415995,2,6,40092,231,39861,0.9942382520203532,15.632876444444445,1452.8704266666666,16.508534771224895,116,1.0E-4
1,test_20231031_152332,10404007.png,502730,33867,468863,0.9326338193463688,4,6,61265,4864,56401,0.9206071982371664,24.629676444444446,3146.2855093333333,13.152822307872965,116,2.0E-4
2,test_20231031_152332,1254659.png,342646,91799,250847,0.7320879274820077,4,6,80080,12601,67479,0.8426448551448551,18.810426666666668,2627.3261706666667,13.935663690382661,116,2.0E-4
3,test_20231031_152332,10188041.png,221231,11972,209259,0.9458846183401061,3,5,41731,1678,40053,0.959790084110134,9.876396444444444,878.3562293333333,18.694096751924906,116,2.0E-4
4,test_20231031_152332,10287332.png,216980,14544,202436,0.9329707807171168,3,6,22337,1984,20353,0.911178761695841,9.188432,714.198928,19.59261166879019,116,2.0E-4
5,test_20231031_152332,11610969.png,368720,35727,332993,0.9031053373833804,4,6,84111,5190,78921,0.9382958233762528,18.311834666666666,2264.81592,14.580474517274604,116,2.0E-4
6,test_20231031_152332,10350842.png,212614,8637,203977,0.959377087115618,3,6,42529,1270,41259,0.9701380234663406,16.81530311111111,1819.8883306666667,15.530356206098393,116,2.0E-4
7,test_20231031_152332,10863862.png,317432,18352,299080,0.9421860429950352,3,5,66058,2586,63472,0.960852584092767,21.802058666666667,2790.8487466666666,13.673440608422089,116,2.0E-4
8,test_20231031_152332,11382381.png,312486,1662,310824,0.9946813617250053,3,6,46745,224,46521,0.9952080436410311,18.958577777777776,1992.2935466666668,15.137270326511574,116,2.0E-4
9,test_20231031_152332,11079715.png,443815,141952,301863,0.6801550195464326,6,7,124136,19664,104472,0.8415930914480891,15.445934222222222,1768.086976,15.655767357860086,116,2.0E-4
10,test_20231031_152332,11551286.png,271883,1582,270301,0.9941813206415995,2,5,40092,231,39861,0.9942382520203532,15.632876444444445,1452.8704266666666,16.508534771224895,116,2.0E-4
1,test_20231031_152333,10404007.png,502730,33787,468943,0.9327929504903228,4,6,61265,4852,56413,0.9208030686362524,24.66345777777778,3152.1797493333333,13.144693862135295,116,3.0000000000000003E-4
2,test_20231031_152333,1254659.png,342646,91719,250927,0.7323214045983317,5,7,80080,12594,67486,0.8427322677322677,18.822373333333335,2628.744101333333,13.933320496904166,116,3.0000000000000003E-4
3,test_20231031_152333,10188041.png,221231,11892,209339,0.9462462313147796,3,5,41731,1666,40065,0.960077640123649,10.029598222222223,898.9716853333333,18.59334347774442,116,3.0000000000000003E-4
4,test_20231031_152333,10287332.png,216980,14524,202456,0.9330629551110702,3,6,22337,1981,20356,0.9113130680037606,9.259774222222223,726.953744,19.51573583247749,116,3.0000000000000003E-4
5,test_20231031_152333,11610969.png,368720,35727,332993,0.9031053373833804,4,6,84111,5190,78921,0.9382958233762528,18.311834666666666,2264.81592,14.580474517274604,116,3.0000000000000003E-4
6,test_20231031_152333,10350842.png,212614,8537,204077,0.9598474230295277,3,14,42529,1255,41274,0.9704907239765806,16.884917333333334,1825.9013013333333,15.516030627215432,116,3.0000000000000003E-4
7,test_20231031_152333,10863862.png,317432,18172,299260,0.9427530935759469,3,6,66058,2561,63497,0.9612310393896273,22.22465777777778,2848.9721173333332,13.58392162013667,116,3.0000000000000003E-4
8,test_20231031_152333,11382381.png,312486,1642,310844,0.9947453645923338,3,6,46745,221,46524,0.9952722216279816,19.05557688888889,2014.7817173333333,15.08852359568316,116,3.0000000000000003E-4
9,test_20231031_152333,11079715.png,443815,141772,302043,0.6805605939411692,7,7,124136,19641,104495,0.8417783721080105,15.759267555555555,1820.7535573333334,15.528291937293258,116,3.0000000000000003E-4
10,test_20231031_152333,11551286.png,271883,1562,270321,0.9942548816954352,2,5,40092,228,39864,0.9943130799161928,15.714974222222223,1476.556624,16.438302546266087,116,3.0000000000000003E-4
1,test_20231031_152334,10404007.png,502730,33787,468943,0.9327929504903228,4,6,61265,4852,56413,0.9208030686362524,24.66345777777778,3152.1797493333333,13.144693862135295,116,4.0E-4
2,test_20231031_152334,1254659.png,342646,91719,250927,0.7323214045983317,5,7,80080,12594,67486,0.8427322677322677,18.822373333333335,2628.744101333333,13.933320496904166,116,4.0E-4
3,test_20231031_152334,10188041.png,221231,11892,209339,0.9462462313147796,3,6,41731,1666,40065,0.960077640123649,10.029598222222223,898.9716853333333,18.59334347774442,116,4.0E-4
4,test_20231031_152334,10287332.png,216980,14524,202456,0.9330629551110702,2,5,22337,1981,20356,0.9113130680037606,9.259774222222223,726.953744,19.51573583247749,116,4.0E-4
5,test_20231031_152334,11610969.png,368720,35727,332993,0.9031053373833804,4,6,84111,5190,78921,0.9382958233762528,18.311834666666666,2264.81592,14.580474517274604,116,4.0E-4
6,test_20231031_152334,10350842.png,212614,8537,204077,0.9598474230295277,3,6,42529,1255,41274,0.9704907239765806,16.884917333333334,1825.9013013333333,15.516030627215432,116,4.0E-4
7,test_20231031_152334,10863862.png,317432,18172,299260,0.9427530935759469,3,6,66058,2561,63497,0.9612310393896273,22.22465777777778,2848.9721173333332,13.58392162013667,116,4.0E-4
8,test_20231031_152334,11382381.png,312486,1249,311237,0.9960030209353379,2,6,46745,165,46580,0.9964702107177238,20.03434488888889,2161.3748106666667,14.783502751093609,116,4.0E-4
9,test_20231031_152334,11079715.png,443815,141772,302043,0.6805605939411692,6,7,124136,19641,104495,0.8417783721080105,15.759267555555555,1820.7535573333334,15.528291937293258,116,4.0E-4
10,test_20231031_152334,11551286.png,271883,1382,270501,0.994916931179956,2,5,40092,201,39891,0.9949865309787489,16.274922666666665,1573.1751893333333,16.16303272367802,116,4.0E-4
1,test_20231031_152335,10404007.png,502730,33787,468943,0.9327929504903228,4,6,61265,4852,56413,0.9208030686362524,24.66345777777778,3152.1797493333333,13.144693862135295,116,5.0E-4
2,test_20231031_152335,1254659.png,342646,91719,250927,0.7323214045983317,5,6,80080,12594,67486,0.8427322677322677,18.822373333333335,2628.744101333333,13.933320496904166,116,5.0E-4
3,test_20231031_152335,10188041.png,221231,11892,209339,0.9462462313147796,3,5,41731,1666,40065,0.960077640123649,10.029598222222223,898.9716853333333,18.59334347774442,116,5.0E-4
4,test_20231031_152335,10287332.png,216980,14524,202456,0.9330629551110702,8,6,22337,1981,20356,0.9113130680037606,9.259774222222223,726.953744,19.51573583247749,116,5.0E-4
5,test_20231031_152335,11610969.png,368720,35727,332993,0.9031053373833804,4,6,84111,5190,78921,0.9382958233762528,18.311834666666666,2264.81592,14.580474517274604,116,5.0E-4
6,test_20231031_152335,10350842.png,212614,8537,204077,0.9598474230295277,2,6,42529,1255,41274,0.9704907239765806,16.884917333333334,1825.9013013333333,15.516030627215432,116,5.0E-4
7,test_20231031_152335,10863862.png,317432,18172,299260,0.9427530935759469,3,6,66058,2561,63497,0.9612310393896273,22.22465777777778,2848.9721173333332,13.58392162013667,116,5.0E-4
8,test_20231031_152335,11382381.png,312486,1249,311237,0.9960030209353379,3,6,46745,165,46580,0.9964702107177238,20.03434488888889,2161.3748106666667,14.783502751093609,116,5.0E-4
9,test_20231031_152335,11079715.png,443815,141772,302043,0.6805605939411692,6,7,124136,19641,104495,0.8417783721080105,15.759267555555555,1820.7535573333334,15.528291937293258,116,5.0E-4
10,test_20231031_152335,11551286.png,271883,1049,270834,0.9961417227263197,2,5,40092,152,39940,0.9962087199441285,16.558597333333335,1617.841712,16.04144332446876,116,5.0E-4
1,test_20231031_152336,10404007.png,502730,33787,468943,0.9327929504903228,4,6,61265,4852,56413,0.9208030686362524,24.66345777777778,3152.1797493333333,13.144693862135295,116,6.000000000000001E-4
2,test_20231031_152336,1254659.png,342646,91699,250947,0.7323797738774128,5,7,80080,12591,67489,0.8427697302697302,18.835500444444445,2629.94168,13.931342429237844,116,6.000000000000001E-4
3,test_20231031_152336,10188041.png,221231,11832,209399,0.9465174410457847,3,6,41731,1657,40074,0.9602933071337855,10.149989333333334,922.614064,18.48060290314891,116,6.000000000000001E-4
4,test_20231031_152336,10287332.png,216980,14524,202456,0.9330629551110702,2,6,22337,1981,20356,0.9113130680037606,9.259774222222223,726.953744,19.51573583247749,116,6.000000000000001E-4
5,test_20231031_152336,11610969.png,368720,35727,332993,0.9031053373833804,4,6,84111,5190,78921,0.9382958233762528,18.311834666666666,2264.81592,14.580474517274604,116,6.000000000000001E-4
6,test_20231031_152336,10350842.png,212614,8434,204180,0.9603318690208547,3,6,42529,1240,41289,0.9708434244868207,17.349187555555556,1934.122336,15.265964205059156,116,6.000000000000001E-4
7,test_20231031_152336,10863862.png,317432,18172,299260,0.9427530935759469,3,5,66058,2561,63497,0.9612310393896273,22.22465777777778,2848.9721173333332,13.58392162013667,116,6.000000000000001E-4
8,test_20231031_152336,11382381.png,312486,1249,311237,0.9960030209353379,3,5,46745,165,46580,0.9964702107177238,20.03434488888889,2161.3748106666667,14.783502751093609,116,6.000000000000001E-4
9,test_20231031_152336,11079715.png,443815,141772,302043,0.6805605939411692,6,7,124136,19641,104495,0.8417783721080105,15.759267555555555,1820.7535573333334,15.528291937293258,116,6.000000000000001E-4
10,test_20231031_152336,11551286.png,271883,927,270956,0.9965904451547173,3,5,40092,134,39958,0.9966576873191659,16.746789333333332,1644.6409546666666,15.97009260057086,116,6.000000000000001E-4
1,test_20231031_152337,10404007.png,502730,33787,468943,0.9327929504903228,4,6,61265,4852,56413,0.9208030686362524,24.66345777777778,3152.1797493333333,13.144693862135295,116,7.000000000000001E-4
2,test_20231031_152337,1254659.png,342646,91699,250947,0.7323797738774128,6,6,80080,12591,67489,0.8427697302697302,18.835500444444445,2629.94168,13.931342429237844,116,7.000000000000001E-4
3,test_20231031_152337,10188041.png,221231,11832,209399,0.9465174410457847,4,5,41731,1657,40074,0.9602933071337855,10.149989333333334,922.614064,18.48060290314891,116,7.000000000000001E-4
4,test_20231031_152337,10287332.png,216980,14524,202456,0.9330629551110702,3,6,22337,1981,20356,0.9113130680037606,9.259774222222223,726.953744,19.51573583247749,116,7.000000000000001E-4
5,test_20231031_152337,11610969.png,368720,35727,332993,0.9031053373833804,4,6,84111,5190,78921,0.9382958233762528,18.311834666666666,2264.81592,14.580474517274604,116,7.000000000000001E-4
6,test_20231031_152337,10350842.png,212614,8434,204180,0.9603318690208547,3,6,42529,1240,41289,0.9708434244868207,17.349187555555556,1934.122336,15.265964205059156,116,7.000000000000001E-4
7,test_20231031_152337,10863862.png,317432,18172,299260,0.9427530935759469,3,5,66058,2561,63497,0.9612310393896273,22.22465777777778,2848.9721173333332,13.58392162013667,116,7.000000000000001E-4
8,test_20231031_152337,11382381.png,312486,1249,311237,0.9960030209353379,3,6,46745,165,46580,0.9964702107177238,20.03434488888889,2161.3748106666667,14.783502751093609,116,7.000000000000001E-4
9,test_20231031_152337,11079715.png,443815,141772,302043,0.6805605939411692,8,7,124136,19641,104495,0.8417783721080105,15.759267555555555,1820.7535573333334,15.528291937293258,116,7.000000000000001E-4
10,test_20231031_152337,11551286.png,271883,927,270956,0.9965904451547173,2,6,40092,134,39958,0.9966576873191659,16.746789333333332,1644.6409546666666,15.97009260057086,116,7.000000000000001E-4
1,test_20231031_152338,10404007.png,502730,33427,469303,0.9335090406381159,4,6,61265,4802,56463,0.9216191952991104,24.694835555555557,3157.8188106666666,13.136931534303173,116,8.000000000000001E-4
2,test_20231031_152338,1254659.png,342646,91699,250947,0.7323797738774128,5,7,80080,12591,67489,0.8427697302697302,18.835500444444445,2629.94168,13.931342429237844,116,8.000000000000001E-4
3,test_20231031_152338,10188041.png,221231,11612,209619,0.9475118767261369,3,13,41731,1629,40102,0.9609642711653208,10.403141333333334,949.7457013333334,18.35473024307315,116,8.000000000000001E-4
4,test_20231031_152338,10287332.png,216980,14524,202456,0.9330629551110702,3,5,22337,1981,20356,0.9113130680037606,9.259774222222223,726.953744,19.51573583247749,116,8.000000000000001E-4
5,test_20231031_152338,11610969.png,368720,35447,333273,0.9038647211976567,4,7,84111,5151,78960,0.9387594963797838,18.76879466666667,2361.6078986666666,14.398725681751614,116,8.000000000000001E-4
6,test_20231031_152338,10350842.png,212614,8092,204522,0.9619404178464259,3,6,42529,1190,41339,0.9720190928542877,18.278197333333335,2149.2323306666667,14.80796995877768,116,8.000000000000001E-4
7,test_20231031_152338,10863862.png,317432,18092,299340,0.9430051160563522,3,6,66058,2549,63509,0.9614126979321203,22.26656711111111,2850.682816,13.581314630688599,116,8.000000000000001E-4
8,test_20231031_152338,11382381.png,312486,1069,311417,0.996579046741294,2,6,46745,138,46607,0.9970478126002781,21.280266666666666,2419.63232,14.293309839481578,116,8.000000000000001E-4
9,test_20231031_152338,11079715.png,443815,141772,302043,0.6805605939411692,6,7,124136,19641,104495,0.8417783721080105,15.759267555555555,1820.7535573333334,15.528291937293258,116,8.000000000000001E-4
10,test_20231031_152338,11551286.png,271883,867,271016,0.9968111283162242,2,5,40092,125,39967,0.9968821710066846,16.950768,1680.321872,15.876878804252392,116,8.000000000000001E-4
1,test_20231031_152340,10404007.png,502730,33427,469303,0.9335090406381159,4,5,61265,4802,56463,0.9216191952991104,24.694835555555557,3157.8188106666666,13.136931534303173,116,9.000000000000002E-4
2,test_20231031_152340,1254659.png,342646,91699,250947,0.7323797738774128,5,7,80080,12591,67489,0.8427697302697302,18.835500444444445,2629.94168,13.931342429237844,116,9.000000000000002E-4
3,test_20231031_152340,10188041.png,221231,11612,209619,0.9475118767261369,4,6,41731,1629,40102,0.9609642711653208,10.403141333333334,949.7457013333334,18.35473024307315,116,9.000000000000002E-4
4,test_20231031_152340,10287332.png,216980,14524,202456,0.9330629551110702,3,6,22337,1981,20356,0.9113130680037606,9.259774222222223,726.953744,19.51573583247749,116,9.000000000000002E-4
5,test_20231031_152340,11610969.png,368720,35447,333273,0.9038647211976567,5,6,84111,5151,78960,0.9387594963797838,18.76879466666667,2361.6078986666666,14.398725681751614,116,9.000000000000002E-4
6,test_20231031_152340,10350842.png,212614,8092,204522,0.9619404178464259,2,6,42529,1190,41339,0.9720190928542877,18.278197333333335,2149.2323306666667,14.80796995877768,116,9.000000000000002E-4
7,test_20231031_152340,10863862.png,317432,18092,299340,0.9430051160563522,9,5,66058,2549,63509,0.9614126979321203,22.26656711111111,2850.682816,13.581314630688599,116,9.000000000000002E-4
8,test_20231031_152340,11382381.png,312486,1069,311417,0.996579046741294,2,5,46745,138,46607,0.9970478126002781,21.280266666666666,2419.63232,14.293309839481578,116,9.000000000000002E-4
9,test_20231031_152340,11079715.png,443815,141772,302043,0.6805605939411692,7,7,124136,19641,104495,0.8417783721080105,15.759267555555555,1820.7535573333334,15.528291937293258,116,9.000000000000002E-4
10,test_20231031_152340,11551286.png,271883,627,271256,0.9976938609622521,2,5,40092,91,40001,0.9977302204928664,17.18488888888889,1728.3928213333334,15.754379070136029,116,9.000000000000002E-4
1,test_20231031_152341,10404007.png,502730,32482,470248,0.9353887772760726,5,6,61265,4676,56589,0.9236758344895127,24.755056,3170.4136373333336,13.119644334475693,116,0.0010000000000000002
2,test_20231031_152341,1254659.png,342646,91237,251409,0.7337281042241848,5,6,80080,12539,67541,0.8434190809190809,19.238501333333332,2717.9233013333333,13.78843163908408,116,0.0010000000000000002
3,test_20231031_152341,10188041.png,221231,11409,209822,0.948429469649371,3,5,41731,1607,40124,0.9614914571900985,10.555212444444445,977.8580426666666,18.228045487810526,116,0.0010000000000000002
4,test_20231031_152341,10287332.png,216980,14464,202516,0.9333394782929302,2,6,22337,1972,20365,0.9117159869275193,9.262522666666667,728.3941706666667,19.507138993867496,116,0.0010000000000000002
5,test_20231031_152341,11610969.png,368720,34942,333778,0.9052343241484053,4,6,84111,5088,79023,0.9395085066162571,18.98580088888889,2402.3705013333333,14.324403743388281,116,0.0010000000000000002
6,test_20231031_152341,10350842.png,212614,7932,204682,0.9626929553086815,2,5,42529,1166,41363,0.9725834136706718,18.4336,2178.3608,14.749505476741163,116,0.0010000000000000002
7,test_20231031_152341,10863862.png,317432,17529,299903,0.9447787242622042,3,6,66058,2470,63588,0.9626086166701989,22.472348444444446,2895.600768,13.513416777235879,116,0.0010000000000000002
8,test_20231031_152341,11382381.png,312486,1049,311437,0.9966430496086225,2,5,46745,136,46609,0.9970905979249117,21.32126577777778,2423.943648,14.28557841762738,116,0.0010000000000000002
9,test_20231031_152341,11079715.png,443815,141692,302123,0.6807408492277187,6,7,124136,19635,104501,0.8418267061932074,15.777998222222223,1823.6191466666667,15.521462175397689,116,0.0010000000000000002
10,test_20231031_152341,11551286.png,271883,527,271356,0.9980616662314304,2,6,40092,76,40016,0.9981043599720643,17.27745422222222,1748.2442026666668,15.70478264112391,116,0.0010000000000000002
1,test_20231031_152342,10404007.png,502730,32202,470528,0.9359457362799117,4,7,61265,4639,56626,0.9242797682200278,24.771313777777777,3173.869952,13.114912331201175,116,0.0011000000000000003
2,test_20231031_152342,1254659.png,342646,91237,251409,0.7337281042241848,6,7,80080,12539,67541,0.8434190809190809,19.238501333333332,2717.9233013333333,13.78843163908408,116,0.0011000000000000003
3,test_20231031_152342,10188041.png,221231,11287,209944,0.9489809294357482,3,5,41731,1593,40138,0.9618269392058661,10.602796444444444,983.0869066666667,18.20488448918332,116,0.0011000000000000003
4,test_20231031_152342,10287332.png,216980,14464,202516,0.9333394782929302,3,6,22337,1972,20365,0.9117159869275193,9.262522666666667,728.3941706666667,19.507138993867496,116,0.0011000000000000003
5,test_20231031_152342,11610969.png,368720,34622,334098,0.9061021913647211,4,6,84111,5041,79070,0.9400672920307689,19.479543111111113,2513.5601013333335,14.127910868338095,116,0.0011000000000000003
6,test_20231031_152342,10350842.png,212614,7752,204862,0.963539559953719,3,6,42529,1139,41390,0.9732182745891039,18.806680888888888,2247.856064,14.613118620722489,116,0.0011000000000000003
7,test_20231031_152342,10863862.png,317432,17529,299903,0.9447787242622042,3,11,66058,2470,63588,0.9626086166701989,22.472348444444446,2895.600768,13.513416777235879,116,0.0011000000000000003
8,test_20231031_152342,11382381.png,312486,1049,311437,0.9966430496086225,3,5,46745,136,46609,0.9970905979249117,21.32126577777778,2423.943648,14.28557841762738,116,0.0011000000000000003
9,test_20231031_152342,11079715.png,443815,141692,302123,0.6807408492277187,6,7,124136,19635,104501,0.8418267061932074,15.777998222222223,1823.6191466666667,15.521462175397689,116,0.0011000000000000003
10,test_20231031_152342,11551286.png,271883,527,271356,0.9980616662314304,2,16,40092,76,40016,0.9981043599720643,17.27745422222222,1748.2442026666668,15.70478264112391,116,0.0011000000000000003
1,test_20231031_152343,10404007.png,502730,31939,470791,0.9364688799156605,7,5,61265,4603,56662,0.9248673794172856,24.855854222222224,3192.616789333333,13.089335676856956,116,0.0012000000000000003
2,test_20231031_152343,1254659.png,342646,91237,251409,0.7337281042241848,5,6,80080,12539,67541,0.8434190809190809,19.238501333333332,2717.9233013333333,13.78843163908408,116,0.0012000000000000003
3,test_20231031_152343,10188041.png,221231,11287,209944,0.9489809294357482,4,13,41731,1593,40138,0.9618269392058661,10.602796444444444,983.0869066666667,18.20488448918332,116,0.0012000000000000003
4,test_20231031_152343,10287332.png,216980,14464,202516,0.9333394782929302,3,5,22337,1972,20365,0.9117159869275193,9.262522666666667,728.3941706666667,19.507138993867496,116,0.0012000000000000003
5,test_20231031_152343,11610969.png,368720,34622,334098,0.9061021913647211,4,6,84111,5041,79070,0.9400672920307689,19.479543111111113,2513.5601013333335,14.127910868338095,116,0.0012000000000000003
6,test_20231031_152343,10350842.png,212614,7752,204862,0.963539559953719,3,6,42529,1139,41390,0.9732182745891039,18.806680888888888,2247.856064,14.613118620722489,116,0.0012000000000000003
7,test_20231031_152343,10863862.png,317432,17529,299903,0.9447787242622042,4,5,66058,2470,63588,0.9626086166701989,22.472348444444446,2895.600768,13.513416777235879,116,0.0012000000000000003
8,test_20231031_152343,11382381.png,312486,1049,311437,0.9966430496086225,3,5,46745,136,46609,0.9970905979249117,21.32126577777778,2423.943648,14.28557841762738,116,0.0012000000000000003
9,test_20231031_152343,11079715.png,443815,141692,302123,0.6807408492277187,6,6,124136,19635,104501,0.8418267061932074,15.777998222222223,1823.6191466666667,15.521462175397689,116,0.0012000000000000003
10,test_20231031_152343,11551286.png,271883,527,271356,0.9980616662314304,2,5,40092,76,40016,0.9981043599720643,17.27745422222222,1748.2442026666668,15.70478264112391,116,0.0012000000000000003
1,test_20231031_152344,10404007.png,502730,31939,470791,0.9364688799156605,4,6,61265,4603,56662,0.9248673794172856,24.855854222222224,3192.616789333333,13.089335676856956,116,0.0013000000000000004
2,test_20231031_152344,1254659.png,342646,91237,251409,0.7337281042241848,5,7,80080,12539,67541,0.8434190809190809,19.238501333333332,2717.9233013333333,13.78843163908408,116,0.0013000000000000004
3,test_20231031_152344,10188041.png,221231,11147,210084,0.9496137521414268,3,6,41731,1572,40159,0.9623301622295176,10.697875555555555,1007.1370506666667,18.09991787734012,116,0.0013000000000000004
4,test_20231031_152344,10287332.png,216980,14302,202678,0.9340860908839524,2,6,22337,1950,20387,0.9127008998522631,9.330544,739.4446026666667,19.44174717568626,116,0.0013000000000000004
5,test_20231031_152344,11610969.png,368720,34622,334098,0.9061021913647211,4,6,84111,5041,79070,0.9400672920307689,19.479543111111113,2513.5601013333335,14.127910868338095,116,0.0013000000000000004
6,test_20231031_152344,10350842.png,212614,7752,204862,0.963539559953719,3,5,42529,1139,41390,0.9732182745891039,18.806680888888888,2247.856064,14.613118620722489,116,0.0013000000000000004
7,test_20231031_152344,10863862.png,317432,17529,299903,0.9447787242622042,3,6,66058,2470,63588,0.9626086166701989,22.472348444444446,2895.600768,13.513416777235879,116,0.0013000000000000004
8,test_20231031_152344,11382381.png,312486,1049,311437,0.9966430496086225,2,5,46745,136,46609,0.9970905979249117,21.32126577777778,2423.943648,14.28557841762738,116,0.0013000000000000004
9,test_20231031_152344,11079715.png,443815,141692,302123,0.6807408492277187,5,12,124136,19635,104501,0.8418267061932074,15.777998222222223,1823.6191466666667,15.521462175397689,116,0.0013000000000000004
10,test_20231031_152344,11551286.png,271883,507,271376,0.998135227285266,2,6,40092,73,40019,0.9981791878679038,17.982668444444446,1868.1795146666666,15.416617553103926,116,0.0013000000000000004
1,test_20231031_152345,10404007.png,502730,31939,470791,0.9364688799156605,4,6,61265,4603,56662,0.9248673794172856,24.855854222222224,3192.616789333333,13.089335676856956,116,0.0014000000000000004
2,test_20231031_152345,1254659.png,342646,91237,251409,0.7337281042241848,6,16,80080,12539,67541,0.8434190809190809,19.238501333333332,2717.9233013333333,13.78843163908408,116,0.0014000000000000004
3,test_20231031_152345,10188041.png,221231,11147,210084,0.9496137521414268,3,5,41731,1572,40159,0.9623301622295176,10.697875555555555,1007.1370506666667,18.09991787734012,116,0.0014000000000000004
4,test_20231031_152345,10287332.png,216980,14302,202678,0.9340860908839524,3,6,22337,1950,20387,0.9127008998522631,9.330544,739.4446026666667,19.44174717568626,116,0.0014000000000000004
5,test_20231031_152345,11610969.png,368720,34622,334098,0.9061021913647211,4,6,84111,5041,79070,0.9400672920307689,19.479543111111113,2513.5601013333335,14.127910868338095,116,0.0014000000000000004
6,test_20231031_152345,10350842.png,212614,7752,204862,0.963539559953719,3,6,42529,1139,41390,0.9732182745891039,18.806680888888888,2247.856064,14.613118620722489,116,0.0014000000000000004
7,test_20231031_152345,10863862.png,317432,17529,299903,0.9447787242622042,4,6,66058,2470,63588,0.9626086166701989,22.472348444444446,2895.600768,13.513416777235879,116,0.0014000000000000004
8,test_20231031_152345,11382381.png,312486,1049,311437,0.9966430496086225,3,6,46745,136,46609,0.9970905979249117,21.32126577777778,2423.943648,14.28557841762738,116,0.0014000000000000004
9,test_20231031_152345,11079715.png,443815,141692,302123,0.6807408492277187,6,7,124136,19635,104501,0.8418267061932074,15.777998222222223,1823.6191466666667,15.521462175397689,116,0.0014000000000000004
10,test_20231031_152345,11551286.png,271883,507,271376,0.998135227285266,2,5,40092,73,40019,0.9981791878679038,17.982668444444446,1868.1795146666666,15.416617553103926,116,0.0014000000000000004
1,test_20231031_152346,10404007.png,502730,31677,471053,0.9369900344121098,3,5,61265,4551,56714,0.925716151146658,24.734689777777778,3176.4103306666666,13.111437610569578,117,1.0E-4
2,test_20231031_152346,1254659.png,342646,90072,252574,0.737128114730655,5,6,80080,12381,67699,0.8453921078921078,18.985667555555555,2670.5895786666665,13.864732109281695,117,1.0E-4
3,test_20231031_152346,10188041.png,221231,11792,209439,0.9466982475331215,3,5,41731,1653,40078,0.9603891591382905,9.969694222222222,899.8637813333333,18.589035886426927,117,1.0E-4
4,test_20231031_152346,10287332.png,216980,14594,202386,0.9327403447322333,3,6,22337,1986,20351,0.9110892241572279,9.070316444444444,690.6286986666667,19.738357396294425,117,1.0E-4
5,test_20231031_152346,11610969.png,368720,34742,333978,0.9057767411586027,3,5,84111,5048,79063,0.9399840686711607,18.42931377777778,2292.6691466666666,14.527389743212353,117,1.0E-4
6,test_20231031_152346,10350842.png,212614,8394,204220,0.9605200033864186,2,6,42529,1234,41295,0.9709845046909168,16.888302222222222,1838.429856,15.48633296547871,117,1.0E-4
7,test_20231031_152346,10863862.png,317432,17487,299945,0.944911036064417,3,5,66058,2468,63590,0.9626388930939478,22.312561777777777,2883.6580266666665,13.531366047988854,117,1.0E-4
8,test_20231031_152346,11382381.png,312486,1742,310744,0.9944253502556915,3,6,46745,236,46509,0.9949513316932292,18.244037333333335,1872.6613066666666,15.406211237738582,117,1.0E-4
9,test_20231031_152346,11079715.png,443815,139522,304293,0.685630273875376,7,7,124136,19343,104793,0.8441789650061223,15.88592888888889,1852.93208,15.452208605030451,117,1.0E-4
10,test_20231031_152346,11551286.png,271883,1562,270321,0.9942548816954352,2,6,40092,228,39864,0.9943130799161928,15.633242666666666,1453.037136,16.508036469458126,117,1.0E-4
1,test_20231031_152347,10404007.png,502730,31677,471053,0.9369900344121098,4,6,61265,4551,56714,0.925716151146658,24.734689777777778,3176.4103306666666,13.111437610569578,117,2.0E-4
2,test_20231031_152347,1254659.png,342646,90072,252574,0.737128114730655,4,6,80080,12381,67699,0.8453921078921078,18.985667555555555,2670.5895786666665,13.864732109281695,117,2.0E-4
3,test_20231031_152347,10188041.png,221231,11792,209439,0.9466982475331215,3,6,41731,1653,40078,0.9603891591382905,9.969694222222222,899.8637813333333,18.589035886426927,117,2.0E-4
4,test_20231031_152347,10287332.png,216980,14342,202638,0.9339017420960457,2,6,22337,1956,20381,0.9124322872364239,9.20136711111111,717.6797493333333,19.571496688878824,117,2.0E-4
5,test_20231031_152347,11610969.png,368720,34742,333978,0.9057767411586027,4,6,84111,5048,79063,0.9399840686711607,18.42931377777778,2292.6691466666666,14.527389743212353,117,2.0E-4
6,test_20231031_152347,10350842.png,212614,8394,204220,0.9605200033864186,3,6,42529,1234,41295,0.9709845046909168,16.888302222222222,1838.429856,15.48633296547871,117,2.0E-4
7,test_20231031_152347,10863862.png,317432,17487,299945,0.944911036064417,3,5,66058,2468,63590,0.9626388930939478,22.312561777777777,2883.6580266666665,13.531366047988854,117,2.0E-4
8,test_20231031_152347,11382381.png,312486,1602,310884,0.9948733703269906,3,6,46745,215,46530,0.9954005776018826,19.084764444444446,2018.0422186666667,15.081501131681227,117,2.0E-4
9,test_20231031_152347,11079715.png,443815,139522,304293,0.685630273875376,6,7,124136,19343,104793,0.8441789650061223,15.88592888888889,1852.93208,15.452208605030451,117,2.0E-4
10,test_20231031_152347,11551286.png,271883,1562,270321,0.9942548816954352,3,6,40092,228,39864,0.9943130799161928,15.633242666666666,1453.037136,16.508036469458126,117,2.0E-4
1,test_20231031_152348,10404007.png,502730,31597,471133,0.9371491655560639,4,6,61265,4539,56726,0.9259120215457439,24.76847111111111,3182.3045706666667,13.103386182946512,117,3.0000000000000003E-4
2,test_20231031_152348,1254659.png,342646,89972,252674,0.7374199611260601,5,7,80080,12371,67709,0.8455169830169831,19.010741333333332,2673.205088,13.860480818083612,117,3.0000000000000003E-4
3,test_20231031_152348,10188041.png,221231,11712,209519,0.947059860507795,3,6,41731,1641,40090,0.9606767151518056,10.122896,920.4792373333333,18.49066364022726,117,3.0000000000000003E-4
4,test_20231031_152348,10287332.png,216980,14322,202658,0.9339939164899991,3,6,22337,1953,20384,0.9125665935443434,9.272709333333333,730.4345653333334,19.49499044345034,117,3.0000000000000003E-4
5,test_20231031_152348,11610969.png,368720,34582,334138,0.9062106747667606,4,6,84111,5026,79085,0.9402456278013578,18.844698666666666,2385.15832,14.3556314930714,117,3.0000000000000003E-4
6,test_20231031_152348,10350842.png,212614,8192,204422,0.9614700819325162,2,5,42529,1204,41325,0.9716899057113969,17.422186666666665,1952.6638613333334,15.224528721793412,117,3.0000000000000003E-4
7,test_20231031_152348,10863862.png,317432,17347,300085,0.9453520754051261,3,5,66058,2448,63610,0.962941657331436,22.402908444444446,2894.7943466666666,13.514626450601803,117,3.0000000000000003E-4
8,test_20231031_152348,11382381.png,312486,1352,311134,0.9956734061685963,2,5,46745,180,46565,0.9961493207829715,19.567729777777778,2094.4224426666665,14.920160779780403,117,3.0000000000000003E-4
9,test_20231031_152348,11079715.png,443815,139522,304293,0.685630273875376,5,7,124136,19343,104793,0.8441789650061223,15.88592888888889,1852.93208,15.452208605030451,117,3.0000000000000003E-4
10,test_20231031_152348,11551286.png,271883,1542,270341,0.9943284427492708,2,5,40092,225,39867,0.9943879078120323,15.715340444444445,1476.7233333333334,16.437812237560706,117,3.0000000000000003E-4
1,test_20231031_152349,10404007.png,502730,31597,471133,0.9371491655560639,4,5,61265,4539,56726,0.9259120215457439,24.76847111111111,3182.3045706666667,13.103386182946512,117,4.0E-4
2,test_20231031_152349,1254659.png,342646,89972,252674,0.7374199611260601,5,7,80080,12371,67709,0.8455169830169831,19.010741333333332,2673.205088,13.860480818083612,117,4.0E-4
3,test_20231031_152349,10188041.png,221231,11712,209519,0.947059860507795,4,6,41731,1641,40090,0.9606767151518056,10.122896,920.4792373333333,18.49066364022726,117,4.0E-4
4,test_20231031_152349,10287332.png,216980,14322,202658,0.9339939164899991,3,6,22337,1953,20384,0.9125665935443434,9.272709333333333,730.4345653333334,19.49499044345034,117,4.0E-4
5,test_20231031_152349,11610969.png,368720,34582,334138,0.9062106747667606,4,6,84111,5026,79085,0.9402456278013578,18.844698666666666,2385.15832,14.3556314930714,117,4.0E-4
6,test_20231031_152349,10350842.png,212614,8192,204422,0.9614700819325162,2,5,42529,1204,41325,0.9716899057113969,17.422186666666665,1952.6638613333334,15.224528721793412,117,4.0E-4
7,test_20231031_152349,10863862.png,317432,17347,300085,0.9453520754051261,3,5,66058,2448,63610,0.962941657331436,22.402908444444446,2894.7943466666666,13.514626450601803,117,4.0E-4
8,test_20231031_152349,11382381.png,312486,1209,311277,0.9961310266699949,3,6,46745,159,46586,0.9965985666916247,20.063532444444444,2164.635312,14.77695621992387,117,4.0E-4
9,test_20231031_152349,11079715.png,443815,139522,304293,0.685630273875376,7,6,124136,19343,104793,0.8441789650061223,15.88592888888889,1852.93208,15.452208605030451,117,4.0E-4
10,test_20231031_152349,11551286.png,271883,1362,270521,0.9949904922337918,2,5,40092,198,39894,0.9950613588745885,16.275288888888888,1573.3418986666666,16.162572526313173,117,4.0E-4
1,test_20231031_152350,10404007.png,502730,31597,471133,0.9371491655560639,4,5,61265,4539,56726,0.9259120215457439,24.76847111111111,3182.3045706666667,13.103386182946512,117,5.0E-4
2,test_20231031_152350,1254659.png,342646,89972,252674,0.7374199611260601,4,6,80080,12371,67709,0.8455169830169831,19.010741333333332,2673.205088,13.860480818083612,117,5.0E-4
3,test_20231031_152350,10188041.png,221231,11712,209519,0.947059860507795,3,6,41731,1641,40090,0.9606767151518056,10.122896,920.4792373333333,18.49066364022726,117,5.0E-4
4,test_20231031_152350,10287332.png,216980,14322,202658,0.9339939164899991,2,5,22337,1953,20384,0.9125665935443434,9.272709333333333,730.4345653333334,19.49499044345034,117,5.0E-4
5,test_20231031_152350,11610969.png,368720,34582,334138,0.9062106747667606,3,6,84111,5026,79085,0.9402456278013578,18.844698666666666,2385.15832,14.3556314930714,117,5.0E-4
6,test_20231031_152350,10350842.png,212614,8192,204422,0.9614700819325162,3,6,42529,1204,41325,0.9716899057113969,17.422186666666665,1952.6638613333334,15.224528721793412,117,5.0E-4
7,test_20231031_152350,10863862.png,317432,17347,300085,0.9453520754051261,3,6,66058,2448,63610,0.962941657331436,22.402908444444446,2894.7943466666666,13.514626450601803,117,5.0E-4
8,test_20231031_152350,11382381.png,312486,1089,311397,0.9965150438739655,2,6,46745,141,46604,0.9969836346133276,20.975168,2356.8750293333333,14.407438057130474,117,5.0E-4
9,test_20231031_152350,11079715.png,443815,139522,304293,0.685630273875376,5,7,124136,19343,104793,0.8441789650061223,15.88592888888889,1852.93208,15.452208605030451,117,5.0E-4
10,test_20231031_152350,11551286.png,271883,1027,270856,0.996222639885539,2,5,40092,149,39943,0.9962835478399681,16.558963555555554,1618.0084213333334,16.040995831904958,117,5.0E-4
1,test_20231031_152351,10404007.png,502730,31377,471353,0.9375867762019374,4,5,61265,4509,56756,0.9264016975434588,24.78187022222222,3184.601312,13.100252911781293,117,6.000000000000001E-4
2,test_20231031_152351,1254659.png,342646,89972,252674,0.7374199611260601,5,6,80080,12371,67709,0.8455169830169831,19.010741333333332,2673.205088,13.860480818083612,117,6.000000000000001E-4
3,test_20231031_152351,10188041.png,221231,11549,209682,0.9477966469436924,3,6,41731,1620,40111,0.9611799381754571,10.341367111111111,955.479728,18.328588836172578,117,6.000000000000001E-4
4,test_20231031_152351,10287332.png,216980,14322,202658,0.9339939164899991,3,6,22337,1953,20384,0.9125665935443434,9.272709333333333,730.4345653333334,19.49499044345034,117,6.000000000000001E-4
5,test_20231031_152351,11610969.png,368720,34582,334138,0.9062106747667606,4,6,84111,5026,79085,0.9402456278013578,18.844698666666666,2385.15832,14.3556314930714,117,6.000000000000001E-4
6,test_20231031_152351,10350842.png,212614,8192,204422,0.9614700819325162,2,5,42529,1204,41325,0.9716899057113969,17.422186666666665,1952.6638613333334,15.224528721793412,117,6.000000000000001E-4
7,test_20231031_152351,10863862.png,317432,17347,300085,0.9453520754051261,3,6,66058,2448,63610,0.962941657331436,22.402908444444446,2894.7943466666666,13.514626450601803,117,6.000000000000001E-4
8,test_20231031_152351,11382381.png,312486,1049,311437,0.9966430496086225,2,6,46745,135,46610,0.9971119905872285,21.28302933333333,2420.0730986666667,14.292518767601603,117,6.000000000000001E-4
9,test_20231031_152351,11079715.png,443815,139522,304293,0.685630273875376,5,7,124136,19343,104793,0.8441789650061223,15.88592888888889,1852.93208,15.452208605030451,117,6.000000000000001E-4
10,test_20231031_152351,11551286.png,271883,927,270956,0.9965904451547173,2,19,40092,134,39958,0.9966576873191659,16.746789333333332,1644.6409546666666,15.97009260057086,117,6.000000000000001E-4
1,test_20231031_152352,10404007.png,502730,31377,471353,0.9375867762019374,9,6,61265,4509,56756,0.9264016975434588,24.78187022222222,3184.601312,13.100252911781293,117,7.000000000000001E-4
2,test_20231031_152352,1254659.png,342646,89972,252674,0.7374199611260601,5,7,80080,12371,67709,0.8455169830169831,19.010741333333332,2673.205088,13.860480818083612,117,7.000000000000001E-4
3,test_20231031_152352,10188041.png,221231,11549,209682,0.9477966469436924,3,6,41731,1620,40111,0.9611799381754571,10.341367111111111,955.479728,18.328588836172578,117,7.000000000000001E-4
4,test_20231031_152352,10287332.png,216980,14322,202658,0.9339939164899991,2,17,22337,1953,20384,0.9125665935443434,9.272709333333333,730.4345653333334,19.49499044345034,117,7.000000000000001E-4
5,test_20231031_152352,11610969.png,368720,34582,334138,0.9062106747667606,4,6,84111,5026,79085,0.9402456278013578,18.844698666666666,2385.15832,14.3556314930714,117,7.000000000000001E-4
6,test_20231031_152352,10350842.png,212614,8192,204422,0.9614700819325162,2,6,42529,1204,41325,0.9716899057113969,17.422186666666665,1952.6638613333334,15.224528721793412,117,7.000000000000001E-4
7,test_20231031_152352,10863862.png,317432,17347,300085,0.9453520754051261,3,6,66058,2448,63610,0.962941657331436,22.402908444444446,2894.7943466666666,13.514626450601803,117,7.000000000000001E-4
8,test_20231031_152352,11382381.png,312486,1049,311437,0.9966430496086225,2,5,46745,135,46610,0.9971119905872285,21.28302933333333,2420.0730986666667,14.292518767601603,117,7.000000000000001E-4
9,test_20231031_152352,11079715.png,443815,139522,304293,0.685630273875376,5,18,124136,19343,104793,0.8441789650061223,15.88592888888889,1852.93208,15.452208605030451,117,7.000000000000001E-4
10,test_20231031_152352,11551286.png,271883,927,270956,0.9965904451547173,2,6,40092,134,39958,0.9966576873191659,16.746789333333332,1644.6409546666666,15.97009260057086,117,7.000000000000001E-4
1,test_20231031_152353,10404007.png,502730,31074,471656,0.9381894854096633,3,6,61265,4466,56799,0.9271035664735167,24.814042666666666,3191.2726453333335,13.091164512825008,117,8.000000000000001E-4
2,test_20231031_152353,1254659.png,342646,89972,252674,0.7374199611260601,5,6,80080,12371,67709,0.8455169830169831,19.010741333333332,2673.205088,13.860480818083612,117,8.000000000000001E-4
3,test_20231031_152353,10188041.png,221231,11449,209782,0.9482486631620343,3,5,41731,1607,40124,0.9614914571900985,10.469011555555555,966.6281333333334,18.278209299102585,117,8.000000000000001E-4
4,test_20231031_152353,10287332.png,216980,14322,202658,0.9339939164899991,2,5,22337,1953,20384,0.9125665935443434,9.272709333333333,730.4345653333334,19.49499044345034,117,8.000000000000001E-4
5,test_20231031_152353,11610969.png,368720,34119,334601,0.9074663701453678,4,6,84111,4959,79152,0.9410421942433214,19.417427555555555,2508.4862026666665,14.136686442313518,117,8.000000000000001E-4
6,test_20231031_152353,10350842.png,212614,7732,204882,0.9636336271365009,3,6,42529,1136,41393,0.9732888146911519,18.686051555555554,2228.161792,14.651336380907754,117,8.000000000000001E-4
7,test_20231031_152353,10863862.png,317432,17287,300145,0.94554109226543,3,6,66058,2439,63619,0.9630779012383057,22.44475733333333,2896.66128,13.511826467574739,117,8.000000000000001E-4
8,test_20231031_152353,11382381.png,312486,1049,311437,0.9966430496086225,2,5,46745,135,46610,0.9971119905872285,21.28302933333333,2420.0730986666667,14.292518767601603,117,8.000000000000001E-4
9,test_20231031_152353,11079715.png,443815,139522,304293,0.685630273875376,6,7,124136,19343,104793,0.8441789650061223,15.88592888888889,1852.93208,15.452208605030451,117,8.000000000000001E-4
10,test_20231031_152353,11551286.png,271883,627,271256,0.9976938609622521,2,6,40092,91,40001,0.9977302204928664,17.18488888888889,1728.3928213333334,15.754379070136029,117,8.000000000000001E-4
1,test_20231031_152354,10404007.png,502730,31074,471656,0.9381894854096633,4,6,61265,4466,56799,0.9271035664735167,24.814042666666666,3191.2726453333335,13.091164512825008,117,9.000000000000002E-4
2,test_20231031_152354,1254659.png,342646,89972,252674,0.7374199611260601,4,6,80080,12371,67709,0.8455169830169831,19.010741333333332,2673.205088,13.860480818083612,117,9.000000000000002E-4
3,test_20231031_152354,10188041.png,221231,11449,209782,0.9482486631620343,4,6,41731,1607,40124,0.9614914571900985,10.469011555555555,966.6281333333334,18.278209299102585,117,9.000000000000002E-4
4,test_20231031_152354,10287332.png,216980,14322,202658,0.9339939164899991,2,9,22337,1953,20384,0.9125665935443434,9.272709333333333,730.4345653333334,19.49499044345034,117,9.000000000000002E-4
5,test_20231031_152354,11610969.png,368720,34119,334601,0.9074663701453678,4,6,84111,4959,79152,0.9410421942433214,19.417427555555555,2508.4862026666665,14.136686442313518,117,9.000000000000002E-4
6,test_20231031_152354,10350842.png,212614,7732,204882,0.9636336271365009,3,6,42529,1136,41393,0.9732888146911519,18.686051555555554,2228.161792,14.651336380907754,117,9.000000000000002E-4
7,test_20231031_152354,10863862.png,317432,17287,300145,0.94554109226543,3,6,66058,2439,63619,0.9630779012383057,22.44475733333333,2896.66128,13.511826467574739,117,9.000000000000002E-4
8,test_20231031_152354,11382381.png,312486,1049,311437,0.9966430496086225,2,6,46745,135,46610,0.9971119905872285,21.28302933333333,2420.0730986666667,14.292518767601603,117,9.000000000000002E-4
9,test_20231031_152354,11079715.png,443815,139522,304293,0.685630273875376,6,7,124136,19343,104793,0.8441789650061223,15.88592888888889,1852.93208,15.452208605030451,117,9.000000000000002E-4
10,test_20231031_152354,11551286.png,271883,627,271256,0.9976938609622521,2,6,40092,91,40001,0.9977302204928664,17.18488888888889,1728.3928213333334,15.754379070136029,117,9.000000000000002E-4
1,test_20231031_152355,10404007.png,502730,30372,472358,0.9395858611978597,4,12,61265,4371,56894,0.928654207132947,24.86257422222222,3201.4477333333334,13.07733944918629,117,0.0010000000000000002
2,test_20231031_152355,1254659.png,342646,89527,253119,0.7387186775856132,4,6,80080,12322,67758,0.8461288711288711,19.403918222222224,2760.138634666667,13.721494647597016,117,0.0010000000000000002
3,test_20231031_152355,10188041.png,221231,11247,209984,0.949161735923085,4,6,41731,1585,40146,0.9620186432148763,10.621082666666666,994.7404746666666,18.153705717019207,117,0.0010000000000000002
4,test_20231031_152355,10287332.png,216980,14282,202698,0.9341782652779058,3,6,22337,1947,20390,0.9128352061601827,9.274181333333333,731.3798346666666,19.489373789070704,117,0.0010000000000000002
5,test_20231031_152355,11610969.png,368720,33657,335063,0.9087193534389238,4,6,84111,4902,79209,0.941719870171559,19.66441777777778,2550.8069493333333,14.064027693736868,117,0.0010000000000000002
6,test_20231031_152355,10350842.png,212614,7612,205002,0.9641980302331925,3,6,42529,1118,41411,0.97371205530344,18.840768,2256.820672,14.595833096567876,117,0.0010000000000000002
7,test_20231031_152355,10863862.png,317432,16807,300625,0.9470532271478616,4,6,66058,2372,63686,0.9640921614338914,22.623338666666665,2938.107648,13.45012657202667,117,0.0010000000000000002
8,test_20231031_152355,11382381.png,312486,1027,311459,0.9967134527626837,3,6,46745,133,46612,0.9971547759118622,21.324028444444444,2424.3844266666665,14.284788752653174,117,0.0010000000000000002
9,test_20231031_152355,11079715.png,443815,139442,304373,0.6858105291619256,5,7,124136,19337,104799,0.8442272990913192,15.904659555555556,1855.7976693333333,15.44549735904252,117,0.0010000000000000002
10,test_20231031_152355,11551286.png,271883,507,271376,0.998135227285266,3,6,40092,73,40019,0.9981791878679038,17.982668444444446,1868.1795146666666,15.416617553103926,117,0.0010000000000000002
1,test_20231031_152356,10404007.png,502730,29949,472781,0.9404272671215165,3,6,61265,4314,56951,0.9295845915286053,24.951585777777776,3220.983002666667,13.050919278419324,117,0.0011000000000000003
2,test_20231031_152356,1254659.png,342646,89527,253119,0.7387186775856132,5,7,80080,12322,67758,0.8461288711288711,19.403918222222224,2760.138634666667,13.721494647597016,117,0.0011000000000000003
3,test_20231031_152356,10188041.png,221231,11127,210104,0.9497041553850952,3,6,41731,1571,40160,0.9623541252306439,10.668666666666667,999.9693386666667,18.13093677119933,117,0.0011000000000000003
4,test_20231031_152356,10287332.png,216980,14282,202698,0.9341782652779058,3,6,22337,1947,20390,0.9128352061601827,9.274181333333333,731.3798346666666,19.489373789070704,117,0.0011000000000000003
5,test_20231031_152356,11610969.png,368720,33657,335063,0.9087193534389238,4,6,84111,4902,79209,0.941719870171559,19.66441777777778,2550.8069493333333,14.064027693736868,117,0.0011000000000000003
6,test_20231031_152356,10350842.png,212614,7612,205002,0.9641980302331925,3,6,42529,1118,41411,0.97371205530344,18.840768,2256.820672,14.595833096567876,117,0.0011000000000000003
7,test_20231031_152356,10863862.png,317432,16807,300625,0.9470532271478616,3,6,66058,2372,63686,0.9640921614338914,22.623338666666665,2938.107648,13.45012657202667,117,0.0011000000000000003
8,test_20231031_152356,11382381.png,312486,1027,311459,0.9967134527626837,2,6,46745,133,46612,0.9971547759118622,21.324028444444444,2424.3844266666665,14.284788752653174,117,0.0011000000000000003
9,test_20231031_152356,11079715.png,443815,139442,304373,0.6858105291619256,6,7,124136,19337,104799,0.8442272990913192,15.904659555555556,1855.7976693333333,15.44549735904252,117,0.0011000000000000003
10,test_20231031_152356,11551286.png,271883,507,271376,0.998135227285266,2,6,40092,73,40019,0.9981791878679038,17.982668444444446,1868.1795146666666,15.416617553103926,117,0.0011000000000000003
1,test_20231031_152357,10404007.png,502730,29949,472781,0.9404272671215165,4,6,61265,4314,56951,0.9295845915286053,24.951585777777776,3220.983002666667,13.050919278419324,117,0.0012000000000000003
2,test_20231031_152357,1254659.png,342646,89527,253119,0.7387186775856132,6,6,80080,12322,67758,0.8461288711288711,19.403918222222224,2760.138634666667,13.721494647597016,117,0.0012000000000000003
3,test_20231031_152357,10188041.png,221231,11127,210104,0.9497041553850952,3,6,41731,1571,40160,0.9623541252306439,10.668666666666667,999.9693386666667,18.13093677119933,117,0.0012000000000000003
4,test_20231031_152357,10287332.png,216980,14282,202698,0.9341782652779058,3,6,22337,1947,20390,0.9128352061601827,9.274181333333333,731.3798346666666,19.489373789070704,117,0.0012000000000000003
5,test_20231031_152357,11610969.png,368720,33657,335063,0.9087193534389238,4,10,84111,4902,79209,0.941719870171559,19.66441777777778,2550.8069493333333,14.064027693736868,117,0.0012000000000000003
6,test_20231031_152357,10350842.png,212614,7612,205002,0.9641980302331925,3,6,42529,1118,41411,0.97371205530344,18.840768,2256.820672,14.595833096567876,117,0.0012000000000000003
7,test_20231031_152357,10863862.png,317432,16807,300625,0.9470532271478616,3,6,66058,2372,63686,0.9640921614338914,22.623338666666665,2938.107648,13.45012657202667,117,0.0012000000000000003
8,test_20231031_152357,11382381.png,312486,1027,311459,0.9967134527626837,2,5,46745,133,46612,0.9971547759118622,21.324028444444444,2424.3844266666665,14.284788752653174,117,0.0012000000000000003
9,test_20231031_152357,11079715.png,443815,139442,304373,0.6858105291619256,6,7,124136,19337,104799,0.8442272990913192,15.904659555555556,1855.7976693333333,15.44549735904252,117,0.0012000000000000003
10,test_20231031_152357,11551286.png,271883,507,271376,0.998135227285266,2,6,40092,73,40019,0.9981791878679038,17.982668444444446,1868.1795146666666,15.416617553103926,117,0.0012000000000000003
1,test_20231031_152358,10404007.png,502730,29687,473043,0.9409484216179659,4,6,61265,4275,56990,0.9302211703256346,24.96276622222222,3223.399744,13.04766193783073,117,0.0013000000000000004
2,test_20231031_152358,1254659.png,342646,89527,253119,0.7387186775856132,4,6,80080,12322,67758,0.8461288711288711,19.403918222222224,2760.138634666667,13.721494647597016,117,0.0013000000000000004
3,test_20231031_152358,10188041.png,221231,10987,210244,0.9503369780907739,4,6,41731,1550,40181,0.9628573482542954,10.763745777777778,1024.0194826666666,18.027721414017943,117,0.0013000000000000004
4,test_20231031_152358,10287332.png,216980,14122,202858,0.9349156604295327,3,6,22337,1925,20412,0.9138201190849263,9.342202666666667,742.4302666666666,19.424246924060522,117,0.0013000000000000004
5,test_20231031_152358,11610969.png,368720,33657,335063,0.9087193534389238,4,5,84111,4902,79209,0.941719870171559,19.66441777777778,2550.8069493333333,14.064027693736868,117,0.0013000000000000004
6,test_20231031_152358,10350842.png,212614,7612,205002,0.9641980302331925,3,6,42529,1118,41411,0.97371205530344,18.840768,2256.820672,14.595833096567876,117,0.0013000000000000004
7,test_20231031_152358,10863862.png,317432,16807,300625,0.9470532271478616,3,6,66058,2372,63686,0.9640921614338914,22.623338666666665,2938.107648,13.45012657202667,117,0.0013000000000000004
8,test_20231031_152358,11382381.png,312486,1027,311459,0.9967134527626837,2,5,46745,133,46612,0.9971547759118622,21.324028444444444,2424.3844266666665,14.284788752653174,117,0.0013000000000000004
9,test_20231031_152358,11079715.png,443815,139442,304373,0.6858105291619256,6,8,124136,19337,104799,0.8442272990913192,15.904659555555556,1855.7976693333333,15.44549735904252,117,0.0013000000000000004
10,test_20231031_152358,11551286.png,271883,507,271376,0.998135227285266,2,5,40092,73,40019,0.9981791878679038,17.982668444444446,1868.1795146666666,15.416617553103926,117,0.0013000000000000004
1,test_20231031_152359,10404007.png,502730,29687,473043,0.9409484216179659,4,6,61265,4275,56990,0.9302211703256346,24.96276622222222,3223.399744,13.04766193783073,117,0.0014000000000000004
2,test_20231031_152359,1254659.png,342646,89527,253119,0.7387186775856132,5,6,80080,12322,67758,0.8461288711288711,19.403918222222224,2760.138634666667,13.721494647597016,117,0.0014000000000000004
3,test_20231031_152359,10188041.png,221231,10987,210244,0.9503369780907739,3,5,41731,1550,40181,0.9628573482542954,10.763745777777778,1024.0194826666666,18.027721414017943,117,0.0014000000000000004
4,test_20231031_152359,10287332.png,216980,14122,202858,0.9349156604295327,3,8,22337,1925,20412,0.9138201190849263,9.342202666666667,742.4302666666666,19.424246924060522,117,0.0014000000000000004
5,test_20231031_152359,11610969.png,368720,33657,335063,0.9087193534389238,5,6,84111,4902,79209,0.941719870171559,19.66441777777778,2550.8069493333333,14.064027693736868,117,0.0014000000000000004
6,test_20231031_152359,10350842.png,212614,5982,206632,0.9718645056299209,3,6,42529,880,41649,0.9793082367325825,22.200878222222222,3074.517984,13.25303323129748,117,0.0014000000000000004
7,test_20231031_152359,10863862.png,317432,16807,300625,0.9470532271478616,4,6,66058,2372,63686,0.9640921614338914,22.623338666666665,2938.107648,13.45012657202667,117,0.0014000000000000004
8,test_20231031_152359,11382381.png,312486,1027,311459,0.9967134527626837,3,12,46745,133,46612,0.9971547759118622,21.324028444444444,2424.3844266666665,14.284788752653174,117,0.0014000000000000004
9,test_20231031_152359,11079715.png,443815,139442,304373,0.6858105291619256,6,7,124136,19337,104799,0.8442272990913192,15.904659555555556,1855.7976693333333,15.44549735904252,117,0.0014000000000000004
10,test_20231031_152359,11551286.png,271883,507,271376,0.998135227285266,2,5,40092,73,40019,0.9981791878679038,17.982668444444446,1868.1795146666666,15.416617553103926,117,0.0014000000000000004
1,test_20231031_152400,10404007.png,502730,30312,472418,0.9397052095558251,4,6,61265,4360,56905,0.9288337549987759,24.800556444444446,3195.080944,13.085984958422706,118,1.0E-4
2,test_20231031_152400,1254659.png,342646,88192,254454,0.7426148269642722,5,7,80080,12146,67934,0.8483266733266733,19.181717333333335,2722.34336,13.781374604455063,118,1.0E-4
3,test_20231031_152400,10188041.png,221231,11529,209702,0.9478870501873607,3,6,41731,1616,40115,0.9612757901799621,10.019447111111111,910.5794613333334,18.537625105581533,118,1.0E-4
4,test_20231031_152400,10287332.png,216980,14474,202506,0.9332933910959536,3,5,22337,1969,20368,0.911850293235439,9.077187555555556,692.308,19.727810107156955,118,1.0E-4
5,test_20231031_152400,11610969.png,368720,33927,334793,0.9079870904751572,4,6,84111,4941,79170,0.941256197168028,18.572876444444443,2320.885616,14.474266239295016,118,1.0E-4
6,test_20231031_152400,10350842.png,212614,8092,204522,0.9619404178464259,2,6,42529,1188,41341,0.9720661195889864,16.911514666666665,1844.3901386666666,15.472275693407639,118,1.0E-4
7,test_20231031_152400,10863862.png,317432,16724,300708,0.9473147004712821,3,6,66058,2378,63680,0.9640013321626449,22.621194666666668,2958.6381653333333,13.419885056794993,118,1.0E-4
8,test_20231031_152400,11382381.png,312486,1482,311004,0.9952573875309614,3,6,46745,202,46543,0.9956786822120013,19.14695111111111,2032.8025066666667,15.049851732929183,118,1.0E-4
9,test_20231031_152400,11079715.png,443815,137332,306483,0.6905647623446707,5,7,124136,19058,105078,0.8464748340529742,15.998211555555555,1880.0749546666666,15.389051968440075,118,1.0E-4
10,test_20231031_152400,11551286.png,271883,1522,270361,0.9944020038031065,2,5,40092,222,39870,0.9944627357078719,15.663358222222222,1460.1056266666667,16.486960863032234,118,1.0E-4
1,test_20231031_152402,10404007.png,502730,30312,472418,0.9397052095558251,4,6,61265,4360,56905,0.9288337549987759,24.800556444444446,3195.080944,13.085984958422706,118,2.0E-4
2,test_20231031_152402,1254659.png,342646,88192,254454,0.7426148269642722,5,6,80080,12146,67934,0.8483266733266733,19.181717333333335,2722.34336,13.781374604455063,118,2.0E-4
3,test_20231031_152402,10188041.png,221231,11529,209702,0.9478870501873607,3,6,41731,1616,40115,0.9612757901799621,10.019447111111111,910.5794613333334,18.537625105581533,118,2.0E-4
4,test_20231031_152402,10287332.png,216980,14222,202758,0.9344547884597658,3,6,22337,1939,20398,0.9131933563146349,9.208238222222223,719.3590506666667,19.56134648786129,118,2.0E-4
5,test_20231031_152402,11610969.png,368720,33927,334793,0.9079870904751572,4,6,84111,4941,79170,0.941256197168028,18.572876444444443,2320.885616,14.474266239295016,118,2.0E-4
6,test_20231031_152402,10350842.png,212614,8092,204522,0.9619404178464259,2,6,42529,1188,41341,0.9720661195889864,16.911514666666665,1844.3901386666666,15.472275693407639,118,2.0E-4
7,test_20231031_152402,10863862.png,317432,16724,300708,0.9473147004712821,3,12,66058,2378,63680,0.9640013321626449,22.621194666666668,2958.6381653333333,13.419885056794993,118,2.0E-4
8,test_20231031_152402,11382381.png,312486,1482,311004,0.9952573875309614,2,5,46745,202,46543,0.9956786822120013,19.14695111111111,2032.8025066666667,15.049851732929183,118,2.0E-4
9,test_20231031_152402,11079715.png,443815,137332,306483,0.6905647623446707,5,7,124136,19058,105078,0.8464748340529742,15.998211555555555,1880.0749546666666,15.389051968440075,118,2.0E-4
10,test_20231031_152402,11551286.png,271883,1522,270361,0.9944020038031065,2,5,40092,222,39870,0.9944627357078719,15.663358222222222,1460.1056266666667,16.486960863032234,118,2.0E-4
1,test_20231031_152403,10404007.png,502730,30232,472498,0.9398643406997792,6,6,61265,4349,56916,0.9290133028646046,24.834337777777776,3200.975184,13.077980536383798,118,3.0000000000000003E-4
2,test_20231031_152403,1254659.png,342646,88092,254554,0.7429066733596774,5,7,80080,12136,67944,0.8484515484515485,19.206791111111112,2724.9588693333335,13.777204094685997,118,3.0000000000000003E-4
3,test_20231031_152403,10188041.png,221231,11449,209782,0.9482486631620343,3,6,41731,1604,40127,0.9615633461934773,10.172648888888888,931.1949173333334,18.44039764030429,118,3.0000000000000003E-4
4,test_20231031_152403,10287332.png,216980,14202,202778,0.9345469628537193,3,6,22337,1936,20401,0.9133276626225545,9.279580444444445,732.1138666666667,19.485017281439937,118,3.0000000000000003E-4
5,test_20231031_152403,11610969.png,368720,33767,334953,0.9084210240833153,4,6,84111,4919,79192,0.941517756298225,18.988261333333334,2413.3747893333334,14.304555891870805,118,3.0000000000000003E-4
6,test_20231031_152403,10350842.png,212614,7952,204662,0.9625988881258996,3,5,42529,1167,41362,0.9725599003033224,17.44026488888889,1956.686224,15.215591734884253,118,3.0000000000000003E-4
7,test_20231031_152403,10863862.png,317432,16584,300848,0.9477557398119912,3,6,66058,2358,63700,0.9643040964001333,22.711541333333333,2969.7744853333334,13.403568891580502,118,3.0000000000000003E-4
8,test_20231031_152403,11382381.png,312486,1229,311257,0.9960670238026663,3,6,46745,167,46578,0.9964274253930901,19.629916444444444,2109.182730666667,14.889661540623035,118,3.0000000000000003E-4
9,test_20231031_152403,11079715.png,443815,137332,306483,0.6905647623446707,5,7,124136,19058,105078,0.8464748340529742,15.998211555555555,1880.0749546666666,15.389051968440075,118,3.0000000000000003E-4
10,test_20231031_152403,11551286.png,271883,1502,270381,0.9944755648569421,3,5,40092,219,39873,0.9945375636037115,15.745456,1483.791824,16.417073871688427,118,3.0000000000000003E-4
1,test_20231031_152404,10404007.png,502730,30232,472498,0.9398643406997792,4,5,61265,4349,56916,0.9290133028646046,24.834337777777776,3200.975184,13.077980536383798,118,4.0E-4
2,test_20231031_152404,1254659.png,342646,88092,254554,0.7429066733596774,4,6,80080,12136,67944,0.8484515484515485,19.206791111111112,2724.9588693333335,13.777204094685997,118,4.0E-4
3,test_20231031_152404,10188041.png,221231,11449,209782,0.9482486631620343,3,6,41731,1604,40127,0.9615633461934773,10.172648888888888,931.1949173333334,18.44039764030429,118,4.0E-4
4,test_20231031_152404,10287332.png,216980,14202,202778,0.9345469628537193,3,5,22337,1936,20401,0.9133276626225545,9.279580444444445,732.1138666666667,19.485017281439937,118,4.0E-4
5,test_20231031_152404,11610969.png,368720,33767,334953,0.9084210240833153,3,6,84111,4919,79192,0.941517756298225,18.988261333333334,2413.3747893333334,14.304555891870805,118,4.0E-4
6,test_20231031_152404,10350842.png,212614,7952,204662,0.9625988881258996,2,5,42529,1167,41362,0.9725599003033224,17.44026488888889,1956.686224,15.215591734884253,118,4.0E-4
7,test_20231031_152404,10863862.png,317432,16584,300848,0.9477557398119912,3,5,66058,2358,63700,0.9643040964001333,22.711541333333333,2969.7744853333334,13.403568891580502,118,4.0E-4
8,test_20231031_152404,11382381.png,312486,987,311499,0.9968414584973406,2,5,46745,131,46614,0.9971975612364958,21.02876088888889,2370.6178346666666,14.382188134999502,118,4.0E-4
9,test_20231031_152404,11079715.png,443815,137332,306483,0.6905647623446707,7,6,124136,19058,105078,0.8464748340529742,15.998211555555555,1880.0749546666666,15.389051968440075,118,4.0E-4
10,test_20231031_152404,11551286.png,271883,987,270896,0.9963697619932104,2,5,40092,143,39949,0.9964332036316472,16.58907911111111,1625.076912,16.022064406811772,118,4.0E-4
1,test_20231031_152405,10404007.png,502730,30232,472498,0.9398643406997792,3,6,61265,4349,56916,0.9290133028646046,24.834337777777776,3200.975184,13.077980536383798,118,5.0E-4
2,test_20231031_152405,1254659.png,342646,88092,254554,0.7429066733596774,5,7,80080,12136,67944,0.8484515484515485,19.206791111111112,2724.9588693333335,13.777204094685997,118,5.0E-4
3,test_20231031_152405,10188041.png,221231,11449,209782,0.9482486631620343,3,6,41731,1604,40127,0.9615633461934773,10.172648888888888,931.1949173333334,18.44039764030429,118,5.0E-4
4,test_20231031_152405,10287332.png,216980,14202,202778,0.9345469628537193,3,6,22337,1936,20401,0.9133276626225545,9.279580444444445,732.1138666666667,19.485017281439937,118,5.0E-4
5,test_20231031_152405,11610969.png,368720,33767,334953,0.9084210240833153,4,6,84111,4919,79192,0.941517756298225,18.988261333333334,2413.3747893333334,14.304555891870805,118,5.0E-4
6,test_20231031_152405,10350842.png,212614,7952,204662,0.9625988881258996,2,5,42529,1167,41362,0.9725599003033224,17.44026488888889,1956.686224,15.215591734884253,118,5.0E-4
7,test_20231031_152405,10863862.png,317432,16584,300848,0.9477557398119912,3,6,66058,2358,63700,0.9643040964001333,22.711541333333333,2969.7744853333334,13.403568891580502,118,5.0E-4
8,test_20231031_152405,11382381.png,312486,987,311499,0.9968414584973406,2,5,46745,131,46614,0.9971975612364958,21.02876088888889,2370.6178346666666,14.382188134999502,118,5.0E-4
9,test_20231031_152405,11079715.png,443815,137332,306483,0.6905647623446707,5,7,124136,19058,105078,0.8464748340529742,15.998211555555555,1880.0749546666666,15.389051968440075,118,5.0E-4
10,test_20231031_152405,11551286.png,271883,987,270896,0.9963697619932104,2,6,40092,143,39949,0.9964332036316472,16.58907911111111,1625.076912,16.022064406811772,118,5.0E-4
1,test_20231031_152406,10404007.png,502730,29869,472861,0.9405863982654705,4,6,61265,4297,56968,0.929862074593977,24.854192,3204.698778666667,13.072931460179952,118,6.000000000000001E-4
2,test_20231031_152406,1254659.png,342646,88092,254554,0.7429066733596774,5,7,80080,12136,67944,0.8484515484515485,19.206791111111112,2724.9588693333335,13.777204094685997,118,6.000000000000001E-4
3,test_20231031_152406,10188041.png,221231,11287,209944,0.9489809294357482,3,5,41731,1583,40148,0.9620665692171287,10.39112,966.195408,18.280153917672955,118,6.000000000000001E-4
4,test_20231031_152406,10287332.png,216980,14202,202778,0.9345469628537193,2,5,22337,1936,20401,0.9133276626225545,9.279580444444445,732.1138666666667,19.485017281439937,118,6.000000000000001E-4
5,test_20231031_152406,11610969.png,368720,33427,335293,0.909343133000651,3,6,84111,4869,79242,0.9421122088668545,19.519415111111112,2532.3998666666666,14.09548078884506,118,6.000000000000001E-4
6,test_20231031_152406,10350842.png,212614,7672,204942,0.9639158286848467,3,6,42529,1126,41403,0.9735239483646453,18.33104888888889,2162.688890666667,14.78086311509485,118,6.000000000000001E-4
7,test_20231031_152406,10863862.png,317432,16584,300848,0.9477557398119912,4,6,66058,2358,63700,0.9643040964001333,22.711541333333333,2969.7744853333334,13.403568891580502,118,6.000000000000001E-4
8,test_20231031_152406,11382381.png,312486,947,311539,0.9969694642319976,3,6,46745,125,46620,0.9973259172103969,21.33662222222222,2433.815904,14.267926361524507,118,6.000000000000001E-4
9,test_20231031_152406,11079715.png,443815,137332,306483,0.6905647623446707,6,7,124136,19058,105078,0.8464748340529742,15.998211555555555,1880.0749546666666,15.389051968440075,118,6.000000000000001E-4
10,test_20231031_152406,11551286.png,271883,807,271076,0.9970318114777312,2,5,40092,116,39976,0.9971066546942033,17.68609777777778,1807.3256746666666,15.560439426918995,118,6.000000000000001E-4
1,test_20231031_152407,10404007.png,502730,29869,472861,0.9405863982654705,8,6,61265,4297,56968,0.929862074593977,24.854192,3204.698778666667,13.072931460179952,118,7.000000000000001E-4
2,test_20231031_152407,1254659.png,342646,88092,254554,0.7429066733596774,5,6,80080,12136,67944,0.8484515484515485,19.206791111111112,2724.9588693333335,13.777204094685997,118,7.000000000000001E-4
3,test_20231031_152407,10188041.png,221231,11287,209944,0.9489809294357482,3,5,41731,1583,40148,0.9620665692171287,10.39112,966.195408,18.280153917672955,118,7.000000000000001E-4
4,test_20231031_152407,10287332.png,216980,14202,202778,0.9345469628537193,2,5,22337,1936,20401,0.9133276626225545,9.279580444444445,732.1138666666667,19.485017281439937,118,7.000000000000001E-4
5,test_20231031_152407,11610969.png,368720,33427,335293,0.909343133000651,4,5,84111,4869,79242,0.9421122088668545,19.519415111111112,2532.3998666666666,14.09548078884506,118,7.000000000000001E-4
6,test_20231031_152407,10350842.png,212614,7672,204942,0.9639158286848467,3,6,42529,1126,41403,0.9735239483646453,18.33104888888889,2162.688890666667,14.78086311509485,118,7.000000000000001E-4
7,test_20231031_152407,10863862.png,317432,16584,300848,0.9477557398119912,4,6,66058,2358,63700,0.9643040964001333,22.711541333333333,2969.7744853333334,13.403568891580502,118,7.000000000000001E-4
8,test_20231031_152407,11382381.png,312486,947,311539,0.9969694642319976,2,6,46745,125,46620,0.9973259172103969,21.33662222222222,2433.815904,14.267926361524507,118,7.000000000000001E-4
9,test_20231031_152407,11079715.png,443815,137332,306483,0.6905647623446707,5,7,124136,19058,105078,0.8464748340529742,15.998211555555555,1880.0749546666666,15.389051968440075,118,7.000000000000001E-4
10,test_20231031_152407,11551286.png,271883,567,271316,0.9979145441237591,2,5,40092,82,40010,0.9979547041803851,17.920218666666667,1855.396624,15.446435988293219,118,7.000000000000001E-4
1,test_20231031_152408,10404007.png,502730,29427,473303,0.9414655978358164,4,6,61265,4234,57031,0.9308903941891782,24.896499555555554,3213.6712053333335,13.060789193720916,118,8.000000000000001E-4
2,test_20231031_152408,1254659.png,342646,88092,254554,0.7429066733596774,4,6,80080,12136,67944,0.8484515484515485,19.206791111111112,2724.9588693333335,13.777204094685997,118,8.000000000000001E-4
3,test_20231031_152408,10188041.png,221231,11187,210044,0.9494329456540901,3,6,41731,1570,40161,0.9623780882317702,10.518764444444445,977.3438133333333,18.23032992679429,118,8.000000000000001E-4
4,test_20231031_152408,10287332.png,216980,14202,202778,0.9345469628537193,3,6,22337,1936,20401,0.9133276626225545,9.279580444444445,732.1138666666667,19.485017281439937,118,8.000000000000001E-4
5,test_20231031_152408,11610969.png,368720,33327,335393,0.9096143415057496,3,5,84111,4854,79257,0.9422905446374433,19.55695111111111,2536.3416906666666,14.088726004693697,118,8.000000000000001E-4
6,test_20231031_152408,10350842.png,212614,7512,205102,0.9646683661471023,2,6,42529,1102,41427,0.9740882691810294,18.70272888888889,2231.8623413333335,14.644129565535328,118,8.000000000000001E-4
7,test_20231031_152408,10863862.png,317432,16524,300908,0.9479447566722952,3,6,66058,2349,63709,0.964440340307003,22.753390222222222,2971.6414186666666,13.400839579630173,118,8.000000000000001E-4
8,test_20231031_152408,11382381.png,312486,947,311539,0.9969694642319976,2,5,46745,125,46620,0.9973259172103969,21.33662222222222,2433.815904,14.267926361524507,118,8.000000000000001E-4
9,test_20231031_152408,11079715.png,443815,137332,306483,0.6905647623446707,5,7,124136,19058,105078,0.8464748340529742,15.998211555555555,1880.0749546666666,15.389051968440075,118,8.000000000000001E-4
10,test_20231031_152408,11551286.png,271883,567,271316,0.9979145441237591,2,6,40092,82,40010,0.9979547041803851,17.920218666666667,1855.396624,15.446435988293219,118,8.000000000000001E-4
1,test_20231031_152409,10404007.png,502730,29427,473303,0.9414655978358164,4,6,61265,4234,57031,0.9308903941891782,24.896499555555554,3213.6712053333335,13.060789193720916,118,9.000000000000002E-4
2,test_20231031_152409,1254659.png,342646,88092,254554,0.7429066733596774,5,12,80080,12136,67944,0.8484515484515485,19.206791111111112,2724.9588693333335,13.777204094685997,118,9.000000000000002E-4
3,test_20231031_152409,10188041.png,221231,11187,210044,0.9494329456540901,3,5,41731,1570,40161,0.9623780882317702,10.518764444444445,977.3438133333333,18.23032992679429,118,9.000000000000002E-4
4,test_20231031_152409,10287332.png,216980,14202,202778,0.9345469628537193,3,6,22337,1936,20401,0.9133276626225545,9.279580444444445,732.1138666666667,19.485017281439937,118,9.000000000000002E-4
5,test_20231031_152409,11610969.png,368720,33327,335393,0.9096143415057496,3,6,84111,4854,79257,0.9422905446374433,19.55695111111111,2536.3416906666666,14.088726004693697,118,9.000000000000002E-4
6,test_20231031_152409,10350842.png,212614,7512,205102,0.9646683661471023,2,6,42529,1102,41427,0.9740882691810294,18.70272888888889,2231.8623413333335,14.644129565535328,118,9.000000000000002E-4
7,test_20231031_152409,10863862.png,317432,16524,300908,0.9479447566722952,3,5,66058,2349,63709,0.964440340307003,22.753390222222222,2971.6414186666666,13.400839579630173,118,9.000000000000002E-4
8,test_20231031_152409,11382381.png,312486,947,311539,0.9969694642319976,2,5,46745,125,46620,0.9973259172103969,21.33662222222222,2433.815904,14.267926361524507,118,9.000000000000002E-4
9,test_20231031_152409,11079715.png,443815,137332,306483,0.6905647623446707,5,7,124136,19058,105078,0.8464748340529742,15.998211555555555,1880.0749546666666,15.389051968440075,118,9.000000000000002E-4
10,test_20231031_152409,11551286.png,271883,567,271316,0.9979145441237591,2,6,40092,82,40010,0.9979547041803851,17.920218666666667,1855.396624,15.446435988293219,118,9.000000000000002E-4
1,test_20231031_152410,10404007.png,502730,28602,474128,0.9431066377578422,4,7,61265,4124,57141,0.932685872847466,25.022752,3241.604746666667,13.0232030125188,118,0.0010000000000000002
2,test_20231031_152410,1254659.png,342646,87709,254937,0.7440244450540792,5,6,80080,12093,67987,0.8489885114885115,19.573024,2807.328576,13.647871144634427,118,0.0010000000000000002
3,test_20231031_152410,10188041.png,221231,10987,210244,0.9503369780907739,3,5,41731,1548,40183,0.9629052742565479,10.670835555555556,1005.4561546666666,18.107172239774165,118,0.0010000000000000002
4,test_20231031_152410,10287332.png,216980,14162,202818,0.9347313116416259,3,6,22337,1930,20407,0.9135962752383937,9.281052444444445,733.059136,19.479413502069313,118,0.0010000000000000002
5,test_20231031_152410,11610969.png,368720,32862,335858,0.9108754610544587,4,6,84111,4797,79314,0.9429682205656811,19.756627555555557,2571.6013493333335,14.028767159017004,118,0.0010000000000000002
6,test_20231031_152410,10350842.png,212614,7389,205225,0.9652468793212112,3,6,42529,1084,41445,0.9745115097933175,18.857445333333335,2260.5212213333334,14.588717724063764,118,0.0010000000000000002
7,test_20231031_152410,10863862.png,317432,16002,301430,0.9495892033569394,3,6,66058,2276,63782,0.9655454297738351,22.952693333333333,3016.921312,13.3351637790865,118,0.0010000000000000002
8,test_20231031_152410,11382381.png,312486,927,311559,0.997033467099326,2,6,46745,123,46622,0.9973687025350305,21.377621333333334,2438.127232,14.260239956340525,118,0.0010000000000000002
9,test_20231031_152410,11079715.png,443815,137109,306706,0.6910672239559276,8,6,124136,19032,105104,0.846684281755494,16.070979555555557,1893.9525226666667,15.357112728967056,118,0.0010000000000000002
10,test_20231031_152410,11551286.png,271883,487,271396,0.9982087883391018,2,6,40092,70,40022,0.9982540157637434,17.985697777777776,1870.2736906666667,15.411751962304145,118,0.0010000000000000002
1,test_20231031_152411,10404007.png,502730,28422,474308,0.9434646828317387,4,6,61265,4099,57166,0.933093936178895,25.02945777777778,3242.877941333333,13.021497582951532,118,0.0011000000000000003
2,test_20231031_152411,1254659.png,342646,87709,254937,0.7440244450540792,5,6,80080,12093,67987,0.8489885114885115,19.573024,2807.328576,13.647871144634427,118,0.0011000000000000003
3,test_20231031_152411,10188041.png,221231,10867,210364,0.9508793975527842,3,5,41731,1534,40197,0.9632407562723155,10.718419555555556,1010.6850186666667,18.084645326447365,118,0.0011000000000000003
4,test_20231031_152411,10287332.png,216980,14162,202818,0.9347313116416259,3,6,22337,1930,20407,0.9135962752383937,9.281052444444445,733.059136,19.479413502069313,118,0.0011000000000000003
5,test_20231031_152411,11610969.png,368720,32862,335858,0.9108754610544587,4,6,84111,4797,79314,0.9429682205656811,19.756627555555557,2571.6013493333335,14.028767159017004,118,0.0011000000000000003
6,test_20231031_152411,10350842.png,212614,7389,205225,0.9652468793212112,2,5,42529,1084,41445,0.9745115097933175,18.857445333333335,2260.5212213333334,14.588717724063764,118,0.0011000000000000003
7,test_20231031_152411,10863862.png,317432,16002,301430,0.9495892033569394,3,6,66058,2276,63782,0.9655454297738351,22.952693333333333,3016.921312,13.3351637790865,118,0.0011000000000000003
8,test_20231031_152411,11382381.png,312486,927,311559,0.997033467099326,2,6,46745,123,46622,0.9973687025350305,21.377621333333334,2438.127232,14.260239956340525,118,0.0011000000000000003
9,test_20231031_152411,11079715.png,443815,137109,306706,0.6910672239559276,6,7,124136,19032,105104,0.846684281755494,16.070979555555557,1893.9525226666667,15.357112728967056,118,0.0011000000000000003
10,test_20231031_152411,11551286.png,271883,487,271396,0.9982087883391018,2,6,40092,70,40022,0.9982540157637434,17.985697777777776,1870.2736906666667,15.411751962304145,118,0.0011000000000000003
1,test_20231031_152412,10404007.png,502730,28422,474308,0.9434646828317387,4,5,61265,4099,57166,0.933093936178895,25.02945777777778,3242.877941333333,13.021497582951532,118,0.0012000000000000003
2,test_20231031_152412,1254659.png,342646,87709,254937,0.7440244450540792,5,7,80080,12093,67987,0.8489885114885115,19.573024,2807.328576,13.647871144634427,118,0.0012000000000000003
3,test_20231031_152412,10188041.png,221231,10867,210364,0.9508793975527842,3,5,41731,1534,40197,0.9632407562723155,10.718419555555556,1010.6850186666667,18.084645326447365,118,0.0012000000000000003
4,test_20231031_152412,10287332.png,216980,14162,202818,0.9347313116416259,2,5,22337,1930,20407,0.9135962752383937,9.281052444444445,733.059136,19.479413502069313,118,0.0012000000000000003
5,test_20231031_152412,11610969.png,368720,32862,335858,0.9108754610544587,4,5,84111,4797,79314,0.9429682205656811,19.756627555555557,2571.6013493333335,14.028767159017004,118,0.0012000000000000003
6,test_20231031_152412,10350842.png,212614,7389,205225,0.9652468793212112,3,6,42529,1084,41445,0.9745115097933175,18.857445333333335,2260.5212213333334,14.588717724063764,118,0.0012000000000000003
7,test_20231031_152412,10863862.png,317432,16002,301430,0.9495892033569394,3,6,66058,2276,63782,0.9655454297738351,22.952693333333333,3016.921312,13.3351637790865,118,0.0012000000000000003
8,test_20231031_152412,11382381.png,312486,927,311559,0.997033467099326,2,5,46745,123,46622,0.9973687025350305,21.377621333333334,2438.127232,14.260239956340525,118,0.0012000000000000003
9,test_20231031_152412,11079715.png,443815,137109,306706,0.6910672239559276,5,7,124136,19032,105104,0.846684281755494,16.070979555555557,1893.9525226666667,15.357112728967056,118,0.0012000000000000003
10,test_20231031_152412,11551286.png,271883,487,271396,0.9982087883391018,2,6,40092,70,40022,0.9982540157637434,17.985697777777776,1870.2736906666667,15.411751962304145,118,0.0012000000000000003
1,test_20231031_152413,10404007.png,502730,28162,474568,0.9439818590495892,3,6,61265,4062,57203,0.93369786990941,25.04216177777778,3246.334496,13.016870942123848,118,0.0013000000000000004
2,test_20231031_152413,1254659.png,342646,87709,254937,0.7440244450540792,4,6,80080,12093,67987,0.8489885114885115,19.573024,2807.328576,13.647871144634427,118,0.0013000000000000004
3,test_20231031_152413,10188041.png,221231,10727,210504,0.9515122202584628,4,6,41731,1513,40218,0.963743979295967,10.813498666666666,1034.7351626666666,17.982511532106162,118,0.0013000000000000004
4,test_20231031_152413,10287332.png,216980,14002,202978,0.9354687067932528,3,6,22337,1908,20429,0.9145811881631374,9.349073777777777,744.109568,19.41443471996413,118,0.0013000000000000004
5,test_20231031_152413,11610969.png,368720,32862,335858,0.9108754610544587,4,6,84111,4797,79314,0.9429682205656811,19.756627555555557,2571.6013493333335,14.028767159017004,118,0.0013000000000000004
6,test_20231031_152413,10350842.png,212614,5782,206832,0.9728051774577403,3,5,42529,849,41680,0.980037151120412,22.217029333333333,3078.0668746666665,13.248023097053906,118,0.0013000000000000004
7,test_20231031_152413,10863862.png,317432,16002,301430,0.9495892033569394,3,6,66058,2276,63782,0.9655454297738351,22.952693333333333,3016.921312,13.3351637790865,118,0.0013000000000000004
8,test_20231031_152413,11382381.png,312486,927,311559,0.997033467099326,2,6,46745,123,46622,0.9973687025350305,21.377621333333334,2438.127232,14.260239956340525,118,0.0013000000000000004
9,test_20231031_152413,11079715.png,443815,137109,306706,0.6910672239559276,5,7,124136,19032,105104,0.846684281755494,16.070979555555557,1893.9525226666667,15.357112728967056,118,0.0013000000000000004
10,test_20231031_152413,11551286.png,271883,487,271396,0.9982087883391018,2,5,40092,70,40022,0.9982540157637434,17.985697777777776,1870.2736906666667,15.411751962304145,118,0.0013000000000000004
1,test_20231031_152414,10404007.png,502730,28162,474568,0.9439818590495892,4,6,61265,4062,57203,0.93369786990941,25.04216177777778,3246.334496,13.016870942123848,118,0.0014000000000000004
2,test_20231031_152414,1254659.png,342646,87709,254937,0.7440244450540792,6,7,80080,12093,67987,0.8489885114885115,19.573024,2807.328576,13.647871144634427,118,0.0014000000000000004
3,test_20231031_152414,10188041.png,221231,10727,210504,0.9515122202584628,5,7,41731,1513,40218,0.963743979295967,10.813498666666666,1034.7351626666666,17.982511532106162,118,0.0014000000000000004
4,test_20231031_152414,10287332.png,216980,14002,202978,0.9354687067932528,3,16,22337,1908,20429,0.9145811881631374,9.349073777777777,744.109568,19.41443471996413,118,0.0014000000000000004
5,test_20231031_152414,11610969.png,368720,32862,335858,0.9108754610544587,4,7,84111,4797,79314,0.9429682205656811,19.756627555555557,2571.6013493333335,14.028767159017004,118,0.0014000000000000004
6,test_20231031_152414,10350842.png,212614,5782,206832,0.9728051774577403,3,5,42529,849,41680,0.980037151120412,22.217029333333333,3078.0668746666665,13.248023097053906,118,0.0014000000000000004
7,test_20231031_152414,10863862.png,317432,16002,301430,0.9495892033569394,3,5,66058,2276,63782,0.9655454297738351,22.952693333333333,3016.921312,13.3351637790865,118,0.0014000000000000004
8,test_20231031_152414,11382381.png,312486,927,311559,0.997033467099326,3,6,46745,123,46622,0.9973687025350305,21.377621333333334,2438.127232,14.260239956340525,118,0.0014000000000000004
9,test_20231031_152414,11079715.png,443815,137109,306706,0.6910672239559276,6,7,124136,19032,105104,0.846684281755494,16.070979555555557,1893.9525226666667,15.357112728967056,118,0.0014000000000000004
10,test_20231031_152414,11551286.png,271883,487,271396,0.9982087883391018,2,6,40092,70,40022,0.9982540157637434,17.985697777777776,1870.2736906666667,15.411751962304145,118,0.0014000000000000004
1,test_20231031_152415,10404007.png,502730,28864,473866,0.9425854832613928,3,6,61265,4157,57108,0.9321472292499796,24.88056,3217.1794826666664,13.056050705107438,119,1.0E-4
2,test_20231031_152415,1254659.png,342646,86484,256162,0.7475995633977925,5,7,80080,11940,68140,0.8508991008991009,19.493813333333332,2798.499050666667,13.661551969506212,119,1.0E-4
3,test_20231031_152415,10188041.png,221231,11287,209944,0.9489809294357482,3,6,41731,1585,40146,0.9620186432148763,10.129530666666666,932.9076746666667,18.43241695006526,119,1.0E-4
4,test_20231031_152415,10287332.png,216980,14232,202748,0.9344087012627892,3,6,22337,1937,20400,0.913282893853248,9.094965333333333,697.079072,19.697983165066027,119,1.0E-4
5,test_20231031_152415,11610969.png,368720,32782,335938,0.9110924278585376,3,5,84111,4776,79335,0.9432178906445055,18.815036444444445,2382.4364906666665,14.360590285231876,119,1.0E-4
6,test_20231031_152415,10350842.png,212614,7832,204782,0.9631632912225911,2,6,42529,1149,41380,0.9729831409156106,16.944677333333335,1852.7270346666667,15.45268922159092,119,1.0E-4
7,test_20231031_152415,10863862.png,317432,16322,301110,0.9485811134353185,4,6,66058,2323,63735,0.9648339338157377,22.752236444444446,2984.604368,13.381935906226355,119,1.0E-4
8,test_20231031_152415,11382381.png,312486,1402,311084,0.9955133990002752,2,5,46745,190,46555,0.9959353941598031,19.16794311111111,2039.7081386666666,15.035123320864711,119,1.0E-4
9,test_20231031_152415,11079715.png,443815,134879,308936,0.696091840068497,5,7,124136,18739,105397,0.849044596249275,16.172732444444446,1919.789856,15.298266682968674,119,1.0E-4
10,test_20231031_152415,11551286.png,271883,1462,270421,0.9946226869646134,3,6,40092,215,39877,0.9946373341314976,15.664478222222222,1460.3968373333332,16.48609477106633,119,1.0E-4
1,test_20231031_152416,10404007.png,502730,28864,473866,0.9425854832613928,4,6,61265,4157,57108,0.9321472292499796,24.88056,3217.1794826666664,13.056050705107438,119,2.0E-4
2,test_20231031_152416,1254659.png,342646,86484,256162,0.7475995633977925,11,7,80080,11940,68140,0.8508991008991009,19.493813333333332,2798.499050666667,13.661551969506212,119,2.0E-4
3,test_20231031_152416,10188041.png,221231,11287,209944,0.9489809294357482,4,6,41731,1585,40146,0.9620186432148763,10.129530666666666,932.9076746666667,18.43241695006526,119,2.0E-4
4,test_20231031_152416,10287332.png,216980,13982,202998,0.9355608811872062,2,5,22337,1907,20430,0.914625956932444,9.226016,724.1301226666667,19.532637470487003,119,2.0E-4
5,test_20231031_152416,11610969.png,368720,32782,335938,0.9110924278585376,4,6,84111,4776,79335,0.9432178906445055,18.815036444444445,2382.4364906666665,14.360590285231876,119,2.0E-4
6,test_20231031_152416,10350842.png,212614,7832,204782,0.9631632912225911,3,5,42529,1149,41380,0.9729831409156106,16.944677333333335,1852.7270346666667,15.45268922159092,119,2.0E-4
7,test_20231031_152416,10863862.png,317432,16322,301110,0.9485811134353185,3,6,66058,2323,63735,0.9648339338157377,22.752236444444446,2984.604368,13.381935906226355,119,2.0E-4
8,test_20231031_152416,11382381.png,312486,1402,311084,0.9955133990002752,2,5,46745,190,46555,0.9959353941598031,19.16794311111111,2039.7081386666666,15.035123320864711,119,2.0E-4
9,test_20231031_152416,11079715.png,443815,134879,308936,0.696091840068497,8,7,124136,18739,105397,0.849044596249275,16.172732444444446,1919.789856,15.298266682968674,119,2.0E-4
10,test_20231031_152416,11551286.png,271883,1462,270421,0.9946226869646134,3,6,40092,215,39877,0.9946373341314976,15.664478222222222,1460.3968373333332,16.48609477106633,119,2.0E-4
1,test_20231031_152417,10404007.png,502730,28482,474248,0.9433453344737732,4,6,61265,4103,57162,0.9330286460458663,24.933249777777778,3226.5467893333334,13.043423935162151,119,3.0000000000000003E-4
2,test_20231031_152417,1254659.png,342646,86402,256244,0.7478388774420247,5,7,80080,11933,68147,0.8509865134865136,19.50576,2799.9169813333333,13.659352063411694,119,3.0000000000000003E-4
3,test_20231031_152417,10188041.png,221231,11207,210024,0.9493425424104217,3,5,41731,1573,40158,0.9623061992283913,10.282732444444445,953.5231306666667,18.337491281958467,119,3.0000000000000003E-4
4,test_20231031_152417,10287332.png,216980,13962,203018,0.9356530555811595,2,6,22337,1904,20433,0.9147602632403635,9.297358222222222,736.8849386666667,19.456806808830528,119,3.0000000000000003E-4
5,test_20231031_152417,11610969.png,368720,32622,336098,0.9115263614666956,4,6,84111,4754,79357,0.9434794497747024,19.230421333333332,2474.925664,14.19518201719306,119,3.0000000000000003E-4
6,test_20231031_152417,10350842.png,212614,7692,204922,0.9638217615020648,2,6,42529,1128,41401,0.9734769216299466,17.473427555555556,1965.02312,15.197126963196443,119,3.0000000000000003E-4
7,test_20231031_152417,10863862.png,317432,16202,301230,0.9489591471559263,3,6,66058,2306,63752,0.9650912834176028,22.782085333333335,2989.8751626666667,13.37427305418678,119,3.0000000000000003E-4
8,test_20231031_152417,11382381.png,312486,1007,311479,0.9967774556300122,2,5,46745,134,46611,0.9971333832495454,20.861811555555555,2370.5086666666666,14.38238813413471,119,3.0000000000000003E-4
9,test_20231031_152417,11079715.png,443815,134879,308936,0.696091840068497,6,7,124136,18739,105397,0.849044596249275,16.172732444444446,1919.789856,15.298266682968674,119,3.0000000000000003E-4
10,test_20231031_152417,11551286.png,271883,1302,270581,0.9952111753952987,3,7,40092,191,39901,0.9952359572982141,16.06636622222222,1535.6389493333334,16.267912420109646,119,3.0000000000000003E-4
1,test_20231031_152418,10404007.png,502730,28482,474248,0.9433453344737732,4,6,61265,4103,57162,0.9330286460458663,24.933249777777778,3226.5467893333334,13.043423935162151,119,4.0E-4
2,test_20231031_152418,1254659.png,342646,86402,256244,0.7478388774420247,5,6,80080,11933,68147,0.8509865134865136,19.50576,2799.9169813333333,13.659352063411694,119,4.0E-4
3,test_20231031_152418,10188041.png,221231,11207,210024,0.9493425424104217,4,6,41731,1573,40158,0.9623061992283913,10.282732444444445,953.5231306666667,18.337491281958467,119,4.0E-4
4,test_20231031_152418,10287332.png,216980,13962,203018,0.9356530555811595,3,6,22337,1904,20433,0.9147602632403635,9.297358222222222,736.8849386666667,19.456806808830528,119,4.0E-4
5,test_20231031_152418,11610969.png,368720,32622,336098,0.9115263614666956,4,6,84111,4754,79357,0.9434794497747024,19.230421333333332,2474.925664,14.19518201719306,119,4.0E-4
6,test_20231031_152418,10350842.png,212614,7692,204922,0.9638217615020648,3,6,42529,1128,41401,0.9734769216299466,17.473427555555556,1965.02312,15.197126963196443,119,4.0E-4
7,test_20231031_152418,10863862.png,317432,16202,301230,0.9489591471559263,3,6,66058,2306,63752,0.9650912834176028,22.782085333333335,2989.8751626666667,13.37427305418678,119,4.0E-4
8,test_20231031_152418,11382381.png,312486,867,311619,0.9972254757013114,3,5,46745,113,46632,0.9975826291581987,21.35761422222222,2440.721536,14.25562127651933,119,4.0E-4
9,test_20231031_152418,11079715.png,443815,134879,308936,0.696091840068497,5,8,124136,18739,105397,0.849044596249275,16.172732444444446,1919.789856,15.298266682968674,119,4.0E-4
10,test_20231031_152418,11551286.png,271883,947,270936,0.9965168841008817,2,5,40092,139,39953,0.9965329741594333,16.59003911111111,1625.298352,16.021472658706333,119,4.0E-4
1,test_20231031_152419,10404007.png,502730,28482,474248,0.9433453344737732,3,5,61265,4103,57162,0.9330286460458663,24.933249777777778,3226.5467893333334,13.043423935162151,119,5.0E-4
2,test_20231031_152419,1254659.png,342646,86402,256244,0.7478388774420247,5,19,80080,11933,68147,0.8509865134865136,19.50576,2799.9169813333333,13.659352063411694,119,5.0E-4
3,test_20231031_152419,10188041.png,221231,11207,210024,0.9493425424104217,4,6,41731,1573,40158,0.9623061992283913,10.282732444444445,953.5231306666667,18.337491281958467,119,5.0E-4
4,test_20231031_152419,10287332.png,216980,13962,203018,0.9356530555811595,3,6,22337,1904,20433,0.9147602632403635,9.297358222222222,736.8849386666667,19.456806808830528,119,5.0E-4
5,test_20231031_152419,11610969.png,368720,32622,336098,0.9115263614666956,4,6,84111,4754,79357,0.9434794497747024,19.230421333333332,2474.925664,14.19518201719306,119,5.0E-4
6,test_20231031_152419,10350842.png,212614,7692,204922,0.9638217615020648,3,5,42529,1128,41401,0.9734769216299466,17.473427555555556,1965.02312,15.197126963196443,119,5.0E-4
7,test_20231031_152419,10863862.png,317432,16202,301230,0.9489591471559263,3,5,66058,2306,63752,0.9650912834176028,22.782085333333335,2989.8751626666667,13.37427305418678,119,5.0E-4
8,test_20231031_152419,11382381.png,312486,867,311619,0.9972254757013114,2,5,46745,113,46632,0.9975826291581987,21.35761422222222,2440.721536,14.25562127651933,119,5.0E-4
9,test_20231031_152419,11079715.png,443815,134879,308936,0.696091840068497,6,7,124136,18739,105397,0.849044596249275,16.172732444444446,1919.789856,15.298266682968674,119,5.0E-4
10,test_20231031_152419,11551286.png,271883,927,270956,0.9965904451547173,2,6,40092,136,39956,0.9966078020552729,17.295253333333335,1745.233664,15.712267793193245,119,5.0E-4
1,test_20231031_152420,10404007.png,502730,28382,474348,0.9435442484037158,4,6,61265,4090,57175,0.9332408389782094,24.93548977777778,3226.98008,13.042840763356448,119,6.000000000000001E-4
2,test_20231031_152420,1254659.png,342646,86402,256244,0.7478388774420247,5,6,80080,11933,68147,0.8509865134865136,19.50576,2799.9169813333333,13.659352063411694,119,6.000000000000001E-4
3,test_20231031_152420,10188041.png,221231,11107,210124,0.9497945586287636,4,6,41731,1559,40172,0.962641681244159,10.406085333333333,969.2385226666667,18.26649693899053,119,6.000000000000001E-4
4,test_20231031_152420,10287332.png,216980,13962,203018,0.9356530555811595,3,6,22337,1904,20433,0.9147602632403635,9.297358222222222,736.8849386666667,19.456806808830528,119,6.000000000000001E-4
5,test_20231031_152420,11610969.png,368720,32342,336378,0.9122857452809721,4,6,84111,4713,79398,0.9439669008809787,19.652298666666667,2565.75856,14.03864574375796,119,6.000000000000001E-4
6,test_20231031_152420,10350842.png,212614,7429,205185,0.9650587449556474,3,6,42529,1090,41439,0.9743704295892215,18.360709333333332,2170.492528,14.765220657652737,119,6.000000000000001E-4
7,test_20231031_152420,10863862.png,317432,16202,301230,0.9489591471559263,3,6,66058,2306,63752,0.9650912834176028,22.782085333333335,2989.8751626666667,13.37427305418678,119,6.000000000000001E-4
8,test_20231031_152420,11382381.png,312486,867,311619,0.9972254757013114,2,5,46745,113,46632,0.9975826291581987,21.35761422222222,2440.721536,14.25562127651933,119,6.000000000000001E-4
9,test_20231031_152420,11079715.png,443815,134879,308936,0.696091840068497,6,7,124136,18739,105397,0.849044596249275,16.172732444444446,1919.789856,15.298266682968674,119,6.000000000000001E-4
10,test_20231031_152420,11551286.png,271883,567,271316,0.9979145441237591,2,6,40092,82,40010,0.9979547041803851,17.920218666666667,1855.396624,15.446435988293219,119,6.000000000000001E-4
1,test_20231031_152421,10404007.png,502730,28382,474348,0.9435442484037158,4,6,61265,4090,57175,0.9332408389782094,24.93548977777778,3226.98008,13.042840763356448,119,7.000000000000001E-4
2,test_20231031_152421,1254659.png,342646,86402,256244,0.7478388774420247,5,6,80080,11933,68147,0.8509865134865136,19.50576,2799.9169813333333,13.659352063411694,119,7.000000000000001E-4
3,test_20231031_152421,10188041.png,221231,11107,210124,0.9497945586287636,3,5,41731,1559,40172,0.962641681244159,10.406085333333333,969.2385226666667,18.26649693899053,119,7.000000000000001E-4
4,test_20231031_152421,10287332.png,216980,13962,203018,0.9356530555811595,3,6,22337,1904,20433,0.9147602632403635,9.297358222222222,736.8849386666667,19.456806808830528,119,7.000000000000001E-4
5,test_20231031_152421,11610969.png,368720,32342,336378,0.9122857452809721,4,6,84111,4713,79398,0.9439669008809787,19.652298666666667,2565.75856,14.03864574375796,119,7.000000000000001E-4
6,test_20231031_152421,10350842.png,212614,7429,205185,0.9650587449556474,3,6,42529,1090,41439,0.9743704295892215,18.360709333333332,2170.492528,14.765220657652737,119,7.000000000000001E-4
7,test_20231031_152421,10863862.png,317432,16202,301230,0.9489591471559263,3,5,66058,2306,63752,0.9650912834176028,22.782085333333335,2989.8751626666667,13.37427305418678,119,7.000000000000001E-4
8,test_20231031_152421,11382381.png,312486,867,311619,0.9972254757013114,2,5,46745,113,46632,0.9975826291581987,21.35761422222222,2440.721536,14.25562127651933,119,7.000000000000001E-4
9,test_20231031_152421,11079715.png,443815,134879,308936,0.696091840068497,5,7,124136,18739,105397,0.849044596249275,16.172732444444446,1919.789856,15.298266682968674,119,7.000000000000001E-4
10,test_20231031_152421,11551286.png,271883,567,271316,0.9979145441237591,2,5,40092,82,40010,0.9979547041803851,17.920218666666667,1855.396624,15.446435988293219,119,7.000000000000001E-4
1,test_20231031_152422,10404007.png,502730,27859,474871,0.9445845682573151,4,6,61265,4014,57251,0.9344813515057537,24.981834666666668,3236.567648,13.029956721630942,119,8.000000000000001E-4
2,test_20231031_152422,1254659.png,342646,86402,256244,0.7478388774420247,5,6,80080,11933,68147,0.8509865134865136,19.50576,2799.9169813333333,13.659352063411694,119,8.000000000000001E-4
3,test_20231031_152422,10188041.png,221231,11007,210224,0.9502465748471055,3,5,41731,1546,40185,0.9629532002588004,10.533729777777777,980.386928,18.216828489195663,119,8.000000000000001E-4
4,test_20231031_152422,10287332.png,216980,13962,203018,0.9356530555811595,3,6,22337,1904,20433,0.9147602632403635,9.297358222222222,736.8849386666667,19.456806808830528,119,8.000000000000001E-4
5,test_20231031_152422,11610969.png,368720,32242,336478,0.9125569537860707,4,7,84111,4698,79413,0.9441452366515676,19.689834666666666,2569.700384,14.031978714514029,119,8.000000000000001E-4
6,test_20231031_152422,10350842.png,212614,7269,205345,0.9658112824179028,2,6,42529,1066,41463,0.9749347504056056,18.732389333333334,2239.665978666667,14.62897107908159,119,8.000000000000001E-4
7,test_20231031_152422,10863862.png,317432,16142,301290,0.9491481640162303,3,6,66058,2297,63761,0.9652275273244725,22.82393422222222,2991.742096,13.371562085443669,119,8.000000000000001E-4
8,test_20231031_152422,11382381.png,312486,867,311619,0.9972254757013114,3,6,46745,113,46632,0.9975826291581987,21.35761422222222,2440.721536,14.25562127651933,119,8.000000000000001E-4
9,test_20231031_152422,11079715.png,443815,134879,308936,0.696091840068497,7,7,124136,18739,105397,0.849044596249275,16.172732444444446,1919.789856,15.298266682968674,119,8.000000000000001E-4
10,test_20231031_152422,11551286.png,271883,567,271316,0.9979145441237591,2,17,40092,82,40010,0.9979547041803851,17.920218666666667,1855.396624,15.446435988293219,119,8.000000000000001E-4
1,test_20231031_152423,10404007.png,502730,27697,475033,0.9449068088238219,4,6,61265,3992,57273,0.9348404472374112,25.057685333333332,3253.2331733333335,13.007651687010817,119,9.000000000000002E-4
2,test_20231031_152423,1254659.png,342646,86402,256244,0.7478388774420247,5,7,80080,11933,68147,0.8509865134865136,19.50576,2799.9169813333333,13.659352063411694,119,9.000000000000002E-4
3,test_20231031_152423,10188041.png,221231,11007,210224,0.9502465748471055,3,6,41731,1546,40185,0.9629532002588004,10.533729777777777,980.386928,18.216828489195663,119,9.000000000000002E-4
4,test_20231031_152423,10287332.png,216980,13962,203018,0.9356530555811595,2,5,22337,1904,20433,0.9147602632403635,9.297358222222222,736.8849386666667,19.456806808830528,119,9.000000000000002E-4
5,test_20231031_152423,11610969.png,368720,32242,336478,0.9125569537860707,4,14,84111,4698,79413,0.9441452366515676,19.689834666666666,2569.700384,14.031978714514029,119,9.000000000000002E-4
6,test_20231031_152423,10350842.png,212614,7269,205345,0.9658112824179028,3,6,42529,1066,41463,0.9749347504056056,18.732389333333334,2239.665978666667,14.62897107908159,119,9.000000000000002E-4
7,test_20231031_152423,10863862.png,317432,16142,301290,0.9491481640162303,4,6,66058,2297,63761,0.9652275273244725,22.82393422222222,2991.742096,13.371562085443669,119,9.000000000000002E-4
8,test_20231031_152423,11382381.png,312486,867,311619,0.9972254757013114,2,6,46745,113,46632,0.9975826291581987,21.35761422222222,2440.721536,14.25562127651933,119,9.000000000000002E-4
9,test_20231031_152423,11079715.png,443815,134879,308936,0.696091840068497,6,7,124136,18739,105397,0.849044596249275,16.172732444444446,1919.789856,15.298266682968674,119,9.000000000000002E-4
10,test_20231031_152423,11551286.png,271883,567,271316,0.9979145441237591,2,6,40092,82,40010,0.9979547041803851,17.920218666666667,1855.396624,15.446435988293219,119,9.000000000000002E-4
1,test_20231031_152425,10404007.png,502730,26934,475796,0.9464245221092833,4,6,61265,3890,57375,0.9365053456296417,25.10156977777778,3264.2156746666665,12.993015149456546,119,0.0010000000000000002
2,test_20231031_152425,1254659.png,342646,86042,256604,0.7488895244654834,5,6,80080,11891,68189,0.851510989010989,19.858236444444444,2878.761344,13.53874698518499,119,0.0010000000000000002
3,test_20231031_152425,10188041.png,221231,10847,210384,0.9509698007964525,3,6,41731,1530,40201,0.9633366082768205,10.685633777777777,1008.2943626666666,18.094930217950093,119,0.0010000000000000002
4,test_20231031_152425,10287332.png,216980,13882,203098,0.936021753156973,2,6,22337,1893,20444,0.9152527197027354,9.332074666666667,743.4874773333333,19.418067028328462,119,0.0010000000000000002
5,test_20231031_152425,11610969.png,368720,31617,337103,0.9142520069429377,4,14,84111,4617,79494,0.9451082498127474,20.060256,2640.3675946666667,13.914159668685826,119,0.0010000000000000002
6,test_20231031_152425,10350842.png,212614,7147,205467,0.9663850922328727,3,6,42529,1048,41481,0.9753579910178937,18.887105777777776,2268.324858666667,14.573751086086212,119,0.0010000000000000002
7,test_20231031_152425,10863862.png,317432,15619,301813,0.9507957609818796,3,5,66058,2224,63834,0.9663326167913047,23.023237333333334,3037.0219893333333,13.306324244611517,119,0.0010000000000000002
8,test_20231031_152425,11382381.png,312486,827,311659,0.9973534814359684,2,5,46745,110,46635,0.9976468071451492,21.604046222222223,2480.41584,14.185558647682965,119,0.0010000000000000002
9,test_20231031_152425,11079715.png,443815,134797,309018,0.6962766017372104,5,7,124136,18733,105403,0.8490929303344719,16.191463111111112,1922.6554453333333,15.291788985731667,119,0.0010000000000000002
10,test_20231031_152425,11551286.png,271883,487,271396,0.9982087883391018,2,13,40092,70,40022,0.9982540157637434,17.985697777777776,1870.2736906666667,15.411751962304145,119,0.0010000000000000002
1,test_20231031_152426,10404007.png,502730,26672,476058,0.9469456766057327,4,6,61265,3853,57412,0.9371092793601568,25.11427377777778,3267.6722293333332,12.988418736351122,119,0.0011000000000000003
2,test_20231031_152426,1254659.png,342646,86042,256604,0.7488895244654834,5,7,80080,11891,68189,0.851510989010989,19.858236444444444,2878.761344,13.53874698518499,119,0.0011000000000000003
3,test_20231031_152426,10188041.png,221231,10727,210504,0.9515122202584628,3,6,41731,1516,40215,0.9636720902925883,10.733217777777778,1013.5232266666667,18.072466551032317,119,0.0011000000000000003
4,test_20231031_152426,10287332.png,216980,13882,203098,0.936021753156973,2,5,22337,1893,20444,0.9152527197027354,9.332074666666667,743.4874773333333,19.418067028328462,119,0.0011000000000000003
5,test_20231031_152426,11610969.png,368720,31617,337103,0.9142520069429377,4,5,84111,4617,79494,0.9451082498127474,20.060256,2640.3675946666667,13.914159668685826,119,0.0011000000000000003
6,test_20231031_152426,10350842.png,212614,7147,205467,0.9663850922328727,2,5,42529,1048,41481,0.9753579910178937,18.887105777777776,2268.324858666667,14.573751086086212,119,0.0011000000000000003
7,test_20231031_152426,10863862.png,317432,15619,301813,0.9507957609818796,4,6,66058,2224,63834,0.9663326167913047,23.023237333333334,3037.0219893333333,13.306324244611517,119,0.0011000000000000003
8,test_20231031_152426,11382381.png,312486,827,311659,0.9973534814359684,2,6,46745,110,46635,0.9976468071451492,21.604046222222223,2480.41584,14.185558647682965,119,0.0011000000000000003
9,test_20231031_152426,11079715.png,443815,134797,309018,0.6962766017372104,6,7,124136,18733,105403,0.8490929303344719,16.191463111111112,1922.6554453333333,15.291788985731667,119,0.0011000000000000003
10,test_20231031_152426,11551286.png,271883,487,271396,0.9982087883391018,2,5,40092,70,40022,0.9982540157637434,17.985697777777776,1870.2736906666667,15.411751962304145,119,0.0011000000000000003
1,test_20231031_152427,10404007.png,502730,26672,476058,0.9469456766057327,4,7,61265,3853,57412,0.9371092793601568,25.11427377777778,3267.6722293333332,12.988418736351122,119,0.0012000000000000003
2,test_20231031_152427,1254659.png,342646,86042,256604,0.7488895244654834,5,6,80080,11891,68189,0.851510989010989,19.858236444444444,2878.761344,13.53874698518499,119,0.0012000000000000003
3,test_20231031_152427,10188041.png,221231,10727,210504,0.9515122202584628,3,6,41731,1516,40215,0.9636720902925883,10.733217777777778,1013.5232266666667,18.072466551032317,119,0.0012000000000000003
4,test_20231031_152427,10287332.png,216980,13882,203098,0.936021753156973,3,6,22337,1893,20444,0.9152527197027354,9.332074666666667,743.4874773333333,19.418067028328462,119,0.0012000000000000003
5,test_20231031_152427,11610969.png,368720,31617,337103,0.9142520069429377,3,6,84111,4617,79494,0.9451082498127474,20.060256,2640.3675946666667,13.914159668685826,119,0.0012000000000000003
6,test_20231031_152427,10350842.png,212614,7147,205467,0.9663850922328727,3,6,42529,1048,41481,0.9753579910178937,18.887105777777776,2268.324858666667,14.573751086086212,119,0.0012000000000000003
7,test_20231031_152427,10863862.png,317432,15619,301813,0.9507957609818796,3,6,66058,2224,63834,0.9663326167913047,23.023237333333334,3037.0219893333333,13.306324244611517,119,0.0012000000000000003
8,test_20231031_152427,11382381.png,312486,827,311659,0.9973534814359684,2,5,46745,110,46635,0.9976468071451492,21.604046222222223,2480.41584,14.185558647682965,119,0.0012000000000000003
9,test_20231031_152427,11079715.png,443815,134797,309018,0.6962766017372104,6,7,124136,18733,105403,0.8490929303344719,16.191463111111112,1922.6554453333333,15.291788985731667,119,0.0012000000000000003
10,test_20231031_152427,11551286.png,271883,487,271396,0.9982087883391018,2,5,40092,70,40022,0.9982540157637434,17.985697777777776,1870.2736906666667,15.411751962304145,119,0.0012000000000000003
1,test_20231031_152428,10404007.png,502730,26372,476358,0.9475424183955602,3,5,61265,3810,57455,0.9378111482902146,25.16091377777778,3276.8573653333333,12.97622822993871,119,0.0013000000000000004
2,test_20231031_152428,1254659.png,342646,86042,256604,0.7488895244654834,5,6,80080,11891,68189,0.851510989010989,19.858236444444444,2878.761344,13.53874698518499,119,0.0013000000000000004
3,test_20231031_152428,10188041.png,221231,10587,210644,0.9521450429641416,3,5,41731,1495,40236,0.9641753133162397,10.82829688888889,1037.5733706666667,17.97061543822081,119,0.0013000000000000004
4,test_20231031_152428,10287332.png,216980,13722,203258,0.9367591483085999,3,5,22337,1871,20466,0.916237632627479,9.400096,754.5379093333333,19.353992964770615,119,0.0013000000000000004
5,test_20231031_152428,11610969.png,368720,31617,337103,0.9142520069429377,4,6,84111,4617,79494,0.9451082498127474,20.060256,2640.3675946666667,13.914159668685826,119,0.0013000000000000004
6,test_20231031_152428,10350842.png,212614,5562,207052,0.9738399164683417,3,6,42529,816,41713,0.9808130922429401,22.245409777777777,3085.434512,13.237640278711456,119,0.0013000000000000004
7,test_20231031_152428,10863862.png,317432,15619,301813,0.9507957609818796,4,6,66058,2224,63834,0.9663326167913047,23.023237333333334,3037.0219893333333,13.306324244611517,119,0.0013000000000000004
8,test_20231031_152428,11382381.png,312486,827,311659,0.9973534814359684,2,5,46745,110,46635,0.9976468071451492,21.604046222222223,2480.41584,14.185558647682965,119,0.0013000000000000004
9,test_20231031_152428,11079715.png,443815,134797,309018,0.6962766017372104,5,7,124136,18733,105403,0.8490929303344719,16.191463111111112,1922.6554453333333,15.291788985731667,119,0.0013000000000000004
10,test_20231031_152428,11551286.png,271883,487,271396,0.9982087883391018,2,6,40092,70,40022,0.9982540157637434,17.985697777777776,1870.2736906666667,15.411751962304145,119,0.0013000000000000004
1,test_20231031_152429,10404007.png,502730,26372,476358,0.9475424183955602,3,6,61265,3810,57455,0.9378111482902146,25.16091377777778,3276.8573653333333,12.97622822993871,119,0.0014000000000000004
2,test_20231031_152429,1254659.png,342646,86042,256604,0.7488895244654834,5,6,80080,11891,68189,0.851510989010989,19.858236444444444,2878.761344,13.53874698518499,119,0.0014000000000000004
3,test_20231031_152429,10188041.png,221231,10587,210644,0.9521450429641416,3,6,41731,1495,40236,0.9641753133162397,10.82829688888889,1037.5733706666667,17.97061543822081,119,0.0014000000000000004
4,test_20231031_152429,10287332.png,216980,13722,203258,0.9367591483085999,2,5,22337,1871,20466,0.916237632627479,9.400096,754.5379093333333,19.353992964770615,119,0.0014000000000000004
5,test_20231031_152429,11610969.png,368720,31617,337103,0.9142520069429377,3,6,84111,4617,79494,0.9451082498127474,20.060256,2640.3675946666667,13.914159668685826,119,0.0014000000000000004
6,test_20231031_152429,10350842.png,212614,5562,207052,0.9738399164683417,2,6,42529,816,41713,0.9808130922429401,22.245409777777777,3085.434512,13.237640278711456,119,0.0014000000000000004
7,test_20231031_152429,10863862.png,317432,15619,301813,0.9507957609818796,3,5,66058,2224,63834,0.9663326167913047,23.023237333333334,3037.0219893333333,13.306324244611517,119,0.0014000000000000004
8,test_20231031_152429,11382381.png,312486,827,311659,0.9973534814359684,3,5,46745,110,46635,0.9976468071451492,21.604046222222223,2480.41584,14.185558647682965,119,0.0014000000000000004
9,test_20231031_152429,11079715.png,443815,134797,309018,0.6962766017372104,6,9,124136,18733,105403,0.8490929303344719,16.191463111111112,1922.6554453333333,15.291788985731667,119,0.0014000000000000004
10,test_20231031_152429,11551286.png,271883,487,271396,0.9982087883391018,2,6,40092,70,40022,0.9982540157637434,17.985697777777776,1870.2736906666667,15.411751962304145,119,0.0014000000000000004
1,test_20231031_152430,10404007.png,502730,27377,475353,0.9455433333996379,3,5,61265,3948,57317,0.9355586387007263,24.98091911111111,3241.6444,13.02314988723095,120,1.0E-4
2,test_20231031_152430,1254659.png,342646,84372,258274,0.7537633592687497,5,6,80080,11681,68399,0.8541333666333666,19.952688,2913.615216,13.48648164361196,120,1.0E-4
3,test_20231031_152430,10188041.png,221231,11047,210184,0.9500657683597687,3,6,41731,1550,40181,0.9628573482542954,10.226010666666667,952.9778293333334,18.33997563807963,120,1.0E-4
4,test_20231031_152430,10287332.png,216980,13912,203068,0.935883491566043,3,6,22337,1894,20443,0.9152079509334289,9.119530666666666,704.3960426666666,19.65263453454638,120,1.0E-4
5,test_20231031_152430,11610969.png,368720,31817,336903,0.9137095899327403,4,6,84111,4634,79477,0.9449061359394134,18.97863288888889,2421.380016,14.290174070724388,120,1.0E-4
6,test_20231031_152430,10350842.png,212614,7712,204902,0.9637276943192828,3,6,42529,1131,41398,0.9734063815278986,16.956055111111112,1855.6201013333334,15.445912924238282,120,1.0E-4
7,test_20231031_152430,10863862.png,317432,15377,302055,0.9515581289851055,3,6,66058,2195,63863,0.9667716249356626,23.047130666666668,3065.621008,13.26561897338453,120,1.0E-4
8,test_20231031_152430,11382381.png,312486,1362,311124,0.9956414047349321,3,6,46745,184,46561,0.9960637501337042,19.183123555555557,2043.048048,15.028017804636116,120,1.0E-4
9,test_20231031_152430,11079715.png,443815,132247,311568,0.702022238995978,5,6,124136,18385,105751,0.8518963072758909,16.302611555555554,1952.235056,15.225482537985677,120,1.0E-4
10,test_20231031_152430,11551286.png,271883,1462,270421,0.9946226869646134,2,6,40092,215,39877,0.9946373341314976,15.664478222222222,1460.3968373333332,16.48609477106633,120,1.0E-4
1,test_20231031_152431,10404007.png,502730,27377,475353,0.9455433333996379,4,6,61265,3948,57317,0.9355586387007263,24.98091911111111,3241.6444,13.02314988723095,120,2.0E-4
2,test_20231031_152431,1254659.png,342646,84372,258274,0.7537633592687497,5,7,80080,11681,68399,0.8541333666333666,19.952688,2913.615216,13.48648164361196,120,2.0E-4
3,test_20231031_152431,10188041.png,221231,11047,210184,0.9500657683597687,4,6,41731,1550,40181,0.9628573482542954,10.226010666666667,952.9778293333334,18.33997563807963,120,2.0E-4
4,test_20231031_152431,10287332.png,216980,13662,203318,0.93703567149046,3,6,22337,1864,20473,0.9165510140126247,9.250581333333333,731.4470933333333,19.488974424426054,120,2.0E-4
5,test_20231031_152431,11610969.png,368720,31817,336903,0.9137095899327403,4,6,84111,4634,79477,0.9449061359394134,18.97863288888889,2421.380016,14.290174070724388,120,2.0E-4
6,test_20231031_152431,10350842.png,212614,7712,204902,0.9637276943192828,3,5,42529,1131,41398,0.9734063815278986,16.956055111111112,1855.6201013333334,15.445912924238282,120,2.0E-4
7,test_20231031_152431,10863862.png,317432,15377,302055,0.9515581289851055,3,6,66058,2195,63863,0.9667716249356626,23.047130666666668,3065.621008,13.26561897338453,120,2.0E-4
8,test_20231031_152431,11382381.png,312486,1259,311227,0.9959710195016737,3,5,46745,169,46576,0.9963846400684565,20.086165333333334,2234.270282666667,14.639446517255376,120,2.0E-4
9,test_20231031_152431,11079715.png,443815,132247,311568,0.702022238995978,7,6,124136,18385,105751,0.8518963072758909,16.302611555555554,1952.235056,15.225482537985677,120,2.0E-4
10,test_20231031_152431,11551286.png,271883,1462,270421,0.9946226869646134,3,6,40092,215,39877,0.9946373341314976,15.664478222222222,1460.3968373333332,16.48609477106633,120,2.0E-4
1,test_20231031_152432,10404007.png,502730,27237,475493,0.9458218129015575,4,6,61265,3928,57337,0.9358850893658696,24.993056,3243.490410666667,13.020677425852345,120,3.0000000000000003E-4
2,test_20231031_152432,1254659.png,342646,84312,258334,0.7539384671059928,5,6,80080,11676,68404,0.8541958041958042,19.962241777777777,2914.6974026666667,13.484868869095994,120,3.0000000000000003E-4
3,test_20231031_152432,10188041.png,221231,10967,210264,0.9504273813344423,3,5,41731,1538,40193,0.9631449042678105,10.379212444444445,973.5932853333334,18.247027908726242,120,3.0000000000000003E-4
4,test_20231031_152432,10287332.png,216980,13642,203338,0.9371278458844133,2,5,22337,1861,20476,0.9166853203205444,9.321923555555555,744.2019093333333,19.413895809498406,120,3.0000000000000003E-4
5,test_20231031_152432,11610969.png,368720,31657,337063,0.9141435235408982,4,6,84111,4612,79499,0.9451676950696104,19.394017777777776,2513.8691893333335,14.127376856996587,120,3.0000000000000003E-4
6,test_20231031_152432,10350842.png,212614,7572,205042,0.9643861645987565,3,6,42529,1110,41419,0.9739001622422347,17.484805333333334,1967.9161866666666,15.190737629327984,120,3.0000000000000003E-4
7,test_20231031_152432,10863862.png,317432,15277,302155,0.951873157085612,3,5,66058,2180,63878,0.9669986981137788,23.077662222222223,3070.805008,13.258281206665272,120,3.0000000000000003E-4
8,test_20231031_152432,11382381.png,312486,987,311499,0.9968414584973406,2,5,46745,131,46614,0.9971975612364958,20.862908444444443,2370.7645866666667,14.381919295331382,120,3.0000000000000003E-4
9,test_20231031_152432,11079715.png,443815,132247,311568,0.702022238995978,5,7,124136,18385,105751,0.8518963072758909,16.302611555555554,1952.235056,15.225482537985677,120,3.0000000000000003E-4
10,test_20231031_152432,11551286.png,271883,1302,270581,0.9952111753952987,3,6,40092,191,39901,0.9952359572982141,16.06636622222222,1535.6389493333334,16.267912420109646,120,3.0000000000000003E-4
1,test_20231031_152433,10404007.png,502730,27237,475493,0.9458218129015575,6,5,61265,3928,57337,0.9358850893658696,24.993056,3243.490410666667,13.020677425852345,120,4.0E-4
2,test_20231031_152433,1254659.png,342646,84312,258334,0.7539384671059928,5,6,80080,11676,68404,0.8541958041958042,19.962241777777777,2914.6974026666667,13.484868869095994,120,4.0E-4
3,test_20231031_152433,10188041.png,221231,10967,210264,0.9504273813344423,3,5,41731,1538,40193,0.9631449042678105,10.379212444444445,973.5932853333334,18.247027908726242,120,4.0E-4
4,test_20231031_152433,10287332.png,216980,13642,203338,0.9371278458844133,3,6,22337,1861,20476,0.9166853203205444,9.321923555555555,744.2019093333333,19.413895809498406,120,4.0E-4
5,test_20231031_152433,11610969.png,368720,31657,337063,0.9141435235408982,4,6,84111,4612,79499,0.9451676950696104,19.394017777777776,2513.8691893333335,14.127376856996587,120,4.0E-4
6,test_20231031_152433,10350842.png,212614,7572,205042,0.9643861645987565,3,6,42529,1110,41419,0.9739001622422347,17.484805333333334,1967.9161866666666,15.190737629327984,120,4.0E-4
7,test_20231031_152433,10863862.png,317432,15277,302155,0.951873157085612,3,6,66058,2180,63878,0.9669986981137788,23.077662222222223,3070.805008,13.258281206665272,120,4.0E-4
8,test_20231031_152433,11382381.png,312486,847,311639,0.9972894785686399,3,6,46745,110,46635,0.9976468071451492,21.358711111111113,2440.977456,14.2551659242164,120,4.0E-4
9,test_20231031_152433,11079715.png,443815,132247,311568,0.702022238995978,5,7,124136,18385,105751,0.8518963072758909,16.302611555555554,1952.235056,15.225482537985677,120,4.0E-4
10,test_20231031_152433,11551286.png,271883,647,271236,0.9976202999084165,2,6,40092,94,39998,0.9976553925970268,17.770117333333335,1836.7047093333333,15.490410213370003,120,4.0E-4
1,test_20231031_152434,10404007.png,502730,27237,475493,0.9458218129015575,4,6,61265,3928,57337,0.9358850893658696,24.993056,3243.490410666667,13.020677425852345,120,5.0E-4
2,test_20231031_152434,1254659.png,342646,84312,258334,0.7539384671059928,5,7,80080,11676,68404,0.8541958041958042,19.962241777777777,2914.6974026666667,13.484868869095994,120,5.0E-4
3,test_20231031_152434,10188041.png,221231,10967,210264,0.9504273813344423,4,6,41731,1538,40193,0.9631449042678105,10.379212444444445,973.5932853333334,18.247027908726242,120,5.0E-4
4,test_20231031_152434,10287332.png,216980,13642,203338,0.9371278458844133,2,6,22337,1861,20476,0.9166853203205444,9.321923555555555,744.2019093333333,19.413895809498406,120,5.0E-4
5,test_20231031_152434,11610969.png,368720,31657,337063,0.9141435235408982,4,6,84111,4612,79499,0.9451676950696104,19.394017777777776,2513.8691893333335,14.127376856996587,120,5.0E-4
6,test_20231031_152434,10350842.png,212614,7572,205042,0.9643861645987565,2,5,42529,1110,41419,0.9739001622422347,17.484805333333334,1967.9161866666666,15.190737629327984,120,5.0E-4
7,test_20231031_152434,10863862.png,317432,15277,302155,0.951873157085612,3,6,66058,2180,63878,0.9669986981137788,23.077662222222223,3070.805008,13.258281206665272,120,5.0E-4
8,test_20231031_152434,11382381.png,312486,847,311639,0.9972894785686399,2,6,46745,110,46635,0.9976468071451492,21.358711111111113,2440.977456,14.2551659242164,120,5.0E-4
9,test_20231031_152434,11079715.png,443815,132247,311568,0.702022238995978,5,6,124136,18385,105751,0.8518963072758909,16.302611555555554,1952.235056,15.225482537985677,120,5.0E-4
10,test_20231031_152434,11551286.png,271883,647,271236,0.9976202999084165,2,5,40092,94,39998,0.9976553925970268,17.770117333333335,1836.7047093333333,15.490410213370003,120,5.0E-4
1,test_20231031_152435,10404007.png,502730,27117,475613,0.9460605096174886,3,5,61265,3912,57353,0.9361462498979842,25.00584,3245.6972,13.017723600120569,120,6.000000000000001E-4
2,test_20231031_152435,1254659.png,342646,84312,258334,0.7539384671059928,5,6,80080,11676,68404,0.8541958041958042,19.962241777777777,2914.6974026666667,13.484868869095994,120,6.000000000000001E-4
3,test_20231031_152435,10188041.png,221231,10867,210364,0.9508793975527842,4,6,41731,1524,40207,0.9634803862835781,10.502565333333333,989.3086773333333,18.177485425299558,120,6.000000000000001E-4
4,test_20231031_152435,10287332.png,216980,13642,203338,0.9371278458844133,3,6,22337,1861,20476,0.9166853203205444,9.321923555555555,744.2019093333333,19.413895809498406,120,6.000000000000001E-4
5,test_20231031_152435,11610969.png,368720,31297,337423,0.9151198741592537,4,6,84111,4559,79552,0.9457978147923577,19.816019555555556,2600.808432,13.979719963649465,120,6.000000000000001E-4
6,test_20231031_152435,10350842.png,212614,7309,205305,0.965623148052339,3,6,42529,1072,41457,0.9747936702015095,18.37208711111111,2173.3855946666667,14.75943576664335,120,6.000000000000001E-4
7,test_20231031_152435,10863862.png,317432,15277,302155,0.951873157085612,3,6,66058,2180,63878,0.9669986981137788,23.077662222222223,3070.805008,13.258281206665272,120,6.000000000000001E-4
8,test_20231031_152435,11382381.png,312486,847,311639,0.9972894785686399,2,5,46745,110,46635,0.9976468071451492,21.358711111111113,2440.977456,14.2551659242164,120,6.000000000000001E-4
9,test_20231031_152435,11079715.png,443815,132247,311568,0.702022238995978,5,7,124136,18385,105751,0.8518963072758909,16.302611555555554,1952.235056,15.225482537985677,120,6.000000000000001E-4
10,test_20231031_152435,11551286.png,271883,567,271316,0.9979145441237591,2,5,40092,82,40010,0.9979547041803851,17.920218666666667,1855.396624,15.446435988293219,120,6.000000000000001E-4
1,test_20231031_152436,10404007.png,502730,26794,475936,0.9467030016112028,3,6,61265,3866,57399,0.9368970864278136,25.095884444444444,3265.691738666667,12.991051732763237,120,7.000000000000001E-4
2,test_20231031_152436,1254659.png,342646,84312,258334,0.7539384671059928,5,6,80080,11676,68404,0.8541958041958042,19.962241777777777,2914.6974026666667,13.484868869095994,120,7.000000000000001E-4
3,test_20231031_152436,10188041.png,221231,10867,210364,0.9508793975527842,3,5,41731,1524,40207,0.9634803862835781,10.502565333333333,989.3086773333333,18.177485425299558,120,7.000000000000001E-4
4,test_20231031_152436,10287332.png,216980,13642,203338,0.9371278458844133,3,6,22337,1861,20476,0.9166853203205444,9.321923555555555,744.2019093333333,19.413895809498406,120,7.000000000000001E-4
5,test_20231031_152436,11610969.png,368720,31297,337423,0.9151198741592537,3,6,84111,4559,79552,0.9457978147923577,19.816019555555556,2600.808432,13.979719963649465,120,7.000000000000001E-4
6,test_20231031_152436,10350842.png,212614,7309,205305,0.965623148052339,2,6,42529,1072,41457,0.9747936702015095,18.37208711111111,2173.3855946666667,14.75943576664335,120,7.000000000000001E-4
7,test_20231031_152436,10863862.png,317432,15277,302155,0.951873157085612,3,6,66058,2180,63878,0.9669986981137788,23.077662222222223,3070.805008,13.258281206665272,120,7.000000000000001E-4
8,test_20231031_152436,11382381.png,312486,847,311639,0.9972894785686399,2,6,46745,110,46635,0.9976468071451492,21.358711111111113,2440.977456,14.2551659242164,120,7.000000000000001E-4
9,test_20231031_152436,11079715.png,443815,132247,311568,0.702022238995978,6,7,124136,18385,105751,0.8518963072758909,16.302611555555554,1952.235056,15.225482537985677,120,7.000000000000001E-4
10,test_20231031_152436,11551286.png,271883,567,271316,0.9979145441237591,2,12,40092,82,40010,0.9979547041803851,17.920218666666667,1855.396624,15.446435988293219,120,7.000000000000001E-4
1,test_20231031_152437,10404007.png,502730,26252,476478,0.9477811151114912,4,6,61265,3789,57476,0.938153921488615,25.131184,3274.4032693333334,12.979481956084404,120,8.000000000000001E-4
2,test_20231031_152437,1254659.png,342646,84312,258334,0.7539384671059928,4,6,80080,11676,68404,0.8541958041958042,19.962241777777777,2914.6974026666667,13.484868869095994,120,8.000000000000001E-4
3,test_20231031_152437,10188041.png,221231,10767,210464,0.9513314137711261,3,6,41731,1511,40220,0.9637919052982196,10.630209777777777,1000.4570826666667,18.128818977415765,120,8.000000000000001E-4
4,test_20231031_152437,10287332.png,216980,13642,203338,0.9371278458844133,3,11,22337,1861,20476,0.9166853203205444,9.321923555555555,744.2019093333333,19.413895809498406,120,8.000000000000001E-4
5,test_20231031_152437,11610969.png,368720,31297,337423,0.9151198741592537,3,5,84111,4559,79552,0.9457978147923577,19.816019555555556,2600.808432,13.979719963649465,120,8.000000000000001E-4
6,test_20231031_152437,10350842.png,212614,7167,205447,0.9662910250500908,2,6,42529,1051,41478,0.9752874509158457,18.742366222222223,2242.4111946666667,14.623651080056984,120,8.000000000000001E-4
7,test_20231031_152437,10863862.png,317432,15217,302215,0.952062173945916,3,6,66058,2171,63887,0.9671349420206485,23.119511111111112,3072.6719413333335,13.255641662718435,120,8.000000000000001E-4
8,test_20231031_152437,11382381.png,312486,847,311639,0.9972894785686399,2,11,46745,110,46635,0.9976468071451492,21.358711111111113,2440.977456,14.2551659242164,120,8.000000000000001E-4
9,test_20231031_152437,11079715.png,443815,132247,311568,0.702022238995978,6,7,124136,18385,105751,0.8518963072758909,16.302611555555554,1952.235056,15.225482537985677,120,8.000000000000001E-4
10,test_20231031_152437,11551286.png,271883,567,271316,0.9979145441237591,2,5,40092,82,40010,0.9979547041803851,17.920218666666667,1855.396624,15.446435988293219,120,8.000000000000001E-4
1,test_20231031_152438,10404007.png,502730,26252,476478,0.9477811151114912,4,6,61265,3789,57476,0.938153921488615,25.131184,3274.4032693333334,12.979481956084404,120,9.000000000000002E-4
2,test_20231031_152438,1254659.png,342646,84312,258334,0.7539384671059928,4,6,80080,11676,68404,0.8541958041958042,19.962241777777777,2914.6974026666667,13.484868869095994,120,9.000000000000002E-4
3,test_20231031_152438,10188041.png,221231,10767,210464,0.9513314137711261,3,5,41731,1511,40220,0.9637919052982196,10.630209777777777,1000.4570826666667,18.128818977415765,120,9.000000000000002E-4
4,test_20231031_152438,10287332.png,216980,13642,203338,0.9371278458844133,2,5,22337,1861,20476,0.9166853203205444,9.321923555555555,744.2019093333333,19.413895809498406,120,9.000000000000002E-4
5,test_20231031_152438,11610969.png,368720,31297,337423,0.9151198741592537,3,6,84111,4559,79552,0.9457978147923577,19.816019555555556,2600.808432,13.979719963649465,120,9.000000000000002E-4
6,test_20231031_152438,10350842.png,212614,7167,205447,0.9662910250500908,2,5,42529,1051,41478,0.9752874509158457,18.742366222222223,2242.4111946666667,14.623651080056984,120,9.000000000000002E-4
7,test_20231031_152438,10863862.png,317432,15217,302215,0.952062173945916,3,5,66058,2171,63887,0.9671349420206485,23.119511111111112,3072.6719413333335,13.255641662718435,120,9.000000000000002E-4
8,test_20231031_152438,11382381.png,312486,847,311639,0.9972894785686399,2,5,46745,110,46635,0.9976468071451492,21.358711111111113,2440.977456,14.2551659242164,120,9.000000000000002E-4
9,test_20231031_152438,11079715.png,443815,132247,311568,0.702022238995978,6,7,124136,18385,105751,0.8518963072758909,16.302611555555554,1952.235056,15.225482537985677,120,9.000000000000002E-4
10,test_20231031_152438,11551286.png,271883,567,271316,0.9979145441237591,2,5,40092,82,40010,0.9979547041803851,17.920218666666667,1855.396624,15.446435988293219,120,9.000000000000002E-4
1,test_20231031_152439,10404007.png,502730,25769,476961,0.9487418693931136,4,6,61265,3726,57539,0.9391822410838162,25.164213333333333,3281.9456746666665,12.969489728734926,120,0.0010000000000000002
2,test_20231031_152439,1254659.png,342646,84152,258494,0.7544054213386411,5,7,80080,11662,68418,0.8543706293706294,20.031966222222223,2929.3778613333334,13.463049657968673,120,0.0010000000000000002
3,test_20231031_152439,10188041.png,221231,10504,210727,0.9525202164253653,3,6,41731,1483,40248,0.9644628693297549,10.761733333333334,1020.367216,18.04323864418027,120,0.0010000000000000002
4,test_20231031_152439,10287332.png,216980,13559,203421,0.9375103696193198,2,6,22337,1850,20487,0.9171777767829162,9.35664,750.804448,19.375535240148544,120,0.0010000000000000002
5,test_20231031_152439,11610969.png,368720,30692,338028,0.9167606856151009,4,6,84111,4481,79630,0.9467251607994198,20.176567111111112,2670.363557333333,13.865099683440906,120,0.0010000000000000002
6,test_20231031_152439,10350842.png,212614,7047,205567,0.9668554281467824,2,6,42529,1033,41496,0.9757106915281337,18.897082666666666,2271.0700746666666,14.568498261323061,120,0.0010000000000000002
7,test_20231031_152439,10863862.png,317432,14797,302635,0.9533852919680436,4,6,66058,2114,63944,0.9679978200974901,23.30008,3113.238448,13.198679755902349,120,0.0010000000000000002
8,test_20231031_152439,11382381.png,312486,767,311719,0.9975454900379537,2,5,46745,101,46644,0.9978393411060006,21.620851555555557,2482.477712,14.181950028339719,120,0.0010000000000000002
9,test_20231031_152439,11079715.png,443815,132167,311648,0.7022024942825276,5,7,124136,18379,105757,0.8519446413610878,16.32134222222222,1955.1006453333334,15.219112418020991,120,0.0010000000000000002
10,test_20231031_152439,11551286.png,271883,487,271396,0.9982087883391018,2,6,40092,70,40022,0.9982540157637434,17.985697777777776,1870.2736906666667,15.411751962304145,120,0.0010000000000000002
1,test_20231031_152440,10404007.png,502730,25487,477243,0.9493028066755514,3,6,61265,3686,57579,0.9398351424141027,25.21002488888889,3290.950544,12.957590050485548,120,0.0011000000000000003
2,test_20231031_152440,1254659.png,342646,84152,258494,0.7544054213386411,5,6,80080,11662,68418,0.8543706293706294,20.031966222222223,2929.3778613333334,13.463049657968673,120,0.0011000000000000003
3,test_20231031_152440,10188041.png,221231,10504,210727,0.9525202164253653,3,6,41731,1483,40248,0.9644628693297549,10.761733333333334,1020.367216,18.04323864418027,120,0.0011000000000000003
4,test_20231031_152440,10287332.png,216980,13559,203421,0.9375103696193198,3,6,22337,1850,20487,0.9171777767829162,9.35664,750.804448,19.375535240148544,120,0.0011000000000000003
5,test_20231031_152440,11610969.png,368720,30692,338028,0.9167606856151009,4,6,84111,4481,79630,0.9467251607994198,20.176567111111112,2670.363557333333,13.865099683440906,120,0.0011000000000000003
6,test_20231031_152440,10350842.png,212614,7047,205567,0.9668554281467824,3,6,42529,1033,41496,0.9757106915281337,18.897082666666666,2271.0700746666666,14.568498261323061,120,0.0011000000000000003
7,test_20231031_152440,10863862.png,317432,14797,302635,0.9533852919680436,3,6,66058,2114,63944,0.9679978200974901,23.30008,3113.238448,13.198679755902349,120,0.0011000000000000003
8,test_20231031_152440,11382381.png,312486,767,311719,0.9975454900379537,2,5,46745,101,46644,0.9978393411060006,21.620851555555557,2482.477712,14.181950028339719,120,0.0011000000000000003
9,test_20231031_152440,11079715.png,443815,132167,311648,0.7022024942825276,5,7,124136,18379,105757,0.8519446413610878,16.32134222222222,1955.1006453333334,15.219112418020991,120,0.0011000000000000003
10,test_20231031_152440,11551286.png,271883,487,271396,0.9982087883391018,2,5,40092,70,40022,0.9982540157637434,17.985697777777776,1870.2736906666667,15.411751962304145,120,0.0011000000000000003
1,test_20231031_152441,10404007.png,502730,25487,477243,0.9493028066755514,3,5,61265,3686,57579,0.9398351424141027,25.21002488888889,3290.950544,12.957590050485548,120,0.0012000000000000003
2,test_20231031_152441,1254659.png,342646,84152,258494,0.7544054213386411,6,7,80080,11662,68418,0.8543706293706294,20.031966222222223,2929.3778613333334,13.463049657968673,120,0.0012000000000000003
3,test_20231031_152441,10188041.png,221231,10504,210727,0.9525202164253653,3,5,41731,1483,40248,0.9644628693297549,10.761733333333334,1020.367216,18.04323864418027,120,0.0012000000000000003
4,test_20231031_152441,10287332.png,216980,13559,203421,0.9375103696193198,3,5,22337,1850,20487,0.9171777767829162,9.35664,750.804448,19.375535240148544,120,0.0012000000000000003
5,test_20231031_152441,11610969.png,368720,30692,338028,0.9167606856151009,4,6,84111,4481,79630,0.9467251607994198,20.176567111111112,2670.363557333333,13.865099683440906,120,0.0012000000000000003
6,test_20231031_152441,10350842.png,212614,7047,205567,0.9668554281467824,3,5,42529,1033,41496,0.9757106915281337,18.897082666666666,2271.0700746666666,14.568498261323061,120,0.0012000000000000003
7,test_20231031_152441,10863862.png,317432,14797,302635,0.9533852919680436,4,6,66058,2114,63944,0.9679978200974901,23.30008,3113.238448,13.198679755902349,120,0.0012000000000000003
8,test_20231031_152441,11382381.png,312486,767,311719,0.9975454900379537,2,6,46745,101,46644,0.9978393411060006,21.620851555555557,2482.477712,14.181950028339719,120,0.0012000000000000003
9,test_20231031_152441,11079715.png,443815,132167,311648,0.7022024942825276,6,7,124136,18379,105757,0.8519446413610878,16.32134222222222,1955.1006453333334,15.219112418020991,120,0.0012000000000000003
10,test_20231031_152441,11551286.png,271883,487,271396,0.9982087883391018,2,6,40092,70,40022,0.9982540157637434,17.985697777777776,1870.2736906666667,15.411751962304145,120,0.0012000000000000003
1,test_20231031_152442,10404007.png,502730,25487,477243,0.9493028066755514,4,6,61265,3686,57579,0.9398351424141027,25.21002488888889,3290.950544,12.957590050485548,120,0.0013000000000000004
2,test_20231031_152442,1254659.png,342646,84152,258494,0.7544054213386411,5,6,80080,11662,68418,0.8543706293706294,20.031966222222223,2929.3778613333334,13.463049657968673,120,0.0013000000000000004
3,test_20231031_152442,10188041.png,221231,10384,210847,0.9530626358873756,3,6,41731,1465,40266,0.9648942033500275,10.856592,1044.2380853333334,17.94280832165137,120,0.0013000000000000004
4,test_20231031_152442,10287332.png,216980,13399,203581,0.9382477647709466,3,6,22337,1828,20509,0.9181626897076599,9.424661333333333,761.85488,19.312081071364386,120,0.0013000000000000004
5,test_20231031_152442,11610969.png,368720,30692,338028,0.9167606856151009,4,6,84111,4481,79630,0.9467251607994198,20.176567111111112,2670.363557333333,13.865099683440906,120,0.0013000000000000004
6,test_20231031_152442,10350842.png,212614,5462,207152,0.9743102523822514,2,6,42529,801,41728,0.9811657927531802,22.717729777777777,3169.2366346666668,13.121256933743036,120,0.0013000000000000004
7,test_20231031_152442,10863862.png,317432,14797,302635,0.9533852919680436,3,6,66058,2114,63944,0.9679978200974901,23.30008,3113.238448,13.198679755902349,120,0.0013000000000000004
8,test_20231031_152442,11382381.png,312486,767,311719,0.9975454900379537,2,5,46745,101,46644,0.9978393411060006,21.620851555555557,2482.477712,14.181950028339719,120,0.0013000000000000004
9,test_20231031_152442,11079715.png,443815,131964,311851,0.7026598920721472,5,6,124136,18350,105786,0.8521782561062061,16.559557333333334,1997.333744,15.126297216019795,120,0.0013000000000000004
10,test_20231031_152442,11551286.png,271883,487,271396,0.9982087883391018,3,6,40092,70,40022,0.9982540157637434,17.985697777777776,1870.2736906666667,15.411751962304145,120,0.0013000000000000004
1,test_20231031_152443,10404007.png,502730,25487,477243,0.9493028066755514,3,5,61265,3686,57579,0.9398351424141027,25.21002488888889,3290.950544,12.957590050485548,120,0.0014000000000000004
2,test_20231031_152443,1254659.png,342646,84152,258494,0.7544054213386411,5,6,80080,11662,68418,0.8543706293706294,20.031966222222223,2929.3778613333334,13.463049657968673,120,0.0014000000000000004
3,test_20231031_152443,10188041.png,221231,10384,210847,0.9530626358873756,3,5,41731,1465,40266,0.9648942033500275,10.856592,1044.2380853333334,17.94280832165137,120,0.0014000000000000004
4,test_20231031_152443,10287332.png,216980,13399,203581,0.9382477647709466,3,5,22337,1828,20509,0.9181626897076599,9.424661333333333,761.85488,19.312081071364386,120,0.0014000000000000004
5,test_20231031_152443,11610969.png,368720,30692,338028,0.9167606856151009,4,6,84111,4481,79630,0.9467251607994198,20.176567111111112,2670.363557333333,13.865099683440906,120,0.0014000000000000004
6,test_20231031_152443,10350842.png,212614,5462,207152,0.9743102523822514,2,5,42529,801,41728,0.9811657927531802,22.717729777777777,3169.2366346666668,13.121256933743036,120,0.0014000000000000004
7,test_20231031_152443,10863862.png,317432,14797,302635,0.9533852919680436,3,6,66058,2114,63944,0.9679978200974901,23.30008,3113.238448,13.198679755902349,120,0.0014000000000000004
8,test_20231031_152443,11382381.png,312486,767,311719,0.9975454900379537,2,6,46745,101,46644,0.9978393411060006,21.620851555555557,2482.477712,14.181950028339719,120,0.0014000000000000004
9,test_20231031_152443,11079715.png,443815,131964,311851,0.7026598920721472,6,7,124136,18350,105786,0.8521782561062061,16.559557333333334,1997.333744,15.126297216019795,120,0.0014000000000000004
10,test_20231031_152443,11551286.png,271883,487,271396,0.9982087883391018,2,5,40092,70,40022,0.9982540157637434,17.985697777777776,1870.2736906666667,15.411751962304145,120,0.0014000000000000004
1,test_20231031_152444,10404007.png,502730,26112,476618,0.9480595946134108,3,6,61265,3765,57500,0.9385456622867869,25.063852444444443,3263.948144,12.993371105880328,121,1.0E-4
2,test_20231031_152444,1254659.png,342646,82322,260324,0.7597462103745557,4,6,80080,11414,68666,0.8574675324675325,20.146789333333334,2968.9748,13.404738494515186,121,1.0E-4
3,test_20231031_152444,10188041.png,221231,10747,210484,0.9514218170147944,3,5,41731,1508,40223,0.9638637943015983,10.256744888888889,960.6228746666667,18.30527436879325,121,1.0E-4
4,test_20231031_152444,10287332.png,216980,13682,203298,0.9369434970965066,3,5,22337,1863,20474,0.9165957827819313,9.239728,729.57032,19.500132029302378,121,1.0E-4
5,test_20231031_152444,11610969.png,368720,30472,338248,0.9173573443263181,3,6,84111,4439,79672,0.9472245009570687,19.285690666666667,2490.9437173333336,14.167164460683386,121,1.0E-4
6,test_20231031_152444,10350842.png,212614,7329,205285,0.965529080869557,2,6,42529,1075,41454,0.9747231300994615,16.994460444444446,1865.2112533333334,15.423523338592997,121,1.0E-4
7,test_20231031_152444,10863862.png,317432,14797,302635,0.9533852919680436,4,6,66058,2120,63938,0.9679069908262437,23.245306666666668,3112.5087946666667,13.199697736252237,121,1.0E-4
8,test_20231031_152444,11382381.png,312486,1199,311287,0.9961630281036591,3,6,46745,164,46581,0.9964916033800406,20.298848,2271.7021546666665,14.56728970917017,121,1.0E-4
9,test_20231031_152444,11079715.png,443815,130027,313788,0.7070243231977288,5,7,124136,18094,106042,0.8542405104079397,16.408837333333334,1978.80552,15.166772476828436,121,1.0E-4
10,test_20231031_152444,11551286.png,271883,1362,270521,0.9949904922337918,2,6,40092,200,39892,0.9950114736106954,15.756325333333333,1488.0124746666668,16.404737887600753,121,1.0E-4
1,test_20231031_152445,10404007.png,502730,26112,476618,0.9480595946134108,4,6,61265,3765,57500,0.9385456622867869,25.063852444444443,3263.948144,12.993371105880328,121,2.0E-4
2,test_20231031_152445,1254659.png,342646,82322,260324,0.7597462103745557,5,7,80080,11414,68666,0.8574675324675325,20.146789333333334,2968.9748,13.404738494515186,121,2.0E-4
3,test_20231031_152445,10188041.png,221231,10747,210484,0.9514218170147944,3,6,41731,1508,40223,0.9638637943015983,10.256744888888889,960.6228746666667,18.30527436879325,121,2.0E-4
4,test_20231031_152445,10287332.png,216980,13429,203551,0.9381095031800166,2,5,22337,1833,20504,0.9179388458611273,9.370778666666666,756.6213706666666,19.342017571499717,121,2.0E-4
5,test_20231031_152445,11610969.png,368720,30472,338248,0.9173573443263181,3,6,84111,4439,79672,0.9472245009570687,19.285690666666667,2490.9437173333336,14.167164460683386,121,2.0E-4
6,test_20231031_152445,10350842.png,212614,7329,205285,0.965529080869557,3,6,42529,1075,41454,0.9747231300994615,16.994460444444446,1865.2112533333334,15.423523338592997,121,2.0E-4
7,test_20231031_152445,10863862.png,317432,14797,302635,0.9533852919680436,3,5,66058,2120,63938,0.9679069908262437,23.245306666666668,3112.5087946666667,13.199697736252237,121,2.0E-4
8,test_20231031_152445,11382381.png,312486,1199,311287,0.9961630281036591,3,8,46745,164,46581,0.9964916033800406,20.298848,2271.7021546666665,14.56728970917017,121,2.0E-4
9,test_20231031_152445,11079715.png,443815,130027,313788,0.7070243231977288,6,7,124136,18094,106042,0.8542405104079397,16.408837333333334,1978.80552,15.166772476828436,121,2.0E-4
10,test_20231031_152445,11551286.png,271883,1362,270521,0.9949904922337918,3,5,40092,200,39892,0.9950114736106954,15.756325333333333,1488.0124746666668,16.404737887600753,121,2.0E-4
1,test_20231031_152446,10404007.png,502730,25849,476881,0.9485827382491596,3,5,61265,3728,57537,0.9391495960173019,25.087061333333335,3268.065152,12.987896548459542,121,3.0000000000000003E-4
2,test_20231031_152446,1254659.png,342646,82262,260384,0.7599213182117988,4,6,80080,11409,68671,0.85752997002997,20.156343111111113,2970.0569866666665,13.403155786357337,121,3.0000000000000003E-4
3,test_20231031_152446,10188041.png,221231,10667,210564,0.9517834299894681,3,13,41731,1496,40235,0.9641513503151135,10.409946666666666,981.2383306666667,18.21305855911757,121,3.0000000000000003E-4
4,test_20231031_152446,10287332.png,216980,13429,203551,0.9381095031800166,2,6,22337,1833,20504,0.9179388458611273,9.370778666666666,756.6213706666666,19.342017571499717,121,3.0000000000000003E-4
5,test_20231031_152446,11610969.png,368720,30412,338308,0.9175200694293772,4,6,84111,4432,79679,0.9473077243166768,19.617939555555555,2565.311952,14.039401762955164,121,3.0000000000000003E-4
6,test_20231031_152446,10350842.png,212614,7187,205427,0.9661969578673089,4,6,42529,1054,41475,0.9752169108137977,17.523210666666667,1977.5073386666666,15.169622569983105,121,3.0000000000000003E-4
7,test_20231031_152446,10863862.png,317432,14697,302735,0.9537003200685501,4,6,66058,2105,63953,0.9681340640043599,23.275838222222223,3117.6927946666665,13.192470415975402,121,3.0000000000000003E-4
8,test_20231031_152446,11382381.png,312486,967,311519,0.9969054613646692,3,5,46745,130,46615,0.9972189538988127,21.068341333333333,2406.1475626666665,14.317581029153203,121,3.0000000000000003E-4
9,test_20231031_152446,11079715.png,443815,130027,313788,0.7070243231977288,5,7,124136,18094,106042,0.8542405104079397,16.408837333333334,1978.80552,15.166772476828436,121,3.0000000000000003E-4
10,test_20231031_152446,11551286.png,271883,1219,270664,0.9955164537687167,3,6,40092,179,39913,0.9955352688815724,16.076115555555557,1539.5683893333332,16.25681375358216,121,3.0000000000000003E-4
1,test_20231031_152447,10404007.png,502730,25849,476881,0.9485827382491596,4,6,61265,3728,57537,0.9391495960173019,25.087061333333335,3268.065152,12.987896548459542,121,4.0E-4
2,test_20231031_152447,1254659.png,342646,82262,260384,0.7599213182117988,5,6,80080,11409,68671,0.85752997002997,20.156343111111113,2970.0569866666665,13.403155786357337,121,4.0E-4
3,test_20231031_152447,10188041.png,221231,10667,210564,0.9517834299894681,3,6,41731,1496,40235,0.9641513503151135,10.409946666666666,981.2383306666667,18.21305855911757,121,4.0E-4
4,test_20231031_152447,10287332.png,216980,13429,203551,0.9381095031800166,3,6,22337,1833,20504,0.9179388458611273,9.370778666666666,756.6213706666666,19.342017571499717,121,4.0E-4
5,test_20231031_152447,11610969.png,368720,30412,338308,0.9175200694293772,4,11,84111,4432,79679,0.9473077243166768,19.617939555555555,2565.311952,14.039401762955164,121,4.0E-4
6,test_20231031_152447,10350842.png,212614,7187,205427,0.9661969578673089,2,6,42529,1054,41475,0.9752169108137977,17.523210666666667,1977.5073386666666,15.169622569983105,121,4.0E-4
7,test_20231031_152447,10863862.png,317432,14697,302735,0.9537003200685501,3,5,66058,2105,63953,0.9681340640043599,23.275838222222223,3117.6927946666665,13.192470415975402,121,4.0E-4
8,test_20231031_152447,11382381.png,312486,827,311659,0.9973534814359684,3,23,46745,109,46636,0.997668199807466,21.564144,2476.360432,14.192665047538828,121,4.0E-4
9,test_20231031_152447,11079715.png,443815,130027,313788,0.7070243231977288,5,6,124136,18094,106042,0.8542405104079397,16.408837333333334,1978.80552,15.166772476828436,121,4.0E-4
10,test_20231031_152447,11551286.png,271883,607,271276,0.9977674220160878,2,6,40092,88,40004,0.997805048388706,17.77655288888889,1839.618896,15.483524990035365,121,4.0E-4
1,test_20231031_152448,10404007.png,502730,25849,476881,0.9485827382491596,4,6,61265,3728,57537,0.9391495960173019,25.087061333333335,3268.065152,12.987896548459542,121,5.0E-4
2,test_20231031_152448,1254659.png,342646,82262,260384,0.7599213182117988,5,6,80080,11409,68671,0.85752997002997,20.156343111111113,2970.0569866666665,13.403155786357337,121,5.0E-4
3,test_20231031_152448,10188041.png,221231,10667,210564,0.9517834299894681,3,5,41731,1496,40235,0.9641513503151135,10.409946666666666,981.2383306666667,18.21305855911757,121,5.0E-4
4,test_20231031_152448,10287332.png,216980,13429,203551,0.9381095031800166,2,5,22337,1833,20504,0.9179388458611273,9.370778666666666,756.6213706666666,19.342017571499717,121,5.0E-4
5,test_20231031_152448,11610969.png,368720,30412,338308,0.9175200694293772,4,6,84111,4432,79679,0.9473077243166768,19.617939555555555,2565.311952,14.039401762955164,121,5.0E-4
6,test_20231031_152448,10350842.png,212614,7187,205427,0.9661969578673089,3,6,42529,1054,41475,0.9752169108137977,17.523210666666667,1977.5073386666666,15.169622569983105,121,5.0E-4
7,test_20231031_152448,10863862.png,317432,14697,302735,0.9537003200685501,3,5,66058,2105,63953,0.9681340640043599,23.275838222222223,3117.6927946666665,13.192470415975402,121,5.0E-4
8,test_20231031_152448,11382381.png,312486,827,311659,0.9973534814359684,2,6,46745,109,46636,0.997668199807466,21.564144,2476.360432,14.192665047538828,121,5.0E-4
9,test_20231031_152448,11079715.png,443815,130027,313788,0.7070243231977288,5,7,124136,18094,106042,0.8542405104079397,16.408837333333334,1978.80552,15.166772476828436,121,5.0E-4
10,test_20231031_152448,11551286.png,271883,607,271276,0.9977674220160878,2,6,40092,88,40004,0.997805048388706,17.77655288888889,1839.618896,15.483524990035365,121,5.0E-4
1,test_20231031_152449,10404007.png,502730,25407,477323,0.9494619378195055,3,6,61265,3666,57599,0.9401615930792458,25.18988977777778,3290.26648,12.958492878094653,121,6.000000000000001E-4
2,test_20231031_152449,1254659.png,342646,82262,260384,0.7599213182117988,5,6,80080,11409,68671,0.85752997002997,20.156343111111113,2970.0569866666665,13.403155786357337,121,6.000000000000001E-4
3,test_20231031_152449,10188041.png,221231,10567,210664,0.95223544620781,3,6,41731,1482,40249,0.9644868323308811,10.533299555555555,996.9537226666666,18.14405361490014,121,6.000000000000001E-4
4,test_20231031_152449,10287332.png,216980,13429,203551,0.9381095031800166,3,6,22337,1833,20504,0.9179388458611273,9.370778666666666,756.6213706666666,19.342017571499717,121,6.000000000000001E-4
5,test_20231031_152449,11610969.png,368720,30069,338651,0.9184503146018659,4,6,84111,4382,79729,0.9479021768853063,20.036851555555554,2651.808336,13.895382293801273,121,6.000000000000001E-4
6,test_20231031_152449,10350842.png,212614,6967,205647,0.9672316968779102,2,6,42529,1022,41507,0.9759693385689765,18.40685866666667,2182.083690666667,14.742089575588938,121,6.000000000000001E-4
7,test_20231031_152449,10863862.png,317432,14697,302735,0.9537003200685501,3,6,66058,2105,63953,0.9681340640043599,23.275838222222223,3117.6927946666665,13.192470415975402,121,6.000000000000001E-4
8,test_20231031_152449,11382381.png,312486,827,311659,0.9973534814359684,2,6,46745,109,46636,0.997668199807466,21.564144,2476.360432,14.192665047538828,121,6.000000000000001E-4
9,test_20231031_152449,11079715.png,443815,130027,313788,0.7070243231977288,6,7,124136,18094,106042,0.8542405104079397,16.408837333333334,1978.80552,15.166772476828436,121,6.000000000000001E-4
10,test_20231031_152449,11551286.png,271883,527,271356,0.9980616662314304,2,5,40092,76,40016,0.9981043599720643,17.926654222222222,1858.3108106666666,15.43962007470492,121,6.000000000000001E-4
1,test_20231031_152451,10404007.png,502730,25407,477323,0.9494619378195055,4,6,61265,3666,57599,0.9401615930792458,25.18988977777778,3290.26648,12.958492878094653,121,7.000000000000001E-4
2,test_20231031_152451,1254659.png,342646,82262,260384,0.7599213182117988,5,6,80080,11409,68671,0.85752997002997,20.156343111111113,2970.0569866666665,13.403155786357337,121,7.000000000000001E-4
3,test_20231031_152451,10188041.png,221231,10567,210664,0.95223544620781,3,6,41731,1482,40249,0.9644868323308811,10.533299555555555,996.9537226666666,18.14405361490014,121,7.000000000000001E-4
4,test_20231031_152451,10287332.png,216980,13429,203551,0.9381095031800166,2,5,22337,1833,20504,0.9179388458611273,9.370778666666666,756.6213706666666,19.342017571499717,121,7.000000000000001E-4
5,test_20231031_152451,11610969.png,368720,30069,338651,0.9184503146018659,4,6,84111,4382,79729,0.9479021768853063,20.036851555555554,2651.808336,13.895382293801273,121,7.000000000000001E-4
6,test_20231031_152451,10350842.png,212614,6967,205647,0.9672316968779102,3,6,42529,1022,41507,0.9759693385689765,18.40685866666667,2182.083690666667,14.742089575588938,121,7.000000000000001E-4
7,test_20231031_152451,10863862.png,317432,14697,302735,0.9537003200685501,3,6,66058,2105,63953,0.9681340640043599,23.275838222222223,3117.6927946666665,13.192470415975402,121,7.000000000000001E-4
8,test_20231031_152451,11382381.png,312486,827,311659,0.9973534814359684,2,6,46745,109,46636,0.997668199807466,21.564144,2476.360432,14.192665047538828,121,7.000000000000001E-4
9,test_20231031_152451,11079715.png,443815,130027,313788,0.7070243231977288,5,6,124136,18094,106042,0.8542405104079397,16.408837333333334,1978.80552,15.166772476828436,121,7.000000000000001E-4
10,test_20231031_152451,11551286.png,271883,527,271356,0.9980616662314304,2,6,40092,76,40016,0.9981043599720643,17.926654222222222,1858.3108106666666,15.43962007470492,121,7.000000000000001E-4
1,test_20231031_152452,10404007.png,502730,25107,477623,0.950058679609333,4,6,61265,3624,57641,0.9408471394760467,25.206074666666666,3294.1665333333335,12.953348101508894,121,8.000000000000001E-4
2,test_20231031_152452,1254659.png,342646,82262,260384,0.7599213182117988,5,6,80080,11409,68671,0.85752997002997,20.156343111111113,2970.0569866666665,13.403155786357337,121,8.000000000000001E-4
3,test_20231031_152452,10188041.png,221231,10484,210747,0.9526106196690337,3,6,41731,1472,40259,0.9647264623421438,10.660069333333333,1007.872112,18.09674932504763,121,8.000000000000001E-4
4,test_20231031_152452,10287332.png,216980,13429,203551,0.9381095031800166,2,5,22337,1833,20504,0.9179388458611273,9.370778666666666,756.6213706666666,19.342017571499717,121,8.000000000000001E-4
5,test_20231031_152452,11610969.png,368720,30069,338651,0.9184503146018659,4,6,84111,4382,79729,0.9479021768853063,20.036851555555554,2651.808336,13.895382293801273,121,8.000000000000001E-4
6,test_20231031_152452,10350842.png,212614,6847,205767,0.9677960999746018,2,5,42529,1004,41525,0.9763925791812645,18.767114666666668,2248.3353386666668,14.612192742239138,121,8.000000000000001E-4
7,test_20231031_152452,10863862.png,317432,14634,302798,0.9538987877718692,4,6,66058,2096,63962,0.9682703079112295,23.317687111111113,3119.559728,13.189870556931647,121,8.000000000000001E-4
8,test_20231031_152452,11382381.png,312486,827,311659,0.9973534814359684,2,5,46745,109,46636,0.997668199807466,21.564144,2476.360432,14.192665047538828,121,8.000000000000001E-4
9,test_20231031_152452,11079715.png,443815,130027,313788,0.7070243231977288,5,7,124136,18094,106042,0.8542405104079397,16.408837333333334,1978.80552,15.166772476828436,121,8.000000000000001E-4
10,test_20231031_152452,11551286.png,271883,527,271356,0.9980616662314304,2,6,40092,76,40016,0.9981043599720643,17.926654222222222,1858.3108106666666,15.43962007470492,121,8.000000000000001E-4
1,test_20231031_152453,10404007.png,502730,25107,477623,0.950058679609333,3,5,61265,3624,57641,0.9408471394760467,25.206074666666666,3294.1665333333335,12.953348101508894,121,9.000000000000002E-4
2,test_20231031_152453,1254659.png,342646,82262,260384,0.7599213182117988,5,7,80080,11409,68671,0.85752997002997,20.156343111111113,2970.0569866666665,13.403155786357337,121,9.000000000000002E-4
3,test_20231031_152453,10188041.png,221231,10484,210747,0.9526106196690337,3,5,41731,1472,40259,0.9647264623421438,10.660069333333333,1007.872112,18.09674932504763,121,9.000000000000002E-4
4,test_20231031_152453,10287332.png,216980,13429,203551,0.9381095031800166,3,6,22337,1833,20504,0.9179388458611273,9.370778666666666,756.6213706666666,19.342017571499717,121,9.000000000000002E-4
5,test_20231031_152453,11610969.png,368720,30069,338651,0.9184503146018659,4,6,84111,4382,79729,0.9479021768853063,20.036851555555554,2651.808336,13.895382293801273,121,9.000000000000002E-4
6,test_20231031_152453,10350842.png,212614,6847,205767,0.9677960999746018,3,6,42529,1004,41525,0.9763925791812645,18.767114666666668,2248.3353386666668,14.612192742239138,121,9.000000000000002E-4
7,test_20231031_152453,10863862.png,317432,14634,302798,0.9538987877718692,4,6,66058,2096,63962,0.9682703079112295,23.317687111111113,3119.559728,13.189870556931647,121,9.000000000000002E-4
8,test_20231031_152453,11382381.png,312486,827,311659,0.9973534814359684,2,6,46745,109,46636,0.997668199807466,21.564144,2476.360432,14.192665047538828,121,9.000000000000002E-4
9,test_20231031_152453,11079715.png,443815,130027,313788,0.7070243231977288,8,7,124136,18094,106042,0.8542405104079397,16.408837333333334,1978.80552,15.166772476828436,121,9.000000000000002E-4
10,test_20231031_152453,11551286.png,271883,527,271356,0.9980616662314304,2,5,40092,76,40016,0.9981043599720643,17.926654222222222,1858.3108106666666,15.43962007470492,121,9.000000000000002E-4
1,test_20231031_152454,10404007.png,502730,24642,478088,0.9509836293835657,3,5,61265,3562,57703,0.9418591365379907,25.378030222222222,3330.4072,12.905830240878892,121,0.0010000000000000002
2,test_20231031_152454,1254659.png,342646,82102,260544,0.7603882724444471,5,6,80080,11395,68685,0.8577047952047951,20.226067555555556,2984.737445333333,13.381742267619789,121,0.0010000000000000002
3,test_20231031_152454,10188041.png,221231,10222,211009,0.9537949021610895,3,5,41731,1444,40287,0.9653974263736791,10.79159288888889,1027.7822453333333,18.011792497763565,121,0.0010000000000000002
4,test_20231031_152454,10287332.png,216980,13347,203633,0.9384874181952254,3,6,22337,1822,20515,0.9184313023234991,9.405495111111112,763.2239093333334,19.304283939191368,121,0.0010000000000000002
5,test_20231031_152454,11610969.png,368720,29647,339073,0.9195948144933825,4,6,84111,4330,79781,0.9485204075566811,20.305616,2703.970181333333,13.810784628563725,121,0.0010000000000000002
6,test_20231031_152454,10350842.png,212614,6727,205887,0.9683605030712935,3,5,42529,986,41543,0.9768158197935526,18.92183111111111,2276.9942186666667,14.557184329336422,121,0.0010000000000000002
7,test_20231031_152454,10863862.png,317432,14132,303300,0.9554802288364123,3,5,66058,2027,64031,0.969314844530564,23.496147555555556,3160.1726346666665,13.133695528586127,121,0.0010000000000000002
8,test_20231031_152454,11382381.png,312486,767,311719,0.9975454900379537,3,6,46745,101,46644,0.9978393411060006,21.620851555555557,2482.477712,14.181950028339719,121,0.0010000000000000002
9,test_20231031_152454,11079715.png,443815,129947,313868,0.7072045784842784,5,7,124136,18088,106048,0.8542888444931366,16.427568,1981.6711093333333,15.160487829961314,121,0.0010000000000000002
10,test_20231031_152454,11551286.png,271883,487,271396,0.9982087883391018,2,6,40092,70,40022,0.9982540157637434,17.985697777777776,1870.2736906666667,15.411751962304145,121,0.0010000000000000002
1,test_20231031_152455,10404007.png,502730,24362,478368,0.9515405883874047,3,5,61265,3522,57743,0.9425120378682772,25.423841777777778,3339.4120693333334,12.8941034840361,121,0.0011000000000000003
2,test_20231031_152455,1254659.png,342646,82102,260544,0.7603882724444471,5,7,80080,11395,68685,0.8577047952047951,20.226067555555556,2984.737445333333,13.381742267619789,121,0.0011000000000000003
3,test_20231031_152455,10188041.png,221231,10222,211009,0.9537949021610895,3,5,41731,1444,40287,0.9653974263736791,10.79159288888889,1027.7822453333333,18.011792497763565,121,0.0011000000000000003
4,test_20231031_152455,10287332.png,216980,13347,203633,0.9384874181952254,3,7,22337,1822,20515,0.9184313023234991,9.405495111111112,763.2239093333334,19.304283939191368,121,0.0011000000000000003
5,test_20231031_152455,11610969.png,368720,29647,339073,0.9195948144933825,6,10,84111,4330,79781,0.9485204075566811,20.305616,2703.970181333333,13.810784628563725,121,0.0011000000000000003
6,test_20231031_152455,10350842.png,212614,5359,207255,0.9747946983735785,4,9,42529,786,41743,0.9815184932634202,22.265804444444445,3090.826106666667,13.230057890105298,121,0.0011000000000000003
7,test_20231031_152455,10863862.png,317432,14132,303300,0.9554802288364123,4,7,66058,2027,64031,0.969314844530564,23.496147555555556,3160.1726346666665,13.133695528586127,121,0.0011000000000000003
8,test_20231031_152455,11382381.png,312486,767,311719,0.9975454900379537,3,6,46745,101,46644,0.9978393411060006,21.620851555555557,2482.477712,14.181950028339719,121,0.0011000000000000003
9,test_20231031_152455,11079715.png,443815,129947,313868,0.7072045784842784,6,6,124136,18088,106048,0.8542888444931366,16.427568,1981.6711093333333,15.160487829961314,121,0.0011000000000000003
10,test_20231031_152455,11551286.png,271883,487,271396,0.9982087883391018,2,6,40092,70,40022,0.9982540157637434,17.985697777777776,1870.2736906666667,15.411751962304145,121,0.0011000000000000003
1,test_20231031_152456,10404007.png,502730,24362,478368,0.9515405883874047,3,6,61265,3522,57743,0.9425120378682772,25.423841777777778,3339.4120693333334,12.8941034840361,121,0.0012000000000000003
2,test_20231031_152456,1254659.png,342646,82102,260544,0.7603882724444471,6,7,80080,11395,68685,0.8577047952047951,20.226067555555556,2984.737445333333,13.381742267619789,121,0.0012000000000000003
3,test_20231031_152456,10188041.png,221231,10222,211009,0.9537949021610895,3,5,41731,1444,40287,0.9653974263736791,10.79159288888889,1027.7822453333333,18.011792497763565,121,0.0012000000000000003
4,test_20231031_152456,10287332.png,216980,13347,203633,0.9384874181952254,2,6,22337,1822,20515,0.9184313023234991,9.405495111111112,763.2239093333334,19.304283939191368,121,0.0012000000000000003
5,test_20231031_152456,11610969.png,368720,29647,339073,0.9195948144933825,3,6,84111,4330,79781,0.9485204075566811,20.305616,2703.970181333333,13.810784628563725,121,0.0012000000000000003
6,test_20231031_152456,10350842.png,212614,5359,207255,0.9747946983735785,2,5,42529,786,41743,0.9815184932634202,22.265804444444445,3090.826106666667,13.230057890105298,121,0.0012000000000000003
7,test_20231031_152456,10863862.png,317432,14132,303300,0.9554802288364123,3,5,66058,2027,64031,0.969314844530564,23.496147555555556,3160.1726346666665,13.133695528586127,121,0.0012000000000000003
8,test_20231031_152456,11382381.png,312486,767,311719,0.9975454900379537,2,5,46745,101,46644,0.9978393411060006,21.620851555555557,2482.477712,14.181950028339719,121,0.0012000000000000003
9,test_20231031_152456,11079715.png,443815,129947,313868,0.7072045784842784,5,6,124136,18088,106048,0.8542888444931366,16.427568,1981.6711093333333,15.160487829961314,121,0.0012000000000000003
10,test_20231031_152456,11551286.png,271883,487,271396,0.9982087883391018,3,6,40092,70,40022,0.9982540157637434,17.985697777777776,1870.2736906666667,15.411751962304145,121,0.0012000000000000003
1,test_20231031_152457,10404007.png,502730,24362,478368,0.9515405883874047,4,6,61265,3522,57743,0.9425120378682772,25.423841777777778,3339.4120693333334,12.8941034840361,121,0.0013000000000000004
2,test_20231031_152457,1254659.png,342646,82102,260544,0.7603882724444471,5,6,80080,11395,68685,0.8577047952047951,20.226067555555556,2984.737445333333,13.381742267619789,121,0.0013000000000000004
3,test_20231031_152457,10188041.png,221231,10102,211129,0.9543373216230998,3,5,41731,1426,40305,0.9658287603939517,10.886451555555556,1051.6531146666666,17.912078484543994,121,0.0013000000000000004
4,test_20231031_152457,10287332.png,216980,13187,203793,0.9392248133468523,3,6,22337,1800,20537,0.9194162152482428,9.473516444444444,774.2743413333334,19.241854934447318,121,0.0013000000000000004
5,test_20231031_152457,11610969.png,368720,29647,339073,0.9195948144933825,4,5,84111,4330,79781,0.9485204075566811,20.305616,2703.970181333333,13.810784628563725,121,0.0013000000000000004
6,test_20231031_152457,10350842.png,212614,4617,207997,0.9782845908547885,3,6,42529,675,41854,0.9841284770391968,23.887226666666667,3453.5718133333335,12.748118697424438,121,0.0013000000000000004
7,test_20231031_152457,10863862.png,317432,14132,303300,0.9554802288364123,4,6,66058,2027,64031,0.969314844530564,23.496147555555556,3160.1726346666665,13.133695528586127,121,0.0013000000000000004
8,test_20231031_152457,11382381.png,312486,767,311719,0.9975454900379537,2,5,46745,101,46644,0.9978393411060006,21.620851555555557,2482.477712,14.181950028339719,121,0.0013000000000000004
9,test_20231031_152457,11079715.png,443815,129744,314071,0.7076619762738979,6,7,124136,18059,106077,0.8545224592382548,16.66578311111111,2023.904208,15.06890407503267,121,0.0013000000000000004
10,test_20231031_152457,11551286.png,271883,487,271396,0.9982087883391018,2,5,40092,70,40022,0.9982540157637434,17.985697777777776,1870.2736906666667,15.411751962304145,121,0.0013000000000000004
1,test_20231031_152458,10404007.png,502730,24362,478368,0.9515405883874047,3,5,61265,3522,57743,0.9425120378682772,25.423841777777778,3339.4120693333334,12.8941034840361,121,0.0014000000000000004
2,test_20231031_152458,1254659.png,342646,82102,260544,0.7603882724444471,5,6,80080,11395,68685,0.8577047952047951,20.226067555555556,2984.737445333333,13.381742267619789,121,0.0014000000000000004
3,test_20231031_152458,10188041.png,221231,10102,211129,0.9543373216230998,5,14,41731,1426,40305,0.9658287603939517,10.886451555555556,1051.6531146666666,17.912078484543994,121,0.0014000000000000004
4,test_20231031_152458,10287332.png,216980,13187,203793,0.9392248133468523,2,5,22337,1800,20537,0.9194162152482428,9.473516444444444,774.2743413333334,19.241854934447318,121,0.0014000000000000004
5,test_20231031_152458,11610969.png,368720,29647,339073,0.9195948144933825,4,6,84111,4330,79781,0.9485204075566811,20.305616,2703.970181333333,13.810784628563725,121,0.0014000000000000004
6,test_20231031_152458,10350842.png,212614,4617,207997,0.9782845908547885,3,6,42529,675,41854,0.9841284770391968,23.887226666666667,3453.5718133333335,12.748118697424438,121,0.0014000000000000004
7,test_20231031_152458,10863862.png,317432,14132,303300,0.9554802288364123,4,6,66058,2027,64031,0.969314844530564,23.496147555555556,3160.1726346666665,13.133695528586127,121,0.0014000000000000004
8,test_20231031_152458,11382381.png,312486,767,311719,0.9975454900379537,2,5,46745,101,46644,0.9978393411060006,21.620851555555557,2482.477712,14.181950028339719,121,0.0014000000000000004
9,test_20231031_152458,11079715.png,443815,129744,314071,0.7076619762738979,5,6,124136,18059,106077,0.8545224592382548,16.66578311111111,2023.904208,15.06890407503267,121,0.0014000000000000004
10,test_20231031_152458,11551286.png,271883,487,271396,0.9982087883391018,2,5,40092,70,40022,0.9982540157637434,17.985697777777776,1870.2736906666667,15.411751962304145,121,0.0014000000000000004
1,test_20231031_152459,10404007.png,502730,25187,477543,0.949899548465379,3,5,61265,3630,57635,0.9407492042765038,25.12879288888889,3282.03776,12.969367875434926,122,1.0E-4
2,test_20231031_152459,1254659.png,342646,79962,262684,0.7666337853061177,4,6,80080,11106,68974,0.8613136863136863,20.326528,3020.2829653333333,13.330327276703748,122,1.0E-4
3,test_20231031_152459,10188041.png,221231,10484,210747,0.9526106196690337,3,6,41731,1476,40255,0.9646306103376386,10.29104711111111,967.4823253333333,18.274373211101064,122,1.0E-4
4,test_20231031_152459,10287332.png,216980,13317,203663,0.9386256797861554,3,5,22337,1816,20521,0.9186999149393383,9.276503111111111,739.8157706666667,19.43956775926238,122,1.0E-4
5,test_20231031_152459,11610969.png,368720,29517,339203,0.9199473855500109,4,6,84111,4304,79807,0.9488295228923684,19.500469333333335,2542.365472,14.078423791408932,122,1.0E-4
6,test_20231031_152459,10350842.png,212614,7067,205547,0.9667613609640004,3,6,42529,1036,41493,0.9756401514260857,17.272896,1936.234528,15.261224004330279,122,1.0E-4
7,test_20231031_152459,10863862.png,317432,14152,303280,0.955417223216311,3,6,66058,2034,64024,0.9692088770474432,23.416272,3158.1188533333334,13.136518905548746,122,1.0E-4
8,test_20231031_152459,11382381.png,312486,1159,311327,0.996291033838316,2,5,46745,158,46587,0.9966199593539415,20.606709333333335,2334.900224,14.448120340351833,122,1.0E-4
9,test_20231031_152459,11079715.png,443815,127382,316433,0.7129840136092742,6,7,124136,17736,106400,0.8571244441580202,16.53779911111111,2010.815104,15.097082221479486,122,1.0E-4
10,test_20231031_152459,11551286.png,271883,1322,270561,0.9951376143414631,3,6,40092,194,39898,0.9951611294023746,15.757246222222221,1488.3021066666668,16.40389264375073,122,1.0E-4
1,test_20231031_152500,10404007.png,502730,25187,477543,0.949899548465379,3,5,61265,3630,57635,0.9407492042765038,25.12879288888889,3282.03776,12.969367875434926,122,2.0E-4
2,test_20231031_152500,1254659.png,342646,79962,262684,0.7666337853061177,5,6,80080,11106,68974,0.8613136863136863,20.326528,3020.2829653333333,13.330327276703748,122,2.0E-4
3,test_20231031_152500,10188041.png,221231,10484,210747,0.9526106196690337,3,6,41731,1476,40255,0.9646306103376386,10.29104711111111,967.4823253333333,18.274373211101064,122,2.0E-4
4,test_20231031_152500,10287332.png,216980,13087,203893,0.939685685316619,2,5,22337,1789,20548,0.9199086717106146,9.406264888888888,766.5465173333333,19.285418460243026,122,2.0E-4
5,test_20231031_152500,11610969.png,368720,29517,339203,0.9199473855500109,4,6,84111,4304,79807,0.9488295228923684,19.500469333333335,2542.365472,14.078423791408932,122,2.0E-4
6,test_20231031_152500,10350842.png,212614,7067,205547,0.9667613609640004,2,5,42529,1036,41493,0.9756401514260857,17.272896,1936.234528,15.261224004330279,122,2.0E-4
7,test_20231031_152500,10863862.png,317432,14152,303280,0.955417223216311,4,6,66058,2034,64024,0.9692088770474432,23.416272,3158.1188533333334,13.136518905548746,122,2.0E-4
8,test_20231031_152500,11382381.png,312486,1159,311327,0.996291033838316,3,6,46745,158,46587,0.9966199593539415,20.606709333333335,2334.900224,14.448120340351833,122,2.0E-4
9,test_20231031_152500,11079715.png,443815,127382,316433,0.7129840136092742,5,7,124136,17736,106400,0.8571244441580202,16.53779911111111,2010.815104,15.097082221479486,122,2.0E-4
10,test_20231031_152500,11551286.png,271883,1322,270561,0.9951376143414631,3,6,40092,194,39898,0.9951611294023746,15.757246222222221,1488.3021066666668,16.40389264375073,122,2.0E-4
1,test_20231031_152501,10404007.png,502730,24924,477806,0.9504226921011278,3,6,61265,3592,57673,0.9413694605402758,25.162432,3287.893781333333,12.961625820868626,122,3.0000000000000003E-4
2,test_20231031_152501,1254659.png,342646,79902,262744,0.7668088931433608,5,7,80080,11101,68979,0.861376123876124,20.33608177777778,3021.365152,13.328771450566173,122,3.0000000000000003E-4
3,test_20231031_152501,10188041.png,221231,10304,210927,0.9534242488620491,3,6,41731,1450,40281,0.9652536483669215,10.567601777777778,1003.8131733333333,18.114274701111977,122,3.0000000000000003E-4
4,test_20231031_152501,10287332.png,216980,13087,203893,0.939685685316619,2,8,22337,1789,20548,0.9199086717106146,9.406264888888888,766.5465173333333,19.285418460243026,122,3.0000000000000003E-4
5,test_20231031_152501,11610969.png,368720,29457,339263,0.92011011065307,4,6,84111,4297,79814,0.9489127462519765,19.832718222222223,2616.733706666667,13.953208321942551,122,3.0000000000000003E-4
6,test_20231031_152501,10350842.png,212614,6727,205887,0.9683605030712935,3,6,42529,986,41543,0.9768158197935526,18.680309333333334,2252.1961813333332,14.604741430901797,122,3.0000000000000003E-4
7,test_20231031_152501,10863862.png,317432,14072,303360,0.9556692456967162,3,5,66058,2022,64036,0.9693905355899362,23.44550577777778,3163.1715893333335,13.129576095846978,122,3.0000000000000003E-4
8,test_20231031_152501,11382381.png,312486,967,311519,0.9969054613646692,3,5,46745,130,46615,0.9972189538988127,21.068341333333333,2406.1475626666665,14.317581029153203,122,3.0000000000000003E-4
9,test_20231031_152501,11079715.png,443815,127382,316433,0.7129840136092742,6,8,124136,17736,106400,0.8571244441580202,16.53779911111111,2010.815104,15.097082221479486,122,3.0000000000000003E-4
10,test_20231031_152501,11551286.png,271883,847,271036,0.9968846893700599,2,5,40092,124,39968,0.9969071136386312,17.065274666666667,1704.2078666666666,15.81557795178707,122,3.0000000000000003E-4
1,test_20231031_152502,10404007.png,502730,24924,477806,0.9504226921011278,4,6,61265,3592,57673,0.9413694605402758,25.162432,3287.893781333333,12.961625820868626,122,4.0E-4
2,test_20231031_152502,1254659.png,342646,79902,262744,0.7668088931433608,5,7,80080,11101,68979,0.861376123876124,20.33608177777778,3021.365152,13.328771450566173,122,4.0E-4
3,test_20231031_152502,10188041.png,221231,10304,210927,0.9534242488620491,4,7,41731,1450,40281,0.9652536483669215,10.567601777777778,1003.8131733333333,18.114274701111977,122,4.0E-4
4,test_20231031_152502,10287332.png,216980,13087,203893,0.939685685316619,2,6,22337,1789,20548,0.9199086717106146,9.406264888888888,766.5465173333333,19.285418460243026,122,4.0E-4
5,test_20231031_152502,11610969.png,368720,29457,339263,0.92011011065307,4,7,84111,4297,79814,0.9489127462519765,19.832718222222223,2616.733706666667,13.953208321942551,122,4.0E-4
6,test_20231031_152502,10350842.png,212614,6727,205887,0.9683605030712935,3,10,42529,986,41543,0.9768158197935526,18.680309333333334,2252.1961813333332,14.604741430901797,122,4.0E-4
7,test_20231031_152502,10863862.png,317432,14072,303360,0.9556692456967162,3,6,66058,2022,64036,0.9693905355899362,23.44550577777778,3163.1715893333335,13.129576095846978,122,4.0E-4
8,test_20231031_152502,11382381.png,312486,827,311659,0.9973534814359684,2,6,46745,109,46636,0.997668199807466,21.564144,2476.360432,14.192665047538828,122,4.0E-4
9,test_20231031_152502,11079715.png,443815,127382,316433,0.7129840136092742,5,6,124136,17736,106400,0.8571244441580202,16.53779911111111,2010.815104,15.097082221479486,122,4.0E-4
10,test_20231031_152502,11551286.png,271883,607,271276,0.9977674220160878,2,5,40092,88,40004,0.997805048388706,17.77655288888889,1839.618896,15.483524990035365,122,4.0E-4
1,test_20231031_152503,10404007.png,502730,24924,477806,0.9504226921011278,4,6,61265,3592,57673,0.9413694605402758,25.162432,3287.893781333333,12.961625820868626,122,5.0E-4
2,test_20231031_152503,1254659.png,342646,79902,262744,0.7668088931433608,4,7,80080,11101,68979,0.861376123876124,20.33608177777778,3021.365152,13.328771450566173,122,5.0E-4
3,test_20231031_152503,10188041.png,221231,10304,210927,0.9534242488620491,3,5,41731,1450,40281,0.9652536483669215,10.567601777777778,1003.8131733333333,18.114274701111977,122,5.0E-4
4,test_20231031_152503,10287332.png,216980,13087,203893,0.939685685316619,2,5,22337,1789,20548,0.9199086717106146,9.406264888888888,766.5465173333333,19.285418460243026,122,5.0E-4
5,test_20231031_152503,11610969.png,368720,29457,339263,0.92011011065307,5,6,84111,4297,79814,0.9489127462519765,19.832718222222223,2616.733706666667,13.953208321942551,122,5.0E-4
6,test_20231031_152503,10350842.png,212614,6727,205887,0.9683605030712935,3,5,42529,986,41543,0.9768158197935526,18.680309333333334,2252.1961813333332,14.604741430901797,122,5.0E-4
7,test_20231031_152503,10863862.png,317432,14072,303360,0.9556692456967162,3,7,66058,2022,64036,0.9693905355899362,23.44550577777778,3163.1715893333335,13.129576095846978,122,5.0E-4
8,test_20231031_152503,11382381.png,312486,827,311659,0.9973534814359684,2,6,46745,109,46636,0.997668199807466,21.564144,2476.360432,14.192665047538828,122,5.0E-4
9,test_20231031_152503,11079715.png,443815,127382,316433,0.7129840136092742,5,7,124136,17736,106400,0.8571244441580202,16.53779911111111,2010.815104,15.097082221479486,122,5.0E-4
10,test_20231031_152503,11551286.png,271883,607,271276,0.9977674220160878,2,6,40092,88,40004,0.997805048388706,17.77655288888889,1839.618896,15.483524990035365,122,5.0E-4
1,test_20231031_152504,10404007.png,502730,24502,478228,0.9512621088854852,4,6,61265,3533,57732,0.9423324900024483,25.254716444444444,3308.321610666667,12.934726390234932,122,6.000000000000001E-4
2,test_20231031_152504,1254659.png,342646,79902,262744,0.7668088931433608,5,6,80080,11101,68979,0.861376123876124,20.33608177777778,3021.365152,13.328771450566173,122,6.000000000000001E-4
3,test_20231031_152504,10188041.png,221231,10304,210927,0.9534242488620491,3,5,41731,1450,40281,0.9652536483669215,10.567601777777778,1003.8131733333333,18.114274701111977,122,6.000000000000001E-4
4,test_20231031_152504,10287332.png,216980,13087,203893,0.939685685316619,2,6,22337,1789,20548,0.9199086717106146,9.406264888888888,766.5465173333333,19.285418460243026,122,6.000000000000001E-4
5,test_20231031_152504,11610969.png,368720,29117,339603,0.9210322195704057,4,6,84111,4247,79864,0.9495071988206061,20.25163022222222,2703.2300906666665,13.811973477796158,122,6.000000000000001E-4
6,test_20231031_152504,10350842.png,212614,6607,206007,0.9689249061679852,3,6,42529,968,41561,0.9772390604058407,19.040565333333333,2318.447829333333,14.478830331991979,122,6.000000000000001E-4
7,test_20231031_152504,10863862.png,317432,14012,303420,0.9558582625570201,3,6,66058,2013,64045,0.9695267794968059,23.48735466666667,3165.0385226666667,13.127013605493714,122,6.000000000000001E-4
8,test_20231031_152504,11382381.png,312486,827,311659,0.9973534814359684,2,5,46745,109,46636,0.997668199807466,21.564144,2476.360432,14.192665047538828,122,6.000000000000001E-4
9,test_20231031_152504,11079715.png,443815,127382,316433,0.7129840136092742,5,7,124136,17736,106400,0.8571244441580202,16.53779911111111,2010.815104,15.097082221479486,122,6.000000000000001E-4
10,test_20231031_152504,11551286.png,271883,527,271356,0.9980616662314304,2,5,40092,76,40016,0.9981043599720643,17.926654222222222,1858.3108106666666,15.43962007470492,122,6.000000000000001E-4
1,test_20231031_152505,10404007.png,502730,24502,478228,0.9512621088854852,4,6,61265,3533,57732,0.9423324900024483,25.254716444444444,3308.321610666667,12.934726390234932,122,7.000000000000001E-4
2,test_20231031_152505,1254659.png,342646,79902,262744,0.7668088931433608,5,6,80080,11101,68979,0.861376123876124,20.33608177777778,3021.365152,13.328771450566173,122,7.000000000000001E-4
3,test_20231031_152505,10188041.png,221231,10304,210927,0.9534242488620491,3,6,41731,1450,40281,0.9652536483669215,10.567601777777778,1003.8131733333333,18.114274701111977,122,7.000000000000001E-4
4,test_20231031_152505,10287332.png,216980,13087,203893,0.939685685316619,3,6,22337,1789,20548,0.9199086717106146,9.406264888888888,766.5465173333333,19.285418460243026,122,7.000000000000001E-4
5,test_20231031_152505,11610969.png,368720,29117,339603,0.9210322195704057,4,6,84111,4247,79864,0.9495071988206061,20.25163022222222,2703.2300906666665,13.811973477796158,122,7.000000000000001E-4
6,test_20231031_152505,10350842.png,212614,6607,206007,0.9689249061679852,2,6,42529,968,41561,0.9772390604058407,19.040565333333333,2318.447829333333,14.478830331991979,122,7.000000000000001E-4
7,test_20231031_152505,10863862.png,317432,14012,303420,0.9558582625570201,3,5,66058,2013,64045,0.9695267794968059,23.48735466666667,3165.0385226666667,13.127013605493714,122,7.000000000000001E-4
8,test_20231031_152505,11382381.png,312486,827,311659,0.9973534814359684,2,5,46745,109,46636,0.997668199807466,21.564144,2476.360432,14.192665047538828,122,7.000000000000001E-4
9,test_20231031_152505,11079715.png,443815,127382,316433,0.7129840136092742,6,7,124136,17736,106400,0.8571244441580202,16.53779911111111,2010.815104,15.097082221479486,122,7.000000000000001E-4
10,test_20231031_152505,11551286.png,271883,527,271356,0.9980616662314304,2,5,40092,76,40016,0.9981043599720643,17.926654222222222,1858.3108106666666,15.43962007470492,122,7.000000000000001E-4
1,test_20231031_152506,10404007.png,502730,24202,478528,0.9518588506753128,4,6,61265,3491,57774,0.9430180363992492,25.270901333333335,3312.221664,12.92960967468018,122,8.000000000000001E-4
2,test_20231031_152506,1254659.png,342646,79902,262744,0.7668088931433608,5,6,80080,11101,68979,0.861376123876124,20.33608177777778,3021.365152,13.328771450566173,122,8.000000000000001E-4
3,test_20231031_152506,10188041.png,221231,10222,211009,0.9537949021610895,4,6,41731,1440,40291,0.9654932783781841,10.694371555555556,1014.7315626666667,18.06729191792479,122,8.000000000000001E-4
4,test_20231031_152506,10287332.png,216980,13087,203893,0.939685685316619,3,6,22337,1789,20548,0.9199086717106146,9.406264888888888,766.5465173333333,19.285418460243026,122,8.000000000000001E-4
5,test_20231031_152506,11610969.png,368720,29117,339603,0.9210322195704057,4,7,84111,4247,79864,0.9495071988206061,20.25163022222222,2703.2300906666665,13.811973477796158,122,8.000000000000001E-4
6,test_20231031_152506,10350842.png,212614,6607,206007,0.9689249061679852,2,5,42529,968,41561,0.9772390604058407,19.040565333333333,2318.447829333333,14.478830331991979,122,8.000000000000001E-4
7,test_20231031_152506,10863862.png,317432,14012,303420,0.9558582625570201,3,5,66058,2013,64045,0.9695267794968059,23.48735466666667,3165.0385226666667,13.127013605493714,122,8.000000000000001E-4
8,test_20231031_152506,11382381.png,312486,827,311659,0.9973534814359684,3,6,46745,109,46636,0.997668199807466,21.564144,2476.360432,14.192665047538828,122,8.000000000000001E-4
9,test_20231031_152506,11079715.png,443815,127382,316433,0.7129840136092742,6,7,124136,17736,106400,0.8571244441580202,16.53779911111111,2010.815104,15.097082221479486,122,8.000000000000001E-4
10,test_20231031_152506,11551286.png,271883,527,271356,0.9980616662314304,2,6,40092,76,40016,0.9981043599720643,17.926654222222222,1858.3108106666666,15.43962007470492,122,8.000000000000001E-4
1,test_20231031_152507,10404007.png,502730,24202,478528,0.9518588506753128,4,6,61265,3491,57774,0.9430180363992492,25.270901333333335,3312.221664,12.92960967468018,122,9.000000000000002E-4
2,test_20231031_152507,1254659.png,342646,79902,262744,0.7668088931433608,5,7,80080,11101,68979,0.861376123876124,20.33608177777778,3021.365152,13.328771450566173,122,9.000000000000002E-4
3,test_20231031_152507,10188041.png,221231,10222,211009,0.9537949021610895,3,5,41731,1440,40291,0.9654932783781841,10.694371555555556,1014.7315626666667,18.06729191792479,122,9.000000000000002E-4
4,test_20231031_152507,10287332.png,216980,13087,203893,0.939685685316619,3,6,22337,1789,20548,0.9199086717106146,9.406264888888888,766.5465173333333,19.285418460243026,122,9.000000000000002E-4
5,test_20231031_152507,11610969.png,368720,29117,339603,0.9210322195704057,4,6,84111,4247,79864,0.9495071988206061,20.25163022222222,2703.2300906666665,13.811973477796158,122,9.000000000000002E-4
6,test_20231031_152507,10350842.png,212614,6607,206007,0.9689249061679852,3,6,42529,968,41561,0.9772390604058407,19.040565333333333,2318.447829333333,14.478830331991979,122,9.000000000000002E-4
7,test_20231031_152507,10863862.png,317432,14012,303420,0.9558582625570201,3,6,66058,2013,64045,0.9695267794968059,23.48735466666667,3165.0385226666667,13.127013605493714,122,9.000000000000002E-4
8,test_20231031_152507,11382381.png,312486,827,311659,0.9973534814359684,2,5,46745,109,46636,0.997668199807466,21.564144,2476.360432,14.192665047538828,122,9.000000000000002E-4
9,test_20231031_152507,11079715.png,443815,127382,316433,0.7129840136092742,6,7,124136,17736,106400,0.8571244441580202,16.53779911111111,2010.815104,15.097082221479486,122,9.000000000000002E-4
10,test_20231031_152507,11551286.png,271883,527,271356,0.9980616662314304,2,5,40092,76,40016,0.9981043599720643,17.926654222222222,1858.3108106666666,15.43962007470492,122,9.000000000000002E-4
1,test_20231031_152508,10404007.png,502730,23397,479333,0.95346010781135,4,6,61265,3384,57881,0.9447645474577655,25.510517333333333,3363.304448,12.86314179220259,122,0.0010000000000000002
2,test_20231031_152508,1254659.png,342646,79682,262964,0.7674509552132521,5,6,80080,11078,69002,0.8616633366633366,20.429603555555556,3038.799296,13.303783437488493,122,0.0010000000000000002
3,test_20231031_152508,10188041.png,221231,10002,211229,0.9547893378414417,3,5,41731,1414,40317,0.9661163164074669,10.823772444444444,1034.4124266666668,17.983866316711868,122,0.0010000000000000002
4,test_20231031_152508,10287332.png,216980,13067,203913,0.9397778597105724,3,6,22337,1786,20551,0.9200429780185343,9.432291555555556,770.9674026666667,19.260443448678878,122,0.0010000000000000002
5,test_20231031_152508,11610969.png,368720,28812,339908,0.9218594055109568,3,6,84111,4210,79901,0.949947093721392,20.388913777777777,2726.347488,13.774991526182546,122,0.0010000000000000002
6,test_20231031_152508,10350842.png,212614,6487,206127,0.9694893092646768,3,14,42529,950,41579,0.9776623010181288,19.19528177777778,2347.106709333333,14.425475259684495,122,0.0010000000000000002
7,test_20231031_152508,10863862.png,317432,13429,304003,0.9576948763829733,4,6,66058,1933,64125,0.9707378364467589,23.766021333333335,3231.9151413333334,13.036204116535098,122,0.0010000000000000002
8,test_20231031_152508,11382381.png,312486,767,311719,0.9975454900379537,3,6,46745,101,46644,0.9978393411060006,21.620851555555557,2482.477712,14.181950028339719,122,0.0010000000000000002
9,test_20231031_152508,11079715.png,443815,127302,316513,0.7131642688958237,5,7,124136,17730,106406,0.8571727782432171,16.55652977777778,2013.6806933333332,15.090897546887387,122,0.0010000000000000002
10,test_20231031_152508,11551286.png,271883,487,271396,0.9982087883391018,2,6,40092,70,40022,0.9982540157637434,17.985697777777776,1870.2736906666667,15.411751962304145,122,0.0010000000000000002
1,test_20231031_152509,10404007.png,502730,23397,479333,0.95346010781135,3,6,61265,3384,57881,0.9447645474577655,25.510517333333333,3363.304448,12.86314179220259,122,0.0011000000000000003
2,test_20231031_152509,1254659.png,342646,79682,262964,0.7674509552132521,5,6,80080,11078,69002,0.8616633366633366,20.429603555555556,3038.799296,13.303783437488493,122,0.0011000000000000003
3,test_20231031_152509,10188041.png,221231,9982,211249,0.9548797410851101,3,6,41731,1411,40320,0.9661882054108457,11.081482666666666,1073.4543786666666,17.822967690256306,122,0.0011000000000000003
4,test_20231031_152509,10287332.png,216980,13067,203913,0.9397778597105724,2,14,22337,1786,20551,0.9200429780185343,9.432291555555556,770.9674026666667,19.260443448678878,122,0.0011000000000000003
5,test_20231031_152509,11610969.png,368720,28772,339948,0.9219678889129963,4,6,84111,4204,79907,0.9500184280296275,20.450026666666666,2737.991264,13.756483027538861,122,0.0011000000000000003
6,test_20231031_152509,10350842.png,212614,4577,208037,0.9784727252203523,2,5,42529,669,41860,0.9842695572432928,23.426469333333333,3373.119696,12.850486083564514,122,0.0011000000000000003
7,test_20231031_152509,10863862.png,317432,13429,304003,0.9576948763829733,3,6,66058,1933,64125,0.9707378364467589,23.766021333333335,3231.9151413333334,13.036204116535098,122,0.0011000000000000003
8,test_20231031_152509,11382381.png,312486,767,311719,0.9975454900379537,2,6,46745,101,46644,0.9978393411060006,21.620851555555557,2482.477712,14.181950028339719,122,0.0011000000000000003
9,test_20231031_152509,11079715.png,443815,127302,316513,0.7131642688958237,5,7,124136,17730,106406,0.8571727782432171,16.55652977777778,2013.6806933333332,15.090897546887387,122,0.0011000000000000003
10,test_20231031_152509,11551286.png,271883,487,271396,0.9982087883391018,2,6,40092,70,40022,0.9982540157637434,17.985697777777776,1870.2736906666667,15.411751962304145,122,0.0011000000000000003
1,test_20231031_152510,10404007.png,502730,23397,479333,0.95346010781135,3,6,61265,3384,57881,0.9447645474577655,25.510517333333333,3363.304448,12.86314179220259,122,0.0012000000000000003
2,test_20231031_152510,1254659.png,342646,79682,262964,0.7674509552132521,4,6,80080,11078,69002,0.8616633366633366,20.429603555555556,3038.799296,13.303783437488493,122,0.0012000000000000003
3,test_20231031_152510,10188041.png,221231,9982,211249,0.9548797410851101,4,6,41731,1411,40320,0.9661882054108457,11.081482666666666,1073.4543786666666,17.822967690256306,122,0.0012000000000000003
4,test_20231031_152510,10287332.png,216980,13067,203913,0.9397778597105724,2,6,22337,1786,20551,0.9200429780185343,9.432291555555556,770.9674026666667,19.260443448678878,122,0.0012000000000000003
5,test_20231031_152510,11610969.png,368720,28772,339948,0.9219678889129963,4,6,84111,4204,79907,0.9500184280296275,20.450026666666666,2737.991264,13.756483027538861,122,0.0012000000000000003
6,test_20231031_152510,10350842.png,212614,4577,208037,0.9784727252203523,2,6,42529,669,41860,0.9842695572432928,23.426469333333333,3373.119696,12.850486083564514,122,0.0012000000000000003
7,test_20231031_152510,10863862.png,317432,13429,304003,0.9576948763829733,3,5,66058,1933,64125,0.9707378364467589,23.766021333333335,3231.9151413333334,13.036204116535098,122,0.0012000000000000003
8,test_20231031_152510,11382381.png,312486,767,311719,0.9975454900379537,2,5,46745,101,46644,0.9978393411060006,21.620851555555557,2482.477712,14.181950028339719,122,0.0012000000000000003
9,test_20231031_152510,11079715.png,443815,127302,316513,0.7131642688958237,6,7,124136,17730,106406,0.8571727782432171,16.55652977777778,2013.6806933333332,15.090897546887387,122,0.0012000000000000003
10,test_20231031_152510,11551286.png,271883,487,271396,0.9982087883391018,3,6,40092,70,40022,0.9982540157637434,17.985697777777776,1870.2736906666667,15.411751962304145,122,0.0012000000000000003
1,test_20231031_152511,10404007.png,502730,23397,479333,0.95346010781135,4,6,61265,3384,57881,0.9447645474577655,25.510517333333333,3363.304448,12.86314179220259,122,0.0013000000000000004
2,test_20231031_152511,1254659.png,342646,79682,262964,0.7674509552132521,4,6,80080,11078,69002,0.8616633366633366,20.429603555555556,3038.799296,13.303783437488493,122,0.0013000000000000004
3,test_20231031_152511,10188041.png,221231,9862,211369,0.9554221605471205,3,6,41731,1393,40338,0.9666195394311183,11.176341333333333,1097.325248,17.72744989012639,122,0.0013000000000000004
4,test_20231031_152511,10287332.png,216980,12907,204073,0.9405152548621993,2,6,22337,1764,20573,0.921027890943278,9.500312888888889,782.0178346666667,19.198637031929763,122,0.0013000000000000004
5,test_20231031_152511,11610969.png,368720,28772,339948,0.9219678889129963,4,6,84111,4204,79907,0.9500184280296275,20.450026666666666,2737.991264,13.756483027538861,122,0.0013000000000000004
6,test_20231031_152511,10350842.png,212614,4557,208057,0.9785667924031343,3,5,42529,666,41863,0.9843400973453408,23.889207111111112,3454.309808,12.74719075154987,122,0.0013000000000000004
7,test_20231031_152511,10863862.png,317432,13429,304003,0.9576948763829733,3,6,66058,1933,64125,0.9707378364467589,23.766021333333335,3231.9151413333334,13.036204116535098,122,0.0013000000000000004
8,test_20231031_152511,11382381.png,312486,767,311719,0.9975454900379537,2,5,46745,101,46644,0.9978393411060006,21.620851555555557,2482.477712,14.181950028339719,122,0.0013000000000000004
9,test_20231031_152511,11079715.png,443815,127102,316713,0.7136149071121977,6,7,124136,17701,106435,0.8574063929883353,16.79474488888889,2055.913792,15.000754608771818,122,0.0013000000000000004
10,test_20231031_152511,11551286.png,271883,487,271396,0.9982087883391018,2,5,40092,70,40022,0.9982540157637434,17.985697777777776,1870.2736906666667,15.411751962304145,122,0.0013000000000000004
1,test_20231031_152513,10404007.png,502730,23397,479333,0.95346010781135,3,5,61265,3384,57881,0.9447645474577655,25.510517333333333,3363.304448,12.86314179220259,122,0.0014000000000000004
2,test_20231031_152513,1254659.png,342646,79682,262964,0.7674509552132521,5,7,80080,11078,69002,0.8616633366633366,20.429603555555556,3038.799296,13.303783437488493,122,0.0014000000000000004
3,test_20231031_152513,10188041.png,221231,9862,211369,0.9554221605471205,3,6,41731,1393,40338,0.9666195394311183,11.176341333333333,1097.325248,17.72744989012639,122,0.0014000000000000004
4,test_20231031_152513,10287332.png,216980,12907,204073,0.9405152548621993,2,5,22337,1764,20573,0.921027890943278,9.500312888888889,782.0178346666667,19.198637031929763,122,0.0014000000000000004
5,test_20231031_152513,11610969.png,368720,28772,339948,0.9219678889129963,4,5,84111,4204,79907,0.9500184280296275,20.450026666666666,2737.991264,13.756483027538861,122,0.0014000000000000004
6,test_20231031_152513,10350842.png,212614,4557,208057,0.9785667924031343,8,5,42529,666,41863,0.9843400973453408,23.889207111111112,3454.309808,12.74719075154987,122,0.0014000000000000004
7,test_20231031_152513,10863862.png,317432,13429,304003,0.9576948763829733,3,5,66058,1933,64125,0.9707378364467589,23.766021333333335,3231.9151413333334,13.036204116535098,122,0.0014000000000000004
8,test_20231031_152513,11382381.png,312486,767,311719,0.9975454900379537,2,5,46745,101,46644,0.9978393411060006,21.620851555555557,2482.477712,14.181950028339719,122,0.0014000000000000004
9,test_20231031_152513,11079715.png,443815,127102,316713,0.7136149071121977,5,6,124136,17701,106435,0.8574063929883353,16.79474488888889,2055.913792,15.000754608771818,122,0.0014000000000000004
10,test_20231031_152513,11551286.png,271883,487,271396,0.9982087883391018,2,5,40092,70,40022,0.9982540157637434,17.985697777777776,1870.2736906666667,15.411751962304145,122,0.0014000000000000004
1,test_20231031_152514,10404007.png,502730,24182,478548,0.9518986334613013,4,6,61265,3483,57782,0.9431486166653065,25.191109333333333,3298.676826666667,12.947405913275208,123,1.0E-4
2,test_20231031_152514,1254659.png,342646,78072,264574,0.7721496821792754,5,6,80080,10861,69219,0.8643731268731268,20.51848177777778,3069.789525333333,13.259717609997972,123,1.0E-4
3,test_20231031_152514,10188041.png,221231,10202,211029,0.9538853054047579,3,6,41731,1437,40294,0.9655651673815628,10.472250666666667,996.2625973333334,18.147065349528113,123,1.0E-4
4,test_20231031_152514,10287332.png,216980,12977,204003,0.9401926444833625,3,6,22337,1774,20563,0.9205802032502126,9.307064888888888,748.7130986666666,19.387649297314677,123,1.0E-4
5,test_20231031_152514,11610969.png,368720,28492,340228,0.9227272727272727,4,6,84111,4156,79955,0.9505891024955119,19.969996444444444,2649.321978666667,13.899456184782972,123,1.0E-4
6,test_20231031_152514,10350842.png,212614,6887,205727,0.967607965609038,2,5,42529,1009,41520,0.9762750123445179,17.477884444444445,1977.0087253333334,15.170717748340774,123,1.0E-4
7,test_20231031_152514,10863862.png,317432,13337,304095,0.9579847022354394,3,5,66058,1928,64130,0.9708135275061309,23.652634666666668,3218.7282186666666,13.053960533703744,123,1.0E-4
8,test_20231031_152514,11382381.png,312486,1159,311327,0.996291033838316,3,6,46745,158,46587,0.9966199593539415,20.606709333333335,2334.900224,14.448120340351833,123,1.0E-4
9,test_20231031_152514,11079715.png,443815,125192,318623,0.7179185020785688,5,6,124136,17444,106692,0.8594767029709351,16.64877511111111,2039.7730453333334,15.034985123844537,123,1.0E-4
10,test_20231031_152514,11551286.png,271883,1199,270684,0.9955900148225524,2,6,40092,176,39916,0.995610096777412,15.83984888888889,1503.00104,16.36121079771285,123,1.0E-4
1,test_20231031_152515,10404007.png,502730,24182,478548,0.9518986334613013,3,6,61265,3483,57782,0.9431486166653065,25.191109333333333,3298.676826666667,12.947405913275208,123,2.0E-4
2,test_20231031_152515,1254659.png,342646,78072,264574,0.7721496821792754,4,6,80080,10861,69219,0.8643731268731268,20.51848177777778,3069.789525333333,13.259717609997972,123,2.0E-4
3,test_20231031_152515,10188041.png,221231,10202,211029,0.9538853054047579,3,5,41731,1437,40294,0.9655651673815628,10.472250666666667,996.2625973333334,18.147065349528113,123,2.0E-4
4,test_20231031_152515,10287332.png,216980,12767,204213,0.9411604756198728,3,6,22337,1747,20590,0.921788960021489,9.436826666666667,775.4438453333333,19.235300075188995,123,2.0E-4
5,test_20231031_152515,11610969.png,368720,28492,340228,0.9227272727272727,3,5,84111,4156,79955,0.9505891024955119,19.969996444444444,2649.321978666667,13.899456184782972,123,2.0E-4
6,test_20231031_152515,10350842.png,212614,6887,205727,0.967607965609038,3,6,42529,1009,41520,0.9762750123445179,17.477884444444445,1977.0087253333334,15.170717748340774,123,2.0E-4
7,test_20231031_152515,10863862.png,317432,13337,304095,0.9579847022354394,3,6,66058,1928,64130,0.9708135275061309,23.652634666666668,3218.7282186666666,13.053960533703744,123,2.0E-4
8,test_20231031_152515,11382381.png,312486,1159,311327,0.996291033838316,3,6,46745,158,46587,0.9966199593539415,20.606709333333335,2334.900224,14.448120340351833,123,2.0E-4
9,test_20231031_152515,11079715.png,443815,125192,318623,0.7179185020785688,5,6,124136,17444,106692,0.8594767029709351,16.64877511111111,2039.7730453333334,15.034985123844537,123,2.0E-4
10,test_20231031_152515,11551286.png,271883,1179,270704,0.995663575876388,3,6,40092,173,39919,0.9956849246732515,16.545063111111112,1622.936352,16.027788727836416,123,2.0E-4
1,test_20231031_152516,10404007.png,502730,24062,478668,0.9521373301772323,3,5,61265,3466,57799,0.9434260997306783,25.205253333333335,3301.279184,12.943981073817032,123,3.0000000000000003E-4
2,test_20231031_152516,1254659.png,342646,78012,264634,0.7723247900165185,5,6,80080,10856,69224,0.8644355644355645,20.528035555555554,3070.871712,13.258186870279811,123,3.0000000000000003E-4
3,test_20231031_152516,10188041.png,221231,10102,211129,0.9543373216230998,3,6,41731,1423,40308,0.9659006493973306,10.595603555555556,1011.9779893333333,18.079092942287858,123,3.0000000000000003E-4
4,test_20231031_152516,10287332.png,216980,12767,204213,0.9411604756198728,2,6,22337,1747,20590,0.921788960021489,9.436826666666667,775.4438453333333,19.235300075188995,123,3.0000000000000003E-4
5,test_20231031_152516,11610969.png,368720,28252,340468,0.9233781731395097,4,6,84111,4121,79990,0.9510052192935525,20.351372444444443,2731.876538666667,13.766192924277291,123,3.0000000000000003E-4
6,test_20231031_152516,10350842.png,212614,6467,206147,0.9695833764474587,2,7,42529,947,41582,0.9777328411201768,19.205194666666667,2350.2698026666667,14.419626402627658,123,3.0000000000000003E-4
7,test_20231031_152516,10863862.png,317432,13257,304175,0.9582367247158446,3,6,66058,1916,64142,0.9709951860486239,23.681868444444444,3223.7809546666667,13.047148356167963,123,3.0000000000000003E-4
8,test_20231031_152516,11382381.png,312486,967,311519,0.9969054613646692,3,6,46745,130,46615,0.9972189538988127,21.068341333333333,2406.1475626666665,14.317581029153203,123,3.0000000000000003E-4
9,test_20231031_152516,11079715.png,443815,125192,318623,0.7179185020785688,5,15,124136,17444,106692,0.8594767029709351,16.64877511111111,2039.7730453333334,15.034985123844537,123,3.0000000000000003E-4
10,test_20231031_152516,11551286.png,271883,547,271336,0.9979881051775947,2,5,40092,79,40013,0.9980295320762247,17.838736,1852.2023093333332,15.453919395217167,123,3.0000000000000003E-4
1,test_20231031_152517,10404007.png,502730,24062,478668,0.9521373301772323,3,5,61265,3466,57799,0.9434260997306783,25.205253333333335,3301.279184,12.943981073817032,123,4.0E-4
2,test_20231031_152517,1254659.png,342646,78012,264634,0.7723247900165185,5,6,80080,10856,69224,0.8644355644355645,20.528035555555554,3070.871712,13.258186870279811,123,4.0E-4
3,test_20231031_152517,10188041.png,221231,10102,211129,0.9543373216230998,4,6,41731,1423,40308,0.9659006493973306,10.595603555555556,1011.9779893333333,18.079092942287858,123,4.0E-4
4,test_20231031_152517,10287332.png,216980,12767,204213,0.9411604756198728,3,6,22337,1747,20590,0.921788960021489,9.436826666666667,775.4438453333333,19.235300075188995,123,4.0E-4
5,test_20231031_152517,11610969.png,368720,28252,340468,0.9233781731395097,4,6,84111,4121,79990,0.9510052192935525,20.351372444444443,2731.876538666667,13.766192924277291,123,4.0E-4
6,test_20231031_152517,10350842.png,212614,6467,206147,0.9695833764474587,2,5,42529,947,41582,0.9777328411201768,19.205194666666667,2350.2698026666667,14.419626402627658,123,4.0E-4
7,test_20231031_152517,10863862.png,317432,13257,304175,0.9582367247158446,4,6,66058,1916,64142,0.9709951860486239,23.681868444444444,3223.7809546666667,13.047148356167963,123,4.0E-4
8,test_20231031_152517,11382381.png,312486,827,311659,0.9973534814359684,2,6,46745,109,46636,0.997668199807466,21.564144,2476.360432,14.192665047538828,123,4.0E-4
9,test_20231031_152517,11079715.png,443815,125192,318623,0.7179185020785688,7,7,124136,17444,106692,0.8594767029709351,16.64877511111111,2039.7730453333334,15.034985123844537,123,4.0E-4
10,test_20231031_152517,11551286.png,271883,547,271336,0.9979881051775947,2,5,40092,79,40013,0.9980295320762247,17.838736,1852.2023093333332,15.453919395217167,123,4.0E-4
1,test_20231031_152518,10404007.png,502730,23739,478991,0.9527798221709466,4,7,61265,3420,57845,0.9441769362605076,25.295297777777776,3321.273722666667,12.917756914288205,123,5.0E-4
2,test_20231031_152518,1254659.png,342646,78012,264634,0.7723247900165185,5,6,80080,10856,69224,0.8644355644355645,20.528035555555554,3070.871712,13.258186870279811,123,5.0E-4
3,test_20231031_152518,10188041.png,221231,10102,211129,0.9543373216230998,3,6,41731,1423,40308,0.9659006493973306,10.595603555555556,1011.9779893333333,18.079092942287858,123,5.0E-4
4,test_20231031_152518,10287332.png,216980,12767,204213,0.9411604756198728,3,6,22337,1747,20590,0.921788960021489,9.436826666666667,775.4438453333333,19.235300075188995,123,5.0E-4
5,test_20231031_152518,11610969.png,368720,28252,340468,0.9233781731395097,5,6,84111,4121,79990,0.9510052192935525,20.351372444444443,2731.876538666667,13.766192924277291,123,5.0E-4
6,test_20231031_152518,10350842.png,212614,6467,206147,0.9695833764474587,2,5,42529,947,41582,0.9777328411201768,19.205194666666667,2350.2698026666667,14.419626402627658,123,5.0E-4
7,test_20231031_152518,10863862.png,317432,13257,304175,0.9582367247158446,3,5,66058,1916,64142,0.9709951860486239,23.681868444444444,3223.7809546666667,13.047148356167963,123,5.0E-4
8,test_20231031_152518,11382381.png,312486,827,311659,0.9973534814359684,2,5,46745,109,46636,0.997668199807466,21.564144,2476.360432,14.192665047538828,123,5.0E-4
9,test_20231031_152518,11079715.png,443815,125192,318623,0.7179185020785688,6,7,124136,17444,106692,0.8594767029709351,16.64877511111111,2039.7730453333334,15.034985123844537,123,5.0E-4
10,test_20231031_152518,11551286.png,271883,547,271336,0.9979881051775947,1,5,40092,79,40013,0.9980295320762247,17.838736,1852.2023093333332,15.453919395217167,123,5.0E-4
1,test_20231031_152519,10404007.png,502730,23337,479393,0.9535794561693155,3,6,61265,3365,57900,0.9450746755896515,25.313722666666667,3325.6070666666665,12.912094265254296,123,6.000000000000001E-4
2,test_20231031_152519,1254659.png,342646,78012,264634,0.7723247900165185,5,6,80080,10856,69224,0.8644355644355645,20.528035555555554,3070.871712,13.258186870279811,123,6.000000000000001E-4
3,test_20231031_152519,10188041.png,221231,10082,211149,0.9544277248667682,3,6,41731,1420,40311,0.9659725384007093,10.853313777777778,1051.0199413333332,17.91469404755111,123,6.000000000000001E-4
4,test_20231031_152519,10287332.png,216980,12767,204213,0.9411604756198728,3,6,22337,1747,20590,0.921788960021489,9.436826666666667,775.4438453333333,19.235300075188995,123,6.000000000000001E-4
5,test_20231031_152519,11610969.png,368720,28152,340568,0.9236493816446084,3,6,84111,4106,80005,0.9511835550641414,20.388908444444443,2735.818362666667,13.759931006817341,123,6.000000000000001E-4
6,test_20231031_152519,10350842.png,212614,6467,206147,0.9695833764474587,3,6,42529,947,41582,0.9777328411201768,19.205194666666667,2350.2698026666667,14.419626402627658,123,6.000000000000001E-4
7,test_20231031_152519,10863862.png,317432,13197,304235,0.9584257415761486,3,6,66058,1907,64151,0.9711314299554936,23.723717333333333,3225.647888,13.044634028505238,123,6.000000000000001E-4
8,test_20231031_152519,11382381.png,312486,827,311659,0.9973534814359684,3,6,46745,109,46636,0.997668199807466,21.564144,2476.360432,14.192665047538828,123,6.000000000000001E-4
9,test_20231031_152519,11079715.png,443815,125192,318623,0.7179185020785688,6,7,124136,17444,106692,0.8594767029709351,16.64877511111111,2039.7730453333334,15.034985123844537,123,6.000000000000001E-4
10,test_20231031_152519,11551286.png,271883,467,271416,0.9982823493929374,2,5,40092,67,40025,0.998328843659583,17.988837333333333,1870.894224,15.410311266718583,123,6.000000000000001E-4
1,test_20231031_152520,10404007.png,502730,23337,479393,0.9535794561693155,4,6,61265,3365,57900,0.9450746755896515,25.313722666666667,3325.6070666666665,12.912094265254296,123,7.000000000000001E-4
2,test_20231031_152520,1254659.png,342646,78012,264634,0.7723247900165185,5,6,80080,10856,69224,0.8644355644355645,20.528035555555554,3070.871712,13.258186870279811,123,7.000000000000001E-4
3,test_20231031_152520,10188041.png,221231,10082,211149,0.9544277248667682,3,6,41731,1420,40311,0.9659725384007093,10.853313777777778,1051.0199413333332,17.91469404755111,123,7.000000000000001E-4
4,test_20231031_152520,10287332.png,216980,12767,204213,0.9411604756198728,3,6,22337,1747,20590,0.921788960021489,9.436826666666667,775.4438453333333,19.235300075188995,123,7.000000000000001E-4
5,test_20231031_152520,11610969.png,368720,28152,340568,0.9236493816446084,4,7,84111,4106,80005,0.9511835550641414,20.388908444444443,2735.818362666667,13.759931006817341,123,7.000000000000001E-4
6,test_20231031_152520,10350842.png,212614,6467,206147,0.9695833764474587,2,6,42529,947,41582,0.9777328411201768,19.205194666666667,2350.2698026666667,14.419626402627658,123,7.000000000000001E-4
7,test_20231031_152520,10863862.png,317432,13197,304235,0.9584257415761486,3,6,66058,1907,64151,0.9711314299554936,23.723717333333333,3225.647888,13.044634028505238,123,7.000000000000001E-4
8,test_20231031_152520,11382381.png,312486,827,311659,0.9973534814359684,3,6,46745,109,46636,0.997668199807466,21.564144,2476.360432,14.192665047538828,123,7.000000000000001E-4
9,test_20231031_152520,11079715.png,443815,125192,318623,0.7179185020785688,6,7,124136,17444,106692,0.8594767029709351,16.64877511111111,2039.7730453333334,15.034985123844537,123,7.000000000000001E-4
10,test_20231031_152520,11551286.png,271883,467,271416,0.9982823493929374,2,6,40092,67,40025,0.998328843659583,17.988837333333333,1870.894224,15.410311266718583,123,7.000000000000001E-4
1,test_20231031_152521,10404007.png,502730,23337,479393,0.9535794561693155,4,6,61265,3365,57900,0.9450746755896515,25.313722666666667,3325.6070666666665,12.912094265254296,123,8.000000000000001E-4
2,test_20231031_152521,1254659.png,342646,78012,264634,0.7723247900165185,5,7,80080,10856,69224,0.8644355644355645,20.528035555555554,3070.871712,13.258186870279811,123,8.000000000000001E-4
3,test_20231031_152521,10188041.png,221231,10002,211229,0.9547893378414417,3,5,41731,1410,40321,0.9662121684119719,10.980083555555556,1061.9383306666666,17.8698106392361,123,8.000000000000001E-4
4,test_20231031_152521,10287332.png,216980,12767,204213,0.9411604756198728,2,6,22337,1747,20590,0.921788960021489,9.436826666666667,775.4438453333333,19.235300075188995,123,8.000000000000001E-4
5,test_20231031_152521,11610969.png,368720,27849,340871,0.9244711434150575,4,6,84111,4062,80049,0.9517066733245354,21.206458666666666,2901.9369866666666,13.503923830349978,123,8.000000000000001E-4
6,test_20231031_152521,10350842.png,212614,6467,206147,0.9695833764474587,3,6,42529,947,41582,0.9777328411201768,19.205194666666667,2350.2698026666667,14.419626402627658,123,8.000000000000001E-4
7,test_20231031_152521,10863862.png,317432,13197,304235,0.9584257415761486,4,6,66058,1907,64151,0.9711314299554936,23.723717333333333,3225.647888,13.044634028505238,123,8.000000000000001E-4
8,test_20231031_152521,11382381.png,312486,827,311659,0.9973534814359684,3,6,46745,109,46636,0.997668199807466,21.564144,2476.360432,14.192665047538828,123,8.000000000000001E-4
9,test_20231031_152521,11079715.png,443815,125192,318623,0.7179185020785688,5,6,124136,17444,106692,0.8594767029709351,16.64877511111111,2039.7730453333334,15.034985123844537,123,8.000000000000001E-4
10,test_20231031_152521,11551286.png,271883,467,271416,0.9982823493929374,2,6,40092,67,40025,0.998328843659583,17.988837333333333,1870.894224,15.410311266718583,123,8.000000000000001E-4
1,test_20231031_152522,10404007.png,502730,23077,479653,0.954096632387166,5,6,61265,3328,57937,0.9456786093201665,25.358901333333332,3334.2294613333333,12.90084876245235,123,9.000000000000002E-4
2,test_20231031_152522,1254659.png,342646,78012,264634,0.7723247900165185,5,8,80080,10856,69224,0.8644355644355645,20.528035555555554,3070.871712,13.258186870279811,123,9.000000000000002E-4
3,test_20231031_152522,10188041.png,221231,10002,211229,0.9547893378414417,4,7,41731,1410,40321,0.9662121684119719,10.980083555555556,1061.9383306666666,17.8698106392361,123,9.000000000000002E-4
4,test_20231031_152522,10287332.png,216980,12767,204213,0.9411604756198728,3,7,22337,1747,20590,0.921788960021489,9.436826666666667,775.4438453333333,19.235300075188995,123,9.000000000000002E-4
5,test_20231031_152522,11610969.png,368720,27849,340871,0.9244711434150575,4,6,84111,4062,80049,0.9517066733245354,21.206458666666666,2901.9369866666666,13.503923830349978,123,9.000000000000002E-4
6,test_20231031_152522,10350842.png,212614,6467,206147,0.9695833764474587,2,5,42529,947,41582,0.9777328411201768,19.205194666666667,2350.2698026666667,14.419626402627658,123,9.000000000000002E-4
7,test_20231031_152522,10863862.png,317432,13197,304235,0.9584257415761486,3,5,66058,1907,64151,0.9711314299554936,23.723717333333333,3225.647888,13.044634028505238,123,9.000000000000002E-4
8,test_20231031_152522,11382381.png,312486,827,311659,0.9973534814359684,2,5,46745,109,46636,0.997668199807466,21.564144,2476.360432,14.192665047538828,123,9.000000000000002E-4
9,test_20231031_152522,11079715.png,443815,125192,318623,0.7179185020785688,6,7,124136,17444,106692,0.8594767029709351,16.64877511111111,2039.7730453333334,15.034985123844537,123,9.000000000000002E-4
10,test_20231031_152522,11551286.png,271883,467,271416,0.9982823493929374,2,6,40092,67,40025,0.998328843659583,17.988837333333333,1870.894224,15.410311266718583,123,9.000000000000002E-4
1,test_20231031_152523,10404007.png,502730,22452,480278,0.9553398444493068,3,5,61265,3246,58019,0.9470170570472537,25.653054222222224,3401.166714666667,12.814524406419615,123,0.0010000000000000002
2,test_20231031_152523,1254659.png,342646,77812,264834,0.7729084828073288,5,6,80080,10838,69242,0.8646603396603396,20.601813333333332,3087.073888,13.235333365796425,123,0.0010000000000000002
3,test_20231031_152523,10188041.png,221231,9782,211449,0.955783773521794,3,6,41731,1384,40347,0.9668352064412546,11.109484444444444,1081.6191946666668,17.790059751107275,123,0.0010000000000000002
4,test_20231031_152523,10287332.png,216980,12747,204233,0.9412526500138262,3,6,22337,1744,20593,0.9219232663294086,9.462853333333333,779.8647306666667,19.21061081023097,123,0.0010000000000000002
5,test_20231031_152523,11610969.png,368720,27547,341173,0.9252901931004556,7,6,84111,4025,80086,0.9521465682253213,21.362599111111113,2927.6268906666664,13.465646333072625,123,0.0010000000000000002
6,test_20231031_152523,10350842.png,212614,6344,206270,0.9701618896215677,2,5,42529,929,41600,0.9781560817324649,19.35991111111111,2378.9286826666666,14.366989382457716,123,0.0010000000000000002
7,test_20231031_152523,10863862.png,317432,12817,304615,0.9596228483580735,3,6,66058,1853,64205,0.971948893396712,23.90223111111111,3267.265936,12.988958759679466,123,0.0010000000000000002
8,test_20231031_152523,11382381.png,312486,767,311719,0.9975454900379537,2,5,46745,101,46644,0.9978393411060006,21.620851555555557,2482.477712,14.181950028339719,123,0.0010000000000000002
9,test_20231031_152523,11079715.png,443815,125112,318703,0.7180987573651183,5,6,124136,17438,106698,0.859525037056132,16.667505777777777,2042.6386346666666,15.02888818930283,123,0.0010000000000000002
10,test_20231031_152523,11551286.png,271883,467,271416,0.9982823493929374,2,5,40092,67,40025,0.998328843659583,17.988837333333333,1870.894224,15.410311266718583,123,0.0010000000000000002
1,test_20231031_152524,10404007.png,502730,22452,480278,0.9553398444493068,3,5,61265,3246,58019,0.9470170570472537,25.653054222222224,3401.166714666667,12.814524406419615,123,0.0011000000000000003
2,test_20231031_152524,1254659.png,342646,77812,264834,0.7729084828073288,5,15,80080,10838,69242,0.8646603396603396,20.601813333333332,3087.073888,13.235333365796425,123,0.0011000000000000003
3,test_20231031_152524,10188041.png,221231,9662,211569,0.9563261929838043,3,5,41731,1366,40365,0.9672665404615274,11.204343111111111,1105.490064,17.69525517317596,123,0.0011000000000000003
4,test_20231031_152524,10287332.png,216980,12747,204233,0.9412526500138262,3,6,22337,1744,20593,0.9219232663294086,9.462853333333333,779.8647306666667,19.21061081023097,123,0.0011000000000000003
5,test_20231031_152524,11610969.png,368720,27507,341213,0.9253986765024951,4,6,84111,4019,80092,0.9522179025335569,21.423712,2939.270666666667,13.448407803661475,123,0.0011000000000000003
6,test_20231031_152524,10350842.png,212614,4457,208157,0.979037128317044,2,6,42529,651,41878,0.984692797855581,23.590419555555556,3404.762,12.809936016526517,123,0.0011000000000000003
7,test_20231031_152524,10863862.png,317432,12817,304615,0.9596228483580735,4,5,66058,1853,64205,0.971948893396712,23.90223111111111,3267.265936,12.988958759679466,123,0.0011000000000000003
8,test_20231031_152524,11382381.png,312486,767,311719,0.9975454900379537,2,5,46745,101,46644,0.9978393411060006,21.620851555555557,2482.477712,14.181950028339719,123,0.0011000000000000003
9,test_20231031_152524,11079715.png,443815,125112,318703,0.7180987573651183,5,7,124136,17438,106698,0.859525037056132,16.667505777777777,2042.6386346666666,15.02888818930283,123,0.0011000000000000003
10,test_20231031_152524,11551286.png,271883,467,271416,0.9982823493929374,2,6,40092,67,40025,0.998328843659583,17.988837333333333,1870.894224,15.410311266718583,123,0.0011000000000000003
1,test_20231031_152525,10404007.png,502730,22452,480278,0.9553398444493068,4,6,61265,3246,58019,0.9470170570472537,25.653054222222224,3401.166714666667,12.814524406419615,123,0.0012000000000000003
2,test_20231031_152525,1254659.png,342646,77812,264834,0.7729084828073288,5,7,80080,10838,69242,0.8646603396603396,20.601813333333332,3087.073888,13.235333365796425,123,0.0012000000000000003
3,test_20231031_152525,10188041.png,221231,9662,211569,0.9563261929838043,3,6,41731,1366,40365,0.9672665404615274,11.204343111111111,1105.490064,17.69525517317596,123,0.0012000000000000003
4,test_20231031_152525,10287332.png,216980,12747,204233,0.9412526500138262,2,6,22337,1744,20593,0.9219232663294086,9.462853333333333,779.8647306666667,19.21061081023097,123,0.0012000000000000003
5,test_20231031_152525,11610969.png,368720,27507,341213,0.9253986765024951,4,6,84111,4019,80092,0.9522179025335569,21.423712,2939.270666666667,13.448407803661475,123,0.0012000000000000003
6,test_20231031_152525,10350842.png,212614,4457,208157,0.979037128317044,2,6,42529,651,41878,0.984692797855581,23.590419555555556,3404.762,12.809936016526517,123,0.0012000000000000003
7,test_20231031_152525,10863862.png,317432,12817,304615,0.9596228483580735,4,6,66058,1853,64205,0.971948893396712,23.90223111111111,3267.265936,12.988958759679466,123,0.0012000000000000003
8,test_20231031_152525,11382381.png,312486,767,311719,0.9975454900379537,2,6,46745,101,46644,0.9978393411060006,21.620851555555557,2482.477712,14.181950028339719,123,0.0012000000000000003
9,test_20231031_152525,11079715.png,443815,125112,318703,0.7180987573651183,6,7,124136,17438,106698,0.859525037056132,16.667505777777777,2042.6386346666666,15.02888818930283,123,0.0012000000000000003
10,test_20231031_152525,11551286.png,271883,467,271416,0.9982823493929374,2,5,40092,67,40025,0.998328843659583,17.988837333333333,1870.894224,15.410311266718583,123,0.0012000000000000003
1,test_20231031_152526,10404007.png,502730,22452,480278,0.9553398444493068,4,6,61265,3246,58019,0.9470170570472537,25.653054222222224,3401.166714666667,12.814524406419615,123,0.0013000000000000004
2,test_20231031_152526,1254659.png,342646,77812,264834,0.7729084828073288,5,17,80080,10838,69242,0.8646603396603396,20.601813333333332,3087.073888,13.235333365796425,123,0.0013000000000000004
3,test_20231031_152526,10188041.png,221231,9662,211569,0.9563261929838043,3,6,41731,1366,40365,0.9672665404615274,11.204343111111111,1105.490064,17.69525517317596,123,0.0013000000000000004
4,test_20231031_152526,10287332.png,216980,12584,204396,0.942003871324546,3,6,22337,1722,20615,0.9229081792541522,9.530874666666667,790.9151626666667,19.149504593698644,123,0.0013000000000000004
5,test_20231031_152526,11610969.png,368720,27507,341213,0.9253986765024951,4,6,84111,4019,80092,0.9522179025335569,21.423712,2939.270666666667,13.448407803661475,123,0.0013000000000000004
6,test_20231031_152526,10350842.png,212614,4437,208177,0.979131195499826,2,5,42529,648,41881,0.9847633379576289,24.053157333333335,3485.952112,12.707589441401211,123,0.0013000000000000004
7,test_20231031_152526,10863862.png,317432,12817,304615,0.9596228483580735,3,6,66058,1853,64205,0.971948893396712,23.90223111111111,3267.265936,12.988958759679466,123,0.0013000000000000004
8,test_20231031_152526,11382381.png,312486,767,311719,0.9975454900379537,3,5,46745,101,46644,0.9978393411060006,21.620851555555557,2482.477712,14.181950028339719,123,0.0013000000000000004
9,test_20231031_152526,11079715.png,443815,124457,319358,0.719574597523743,6,10,124136,17342,106794,0.860298382419282,17.039452444444443,2120.0095466666667,14.867425442526878,123,0.0013000000000000004
10,test_20231031_152526,11551286.png,271883,467,271416,0.9982823493929374,2,5,40092,67,40025,0.998328843659583,17.988837333333333,1870.894224,15.410311266718583,123,0.0013000000000000004
1,test_20231031_152527,10404007.png,502730,22452,480278,0.9553398444493068,4,6,61265,3246,58019,0.9470170570472537,25.653054222222224,3401.166714666667,12.814524406419615,123,0.0014000000000000004
2,test_20231031_152527,1254659.png,342646,77812,264834,0.7729084828073288,5,6,80080,10838,69242,0.8646603396603396,20.601813333333332,3087.073888,13.235333365796425,123,0.0014000000000000004
3,test_20231031_152527,10188041.png,221231,9662,211569,0.9563261929838043,3,5,41731,1366,40365,0.9672665404615274,11.204343111111111,1105.490064,17.69525517317596,123,0.0014000000000000004
4,test_20231031_152527,10287332.png,216980,12584,204396,0.942003871324546,3,6,22337,1722,20615,0.9229081792541522,9.530874666666667,790.9151626666667,19.149504593698644,123,0.0014000000000000004
5,test_20231031_152527,11610969.png,368720,27507,341213,0.9253986765024951,4,6,84111,4019,80092,0.9522179025335569,21.423712,2939.270666666667,13.448407803661475,123,0.0014000000000000004
6,test_20231031_152527,10350842.png,212614,4437,208177,0.979131195499826,2,10,42529,648,41881,0.9847633379576289,24.053157333333335,3485.952112,12.707589441401211,123,0.0014000000000000004
7,test_20231031_152527,10863862.png,317432,12817,304615,0.9596228483580735,3,5,66058,1853,64205,0.971948893396712,23.90223111111111,3267.265936,12.988958759679466,123,0.0014000000000000004
8,test_20231031_152527,11382381.png,312486,767,311719,0.9975454900379537,3,6,46745,101,46644,0.9978393411060006,21.620851555555557,2482.477712,14.181950028339719,123,0.0014000000000000004
9,test_20231031_152527,11079715.png,443815,124457,319358,0.719574597523743,5,7,124136,17342,106794,0.860298382419282,17.039452444444443,2120.0095466666667,14.867425442526878,123,0.0014000000000000004
10,test_20231031_152527,11551286.png,271883,467,271416,0.9982823493929374,2,5,40092,67,40025,0.998328843659583,17.988837333333333,1870.894224,15.410311266718583,123,0.0014000000000000004
1,test_20231031_152528,10404007.png,502730,22884,479846,0.9544805362719552,4,6,61265,3295,57970,0.9462172529176528,25.586942222222223,3400.765381333333,12.815036898605106,124,1.0E-4
2,test_20231031_152528,1254659.png,342646,76264,266382,0.7774262650082009,5,6,80080,10638,69442,0.8671578421578422,20.667370666666667,3113.3477866666667,13.198527231942004,124,1.0E-4
3,test_20231031_152528,10188041.png,221231,10142,211089,0.954156515135763,3,5,41731,1428,40303,0.9657808343916993,10.476305777777778,997.11648,18.1433446668218,124,1.0E-4
4,test_20231031_152528,10287332.png,216980,12897,204083,0.940561342059176,3,5,22337,1766,20571,0.9209383534046649,9.311077333333333,749.8733493333333,19.38092441916683,124,1.0E-4
5,test_20231031_152528,11610969.png,368720,27227,341493,0.9261580603167715,3,5,84111,3970,80141,0.9528004660508138,20.228828444444446,2711.644832,13.798475553202607,124,1.0E-4
6,test_20231031_152528,10350842.png,212614,6344,206270,0.9701618896215677,2,5,42529,929,41600,0.9781560817324649,19.196949333333333,2355.988128,14.409072631896374,124,1.0E-4
7,test_20231031_152528,10863862.png,317432,12977,304455,0.9591188033972631,3,5,66058,1885,64173,0.9714644706167308,23.722218666666667,3236.9452053333334,13.029450130942488,124,1.0E-4
8,test_20231031_152528,11382381.png,312486,1099,311387,0.9964830424403013,2,5,46745,149,46596,0.996812493314793,20.626588444444444,2338.262816,14.441870374793048,124,1.0E-4
9,test_20231031_152528,11079715.png,443815,122782,321033,0.7233486925858748,6,7,124136,17120,107016,0.8620867435715667,16.763402666666668,2067.635402666667,14.97606401189655,124,1.0E-4
10,test_20231031_152528,11551286.png,271883,1199,270684,0.9955900148225524,2,5,40092,176,39916,0.995610096777412,15.83984888888889,1503.00104,16.36121079771285,124,1.0E-4
1,test_20231031_152529,10404007.png,502730,22884,479846,0.9544805362719552,3,5,61265,3295,57970,0.9462172529176528,25.586942222222223,3400.765381333333,12.815036898605106,124,2.0E-4
2,test_20231031_152529,1254659.png,342646,76264,266382,0.7774262650082009,5,6,80080,10638,69442,0.8671578421578422,20.667370666666667,3113.3477866666667,13.198527231942004,124,2.0E-4
3,test_20231031_152529,10188041.png,221231,10142,211089,0.954156515135763,3,7,41731,1428,40303,0.9657808343916993,10.476305777777778,997.11648,18.1433446668218,124,2.0E-4
4,test_20231031_152529,10287332.png,216980,12687,204293,0.9415291731956862,3,6,22337,1739,20598,0.9221471101759413,9.440839111111112,776.604096,19.22880684076492,124,2.0E-4
5,test_20231031_152529,11610969.png,368720,27227,341493,0.9261580603167715,4,6,84111,3970,80141,0.9528004660508138,20.228828444444446,2711.644832,13.798475553202607,124,2.0E-4
6,test_20231031_152529,10350842.png,212614,6344,206270,0.9701618896215677,3,6,42529,929,41600,0.9781560817324649,19.196949333333333,2355.988128,14.409072631896374,124,2.0E-4
7,test_20231031_152529,10863862.png,317432,12977,304455,0.9591188033972631,3,6,66058,1885,64173,0.9714644706167308,23.722218666666667,3236.9452053333334,13.029450130942488,124,2.0E-4
8,test_20231031_152529,11382381.png,312486,907,311579,0.9970974699666545,3,5,46745,121,46624,0.9974114878596642,21.088220444444445,2409.5101546666665,14.311515999312824,124,2.0E-4
9,test_20231031_152529,11079715.png,443815,122782,321033,0.7233486925858748,5,7,124136,17120,107016,0.8620867435715667,16.763402666666668,2067.635402666667,14.97606401189655,124,2.0E-4
10,test_20231031_152529,11551286.png,271883,977,270906,0.9964065425201282,3,6,40092,143,39949,0.9964332036316472,17.00562311111111,1711.9347146666667,15.795931622093908,124,2.0E-4
1,test_20231031_152530,10404007.png,502730,22704,480026,0.9548385813458516,4,6,61265,3271,57994,0.9466089937158247,25.603198222222222,3403.693370666667,12.811299320833328,124,3.0000000000000003E-4
2,test_20231031_152530,1254659.png,342646,76204,266442,0.777601372845444,5,7,80080,10632,69448,0.8672327672327672,20.676924444444445,3114.4299733333332,13.197017904793334,124,3.0000000000000003E-4
3,test_20231031_152530,10188041.png,221231,10042,211189,0.954608531354105,3,6,41731,1414,40317,0.9661163164074669,10.599658666666667,1012.831872,18.07543001512229,124,3.0000000000000003E-4
4,test_20231031_152530,10287332.png,216980,12687,204293,0.9415291731956862,3,6,22337,1739,20598,0.9221471101759413,9.440839111111112,776.604096,19.22880684076492,124,3.0000000000000003E-4
5,test_20231031_152530,11610969.png,368720,26582,342138,0.9279073551746583,4,6,84111,3877,80234,0.9539061478284647,21.465290666666668,2964.25984,13.411640906658562,124,3.0000000000000003E-4
6,test_20231031_152530,10350842.png,212614,6264,206350,0.9705381583526955,2,6,42529,917,41612,0.978438242140657,19.265742222222222,2361.7458346666667,14.398472027898631,124,3.0000000000000003E-4
7,test_20231031_152530,10863862.png,317432,12917,304515,0.959307820257567,3,6,66058,1876,64182,0.9716007145236005,23.73152711111111,3238.389536,13.027512733498073,124,3.0000000000000003E-4
8,test_20231031_152530,11382381.png,312486,767,311719,0.9975454900379537,3,5,46745,100,46645,0.9978607337683175,21.58402311111111,2479.723024,14.186771864393144,124,3.0000000000000003E-4
9,test_20231031_152530,11079715.png,443815,122782,321033,0.7233486925858748,6,7,124136,17120,107016,0.8620867435715667,16.763402666666668,2067.635402666667,14.97606401189655,124,3.0000000000000003E-4
10,test_20231031_152530,11551286.png,271883,547,271336,0.9979881051775947,3,5,40092,79,40013,0.9980295320762247,17.838736,1852.2023093333332,15.453919395217167,124,3.0000000000000003E-4
1,test_20231031_152531,10404007.png,502730,22704,480026,0.9548385813458516,4,6,61265,3271,57994,0.9466089937158247,25.603198222222222,3403.693370666667,12.811299320833328,124,4.0E-4
2,test_20231031_152531,1254659.png,342646,76204,266442,0.777601372845444,5,6,80080,10632,69448,0.8672327672327672,20.676924444444445,3114.4299733333332,13.197017904793334,124,4.0E-4
3,test_20231031_152531,10188041.png,221231,10042,211189,0.954608531354105,3,6,41731,1414,40317,0.9661163164074669,10.599658666666667,1012.831872,18.07543001512229,124,4.0E-4
4,test_20231031_152531,10287332.png,216980,12687,204293,0.9415291731956862,3,6,22337,1739,20598,0.9221471101759413,9.440839111111112,776.604096,19.22880684076492,124,4.0E-4
5,test_20231031_152531,11610969.png,368720,26582,342138,0.9279073551746583,3,5,84111,3877,80234,0.9539061478284647,21.465290666666668,2964.25984,13.411640906658562,124,4.0E-4
6,test_20231031_152531,10350842.png,212614,6264,206350,0.9705381583526955,2,6,42529,917,41612,0.978438242140657,19.265742222222222,2361.7458346666667,14.398472027898631,124,4.0E-4
7,test_20231031_152531,10863862.png,317432,12917,304515,0.959307820257567,3,5,66058,1876,64182,0.9716007145236005,23.73152711111111,3238.389536,13.027512733498073,124,4.0E-4
8,test_20231031_152531,11382381.png,312486,767,311719,0.9975454900379537,2,5,46745,100,46645,0.9978607337683175,21.58402311111111,2479.723024,14.186771864393144,124,4.0E-4
9,test_20231031_152531,11079715.png,443815,122782,321033,0.7233486925858748,6,7,124136,17120,107016,0.8620867435715667,16.763402666666668,2067.635402666667,14.97606401189655,124,4.0E-4
10,test_20231031_152531,11551286.png,271883,547,271336,0.9979881051775947,2,5,40092,79,40013,0.9980295320762247,17.838736,1852.2023093333332,15.453919395217167,124,4.0E-4
1,test_20231031_152532,10404007.png,502730,22382,480348,0.9554790842002665,4,6,61265,3225,58040,0.9473598302456542,25.693242666666666,3423.687909333333,12.785861917295664,124,5.0E-4
2,test_20231031_152532,1254659.png,342646,76204,266442,0.777601372845444,5,6,80080,10632,69448,0.8672327672327672,20.676924444444445,3114.4299733333332,13.197017904793334,124,5.0E-4
3,test_20231031_152532,10188041.png,221231,10042,211189,0.954608531354105,3,5,41731,1414,40317,0.9661163164074669,10.599658666666667,1012.831872,18.07543001512229,124,5.0E-4
4,test_20231031_152532,10287332.png,216980,12687,204293,0.9415291731956862,5,6,22337,1739,20598,0.9221471101759413,9.440839111111112,776.604096,19.22880684076492,124,5.0E-4
5,test_20231031_152532,11610969.png,368720,26582,342138,0.9279073551746583,4,6,84111,3877,80234,0.9539061478284647,21.465290666666668,2964.25984,13.411640906658562,124,5.0E-4
6,test_20231031_152532,10350842.png,212614,6264,206350,0.9705381583526955,3,5,42529,917,41612,0.978438242140657,19.265742222222222,2361.7458346666667,14.398472027898631,124,5.0E-4
7,test_20231031_152532,10863862.png,317432,12917,304515,0.959307820257567,3,5,66058,1876,64182,0.9716007145236005,23.73152711111111,3238.389536,13.027512733498073,124,5.0E-4
8,test_20231031_152532,11382381.png,312486,767,311719,0.9975454900379537,2,5,46745,100,46645,0.9978607337683175,21.58402311111111,2479.723024,14.186771864393144,124,5.0E-4
9,test_20231031_152532,11079715.png,443815,122782,321033,0.7233486925858748,5,7,124136,17120,107016,0.8620867435715667,16.763402666666668,2067.635402666667,14.97606401189655,124,5.0E-4
10,test_20231031_152532,11551286.png,271883,547,271336,0.9979881051775947,2,5,40092,79,40013,0.9980295320762247,17.838736,1852.2023093333332,15.453919395217167,124,5.0E-4
1,test_20231031_152533,10404007.png,502730,22102,480628,0.9560360432041056,3,5,61265,3186,58079,0.9479964090426835,25.709000888888887,3427.5201546666667,12.781003436398297,124,6.000000000000001E-4
2,test_20231031_152533,1254659.png,342646,76204,266442,0.777601372845444,4,6,80080,10632,69448,0.8672327672327672,20.676924444444445,3114.4299733333332,13.197017904793334,124,6.000000000000001E-4
3,test_20231031_152533,10188041.png,221231,10022,211209,0.9546989345977733,4,6,41731,1411,40320,0.9661882054108457,10.857368888888889,1051.873824,17.911167130910616,124,6.000000000000001E-4
4,test_20231031_152533,10287332.png,216980,12687,204293,0.9415291731956862,2,6,22337,1739,20598,0.9221471101759413,9.440839111111112,776.604096,19.22880684076492,124,6.000000000000001E-4
5,test_20231031_152533,11610969.png,368720,26582,342138,0.9279073551746583,4,6,84111,3877,80234,0.9539061478284647,21.465290666666668,2964.25984,13.411640906658562,124,6.000000000000001E-4
6,test_20231031_152533,10350842.png,212614,6264,206350,0.9705381583526955,2,6,42529,917,41612,0.978438242140657,19.265742222222222,2361.7458346666667,14.398472027898631,124,6.000000000000001E-4
7,test_20231031_152533,10863862.png,317432,12857,304575,0.9594968371178709,3,6,66058,1867,64191,0.9717369584304701,23.773376,3240.2564693333334,13.025009744859632,124,6.000000000000001E-4
8,test_20231031_152533,11382381.png,312486,767,311719,0.9975454900379537,2,5,46745,100,46645,0.9978607337683175,21.58402311111111,2479.723024,14.186771864393144,124,6.000000000000001E-4
9,test_20231031_152533,11079715.png,443815,122782,321033,0.7233486925858748,6,9,124136,17120,107016,0.8620867435715667,16.763402666666668,2067.635402666667,14.97606401189655,124,6.000000000000001E-4
10,test_20231031_152533,11551286.png,271883,467,271416,0.9982823493929374,1,6,40092,67,40025,0.998328843659583,17.988837333333333,1870.894224,15.410311266718583,124,6.000000000000001E-4
1,test_20231031_152534,10404007.png,502730,22102,480628,0.9560360432041056,4,6,61265,3186,58079,0.9479964090426835,25.709000888888887,3427.5201546666667,12.781003436398297,124,7.000000000000001E-4
2,test_20231031_152534,1254659.png,342646,76204,266442,0.777601372845444,5,12,80080,10632,69448,0.8672327672327672,20.676924444444445,3114.4299733333332,13.197017904793334,124,7.000000000000001E-4
3,test_20231031_152534,10188041.png,221231,10022,211209,0.9546989345977733,3,5,41731,1411,40320,0.9661882054108457,10.857368888888889,1051.873824,17.911167130910616,124,7.000000000000001E-4
4,test_20231031_152534,10287332.png,216980,12687,204293,0.9415291731956862,2,5,22337,1739,20598,0.9221471101759413,9.440839111111112,776.604096,19.22880684076492,124,7.000000000000001E-4
5,test_20231031_152534,11610969.png,368720,26582,342138,0.9279073551746583,4,6,84111,3877,80234,0.9539061478284647,21.465290666666668,2964.25984,13.411640906658562,124,7.000000000000001E-4
6,test_20231031_152534,10350842.png,212614,6264,206350,0.9705381583526955,2,5,42529,917,41612,0.978438242140657,19.265742222222222,2361.7458346666667,14.398472027898631,124,7.000000000000001E-4
7,test_20231031_152534,10863862.png,317432,12857,304575,0.9594968371178709,3,6,66058,1867,64191,0.9717369584304701,23.773376,3240.2564693333334,13.025009744859632,124,7.000000000000001E-4
8,test_20231031_152534,11382381.png,312486,767,311719,0.9975454900379537,2,5,46745,100,46645,0.9978607337683175,21.58402311111111,2479.723024,14.186771864393144,124,7.000000000000001E-4
9,test_20231031_152534,11079715.png,443815,122782,321033,0.7233486925858748,6,7,124136,17120,107016,0.8620867435715667,16.763402666666668,2067.635402666667,14.97606401189655,124,7.000000000000001E-4
10,test_20231031_152534,11551286.png,271883,467,271416,0.9982823493929374,3,5,40092,67,40025,0.998328843659583,17.988837333333333,1870.894224,15.410311266718583,124,7.000000000000001E-4
1,test_20231031_152535,10404007.png,502730,21839,480891,0.9565591868398544,4,6,61265,3149,58116,0.9486003427731984,25.754179555555556,3436.142549333333,12.770091885071036,124,8.000000000000001E-4
2,test_20231031_152535,1254659.png,342646,76204,266442,0.777601372845444,5,6,80080,10632,69448,0.8672327672327672,20.676924444444445,3114.4299733333332,13.197017904793334,124,8.000000000000001E-4
3,test_20231031_152535,10188041.png,221231,9942,211289,0.9550605475724468,3,5,41731,1401,40330,0.9664278354221083,10.984138666666666,1062.7922133333334,17.86631997025374,124,8.000000000000001E-4
4,test_20231031_152535,10287332.png,216980,12687,204293,0.9415291731956862,2,5,22337,1739,20598,0.9221471101759413,9.440839111111112,776.604096,19.22880684076492,124,8.000000000000001E-4
5,test_20231031_152535,11610969.png,368720,26502,342218,0.9281243219787373,4,10,84111,3866,80245,0.9540369273935633,21.558876444444444,2980.7761066666667,13.3875100452361,124,8.000000000000001E-4
6,test_20231031_152535,10350842.png,212614,6264,206350,0.9705381583526955,2,5,42529,917,41612,0.978438242140657,19.265742222222222,2361.7458346666667,14.398472027898631,124,8.000000000000001E-4
7,test_20231031_152535,10863862.png,317432,12857,304575,0.9594968371178709,3,6,66058,1867,64191,0.9717369584304701,23.773376,3240.2564693333334,13.025009744859632,124,8.000000000000001E-4
8,test_20231031_152535,11382381.png,312486,767,311719,0.9975454900379537,3,6,46745,100,46645,0.9978607337683175,21.58402311111111,2479.723024,14.186771864393144,124,8.000000000000001E-4
9,test_20231031_152535,11079715.png,443815,122782,321033,0.7233486925858748,5,7,124136,17120,107016,0.8620867435715667,16.763402666666668,2067.635402666667,14.97606401189655,124,8.000000000000001E-4
10,test_20231031_152535,11551286.png,271883,467,271416,0.9982823493929374,2,6,40092,67,40025,0.998328843659583,17.988837333333333,1870.894224,15.410311266718583,124,8.000000000000001E-4
1,test_20231031_152536,10404007.png,502730,21839,480891,0.9565591868398544,4,5,61265,3149,58116,0.9486003427731984,25.754179555555556,3436.142549333333,12.770091885071036,124,9.000000000000002E-4
2,test_20231031_152536,1254659.png,342646,76204,266442,0.777601372845444,5,7,80080,10632,69448,0.8672327672327672,20.676924444444445,3114.4299733333332,13.197017904793334,124,9.000000000000002E-4
3,test_20231031_152536,10188041.png,221231,9842,211389,0.9555125637907889,3,5,41731,1390,40341,0.9666914284344972,11.031626666666666,1067.9992426666668,17.84509416139609,124,9.000000000000002E-4
4,test_20231031_152536,10287332.png,216980,12687,204293,0.9415291731956862,3,11,22337,1739,20598,0.9221471101759413,9.440839111111112,776.604096,19.22880684076492,124,9.000000000000002E-4
5,test_20231031_152536,11610969.png,368720,26502,342218,0.9281243219787373,3,5,84111,3866,80245,0.9540369273935633,21.558876444444444,2980.7761066666667,13.3875100452361,124,9.000000000000002E-4
6,test_20231031_152536,10350842.png,212614,6264,206350,0.9705381583526955,3,6,42529,917,41612,0.978438242140657,19.265742222222222,2361.7458346666667,14.398472027898631,124,9.000000000000002E-4
7,test_20231031_152536,10863862.png,317432,12857,304575,0.9594968371178709,6,9,66058,1867,64191,0.9717369584304701,23.773376,3240.2564693333334,13.025009744859632,124,9.000000000000002E-4
8,test_20231031_152536,11382381.png,312486,767,311719,0.9975454900379537,2,6,46745,100,46645,0.9978607337683175,21.58402311111111,2479.723024,14.186771864393144,124,9.000000000000002E-4
9,test_20231031_152536,11079715.png,443815,122782,321033,0.7233486925858748,5,10,124136,17120,107016,0.8620867435715667,16.763402666666668,2067.635402666667,14.97606401189655,124,9.000000000000002E-4
10,test_20231031_152536,11551286.png,271883,467,271416,0.9982823493929374,2,5,40092,67,40025,0.998328843659583,17.988837333333333,1870.894224,15.410311266718583,124,9.000000000000002E-4
1,test_20231031_152537,10404007.png,502730,21297,481433,0.9576373003401428,3,5,61265,3079,58186,0.9497429201011998,25.904113777777777,3475.3629546666666,12.720801933870991,124,0.0010000000000000002
2,test_20231031_152537,1254659.png,342646,76022,266624,0.7781325332850814,5,12,80080,10617,69463,0.86742007992008,20.750830222222223,3130.270112,13.174985462960077,124,0.0010000000000000002
3,test_20231031_152537,10188041.png,221231,9702,211529,0.9561453864964675,5,6,41731,1372,40359,0.9671227624547698,11.116775111111112,1082.9984213333332,17.784525373051217,124,0.0010000000000000002
4,test_20231031_152537,10287332.png,216980,12584,204396,0.942003871324546,3,7,22337,1724,20613,0.9228186417155393,9.492426666666667,785.1949546666667,19.181028605250994,124,0.0010000000000000002
5,test_20231031_152537,11610969.png,368720,26242,342478,0.928829464091994,6,6,84111,3834,80277,0.9544173770374862,21.61884088888889,2989.316704,13.375084319399264,124,0.0010000000000000002
6,test_20231031_152537,10350842.png,212614,5462,207152,0.9743102523822514,2,6,42529,797,41732,0.9812598462225776,20.577888,2671.673152,13.862970346711855,124,0.0010000000000000002
7,test_20231031_152537,10863862.png,317432,12514,304918,0.9605773835026085,4,6,66058,1818,64240,0.9724787308123164,23.941692444444445,3280.01456,12.972045893167124,124,0.0010000000000000002
8,test_20231031_152537,11382381.png,312486,727,311759,0.9976734957726107,2,5,46745,95,46650,0.9979676970799016,21.638337777777778,2485.5710026666666,14.176541871865357,124,0.0010000000000000002
9,test_20231031_152537,11079715.png,443815,122699,321116,0.7235357074456699,5,7,124136,17114,107022,0.8621350776567636,16.782133333333334,2070.500992,14.970049179541583,124,0.0010000000000000002
10,test_20231031_152537,11551286.png,271883,467,271416,0.9982823493929374,2,6,40092,67,40025,0.998328843659583,17.988837333333333,1870.894224,15.410311266718583,124,0.0010000000000000002
1,test_20231031_152539,10404007.png,502730,21297,481433,0.9576373003401428,4,12,61265,3079,58186,0.9497429201011998,25.904113777777777,3475.3629546666666,12.720801933870991,124,0.0011000000000000003
2,test_20231031_152539,1254659.png,342646,76022,266624,0.7781325332850814,5,6,80080,10617,69463,0.86742007992008,20.750830222222223,3130.270112,13.174985462960077,124,0.0011000000000000003
3,test_20231031_152539,10188041.png,221231,9582,211649,0.9566878059584778,3,5,41731,1354,40377,0.9675540964750425,11.211633777777777,1106.8692906666668,17.68984022458758,124,0.0011000000000000003
4,test_20231031_152539,10287332.png,216980,12584,204396,0.942003871324546,3,6,22337,1724,20613,0.9228186417155393,9.492426666666667,785.1949546666667,19.181028605250994,124,0.0011000000000000003
5,test_20231031_152539,11610969.png,368720,26242,342478,0.928829464091994,4,6,84111,3834,80277,0.9544173770374862,21.61884088888889,2989.316704,13.375084319399264,124,0.0011000000000000003
6,test_20231031_152539,10350842.png,212614,4274,208340,0.9798978430394988,2,6,42529,624,41905,0.9853276587740131,23.650088888888888,3415.9803893333333,12.795649920677949,124,0.0011000000000000003
7,test_20231031_152539,10863862.png,317432,12514,304918,0.9605773835026085,6,6,66058,1818,64240,0.9724787308123164,23.941692444444445,3280.01456,12.972045893167124,124,0.0011000000000000003
8,test_20231031_152539,11382381.png,312486,727,311759,0.9976734957726107,3,6,46745,95,46650,0.9979676970799016,21.638337777777778,2485.5710026666666,14.176541871865357,124,0.0011000000000000003
9,test_20231031_152539,11079715.png,443815,122699,321116,0.7235357074456699,5,7,124136,17114,107022,0.8621350776567636,16.782133333333334,2070.500992,14.970049179541583,124,0.0011000000000000003
10,test_20231031_152539,11551286.png,271883,467,271416,0.9982823493929374,2,11,40092,67,40025,0.998328843659583,17.988837333333333,1870.894224,15.410311266718583,124,0.0011000000000000003
1,test_20231031_152540,10404007.png,502730,21297,481433,0.9576373003401428,4,6,61265,3079,58186,0.9497429201011998,25.904113777777777,3475.3629546666666,12.720801933870991,124,0.0012000000000000003
2,test_20231031_152540,1254659.png,342646,76022,266624,0.7781325332850814,6,6,80080,10617,69463,0.86742007992008,20.750830222222223,3130.270112,13.174985462960077,124,0.0012000000000000003
3,test_20231031_152540,10188041.png,221231,9582,211649,0.9566878059584778,3,6,41731,1354,40377,0.9675540964750425,11.211633777777777,1106.8692906666668,17.68984022458758,124,0.0012000000000000003
4,test_20231031_152540,10287332.png,216980,12584,204396,0.942003871324546,3,6,22337,1724,20613,0.9228186417155393,9.492426666666667,785.1949546666667,19.181028605250994,124,0.0012000000000000003
5,test_20231031_152540,11610969.png,368720,26242,342478,0.928829464091994,4,6,84111,3834,80277,0.9544173770374862,21.61884088888889,2989.316704,13.375084319399264,124,0.0012000000000000003
6,test_20231031_152540,10350842.png,212614,4274,208340,0.9798978430394988,2,8,42529,624,41905,0.9853276587740131,23.650088888888888,3415.9803893333333,12.795649920677949,124,0.0012000000000000003
7,test_20231031_152540,10863862.png,317432,12514,304918,0.9605773835026085,3,6,66058,1818,64240,0.9724787308123164,23.941692444444445,3280.01456,12.972045893167124,124,0.0012000000000000003
8,test_20231031_152540,11382381.png,312486,727,311759,0.9976734957726107,2,6,46745,95,46650,0.9979676970799016,21.638337777777778,2485.5710026666666,14.176541871865357,124,0.0012000000000000003
9,test_20231031_152540,11079715.png,443815,122699,321116,0.7235357074456699,5,11,124136,17114,107022,0.8621350776567636,16.782133333333334,2070.500992,14.970049179541583,124,0.0012000000000000003
10,test_20231031_152540,11551286.png,271883,467,271416,0.9982823493929374,2,6,40092,67,40025,0.998328843659583,17.988837333333333,1870.894224,15.410311266718583,124,0.0012000000000000003
1,test_20231031_152541,10404007.png,502730,21137,481593,0.9579555626280508,4,6,61265,3056,58209,0.9501183383661145,25.909102222222224,3476.523552,12.719351849719654,124,0.0013000000000000004
2,test_20231031_152541,1254659.png,342646,76022,266624,0.7781325332850814,12,7,80080,10617,69463,0.86742007992008,20.750830222222223,3130.270112,13.174985462960077,124,0.0013000000000000004
3,test_20231031_152541,10188041.png,221231,9439,211792,0.9573341891507068,3,6,41731,1343,40388,0.9678176894874314,11.208778666666667,1106.1163733333333,17.692795398325323,124,0.0013000000000000004
4,test_20231031_152541,10287332.png,216980,12424,204556,0.942741266476173,3,6,22337,1702,20635,0.923803554640283,9.560448,796.2453866666667,19.12033431758116,124,0.0013000000000000004
5,test_20231031_152541,11610969.png,368720,25979,342741,0.9295427424604036,4,6,84111,3795,80316,0.9548810500410172,22.09772088888889,3099.383584,13.218050324164574,124,0.0013000000000000004
6,test_20231031_152541,10350842.png,212614,4254,208360,0.9799919102222807,3,6,42529,621,41908,0.9853981988760611,24.112826666666667,3497.1705013333335,12.693635544142193,124,0.0013000000000000004
7,test_20231031_152541,10863862.png,317432,12514,304918,0.9605773835026085,3,5,66058,1818,64240,0.9724787308123164,23.941692444444445,3280.01456,12.972045893167124,124,0.0013000000000000004
8,test_20231031_152541,11382381.png,312486,727,311759,0.9976734957726107,3,6,46745,95,46650,0.9979676970799016,21.638337777777778,2485.5710026666666,14.176541871865357,124,0.0013000000000000004
9,test_20231031_152541,11079715.png,443815,122067,321748,0.7249597242094116,5,7,124136,17021,107115,0.8628842559773152,17.153242666666667,2147.674650666667,14.811118697445487,124,0.0013000000000000004
10,test_20231031_152541,11551286.png,271883,467,271416,0.9982823493929374,3,5,40092,67,40025,0.998328843659583,17.988837333333333,1870.894224,15.410311266718583,124,0.0013000000000000004
1,test_20231031_152542,10404007.png,502730,21137,481593,0.9579555626280508,4,6,61265,3056,58209,0.9501183383661145,25.909102222222224,3476.523552,12.719351849719654,124,0.0014000000000000004
2,test_20231031_152542,1254659.png,342646,76022,266624,0.7781325332850814,4,6,80080,10617,69463,0.86742007992008,20.750830222222223,3130.270112,13.174985462960077,124,0.0014000000000000004
3,test_20231031_152542,10188041.png,221231,9439,211792,0.9573341891507068,3,5,41731,1343,40388,0.9678176894874314,11.208778666666667,1106.1163733333333,17.692795398325323,124,0.0014000000000000004
4,test_20231031_152542,10287332.png,216980,12424,204556,0.942741266476173,2,5,22337,1702,20635,0.923803554640283,9.560448,796.2453866666667,19.12033431758116,124,0.0014000000000000004
5,test_20231031_152542,11610969.png,368720,25979,342741,0.9295427424604036,3,6,84111,3795,80316,0.9548810500410172,22.09772088888889,3099.383584,13.218050324164574,124,0.0014000000000000004
6,test_20231031_152542,10350842.png,212614,4254,208360,0.9799919102222807,2,10,42529,621,41908,0.9853981988760611,24.112826666666667,3497.1705013333335,12.693635544142193,124,0.0014000000000000004
7,test_20231031_152542,10863862.png,317432,12514,304918,0.9605773835026085,3,5,66058,1818,64240,0.9724787308123164,23.941692444444445,3280.01456,12.972045893167124,124,0.0014000000000000004
8,test_20231031_152542,11382381.png,312486,727,311759,0.9976734957726107,3,6,46745,95,46650,0.9979676970799016,21.638337777777778,2485.5710026666666,14.176541871865357,124,0.0014000000000000004
9,test_20231031_152542,11079715.png,443815,122067,321748,0.7249597242094116,5,6,124136,17021,107115,0.8628842559773152,17.153242666666667,2147.674650666667,14.811118697445487,124,0.0014000000000000004
10,test_20231031_152542,11551286.png,271883,467,271416,0.9982823493929374,2,5,40092,67,40025,0.998328843659583,17.988837333333333,1870.894224,15.410311266718583,124,0.0014000000000000004
1,test_20231031_152543,10404007.png,502730,21859,480871,0.9565194040538659,4,6,61265,3161,58104,0.9484044723741125,25.648606222222224,3418.377488,12.792603411306079,125,1.0E-4
2,test_20231031_152543,1254659.png,342646,74757,267889,0.7818243901869568,4,6,80080,10445,69635,0.869567932067932,20.832983111111112,3162.755813333333,13.130146982015201,125,1.0E-4
3,test_20231031_152543,10188041.png,221231,9952,211279,0.9550153459506127,3,15,41731,1403,40328,0.9663799094198557,10.516405333333333,1008.327776,18.094786301784424,125,1.0E-4
4,test_20231031_152543,10287332.png,216980,12797,204183,0.9410222140289428,3,6,22337,1754,20583,0.9214755786363433,9.318817777777777,752.2076,19.367426438243534,125,1.0E-4
5,test_20231031_152543,11610969.png,368720,26082,342638,0.9292633977001519,3,6,84111,3804,80307,0.9547740485786639,21.12351288888889,2899.7180693333335,13.507245860327119,125,1.0E-4
6,test_20231031_152543,10350842.png,212614,6184,206430,0.9709144270838233,2,5,42529,906,41623,0.9786968891814997,19.249219555555555,2368.0866986666665,14.386827624524777,125,1.0E-4
7,test_20231031_152543,10863862.png,317432,12282,305150,0.9613082486957837,3,5,66058,1783,64275,0.9730085682279209,23.971452444444445,3305.626730666667,12.938265491291542,125,1.0E-4
8,test_20231031_152543,11382381.png,312486,1039,311447,0.9966750510422867,2,5,46745,140,46605,0.9970050272756444,20.829804444444445,2368.9669066666665,14.385213669887252,125,1.0E-4
9,test_20231031_152543,11079715.png,443815,120387,323428,0.7287450852269527,6,7,124136,16809,107327,0.8645920603209383,16.86984177777778,2095.0260693333335,14.918909294142013,125,1.0E-4
10,test_20231031_152543,11551286.png,271883,1059,270824,0.9961049421994019,3,5,40092,155,39937,0.996133892048289,15.857982222222223,1506.99288,16.349691604338467,125,1.0E-4
1,test_20231031_152544,10404007.png,502730,21859,480871,0.9565194040538659,4,6,61265,3161,58104,0.9484044723741125,25.648606222222224,3418.377488,12.792603411306079,125,2.0E-4
2,test_20231031_152544,1254659.png,342646,74757,267889,0.7818243901869568,5,6,80080,10445,69635,0.869567932067932,20.832983111111112,3162.755813333333,13.130146982015201,125,2.0E-4
3,test_20231031_152544,10188041.png,221231,9952,211279,0.9550153459506127,3,7,41731,1403,40328,0.9663799094198557,10.516405333333333,1008.327776,18.094786301784424,125,2.0E-4
4,test_20231031_152544,10287332.png,216980,12584,204396,0.942003871324546,2,10,22337,1727,20610,0.9226843354076196,9.448579555555556,778.9383466666667,19.21577276445775,125,2.0E-4
5,test_20231031_152544,11610969.png,368720,26082,342638,0.9292633977001519,4,6,84111,3804,80307,0.9547740485786639,21.12351288888889,2899.7180693333335,13.507245860327119,125,2.0E-4
6,test_20231031_152544,10350842.png,212614,6184,206430,0.9709144270838233,2,5,42529,906,41623,0.9786968891814997,19.249219555555555,2368.0866986666665,14.386827624524777,125,2.0E-4
7,test_20231031_152544,10863862.png,317432,12282,305150,0.9613082486957837,3,6,66058,1783,64275,0.9730085682279209,23.971452444444445,3305.626730666667,12.938265491291542,125,2.0E-4
8,test_20231031_152544,11382381.png,312486,907,311579,0.9970974699666545,3,5,46745,121,46624,0.9974114878596642,21.088220444444445,2409.5101546666665,14.311515999312824,125,2.0E-4
9,test_20231031_152544,11079715.png,443815,120387,323428,0.7287450852269527,6,7,124136,16809,107327,0.8645920603209383,16.86984177777778,2095.0260693333335,14.918909294142013,125,2.0E-4
10,test_20231031_152544,11551286.png,271883,877,271006,0.9967743477893064,2,6,40092,128,39964,0.9968073431108451,17.018796444444444,1715.096528,15.787917931083486,125,2.0E-4
1,test_20231031_152545,10404007.png,502730,21619,481111,0.956996797485728,4,6,61265,3126,58139,0.9489757610381131,25.66681422222222,3421.940368,12.788079237733479,125,3.0000000000000003E-4
2,test_20231031_152545,1254659.png,342646,74697,267949,0.7819994980241999,5,7,80080,10439,69641,0.8696428571428572,20.84253688888889,3163.838,13.12866122928261,125,3.0000000000000003E-4
3,test_20231031_152545,10188041.png,221231,9852,211379,0.9554673621689547,4,5,41731,1388,40343,0.9667393544367496,10.639758222222222,1024.043168,18.02762096387238,125,3.0000000000000003E-4
4,test_20231031_152545,10287332.png,216980,12584,204396,0.942003871324546,3,5,22337,1727,20610,0.9226843354076196,9.448579555555556,778.9383466666667,19.21577276445775,125,3.0000000000000003E-4
5,test_20231031_152545,11610969.png,368720,25759,342961,0.9301394011716207,4,6,84111,3758,80353,0.9553209449418031,21.541429333333333,2985.787157333333,13.380215151782494,125,3.0000000000000003E-4
6,test_20231031_152545,10350842.png,212614,6102,206512,0.9713001025332292,2,5,42529,894,41635,0.9789790495896917,19.318012444444445,2373.8444053333333,14.37628111337661,125,3.0000000000000003E-4
7,test_20231031_152545,10863862.png,317432,12162,305270,0.9616862824163915,3,6,66058,1765,64293,0.9732810560416604,24.022609777777777,3308.937994666667,12.933917317637896,125,3.0000000000000003E-4
8,test_20231031_152545,11382381.png,312486,767,311719,0.9975454900379537,3,11,46745,100,46645,0.9978607337683175,21.58402311111111,2479.723024,14.186771864393144,125,3.0000000000000003E-4
9,test_20231031_152545,11079715.png,443815,120387,323428,0.7287450852269527,6,7,124136,16809,107327,0.8645920603209383,16.86984177777778,2095.0260693333335,14.918909294142013,125,3.0000000000000003E-4
10,test_20231031_152545,11551286.png,271883,447,271436,0.9983559104467731,2,6,40092,64,40028,0.9984036715554225,17.85190933333333,1855.3641226666666,15.446512065144763,125,3.0000000000000003E-4
1,test_20231031_152546,10404007.png,502730,21297,481433,0.9576373003401428,4,6,61265,3080,58185,0.9497265975679425,25.756858666666666,3441.934906666667,12.76277708107859,125,4.0E-4
2,test_20231031_152546,1254659.png,342646,74697,267949,0.7819994980241999,6,6,80080,10439,69641,0.8696428571428572,20.84253688888889,3163.838,13.12866122928261,125,4.0E-4
3,test_20231031_152546,10188041.png,221231,9852,211379,0.9554673621689547,11,5,41731,1388,40343,0.9667393544367496,10.639758222222222,1024.043168,18.02762096387238,125,4.0E-4
4,test_20231031_152546,10287332.png,216980,12584,204396,0.942003871324546,3,11,22337,1727,20610,0.9226843354076196,9.448579555555556,778.9383466666667,19.21577276445775,125,4.0E-4
5,test_20231031_152546,11610969.png,368720,25759,342961,0.9301394011716207,5,7,84111,3758,80353,0.9553209449418031,21.541429333333333,2985.787157333333,13.380215151782494,125,4.0E-4
6,test_20231031_152546,10350842.png,212614,6102,206512,0.9713001025332292,3,6,42529,894,41635,0.9789790495896917,19.318012444444445,2373.8444053333333,14.37628111337661,125,4.0E-4
7,test_20231031_152546,10863862.png,317432,12162,305270,0.9616862824163915,3,5,66058,1765,64293,0.9732810560416604,24.022609777777777,3308.937994666667,12.933917317637896,125,4.0E-4
8,test_20231031_152546,11382381.png,312486,767,311719,0.9975454900379537,2,5,46745,100,46645,0.9978607337683175,21.58402311111111,2479.723024,14.186771864393144,125,4.0E-4
9,test_20231031_152546,11079715.png,443815,120387,323428,0.7287450852269527,5,7,124136,16809,107327,0.8645920603209383,16.86984177777778,2095.0260693333335,14.918909294142013,125,4.0E-4
10,test_20231031_152546,11551286.png,271883,447,271436,0.9983559104467731,2,5,40092,64,40028,0.9984036715554225,17.85190933333333,1855.3641226666666,15.446512065144763,125,4.0E-4
1,test_20231031_152547,10404007.png,502730,21297,481433,0.9576373003401428,5,6,61265,3080,58185,0.9497265975679425,25.756858666666666,3441.934906666667,12.76277708107859,125,5.0E-4
2,test_20231031_152547,1254659.png,342646,74697,267949,0.7819994980241999,5,6,80080,10439,69641,0.8696428571428572,20.84253688888889,3163.838,13.12866122928261,125,5.0E-4
3,test_20231031_152547,10188041.png,221231,9852,211379,0.9554673621689547,3,5,41731,1388,40343,0.9667393544367496,10.639758222222222,1024.043168,18.02762096387238,125,5.0E-4
4,test_20231031_152547,10287332.png,216980,12584,204396,0.942003871324546,3,7,22337,1727,20610,0.9226843354076196,9.448579555555556,778.9383466666667,19.21577276445775,125,5.0E-4
5,test_20231031_152547,11610969.png,368720,25759,342961,0.9301394011716207,4,6,84111,3758,80353,0.9553209449418031,21.541429333333333,2985.787157333333,13.380215151782494,125,5.0E-4
6,test_20231031_152547,10350842.png,212614,6102,206512,0.9713001025332292,2,5,42529,894,41635,0.9789790495896917,19.318012444444445,2373.8444053333333,14.37628111337661,125,5.0E-4
7,test_20231031_152547,10863862.png,317432,12162,305270,0.9616862824163915,3,5,66058,1765,64293,0.9732810560416604,24.022609777777777,3308.937994666667,12.933917317637896,125,5.0E-4
8,test_20231031_152547,11382381.png,312486,767,311719,0.9975454900379537,2,5,46745,100,46645,0.9978607337683175,21.58402311111111,2479.723024,14.186771864393144,125,5.0E-4
9,test_20231031_152547,11079715.png,443815,120387,323428,0.7287450852269527,5,6,124136,16809,107327,0.8645920603209383,16.86984177777778,2095.0260693333335,14.918909294142013,125,5.0E-4
10,test_20231031_152547,11551286.png,271883,447,271436,0.9983559104467731,2,11,40092,64,40028,0.9984036715554225,17.85190933333333,1855.3641226666666,15.446512065144763,125,5.0E-4
1,test_20231031_152548,10404007.png,502730,21177,481553,0.9578759970560738,3,5,61265,3065,58200,0.9499714355668,25.765313777777777,3444.1170506666667,12.760024580413443,125,6.000000000000001E-4
2,test_20231031_152548,1254659.png,342646,74697,267949,0.7819994980241999,11,6,80080,10439,69641,0.8696428571428572,20.84253688888889,3163.838,13.12866122928261,125,6.000000000000001E-4
3,test_20231031_152548,10188041.png,221231,9752,211479,0.9559193783872966,3,6,41731,1375,40356,0.9670508734513911,11.024238222222221,1074.0035093333333,17.82074660433971,125,6.000000000000001E-4
4,test_20231031_152548,10287332.png,216980,12584,204396,0.942003871324546,3,6,22337,1727,20610,0.9226843354076196,9.448579555555556,778.9383466666667,19.21577276445775,125,6.000000000000001E-4
5,test_20231031_152548,11610969.png,368720,25697,343023,0.930307550444782,4,6,84111,3750,80361,0.9554160573527838,21.631701333333332,3001.576629333333,13.357309256291893,125,6.000000000000001E-4
6,test_20231031_152548,10350842.png,212614,6102,206512,0.9713001025332292,3,6,42529,894,41635,0.9789790495896917,19.318012444444445,2373.8444053333333,14.37628111337661,125,6.000000000000001E-4
7,test_20231031_152548,10863862.png,317432,12162,305270,0.9616862824163915,3,6,66058,1765,64293,0.9732810560416604,24.022609777777777,3308.937994666667,12.933917317637896,125,6.000000000000001E-4
8,test_20231031_152548,11382381.png,312486,767,311719,0.9975454900379537,2,5,46745,100,46645,0.9978607337683175,21.58402311111111,2479.723024,14.186771864393144,125,6.000000000000001E-4
9,test_20231031_152548,11079715.png,443815,120387,323428,0.7287450852269527,6,7,124136,16809,107327,0.8645920603209383,16.86984177777778,2095.0260693333335,14.918909294142013,125,6.000000000000001E-4
10,test_20231031_152548,11551286.png,271883,367,271516,0.9986501546621157,2,6,40092,52,40040,0.9987029831387808,18.002010666666667,1874.0560373333333,15.402977880083654,125,6.000000000000001E-4
1,test_20231031_152549,10404007.png,502730,21177,481553,0.9578759970560738,4,6,61265,3065,58200,0.9499714355668,25.765313777777777,3444.1170506666667,12.760024580413443,125,7.000000000000001E-4
2,test_20231031_152549,1254659.png,342646,74697,267949,0.7819994980241999,4,6,80080,10439,69641,0.8696428571428572,20.84253688888889,3163.838,13.12866122928261,125,7.000000000000001E-4
3,test_20231031_152549,10188041.png,221231,9752,211479,0.9559193783872966,3,6,41731,1375,40356,0.9670508734513911,11.024238222222221,1074.0035093333333,17.82074660433971,125,7.000000000000001E-4
4,test_20231031_152549,10287332.png,216980,12584,204396,0.942003871324546,2,5,22337,1727,20610,0.9226843354076196,9.448579555555556,778.9383466666667,19.21577276445775,125,7.000000000000001E-4
5,test_20231031_152549,11610969.png,368720,25697,343023,0.930307550444782,4,5,84111,3750,80361,0.9554160573527838,21.631701333333332,3001.576629333333,13.357309256291893,125,7.000000000000001E-4
6,test_20231031_152549,10350842.png,212614,6102,206512,0.9713001025332292,2,5,42529,894,41635,0.9789790495896917,19.318012444444445,2373.8444053333333,14.37628111337661,125,7.000000000000001E-4
7,test_20231031_152549,10863862.png,317432,12162,305270,0.9616862824163915,3,6,66058,1765,64293,0.9732810560416604,24.022609777777777,3308.937994666667,12.933917317637896,125,7.000000000000001E-4
8,test_20231031_152549,11382381.png,312486,767,311719,0.9975454900379537,2,5,46745,100,46645,0.9978607337683175,21.58402311111111,2479.723024,14.186771864393144,125,7.000000000000001E-4
9,test_20231031_152549,11079715.png,443815,120387,323428,0.7287450852269527,5,7,124136,16809,107327,0.8645920603209383,16.86984177777778,2095.0260693333335,14.918909294142013,125,7.000000000000001E-4
10,test_20231031_152549,11551286.png,271883,367,271516,0.9986501546621157,2,5,40092,52,40040,0.9987029831387808,18.002010666666667,1874.0560373333333,15.402977880083654,125,7.000000000000001E-4
1,test_20231031_152550,10404007.png,502730,20937,481793,0.9583533904879359,3,6,61265,3030,58235,0.9505427242308007,25.80952177777778,3452.553962666667,12.749398856360063,125,8.000000000000001E-4
2,test_20231031_152550,1254659.png,342646,74697,267949,0.7819994980241999,5,6,80080,10439,69641,0.8696428571428572,20.84253688888889,3163.838,13.12866122928261,125,8.000000000000001E-4
3,test_20231031_152550,10188041.png,221231,9632,211599,0.9564617978493068,3,5,41731,1357,40374,0.9674822074716638,11.119096888888889,1097.8743786666666,17.72527710893187,125,8.000000000000001E-4
4,test_20231031_152550,10287332.png,216980,12584,204396,0.942003871324546,2,5,22337,1727,20610,0.9226843354076196,9.448579555555556,778.9383466666667,19.21577276445775,125,8.000000000000001E-4
5,test_20231031_152550,11610969.png,368720,25697,343023,0.930307550444782,4,6,84111,3750,80361,0.9554160573527838,21.631701333333332,3001.576629333333,13.357309256291893,125,8.000000000000001E-4
6,test_20231031_152550,10350842.png,212614,6102,206512,0.9713001025332292,2,5,42529,894,41635,0.9789790495896917,19.318012444444445,2373.8444053333333,14.37628111337661,125,8.000000000000001E-4
7,test_20231031_152550,10863862.png,317432,12162,305270,0.9616862824163915,3,6,66058,1765,64293,0.9732810560416604,24.022609777777777,3308.937994666667,12.933917317637896,125,8.000000000000001E-4
8,test_20231031_152550,11382381.png,312486,767,311719,0.9975454900379537,2,5,46745,100,46645,0.9978607337683175,21.58402311111111,2479.723024,14.186771864393144,125,8.000000000000001E-4
9,test_20231031_152550,11079715.png,443815,120387,323428,0.7287450852269527,5,8,124136,16809,107327,0.8645920603209383,16.86984177777778,2095.0260693333335,14.918909294142013,125,8.000000000000001E-4
10,test_20231031_152550,11551286.png,271883,367,271516,0.9986501546621157,2,5,40092,52,40040,0.9987029831387808,18.002010666666667,1874.0560373333333,15.402977880083654,125,8.000000000000001E-4
1,test_20231031_152551,10404007.png,502730,20937,481793,0.9583533904879359,4,6,61265,3030,58235,0.9505427242308007,25.80952177777778,3452.553962666667,12.749398856360063,125,9.000000000000002E-4
2,test_20231031_152551,1254659.png,342646,74697,267949,0.7819994980241999,5,6,80080,10439,69641,0.8696428571428572,20.84253688888889,3163.838,13.12866122928261,125,9.000000000000002E-4
3,test_20231031_152551,10188041.png,221231,9532,211699,0.9569138140676487,3,5,41731,1346,40385,0.9677458004840527,11.166584888888888,1103.081408,17.704727960790887,125,9.000000000000002E-4
4,test_20231031_152551,10287332.png,216980,12584,204396,0.942003871324546,3,6,22337,1727,20610,0.9226843354076196,9.448579555555556,778.9383466666667,19.21577276445775,125,9.000000000000002E-4
5,test_20231031_152551,11610969.png,368720,25697,343023,0.930307550444782,4,6,84111,3750,80361,0.9554160573527838,21.631701333333332,3001.576629333333,13.357309256291893,125,9.000000000000002E-4
6,test_20231031_152551,10350842.png,212614,6102,206512,0.9713001025332292,2,5,42529,894,41635,0.9789790495896917,19.318012444444445,2373.8444053333333,14.37628111337661,125,9.000000000000002E-4
7,test_20231031_152551,10863862.png,317432,12162,305270,0.9616862824163915,3,5,66058,1765,64293,0.9732810560416604,24.022609777777777,3308.937994666667,12.933917317637896,125,9.000000000000002E-4
8,test_20231031_152551,11382381.png,312486,767,311719,0.9975454900379537,2,5,46745,100,46645,0.9978607337683175,21.58402311111111,2479.723024,14.186771864393144,125,9.000000000000002E-4
9,test_20231031_152551,11079715.png,443815,120387,323428,0.7287450852269527,6,7,124136,16809,107327,0.8645920603209383,16.86984177777778,2095.0260693333335,14.918909294142013,125,9.000000000000002E-4
10,test_20231031_152551,11551286.png,271883,367,271516,0.9986501546621157,2,6,40092,52,40040,0.9987029831387808,18.002010666666667,1874.0560373333333,15.402977880083654,125,9.000000000000002E-4
1,test_20231031_152552,10404007.png,502730,20432,482298,0.9593579058341456,4,6,61265,2964,58301,0.9516200114257732,25.95758222222222,3491.477024,12.700711723980348,125,0.0010000000000000002
2,test_20231031_152552,1254659.png,342646,74537,268109,0.7824664522568482,6,6,80080,10425,69655,0.8698176823176823,20.912261333333333,3178.5184586666664,13.108556230080575,125,0.0010000000000000002
3,test_20231031_152552,10188041.png,221231,9329,211902,0.9578314069908829,3,6,41731,1326,40405,0.9682250605065779,11.250503111111112,1118.0084053333333,17.646352922225475,125,0.0010000000000000002
4,test_20231031_152552,10287332.png,216980,12484,204496,0.9424647432943128,2,5,22337,1712,20625,0.9233558669472176,9.50016711111111,787.5292053333334,19.16813692400025,125,0.0010000000000000002
5,test_20231031_152552,11610969.png,368720,25417,343303,0.9310669342590584,4,6,84111,3715,80396,0.9558321741508246,21.703139555555556,3011.838026666667,13.342487485903638,125,0.0010000000000000002
6,test_20231031_152552,10350842.png,212614,5399,207215,0.9746065640080145,2,5,42529,789,41740,0.9814479531613722,20.581038222222222,2672.5666026666668,13.861518238588664,125,0.0010000000000000002
7,test_20231031_152552,10863862.png,317432,11902,305530,0.9625053554777087,3,5,66058,1728,64330,0.9738411698810137,24.169952,3343.8964906666665,12.888275353509457,125,0.0010000000000000002
8,test_20231031_152552,11382381.png,312486,547,311939,0.9982495215785667,2,5,46745,73,46672,0.9984383356508717,22.032236444444443,2581.941392,14.011339809622479,125,0.0010000000000000002
9,test_20231031_152552,11079715.png,443815,120307,323508,0.7289253405135023,5,6,124136,16802,107334,0.8646484500870013,16.910190222222223,2101.7455466666665,14.905002249928847,125,0.0010000000000000002
10,test_20231031_152552,11551286.png,271883,367,271516,0.9986501546621157,2,6,40092,52,40040,0.9987029831387808,18.002010666666667,1874.0560373333333,15.402977880083654,125,0.0010000000000000002
1,test_20231031_152553,10404007.png,502730,20212,482518,0.9597955164800192,3,6,61265,2934,58331,0.9521096874234881,25.96658488888889,3493.913088,12.697682632752256,125,0.0011000000000000003
2,test_20231031_152553,1254659.png,342646,74537,268109,0.7824664522568482,5,6,80080,10425,69655,0.8698176823176823,20.912261333333333,3178.5184586666664,13.108556230080575,125,0.0011000000000000003
3,test_20231031_152553,10188041.png,221231,9329,211902,0.9578314069908829,6,6,41731,1326,40405,0.9682250605065779,11.250503111111112,1118.0084053333333,17.646352922225475,125,0.0011000000000000003
4,test_20231031_152553,10287332.png,216980,12484,204496,0.9424647432943128,2,6,22337,1712,20625,0.9233558669472176,9.50016711111111,787.5292053333334,19.16813692400025,125,0.0011000000000000003
5,test_20231031_152553,11610969.png,368720,25157,343563,0.9317720763723151,3,5,84111,3676,80435,0.9562958471543556,22.182019555555556,3121.9049066666666,13.186606905652473,125,0.0011000000000000003
6,test_20231031_152553,10350842.png,212614,4214,208400,0.9801800445878447,3,6,42529,616,41913,0.9855157657128077,23.653239111111112,3416.87384,12.794514170715859,125,0.0011000000000000003
7,test_20231031_152553,10863862.png,317432,11902,305530,0.9625053554777087,3,6,66058,1728,64330,0.9738411698810137,24.169952,3343.8964906666665,12.888275353509457,125,0.0011000000000000003
8,test_20231031_152553,11382381.png,312486,547,311939,0.9982495215785667,3,5,46745,73,46672,0.9984383356508717,22.032236444444443,2581.941392,14.011339809622479,125,0.0011000000000000003
9,test_20231031_152553,11079715.png,443815,120107,323708,0.7293759787298761,5,7,124136,16772,107364,0.8648901205129857,17.148405333333333,2143.978645333333,14.818599055281869,125,0.0011000000000000003
10,test_20231031_152553,11551286.png,271883,367,271516,0.9986501546621157,3,6,40092,52,40040,0.9987029831387808,18.002010666666667,1874.0560373333333,15.402977880083654,125,0.0011000000000000003
1,test_20231031_152554,10404007.png,502730,20212,482518,0.9597955164800192,4,6,61265,2934,58331,0.9521096874234881,25.96658488888889,3493.913088,12.697682632752256,125,0.0012000000000000003
2,test_20231031_152554,1254659.png,342646,74537,268109,0.7824664522568482,5,7,80080,10425,69655,0.8698176823176823,20.912261333333333,3178.5184586666664,13.108556230080575,125,0.0012000000000000003
3,test_20231031_152554,10188041.png,221231,9329,211902,0.9578314069908829,3,6,41731,1326,40405,0.9682250605065779,11.250503111111112,1118.0084053333333,17.646352922225475,125,0.0012000000000000003
4,test_20231031_152554,10287332.png,216980,12484,204496,0.9424647432943128,2,12,22337,1712,20625,0.9233558669472176,9.50016711111111,787.5292053333334,19.16813692400025,125,0.0012000000000000003
5,test_20231031_152554,11610969.png,368720,25157,343563,0.9317720763723151,4,6,84111,3676,80435,0.9562958471543556,22.182019555555556,3121.9049066666666,13.186606905652473,125,0.0012000000000000003
6,test_20231031_152554,10350842.png,212614,4214,208400,0.9801800445878447,2,6,42529,616,41913,0.9855157657128077,23.653239111111112,3416.87384,12.794514170715859,125,0.0012000000000000003
7,test_20231031_152554,10863862.png,317432,11902,305530,0.9625053554777087,3,5,66058,1728,64330,0.9738411698810137,24.169952,3343.8964906666665,12.888275353509457,125,0.0012000000000000003
8,test_20231031_152554,11382381.png,312486,547,311939,0.9982495215785667,2,5,46745,73,46672,0.9984383356508717,22.032236444444443,2581.941392,14.011339809622479,125,0.0012000000000000003
9,test_20231031_152554,11079715.png,443815,120107,323708,0.7293759787298761,5,7,124136,16772,107364,0.8648901205129857,17.148405333333333,2143.978645333333,14.818599055281869,125,0.0012000000000000003
10,test_20231031_152554,11551286.png,271883,367,271516,0.9986501546621157,2,5,40092,52,40040,0.9987029831387808,18.002010666666667,1874.0560373333333,15.402977880083654,125,0.0012000000000000003
1,test_20231031_152555,10404007.png,502730,20212,482518,0.9597955164800192,4,5,61265,2934,58331,0.9521096874234881,25.96658488888889,3493.913088,12.697682632752256,125,0.0013000000000000004
2,test_20231031_152555,1254659.png,342646,74537,268109,0.7824664522568482,4,7,80080,10425,69655,0.8698176823176823,20.912261333333333,3178.5184586666664,13.108556230080575,125,0.0013000000000000004
3,test_20231031_152555,10188041.png,221231,9187,212044,0.9584732700209283,3,6,41731,1315,40416,0.9684886535189667,11.247648,1117.255488,17.64927864259825,125,0.0013000000000000004
4,test_20231031_152555,10287332.png,216980,12322,204658,0.943211355885335,2,5,22337,1690,20647,0.9243407798719613,9.568188444444445,798.5796373333334,19.10762128771821,125,0.0013000000000000004
5,test_20231031_152555,11610969.png,368720,25137,343583,0.9318263180733348,3,15,84111,3675,80436,0.9563077362057282,22.287669333333334,3132.082986666667,13.172471004022025,125,0.0013000000000000004
6,test_20231031_152555,10350842.png,212614,4194,208420,0.9802741117706266,3,6,42529,613,41916,0.9855863058148557,24.115976888888888,3498.063952,12.69252615831936,125,0.0013000000000000004
7,test_20231031_152555,10863862.png,317432,11642,305790,0.9633244285390257,4,6,66058,1695,64363,0.9743407308728693,24.616192,3472.89312,12.723889429785352,125,0.0013000000000000004
8,test_20231031_152555,11382381.png,312486,547,311939,0.9982495215785667,2,6,46745,73,46672,0.9984383356508717,22.032236444444443,2581.941392,14.011339809622479,125,0.0013000000000000004
9,test_20231031_152555,11079715.png,443815,119677,324138,0.7303448508950802,6,7,124136,16708,107428,0.8654056840884191,17.281299555555556,2178.919205333333,14.748392340307594,125,0.0013000000000000004
10,test_20231031_152555,11551286.png,271883,367,271516,0.9986501546621157,2,6,40092,52,40040,0.9987029831387808,18.002010666666667,1874.0560373333333,15.402977880083654,125,0.0013000000000000004
1,test_20231031_152556,10404007.png,502730,20212,482518,0.9597955164800192,4,6,61265,2934,58331,0.9521096874234881,25.96658488888889,3493.913088,12.697682632752256,125,0.0014000000000000004
2,test_20231031_152556,1254659.png,342646,74537,268109,0.7824664522568482,5,6,80080,10425,69655,0.8698176823176823,20.912261333333333,3178.5184586666664,13.108556230080575,125,0.0014000000000000004
3,test_20231031_152556,10188041.png,221231,9187,212044,0.9584732700209283,3,5,41731,1315,40416,0.9684886535189667,11.247648,1117.255488,17.64927864259825,125,0.0014000000000000004
4,test_20231031_152556,10287332.png,216980,12322,204658,0.943211355885335,3,6,22337,1690,20647,0.9243407798719613,9.568188444444445,798.5796373333334,19.10762128771821,125,0.0014000000000000004
5,test_20231031_152556,11610969.png,368720,25137,343583,0.9318263180733348,4,6,84111,3675,80436,0.9563077362057282,22.287669333333334,3132.082986666667,13.172471004022025,125,0.0014000000000000004
6,test_20231031_152556,10350842.png,212614,4194,208420,0.9802741117706266,2,5,42529,613,41916,0.9855863058148557,24.115976888888888,3498.063952,12.69252615831936,125,0.0014000000000000004
7,test_20231031_152556,10863862.png,317432,11642,305790,0.9633244285390257,3,6,66058,1695,64363,0.9743407308728693,24.616192,3472.89312,12.723889429785352,125,0.0014000000000000004
8,test_20231031_152556,11382381.png,312486,547,311939,0.9982495215785667,2,5,46745,73,46672,0.9984383356508717,22.032236444444443,2581.941392,14.011339809622479,125,0.0014000000000000004
9,test_20231031_152556,11079715.png,443815,119677,324138,0.7303448508950802,5,7,124136,16708,107428,0.8654056840884191,17.281299555555556,2178.919205333333,14.748392340307594,125,0.0014000000000000004
10,test_20231031_152556,11551286.png,271883,367,271516,0.9986501546621157,2,16,40092,52,40040,0.9987029831387808,18.002010666666667,1874.0560373333333,15.402977880083654,125,0.0014000000000000004
1,test_20231031_152557,10404007.png,502730,20834,481896,0.9585582718357767,3,5,61265,3016,58249,0.9507712396964009,25.686528,3429.773024,12.778149806752824,126,1.0E-4
2,test_20231031_152557,1254659.png,342646,73249,269397,0.7862254338296668,4,6,80080,10244,69836,0.8720779220779221,20.98264711111111,3208.4044853333335,13.067912460579436,126,1.0E-4
3,test_20231031_152557,10188041.png,221231,9692,211539,0.9561905881183017,3,6,41731,1366,40365,0.9672665404615274,10.568042666666667,1021.7253333333333,18.037461991689202,126,1.0E-4
4,test_20231031_152557,10287332.png,216980,12574,204406,0.9420499585215227,2,6,22337,1723,20614,0.9228634104848458,9.367333333333333,764.1768586666667,19.29886478922929,126,1.0E-4
5,test_20231031_152557,11610969.png,368720,25357,343363,0.9312296593621177,7,6,84111,3701,80410,0.9559986208700408,21.3076,2937.504816,13.451017735675183,126,1.0E-4
6,test_20231031_152557,10350842.png,212614,6082,206532,0.9713941697160112,2,5,42529,891,41638,0.9790495896917397,19.26112,2371.9918826666667,14.379671623979055,126,1.0E-4
7,test_20231031_152557,10863862.png,317432,11479,305953,0.9638379243428514,3,6,66058,1667,64391,0.9747646008053529,24.188906666666668,3362.179488,12.864594665868092,126,1.0E-4
8,test_20231031_152557,11382381.png,312486,997,311489,0.9968094570636764,2,9,46745,135,46610,0.9971119905872285,20.87208,2373.5487946666667,14.376821966329306,126,1.0E-4
9,test_20231031_152557,11079715.png,443815,118057,325758,0.733995020447709,6,7,124136,16497,107639,0.8671054327511761,17.022149333333335,2131.304528,14.84434853255526,126,1.0E-4
10,test_20231031_152557,11551286.png,271883,1039,270844,0.9961785032532376,2,6,40092,152,39940,0.9962087199441285,15.859841777777778,1507.39176,16.348542239511865,126,1.0E-4
1,test_20231031_152558,10404007.png,502730,20834,481896,0.9585582718357767,3,5,61265,3016,58249,0.9507712396964009,25.686528,3429.773024,12.778149806752824,126,2.0E-4
2,test_20231031_152558,1254659.png,342646,73249,269397,0.7862254338296668,5,7,80080,10244,69836,0.8720779220779221,20.98264711111111,3208.4044853333335,13.067912460579436,126,2.0E-4
3,test_20231031_152558,10188041.png,221231,9692,211539,0.9561905881183017,3,5,41731,1366,40365,0.9672665404615274,10.568042666666667,1021.7253333333333,18.037461991689202,126,2.0E-4
4,test_20231031_152558,10287332.png,216980,12364,204616,0.943017789658033,3,6,22337,1696,20641,0.9240721672561221,9.497095111111111,790.9076053333333,19.149546091497648,126,2.0E-4
5,test_20231031_152558,11610969.png,368720,25357,343363,0.9312296593621177,3,6,84111,3701,80410,0.9559986208700408,21.3076,2937.504816,13.451017735675183,126,2.0E-4
6,test_20231031_152558,10350842.png,212614,6082,206532,0.9713941697160112,2,6,42529,891,41638,0.9790495896917397,19.26112,2371.9918826666667,14.379671623979055,126,2.0E-4
7,test_20231031_152558,10863862.png,317432,11479,305953,0.9638379243428514,3,6,66058,1667,64391,0.9747646008053529,24.188906666666668,3362.179488,12.864594665868092,126,2.0E-4
8,test_20231031_152558,11382381.png,312486,867,311619,0.9972254757013114,2,5,46745,116,46629,0.9975184511712483,21.130496,2414.0920426666667,14.303265363409706,126,2.0E-4
9,test_20231031_152558,11079715.png,443815,118057,325758,0.733995020447709,6,6,124136,16497,107639,0.8671054327511761,17.022149333333335,2131.304528,14.84434853255526,126,2.0E-4
10,test_20231031_152558,11551286.png,271883,737,271146,0.9972892751661561,2,6,40092,107,39985,0.997331138381722,17.57074488888889,1811.3484693333332,15.5507835243661,126,2.0E-4
1,test_20231031_152559,10404007.png,502730,20754,481976,0.9587174029797306,3,5,61265,3004,58261,0.9509671100954868,25.695610666666667,3431.257168,12.776270918184878,126,3.0000000000000003E-4
2,test_20231031_152559,1254659.png,342646,73189,269457,0.7864005416669099,4,6,80080,10238,69842,0.8721528471528471,20.99220088888889,3209.486672,13.066447843337867,126,3.0000000000000003E-4
3,test_20231031_152559,10188041.png,221231,9592,211639,0.9566426043366436,4,6,41731,1351,40380,0.9676259854784213,10.691395555555555,1037.4407253333334,17.971170683956313,126,3.0000000000000003E-4
4,test_20231031_152559,10287332.png,216980,12364,204616,0.943017789658033,3,6,22337,1696,20641,0.9240721672561221,9.497095111111111,790.9076053333333,19.149546091497648,126,3.0000000000000003E-4
5,test_20231031_152559,11610969.png,368720,25037,343683,0.9320975265784335,4,6,84111,3655,80456,0.9565455172331799,21.725516444444445,3023.573904,13.3255977251099,126,3.0000000000000003E-4
6,test_20231031_152559,10350842.png,212614,6002,206612,0.971770438447139,3,6,42529,879,41650,0.9793317500999318,19.329912888888888,2377.7495893333335,14.369142455293513,126,3.0000000000000003E-4
7,test_20231031_152559,10863862.png,317432,11359,306073,0.9642159580634593,3,6,66058,1649,64409,0.9750370886190923,24.240064,3365.490752,12.860319593671788,126,3.0000000000000003E-4
8,test_20231031_152559,11382381.png,312486,747,311739,0.9976094929052821,2,5,46745,98,46647,0.9979035190929512,21.62502222222222,2484.034352,14.179227634129312,126,3.0000000000000003E-4
9,test_20231031_152559,11079715.png,443815,118057,325758,0.733995020447709,5,6,124136,16497,107639,0.8671054327511761,17.022149333333335,2131.304528,14.84434853255526,126,3.0000000000000003E-4
10,test_20231031_152559,11551286.png,271883,427,271456,0.9984294715006087,2,6,40092,61,40031,0.9984784994512621,17.85376888888889,1855.7630026666666,15.445578486866474,126,3.0000000000000003E-4
1,test_20231031_152600,10404007.png,502730,20472,482258,0.9592783402621685,3,5,61265,2964,58301,0.9516200114257732,25.783781333333334,3450.961552,12.75140240129671,126,4.0E-4
2,test_20231031_152600,1254659.png,342646,73189,269457,0.7864005416669099,4,6,80080,10238,69842,0.8721528471528471,20.99220088888889,3209.486672,13.066447843337867,126,4.0E-4
3,test_20231031_152600,10188041.png,221231,9592,211639,0.9566426043366436,3,6,41731,1351,40380,0.9676259854784213,10.691395555555555,1037.4407253333334,17.971170683956313,126,4.0E-4
4,test_20231031_152600,10287332.png,216980,12364,204616,0.943017789658033,2,6,22337,1696,20641,0.9240721672561221,9.497095111111111,790.9076053333333,19.149546091497648,126,4.0E-4
5,test_20231031_152600,11610969.png,368720,25037,343683,0.9320975265784335,4,6,84111,3655,80456,0.9565455172331799,21.725516444444445,3023.573904,13.3255977251099,126,4.0E-4
6,test_20231031_152600,10350842.png,212614,6002,206612,0.971770438447139,2,5,42529,879,41650,0.9793317500999318,19.329912888888888,2377.7495893333335,14.369142455293513,126,4.0E-4
7,test_20231031_152600,10863862.png,317432,11359,306073,0.9642159580634593,3,5,66058,1649,64409,0.9750370886190923,24.240064,3365.490752,12.860319593671788,126,4.0E-4
8,test_20231031_152600,11382381.png,312486,747,311739,0.9976094929052821,2,5,46745,98,46647,0.9979035190929512,21.62502222222222,2484.034352,14.179227634129312,126,4.0E-4
9,test_20231031_152600,11079715.png,443815,118057,325758,0.733995020447709,5,7,124136,16497,107639,0.8671054327511761,17.022149333333335,2131.304528,14.84434853255526,126,4.0E-4
10,test_20231031_152600,11551286.png,271883,427,271456,0.9984294715006087,2,6,40092,61,40031,0.9984784994512621,17.85376888888889,1855.7630026666666,15.445578486866474,126,4.0E-4
1,test_20231031_152601,10404007.png,502730,20472,482258,0.9592783402621685,4,6,61265,2964,58301,0.9516200114257732,25.783781333333334,3450.961552,12.75140240129671,126,5.0E-4
2,test_20231031_152601,1254659.png,342646,73189,269457,0.7864005416669099,5,6,80080,10238,69842,0.8721528471528471,20.99220088888889,3209.486672,13.066447843337867,126,5.0E-4
3,test_20231031_152601,10188041.png,221231,9592,211639,0.9566426043366436,3,5,41731,1351,40380,0.9676259854784213,10.691395555555555,1037.4407253333334,17.971170683956313,126,5.0E-4
4,test_20231031_152601,10287332.png,216980,12364,204616,0.943017789658033,3,6,22337,1696,20641,0.9240721672561221,9.497095111111111,790.9076053333333,19.149546091497648,126,5.0E-4
5,test_20231031_152601,11610969.png,368720,25037,343683,0.9320975265784335,4,6,84111,3655,80456,0.9565455172331799,21.725516444444445,3023.573904,13.3255977251099,126,5.0E-4
6,test_20231031_152601,10350842.png,212614,6002,206612,0.971770438447139,3,6,42529,879,41650,0.9793317500999318,19.329912888888888,2377.7495893333335,14.369142455293513,126,5.0E-4
7,test_20231031_152601,10863862.png,317432,10292,307140,0.9675773078958643,3,5,66058,1495,64563,0.9773683732477519,26.677214222222222,4038.738533333333,12.068346228764726,126,5.0E-4
8,test_20231031_152601,11382381.png,312486,747,311739,0.9976094929052821,2,6,46745,98,46647,0.9979035190929512,21.62502222222222,2484.034352,14.179227634129312,126,5.0E-4
9,test_20231031_152601,11079715.png,443815,118057,325758,0.733995020447709,6,7,124136,16497,107639,0.8671054327511761,17.022149333333335,2131.304528,14.84434853255526,126,5.0E-4
10,test_20231031_152601,11551286.png,271883,427,271456,0.9984294715006087,2,6,40092,61,40031,0.9984784994512621,17.85376888888889,1855.7630026666666,15.445578486866474,126,5.0E-4
1,test_20231031_152602,10404007.png,502730,20152,482578,0.9599148648379846,4,6,61265,2920,58345,0.9523382028890884,25.83563022222222,3461.3983253333336,12.738287816430331,126,6.000000000000001E-4
2,test_20231031_152602,1254659.png,342646,73189,269457,0.7864005416669099,5,6,80080,10238,69842,0.8721528471528471,20.99220088888889,3209.486672,13.066447843337867,126,6.000000000000001E-4
3,test_20231031_152602,10188041.png,221231,9489,211742,0.9571081810415357,4,5,41731,1338,40393,0.9679375044930627,11.075875555555555,1087.4010666666666,17.766906061885894,126,6.000000000000001E-4
4,test_20231031_152602,10287332.png,216980,12364,204616,0.943017789658033,3,6,22337,1696,20641,0.9240721672561221,9.497095111111111,790.9076053333333,19.149546091497648,126,6.000000000000001E-4
5,test_20231031_152602,11610969.png,368720,25037,343683,0.9320975265784335,3,6,84111,3655,80456,0.9565455172331799,21.725516444444445,3023.573904,13.3255977251099,126,6.000000000000001E-4
6,test_20231031_152602,10350842.png,212614,6002,206612,0.971770438447139,3,5,42529,879,41650,0.9793317500999318,19.329912888888888,2377.7495893333335,14.369142455293513,126,6.000000000000001E-4
7,test_20231031_152602,10863862.png,317432,10292,307140,0.9675773078958643,4,6,66058,1495,64563,0.9773683732477519,26.677214222222222,4038.738533333333,12.068346228764726,126,6.000000000000001E-4
8,test_20231031_152602,11382381.png,312486,747,311739,0.9976094929052821,3,6,46745,98,46647,0.9979035190929512,21.62502222222222,2484.034352,14.179227634129312,126,6.000000000000001E-4
9,test_20231031_152602,11079715.png,443815,118057,325758,0.733995020447709,5,7,124136,16497,107639,0.8671054327511761,17.022149333333335,2131.304528,14.84434853255526,126,6.000000000000001E-4
10,test_20231031_152602,11551286.png,271883,367,271516,0.9986501546621157,2,5,40092,52,40040,0.9987029831387808,18.002010666666667,1874.0560373333333,15.402977880083654,126,6.000000000000001E-4
1,test_20231031_152604,10404007.png,502730,20152,482578,0.9599148648379846,3,6,61265,2920,58345,0.9523382028890884,25.83563022222222,3461.3983253333336,12.738287816430331,126,7.000000000000001E-4
2,test_20231031_152604,1254659.png,342646,73189,269457,0.7864005416669099,5,6,80080,10238,69842,0.8721528471528471,20.99220088888889,3209.486672,13.066447843337867,126,7.000000000000001E-4
3,test_20231031_152604,10188041.png,221231,9489,211742,0.9571081810415357,3,7,41731,1338,40393,0.9679375044930627,11.075875555555555,1087.4010666666666,17.766906061885894,126,7.000000000000001E-4
4,test_20231031_152604,10287332.png,216980,12364,204616,0.943017789658033,3,6,22337,1696,20641,0.9240721672561221,9.497095111111111,790.9076053333333,19.149546091497648,126,7.000000000000001E-4
5,test_20231031_152604,11610969.png,368720,25037,343683,0.9320975265784335,3,9,84111,3655,80456,0.9565455172331799,21.725516444444445,3023.573904,13.3255977251099,126,7.000000000000001E-4
6,test_20231031_152604,10350842.png,212614,6002,206612,0.971770438447139,2,6,42529,879,41650,0.9793317500999318,19.329912888888888,2377.7495893333335,14.369142455293513,126,7.000000000000001E-4
7,test_20231031_152604,10863862.png,317432,10292,307140,0.9675773078958643,3,5,66058,1495,64563,0.9773683732477519,26.677214222222222,4038.738533333333,12.068346228764726,126,7.000000000000001E-4
8,test_20231031_152604,11382381.png,312486,747,311739,0.9976094929052821,2,5,46745,98,46647,0.9979035190929512,21.62502222222222,2484.034352,14.179227634129312,126,7.000000000000001E-4
9,test_20231031_152604,11079715.png,443815,118057,325758,0.733995020447709,5,8,124136,16497,107639,0.8671054327511761,17.022149333333335,2131.304528,14.84434853255526,126,7.000000000000001E-4
10,test_20231031_152604,11551286.png,271883,367,271516,0.9986501546621157,3,6,40092,52,40040,0.9987029831387808,18.002010666666667,1874.0560373333333,15.402977880083654,126,7.000000000000001E-4
1,test_20231031_152605,10404007.png,502730,20012,482718,0.9601933443399041,4,6,61265,2900,58365,0.9526646535542316,25.84072888888889,3462.5373013333333,12.736859001886254,126,8.000000000000001E-4
2,test_20231031_152605,1254659.png,342646,73189,269457,0.7864005416669099,4,6,80080,10238,69842,0.8721528471528471,20.99220088888889,3209.486672,13.066447843337867,126,8.000000000000001E-4
3,test_20231031_152605,10188041.png,221231,9369,211862,0.9576506005035461,3,6,41731,1320,40411,0.9683688385133354,11.170734222222222,1111.271936,17.672600140304922,126,8.000000000000001E-4
4,test_20231031_152605,10287332.png,216980,12364,204616,0.943017789658033,3,7,22337,1696,20641,0.9240721672561221,9.497095111111111,790.9076053333333,19.149546091497648,126,8.000000000000001E-4
5,test_20231031_152605,11610969.png,368720,24997,343723,0.932206009980473,7,7,84111,3653,80458,0.9565692953359252,22.103546666666666,3086.686544,13.235878321707402,126,8.000000000000001E-4
6,test_20231031_152605,10350842.png,212614,6002,206612,0.971770438447139,2,5,42529,879,41650,0.9793317500999318,19.329912888888888,2377.7495893333335,14.369142455293513,126,8.000000000000001E-4
7,test_20231031_152605,10863862.png,317432,10292,307140,0.9675773078958643,3,6,66058,1495,64563,0.9773683732477519,26.677214222222222,4038.738533333333,12.068346228764726,126,8.000000000000001E-4
8,test_20231031_152605,11382381.png,312486,747,311739,0.9976094929052821,3,5,46745,98,46647,0.9979035190929512,21.62502222222222,2484.034352,14.179227634129312,126,8.000000000000001E-4
9,test_20231031_152605,11079715.png,443815,118057,325758,0.733995020447709,5,8,124136,16497,107639,0.8671054327511761,17.022149333333335,2131.304528,14.84434853255526,126,8.000000000000001E-4
10,test_20231031_152605,11551286.png,271883,367,271516,0.9986501546621157,2,6,40092,52,40040,0.9987029831387808,18.002010666666667,1874.0560373333333,15.402977880083654,126,8.000000000000001E-4
1,test_20231031_152606,10404007.png,502730,20012,482718,0.9601933443399041,4,6,61265,2900,58365,0.9526646535542316,25.84072888888889,3462.5373013333333,12.736859001886254,126,9.000000000000002E-4
2,test_20231031_152606,1254659.png,342646,73189,269457,0.7864005416669099,4,7,80080,10238,69842,0.8721528471528471,20.99220088888889,3209.486672,13.066447843337867,126,9.000000000000002E-4
3,test_20231031_152606,10188041.png,221231,9269,211962,0.958102616721888,3,6,41731,1309,40422,0.9686324315257243,11.218222222222222,1116.4789653333332,17.65229815570365,126,9.000000000000002E-4
4,test_20231031_152606,10287332.png,216980,12364,204616,0.943017789658033,2,11,22337,1696,20641,0.9240721672561221,9.497095111111111,790.9076053333333,19.149546091497648,126,9.000000000000002E-4
5,test_20231031_152606,11610969.png,368720,24997,343723,0.932206009980473,3,5,84111,3653,80458,0.9565692953359252,22.103546666666666,3086.686544,13.235878321707402,126,9.000000000000002E-4
6,test_20231031_152606,10350842.png,212614,4294,208320,0.9798037758567169,3,5,42529,628,41901,0.9852336053046157,23.505242666666668,3390.545104,12.828108347509533,126,9.000000000000002E-4
7,test_20231031_152606,10863862.png,317432,10292,307140,0.9675773078958643,3,5,66058,1495,64563,0.9773683732477519,26.677214222222222,4038.738533333333,12.068346228764726,126,9.000000000000002E-4
8,test_20231031_152606,11382381.png,312486,747,311739,0.9976094929052821,3,5,46745,98,46647,0.9979035190929512,21.62502222222222,2484.034352,14.179227634129312,126,9.000000000000002E-4
9,test_20231031_152606,11079715.png,443815,118057,325758,0.733995020447709,5,7,124136,16497,107639,0.8671054327511761,17.022149333333335,2131.304528,14.84434853255526,126,9.000000000000002E-4
10,test_20231031_152606,11551286.png,271883,367,271516,0.9986501546621157,2,6,40092,52,40040,0.9987029831387808,18.002010666666667,1874.0560373333333,15.402977880083654,126,9.000000000000002E-4
1,test_20231031_152607,10404007.png,502730,19387,483343,0.9614365564020448,4,6,61265,2816,58449,0.9540357463478332,26.041116444444445,3512.823402666667,12.674240434627826,126,0.0010000000000000002
2,test_20231031_152607,1254659.png,342646,73027,269619,0.7868733328274662,5,7,80080,10224,69856,0.8723276723276723,21.061925333333335,3224.1671306666667,13.046628146936053,126,0.0010000000000000002
3,test_20231031_152607,10188041.png,221231,9067,212164,0.9590156894829387,3,6,41731,1289,40442,0.9691116915482495,11.302140444444445,1131.4059626666667,17.594618976652107,126,0.0010000000000000002
4,test_20231031_152607,10287332.png,216980,12262,204718,0.9434878790671951,2,5,22337,1681,20656,0.92474369879572,9.548682666666666,799.498464,19.10262727153343,126,0.0010000000000000002
5,test_20231031_152607,11610969.png,368720,24714,344006,0.9329735300499024,4,6,84111,3616,80495,0.957009190236711,22.159283555555554,3094.5564426666665,13.224819525221838,126,0.0010000000000000002
6,test_20231031_152607,10350842.png,212614,4174,208440,0.9803681789534086,2,5,42529,610,41919,0.9856568459169037,23.65995911111111,3419.203984,12.791553500148652,126,0.0010000000000000002
7,test_20231031_152607,10863862.png,317432,10072,307360,0.9682703697169788,3,5,66058,1463,64595,0.9778527960277332,26.819024,4073.011450666667,12.031647298257727,126,0.0010000000000000002
8,test_20231031_152607,11382381.png,312486,547,311939,0.9982495215785667,2,6,46745,73,46672,0.9984383356508717,22.032236444444443,2581.941392,14.011339809622479,126,0.0010000000000000002
9,test_20231031_152607,11079715.png,443815,117997,325818,0.7341302119126212,6,7,124136,16492,107644,0.8671457111555069,17.046920888888888,2135.3233546666665,14.836167107742856,126,0.0010000000000000002
10,test_20231031_152607,11551286.png,271883,367,271516,0.9986501546621157,2,5,40092,52,40040,0.9987029831387808,18.002010666666667,1874.0560373333333,15.402977880083654,126,0.0010000000000000002
1,test_20231031_152608,10404007.png,502730,19327,483403,0.9615559047600103,3,5,61265,2809,58456,0.9541500040806333,26.043936,3513.8668053333336,12.672950655199806,126,0.0011000000000000003
2,test_20231031_152608,1254659.png,342646,73027,269619,0.7868733328274662,4,7,80080,10224,69856,0.8723276723276723,21.061925333333335,3224.1671306666667,13.046628146936053,126,0.0011000000000000003
3,test_20231031_152608,10188041.png,221231,9067,212164,0.9590156894829387,3,6,41731,1289,40442,0.9691116915482495,11.302140444444445,1131.4059626666667,17.594618976652107,126,0.0011000000000000003
4,test_20231031_152608,10287332.png,216980,12102,204878,0.944225274218822,2,5,22337,1659,20678,0.9257286117204638,9.616704,810.548896,19.043011422725556,126,0.0011000000000000003
5,test_20231031_152608,11610969.png,368720,24452,344268,0.933684096333261,4,6,84111,3577,80534,0.9574728632402421,22.638163555555554,3204.623322666667,13.073033717872452,126,0.0011000000000000003
6,test_20231031_152608,10350842.png,212614,4154,208460,0.9804622461361905,2,6,42529,607,41922,0.9857273860189518,24.12269688888889,3500.394096,12.689634182082042,126,0.0011000000000000003
7,test_20231031_152608,10863862.png,317432,9912,307520,0.9687744146777892,3,5,66058,1444,64614,0.9781404220533471,27.060481777777778,4143.697968,11.956922684770968,126,0.0011000000000000003
8,test_20231031_152608,11382381.png,312486,547,311939,0.9982495215785667,3,6,46745,73,46672,0.9984383356508717,22.032236444444443,2581.941392,14.011339809622479,126,0.0011000000000000003
9,test_20231031_152608,11079715.png,443815,117384,326431,0.7355114180458073,5,6,124136,16401,107735,0.8678787781143262,17.417189333333333,2212.324837333333,14.682314657651789,126,0.0011000000000000003
10,test_20231031_152608,11551286.png,271883,367,271516,0.9986501546621157,2,6,40092,52,40040,0.9987029831387808,18.002010666666667,1874.0560373333333,15.402977880083654,126,0.0011000000000000003
1,test_20231031_152609,10404007.png,502730,19327,483403,0.9615559047600103,3,5,61265,2809,58456,0.9541500040806333,26.043936,3513.8668053333336,12.672950655199806,126,0.0012000000000000003
2,test_20231031_152609,1254659.png,342646,73027,269619,0.7868733328274662,4,6,80080,10224,69856,0.8723276723276723,21.061925333333335,3224.1671306666667,13.046628146936053,126,0.0012000000000000003
3,test_20231031_152609,10188041.png,221231,9067,212164,0.9590156894829387,3,5,41731,1289,40442,0.9691116915482495,11.302140444444445,1131.4059626666667,17.594618976652107,126,0.0012000000000000003
4,test_20231031_152609,10287332.png,216980,12102,204878,0.944225274218822,3,6,22337,1659,20678,0.9257286117204638,9.616704,810.548896,19.043011422725556,126,0.0012000000000000003
5,test_20231031_152609,11610969.png,368720,24452,344268,0.933684096333261,3,5,84111,3577,80534,0.9574728632402421,22.638163555555554,3204.623322666667,13.073033717872452,126,0.0012000000000000003
6,test_20231031_152609,10350842.png,212614,4154,208460,0.9804622461361905,2,6,42529,607,41922,0.9857273860189518,24.12269688888889,3500.394096,12.689634182082042,126,0.0012000000000000003
7,test_20231031_152609,10863862.png,317432,9912,307520,0.9687744146777892,3,6,66058,1444,64614,0.9781404220533471,27.060481777777778,4143.697968,11.956922684770968,126,0.0012000000000000003
8,test_20231031_152609,11382381.png,312486,547,311939,0.9982495215785667,2,6,46745,73,46672,0.9984383356508717,22.032236444444443,2581.941392,14.011339809622479,126,0.0012000000000000003
9,test_20231031_152609,11079715.png,443815,117384,326431,0.7355114180458073,5,7,124136,16401,107735,0.8678787781143262,17.417189333333333,2212.324837333333,14.682314657651789,126,0.0012000000000000003
10,test_20231031_152609,11551286.png,271883,367,271516,0.9986501546621157,2,5,40092,52,40040,0.9987029831387808,18.002010666666667,1874.0560373333333,15.402977880083654,126,0.0012000000000000003
1,test_20231031_152610,10404007.png,502730,19327,483403,0.9615559047600103,4,6,61265,2809,58456,0.9541500040806333,26.043936,3513.8668053333336,12.672950655199806,126,0.0013000000000000004
2,test_20231031_152610,1254659.png,342646,73027,269619,0.7868733328274662,5,6,80080,10224,69856,0.8723276723276723,21.061925333333335,3224.1671306666667,13.046628146936053,126,0.0013000000000000004
3,test_20231031_152610,10188041.png,221231,8787,212444,0.960281334894296,3,5,41731,1263,40468,0.9697347295775323,11.565941333333333,1181.1889813333332,17.40760973851919,126,0.0013000000000000004
4,test_20231031_152610,10287332.png,216980,12102,204878,0.944225274218822,3,6,22337,1659,20678,0.9257286117204638,9.616704,810.548896,19.043011422725556,126,0.0013000000000000004
5,test_20231031_152610,11610969.png,368720,24432,344288,0.9337383380342807,4,6,84111,3576,80535,0.9574847522916147,22.743813333333332,3214.8014026666665,13.059262117227583,126,0.0013000000000000004
6,test_20231031_152610,10350842.png,212614,4154,208460,0.9804622461361905,2,6,42529,607,41922,0.9857273860189518,24.12269688888889,3500.394096,12.689634182082042,126,0.0013000000000000004
7,test_20231031_152610,10863862.png,317432,9672,307760,0.969530482119005,4,6,66058,1410,64648,0.9786551212570771,27.388528,4222.1582026666665,11.875458587418589,126,0.0013000000000000004
8,test_20231031_152610,11382381.png,312486,547,311939,0.9982495215785667,2,5,46745,73,46672,0.9984383356508717,22.032236444444443,2581.941392,14.011339809622479,126,0.0013000000000000004
9,test_20231031_152610,11079715.png,443815,117384,326431,0.7355114180458073,5,7,124136,16401,107735,0.8678787781143262,17.417189333333333,2212.324837333333,14.682314657651789,126,0.0013000000000000004
10,test_20231031_152610,11551286.png,271883,367,271516,0.9986501546621157,2,6,40092,52,40040,0.9987029831387808,18.002010666666667,1874.0560373333333,15.402977880083654,126,0.0013000000000000004
1,test_20231031_152611,10404007.png,502730,19327,483403,0.9615559047600103,4,7,61265,2809,58456,0.9541500040806333,26.043936,3513.8668053333336,12.672950655199806,126,0.0014000000000000004
2,test_20231031_152611,1254659.png,342646,73027,269619,0.7868733328274662,5,7,80080,10224,69856,0.8723276723276723,21.061925333333335,3224.1671306666667,13.046628146936053,126,0.0014000000000000004
3,test_20231031_152611,10188041.png,221231,8787,212444,0.960281334894296,3,6,41731,1263,40468,0.9697347295775323,11.565941333333333,1181.1889813333332,17.40760973851919,126,0.0014000000000000004
4,test_20231031_152611,10287332.png,216980,12102,204878,0.944225274218822,3,5,22337,1659,20678,0.9257286117204638,9.616704,810.548896,19.043011422725556,126,0.0014000000000000004
5,test_20231031_152611,11610969.png,368720,24432,344288,0.9337383380342807,4,5,84111,3576,80535,0.9574847522916147,22.743813333333332,3214.8014026666665,13.059262117227583,126,0.0014000000000000004
6,test_20231031_152611,10350842.png,212614,4154,208460,0.9804622461361905,2,6,42529,607,41922,0.9857273860189518,24.12269688888889,3500.394096,12.689634182082042,126,0.0014000000000000004
7,test_20231031_152611,10863862.png,317432,9672,307760,0.969530482119005,3,6,66058,1410,64648,0.9786551212570771,27.388528,4222.1582026666665,11.875458587418589,126,0.0014000000000000004
8,test_20231031_152611,11382381.png,312486,547,311939,0.9982495215785667,3,5,46745,73,46672,0.9984383356508717,22.032236444444443,2581.941392,14.011339809622479,126,0.0014000000000000004
9,test_20231031_152611,11079715.png,443815,117384,326431,0.7355114180458073,6,7,124136,16401,107735,0.8678787781143262,17.417189333333333,2212.324837333333,14.682314657651789,126,0.0014000000000000004
10,test_20231031_152611,11551286.png,271883,367,271516,0.9986501546621157,2,16,40092,52,40040,0.9987029831387808,18.002010666666667,1874.0560373333333,15.402977880083654,126,0.0014000000000000004
1,test_20231031_152612,10404007.png,502730,19649,483081,0.9609154019055954,4,6,61265,2845,58420,0.9535623928833755,25.79059377777778,3461.428794666667,12.738249587356849,127,1.0E-4
2,test_20231031_152612,1254659.png,342646,71682,270964,0.7907986668456658,4,6,80080,10037,70043,0.8746628371628371,21.233608888888888,3282.5188533333335,12.968731317042248,127,1.0E-4
3,test_20231031_152612,10188041.png,221231,9489,211742,0.9571081810415357,3,6,41731,1337,40394,0.967961467494189,10.60381511111111,1029.055584,18.006415272400552,127,1.0E-4
4,test_20231031_152612,10287332.png,216980,12312,204668,0.9432574430823117,3,5,22337,1688,20649,0.9244303174105744,9.401898666666666,774.2090986666667,19.242220899357278,127,1.0E-4
5,test_20231031_152612,11610969.png,368720,24512,344208,0.9335213712302017,4,6,84111,3579,80532,0.9574490851374968,21.428912,2970.4620213333333,13.402563567661467,127,1.0E-4
6,test_20231031_152612,10350842.png,212614,5842,206772,0.9725229759093945,3,6,42529,859,41670,0.9798020174469185,19.341116444444445,2392.76384,14.341805239536118,127,1.0E-4
7,test_20231031_152612,10863862.png,317432,11017,306415,0.9652933541671918,3,6,66058,1602,64456,0.9757485845771897,24.437365333333332,3426.7552746666665,12.781972709279499,127,1.0E-4
8,test_20231031_152612,11382381.png,312486,957,311529,0.9969374627983334,2,5,46745,131,46614,0.9971975612364958,21.075297777777777,2410.7878986666665,14.309213580767988,127,1.0E-4
9,test_20231031_152612,11079715.png,443815,115577,328238,0.7395829343307458,5,6,124136,16143,107993,0.8699571437777921,17.25776711111111,2193.2968,14.719829558750817,127,1.0E-4
10,test_20231031_152612,11551286.png,271883,917,270966,0.9966272256816351,2,5,40092,134,39958,0.9966576873191659,15.986103111111111,1528.055536,16.289412222433906,127,1.0E-4
1,test_20231031_152613,10404007.png,502730,19649,483081,0.9609154019055954,4,6,61265,2845,58420,0.9535623928833755,25.79059377777778,3461.428794666667,12.738249587356849,127,2.0E-4
2,test_20231031_152613,1254659.png,342646,71682,270964,0.7907986668456658,4,7,80080,10037,70043,0.8746628371628371,21.233608888888888,3282.5188533333335,12.968731317042248,127,2.0E-4
3,test_20231031_152613,10188041.png,221231,9489,211742,0.9571081810415357,4,6,41731,1337,40394,0.967961467494189,10.60381511111111,1029.055584,18.006415272400552,127,2.0E-4
4,test_20231031_152613,10287332.png,216980,12102,204878,0.944225274218822,3,6,22337,1661,20676,0.9256390741818508,9.531660444444444,800.9398453333333,19.09480461289071,127,2.0E-4
5,test_20231031_152613,11610969.png,368720,24512,344208,0.9335213712302017,4,6,84111,3579,80532,0.9574490851374968,21.428912,2970.4620213333333,13.402563567661467,127,2.0E-4
6,test_20231031_152613,10350842.png,212614,5842,206772,0.9725229759093945,2,5,42529,859,41670,0.9798020174469185,19.341116444444445,2392.76384,14.341805239536118,127,2.0E-4
7,test_20231031_152613,10863862.png,317432,11017,306415,0.9652933541671918,3,6,66058,1602,64456,0.9757485845771897,24.437365333333332,3426.7552746666665,12.781972709279499,127,2.0E-4
8,test_20231031_152613,11382381.png,312486,827,311659,0.9973534814359684,2,5,46745,112,46633,0.9976040218205156,21.333713777777778,2451.331146666667,14.236783774592807,127,2.0E-4
9,test_20231031_152613,11079715.png,443815,115577,328238,0.7395829343307458,5,7,124136,16143,107993,0.8699571437777921,17.25776711111111,2193.2968,14.719829558750817,127,2.0E-4
10,test_20231031_152613,11551286.png,271883,697,271186,0.9974363972738274,2,6,40092,101,39991,0.9974807941734012,17.572291555555555,1811.64304,15.55007731009529,127,2.0E-4
1,test_20231031_152614,10404007.png,502730,19467,483263,0.9612774252580908,4,6,61265,2821,58444,0.9539541336815474,25.804821333333333,3464.2128746666667,12.734757894589483,127,3.0000000000000003E-4
2,test_20231031_152614,1254659.png,342646,71622,271024,0.7909737746829089,5,6,80080,10031,70049,0.8747377622377622,21.243162666666667,3283.60104,12.96729976321864,127,3.0000000000000003E-4
3,test_20231031_152614,10188041.png,221231,9449,211782,0.9572889875288726,3,6,41731,1331,40400,0.9681052455009466,10.71383111111111,1042.626304,17.949516834977533,127,3.0000000000000003E-4
4,test_20231031_152614,10287332.png,216980,12102,204878,0.944225274218822,2,5,22337,1661,20676,0.9256390741818508,9.531660444444444,800.9398453333333,19.09480461289071,127,3.0000000000000003E-4
5,test_20231031_152614,11610969.png,368720,24192,344528,0.9343892384465177,3,5,84111,3533,80578,0.957995981500636,21.846828444444444,3056.5311093333335,13.278515404761055,127,3.0000000000000003E-4
6,test_20231031_152614,10350842.png,212614,5762,206852,0.9728992446405222,3,6,42529,847,41682,0.9800841778551106,19.409909333333335,2398.521546666667,14.33136736645771,127,3.0000000000000003E-4
7,test_20231031_152614,10863862.png,317432,10897,306535,0.9656713878877996,3,5,66058,1584,64474,0.9760210723909292,24.488522666666668,3430.0665386666665,12.77777816015962,127,3.0000000000000003E-4
8,test_20231031_152614,11382381.png,312486,707,311779,0.9977374986399391,2,5,46745,94,46651,0.9979890897422184,21.82824,2521.273456,14.11460409284577,127,3.0000000000000003E-4
9,test_20231031_152614,11079715.png,443815,115577,328238,0.7395829343307458,6,7,124136,16143,107993,0.8699571437777921,17.25776711111111,2193.2968,14.719829558750817,127,3.0000000000000003E-4
10,test_20231031_152614,11551286.png,271883,407,271476,0.9985030325544444,2,5,40092,58,40034,0.9985533273471017,17.855009777777777,1855.9584906666666,15.44512102064812,127,3.0000000000000003E-4
1,test_20231031_152615,10404007.png,502730,19187,483543,0.9618343842619299,3,6,61265,2780,58485,0.954623357545091,25.892992,3483.917258666667,12.710125286916409,127,4.0E-4
2,test_20231031_152615,1254659.png,342646,71622,271024,0.7909737746829089,4,6,80080,10031,70049,0.8747377622377622,21.243162666666667,3283.60104,12.96729976321864,127,4.0E-4
3,test_20231031_152615,10188041.png,221231,9449,211782,0.9572889875288726,3,6,41731,1331,40400,0.9681052455009466,10.71383111111111,1042.626304,17.949516834977533,127,4.0E-4
4,test_20231031_152615,10287332.png,216980,12102,204878,0.944225274218822,3,6,22337,1661,20676,0.9256390741818508,9.531660444444444,800.9398453333333,19.09480461289071,127,4.0E-4
5,test_20231031_152615,11610969.png,368720,24192,344528,0.9343892384465177,4,6,84111,3533,80578,0.957995981500636,21.846828444444444,3056.5311093333335,13.278515404761055,127,4.0E-4
6,test_20231031_152615,10350842.png,212614,5762,206852,0.9728992446405222,3,6,42529,847,41682,0.9800841778551106,19.409909333333335,2398.521546666667,14.33136736645771,127,4.0E-4
7,test_20231031_152615,10863862.png,317432,9872,307560,0.9689004259179919,3,5,66058,1435,64623,0.9782766659602168,26.91376177777778,4100.150074666667,12.002806077074947,127,4.0E-4
8,test_20231031_152615,11382381.png,312486,707,311779,0.9977374986399391,2,5,46745,94,46651,0.9979890897422184,21.82824,2521.273456,14.11460409284577,127,4.0E-4
9,test_20231031_152615,11079715.png,443815,115577,328238,0.7395829343307458,5,7,124136,16143,107993,0.8699571437777921,17.25776711111111,2193.2968,14.719829558750817,127,4.0E-4
10,test_20231031_152615,11551286.png,271883,407,271476,0.9985030325544444,2,5,40092,58,40034,0.9985533273471017,17.855009777777777,1855.9584906666666,15.44512102064812,127,4.0E-4
1,test_20231031_152616,10404007.png,502730,19187,483543,0.9618343842619299,3,5,61265,2780,58485,0.954623357545091,25.892992,3483.917258666667,12.710125286916409,127,5.0E-4
2,test_20231031_152616,1254659.png,342646,71622,271024,0.7909737746829089,5,6,80080,10031,70049,0.8747377622377622,21.243162666666667,3283.60104,12.96729976321864,127,5.0E-4
3,test_20231031_152616,10188041.png,221231,9449,211782,0.9572889875288726,3,5,41731,1331,40400,0.9681052455009466,10.71383111111111,1042.626304,17.949516834977533,127,5.0E-4
4,test_20231031_152616,10287332.png,216980,12102,204878,0.944225274218822,3,7,22337,1661,20676,0.9256390741818508,9.531660444444444,800.9398453333333,19.09480461289071,127,5.0E-4
5,test_20231031_152616,11610969.png,368720,24192,344528,0.9343892384465177,3,6,84111,3533,80578,0.957995981500636,21.846828444444444,3056.5311093333335,13.278515404761055,127,5.0E-4
6,test_20231031_152616,10350842.png,212614,5762,206852,0.9728992446405222,3,5,42529,847,41682,0.9800841778551106,19.409909333333335,2398.521546666667,14.33136736645771,127,5.0E-4
7,test_20231031_152616,10863862.png,317432,9872,307560,0.9689004259179919,3,5,66058,1435,64623,0.9782766659602168,26.91376177777778,4100.150074666667,12.002806077074947,127,5.0E-4
8,test_20231031_152616,11382381.png,312486,707,311779,0.9977374986399391,3,5,46745,94,46651,0.9979890897422184,21.82824,2521.273456,14.11460409284577,127,5.0E-4
9,test_20231031_152616,11079715.png,443815,115577,328238,0.7395829343307458,5,7,124136,16143,107993,0.8699571437777921,17.25776711111111,2193.2968,14.719829558750817,127,5.0E-4
10,test_20231031_152616,11551286.png,271883,407,271476,0.9985030325544444,2,5,40092,58,40034,0.9985533273471017,17.855009777777777,1855.9584906666666,15.44512102064812,127,5.0E-4
1,test_20231031_152617,10404007.png,502730,18927,483803,0.9623515604797804,3,6,61265,2745,58520,0.9551946462090917,25.943144888888888,3493.450917333333,12.698257150325322,127,6.000000000000001E-4
2,test_20231031_152617,1254659.png,342646,71622,271024,0.7909737746829089,4,6,80080,10031,70049,0.8747377622377622,21.243162666666667,3283.60104,12.96729976321864,127,6.000000000000001E-4
3,test_20231031_152617,10188041.png,221231,9369,211862,0.9576506005035461,3,6,41731,1321,40410,0.9683448755122092,11.097500444444444,1092.3682453333333,17.7471129396718,127,6.000000000000001E-4
4,test_20231031_152617,10287332.png,216980,12102,204878,0.944225274218822,3,6,22337,1661,20676,0.9256390741818508,9.531660444444444,800.9398453333333,19.09480461289071,127,6.000000000000001E-4
5,test_20231031_152617,11610969.png,368720,23932,344788,0.9350943805597743,4,6,84111,3494,80617,0.9584596545041671,22.325708444444444,3166.5979893333333,13.124874291967245,127,6.000000000000001E-4
6,test_20231031_152617,10350842.png,212614,5762,206852,0.9728992446405222,3,6,42529,847,41682,0.9800841778551106,19.409909333333335,2398.521546666667,14.33136736645771,127,6.000000000000001E-4
7,test_20231031_152617,10863862.png,317432,9872,307560,0.9689004259179919,3,6,66058,1435,64623,0.9782766659602168,26.91376177777778,4100.150074666667,12.002806077074947,127,6.000000000000001E-4
8,test_20231031_152617,11382381.png,312486,707,311779,0.9977374986399391,2,8,46745,94,46651,0.9979890897422184,21.82824,2521.273456,14.11460409284577,127,6.000000000000001E-4
9,test_20231031_152617,11079715.png,443815,115577,328238,0.7395829343307458,5,6,124136,16143,107993,0.8699571437777921,17.25776711111111,2193.2968,14.719829558750817,127,6.000000000000001E-4
10,test_20231031_152617,11551286.png,271883,347,271536,0.9987237157159513,2,6,40092,49,40043,0.9987778110346204,18.003251555555554,1874.2515253333333,15.402524879051395,127,6.000000000000001E-4
1,test_20231031_152618,10404007.png,502730,18927,483803,0.9623515604797804,4,6,61265,2745,58520,0.9551946462090917,25.943144888888888,3493.450917333333,12.698257150325322,127,7.000000000000001E-4
2,test_20231031_152618,1254659.png,342646,71622,271024,0.7909737746829089,5,7,80080,10031,70049,0.8747377622377622,21.243162666666667,3283.60104,12.96729976321864,127,7.000000000000001E-4
3,test_20231031_152618,10188041.png,221231,9369,211862,0.9576506005035461,3,6,41731,1321,40410,0.9683448755122092,11.097500444444444,1092.3682453333333,17.7471129396718,127,7.000000000000001E-4
4,test_20231031_152618,10287332.png,216980,12102,204878,0.944225274218822,3,6,22337,1661,20676,0.9256390741818508,9.531660444444444,800.9398453333333,19.09480461289071,127,7.000000000000001E-4
5,test_20231031_152618,11610969.png,368720,23932,344788,0.9350943805597743,3,6,84111,3494,80617,0.9584596545041671,22.325708444444444,3166.5979893333333,13.124874291967245,127,7.000000000000001E-4
6,test_20231031_152618,10350842.png,212614,5762,206852,0.9728992446405222,3,9,42529,847,41682,0.9800841778551106,19.409909333333335,2398.521546666667,14.33136736645771,127,7.000000000000001E-4
7,test_20231031_152618,10863862.png,317432,9872,307560,0.9689004259179919,3,6,66058,1435,64623,0.9782766659602168,26.91376177777778,4100.150074666667,12.002806077074947,127,7.000000000000001E-4
8,test_20231031_152618,11382381.png,312486,707,311779,0.9977374986399391,3,6,46745,94,46651,0.9979890897422184,21.82824,2521.273456,14.11460409284577,127,7.000000000000001E-4
9,test_20231031_152618,11079715.png,443815,115577,328238,0.7395829343307458,5,6,124136,16143,107993,0.8699571437777921,17.25776711111111,2193.2968,14.719829558750817,127,7.000000000000001E-4
10,test_20231031_152618,11551286.png,271883,347,271536,0.9987237157159513,2,6,40092,49,40043,0.9987778110346204,18.003251555555554,1874.2515253333333,15.402524879051395,127,7.000000000000001E-4
1,test_20231031_152619,10404007.png,502730,18787,483943,0.9626300399816999,3,5,61265,2725,58540,0.9555210968742349,25.948243555555557,3494.5898933333333,12.69684144309177,127,8.000000000000001E-4
2,test_20231031_152619,1254659.png,342646,71622,271024,0.7909737746829089,4,6,80080,10031,70049,0.8747377622377622,21.243162666666667,3283.60104,12.96729976321864,127,8.000000000000001E-4
3,test_20231031_152619,10188041.png,221231,9147,212084,0.9586540765082652,4,5,41731,1291,40440,0.9690637655459969,11.23984711111111,1121.446144,17.633019388786877,127,8.000000000000001E-4
4,test_20231031_152619,10287332.png,216980,12102,204878,0.944225274218822,3,6,22337,1661,20676,0.9256390741818508,9.531660444444444,800.9398453333333,19.09480461289071,127,8.000000000000001E-4
5,test_20231031_152619,11610969.png,368720,23889,344831,0.9352110002169668,4,7,84111,3492,80619,0.9584834326069123,22.703738666666666,3229.710629333333,13.039167480456243,127,8.000000000000001E-4
6,test_20231031_152619,10350842.png,212614,5762,206852,0.9728992446405222,2,5,42529,847,41682,0.9800841778551106,19.409909333333335,2398.521546666667,14.33136736645771,127,8.000000000000001E-4
7,test_20231031_152619,10863862.png,317432,9872,307560,0.9689004259179919,3,5,66058,1435,64623,0.9782766659602168,26.91376177777778,4100.150074666667,12.002806077074947,127,8.000000000000001E-4
8,test_20231031_152619,11382381.png,312486,707,311779,0.9977374986399391,2,6,46745,94,46651,0.9979890897422184,21.82824,2521.273456,14.11460409284577,127,8.000000000000001E-4
9,test_20231031_152619,11079715.png,443815,115577,328238,0.7395829343307458,5,7,124136,16143,107993,0.8699571437777921,17.25776711111111,2193.2968,14.719829558750817,127,8.000000000000001E-4
10,test_20231031_152619,11551286.png,271883,347,271536,0.9987237157159513,2,6,40092,49,40043,0.9987778110346204,18.003251555555554,1874.2515253333333,15.402524879051395,127,8.000000000000001E-4
1,test_20231031_152620,10404007.png,502730,18787,483943,0.9626300399816999,4,6,61265,2725,58540,0.9555210968742349,25.948243555555557,3494.5898933333333,12.69684144309177,127,9.000000000000002E-4
2,test_20231031_152620,1254659.png,342646,71622,271024,0.7909737746829089,5,6,80080,10031,70049,0.8747377622377622,21.243162666666667,3283.60104,12.96729976321864,127,9.000000000000002E-4
3,test_20231031_152620,10188041.png,221231,9147,212084,0.9586540765082652,3,6,41731,1291,40440,0.9690637655459969,11.23984711111111,1121.446144,17.633019388786877,127,9.000000000000002E-4
4,test_20231031_152620,10287332.png,216980,12102,204878,0.944225274218822,3,5,22337,1661,20676,0.9256390741818508,9.531660444444444,800.9398453333333,19.09480461289071,127,9.000000000000002E-4
5,test_20231031_152620,11610969.png,368720,23889,344831,0.9352110002169668,3,5,84111,3492,80619,0.9584834326069123,22.703738666666666,3229.710629333333,13.039167480456243,127,9.000000000000002E-4
6,test_20231031_152620,10350842.png,212614,4112,208502,0.9806597872200326,2,5,42529,603,41926,0.9858214394883491,23.584798222222222,3411.2040586666667,12.801726611315217,127,9.000000000000002E-4
7,test_20231031_152620,10863862.png,317432,9872,307560,0.9689004259179919,3,5,66058,1435,64623,0.9782766659602168,26.91376177777778,4100.150074666667,12.002806077074947,127,9.000000000000002E-4
8,test_20231031_152620,11382381.png,312486,707,311779,0.9977374986399391,2,5,46745,94,46651,0.9979890897422184,21.82824,2521.273456,14.11460409284577,127,9.000000000000002E-4
9,test_20231031_152620,11079715.png,443815,115577,328238,0.7395829343307458,6,7,124136,16143,107993,0.8699571437777921,17.25776711111111,2193.2968,14.719829558750817,127,9.000000000000002E-4
10,test_20231031_152620,11551286.png,271883,347,271536,0.9987237157159513,2,5,40092,49,40043,0.9987778110346204,18.003251555555554,1874.2515253333333,15.402524879051395,127,9.000000000000002E-4
1,test_20231031_152621,10404007.png,502730,18362,484368,0.9634754241839556,3,5,61265,2667,58598,0.9564678038031502,26.119692444444443,3536.8504693333334,12.644636617306142,127,0.0010000000000000002
2,test_20231031_152621,1254659.png,342646,71462,271184,0.7914407289155572,4,6,80080,10017,70063,0.8749125874125874,21.31288711111111,3298.2814986666667,12.947926422154241,127,0.0010000000000000002
3,test_20231031_152621,10188041.png,221231,8967,212264,0.9594677057012806,3,5,41731,1274,40457,0.9694711365651434,11.320529777777777,1135.8477973333333,17.57760220696072,127,0.0010000000000000002
4,test_20231031_152621,10287332.png,216980,12002,204978,0.9446861461885888,3,6,22337,1646,20691,0.9263106057214487,9.583248,809.530704,19.048470354809375,127,0.0010000000000000002
5,test_20231031_152621,11610969.png,368720,23627,345093,0.9359215665003254,4,6,84111,3458,80653,0.9588876603535804,22.748001777777777,3235.859728,13.03090673847314,127,0.0010000000000000002
6,test_20231031_152621,10350842.png,212614,3992,208622,0.9812241903167243,2,5,42529,585,41944,0.9862446801006373,23.73951466666667,3439.8629386666667,12.765392224145835,127,0.0010000000000000002
7,test_20231031_152621,10863862.png,317432,9732,307700,0.9693414652587011,3,6,66058,1414,64644,0.9785945684095795,26.941274666666665,4106.273744,11.996324627047875,127,0.0010000000000000002
8,test_20231031_152621,11382381.png,312486,547,311939,0.9982495215785667,3,10,46745,73,46672,0.9984383356508717,22.032236444444443,2581.941392,14.011339809622479,127,0.0010000000000000002
9,test_20231031_152621,11079715.png,443815,115474,328341,0.7398150130121786,6,7,124136,16133,108003,0.8700377005864536,17.29648,2199.590101333333,14.70738604279775,127,0.0010000000000000002
10,test_20231031_152621,11551286.png,271883,347,271536,0.9987237157159513,2,6,40092,49,40043,0.9987778110346204,18.003251555555554,1874.2515253333333,15.402524879051395,127,0.0010000000000000002
1,test_20231031_152622,10404007.png,502730,18362,484368,0.9634754241839556,3,5,61265,2667,58598,0.9564678038031502,26.119692444444443,3536.8504693333334,12.644636617306142,127,0.0011000000000000003
2,test_20231031_152622,1254659.png,342646,71462,271184,0.7914407289155572,4,6,80080,10017,70063,0.8749125874125874,21.31288711111111,3298.2814986666667,12.947926422154241,127,0.0011000000000000003
3,test_20231031_152622,10188041.png,221231,8967,212264,0.9594677057012806,3,6,41731,1274,40457,0.9694711365651434,11.320529777777777,1135.8477973333333,17.57760220696072,127,0.0011000000000000003
4,test_20231031_152622,10287332.png,216980,11842,205138,0.9454235413402157,3,6,22337,1624,20713,0.9272955186461924,9.651269333333333,820.581136,18.989588319383,127,0.0011000000000000003
5,test_20231031_152622,11610969.png,368720,23627,345093,0.9359215665003254,4,6,84111,3458,80653,0.9588876603535804,22.748001777777777,3235.859728,13.03090673847314,127,0.0011000000000000003
6,test_20231031_152622,10350842.png,212614,3972,208642,0.9813182574995062,2,6,42529,582,41947,0.9863152202026852,24.202252444444444,3521.053050666667,12.664077923617057,127,0.0011000000000000003
7,test_20231031_152622,10863862.png,317432,9469,307963,0.9701699891630333,3,6,66058,1382,64676,0.9790789911895607,27.302753777777777,4197.140453333333,11.901268581593989,127,0.0011000000000000003
8,test_20231031_152622,11382381.png,312486,547,311939,0.9982495215785667,2,5,46745,73,46672,0.9984383356508717,22.032236444444443,2581.941392,14.011339809622479,127,0.0011000000000000003
9,test_20231031_152622,11079715.png,443815,115274,328541,0.7402656512285524,6,8,124136,16104,108032,0.8702713153315718,17.550856888888887,2246.2530506666667,14.616216809292663,127,0.0011000000000000003
10,test_20231031_152622,11551286.png,271883,347,271536,0.9987237157159513,2,6,40092,49,40043,0.9987778110346204,18.003251555555554,1874.2515253333333,15.402524879051395,127,0.0011000000000000003
1,test_20231031_152623,10404007.png,502730,18362,484368,0.9634754241839556,4,6,61265,2667,58598,0.9564678038031502,26.119692444444443,3536.8504693333334,12.644636617306142,127,0.0012000000000000003
2,test_20231031_152623,1254659.png,342646,71462,271184,0.7914407289155572,5,6,80080,10017,70063,0.8749125874125874,21.31288711111111,3298.2814986666667,12.947926422154241,127,0.0012000000000000003
3,test_20231031_152623,10188041.png,221231,8967,212264,0.9594677057012806,4,5,41731,1274,40457,0.9694711365651434,11.320529777777777,1135.8477973333333,17.57760220696072,127,0.0012000000000000003
4,test_20231031_152623,10287332.png,216980,11842,205138,0.9454235413402157,3,11,22337,1624,20713,0.9272955186461924,9.651269333333333,820.581136,18.989588319383,127,0.0012000000000000003
5,test_20231031_152623,11610969.png,368720,23627,345093,0.9359215665003254,4,6,84111,3458,80653,0.9588876603535804,22.748001777777777,3235.859728,13.03090673847314,127,0.0012000000000000003
6,test_20231031_152623,10350842.png,212614,3972,208642,0.9813182574995062,2,6,42529,582,41947,0.9863152202026852,24.202252444444444,3521.053050666667,12.664077923617057,127,0.0012000000000000003
7,test_20231031_152623,10863862.png,317432,9469,307963,0.9701699891630333,3,5,66058,1382,64676,0.9790789911895607,27.302753777777777,4197.140453333333,11.901268581593989,127,0.0012000000000000003
8,test_20231031_152623,11382381.png,312486,547,311939,0.9982495215785667,3,5,46745,73,46672,0.9984383356508717,22.032236444444443,2581.941392,14.011339809622479,127,0.0012000000000000003
9,test_20231031_152623,11079715.png,443815,115274,328541,0.7402656512285524,9,6,124136,16104,108032,0.8702713153315718,17.550856888888887,2246.2530506666667,14.616216809292663,127,0.0012000000000000003
10,test_20231031_152623,11551286.png,271883,347,271536,0.9987237157159513,2,5,40092,49,40043,0.9987778110346204,18.003251555555554,1874.2515253333333,15.402524879051395,127,0.0012000000000000003
1,test_20231031_152624,10404007.png,502730,17457,485273,0.9652755952499353,3,5,61265,2537,58728,0.9585897331265812,26.497326222222224,3621.680832,12.541701862893166,127,0.0013000000000000004
2,test_20231031_152624,1254659.png,342646,71462,271184,0.7914407289155572,5,6,80080,10017,70063,0.8749125874125874,21.31288711111111,3298.2814986666667,12.947926422154241,127,0.0013000000000000004
3,test_20231031_152624,10188041.png,221231,8687,212544,0.9607333511126379,5,10,41731,1248,40483,0.9700941745944263,11.584330666666666,1185.630816,17.3913088223938,127,0.0013000000000000004
4,test_20231031_152624,10287332.png,216980,11842,205138,0.9454235413402157,2,5,22337,1624,20713,0.9272955186461924,9.651269333333333,820.581136,18.989588319383,127,0.0013000000000000004
5,test_20231031_152624,11610969.png,368720,23607,345113,0.9359758082013452,4,6,84111,3457,80654,0.958899549404953,22.853651555555555,3246.037808,13.017267869334129,127,0.0013000000000000004
6,test_20231031_152624,10350842.png,212614,3972,208642,0.9813182574995062,2,6,42529,582,41947,0.9863152202026852,24.202252444444444,3521.053050666667,12.664077923617057,127,0.0013000000000000004
7,test_20231031_152624,10863862.png,317432,9369,308063,0.9704850172635399,3,6,66058,1367,64691,0.9793060643676769,27.507536,4255.4505653333335,11.841348110939586,127,0.0013000000000000004
8,test_20231031_152624,11382381.png,312486,527,311959,0.9983135244458952,3,6,46745,70,46675,0.9985025136378223,22.788933333333333,2727.61464,13.772973480885131,127,0.0013000000000000004
9,test_20231031_152624,11079715.png,443815,115274,328541,0.7402656512285524,5,6,124136,16104,108032,0.8702713153315718,17.550856888888887,2246.2530506666667,14.616216809292663,127,0.0013000000000000004
10,test_20231031_152624,11551286.png,271883,347,271536,0.9987237157159513,2,5,40092,49,40043,0.9987778110346204,18.003251555555554,1874.2515253333333,15.402524879051395,127,0.0013000000000000004
1,test_20231031_152625,10404007.png,502730,17457,485273,0.9652755952499353,3,6,61265,2537,58728,0.9585897331265812,26.497326222222224,3621.680832,12.541701862893166,127,0.0014000000000000004
2,test_20231031_152625,1254659.png,342646,71462,271184,0.7914407289155572,4,6,80080,10017,70063,0.8749125874125874,21.31288711111111,3298.2814986666667,12.947926422154241,127,0.0014000000000000004
3,test_20231031_152625,10188041.png,221231,8687,212544,0.9607333511126379,3,6,41731,1248,40483,0.9700941745944263,11.584330666666666,1185.630816,17.3913088223938,127,0.0014000000000000004
4,test_20231031_152625,10287332.png,216980,11842,205138,0.9454235413402157,3,6,22337,1624,20713,0.9272955186461924,9.651269333333333,820.581136,18.989588319383,127,0.0014000000000000004
5,test_20231031_152625,11610969.png,368720,23607,345113,0.9359758082013452,4,6,84111,3457,80654,0.958899549404953,22.853651555555555,3246.037808,13.017267869334129,127,0.0014000000000000004
6,test_20231031_152625,10350842.png,212614,3972,208642,0.9813182574995062,2,5,42529,582,41947,0.9863152202026852,24.202252444444444,3521.053050666667,12.664077923617057,127,0.0014000000000000004
7,test_20231031_152625,10863862.png,317432,9369,308063,0.9704850172635399,4,6,66058,1367,64691,0.9793060643676769,27.507536,4255.4505653333335,11.841348110939586,127,0.0014000000000000004
8,test_20231031_152625,11382381.png,312486,527,311959,0.9983135244458952,2,6,46745,70,46675,0.9985025136378223,22.788933333333333,2727.61464,13.772973480885131,127,0.0014000000000000004
9,test_20231031_152625,11079715.png,443815,115274,328541,0.7402656512285524,5,7,124136,16104,108032,0.8702713153315718,17.550856888888887,2246.2530506666667,14.616216809292663,127,0.0014000000000000004
10,test_20231031_152625,11551286.png,271883,347,271536,0.9987237157159513,2,5,40092,49,40043,0.9987778110346204,18.003251555555554,1874.2515253333333,15.402524879051395,127,0.0014000000000000004
1,test_20231031_152626,10404007.png,502730,18534,484196,0.9631332922244544,3,5,61265,2687,58578,0.956141353138007,25.885536,3487.714848,12.705393906287338,128,1.0E-4
2,test_20231031_152626,1254659.png,342646,69592,273054,0.7968982565096339,4,6,80080,9768,70312,0.878021978021978,21.430725333333335,3345.388144,12.88633847428336,128,1.0E-4
3,test_20231031_152626,10188041.png,221231,9309,211922,0.9579218102345513,4,6,41731,1311,40420,0.9685845055234718,10.629137777777778,1035.1340373333333,17.980837715530228,128,1.0E-4
4,test_20231031_152626,10287332.png,216980,12152,204828,0.9439948382339386,3,5,22337,1664,20673,0.9255047678739311,9.449086222222222,786.1254666666666,19.175884953215455,128,1.0E-4
5,test_20231031_152626,11610969.png,368720,24032,344688,0.9348231720546756,3,6,84111,3509,80602,0.9582813187335782,21.529770666666668,2995.306272,13.366391249809656,128,1.0E-4
6,test_20231031_152626,10350842.png,212614,5642,206972,0.9734636477372139,2,6,42529,830,41699,0.9804839051000493,19.393774222222223,2404.812736,14.319990975752292,128,1.0E-4
7,test_20231031_152626,10863862.png,317432,10677,306755,0.966364449708914,3,5,66058,1554,64504,0.9764752187471616,24.58188977777778,3464.000261333333,12.735024447582767,128,1.0E-4
8,test_20231031_152626,11382381.png,312486,917,311569,0.9970654685329903,3,6,46745,126,46619,0.99730452454808,21.089132444444445,2412.4090613333333,14.306294097973675,128,1.0E-4
9,test_20231031_152626,11079715.png,443815,113162,330653,0.7450243907934613,5,7,124136,15824,108312,0.872526905974093,17.42231111111111,2238.1416106666666,14.631927993255129,128,1.0E-4
10,test_20231031_152626,11551286.png,271883,797,271086,0.997068592004649,3,5,40092,116,39976,0.9971066546942033,16.03718577777778,1539.4418613333332,16.257170689141084,128,1.0E-4
1,test_20231031_152627,10404007.png,502730,18534,484196,0.9631332922244544,3,5,61265,2687,58578,0.956141353138007,25.885536,3487.714848,12.705393906287338,128,2.0E-4
2,test_20231031_152627,1254659.png,342646,69592,273054,0.7968982565096339,4,7,80080,9768,70312,0.878021978021978,21.430725333333335,3345.388144,12.88633847428336,128,2.0E-4
3,test_20231031_152627,10188041.png,221231,9309,211922,0.9579218102345513,3,5,41731,1311,40420,0.9685845055234718,10.629137777777778,1035.1340373333333,17.980837715530228,128,2.0E-4
4,test_20231031_152627,10287332.png,216980,11942,205038,0.9449626693704489,2,6,22337,1637,20700,0.9267135246452075,9.578848,812.8562133333334,19.03066631114696,128,2.0E-4
5,test_20231031_152627,11610969.png,368720,24032,344688,0.9348231720546756,4,6,84111,3509,80602,0.9582813187335782,21.529770666666668,2995.306272,13.366391249809656,128,2.0E-4
6,test_20231031_152627,10350842.png,212614,5642,206972,0.9734636477372139,2,6,42529,830,41699,0.9804839051000493,19.393774222222223,2404.812736,14.319990975752292,128,2.0E-4
7,test_20231031_152627,10863862.png,317432,10677,306755,0.966364449708914,3,5,66058,1554,64504,0.9764752187471616,24.58188977777778,3464.000261333333,12.735024447582767,128,2.0E-4
8,test_20231031_152627,11382381.png,312486,787,311699,0.9974814871706252,2,6,46745,107,46638,0.9977109851320997,21.347548444444445,2452.9523093333332,14.233912561978928,128,2.0E-4
9,test_20231031_152627,11079715.png,443815,113162,330653,0.7450243907934613,5,7,124136,15824,108312,0.872526905974093,17.42231111111111,2238.1416106666666,14.631927993255129,128,2.0E-4
10,test_20231031_152627,11551286.png,271883,597,271286,0.9978042025430056,2,6,40092,86,40006,0.997854933652599,17.58564977777778,1815.0887466666666,15.541824966498465,128,2.0E-4
1,test_20231031_152628,10404007.png,502730,18032,484698,0.9641318401527659,4,6,61265,2618,58647,0.9572676079327511,25.992037333333332,3511.230128,12.676210665648235,128,3.0000000000000003E-4
2,test_20231031_152628,1254659.png,342646,69532,273114,0.7970733643468769,6,6,80080,9762,70318,0.8780969030969031,21.44027911111111,3346.4703306666665,12.884933819048644,128,3.0000000000000003E-4
3,test_20231031_152628,10188041.png,221231,9269,211962,0.958102616721888,3,6,41731,1305,40426,0.9687282835302293,10.994965333333333,1087.4147413333333,17.76685144730885,128,3.0000000000000003E-4
4,test_20231031_152628,10287332.png,216980,11942,205038,0.9449626693704489,3,5,22337,1637,20700,0.9267135246452075,9.578848,812.8562133333334,19.03066631114696,128,3.0000000000000003E-4
5,test_20231031_152628,11610969.png,368720,23467,345253,0.9363555001084833,4,6,84111,3427,80684,0.9592562209461307,22.418577777777777,3189.8884373333335,13.093048664934157,128,3.0000000000000003E-4
6,test_20231031_152628,10350842.png,212614,5562,207052,0.9738399164683417,3,6,42529,818,41711,0.9807660655082414,19.46256711111111,2410.5704426666666,14.30960533734045,128,3.0000000000000003E-4
7,test_20231031_152628,10863862.png,317432,10557,306875,0.966742483429522,3,6,66058,1536,64522,0.976747706560901,24.63304711111111,3467.3115253333335,12.730874976784207,128,3.0000000000000003E-4
8,test_20231031_152628,11382381.png,312486,667,311819,0.997865504374596,2,6,46745,89,46656,0.9980960530538026,21.842074666666665,2522.8946186666667,14.11181250456314,128,3.0000000000000003E-4
9,test_20231031_152628,11079715.png,443815,113162,330653,0.7450243907934613,6,8,124136,15824,108312,0.872526905974093,17.42231111111111,2238.1416106666666,14.631927993255129,128,3.0000000000000003E-4
10,test_20231031_152628,11551286.png,271883,267,271616,0.9990179599312939,2,5,40092,37,40055,0.9990771226179787,18.016108444444445,1877.54488,15.394900338849709,128,3.0000000000000003E-4
1,test_20231031_152629,10404007.png,502730,18032,484698,0.9641318401527659,3,6,61265,2618,58647,0.9572676079327511,25.992037333333332,3511.230128,12.676210665648235,128,4.0E-4
2,test_20231031_152629,1254659.png,342646,69532,273114,0.7970733643468769,5,7,80080,9762,70318,0.8780969030969031,21.44027911111111,3346.4703306666665,12.884933819048644,128,4.0E-4
3,test_20231031_152629,10188041.png,221231,9269,211962,0.958102616721888,3,5,41731,1305,40426,0.9687282835302293,10.994965333333333,1087.4147413333333,17.76685144730885,128,4.0E-4
4,test_20231031_152629,10287332.png,216980,11942,205038,0.9449626693704489,3,6,22337,1637,20700,0.9267135246452075,9.578848,812.8562133333334,19.03066631114696,128,4.0E-4
5,test_20231031_152629,11610969.png,368720,23467,345253,0.9363555001084833,4,6,84111,3427,80684,0.9592562209461307,22.418577777777777,3189.8884373333335,13.093048664934157,128,4.0E-4
6,test_20231031_152629,10350842.png,212614,5562,207052,0.9738399164683417,2,6,42529,818,41711,0.9807660655082414,19.46256711111111,2410.5704426666666,14.30960533734045,128,4.0E-4
7,test_20231031_152629,10863862.png,317432,9612,307820,0.969719498979309,4,6,66058,1397,64661,0.9788519180114444,27.040947555555555,4133.234704,11.967902936558898,128,4.0E-4
8,test_20231031_152629,11382381.png,312486,667,311819,0.997865504374596,3,6,46745,89,46656,0.9980960530538026,21.842074666666665,2522.8946186666667,14.11181250456314,128,4.0E-4
9,test_20231031_152629,11079715.png,443815,113162,330653,0.7450243907934613,5,7,124136,15824,108312,0.872526905974093,17.42231111111111,2238.1416106666666,14.631927993255129,128,4.0E-4
10,test_20231031_152629,11551286.png,271883,267,271616,0.9990179599312939,2,6,40092,37,40055,0.9990771226179787,18.016108444444445,1877.54488,15.394900338849709,128,4.0E-4
1,test_20231031_152630,10404007.png,502730,18032,484698,0.9641318401527659,4,6,61265,2618,58647,0.9572676079327511,25.992037333333332,3511.230128,12.676210665648235,128,5.0E-4
2,test_20231031_152630,1254659.png,342646,69532,273114,0.7970733643468769,5,6,80080,9762,70318,0.8780969030969031,21.44027911111111,3346.4703306666665,12.884933819048644,128,5.0E-4
3,test_20231031_152630,10188041.png,221231,9269,211962,0.958102616721888,3,5,41731,1305,40426,0.9687282835302293,10.994965333333333,1087.4147413333333,17.76685144730885,128,5.0E-4
4,test_20231031_152630,10287332.png,216980,11942,205038,0.9449626693704489,4,6,22337,1637,20700,0.9267135246452075,9.578848,812.8562133333334,19.03066631114696,128,5.0E-4
5,test_20231031_152630,11610969.png,368720,23467,345253,0.9363555001084833,4,6,84111,3427,80684,0.9592562209461307,22.418577777777777,3189.8884373333335,13.093048664934157,128,5.0E-4
6,test_20231031_152630,10350842.png,212614,5562,207052,0.9738399164683417,3,6,42529,818,41711,0.9807660655082414,19.46256711111111,2410.5704426666666,14.30960533734045,128,5.0E-4
7,test_20231031_152630,10863862.png,317432,9612,307820,0.969719498979309,4,6,66058,1397,64661,0.9788519180114444,27.040947555555555,4133.234704,11.967902936558898,128,5.0E-4
8,test_20231031_152630,11382381.png,312486,667,311819,0.997865504374596,2,6,46745,89,46656,0.9980960530538026,21.842074666666665,2522.8946186666667,14.11181250456314,128,5.0E-4
9,test_20231031_152630,11079715.png,443815,113162,330653,0.7450243907934613,5,6,124136,15824,108312,0.872526905974093,17.42231111111111,2238.1416106666666,14.631927993255129,128,5.0E-4
10,test_20231031_152630,11551286.png,271883,267,271616,0.9990179599312939,2,6,40092,37,40055,0.9990771226179787,18.016108444444445,1877.54488,15.394900338849709,128,5.0E-4
1,test_20231031_152631,10404007.png,502730,17872,484858,0.964450102440674,4,6,61265,2595,58670,0.9576430261976658,26.03386666666667,3518.705610666667,12.666974273692194,128,6.000000000000001E-4
2,test_20231031_152631,1254659.png,342646,69532,273114,0.7970733643468769,4,6,80080,9762,70318,0.8780969030969031,21.44027911111111,3346.4703306666665,12.884933819048644,128,6.000000000000001E-4
3,test_20231031_152631,10188041.png,221231,9207,212024,0.9583828667772599,3,6,41731,1298,40433,0.9688960245381132,11.120924444444444,1098.1147306666667,17.724326434383556,128,6.000000000000001E-4
4,test_20231031_152631,10287332.png,216980,11942,205038,0.9449626693704489,3,6,22337,1637,20700,0.9267135246452075,9.578848,812.8562133333334,19.03066631114696,128,6.000000000000001E-4
5,test_20231031_152631,11610969.png,368720,23427,345293,0.9364639835105228,4,6,84111,3425,80686,0.9592799990488758,22.796608,3253.0010773333333,13.007961537557941,128,6.000000000000001E-4
6,test_20231031_152631,10350842.png,212614,5562,207052,0.9738399164683417,3,5,42529,818,41711,0.9807660655082414,19.46256711111111,2410.5704426666666,14.30960533734045,128,6.000000000000001E-4
7,test_20231031_152631,10863862.png,317432,9612,307820,0.969719498979309,4,5,66058,1397,64661,0.9788519180114444,27.040947555555555,4133.234704,11.967902936558898,128,6.000000000000001E-4
8,test_20231031_152631,11382381.png,312486,667,311819,0.997865504374596,2,5,46745,89,46656,0.9980960530538026,21.842074666666665,2522.8946186666667,14.11181250456314,128,6.000000000000001E-4
9,test_20231031_152631,11079715.png,443815,113162,330653,0.7450243907934613,5,7,124136,15824,108312,0.872526905974093,17.42231111111111,2238.1416106666666,14.631927993255129,128,6.000000000000001E-4
10,test_20231031_152631,11551286.png,271883,267,271616,0.9990179599312939,2,6,40092,37,40055,0.9990771226179787,18.016108444444445,1877.54488,15.394900338849709,128,6.000000000000001E-4
1,test_20231031_152633,10404007.png,502730,17872,484858,0.964450102440674,3,5,61265,2595,58670,0.9576430261976658,26.03386666666667,3518.705610666667,12.666974273692194,128,7.000000000000001E-4
2,test_20231031_152633,1254659.png,342646,69532,273114,0.7970733643468769,4,6,80080,9762,70318,0.8780969030969031,21.44027911111111,3346.4703306666665,12.884933819048644,128,7.000000000000001E-4
3,test_20231031_152633,10188041.png,221231,9207,212024,0.9583828667772599,3,6,41731,1298,40433,0.9688960245381132,11.120924444444444,1098.1147306666667,17.724326434383556,128,7.000000000000001E-4
4,test_20231031_152633,10287332.png,216980,11942,205038,0.9449626693704489,3,5,22337,1637,20700,0.9267135246452075,9.578848,812.8562133333334,19.03066631114696,128,7.000000000000001E-4
5,test_20231031_152633,11610969.png,368720,23427,345293,0.9364639835105228,4,6,84111,3425,80686,0.9592799990488758,22.796608,3253.0010773333333,13.007961537557941,128,7.000000000000001E-4
6,test_20231031_152633,10350842.png,212614,5562,207052,0.9738399164683417,2,5,42529,818,41711,0.9807660655082414,19.46256711111111,2410.5704426666666,14.30960533734045,128,7.000000000000001E-4
7,test_20231031_152633,10863862.png,317432,9612,307820,0.969719498979309,4,6,66058,1397,64661,0.9788519180114444,27.040947555555555,4133.234704,11.967902936558898,128,7.000000000000001E-4
8,test_20231031_152633,11382381.png,312486,667,311819,0.997865504374596,3,6,46745,89,46656,0.9980960530538026,21.842074666666665,2522.8946186666667,14.11181250456314,128,7.000000000000001E-4
9,test_20231031_152633,11079715.png,443815,113162,330653,0.7450243907934613,5,6,124136,15824,108312,0.872526905974093,17.42231111111111,2238.1416106666666,14.631927993255129,128,7.000000000000001E-4
10,test_20231031_152633,11551286.png,271883,267,271616,0.9990179599312939,2,6,40092,37,40055,0.9990771226179787,18.016108444444445,1877.54488,15.394900338849709,128,7.000000000000001E-4
1,test_20231031_152634,10404007.png,502730,17792,484938,0.9646092335846279,4,6,61265,2583,58682,0.9578388965967518,26.03775288888889,3519.475594666667,12.666024028752677,128,8.000000000000001E-4
2,test_20231031_152634,1254659.png,342646,69532,273114,0.7970733643468769,4,6,80080,9762,70318,0.8780969030969031,21.44027911111111,3346.4703306666665,12.884933819048644,128,8.000000000000001E-4
3,test_20231031_152634,10188041.png,221231,8987,212244,0.9593773024576122,3,6,41731,1268,40463,0.969614914571901,11.263271111111111,1127.1926293333333,17.61082220591244,128,8.000000000000001E-4
4,test_20231031_152634,10287332.png,216980,11942,205038,0.9449626693704489,3,6,22337,1637,20700,0.9267135246452075,9.578848,812.8562133333334,19.03066631114696,128,8.000000000000001E-4
5,test_20231031_152634,11610969.png,368720,23407,345313,0.9365182252115426,3,6,84111,3424,80687,0.9592918881002485,22.902257777777777,3263.1791573333335,12.994394424875402,128,8.000000000000001E-4
6,test_20231031_152634,10350842.png,212614,5522,207092,0.9740280508339055,3,6,42529,812,41717,0.9809071457123375,19.516519111111112,2419.365386666667,14.293788978678773,128,8.000000000000001E-4
7,test_20231031_152634,10863862.png,317432,9509,307923,0.9700439779228307,3,5,66058,1384,64674,0.9790487147658119,27.16096888888889,4153.414896,11.94675044724713,128,8.000000000000001E-4
8,test_20231031_152634,11382381.png,312486,667,311819,0.997865504374596,2,5,46745,89,46656,0.9980960530538026,21.842074666666665,2522.8946186666667,14.11181250456314,128,8.000000000000001E-4
9,test_20231031_152634,11079715.png,443815,112982,330833,0.7454299651881977,5,7,124136,15797,108339,0.8727444093574789,17.65957511111111,2280.1507466666667,14.551168005861816,128,8.000000000000001E-4
10,test_20231031_152634,11551286.png,271883,267,271616,0.9990179599312939,3,5,40092,37,40055,0.9990771226179787,18.016108444444445,1877.54488,15.394900338849709,128,8.000000000000001E-4
1,test_20231031_152635,10404007.png,502730,17792,484938,0.9646092335846279,3,5,61265,2583,58682,0.9578388965967518,26.03775288888889,3519.475594666667,12.666024028752677,128,9.000000000000002E-4
2,test_20231031_152635,1254659.png,342646,69532,273114,0.7970733643468769,4,7,80080,9762,70318,0.8780969030969031,21.44027911111111,3346.4703306666665,12.884933819048644,128,9.000000000000002E-4
3,test_20231031_152635,10188041.png,221231,8987,212244,0.9593773024576122,3,5,41731,1268,40463,0.969614914571901,11.263271111111111,1127.1926293333333,17.61082220591244,128,9.000000000000002E-4
4,test_20231031_152635,10287332.png,216980,11942,205038,0.9449626693704489,2,5,22337,1637,20700,0.9267135246452075,9.578848,812.8562133333334,19.03066631114696,128,9.000000000000002E-4
5,test_20231031_152635,11610969.png,368720,23407,345313,0.9365182252115426,4,7,84111,3424,80687,0.9592918881002485,22.902257777777777,3263.1791573333335,12.994394424875402,128,9.000000000000002E-4
6,test_20231031_152635,10350842.png,212614,3932,208682,0.98150639186507,3,6,42529,576,41953,0.9864563004067812,23.636912,3423.166224,12.786523725061926,128,9.000000000000002E-4
7,test_20231031_152635,10863862.png,317432,9509,307923,0.9700439779228307,3,6,66058,1384,64674,0.9790487147658119,27.16096888888889,4153.414896,11.94675044724713,128,9.000000000000002E-4
8,test_20231031_152635,11382381.png,312486,667,311819,0.997865504374596,2,6,46745,89,46656,0.9980960530538026,21.842074666666665,2522.8946186666667,14.11181250456314,128,9.000000000000002E-4
9,test_20231031_152635,11079715.png,443815,112982,330833,0.7454299651881977,5,7,124136,15797,108339,0.8727444093574789,17.65957511111111,2280.1507466666667,14.551168005861816,128,9.000000000000002E-4
10,test_20231031_152635,11551286.png,271883,267,271616,0.9990179599312939,2,6,40092,37,40055,0.9990771226179787,18.016108444444445,1877.54488,15.394900338849709,128,9.000000000000002E-4
1,test_20231031_152636,10404007.png,502730,17227,485503,0.9657330972888032,4,6,61265,2508,58757,0.9590630865910389,26.18104177777778,3556.778357333333,12.620235581466272,128,0.0010000000000000002
2,test_20231031_152636,1254659.png,342646,69372,273274,0.7975403185795252,4,6,80080,9748,70332,0.8782717282717283,21.510003555555556,3361.1507893333333,12.865923644631687,128,0.0010000000000000002
3,test_20231031_152636,10188041.png,221231,8827,212404,0.9601005284069593,4,6,41731,1254,40477,0.9699503965876687,11.451015111111111,1179.3955306666667,17.414208831870877,128,0.0010000000000000002
4,test_20231031_152636,10287332.png,216980,11862,205118,0.9453313669462623,6,6,22337,1625,20712,0.9272507498768858,9.604408888888889,817.0261866666667,19.008443844547408,128,0.0010000000000000002
5,test_20231031_152636,11610969.png,368720,22907,345813,0.9378742677370362,4,5,84111,3354,80757,0.9601241216963299,22.99936,3283.6162026666666,12.96727970887227,128,0.0010000000000000002
6,test_20231031_152636,10350842.png,212614,3832,208782,0.9819767277789797,2,9,42529,561,41968,0.9868090009170213,23.791479111111112,3451.5819786666666,12.750621680748441,128,0.0010000000000000002
7,test_20231031_152636,10863862.png,317432,9309,308123,0.9706740341238439,3,6,66058,1355,64703,0.9794877229101698,27.314110222222222,4188.082469333333,11.91065135897458,128,0.0010000000000000002
8,test_20231031_152636,11382381.png,312486,527,311959,0.9983135244458952,1,5,46745,70,46675,0.9985025136378223,22.788933333333333,2727.61464,13.772973480885131,128,0.0010000000000000002
9,test_20231031_152636,11079715.png,443815,112882,330933,0.7456552842963848,6,7,124136,15787,108349,0.8728249661661404,17.698288,2286.444048,14.539197827226813,128,0.0010000000000000002
10,test_20231031_152636,11551286.png,271883,267,271616,0.9990179599312939,3,5,40092,37,40055,0.9990771226179787,18.016108444444445,1877.54488,15.394900338849709,128,0.0010000000000000002
1,test_20231031_152637,10404007.png,502730,17227,485503,0.9657330972888032,4,6,61265,2508,58757,0.9590630865910389,26.18104177777778,3556.778357333333,12.620235581466272,128,0.0011000000000000003
2,test_20231031_152637,1254659.png,342646,69372,273274,0.7975403185795252,5,6,80080,9748,70332,0.8782717282717283,21.510003555555556,3361.1507893333333,12.865923644631687,128,0.0011000000000000003
3,test_20231031_152637,10188041.png,221231,8707,212524,0.9606429478689695,3,5,41731,1244,40487,0.9701900265989313,11.446936888888889,1178.4294613333334,17.417767693156208,128,0.0011000000000000003
4,test_20231031_152637,10287332.png,216980,11702,205278,0.9460687620978891,2,11,22337,1603,20734,0.9282356628016296,9.672430222222221,828.0766186666667,18.950098386667364,128,0.0011000000000000003
5,test_20231031_152637,11610969.png,368720,22907,345813,0.9378742677370362,4,6,84111,3354,80757,0.9601241216963299,22.99936,3283.6162026666666,12.96727970887227,128,0.0011000000000000003
6,test_20231031_152637,10350842.png,212614,3812,208802,0.9820707949617616,2,6,42529,558,41971,0.9868795410190694,24.254216888888887,3532.772090666667,12.649647401210093,128,0.0011000000000000003
7,test_20231031_152637,10863862.png,317432,9147,308285,0.9711843796466645,3,6,66058,1335,64723,0.9797904871476582,27.555568,4258.768986666667,11.837962780932838,128,0.0011000000000000003
8,test_20231031_152637,11382381.png,312486,527,311959,0.9983135244458952,2,5,46745,70,46675,0.9985025136378223,22.788933333333333,2727.61464,13.772973480885131,128,0.0011000000000000003
9,test_20231031_152637,11079715.png,443815,112862,330953,0.7457003481180222,5,8,124136,15785,108351,0.8728410775278727,17.71540088888889,2291.097861333333,14.530367209454857,128,0.0011000000000000003
10,test_20231031_152637,11551286.png,271883,267,271616,0.9990179599312939,2,6,40092,37,40055,0.9990771226179787,18.016108444444445,1877.54488,15.394900338849709,128,0.0011000000000000003
1,test_20231031_152638,10404007.png,502730,17227,485503,0.9657330972888032,4,5,61265,2508,58757,0.9590630865910389,26.18104177777778,3556.778357333333,12.620235581466272,128,0.0012000000000000003
2,test_20231031_152638,1254659.png,342646,69372,273274,0.7975403185795252,4,6,80080,9748,70332,0.8782717282717283,21.510003555555556,3361.1507893333333,12.865923644631687,128,0.0012000000000000003
3,test_20231031_152638,10188041.png,221231,8707,212524,0.9606429478689695,4,5,41731,1244,40487,0.9701900265989313,11.446936888888889,1178.4294613333334,17.417767693156208,128,0.0012000000000000003
4,test_20231031_152638,10287332.png,216980,11702,205278,0.9460687620978891,2,5,22337,1603,20734,0.9282356628016296,9.672430222222221,828.0766186666667,18.950098386667364,128,0.0012000000000000003
5,test_20231031_152638,11610969.png,368720,22907,345813,0.9378742677370362,5,6,84111,3354,80757,0.9601241216963299,22.99936,3283.6162026666666,12.96727970887227,128,0.0012000000000000003
6,test_20231031_152638,10350842.png,212614,3812,208802,0.9820707949617616,2,9,42529,558,41971,0.9868795410190694,24.254216888888887,3532.772090666667,12.649647401210093,128,0.0012000000000000003
7,test_20231031_152638,10863862.png,317432,9147,308285,0.9711843796466645,3,6,66058,1335,64723,0.9797904871476582,27.555568,4258.768986666667,11.837962780932838,128,0.0012000000000000003
8,test_20231031_152638,11382381.png,312486,527,311959,0.9983135244458952,2,6,46745,70,46675,0.9985025136378223,22.788933333333333,2727.61464,13.772973480885131,128,0.0012000000000000003
9,test_20231031_152638,11079715.png,443815,112862,330953,0.7457003481180222,5,6,124136,15785,108351,0.8728410775278727,17.71540088888889,2291.097861333333,14.530367209454857,128,0.0012000000000000003
10,test_20231031_152638,11551286.png,271883,267,271616,0.9990179599312939,2,5,40092,37,40055,0.9990771226179787,18.016108444444445,1877.54488,15.394900338849709,128,0.0012000000000000003
1,test_20231031_152639,10404007.png,502730,16584,486146,0.9670121138583335,4,6,61265,2414,58851,0.9605974047172121,26.55031288888889,3639.165626666667,12.520785391067646,128,0.0013000000000000004
2,test_20231031_152639,1254659.png,342646,69372,273274,0.7975403185795252,5,6,80080,9748,70332,0.8782717282717283,21.510003555555556,3361.1507893333333,12.865923644631687,128,0.0013000000000000004
3,test_20231031_152639,10188041.png,221231,8547,212684,0.9613661738183166,3,5,41731,1228,40503,0.9705734346169514,11.714816,1229.1785493333334,17.234653881864766,128,0.0013000000000000004
4,test_20231031_152639,10287332.png,216980,11702,205278,0.9460687620978891,3,6,22337,1603,20734,0.9282356628016296,9.672430222222221,828.0766186666667,18.950098386667364,128,0.0013000000000000004
5,test_20231031_152639,11610969.png,368720,22907,345813,0.9378742677370362,4,6,84111,3354,80757,0.9601241216963299,22.99936,3283.6162026666666,12.96727970887227,128,0.0013000000000000004
6,test_20231031_152639,10350842.png,212614,3812,208802,0.9820707949617616,3,5,42529,558,41971,0.9868795410190694,24.254216888888887,3532.772090666667,12.649647401210093,128,0.0013000000000000004
7,test_20231031_152639,10863862.png,317432,9127,308305,0.9712473852667658,3,7,66058,1332,64726,0.9798359017832814,27.631397333333332,4288.0746506666665,11.808180235277863,128,0.0013000000000000004
8,test_20231031_152639,11382381.png,312486,527,311959,0.9983135244458952,2,6,46745,70,46675,0.9985025136378223,22.788933333333333,2727.61464,13.772973480885131,128,0.0013000000000000004
9,test_20231031_152639,11079715.png,443815,112862,330953,0.7457003481180222,5,7,124136,15785,108351,0.8728410775278727,17.71540088888889,2291.097861333333,14.530367209454857,128,0.0013000000000000004
10,test_20231031_152639,11551286.png,271883,267,271616,0.9990179599312939,2,6,40092,37,40055,0.9990771226179787,18.016108444444445,1877.54488,15.394900338849709,128,0.0013000000000000004
1,test_20231031_152640,10404007.png,502730,16584,486146,0.9670121138583335,3,6,61265,2414,58851,0.9605974047172121,26.55031288888889,3639.165626666667,12.520785391067646,128,0.0014000000000000004
2,test_20231031_152640,1254659.png,342646,69372,273274,0.7975403185795252,5,6,80080,9748,70332,0.8782717282717283,21.510003555555556,3361.1507893333333,12.865923644631687,128,0.0014000000000000004
3,test_20231031_152640,10188041.png,221231,8547,212684,0.9613661738183166,3,5,41731,1228,40503,0.9705734346169514,11.714816,1229.1785493333334,17.234653881864766,128,0.0014000000000000004
4,test_20231031_152640,10287332.png,216980,11702,205278,0.9460687620978891,2,5,22337,1603,20734,0.9282356628016296,9.672430222222221,828.0766186666667,18.950098386667364,128,0.0014000000000000004
5,test_20231031_152640,11610969.png,368720,22907,345813,0.9378742677370362,3,5,84111,3354,80757,0.9601241216963299,22.99936,3283.6162026666666,12.96727970887227,128,0.0014000000000000004
6,test_20231031_152640,10350842.png,212614,3812,208802,0.9820707949617616,2,6,42529,558,41971,0.9868795410190694,24.254216888888887,3532.772090666667,12.649647401210093,128,0.0014000000000000004
7,test_20231031_152640,10863862.png,317432,9127,308305,0.9712473852667658,3,6,66058,1332,64726,0.9798359017832814,27.631397333333332,4288.0746506666665,11.808180235277863,128,0.0014000000000000004
8,test_20231031_152640,11382381.png,312486,527,311959,0.9983135244458952,2,5,46745,70,46675,0.9985025136378223,22.788933333333333,2727.61464,13.772973480885131,128,0.0014000000000000004
9,test_20231031_152640,11079715.png,443815,112862,330953,0.7457003481180222,5,7,124136,15785,108351,0.8728410775278727,17.71540088888889,2291.097861333333,14.530367209454857,128,0.0014000000000000004
10,test_20231031_152640,11551286.png,271883,24,271859,0.9999117267353972,0,5,40092,1,40091,0.9999750573680535,24.866876444444443,3470.407338666667,12.72699907819776,128,0.0014000000000000004
1,test_20231031_152641,10404007.png,502730,17207,485523,0.9657728800747917,4,6,61265,2499,58766,0.9592099893903534,26.117214222222223,3546.187088,12.633187167032132,129,1.0E-4
2,test_20231031_152641,1254659.png,342646,67202,275444,0.8038733853598174,4,6,80080,9440,70640,0.8821178821178821,21.685260444444445,3425.6872266666664,12.78332652540119,129,1.0E-4
3,test_20231031_152641,10188041.png,221231,8907,212324,0.9597389154322857,3,6,41731,1262,40469,0.9697586925786585,10.89088711111111,1117.198944,17.64949844343051,129,1.0E-4
4,test_20231031_152641,10287332.png,216980,11792,205188,0.945653977325099,4,6,22337,1617,20720,0.9276089000313381,9.499649777777778,803.2418826666667,19.082340154783257,129,1.0E-4
5,test_20231031_152641,11610969.png,368720,22372,346348,0.9393252332393144,4,6,84111,3270,80841,0.9611228020116275,22.074186666666666,3125.7853333333333,13.18121211800863,129,1.0E-4
6,test_20231031_152641,10350842.png,212614,5359,207255,0.9747946983735785,3,6,42529,788,41741,0.9814714665287215,19.497994666666667,2427.775552,14.27871827160568,129,1.0E-4
7,test_20231031_152641,10863862.png,317432,7622,309810,0.9759885581793896,2,5,66058,1113,64945,0.9831511701837778,35.65140977777778,6505.424832,9.998046977614175,129,1.0E-4
8,test_20231031_152641,11382381.png,312486,817,311669,0.9973854828696326,4,6,46745,112,46633,0.9976040218205156,21.216531555555555,2458.9940213333334,14.223228880483061,129,1.0E-4
9,test_20231031_152641,11079715.png,443815,110349,333466,0.7513626173067607,5,7,124136,15456,108680,0.8754913965328349,17.57312,2279.878944,14.551685732308561,129,1.0E-4
10,test_20231031_152641,11551286.png,271883,737,271146,0.9972892751661561,2,5,40092,107,39985,0.997331138381722,16.330346666666667,1599.3003733333333,16.09150322243563,129,1.0E-4
1,test_20231031_152642,10404007.png,502730,17207,485523,0.9657728800747917,3,6,61265,2499,58766,0.9592099893903534,26.117214222222223,3546.187088,12.633187167032132,129,2.0E-4
2,test_20231031_152642,1254659.png,342646,67202,275444,0.8038733853598174,4,7,80080,9440,70640,0.8821178821178821,21.685260444444445,3425.6872266666664,12.78332652540119,129,2.0E-4
3,test_20231031_152642,10188041.png,221231,8907,212324,0.9597389154322857,3,6,41731,1262,40469,0.9697586925786585,10.89088711111111,1117.198944,17.64949844343051,129,2.0E-4
4,test_20231031_152642,10287332.png,216980,11579,205401,0.9466356346207023,3,6,22337,1590,20747,0.9288176568026145,9.629411555555556,829.9726293333333,18.940165903297878,129,2.0E-4
5,test_20231031_152642,11610969.png,368720,22372,346348,0.9393252332393144,4,6,84111,3270,80841,0.9611228020116275,22.074186666666666,3125.7853333333333,13.18121211800863,129,2.0E-4
6,test_20231031_152642,10350842.png,212614,5359,207255,0.9747946983735785,3,6,42529,788,41741,0.9814714665287215,19.497994666666667,2427.775552,14.27871827160568,129,2.0E-4
7,test_20231031_152642,10863862.png,317432,7622,309810,0.9759885581793896,2,5,66058,1113,64945,0.9831511701837778,35.65140977777778,6505.424832,9.998046977614175,129,2.0E-4
8,test_20231031_152642,11382381.png,312486,707,311779,0.9977374986399391,2,5,46745,96,46649,0.9979463044175848,21.47300977777778,2499.126186666667,14.152921756540431,129,2.0E-4
9,test_20231031_152642,11079715.png,443815,110349,333466,0.7513626173067607,5,7,124136,15456,108680,0.8754913965328349,17.57312,2279.878944,14.551685732308561,129,2.0E-4
10,test_20231031_152642,11551286.png,271883,597,271286,0.9978042025430056,2,5,40092,86,40006,0.997854933652599,17.58564977777778,1815.0887466666666,15.541824966498465,129,2.0E-4
1,test_20231031_152643,10404007.png,502730,17007,485723,0.9661707079346766,4,6,61265,2473,58792,0.9596343752550396,26.13115911111111,3549.4145653333335,12.629236337316815,129,3.0000000000000003E-4
2,test_20231031_152643,1254659.png,342646,67139,275507,0.8040572485889227,5,6,80080,9434,70646,0.8821928071928072,21.694814222222224,3426.7694133333334,12.781954790485319,129,3.0000000000000003E-4
3,test_20231031_152643,10188041.png,221231,8867,212364,0.9599197219196225,3,6,41731,1256,40475,0.9699024705854161,11.256714666666667,1169.479648,17.450876925151316,129,3.0000000000000003E-4
4,test_20231031_152643,10287332.png,216980,11579,205401,0.9466356346207023,2,6,22337,1590,20747,0.9288176568026145,9.629411555555556,829.9726293333333,18.940165903297878,129,3.0000000000000003E-4
5,test_20231031_152643,11610969.png,368720,21849,346871,0.9407436537209807,4,6,84111,3194,80917,0.9620263699159444,22.960643555555556,3319.495392,12.920082907559944,129,3.0000000000000003E-4
6,test_20231031_152643,10350842.png,212614,5279,207335,0.9751709671047062,2,5,42529,776,41753,0.9817536269369136,19.566787555555557,2433.533258666667,14.268430748223048,129,3.0000000000000003E-4
7,test_20231031_152643,10863862.png,317432,7562,309870,0.9761775750396935,2,5,66058,1104,64954,0.9832874140906476,35.66071822222222,6506.869162666667,9.99708286653367,129,3.0000000000000003E-4
8,test_20231031_152643,11382381.png,312486,587,311899,0.9981215158439098,2,6,46745,78,46667,0.9983313723392876,21.967536,2569.068496,14.03304677372966,129,3.0000000000000003E-4
9,test_20231031_152643,11079715.png,443815,110349,333466,0.7513626173067607,5,6,124136,15456,108680,0.8754913965328349,17.57312,2279.878944,14.551685732308561,129,3.0000000000000003E-4
10,test_20231031_152643,11551286.png,271883,267,271616,0.9990179599312939,2,6,40092,37,40055,0.9990771226179787,18.016108444444445,1877.54488,15.394900338849709,129,3.0000000000000003E-4
1,test_20231031_152644,10404007.png,502730,17007,485723,0.9661707079346766,4,6,61265,2473,58792,0.9596343752550396,26.13115911111111,3549.4145653333335,12.629236337316815,129,4.0E-4
2,test_20231031_152644,1254659.png,342646,67139,275507,0.8040572485889227,6,6,80080,9434,70646,0.8821928071928072,21.694814222222224,3426.7694133333334,12.781954790485319,129,4.0E-4
3,test_20231031_152644,10188041.png,221231,8867,212364,0.9599197219196225,3,5,41731,1256,40475,0.9699024705854161,11.256714666666667,1169.479648,17.450876925151316,129,4.0E-4
4,test_20231031_152644,10287332.png,216980,11579,205401,0.9466356346207023,3,6,22337,1590,20747,0.9288176568026145,9.629411555555556,829.9726293333333,18.940165903297878,129,4.0E-4
5,test_20231031_152644,11610969.png,368720,21849,346871,0.9407436537209807,3,6,84111,3194,80917,0.9620263699159444,22.960643555555556,3319.495392,12.920082907559944,129,4.0E-4
6,test_20231031_152644,10350842.png,212614,5279,207335,0.9751709671047062,3,6,42529,776,41753,0.9817536269369136,19.566787555555557,2433.533258666667,14.268430748223048,129,4.0E-4
7,test_20231031_152644,10863862.png,317432,7562,309870,0.9761775750396935,2,5,66058,1104,64954,0.9832874140906476,35.66071822222222,6506.869162666667,9.99708286653367,129,4.0E-4
8,test_20231031_152644,11382381.png,312486,587,311899,0.9981215158439098,2,5,46745,78,46667,0.9983313723392876,21.967536,2569.068496,14.03304677372966,129,4.0E-4
9,test_20231031_152644,11079715.png,443815,110349,333466,0.7513626173067607,5,6,124136,15456,108680,0.8754913965328349,17.57312,2279.878944,14.551685732308561,129,4.0E-4
10,test_20231031_152644,11551286.png,271883,267,271616,0.9990179599312939,2,6,40092,37,40055,0.9990771226179787,18.016108444444445,1877.54488,15.394900338849709,129,4.0E-4
1,test_20231031_152645,10404007.png,502730,16847,485883,0.9664889702225847,3,5,61265,2450,58815,0.9600097935199543,26.172988444444446,3556.890048,12.62009920558409,129,5.0E-4
2,test_20231031_152645,1254659.png,342646,67139,275507,0.8040572485889227,5,6,80080,9434,70646,0.8821928071928072,21.694814222222224,3426.7694133333334,12.781954790485319,129,5.0E-4
3,test_20231031_152645,10188041.png,221231,8867,212364,0.9599197219196225,3,6,41731,1256,40475,0.9699024705854161,11.256714666666667,1169.479648,17.450876925151316,129,5.0E-4
4,test_20231031_152645,10287332.png,216980,11579,205401,0.9466356346207023,3,6,22337,1590,20747,0.9288176568026145,9.629411555555556,829.9726293333333,18.940165903297878,129,5.0E-4
5,test_20231031_152645,11610969.png,368720,21849,346871,0.9407436537209807,3,6,84111,3194,80917,0.9620263699159444,22.960643555555556,3319.495392,12.920082907559944,129,5.0E-4
6,test_20231031_152645,10350842.png,212614,5279,207335,0.9751709671047062,2,6,42529,776,41753,0.9817536269369136,19.566787555555557,2433.533258666667,14.268430748223048,129,5.0E-4
7,test_20231031_152645,10863862.png,317432,7562,309870,0.9761775750396935,3,6,66058,1104,64954,0.9832874140906476,35.66071822222222,6506.869162666667,9.99708286653367,129,5.0E-4
8,test_20231031_152645,11382381.png,312486,587,311899,0.9981215158439098,2,5,46745,78,46667,0.9983313723392876,21.967536,2569.068496,14.03304677372966,129,5.0E-4
9,test_20231031_152645,11079715.png,443815,110349,333466,0.7513626173067607,5,6,124136,15456,108680,0.8754913965328349,17.57312,2279.878944,14.551685732308561,129,5.0E-4
10,test_20231031_152645,11551286.png,271883,267,271616,0.9990179599312939,2,6,40092,37,40055,0.9990771226179787,18.016108444444445,1877.54488,15.394900338849709,129,5.0E-4
1,test_20231031_152646,10404007.png,502730,16847,485883,0.9664889702225847,4,6,61265,2450,58815,0.9600097935199543,26.172988444444446,3556.890048,12.62009920558409,129,6.000000000000001E-4
2,test_20231031_152646,1254659.png,342646,67139,275507,0.8040572485889227,5,6,80080,9434,70646,0.8821928071928072,21.694814222222224,3426.7694133333334,12.781954790485319,129,6.000000000000001E-4
3,test_20231031_152646,10188041.png,221231,8687,212544,0.9607333511126379,3,6,41731,1231,40500,0.9705015456135726,11.477532444444444,1204.0505066666667,17.324356560835014,129,6.000000000000001E-4
4,test_20231031_152646,10287332.png,216980,11579,205401,0.9466356346207023,2,5,22337,1590,20747,0.9288176568026145,9.629411555555556,829.9726293333333,18.940165903297878,129,6.000000000000001E-4
5,test_20231031_152646,11610969.png,368720,21809,346911,0.9408521371230202,3,6,84111,3190,80921,0.9620739261214347,23.338673777777778,3382.608032,12.838286851023904,129,6.000000000000001E-4
6,test_20231031_152646,10350842.png,212614,5279,207335,0.9751709671047062,3,6,42529,776,41753,0.9817536269369136,19.566787555555557,2433.533258666667,14.268430748223048,129,6.000000000000001E-4
7,test_20231031_152646,10863862.png,317432,7459,309973,0.9765020539832153,2,5,66058,1091,64967,0.983484210845015,35.780739555555556,6527.049354666667,9.983634642163107,129,6.000000000000001E-4
8,test_20231031_152646,11382381.png,312486,567,311919,0.9981855187112383,3,6,46745,75,46670,0.9983955503262381,22.72423288888889,2714.741744,13.793518398308729,129,6.000000000000001E-4
9,test_20231031_152646,11079715.png,443815,110169,333646,0.7517681917014972,5,6,124136,15429,108707,0.8757088999162209,17.810384,2321.88808,14.47239078889067,129,6.000000000000001E-4
10,test_20231031_152646,11551286.png,271883,267,271616,0.9990179599312939,2,5,40092,37,40055,0.9990771226179787,18.016108444444445,1877.54488,15.394900338849709,129,6.000000000000001E-4
1,test_20231031_152647,10404007.png,502730,16847,485883,0.9664889702225847,4,6,61265,2450,58815,0.9600097935199543,26.172988444444446,3556.890048,12.62009920558409,129,7.000000000000001E-4
2,test_20231031_152647,1254659.png,342646,67139,275507,0.8040572485889227,5,7,80080,9434,70646,0.8821928071928072,21.694814222222224,3426.7694133333334,12.781954790485319,129,7.000000000000001E-4
3,test_20231031_152647,10188041.png,221231,8687,212544,0.9607333511126379,3,5,41731,1231,40500,0.9705015456135726,11.477532444444444,1204.0505066666667,17.324356560835014,129,7.000000000000001E-4
4,test_20231031_152647,10287332.png,216980,11579,205401,0.9466356346207023,2,5,22337,1590,20747,0.9288176568026145,9.629411555555556,829.9726293333333,18.940165903297878,129,7.000000000000001E-4
5,test_20231031_152647,11610969.png,368720,21809,346911,0.9408521371230202,4,6,84111,3190,80921,0.9620739261214347,23.338673777777778,3382.608032,12.838286851023904,129,7.000000000000001E-4
6,test_20231031_152647,10350842.png,212614,5279,207335,0.9751709671047062,3,6,42529,776,41753,0.9817536269369136,19.566787555555557,2433.533258666667,14.268430748223048,129,7.000000000000001E-4
7,test_20231031_152647,10863862.png,317432,7459,309973,0.9765020539832153,3,6,66058,1091,64967,0.983484210845015,35.780739555555556,6527.049354666667,9.983634642163107,129,7.000000000000001E-4
8,test_20231031_152647,11382381.png,312486,567,311919,0.9981855187112383,2,6,46745,75,46670,0.9983955503262381,22.72423288888889,2714.741744,13.793518398308729,129,7.000000000000001E-4
9,test_20231031_152647,11079715.png,443815,110169,333646,0.7517681917014972,5,6,124136,15429,108707,0.8757088999162209,17.810384,2321.88808,14.47239078889067,129,7.000000000000001E-4
10,test_20231031_152647,11551286.png,271883,267,271616,0.9990179599312939,2,6,40092,37,40055,0.9990771226179787,18.016108444444445,1877.54488,15.394900338849709,129,7.000000000000001E-4
1,test_20231031_152648,10404007.png,502730,16787,485943,0.9666083185805502,3,6,61265,2441,58824,0.9601566963192687,26.176508444444444,3557.550464,12.61929291582764,129,8.000000000000001E-4
2,test_20231031_152648,1254659.png,342646,67139,275507,0.8040572485889227,5,6,80080,9434,70646,0.8821928071928072,21.694814222222224,3426.7694133333334,12.781954790485319,129,8.000000000000001E-4
3,test_20231031_152648,10188041.png,221231,8607,212624,0.9610949640873114,3,6,41731,1221,40510,0.9707411756248353,11.516433777777777,1208.135008,17.30964891853339,129,8.000000000000001E-4
4,test_20231031_152648,10287332.png,216980,11579,205401,0.9466356346207023,3,6,22337,1590,20747,0.9288176568026145,9.629411555555556,829.9726293333333,18.940165903297878,129,8.000000000000001E-4
5,test_20231031_152648,11610969.png,368720,21789,346931,0.9409063788240399,4,6,84111,3189,80922,0.9620858151728073,23.444323555555556,3392.786112,12.825238791497249,129,8.000000000000001E-4
6,test_20231031_152648,10350842.png,212614,4254,208360,0.9799919102222807,3,6,42529,624,41905,0.9853276587740131,23.09414577777778,3256.7716213333333,13.002930558100143,129,8.000000000000001E-4
7,test_20231031_152648,10863862.png,317432,7459,309973,0.9765020539832153,2,5,66058,1091,64967,0.983484210845015,35.780739555555556,6527.049354666667,9.983634642163107,129,8.000000000000001E-4
8,test_20231031_152648,11382381.png,312486,567,311919,0.9981855187112383,2,5,46745,75,46670,0.9983955503262381,22.72423288888889,2714.741744,13.793518398308729,129,8.000000000000001E-4
9,test_20231031_152648,11079715.png,443815,110169,333646,0.7517681917014972,5,7,124136,15429,108707,0.8757088999162209,17.810384,2321.88808,14.47239078889067,129,8.000000000000001E-4
10,test_20231031_152648,11551286.png,271883,267,271616,0.9990179599312939,2,5,40092,37,40055,0.9990771226179787,18.016108444444445,1877.54488,15.394900338849709,129,8.000000000000001E-4
1,test_20231031_152649,10404007.png,502730,16787,485943,0.9666083185805502,4,6,61265,2441,58824,0.9601566963192687,26.176508444444444,3557.550464,12.61929291582764,129,9.000000000000002E-4
2,test_20231031_152649,1254659.png,342646,67139,275507,0.8040572485889227,5,6,80080,9434,70646,0.8821928071928072,21.694814222222224,3426.7694133333334,12.781954790485319,129,9.000000000000002E-4
3,test_20231031_152649,10188041.png,221231,8607,212624,0.9610949640873114,3,5,41731,1221,40510,0.9707411756248353,11.516433777777777,1208.135008,17.30964891853339,129,9.000000000000002E-4
4,test_20231031_152649,10287332.png,216980,11579,205401,0.9466356346207023,3,6,22337,1590,20747,0.9288176568026145,9.629411555555556,829.9726293333333,18.940165903297878,129,9.000000000000002E-4
5,test_20231031_152649,11610969.png,368720,21789,346931,0.9409063788240399,4,5,84111,3189,80922,0.9620858151728073,23.444323555555556,3392.786112,12.825238791497249,129,9.000000000000002E-4
6,test_20231031_152649,10350842.png,212614,3732,208882,0.9824470636928895,3,6,42529,546,41983,0.9871617014272615,24.194565333333333,3524.7187893333335,12.659558872319822,129,9.000000000000002E-4
7,test_20231031_152649,10863862.png,317432,7459,309973,0.9765020539832153,2,5,66058,1091,64967,0.983484210845015,35.780739555555556,6527.049354666667,9.983634642163107,129,9.000000000000002E-4
8,test_20231031_152649,11382381.png,312486,567,311919,0.9981855187112383,2,6,46745,75,46670,0.9983955503262381,22.72423288888889,2714.741744,13.793518398308729,129,9.000000000000002E-4
9,test_20231031_152649,11079715.png,443815,110169,333646,0.7517681917014972,5,6,124136,15429,108707,0.8757088999162209,17.810384,2321.88808,14.47239078889067,129,9.000000000000002E-4
10,test_20231031_152649,11551286.png,271883,267,271616,0.9990179599312939,2,5,40092,37,40055,0.9990771226179787,18.016108444444445,1877.54488,15.394900338849709,129,9.000000000000002E-4
1,test_20231031_152650,10404007.png,502730,16102,486628,0.9679708790006564,4,6,61265,2344,58921,0.9617399820452134,26.247559111111112,3577.6051413333334,12.594879548777731,129,0.0010000000000000002
2,test_20231031_152650,1254659.png,342646,66959,275687,0.804582572100652,5,6,80080,9417,70663,0.8824050949050949,21.778970666666666,3445.463738666667,12.758326772687315,129,0.0010000000000000002
3,test_20231031_152650,10188041.png,221231,8364,212867,0.9621933634978823,2,5,41731,1196,40535,0.9713402506529918,11.78519111111111,1274.0269866666667,17.079017334680383,129,0.0010000000000000002
4,test_20231031_152650,10287332.png,216980,11499,205481,0.9470043321965158,3,6,22337,1578,20759,0.9293548820342928,9.654972444444445,834.1426026666667,18.918400581233193,129,0.0010000000000000002
5,test_20231031_152650,11610969.png,368720,21487,347233,0.9417254285094381,4,5,84111,3149,80962,0.962561377227711,23.572757333333332,3412.3761066666666,12.800234684873093,129,0.0010000000000000002
6,test_20231031_152650,10350842.png,212614,3472,209142,0.9836699370690547,2,5,42529,507,42022,0.9880787227538855,24.338956444444445,3551.941168,12.626145970678104,129,0.0010000000000000002
7,test_20231031_152650,10863862.png,317432,7339,310093,0.9768800877038232,2,5,66058,1073,64985,0.9837566986587545,35.80773688888889,6532.084981333333,9.980285346679377,129,0.0010000000000000002
8,test_20231031_152650,11382381.png,312486,367,312119,0.9988255473845228,2,6,46745,48,46697,0.9989731522087923,23.28773511111111,2886.24232,13.527475705549977,129,0.0010000000000000002
9,test_20231031_152650,11079715.png,443815,110067,333748,0.7519980171918479,5,7,124136,15419,108717,0.8757894567248824,17.849096888888887,2328.1813813333333,14.460635490465751,129,0.0010000000000000002
10,test_20231031_152650,11551286.png,271883,224,271659,0.9991761161970406,2,5,40092,31,40061,0.9992267784096578,18.06671822222222,1885.25176,15.377110059665014,129,0.0010000000000000002
1,test_20231031_152651,10404007.png,502730,16102,486628,0.9679708790006564,4,6,61265,2344,58921,0.9617399820452134,26.247559111111112,3577.6051413333334,12.594879548777731,129,0.0011000000000000003
2,test_20231031_152651,1254659.png,342646,66959,275687,0.804582572100652,4,6,80080,9417,70663,0.8824050949050949,21.778970666666666,3445.463738666667,12.758326772687315,129,0.0011000000000000003
3,test_20231031_152651,10188041.png,221231,8364,212867,0.9621933634978823,3,6,41731,1196,40535,0.9713402506529918,11.78519111111111,1274.0269866666667,17.079017334680383,129,0.0011000000000000003
4,test_20231031_152651,10287332.png,216980,11359,205621,0.9476495529541893,3,6,22337,1557,20780,0.93029502618973,9.722624,845.141568,18.86150898011064,129,0.0011000000000000003
5,test_20231031_152651,11610969.png,368720,21487,347233,0.9417254285094381,4,6,84111,3149,80962,0.962561377227711,23.572757333333332,3412.3761066666666,12.800234684873093,129,0.0011000000000000003
6,test_20231031_152651,10350842.png,212614,3472,209142,0.9836699370690547,3,6,42529,507,42022,0.9880787227538855,24.338956444444445,3551.941168,12.626145970678104,129,0.0011000000000000003
7,test_20231031_152651,10863862.png,317432,7319,310113,0.9769430933239245,3,6,66058,1070,64988,0.9838021132943777,35.90948622222222,6573.747264,9.952673578001443,129,0.0011000000000000003
8,test_20231031_152651,11382381.png,312486,367,312119,0.9988255473845228,2,6,46745,48,46697,0.9989731522087923,23.28773511111111,2886.24232,13.527475705549977,129,0.0011000000000000003
9,test_20231031_152651,11079715.png,443815,110047,333768,0.7520430810134854,6,7,124136,15417,108719,0.8758055680866147,17.86620977777778,2332.8351946666667,14.451963021320246,129,0.0011000000000000003
10,test_20231031_152651,11551286.png,271883,224,271659,0.9991761161970406,3,5,40092,31,40061,0.9992267784096578,18.06671822222222,1885.25176,15.377110059665014,129,0.0011000000000000003
1,test_20231031_152652,10404007.png,502730,15479,487251,0.9692101127841983,3,6,61265,2254,59011,0.9632090100383579,26.614992,3659.324208,12.496794721498617,129,0.0012000000000000003
2,test_20231031_152652,1254659.png,342646,66959,275687,0.804582572100652,5,6,80080,9417,70663,0.8824050949050949,21.778970666666666,3445.463738666667,12.758326772687315,129,0.0012000000000000003
3,test_20231031_152652,10188041.png,221231,8364,212867,0.9621933634978823,2,5,41731,1196,40535,0.9713402506529918,11.78519111111111,1274.0269866666667,17.079017334680383,129,0.0012000000000000003
4,test_20231031_152652,10287332.png,216980,11359,205621,0.9476495529541893,3,6,22337,1557,20780,0.93029502618973,9.722624,845.141568,18.86150898011064,129,0.0012000000000000003
5,test_20231031_152652,11610969.png,368720,21487,347233,0.9417254285094381,4,6,84111,3149,80962,0.962561377227711,23.572757333333332,3412.3761066666666,12.800234684873093,129,0.0012000000000000003
6,test_20231031_152652,10350842.png,212614,3472,209142,0.9836699370690547,2,6,42529,507,42022,0.9880787227538855,24.338956444444445,3551.941168,12.626145970678104,129,0.0012000000000000003
7,test_20231031_152652,10863862.png,317432,7319,310113,0.9769430933239245,3,5,66058,1070,64988,0.9838021132943777,35.90948622222222,6573.747264,9.952673578001443,129,0.0012000000000000003
8,test_20231031_152652,11382381.png,312486,367,312119,0.9988255473845228,2,5,46745,48,46697,0.9989731522087923,23.28773511111111,2886.24232,13.527475705549977,129,0.0012000000000000003
9,test_20231031_152652,11079715.png,443815,110047,333768,0.7520430810134854,5,7,124136,15417,108719,0.8758055680866147,17.86620977777778,2332.8351946666667,14.451963021320246,129,0.0012000000000000003
10,test_20231031_152652,11551286.png,271883,224,271659,0.9991761161970406,3,6,40092,31,40061,0.9992267784096578,18.06671822222222,1885.25176,15.377110059665014,129,0.0012000000000000003
1,test_20231031_152653,10404007.png,502730,15479,487251,0.9692101127841983,3,6,61265,2254,59011,0.9632090100383579,26.614992,3659.324208,12.496794721498617,129,0.0013000000000000004
2,test_20231031_152653,1254659.png,342646,66959,275687,0.804582572100652,4,6,80080,9417,70663,0.8824050949050949,21.778970666666666,3445.463738666667,12.758326772687315,129,0.0013000000000000004
3,test_20231031_152653,10188041.png,221231,8202,213029,0.9629256297715962,3,5,41731,1180,40551,0.971723658671012,12.053070222222223,1324.7760746666668,16.909378846744413,129,0.0013000000000000004
4,test_20231031_152653,10287332.png,216980,11359,205621,0.9476495529541893,3,6,22337,1557,20780,0.93029502618973,9.722624,845.141568,18.86150898011064,129,0.0013000000000000004
5,test_20231031_152653,11610969.png,368720,21487,347233,0.9417254285094381,4,6,84111,3149,80962,0.962561377227711,23.572757333333332,3412.3761066666666,12.800234684873093,129,0.0013000000000000004
6,test_20231031_152653,10350842.png,212614,3472,209142,0.9836699370690547,2,5,42529,507,42022,0.9880787227538855,24.338956444444445,3551.941168,12.626145970678104,129,0.0013000000000000004
7,test_20231031_152653,10863862.png,317432,6737,310695,0.9787765568688727,3,6,66058,984,65074,0.9851039995155773,37.10932088888889,6887.987941333334,9.749879827325582,129,0.0013000000000000004
8,test_20231031_152653,11382381.png,312486,367,312119,0.9988255473845228,2,6,46745,48,46697,0.9989731522087923,23.28773511111111,2886.24232,13.527475705549977,129,0.0013000000000000004
9,test_20231031_152653,11079715.png,443815,110047,333768,0.7520430810134854,5,7,124136,15417,108719,0.8758055680866147,17.86620977777778,2332.8351946666667,14.451963021320246,129,0.0013000000000000004
10,test_20231031_152653,11551286.png,271883,24,271859,0.9999117267353972,1,6,40092,1,40091,0.9999750573680535,24.866876444444443,3470.407338666667,12.72699907819776,129,0.0013000000000000004
1,test_20231031_152654,10404007.png,502730,15479,487251,0.9692101127841983,3,5,61265,2254,59011,0.9632090100383579,26.614992,3659.324208,12.496794721498617,129,0.0014000000000000004
2,test_20231031_152654,1254659.png,342646,66959,275687,0.804582572100652,4,7,80080,9417,70663,0.8824050949050949,21.778970666666666,3445.463738666667,12.758326772687315,129,0.0014000000000000004
3,test_20231031_152654,10188041.png,221231,8202,213029,0.9629256297715962,3,17,41731,1180,40551,0.971723658671012,12.053070222222223,1324.7760746666668,16.909378846744413,129,0.0014000000000000004
4,test_20231031_152654,10287332.png,216980,11359,205621,0.9476495529541893,2,5,22337,1557,20780,0.93029502618973,9.722624,845.141568,18.86150898011064,129,0.0014000000000000004
5,test_20231031_152654,11610969.png,368720,21487,347233,0.9417254285094381,3,5,84111,3149,80962,0.962561377227711,23.572757333333332,3412.3761066666666,12.800234684873093,129,0.0014000000000000004
6,test_20231031_152654,10350842.png,212614,3472,209142,0.9836699370690547,2,6,42529,507,42022,0.9880787227538855,24.338956444444445,3551.941168,12.626145970678104,129,0.0014000000000000004
7,test_20231031_152654,10863862.png,317432,6737,310695,0.9787765568688727,2,6,66058,984,65074,0.9851039995155773,37.10932088888889,6887.987941333334,9.749879827325582,129,0.0014000000000000004
8,test_20231031_152654,11382381.png,312486,367,312119,0.9988255473845228,2,19,46745,48,46697,0.9989731522087923,23.28773511111111,2886.24232,13.527475705549977,129,0.0014000000000000004
9,test_20231031_152654,11079715.png,443815,110047,333768,0.7520430810134854,6,6,124136,15417,108719,0.8758055680866147,17.86620977777778,2332.8351946666667,14.451963021320246,129,0.0014000000000000004
10,test_20231031_152654,11551286.png,271883,24,271859,0.9999117267353972,1,5,40092,1,40091,0.9999750573680535,24.866876444444443,3470.407338666667,12.72699907819776,129,0.0014000000000000004
1,test_20231031_152655,10404007.png,502730,16402,486328,0.9673741372108289,3,6,61265,2384,58881,0.961087080714927,26.161904,3559.777616,12.61657492996368,130,1.0E-4
2,test_20231031_152655,1254659.png,342646,65252,277394,0.8095643900702183,4,6,80080,9171,70909,0.885477022977023,21.881578666666666,3492.428917333333,12.699527853441253,130,1.0E-4
3,test_20231031_152655,10188041.png,221231,8404,212827,0.9620125570105456,3,17,41731,1193,40538,0.9714121396563705,11.447850666666668,1280.5076586666667,17.056981805572335,130,1.0E-4
4,test_20231031_152655,10287332.png,216980,11449,205531,0.9472347681813992,2,5,22337,1574,20763,0.929533957111519,9.561258666666667,823.894464,18.97208776158452,130,1.0E-4
5,test_20231031_152655,11610969.png,368720,21407,347313,0.9419423953135171,3,6,84111,3130,80981,0.9627872692037902,22.610574222222223,3255.403008,13.004756004317752,130,1.0E-4
6,test_20231031_152655,10350842.png,212614,4817,207797,0.977343919026969,2,6,42529,707,41822,0.983376049284018,19.67007111111111,2460.5717813333335,14.22044321803745,130,1.0E-4
7,test_20231031_152655,10863862.png,317432,7439,309993,0.9765650596033166,3,6,66058,1092,64966,0.9834690726331405,35.67820088888889,6511.628522666667,9.993907440417022,130,1.0E-4
8,test_20231031_152655,11382381.png,312486,817,311669,0.9973854828696326,3,6,46745,112,46633,0.9976040218205156,21.216531555555555,2458.9940213333334,14.223228880483061,130,1.0E-4
9,test_20231031_152655,11079715.png,443815,107837,335978,0.7570226333044174,6,7,124136,15131,109005,0.8781094928143327,17.708771555555554,2317.625856,14.480370335498858,130,1.0E-4
10,test_20231031_152655,11551286.png,271883,657,271226,0.9975835193814987,2,5,40092,95,39997,0.9976304499650803,17.08696,1727.1593013333334,15.75747965107392,130,1.0E-4
1,test_20231031_152656,10404007.png,502730,16402,486328,0.9673741372108289,4,6,61265,2384,58881,0.961087080714927,26.161904,3559.777616,12.61657492996368,130,2.0E-4
2,test_20231031_152656,1254659.png,342646,65252,277394,0.8095643900702183,4,6,80080,9171,70909,0.885477022977023,21.881578666666666,3492.428917333333,12.699527853441253,130,2.0E-4
3,test_20231031_152656,10188041.png,221231,8404,212827,0.9620125570105456,2,15,41731,1193,40538,0.9714121396563705,11.447850666666668,1280.5076586666667,17.056981805572335,130,2.0E-4
4,test_20231031_152656,10287332.png,216980,11257,205723,0.9481196423633514,3,8,22337,1550,20787,0.9306084075748757,9.689633777777777,850.2091146666667,18.835546043579313,130,2.0E-4
5,test_20231031_152656,11610969.png,368720,21407,347313,0.9419423953135171,3,5,84111,3130,80981,0.9627872692037902,22.610574222222223,3255.403008,13.004756004317752,130,2.0E-4
6,test_20231031_152656,10350842.png,212614,4817,207797,0.977343919026969,2,6,42529,707,41822,0.983376049284018,19.67007111111111,2460.5717813333335,14.22044321803745,130,2.0E-4
7,test_20231031_152656,10863862.png,317432,7439,309993,0.9765650596033166,2,5,66058,1092,64966,0.9834690726331405,35.67820088888889,6511.628522666667,9.993907440417022,130,2.0E-4
8,test_20231031_152656,11382381.png,312486,707,311779,0.9977374986399391,3,6,46745,96,46649,0.9979463044175848,21.47300977777778,2499.126186666667,14.152921756540431,130,2.0E-4
9,test_20231031_152656,11079715.png,443815,107837,335978,0.7570226333044174,5,7,124136,15131,109005,0.8781094928143327,17.708771555555554,2317.625856,14.480370335498858,130,2.0E-4
10,test_20231031_152656,11551286.png,271883,267,271616,0.9990179599312939,2,5,40092,37,40055,0.9990771226179787,17.919265777777778,1867.1754613333333,15.418952296845859,130,2.0E-4
1,test_20231031_152657,10404007.png,502730,16282,486448,0.9676128339267599,3,6,61265,2367,58898,0.9613645637802987,26.166622222222223,3560.861381333333,12.615252932576213,130,3.0000000000000003E-4
2,test_20231031_152657,1254659.png,342646,65192,277454,0.8097394979074614,4,6,80080,9165,70915,0.885551948051948,21.891132444444445,3493.511104,12.698182328858888,130,3.0000000000000003E-4
3,test_20231031_152657,10188041.png,221231,8364,212867,0.9621933634978823,3,6,41731,1187,40544,0.9715559176631281,11.813678222222222,1332.7883626666667,16.88319168860807,130,3.0000000000000003E-4
4,test_20231031_152657,10287332.png,216980,11257,205723,0.9481196423633514,3,6,22337,1550,20787,0.9306084075748757,9.689633777777777,850.2091146666667,18.835546043579313,130,3.0000000000000003E-4
5,test_20231031_152657,11610969.png,368720,21127,347593,0.9427017791277934,4,6,84111,3090,81021,0.9632628312586938,23.026140444444444,3340.5999893333333,12.892558854769415,130,3.0000000000000003E-4
6,test_20231031_152657,10350842.png,212614,4817,207797,0.977343919026969,4,5,42529,707,41822,0.983376049284018,19.67007111111111,2460.5717813333335,14.22044321803745,130,3.0000000000000003E-4
7,test_20231031_152657,10863862.png,317432,7399,310033,0.9766910708435192,3,6,66058,1086,64972,0.983559901904387,35.68389688888889,6512.697578666666,9.993194489713737,130,3.0000000000000003E-4
8,test_20231031_152657,11382381.png,312486,587,311899,0.9981215158439098,2,5,46745,78,46667,0.9983313723392876,21.967536,2569.068496,14.03304677372966,130,3.0000000000000003E-4
9,test_20231031_152657,11079715.png,443815,107837,335978,0.7570226333044174,5,6,124136,15131,109005,0.8781094928143327,17.708771555555554,2317.625856,14.480370335498858,130,3.0000000000000003E-4
10,test_20231031_152657,11551286.png,271883,204,271679,0.9992496772508763,2,5,40092,28,40064,0.9993016063054974,18.067507555555554,1885.468496,15.37661080624634,130,3.0000000000000003E-4
1,test_20231031_152658,10404007.png,502730,16122,486608,0.9679310962146679,3,6,61265,2344,58921,0.9617399820452134,26.208451555555556,3568.336864,12.606145142471787,130,4.0E-4
2,test_20231031_152658,1254659.png,342646,65192,277454,0.8097394979074614,5,12,80080,9165,70915,0.885551948051948,21.891132444444445,3493.511104,12.698182328858888,130,4.0E-4
3,test_20231031_152658,10188041.png,221231,8364,212867,0.9621933634978823,3,6,41731,1187,40544,0.9715559176631281,11.813678222222222,1332.7883626666667,16.88319168860807,130,4.0E-4
4,test_20231031_152658,10287332.png,216980,11257,205723,0.9481196423633514,3,6,22337,1550,20787,0.9306084075748757,9.689633777777777,850.2091146666667,18.835546043579313,130,4.0E-4
5,test_20231031_152658,11610969.png,368720,21127,347593,0.9427017791277934,4,7,84111,3090,81021,0.9632628312586938,23.026140444444444,3340.5999893333333,12.892558854769415,130,4.0E-4
6,test_20231031_152658,10350842.png,212614,4817,207797,0.977343919026969,3,6,42529,707,41822,0.983376049284018,19.67007111111111,2460.5717813333335,14.22044321803745,130,4.0E-4
7,test_20231031_152658,10863862.png,317432,7399,310033,0.9766910708435192,2,6,66058,1086,64972,0.983559901904387,35.68389688888889,6512.697578666666,9.993194489713737,130,4.0E-4
8,test_20231031_152658,11382381.png,312486,587,311899,0.9981215158439098,2,6,46745,78,46667,0.9983313723392876,21.967536,2569.068496,14.03304677372966,130,4.0E-4
9,test_20231031_152658,11079715.png,443815,107837,335978,0.7570226333044174,6,8,124136,15131,109005,0.8781094928143327,17.708771555555554,2317.625856,14.480370335498858,130,4.0E-4
10,test_20231031_152658,11551286.png,271883,204,271679,0.9992496772508763,2,7,40092,28,40064,0.9993016063054974,18.067507555555554,1885.468496,15.37661080624634,130,4.0E-4
1,test_20231031_152659,10404007.png,502730,16122,486608,0.9679310962146679,5,7,61265,2344,58921,0.9617399820452134,26.208451555555556,3568.336864,12.606145142471787,130,5.0E-4
2,test_20231031_152659,1254659.png,342646,65192,277454,0.8097394979074614,5,8,80080,9165,70915,0.885551948051948,21.891132444444445,3493.511104,12.698182328858888,130,5.0E-4
3,test_20231031_152659,10188041.png,221231,8364,212867,0.9621933634978823,4,7,41731,1187,40544,0.9715559176631281,11.813678222222222,1332.7883626666667,16.88319168860807,130,5.0E-4
4,test_20231031_152659,10287332.png,216980,11257,205723,0.9481196423633514,4,6,22337,1550,20787,0.9306084075748757,9.689633777777777,850.2091146666667,18.835546043579313,130,5.0E-4
5,test_20231031_152659,11610969.png,368720,21127,347593,0.9427017791277934,5,7,84111,3090,81021,0.9632628312586938,23.026140444444444,3340.5999893333333,12.892558854769415,130,5.0E-4
6,test_20231031_152659,10350842.png,212614,4817,207797,0.977343919026969,3,7,42529,707,41822,0.983376049284018,19.67007111111111,2460.5717813333335,14.22044321803745,130,5.0E-4
7,test_20231031_152659,10863862.png,317432,7399,310033,0.9766910708435192,2,5,66058,1086,64972,0.983559901904387,35.68389688888889,6512.697578666666,9.993194489713737,130,5.0E-4
8,test_20231031_152659,11382381.png,312486,567,311919,0.9981855187112383,2,6,46745,75,46670,0.9983955503262381,22.72423288888889,2714.741744,13.793518398308729,130,5.0E-4
9,test_20231031_152659,11079715.png,443815,107837,335978,0.7570226333044174,5,7,124136,15131,109005,0.8781094928143327,17.708771555555554,2317.625856,14.480370335498858,130,5.0E-4
10,test_20231031_152659,11551286.png,271883,204,271679,0.9992496772508763,2,5,40092,28,40064,0.9993016063054974,18.067507555555554,1885.468496,15.37661080624634,130,5.0E-4
1,test_20231031_152701,10404007.png,502730,16122,486608,0.9679310962146679,4,6,61265,2344,58921,0.9617399820452134,26.208451555555556,3568.336864,12.606145142471787,130,6.000000000000001E-4
2,test_20231031_152701,1254659.png,342646,65192,277454,0.8097394979074614,5,6,80080,9165,70915,0.885551948051948,21.891132444444445,3493.511104,12.698182328858888,130,6.000000000000001E-4
3,test_20231031_152701,10188041.png,221231,8202,213029,0.9629256297715962,3,6,41731,1165,40566,0.9720831036879058,12.03271111111111,1366.8562453333334,16.7735751941011,130,6.000000000000001E-4
4,test_20231031_152701,10287332.png,216980,11257,205723,0.9481196423633514,2,11,22337,1550,20787,0.9306084075748757,9.689633777777777,850.2091146666667,18.835546043579313,130,6.000000000000001E-4
5,test_20231031_152701,11610969.png,368720,21087,347633,0.9428102625298329,4,6,84111,3086,81025,0.9633103874641842,23.404170666666666,3403.7126293333336,12.811274747794313,130,6.000000000000001E-4
6,test_20231031_152701,10350842.png,212614,4737,207877,0.9777201877580969,3,6,42529,695,41834,0.9836582096922101,19.730252444444446,2470.973925333333,14.202121982839607,130,6.000000000000001E-4
7,test_20231031_152701,10863862.png,317432,7319,310113,0.9769430933239245,2,5,66058,1074,64984,0.98374156044688,35.801813333333335,6532.50336,9.980007190886644,130,6.000000000000001E-4
8,test_20231031_152701,11382381.png,312486,567,311919,0.9981855187112383,2,5,46745,75,46670,0.9983955503262381,22.72423288888889,2714.741744,13.793518398308729,130,6.000000000000001E-4
9,test_20231031_152701,11079715.png,443815,107657,336158,0.7574282076991539,5,6,124136,15104,109032,0.8783269961977186,17.946035555555557,2359.634992,14.402355329911469,130,6.000000000000001E-4
10,test_20231031_152701,11551286.png,271883,164,271719,0.9993967993585476,2,5,40092,22,40070,0.9994512620971765,18.120286222222223,1899.5769013333334,15.344234809036362,130,6.000000000000001E-4
1,test_20231031_152702,10404007.png,502730,16122,486608,0.9679310962146679,5,5,61265,2344,58921,0.9617399820452134,26.208451555555556,3568.336864,12.606145142471787,130,7.000000000000001E-4
2,test_20231031_152702,1254659.png,342646,65192,277454,0.8097394979074614,5,6,80080,9165,70915,0.885551948051948,21.891132444444445,3493.511104,12.698182328858888,130,7.000000000000001E-4
3,test_20231031_152702,10188041.png,221231,8122,213109,0.9632872427462698,3,6,41731,1155,40576,0.9723227336991684,12.071612444444444,1370.9407466666667,16.760616762839437,130,7.000000000000001E-4
4,test_20231031_152702,10287332.png,216980,11257,205723,0.9481196423633514,2,5,22337,1550,20787,0.9306084075748757,9.689633777777777,850.2091146666667,18.835546043579313,130,7.000000000000001E-4
5,test_20231031_152702,11610969.png,368720,21087,347633,0.9428102625298329,3,5,84111,3086,81025,0.9633103874641842,23.404170666666666,3403.7126293333336,12.811274747794313,130,7.000000000000001E-4
6,test_20231031_152702,10350842.png,212614,4737,207877,0.9777201877580969,2,6,42529,695,41834,0.9836582096922101,19.730252444444446,2470.973925333333,14.202121982839607,130,7.000000000000001E-4
7,test_20231031_152702,10863862.png,317432,7319,310113,0.9769430933239245,3,6,66058,1074,64984,0.98374156044688,35.801813333333335,6532.50336,9.980007190886644,130,7.000000000000001E-4
8,test_20231031_152702,11382381.png,312486,567,311919,0.9981855187112383,2,5,46745,75,46670,0.9983955503262381,22.72423288888889,2714.741744,13.793518398308729,130,7.000000000000001E-4
9,test_20231031_152702,11079715.png,443815,107657,336158,0.7574282076991539,5,7,124136,15104,109032,0.8783269961977186,17.946035555555557,2359.634992,14.402355329911469,130,7.000000000000001E-4
10,test_20231031_152702,11551286.png,271883,164,271719,0.9993967993585476,2,6,40092,22,40070,0.9994512620971765,18.120286222222223,1899.5769013333334,15.344234809036362,130,7.000000000000001E-4
1,test_20231031_152703,10404007.png,502730,16062,486668,0.9680504445726335,4,6,61265,2335,58930,0.9618868848445279,26.211971555555557,3568.99728,12.605341438961224,130,8.000000000000001E-4
2,test_20231031_152703,1254659.png,342646,65192,277454,0.8097394979074614,5,6,80080,9165,70915,0.885551948051948,21.891132444444445,3493.511104,12.698182328858888,130,8.000000000000001E-4
3,test_20231031_152703,10188041.png,221231,8122,213109,0.9632872427462698,3,5,41731,1155,40576,0.9723227336991684,12.071612444444444,1370.9407466666667,16.760616762839437,130,8.000000000000001E-4
4,test_20231031_152703,10287332.png,216980,11257,205723,0.9481196423633514,3,6,22337,1550,20787,0.9306084075748757,9.689633777777777,850.2091146666667,18.835546043579313,130,8.000000000000001E-4
5,test_20231031_152703,11610969.png,368720,21067,347653,0.9428645042308527,4,6,84111,3085,81026,0.9633222765155568,23.509820444444443,3413.8907093333332,12.798307471627746,130,8.000000000000001E-4
6,test_20231031_152703,10350842.png,212614,3732,208882,0.9824470636928895,2,5,42529,546,41983,0.9871617014272615,23.254716444444444,3293.3420266666667,12.954435246046875,130,8.000000000000001E-4
7,test_20231031_152703,10863862.png,317432,7077,310355,0.9777054613271504,3,6,66058,1039,65019,0.9842713978624845,36.419152,6690.678650666667,9.87610189394349,130,8.000000000000001E-4
8,test_20231031_152703,11382381.png,312486,567,311919,0.9981855187112383,2,6,46745,75,46670,0.9983955503262381,22.72423288888889,2714.741744,13.793518398308729,130,8.000000000000001E-4
9,test_20231031_152703,11079715.png,443815,107637,336178,0.7574732715207914,5,6,124136,15102,109034,0.8783431075594509,17.963148444444446,2364.288805333333,14.393798349777816,130,8.000000000000001E-4
10,test_20231031_152703,11551286.png,271883,164,271719,0.9993967993585476,1,5,40092,22,40070,0.9994512620971765,18.120286222222223,1899.5769013333334,15.344234809036362,130,8.000000000000001E-4
1,test_20231031_152704,10404007.png,502730,16062,486668,0.9680504445726335,3,5,61265,2335,58930,0.9618868848445279,26.211971555555557,3568.99728,12.605341438961224,130,9.000000000000002E-4
2,test_20231031_152704,1254659.png,342646,65192,277454,0.8097394979074614,5,6,80080,9165,70915,0.885551948051948,21.891132444444445,3493.511104,12.698182328858888,130,9.000000000000002E-4
3,test_20231031_152704,10188041.png,221231,8122,213109,0.9632872427462698,3,6,41731,1155,40576,0.9723227336991684,12.071612444444444,1370.9407466666667,16.760616762839437,130,9.000000000000002E-4
4,test_20231031_152704,10287332.png,216980,11257,205723,0.9481196423633514,3,6,22337,1550,20787,0.9306084075748757,9.689633777777777,850.2091146666667,18.835546043579313,130,9.000000000000002E-4
5,test_20231031_152704,11610969.png,368720,21067,347653,0.9428645042308527,3,6,84111,3085,81026,0.9633222765155568,23.509820444444443,3413.8907093333332,12.798307471627746,130,9.000000000000002E-4
6,test_20231031_152704,10350842.png,212614,3269,209345,0.9846247189742915,2,5,42529,477,42052,0.9887841237743658,24.34659911111111,3559.0051413333335,12.617517454824732,130,9.000000000000002E-4
7,test_20231031_152704,10863862.png,317432,7077,310355,0.9777054613271504,3,6,66058,1039,65019,0.9842713978624845,36.419152,6690.678650666667,9.87610189394349,130,9.000000000000002E-4
8,test_20231031_152704,11382381.png,312486,567,311919,0.9981855187112383,2,6,46745,75,46670,0.9983955503262381,22.72423288888889,2714.741744,13.793518398308729,130,9.000000000000002E-4
9,test_20231031_152704,11079715.png,443815,107637,336178,0.7574732715207914,5,7,124136,15102,109034,0.8783431075594509,17.963148444444446,2364.288805333333,14.393798349777816,130,9.000000000000002E-4
10,test_20231031_152704,11551286.png,271883,164,271719,0.9993967993585476,2,6,40092,22,40070,0.9994512620971765,18.120286222222223,1899.5769013333334,15.344234809036362,130,9.000000000000002E-4
1,test_20231031_152705,10404007.png,502730,14797,487933,0.9705667057864062,3,15,61265,2153,59112,0.9648575858973313,26.675523555555557,3677.0935466666665,12.475756822407263,130,0.0010000000000000002
2,test_20231031_152705,1254659.png,342646,65009,277637,0.8102735768110528,4,6,80080,9147,70933,0.8857767232767233,21.97528888888889,3512.2054293333335,12.67500450952557,130,0.0010000000000000002
3,test_20231031_152705,10188041.png,221231,7982,213249,0.9639200654519484,3,5,41731,1142,40589,0.9726342527138099,12.194165333333334,1410.783392,16.63620022436401,130,0.0010000000000000002
4,test_20231031_152705,10287332.png,216980,11177,205803,0.9484883399391649,3,6,22337,1538,20799,0.9311456328065542,9.715194666666667,854.379088,18.814297509556095,130,0.0010000000000000002
5,test_20231031_152705,11610969.png,368720,20724,347996,0.9437947494033413,4,6,84111,3041,81070,0.9638453947759509,23.702741333333332,3441.175072,12.763735926731954,130,0.0010000000000000002
6,test_20231031_152705,10350842.png,212614,3027,209587,0.985762931885953,2,6,42529,441,42088,0.9896306049989418,24.490901333333333,3586.0659306666666,12.584620909620183,130,0.0010000000000000002
7,test_20231031_152705,10863862.png,317432,6977,310455,0.978020489427657,2,5,66058,1024,65034,0.9844984710406007,36.437904,6694.791408,9.873433107769149,130,0.0010000000000000002
8,test_20231031_152705,11382381.png,312486,367,312119,0.9988255473845228,2,6,46745,48,46697,0.9989731522087923,23.28773511111111,2886.24232,13.527475705549977,130,0.0010000000000000002
9,test_20231031_152705,11079715.png,443815,107537,336278,0.7576985906289783,5,7,124136,15092,109044,0.8784236643681124,18.001861333333334,2370.5821066666667,14.382253588780998,130,0.0010000000000000002
10,test_20231031_152705,11551286.png,271883,164,271719,0.9993967993585476,2,6,40092,22,40070,0.9994512620971765,18.120286222222223,1899.5769013333334,15.344234809036362,130,0.0010000000000000002
1,test_20231031_152706,10404007.png,502730,14797,487933,0.9705667057864062,3,6,61265,2153,59112,0.9648575858973313,26.675523555555557,3677.0935466666665,12.475756822407263,130,0.0011000000000000003
2,test_20231031_152706,1254659.png,342646,65009,277637,0.8102735768110528,5,6,80080,9147,70933,0.8857767232767233,21.97528888888889,3512.2054293333335,12.67500450952557,130,0.0011000000000000003
3,test_20231031_152706,10188041.png,221231,7982,213249,0.9639200654519484,3,6,41731,1142,40589,0.9726342527138099,12.194165333333334,1410.783392,16.63620022436401,130,0.0011000000000000003
4,test_20231031_152706,10287332.png,216980,11037,205943,0.9491335606968384,2,5,22337,1517,20820,0.9320857769619914,9.782846222222222,865.3780533333334,18.75874483914483,130,0.0011000000000000003
5,test_20231031_152706,11610969.png,368720,20724,347996,0.9437947494033413,4,6,84111,3041,81070,0.9638453947759509,23.702741333333332,3441.175072,12.763735926731954,130,0.0011000000000000003
6,test_20231031_152706,10350842.png,212614,3027,209587,0.985762931885953,2,5,42529,441,42088,0.9896306049989418,24.490901333333333,3586.0659306666666,12.584620909620183,130,0.0011000000000000003
7,test_20231031_152706,10863862.png,317432,6937,310495,0.9781465006678596,3,6,66058,1018,65040,0.9845893003118472,36.615482666666665,6765.759354666667,9.827638141790242,130,0.0011000000000000003
8,test_20231031_152706,11382381.png,312486,367,312119,0.9988255473845228,3,5,46745,48,46697,0.9989731522087923,23.28773511111111,2886.24232,13.527475705549977,130,0.0011000000000000003
9,test_20231031_152706,11079715.png,443815,107537,336278,0.7576985906289783,5,7,124136,15092,109044,0.8784236643681124,18.001861333333334,2370.5821066666667,14.382253588780998,130,0.0011000000000000003
10,test_20231031_152706,11551286.png,271883,24,271859,0.9999117267353972,0,5,40092,1,40091,0.9999750573680535,24.866876444444443,3470.407338666667,12.72699907819776,130,0.0011000000000000003
1,test_20231031_152707,10404007.png,502730,14797,487933,0.9705667057864062,3,5,61265,2153,59112,0.9648575858973313,26.675523555555557,3677.0935466666665,12.475756822407263,130,0.0012000000000000003
2,test_20231031_152707,1254659.png,342646,65009,277637,0.8102735768110528,5,6,80080,9147,70933,0.8857767232767233,21.97528888888889,3512.2054293333335,12.67500450952557,130,0.0012000000000000003
3,test_20231031_152707,10188041.png,221231,7982,213249,0.9639200654519484,3,6,41731,1142,40589,0.9726342527138099,12.194165333333334,1410.783392,16.63620022436401,130,0.0012000000000000003
4,test_20231031_152707,10287332.png,216980,11037,205943,0.9491335606968384,2,5,22337,1517,20820,0.9320857769619914,9.782846222222222,865.3780533333334,18.75874483914483,130,0.0012000000000000003
5,test_20231031_152707,11610969.png,368720,20724,347996,0.9437947494033413,4,6,84111,3041,81070,0.9638453947759509,23.702741333333332,3441.175072,12.763735926731954,130,0.0012000000000000003
6,test_20231031_152707,10350842.png,212614,3027,209587,0.985762931885953,2,6,42529,441,42088,0.9896306049989418,24.490901333333333,3586.0659306666666,12.584620909620183,130,0.0012000000000000003
7,test_20231031_152707,10863862.png,317432,6617,310815,0.9791545905894806,2,5,66058,970,65088,0.985315934481819,37.12214933333333,6892.519077333333,9.747023840343674,130,0.0012000000000000003
8,test_20231031_152707,11382381.png,312486,367,312119,0.9988255473845228,2,5,46745,48,46697,0.9989731522087923,23.28773511111111,2886.24232,13.527475705549977,130,0.0012000000000000003
9,test_20231031_152707,11079715.png,443815,107537,336278,0.7576985906289783,6,6,124136,15092,109044,0.8784236643681124,18.001861333333334,2370.5821066666667,14.382253588780998,130,0.0012000000000000003
10,test_20231031_152707,11551286.png,271883,24,271859,0.9999117267353972,0,5,40092,1,40091,0.9999750573680535,24.866876444444443,3470.407338666667,12.72699907819776,130,0.0012000000000000003
1,test_20231031_152708,10404007.png,502730,14797,487933,0.9705667057864062,3,6,61265,2153,59112,0.9648575858973313,26.675523555555557,3677.0935466666665,12.475756822407263,130,0.0013000000000000004
2,test_20231031_152708,1254659.png,342646,65009,277637,0.8102735768110528,4,6,80080,9147,70933,0.8857767232767233,21.97528888888889,3512.2054293333335,12.67500450952557,130,0.0013000000000000004
3,test_20231031_152708,10188041.png,221231,7642,213589,0.9654569205943109,3,6,41731,1097,40634,0.9737125877644917,12.76224,1520.8037013333333,16.310072000229603,130,0.0013000000000000004
4,test_20231031_152708,10287332.png,216980,11037,205943,0.9491335606968384,3,6,22337,1517,20820,0.9320857769619914,9.782846222222222,865.3780533333334,18.75874483914483,130,0.0013000000000000004
5,test_20231031_152708,11610969.png,368720,20724,347996,0.9437947494033413,4,6,84111,3041,81070,0.9638453947759509,23.702741333333332,3441.175072,12.763735926731954,130,0.0013000000000000004
6,test_20231031_152708,10350842.png,212614,3027,209587,0.985762931885953,2,6,42529,441,42088,0.9896306049989418,24.490901333333333,3586.0659306666666,12.584620909620183,130,0.0013000000000000004
7,test_20231031_152708,10863862.png,317432,6597,310835,0.9792175962095819,2,6,66058,967,65091,0.9853613491174422,37.20948088888889,6920.689093333333,9.72931021536506,130,0.0013000000000000004
8,test_20231031_152708,11382381.png,312486,367,312119,0.9988255473845228,2,5,46745,48,46697,0.9989731522087923,23.28773511111111,2886.24232,13.527475705549977,130,0.0013000000000000004
9,test_20231031_152708,11079715.png,443815,107537,336278,0.7576985906289783,5,7,124136,15092,109044,0.8784236643681124,18.001861333333334,2370.5821066666667,14.382253588780998,130,0.0013000000000000004
10,test_20231031_152708,11551286.png,271883,24,271859,0.9999117267353972,1,5,40092,1,40091,0.9999750573680535,24.866876444444443,3470.407338666667,12.72699907819776,130,0.0013000000000000004
1,test_20231031_152709,10404007.png,502730,14797,487933,0.9705667057864062,4,6,61265,2153,59112,0.9648575858973313,26.675523555555557,3677.0935466666665,12.475756822407263,130,0.0014000000000000004
2,test_20231031_152709,1254659.png,342646,65009,277637,0.8102735768110528,9,12,80080,9147,70933,0.8857767232767233,21.97528888888889,3512.2054293333335,12.67500450952557,130,0.0014000000000000004
3,test_20231031_152709,10188041.png,221231,7642,213589,0.9654569205943109,4,8,41731,1097,40634,0.9737125877644917,12.76224,1520.8037013333333,16.310072000229603,130,0.0014000000000000004
4,test_20231031_152709,10287332.png,216980,11037,205943,0.9491335606968384,3,7,22337,1517,20820,0.9320857769619914,9.782846222222222,865.3780533333334,18.75874483914483,130,0.0014000000000000004
5,test_20231031_152709,11610969.png,368720,20724,347996,0.9437947494033413,7,10,84111,3041,81070,0.9638453947759509,23.702741333333332,3441.175072,12.763735926731954,130,0.0014000000000000004
6,test_20231031_152709,10350842.png,212614,3027,209587,0.985762931885953,4,9,42529,441,42088,0.9896306049989418,24.490901333333333,3586.0659306666666,12.584620909620183,130,0.0014000000000000004
7,test_20231031_152709,10863862.png,317432,6597,310835,0.9792175962095819,2,6,66058,967,65091,0.9853613491174422,37.20948088888889,6920.689093333333,9.72931021536506,130,0.0014000000000000004
8,test_20231031_152709,11382381.png,312486,367,312119,0.9988255473845228,3,6,46745,48,46697,0.9989731522087923,23.28773511111111,2886.24232,13.527475705549977,130,0.0014000000000000004
9,test_20231031_152709,11079715.png,443815,107537,336278,0.7576985906289783,5,6,124136,15092,109044,0.8784236643681124,18.001861333333334,2370.5821066666667,14.382253588780998,130,0.0014000000000000004
10,test_20231031_152709,11551286.png,271883,24,271859,0.9999117267353972,1,5,40092,1,40091,0.9999750573680535,24.866876444444443,3470.407338666667,12.72699907819776,130,0.0014000000000000004
