SN,TestID,FileName,OriginalFileSize,CompressedBinSize,FileSizeDifference,CompressionRate,CompressionTime,DecompressionTime,UniquePixelCountBefore,UniquePixelCountAfter,UniquePixelCountReduction,UniquePixelCountReductionRate,MAE,MSE,PSNR,QuadtreeThreshold,AllowedExceedingThresholdFactor
1,test_20231031_122746,10404007.png,502730,408267,94463,0.1879000656415969,15,19,61265,42484,18781,0.30655349710275037,12.925772444444444,958.9022666666667,18.313060156475444,50,0.011
2,test_20231031_122746,1254659.png,342646,285422,57224,0.16700618130665468,12,13,80080,35428,44652,0.5575924075924076,8.052426666666667,498.82157866666665,21.151351283846708,50,0.011
3,test_20231031_122746,10188041.png,221231,49777,171454,0.7749998869959454,7,21,41731,6792,34939,0.8372432963504349,6.245425777777778,297.691776,23.39313523826673,50,0.011
4,test_20231031_122746,10287332.png,216980,45777,171203,0.7890266383998525,7,12,22337,6144,16193,0.7249406813806689,7.113189333333334,361.061456,22.55499231732035,50,0.011
5,test_20231031_122746,11610969.png,368720,205712,163008,0.4420915599913213,12,13,84111,28216,55895,0.6645385264709729,9.084440888888889,554.4212693333334,20.692404780503878,50,0.011
6,test_20231031_122746,10350842.png,212614,64137,148477,0.6983406548957265,8,16,42529,8786,33743,0.7934115544687155,9.485431111111112,497.6880586666667,21.161231402914357,50,0.011
7,test_20231031_122746,10863862.png,317432,151217,166215,0.5236239572569874,14,17,66058,20004,46054,0.6971752096642345,9.836309333333332,609.20944,20.283137365450983,50,0.011
8,test_20231031_122746,11382381.png,312486,27217,285269,0.9129016979960702,4,8,46745,3858,42887,0.9174671087816879,8.767616,435.2059306666667,21.743855558913488,50,0.011
9,test_20231031_122746,11079715.png,443815,423402,20413,0.045994389554206094,13,13,124136,55989,68147,0.5489704839853065,7.248124444444445,431.762112,21.778358314182608,50,0.011
10,test_20231031_122746,11551286.png,271883,25027,246856,0.9079493752827503,4,8,40092,3576,36516,0.9108051481592337,8.292215111111112,403.47347733333334,22.072653695827192,50,0.011
1,test_20231031_122748,10404007.png,502730,396882,105848,0.21054641656555206,11,10,61265,41596,19669,0.32104790663510974,13.132883555555555,989.808112,18.175293521056435,50,0.020999999999999998
2,test_20231031_122748,1254659.png,342646,280437,62209,0.18155472411760243,8,16,80080,34911,45169,0.5640484515484516,8.316520888888888,529.3514186666666,20.893362795374976,50,0.020999999999999998
3,test_20231031_122748,10188041.png,221231,45424,175807,0.794676152980369,6,8,41731,6278,35453,0.8495602789293331,6.523884444444445,326.249968,22.995298831190418,50,0.020999999999999998
4,test_20231031_122748,10287332.png,216980,39324,177656,0.818766706608904,4,10,22337,5353,16984,0.7603527779021355,7.730064,481.680464,21.303213283152594,50,0.020999999999999998
5,test_20231031_122748,11610969.png,368720,198007,170713,0.4629881753091777,10,13,84111,27278,56833,0.6756904566584632,9.386611555555556,591.3569866666667,20.412306286600153,50,0.020999999999999998
6,test_20231031_122748,10350842.png,212614,61022,151592,0.7129916186140142,4,7,42529,8377,34152,0.8030285217145947,9.618314666666667,513.1796586666667,21.02810927319154,50,0.020999999999999998
7,test_20231031_122748,10863862.png,317432,144847,172585,0.5436912472592556,8,9,66058,19178,46880,0.7096793726724999,10.128037333333333,648.8026826666667,20.00967723942059,50,0.020999999999999998
8,test_20231031_122748,11382381.png,312486,23899,288587,0.9235197736858611,5,9,46745,3392,43353,0.9274360894213285,9.157868444444444,474.9713546666667,21.36412942580586,50,0.020999999999999998
9,test_20231031_122748,11079715.png,443815,414517,29298,0.06601399231661842,12,12,124136,54833,69303,0.5582828510665722,7.371434666666667,445.5812373333333,21.641534657178504,50,0.020999999999999998
10,test_20231031_122748,11551286.png,271883,22032,249851,0.91896514309464,4,7,40092,3143,36949,0.9216053077920783,8.71023288888889,447.6761813333333,21.621163725614814,50,0.020999999999999998
1,test_20231031_122750,10404007.png,502730,391737,110993,0.22078053826109445,14,10,61265,41119,20146,0.32883375499877576,13.256704,1010.4796693333333,18.085527808544597,50,0.031
2,test_20231031_122750,1254659.png,342646,279192,63454,0.1851882117403968,10,9,80080,34782,45298,0.5656593406593406,8.39989511111111,540.8619786666667,20.799939082401202,50,0.031
3,test_20231031_122750,10188041.png,221231,44007,177224,0.8010812227942739,4,6,41731,6091,35640,0.8540413601399439,6.917985777777778,368.3484,22.46821573123811,50,0.031
4,test_20231031_122750,10287332.png,216980,38279,178701,0.8235828186929671,4,7,22337,5227,17110,0.7659936428347585,7.850049777777778,498.5354933333333,21.153842774377345,50,0.031
5,test_20231031_122750,11610969.png,368720,193977,174743,0.47391787806465613,9,11,84111,26767,57344,0.6817657619098572,9.609422222222221,623.391136,20.183197381174264,50,0.031
6,test_20231031_122750,10350842.png,212614,58952,153662,0.7227275720319453,9,16,42529,8108,34421,0.8093536175315668,9.697756444444444,527.111808,20.911776157745557,50,0.031
7,test_20231031_122750,10863862.png,317432,142597,174835,0.5507793795206533,9,10,66058,18900,47158,0.7138877955735868,10.274448,665.284656,19.90072853792485,50,0.031
8,test_20231031_122750,11382381.png,312486,22252,290234,0.9287904098103595,4,7,46745,3156,43589,0.9324847577280992,9.408830222222223,501.95939733333336,21.124117716655952,50,0.031
9,test_20231031_122750,11079715.png,443815,412942,30873,0.06956276827056318,13,10,124136,54630,69506,0.5599181542823999,7.424304,454.0763573333333,21.55951471050137,50,0.031
10,test_20231031_122750,11551286.png,271883,17772,254111,0.934633647561635,4,8,40092,2523,37569,0.9370697395989225,10.247861333333333,671.8391253333333,19.858150689812174,50,0.031
1,test_20231031_122751,10404007.png,502730,380682,122048,0.24277047321623935,15,12,61265,40127,21138,0.3450257079898801,13.496007111111112,1053.3365226666667,17.905132179934373,50,0.041
2,test_20231031_122751,1254659.png,342646,275252,67394,0.19668695971936045,9,10,80080,34388,45692,0.5705794205794206,8.592792888888889,576.0026773333333,20.52655858784298,50,0.041
3,test_20231031_122751,10188041.png,221231,33957,187274,0.8465088527376362,3,7,41731,4731,37000,0.886631041671659,8.571472,733.9638026666667,19.474057187853052,50,0.041
4,test_20231031_122751,10287332.png,216980,34402,182578,0.8414508249608259,4,7,22337,4714,17623,0.7889600214890092,8.254650666666667,610.687184,20.27261554964862,50,0.041
5,test_20231031_122751,11610969.png,368720,187434,181286,0.4916630505532653,8,8,84111,25889,58222,0.6922043490149921,9.838977777777778,658.1835893333333,19.947333111545078,50,0.041
6,test_20231031_122751,10350842.png,212614,55492,157122,0.7390011946532213,4,7,42529,7653,34876,0.8200521996755156,9.841699555555556,549.350112,20.732311434733234,50,0.041
7,test_20231031_122751,10863862.png,317432,135059,182373,0.5745261977368381,13,16,66058,17946,48112,0.7283296497017773,10.91316088888889,749.7013386666666,19.38192074544904,50,0.041
8,test_20231031_122751,11382381.png,312486,18322,294164,0.9413669732404012,5,8,46745,2588,44157,0.9446357899240561,10.982579555555555,704.407024,19.652566829803487,50,0.041
9,test_20231031_122751,11079715.png,443815,403937,39878,0.08985275396279979,15,10,124136,53424,70712,0.569633305406973,7.622798222222222,493.27808,21.199885438986872,50,0.041
10,test_20231031_122751,11551286.png,271883,16142,255741,0.9406288734492411,3,7,40092,2294,37798,0.9427816023146762,10.481696,697.5185386666667,19.69524606078345,50,0.041
1,test_20231031_122753,10404007.png,502730,367519,135211,0.26895351381457244,11,9,61265,39014,22251,0.3631926875051008,13.83619911111111,1108.4624746666666,17.68359365556376,50,0.051000000000000004
2,test_20231031_122753,1254659.png,342646,270347,72299,0.21100202541398416,9,8,80080,33927,46153,0.5763361638361638,8.900773333333333,637.7826613333333,20.084076524671033,50,0.051000000000000004
3,test_20231031_122753,10188041.png,221231,31357,189874,0.8582612744145259,4,6,41731,4399,37332,0.8945867580455776,8.749013333333334,762.9524266666666,19.30582902179458,50,0.051000000000000004
4,test_20231031_122753,10287332.png,216980,29919,187061,0.8621117153654715,3,6,22337,4127,18210,0.8152392890719434,8.705845333333333,681.072704,19.79886885870468,50,0.051000000000000004
5,test_20231031_122753,11610969.png,368720,180329,188391,0.5109324148405294,8,8,84111,24935,59176,0.703546504024444,10.246848,722.024864,19.54528207464382,50,0.051000000000000004
6,test_20231031_122753,10350842.png,212614,51554,161060,0.7575230229429859,5,9,42529,7128,35401,0.832396717533918,10.146224,594.3331573333334,20.390504010199134,50,0.051000000000000004
7,test_20231031_122753,10863862.png,317432,127614,189818,0.5979800398195518,9,11,66058,16975,49083,0.7430288534318326,11.330288,809.3211146666666,19.049594898642127,50,0.051000000000000004
8,test_20231031_122753,11382381.png,312486,15127,297359,0.9515914312961221,5,8,46745,2147,44598,0.954069954005776,11.567619555555556,796.6303146666667,19.118235320032962,50,0.051000000000000004
9,test_20231031_122753,11079715.png,443815,394422,49393,0.11129186710678995,13,11,124136,52191,71945,0.579565959914932,7.847073777777778,539.3448906666666,20.812137919473255,50,0.051000000000000004
10,test_20231031_122753,11551286.png,271883,14292,257591,0.9474332709290393,3,6,40092,2044,38048,0.949017260301307,10.775852444444444,737.0123466666666,19.45605597507788,50,0.051000000000000004
1,test_20231031_122754,10404007.png,502730,360447,142283,0.28302070694010706,13,11,61265,38365,22900,0.3737860115889986,14.134929777777778,1174.4726826666667,17.43237440993193,50,0.061000000000000006
2,test_20231031_122754,1254659.png,342646,269152,73494,0.21448958983907584,18,18,80080,33776,46304,0.5782217782217782,9.077808,673.3667573333333,19.848286884699178,50,0.061000000000000006
3,test_20231031_122754,10188041.png,221231,30934,190297,0.8601733030181122,4,8,41731,4343,37388,0.8959286861086483,8.818954666666666,772.6994133333334,19.250697783578275,50,0.061000000000000006
4,test_20231031_122754,10287332.png,216980,27787,189193,0.8719375057608996,4,7,22337,3830,18507,0.8285356135559834,8.874161777777777,713.3905706666667,19.59752996171853,50,0.061000000000000006
5,test_20231031_122754,11610969.png,368720,176442,192278,0.5214742894337167,8,8,84111,24413,59698,0.7097525888409364,10.488407111111112,766.5959306666666,19.285138513157424,50,0.061000000000000006
6,test_20231031_122754,10350842.png,212614,49807,162807,0.7657397913589886,4,6,42529,6894,35635,0.8378988454936631,10.307776,620.305152,20.204749726162454,50,0.061000000000000006
7,test_20231031_122754,10863862.png,317432,124087,193345,0.6090910809244184,8,7,66058,16512,49546,0.750037845529686,11.983895111111112,901.79,18.579749457865784,50,0.061000000000000006
8,test_20231031_122754,11382381.png,312486,14544,297942,0.9534571148787465,5,9,46745,2064,44681,0.9558455449780725,11.747424,817.3919466666666,19.006500063465776,50,0.061000000000000006
9,test_20231031_122754,11079715.png,443815,391457,52358,0.1179725786645337,16,14,124136,51818,72318,0.5825707288780048,7.986855111111111,562.308352,20.631058267083652,50,0.061000000000000006
10,test_20231031_122754,11551286.png,271883,13792,258091,0.9492722972749308,3,6,40092,1974,38118,0.9507632445375636,10.981297777777778,763.1052693333334,19.304959084476632,50,0.061000000000000006
1,test_20231031_122756,10404007.png,502730,303367,199363,0.396560778151294,11,10,61265,33519,27746,0.4528850077532033,15.400366222222223,1381.91792,16.725981122940503,50,0.07100000000000001
2,test_20231031_122756,1254659.png,342646,251797,90849,0.2651395317616432,8,8,80080,31754,48326,0.6034715284715284,9.837292444444444,810.2500426666667,19.044612982943047,50,0.07100000000000001
3,test_20231031_122756,10188041.png,221231,26672,194559,0.8794382342438447,3,5,41731,3776,37955,0.9095157077472382,9.120810666666667,825.9851626666666,18.961081147943414,50,0.07100000000000001
4,test_20231031_122756,10287332.png,216980,13982,202998,0.9355608811872062,3,6,22337,1924,20413,0.9138648878542329,14.005057777777777,2121.3974773333334,14.864583127946354,50,0.07100000000000001
5,test_20231031_122756,11610969.png,368720,156857,211863,0.574590475157301,7,7,84111,21700,62411,0.7420075852147757,11.078666666666667,860.694592,18.782312866950193,50,0.07100000000000001
6,test_20231031_122756,10350842.png,212614,43707,168907,0.7944302821074811,4,6,42529,6045,36484,0.8578616943732512,11.67731911111111,812.4698026666666,19.03273132483396,50,0.07100000000000001
7,test_20231031_122756,10863862.png,317432,108902,208530,0.6569280979863403,5,7,66058,14488,51570,0.7806775863634987,12.519162666666666,983.194576,18.204408868599028,50,0.07100000000000001
8,test_20231031_122756,11382381.png,312486,11369,301117,0.963617570067139,4,6,46745,1610,45135,0.9655578136699112,12.243171555555556,877.9064106666667,18.69632140516996,50,0.07100000000000001
9,test_20231031_122756,11079715.png,443815,353139,90676,0.20431035453961677,26,21,124136,46874,77262,0.6223980150802346,8.64304,668.83584,19.877608238633997,50,0.07100000000000001
10,test_20231031_122756,11551286.png,271883,10414,261469,0.9616967592677733,8,27,40092,1503,38589,0.962511224184376,11.275527111111112,801.6259733333334,19.09108580622435,50,0.07100000000000001
1,test_20231031_122758,10404007.png,502730,296594,206136,0.4100332186263004,18,15,61265,32885,28380,0.46323349383824375,15.631201777777777,1423.6210826666668,16.596859499415533,50,0.081
2,test_20231031_122758,1254659.png,342646,241437,101209,0.29537481832561885,8,9,80080,30577,49503,0.6181693306693307,12.957623111111111,1453.6463626666666,16.506215949380465,50,0.081
3,test_20231031_122758,10188041.png,221231,25007,196224,0.8869643042792376,3,5,41731,3547,38184,0.915003235005152,9.353525333333334,881.637184,18.677904621353097,50,0.081
4,test_20231031_122758,10287332.png,216980,11237,205743,0.9482118167573048,3,6,22337,1579,20758,0.9293101132649864,14.451834666666667,2252.50216,14.604151447570398,50,0.081
5,test_20231031_122758,11610969.png,368720,150304,218416,0.5923627684964201,7,7,84111,20826,63285,0.7523986161144203,11.65432,958.7908533333333,18.313564785661697,50,0.081
6,test_20231031_122758,10350842.png,212614,41877,170737,0.8030374293320289,3,7,42529,5800,36729,0.863622469373839,11.788085333333333,836.170112,18.90785720764557,50,0.081
7,test_20231031_122758,10863862.png,317432,101197,216235,0.6812010131303712,6,6,66058,13440,52618,0.796542432407884,13.147843555555555,1087.186176,17.767764393335824,50,0.081
8,test_20231031_122758,11382381.png,312486,10524,301962,0.9663216912117663,3,6,46745,1490,45255,0.9681249331479302,12.733436444444445,950.0050133333333,18.353544637293176,50,0.081
9,test_20231031_122758,11079715.png,443815,346027,97788,0.22033504951387406,9,8,124136,45974,78162,0.6296481278597668,8.882771555555555,720.5204,19.554340794208734,50,0.081
10,test_20231031_122758,11551286.png,271883,9289,262594,0.965834568546029,3,6,40092,1338,38754,0.9666267584555522,11.573637333333334,846.6869813333333,18.853574787607915,50,0.081
1,test_20231031_122759,10404007.png,502730,293932,208798,0.41532830744137017,23,18,61265,32627,28638,0.46744470741859134,15.807745777777777,1459.4750773333333,16.48883677692574,50,0.091
2,test_20231031_122759,1254659.png,342646,240232,102414,0.29889156739025113,14,11,80080,30427,49653,0.6200424575424576,13.138837333333333,1502.0472106666666,16.36396777727192,50,0.091
3,test_20231031_122759,10188041.png,221231,20824,200407,0.9058721426924798,3,6,41731,3004,38727,0.9280151446167118,10.37284088888889,1068.397616,17.843474505930793,50,0.091
4,test_20231031_122759,10287332.png,216980,11057,205923,0.949041386302885,3,6,22337,1558,20779,0.9302502574204236,14.493000888888888,2257.76264,14.594020785299286,50,0.091
5,test_20231031_122759,11610969.png,368720,146927,221793,0.6015214797136038,7,8,84111,20364,63747,0.7578913578485573,12.027635555555555,1024.0783093333334,18.027471932798548,50,0.091
6,test_20231031_122759,10350842.png,212614,40017,172597,0.8117856773307497,3,6,42529,5560,36969,0.8692656775376801,13.608401777777777,1183.4286293333334,17.399382894108697,50,0.091
7,test_20231031_122759,10863862.png,317432,95647,221785,0.6986850727084857,6,7,66058,12708,53350,0.8076236034999545,13.729260444444444,1207.3790453333334,17.312367266828023,50,0.091
8,test_20231031_122759,11382381.png,312486,10102,302384,0.9676721517123967,4,6,46745,1428,45317,0.9694512782115734,13.022010666666667,993.5135413333334,18.159065700599562,50,0.091
9,test_20231031_122759,11079715.png,443815,342909,100906,0.22736049930714375,9,8,124136,45586,78550,0.6327737320358316,9.183187555555556,777.6622026666666,19.2228936975927,50,0.091
10,test_20231031_122759,11551286.png,271883,8727,263156,0.9679016341588109,3,16,40092,1255,38837,0.9686969969071136,12.487936,965.3152106666666,18.284112113580548,50,0.091
1,test_20231031_122800,10404007.png,502730,294637,208093,0.4139259642352754,8,8,61265,34094,27171,0.44349955113033546,15.837180444444444,1343.88544,16.84718112162294,60,0.001
2,test_20231031_122800,1254659.png,342646,243889,98757,0.2882187447102841,9,8,80080,30753,49327,0.6159715284715285,9.339310222222222,667.3902293333333,19.887005166217754,60,0.001
3,test_20231031_122800,10188041.png,221231,40612,180619,0.8164271734069819,4,16,41731,5522,36209,0.8676763077807865,6.487973333333334,329.30781333333334,22.954783257305664,60,0.001
4,test_20231031_122800,10287332.png,216980,38502,178478,0.8225550742003871,4,10,22337,5149,17188,0.7694856068406679,7.208124444444445,372.621344,22.418126329165627,60,0.001
5,test_20231031_122800,11610969.png,368720,158322,210398,0.5706172705576047,18,18,84111,21999,62112,0.738452758854371,10.569765333333333,748.855504,19.386823347164057,60,0.001
6,test_20231031_122800,10350842.png,212614,50469,162145,0.7626261676089063,7,13,42529,7037,35492,0.8345364339627078,10.191792,598.0242293333333,20.363615808049214,60,0.001
7,test_20231031_122800,10863862.png,317432,108119,209313,0.6593947680133068,12,15,66058,14556,51502,0.7796481879560386,11.513571555555556,837.5801493333333,18.900539848632587,60,0.001
8,test_20231031_122800,11382381.png,312486,19922,292564,0.9362467438541247,5,12,46745,2828,43917,0.939501550968018,9.294485333333334,498.37960533333336,21.155200990314434,60,0.001
9,test_20231031_122800,11079715.png,443815,344107,99708,0.22466117639106387,16,17,124136,45910,78226,0.6301636914352001,8.626542222222222,582.5818453333334,20.477234140373028,60,0.001
10,test_20231031_122800,11551286.png,271883,18774,253109,0.9309482387644685,3,7,40092,2686,37406,0.9330040905916392,8.894208,478.5263786666667,21.33174477702572,60,0.001
1,test_20231031_122802,10404007.png,502730,290132,212598,0.4228870367791856,8,8,61265,33718,27547,0.4496368236350281,15.952704,1361.657152,16.790125893690778,60,0.011
2,test_20231031_122802,1254659.png,342646,241107,101539,0.29633791143045596,6,8,80080,30533,49547,0.6187187812187812,9.654462222222222,705.445584,19.64616841686087,60,0.011
3,test_20231031_122802,10188041.png,221231,37837,183394,0.82897062346597,4,6,41731,5225,36506,0.874793319115286,7.132538666666667,392.88345066666665,22.18816625350881,60,0.011
4,test_20231031_122802,10287332.png,216980,33347,183633,0.8463130242418656,3,5,22337,4535,17802,0.7969736311948785,8.054487111111111,491.405328,21.216404999154328,60,0.011
5,test_20231031_122802,11610969.png,368720,155732,212988,0.5776415708396616,6,15,84111,21683,62428,0.7422096990881097,10.730035555555556,766.1651893333334,19.287579449147746,60,0.011
6,test_20231031_122802,10350842.png,212614,49282,163332,0.7682090549070146,3,6,42529,6874,35655,0.8383691128406499,10.397463111111112,620.399312,20.204090533426697,60,0.011
7,test_20231031_122802,10863862.png,317432,105357,212075,0.6680958441492981,5,6,66058,14198,51860,0.7850676678070786,12.109125333333333,917.4689546666667,18.50488983360752,60,0.011
8,test_20231031_122802,11382381.png,312486,16564,295922,0.9469928252785724,3,5,46745,2345,44400,0.9498342068670446,10.524017777777777,640.4406613333333,20.066014635542828,60,0.011
9,test_20231031_122802,11079715.png,443815,342057,101758,0.22928021810889676,8,13,124136,45643,78493,0.6323145582264613,8.724666666666666,593.8599733333333,20.393963064214592,60,0.011
10,test_20231031_122802,11551286.png,271883,16644,255239,0.9387824909979661,3,6,40092,2381,37711,0.9406115933353287,9.57834488888889,558.813328,20.65813605144042,60,0.011
1,test_20231031_122803,10404007.png,502730,274517,228213,0.45394744693970923,9,8,61265,32206,29059,0.4743164939198563,16.303347555555554,1424.2341706666666,16.594989595816166,60,0.020999999999999998
2,test_20231031_122803,1254659.png,342646,236182,106464,0.31071134640416054,7,7,80080,29977,50103,0.6256618381618382,9.98971911111111,746.241488,19.402009704801845,60,0.020999999999999998
3,test_20231031_122803,10188041.png,221231,34312,186919,0.8449041951625225,3,6,41731,4767,36964,0.8857683736311136,7.495356444444444,440.95666133333333,21.686844531884788,60,0.020999999999999998
4,test_20231031_122803,10287332.png,216980,28422,188558,0.8690109687528804,3,6,22337,3909,18428,0.8249988807807673,8.547968,593.224288,20.39861437108261,60,0.020999999999999998
5,test_20231031_122803,11610969.png,368720,145832,222888,0.6044912128444349,5,7,84111,20391,63720,0.7575703534614973,11.17165511111111,830.677312,18.936480119745568,60,0.020999999999999998
6,test_20231031_122803,10350842.png,212614,45747,166867,0.784835429463723,4,6,42529,6394,36135,0.8496555291683322,10.54914311111111,642.1815946666667,20.054225066153933,60,0.020999999999999998
7,test_20231031_122803,10863862.png,317432,96292,221140,0.6966531414602182,6,13,66058,12970,53088,0.8036573919888583,12.973171555555556,1032.2820426666667,17.992819883453052,60,0.020999999999999998
8,test_20231031_122803,11382381.png,312486,12434,300052,0.9602094173818987,4,6,46745,1767,44978,0.9621991656861697,12.203002666666666,869.48552,18.73818007003545,60,0.020999999999999998
9,test_20231031_122803,11079715.png,443815,330539,113276,0.25523247298987195,9,8,124136,44080,80056,0.6449055874202487,8.981621333333333,632.1238186666667,20.122782058500537,60,0.020999999999999998
10,test_20231031_122803,11551286.png,271883,11622,260261,0.9572536716160995,2,5,40092,1647,38445,0.9589194851840767,11.388618666666666,817.887712,19.003866774975442,60,0.020999999999999998
1,test_20231031_122804,10404007.png,502730,268047,234683,0.46681717820698987,9,8,61265,31533,29732,0.48530155880192605,16.52344888888889,1468.797024,16.461185769547026,60,0.031
2,test_20231031_122804,1254659.png,342646,234877,107769,0.31451994186419807,7,7,80080,29844,50236,0.6273226773226773,10.091217777777779,766.801632,19.283973323428448,60,0.031
3,test_20231031_122804,10188041.png,221231,32722,188509,0.8520912530341589,5,6,41731,4565,37166,0.8906088998586184,7.7048995555555555,471.2731626666667,21.398076519328736,60,0.031
4,test_20231031_122804,10287332.png,216980,27577,189403,0.8729053368974099,3,6,22337,3790,18547,0.8303263643282446,8.718894222222222,621.0266773333333,20.199701043792366,60,0.031
5,test_20231031_122804,11610969.png,368720,142637,226083,0.6131563245823389,6,6,84111,19953,64158,0.7627777579626922,11.453916444444445,875.5285333333334,18.708100566308666,60,0.031
6,test_20231031_122804,10350842.png,212614,43847,168767,0.7937718118280076,3,6,42529,6131,36398,0.8558395447812082,11.937123555555555,834.197632,18.91811408168926,60,0.031
7,test_20231031_122804,10863862.png,317432,91809,225623,0.7107758512059276,5,6,66058,12350,53708,0.8130430833509946,13.852234666666666,1154.0116906666667,17.50870152424016,60,0.031
8,test_20231031_122804,11382381.png,312486,11349,301137,0.9636815729344674,3,5,46745,1615,45130,0.9654508503583271,12.711027555555555,930.89256,18.44180801574779,60,0.031
9,test_20231031_122804,11079715.png,443815,327567,116248,0.2619289568851887,9,8,124136,43685,80451,0.6480875813623768,9.113923555555555,662.7071573333334,19.91758699808145,60,0.031
10,test_20231031_122804,11551286.png,271883,10717,261166,0.960582309302163,2,5,40092,1517,38575,0.9621620273371246,11.767505777777778,866.2593066666667,18.75432447375301,60,0.031
1,test_20231031_122805,10404007.png,502730,249124,253606,0.5044576611700118,8,8,61265,29557,31708,0.5175548845180772,17.228529777777776,1613.8370133333333,16.052206890842136,60,0.041
2,test_20231031_122805,1254659.png,342646,229962,112684,0.32886419219836216,7,8,80080,29326,50754,0.6337912087912088,10.42887288888889,829.6913653333334,18.94163790491652,60,0.041
3,test_20231031_122805,10188041.png,221231,24987,196244,0.8870547075229059,3,5,41731,3506,38225,0.9159857180513288,9.375036444444444,843.577184,18.86955535884979,60,0.041
4,test_20231031_122805,10287332.png,216980,16132,200848,0.92565213383722,2,6,22337,2197,20140,0.9016430138335497,12.007164444444445,1399.706112,16.670435018575514,60,0.041
5,test_20231031_122805,11610969.png,368720,137232,231488,0.6278151442829247,6,7,84111,19196,64915,0.7717777698517435,11.784698666666667,930.0989813333333,18.44551192142522,60,0.041
6,test_20231031_122805,10350842.png,212614,41072,171542,0.8068236334390021,4,6,42529,5740,36789,0.8650332714147994,12.07594488888889,858.12456,18.795300289698137,60,0.041
7,test_20231031_122805,10863862.png,317432,83732,233700,0.7362206708838428,5,6,66058,11270,54788,0.829392352175361,15.013655111111111,1329.591344,16.893621817934523,60,0.041
8,test_20231031_122805,11382381.png,312486,9359,303127,0.9700498582336489,3,6,46745,1321,45424,0.9717402930794737,13.320995555555555,1015.1976853333333,18.06529741978373,60,0.041
9,test_20231031_122805,11079715.png,443815,318372,125443,0.28264704888298053,9,8,124136,42495,81641,0.6576738415930914,9.560344888888888,746.5558186666667,19.400180761576472,60,0.041
10,test_20231031_122805,11551286.png,271883,9227,262656,0.9660626078129195,2,6,40092,1327,38765,0.966901127406964,12.093329777777777,909.8656426666666,18.541030948726377,60,0.041
1,test_20231031_122807,10404007.png,502730,238392,264338,0.5258051041314423,8,8,61265,28543,32722,0.534105933240839,17.576275555555554,1683.5388106666667,15.868572282257226,60,0.051000000000000004
2,test_20231031_122807,1254659.png,342646,218334,124312,0.36280009105607536,6,7,80080,27971,52109,0.6507117882117882,13.619525333333334,1483.122992,16.41903193297333,60,0.051000000000000004
3,test_20231031_122807,10188041.png,221231,21849,199382,0.9012389764544751,4,6,41731,3080,38651,0.9261939565311159,9.806378666666667,929.1266026666667,18.45005465934139,60,0.051000000000000004
4,test_20231031_122807,10287332.png,216980,15489,201491,0.9286155406028205,4,5,22337,2116,20221,0.9052692841473788,12.089628444444445,1424.6577493333334,16.593698161222598,60,0.051000000000000004
5,test_20231031_122807,11610969.png,368720,130809,237911,0.6452348665654155,6,6,84111,18289,65822,0.7825611394466836,12.238385777777777,1011.8407146666667,18.07968210207981,60,0.051000000000000004
6,test_20231031_122807,10350842.png,212614,37667,174947,0.8228385713076279,3,6,42529,5289,37240,0.8756378000893508,13.621176888888888,1167.6476373333333,17.45768555976249,60,0.051000000000000004
7,test_20231031_122807,10863862.png,317432,78647,238785,0.7522398497946017,5,6,66058,10570,55488,0.8399891004874505,15.594195555555556,1425.2515253333333,16.591888464006548,60,0.051000000000000004
8,test_20231031_122807,11382381.png,312486,8657,303829,0.9722963588768777,3,6,46745,1223,45522,0.9738367739865226,13.626961777777778,1059.3949653333334,17.880224562037167,60,0.051000000000000004
9,test_20231031_122807,11079715.png,443815,309307,134508,0.3030722260401293,8,8,124136,41301,82835,0.6672923245472707,9.880901333333334,806.3477066666667,19.065580057576675,60,0.051000000000000004
10,test_20231031_122807,11551286.png,271883,8182,263701,0.9699061728758326,2,6,40092,1177,38915,0.9706425221989424,13.287306666666666,1112.246816,17.66879189689554,60,0.051000000000000004
1,test_20231031_122808,10404007.png,502730,233257,269473,0.5360193344339904,8,7,61265,28028,33237,0.5425120378682772,17.729159111111112,1716.0738453333333,15.785443885843922,60,0.061000000000000006
2,test_20231031_122808,1254659.png,342646,216487,126159,0.3681904939792089,7,8,80080,27766,52314,0.6532717282717282,13.781868444444445,1524.443824,16.299689356931264,60,0.061000000000000006
3,test_20231031_122808,10188041.png,221231,21287,199944,0.9037793076015568,3,6,41731,3006,38725,0.9279672186144593,9.921061333333334,951.5459466666666,18.346505972495738,60,0.061000000000000006
4,test_20231031_122808,10287332.png,216980,15489,201491,0.9286155406028205,3,6,22337,2116,20221,0.9052692841473788,12.089628444444445,1424.6577493333334,16.593698161222598,60,0.061000000000000006
5,test_20231031_122808,11610969.png,368720,126852,241868,0.6559665871121718,6,14,84111,17748,66363,0.7889931162392553,12.640814222222222,1091.0664533333334,17.75229157999955,60,0.061000000000000006
6,test_20231031_122808,10350842.png,212614,36942,175672,0.8262485066834733,4,6,42529,5188,37341,0.878012650191634,13.672712888888888,1178.4740106666666,17.417603515625213,60,0.061000000000000006
7,test_20231031_122808,10863862.png,317432,76787,240645,0.7580993724640238,5,6,66058,10313,55745,0.8438796209391747,15.970028444444445,1480.6967093333333,16.426142496470728,60,0.061000000000000006
8,test_20231031_122808,11382381.png,312486,8497,303989,0.9728083818155053,4,6,46745,1200,45545,0.9743288052198096,13.879276444444445,1100.083568,17.716546832163008,60,0.061000000000000006
9,test_20231031_122808,11079715.png,443815,308202,135613,0.30556200218559537,9,9,124136,41158,82978,0.6684442869111298,9.946542222222222,817.9869226666667,19.003340003006258,60,0.061000000000000006
10,test_20231031_122808,11551286.png,271883,6677,265206,0.9754416421769658,3,6,40092,960,39132,0.9760550733313379,14.504279111111112,1278.1368906666667,17.065029908660307,60,0.061000000000000006
1,test_20231031_122809,10404007.png,502730,184279,318451,0.6334433990412349,7,7,61265,23079,38186,0.6232922549579695,18.93267911111111,1942.8088853333334,15.246502798396047,60,0.07100000000000001
2,test_20231031_122809,1254659.png,342646,201492,141154,0.4119528609702141,20,7,80080,25935,54145,0.6761363636363636,14.466586666666666,1668.12552,15.908516343549287,60,0.07100000000000001
3,test_20231031_122809,10188041.png,221231,15872,205359,0.9282559858247714,3,6,41731,2256,39475,0.9459394694591551,11.315553777777778,1213.4115466666667,17.29072237550339,60,0.07100000000000001
4,test_20231031_122809,10287332.png,216980,11702,205278,0.9460687620978891,2,6,22337,1632,20705,0.9269373684917401,14.243877333333334,2163.1961866666666,14.779844521902646,60,0.07100000000000001
5,test_20231031_122809,11610969.png,368720,104592,264128,0.7163376003471469,6,7,84111,14611,69500,0.8262890703950732,13.984515555555555,1337.160992,16.868966621114915,60,0.07100000000000001
6,test_20231031_122809,10350842.png,212614,31207,181407,0.8532222713461954,3,6,42529,4401,38128,0.8965176702955631,14.031932444444445,1244.9005013333333,17.179457190334986,60,0.07100000000000001
7,test_20231031_122809,10863862.png,317432,67182,250250,0.7883578215176794,5,6,66058,9031,57027,0.8632868085621727,16.571626666666667,1598.4844266666666,16.093719513804274,60,0.07100000000000001
8,test_20231031_122809,11382381.png,312486,4887,307599,0.9843608993682917,2,6,46745,688,46057,0.9852818483260242,15.774083555555556,1409.6703466666668,16.639627966963303,60,0.07100000000000001
9,test_20231031_122809,11079715.png,443815,277682,166133,0.3743293940042586,9,8,124136,37213,86923,0.700223947928079,10.803747555555555,1002.2841493333333,18.120894986249525,60,0.07100000000000001
10,test_20231031_122809,11551286.png,271883,4587,267296,0.983128772302792,2,5,40092,665,39427,0.9834131497555622,14.658883555555555,1301.9449066666666,16.98487753929818,60,0.07100000000000001
1,test_20231031_122810,10404007.png,502730,158957,343773,0.6838123843812782,8,7,61265,20430,40835,0.6665306455561903,20.162481777777778,2215.1373866666668,14.676796937756937,60,0.081
2,test_20231031_122810,1254659.png,342646,197754,144892,0.4228620792304594,7,8,80080,25475,54605,0.6818806193806194,14.883656888888888,1776.199152,15.635887024851794,60,0.081
3,test_20231031_122810,10188041.png,221231,12414,208817,0.9438867066550348,3,6,41731,1775,39956,0.9574656730008866,11.99615111111111,1376.8191733333333,16.742034556003482,60,0.081
4,test_20231031_122810,10287332.png,216980,9782,207198,0.9549175039174117,3,6,22337,1378,20959,0.9383086358955992,14.630712888888889,2280.957450666667,14.549631769121865,60,0.081
5,test_20231031_122810,11610969.png,368720,101237,267483,0.7254366456932089,5,6,84111,14152,69959,0.8317461449750925,14.220232888888889,1387.2872586666667,16.709139632865234,60,0.081
6,test_20231031_122810,10350842.png,212614,29537,183077,0.8610768811084877,3,6,42529,4187,38342,0.9015495309083214,14.149886222222221,1267.993872,17.09963206188928,60,0.081
7,test_20231031_122810,10863862.png,317432,63834,253598,0.7989049623226392,5,7,66058,8576,57482,0.8701746949650307,16.929941333333332,1673.5082773333334,15.89452496106411,60,0.081
8,test_20231031_122810,11382381.png,312486,4427,308059,0.9858329653168462,3,6,46745,622,46123,0.9866937640389346,16.401034666666668,1496.9621866666666,16.378695306847906,60,0.081
9,test_20231031_122810,11079715.png,443815,274779,169036,0.3808704077149263,8,8,124136,36842,87294,0.7032126055294193,10.944373333333333,1035.3481066666666,17.97993967223329,60,0.081
10,test_20231031_122810,11551286.png,271883,4164,267719,0.9846845885914162,2,6,40092,602,39490,0.9849845355681932,14.942298666666666,1340.73608,16.857370642095496,60,0.081
1,test_20231031_122811,10404007.png,502730,109607,393123,0.7819764088079089,5,6,61265,14808,46457,0.7582959275279524,22.266945777777778,2709.7349386666665,13.801535498106274,60,0.091
2,test_20231031_122811,1254659.png,342646,194559,148087,0.4321865715636546,7,7,80080,25128,54952,0.6862137862137863,15.228021333333333,1874.3970133333332,15.402187772838513,60,0.091
3,test_20231031_122811,10188041.png,221231,11832,209399,0.9465174410457847,3,6,41731,1691,40040,0.9594785650954926,12.09967111111111,1392.4803146666666,16.69291296549663,60,0.091
4,test_20231031_122811,10287332.png,216980,9782,207198,0.9549175039174117,2,5,22337,1378,20959,0.9383086358955992,14.630712888888889,2280.957450666667,14.549631769121865,60,0.091
5,test_20231031_122811,11610969.png,368720,94904,273816,0.7426122803211108,6,7,84111,13270,70841,0.8422322882857177,15.063767111111112,1586.9704693333333,16.12511515477211,60,0.091
6,test_20231031_122811,10350842.png,212614,26182,186432,0.8768566510201586,3,6,42529,3720,38809,0.9125302734604622,15.520072888888889,1505.072688,16.355228860310753,60,0.091
7,test_20231031_122811,10863862.png,317432,56477,260955,0.8220815796769072,4,6,66058,7598,58460,0.884979866178207,18.265596444444444,1972.1149226666666,15.181481415275663,60,0.091
8,test_20231031_122811,11382381.png,312486,4144,308342,0.9867386058895439,3,5,46745,579,46166,0.9876136485185582,16.62467911111111,1531.411552,16.279884420547912,60,0.091
9,test_20231031_122811,11079715.png,443815,272167,171648,0.38675574282076997,9,8,124136,36513,87623,0.7058629245343817,11.129694222222222,1083.9346933333334,17.780772439601524,60,0.091
10,test_20231031_122811,11551286.png,271883,3922,267961,0.9855746773428277,4,6,40092,570,39522,0.9857826997904819,14.973944888888889,1346.4817813333334,16.838798793327314,60,0.091
1,test_20231031_122812,10404007.png,502730,211129,291601,0.5800350088516699,7,7,61265,26360,34905,0.5697380233412226,18.16535288888889,1713.3044746666667,15.792458117276517,70,0.001
2,test_20231031_122812,1254659.png,342646,207452,135194,0.39455881580406604,6,7,80080,26523,53557,0.6687937062937063,10.911459555555556,904.8086826666666,18.565236013818456,70,0.001
3,test_20231031_122812,10188041.png,221231,31857,189374,0.8560011933228164,4,6,41731,4380,37351,0.8950420550669766,7.057932444444444,400.5822773333333,22.103886296562308,70,0.001
4,test_20231031_122812,10287332.png,216980,30642,186338,0.8587796110240575,3,12,22337,4125,18212,0.8153288266105565,7.832318222222222,455.71116266666667,21.543906940911196,70,0.001
5,test_20231031_122812,11610969.png,368720,121957,246763,0.6692422434367542,5,6,84111,17122,66989,0.7964356623984972,11.956593777777778,960.9058026666667,18.303995448821734,70,0.001
6,test_20231031_122812,10350842.png,212614,38402,174212,0.8193816023403915,3,6,42529,5448,37081,0.871899174680806,10.704883555555556,677.8614453333333,19.819394275856276,70,0.001
7,test_20231031_122812,10863862.png,317432,77812,239620,0.7548703344338314,4,6,66058,10587,55471,0.8397317508855854,13.321274666666667,1120.3111946666668,17.637416852029823,70,0.001
8,test_20231031_122812,11382381.png,312486,12647,299839,0.9595277868448506,3,6,46745,1810,44935,0.9612792812065462,10.932672,694.1046826666667,19.716553865571314,70,0.001
9,test_20231031_122812,11079715.png,443815,287932,155883,0.3512341854150941,8,8,124136,38694,85442,0.6882934845653155,9.888963555555556,744.8101866666667,19.410347530680014,70,0.001
10,test_20231031_122812,11551286.png,271883,12404,259479,0.9543774344111253,2,6,40092,1790,38302,0.9553526888157239,10.204236444444444,645.383568,20.032624571563524,70,0.001
1,test_20231031_122813,10404007.png,502730,203272,299458,0.5956636763272531,7,7,61265,25530,35735,0.5832857259446667,18.39985422222222,1755.05488,15.687896596053719,70,0.011
2,test_20231031_122813,1254659.png,342646,204687,137959,0.402628368637019,6,7,80080,26281,53799,0.6718156843156844,11.250008888888889,946.743552,18.36848004920682,70,0.011
3,test_20231031_122813,10188041.png,221231,28442,192789,0.8714375471791928,3,6,41731,3985,37746,0.9045074405118497,7.920718222222222,502.654784,21.118105405741638,70,0.011
4,test_20231031_122813,10287332.png,216980,26012,190968,0.8801179832242603,3,6,22337,3546,18791,0.8412499440390384,8.68632888888889,586.9582613333333,20.444731412507934,70,0.011
5,test_20231031_122813,11610969.png,368720,117887,250833,0.6802804295942722,6,8,84111,16604,67507,0.8025941910094994,12.309735111111111,1006.3803093333333,18.10318230015859,70,0.011
6,test_20231031_122813,10350842.png,212614,36752,175862,0.8271421449199018,3,6,42529,5221,37308,0.8772367090691058,12.140794666666666,869.195472,18.73962905633754,70,0.011
7,test_20231031_122813,10863862.png,317432,71682,245750,0.774181556994884,4,6,66058,9746,56312,0.8524629870719671,15.183612444444444,1372.548992,16.755525056871132,70,0.011
8,test_20231031_122813,11382381.png,312486,9359,303127,0.9700498582336489,3,5,46745,1330,45415,0.9715477591186223,13.332428444444444,1013.9330613333333,18.070710765344568,70,0.011
9,test_20231031_122813,11079715.png,443815,284957,158858,0.3579374288836564,8,8,124136,38281,85855,0.6916204807630342,10.037166222222222,765.76064,19.289873209639858,70,0.011
10,test_20231031_122813,11551286.png,271883,8777,263106,0.9677177315242218,3,12,40092,1260,38832,0.968572283747381,12.584394666666666,1002.177184,18.12135849685253,70,0.011
1,test_20231031_122814,10404007.png,502730,181947,320783,0.6380820718874942,7,7,61265,23129,38136,0.6224761282951115,19.111724444444445,1900.0782346666667,15.343088777126983,70,0.020999999999999998
2,test_20231031_122814,1254659.png,342646,200287,142359,0.4154696100348465,6,7,80080,25781,54299,0.6780594405594406,11.566565333333333,993.2254026666667,18.160325423566302,70,0.020999999999999998
3,test_20231031_122814,10188041.png,221231,25969,195262,0.8826159082587883,4,6,41731,3660,38071,0.9122954158778845,8.268368,552.5669706666666,20.706954391833904,70,0.020999999999999998
4,test_20231031_122814,10287332.png,216980,22864,194116,0.8946262328325192,3,6,22337,3143,19194,0.8592917580695707,9.02424711111111,669.06424,19.876125424452088,70,0.020999999999999998
5,test_20231031_122814,11610969.png,368720,109124,259596,0.7040464308960729,7,7,84111,15396,68715,0.8169561650675893,12.86932088888889,1097.039984,17.728579042010285,70,0.020999999999999998
6,test_20231031_122814,10350842.png,212614,33397,179217,0.8429219148315727,3,6,42529,4749,37780,0.8883350184579933,12.418620444444445,912.0319466666666,18.530703098004025,70,0.020999999999999998
7,test_20231031_122814,10863862.png,317432,64407,253025,0.7970998513067366,5,6,66058,8747,57311,0.8675860607345061,16.16435911111111,1509.7830613333333,16.341658122729875,70,0.020999999999999998
8,test_20231031_122814,11382381.png,312486,7369,305117,0.9764181435328303,5,6,46745,1049,45696,0.9775590972296502,13.970704,1124.0233333333333,17.62305034125321,70,0.020999999999999998
9,test_20231031_122814,11079715.png,443815,275492,168323,0.37926388247355314,8,9,124136,37031,87105,0.7016900818457176,10.499624888888889,844.4682826666667,18.86497018294838,70,0.020999999999999998
10,test_20231031_122814,11551286.png,271883,6737,265146,0.9752209590154588,2,6,40092,966,39126,0.9759054175396588,13.678124444444444,1162.9307253333334,17.47526515874231,70,0.020999999999999998
1,test_20231031_122816,10404007.png,502730,174262,328468,0.6533686074035765,7,7,61265,22318,38947,0.6357137027666694,19.530704,1998.6211786666668,15.123498757069624,70,0.031
2,test_20231031_122816,1254659.png,342646,198609,144037,0.4203667925497452,10,10,80080,25602,54478,0.6802947052947053,12.110092444444444,1090.2012106666666,17.755737008926506,70,0.031
3,test_20231031_122816,10188041.png,221231,20654,200577,0.9066405702636611,3,5,41731,2916,38815,0.9301238887158227,9.773036444444445,902.268848,18.57744397820602,70,0.031
4,test_20231031_122816,10287332.png,216980,15357,201623,0.9292238916029127,2,6,22337,2081,20256,0.9068361910731074,11.846232888888888,1344.172864,16.846252371993838,70,0.031
5,test_20231031_122816,11610969.png,368720,105987,262733,0.7125542417010198,6,7,84111,14953,69158,0.8222230148256471,13.26707911111111,1164.6137173333334,17.468984597540793,70,0.031
6,test_20231031_122816,10350842.png,212614,31627,180987,0.8512468605077746,3,6,42529,4505,38024,0.8940722800912319,13.927569777777778,1213.4469226666668,17.29059576242078,70,0.031
7,test_20231031_122816,10863862.png,317432,60707,256725,0.8087558910254795,5,7,66058,8262,57796,0.8749280934935966,17.706346666666665,1767.5999786666666,15.656963732191965,70,0.031
8,test_20231031_122816,11382381.png,312486,4707,307779,0.9849369251742478,2,6,46745,661,46084,0.9858594502085785,16.342302222222223,1495.186064,16.38385120354348,70,0.031
9,test_20231031_122816,11079715.png,443815,273562,170253,0.38361254126156163,9,8,124136,36779,87357,0.7037201134239865,10.639059555555555,877.158736,18.70002167808863,70,0.031
10,test_20231031_122816,11551286.png,271883,5067,266816,0.9813633070107363,2,5,40092,735,39357,0.9816671655193056,15.30643911111111,1385.4164586666666,16.715000181433467,70,0.031
1,test_20231031_122817,10404007.png,502730,158684,344046,0.6843554194100212,7,7,61265,20560,40705,0.6644087162327593,19.977480888888888,2097.441456,14.913905132699055,70,0.041
2,test_20231031_122817,1254659.png,342646,187122,155524,0.4538911879899371,6,7,80080,24235,55845,0.6973651348651349,15.014810666666667,1697.053168,15.833849120639055,70,0.041
3,test_20231031_122817,10188041.png,221231,17709,203522,0.9199524478938305,3,6,41731,2522,39209,0.9395653111595696,10.249808,988.4168373333333,18.18140226021039,70,0.041
4,test_20231031_122817,10287332.png,216980,14392,202588,0.9336713061111623,3,6,22337,1967,20370,0.911939830774052,12.086437333333333,1413.6754506666666,16.6273064459152,70,0.041
5,test_20231031_122817,11610969.png,368720,99297,269423,0.7306980906921241,5,6,84111,14019,70092,0.833327388807647,13.947429333333334,1287.49368,17.033352549976815,70,0.041
6,test_20231031_122817,10350842.png,212614,29757,182857,0.8600421420978863,3,12,42529,4233,38296,0.9004679160102518,14.047557333333334,1234.169616,17.2170551054612,70,0.041
7,test_20231031_122817,10863862.png,317432,57917,259515,0.8175451750296127,5,6,66058,7875,58183,0.8807865814889946,18.045772444444445,1825.0233653333332,15.518119318724708,70,0.041
8,test_20231031_122817,11382381.png,312486,4244,308242,0.9864185915529016,3,6,46745,593,46152,0.9873141512461225,16.65925688888889,1542.7775466666667,16.247770512791217,70,0.041
9,test_20231031_122817,11079715.png,443815,266457,177358,0.39962146389824593,8,8,124136,35859,88277,0.7111313398208416,10.98762311111111,951.9243733333333,18.344779141101764,70,0.041
10,test_20231031_122817,11551286.png,271883,4184,267699,0.9846110275375805,2,14,40092,606,39486,0.9848847650404071,15.620024888888889,1435.8026453333334,16.55985611722751,70,0.041
1,test_20231031_122818,10404007.png,502730,133012,369718,0.7354206035048634,6,7,61265,17669,43596,0.7115971598792132,21.159592888888888,2370.0816266666666,14.38317057304876,70,0.051000000000000004
2,test_20231031_122818,1254659.png,342646,183032,159614,0.4658277055620086,6,8,80080,23738,56342,0.7035714285714285,15.328504888888888,1775.592832,15.637369777411694,70,0.051000000000000004
3,test_20231031_122818,10188041.png,221231,14707,206524,0.9335219747684547,3,6,41731,2093,39638,0.9498454386427356,10.924924444444445,1113.08816,17.665507977144735,70,0.051000000000000004
4,test_20231031_122818,10287332.png,216980,13812,203168,0.9363443635358097,2,5,22337,1892,20445,0.915297488472042,12.157189333333333,1437.6808693333332,16.55417867080415,70,0.051000000000000004
5,test_20231031_122818,11610969.png,368720,91157,277563,0.7527744630071599,6,9,84111,12872,71239,0.8469641307320088,14.786759111111111,1458.5095146666667,16.49171094257089,70,0.051000000000000004
6,test_20231031_122818,10350842.png,212614,27687,184927,0.8697780955158174,3,6,42529,3955,38574,0.9070046321333678,14.406526222222222,1299.236976,16.99391988869017,70,0.051000000000000004
7,test_20231031_122818,10863862.png,317432,55282,262150,0.8258461654779606,4,6,66058,7507,58551,0.8863574434587786,18.38662933333333,1895.516784,15.353527265943452,70,0.051000000000000004
8,test_20231031_122818,11382381.png,312486,3942,308544,0.9873850348495613,2,5,46745,546,46199,0.9883196063750134,16.804106666666666,1563.6378346666668,16.189441905453034,70,0.051000000000000004
9,test_20231031_122818,11079715.png,443815,260057,183758,0.414041886822212,8,8,124136,35031,89105,0.7178014435780112,11.263276444444445,1011.7580533333334,18.080036909184074,70,0.051000000000000004
10,test_20231031_122818,11551286.png,271883,3339,268544,0.987718982062137,2,14,40092,491,39601,0.9877531677142573,16.087500444444444,1510.89304,16.33846640262822,70,0.051000000000000004
1,test_20231031_122819,10404007.png,502730,92592,410138,0.8158216139876275,4,6,61265,12752,48513,0.7918550559046764,22.946590222222223,2813.532538666667,13.638284187080334,70,0.061000000000000006
2,test_20231031_122819,1254659.png,342646,180219,162427,0.474037344664756,8,7,80080,23405,56675,0.7077297702297702,15.628412444444445,1844.5583573333333,15.471879610682077,70,0.061000000000000006
3,test_20231031_122819,10188041.png,221231,11972,209259,0.9458846183401061,3,6,41731,1724,40007,0.9586877860583259,11.937976888888889,1331.2812693333333,16.88810539191627,70,0.061000000000000006
4,test_20231031_122819,10287332.png,216980,13812,203168,0.9363443635358097,3,6,22337,1892,20445,0.915297488472042,12.157189333333333,1437.6808693333332,16.55417867080415,70,0.061000000000000006
5,test_20231031_122819,11610969.png,368720,86787,281933,0.7646262746799739,6,9,84111,12255,71856,0.8542996754288975,15.325464888888888,1565.2128746666667,16.18506949333049,70,0.061000000000000006
6,test_20231031_122819,10350842.png,212614,25617,186997,0.8795140489337485,3,6,42529,3673,38856,0.9136354017258812,14.719925333333334,1359.3945066666668,16.797348502685544,70,0.061000000000000006
7,test_20231031_122819,10863862.png,317432,51484,265948,0.8378109327352,5,6,66058,6994,59064,0.8941233461503527,18.880245333333335,1997.091008,15.126825046243336,70,0.061000000000000006
8,test_20231031_122819,11382381.png,312486,3279,309207,0.9895067299014996,3,6,46745,451,46294,0.9903519092951117,18.083338666666666,1796.6083626666666,15.586269440091822,70,0.061000000000000006
9,test_20231031_122819,11079715.png,443815,257867,185948,0.41897637529150655,8,8,124136,34755,89381,0.7200248114970678,11.517930666666667,1080.8449813333334,17.79316950521632,70,0.061000000000000006
10,test_20231031_122819,11551286.png,271883,2497,269386,0.9908159024286182,2,5,40092,367,39725,0.9908460540756261,16.446554666666668,1574.8240906666667,16.158483111355615,70,0.061000000000000006
1,test_20231031_122820,10404007.png,502730,72174,430556,0.85643586020329,4,6,61265,10071,51194,0.8356157675671264,23.581146666666665,2949.413498666667,13.43344697302099,70,0.07100000000000001
2,test_20231031_122820,1254659.png,342646,164342,178304,0.5203737968632349,6,7,80080,21406,58674,0.7326923076923078,16.389651555555556,2025.7669173333334,15.064908864474232,70,0.07100000000000001
3,test_20231031_122820,10188041.png,221231,9622,211609,0.956506999471141,2,6,41731,1388,40343,0.9667393544367496,12.235299555555555,1405.7537706666667,16.65171103772701,70,0.07100000000000001
4,test_20231031_122820,10287332.png,216980,8837,208143,0.959272744031708,2,10,22337,1247,21090,0.9441733446747549,14.642103111111112,2279.311546666667,14.552766702856687,70,0.07100000000000001
5,test_20231031_122820,11610969.png,368720,70184,298536,0.8096550227815145,6,7,84111,9874,74237,0.8826075067470367,16.683425777777778,1856.6964853333334,15.443394455601268,70,0.07100000000000001
6,test_20231031_122820,10350842.png,212614,19117,193497,0.9100858833378799,3,6,42529,2761,39768,0.9350795927484775,16.133292444444443,1606.1433546666667,16.072960556897485,70,0.07100000000000001
7,test_20231031_122820,10863862.png,317432,40117,277315,0.8736201769197812,4,11,66058,5449,60609,0.9175118834963214,19.941591111111112,2242.7445173333335,14.623005572055082,70,0.07100000000000001
8,test_20231031_122820,11382381.png,312486,2557,309929,0.9918172334120569,2,5,46745,346,46399,0.9925981388383784,18.428119111111112,1864.0189813333334,15.426300304001872,70,0.07100000000000001
9,test_20231031_122820,11079715.png,443815,230372,213443,0.480927864087514,7,8,124136,31147,92989,0.7490897080621255,12.303617777777777,1243.3687626666667,17.18480408541827,70,0.07100000000000001
10,test_20231031_122820,11551286.png,271883,1352,270531,0.9950272727607096,2,11,40092,197,39895,0.995086301506535,16.721383111111113,1615.894368,16.046673935965035,70,0.07100000000000001
1,test_20231031_122821,10404007.png,502730,67302,435428,0.8661269468700893,5,6,61265,9409,51856,0.8464212845833674,23.79339911111111,3001.4282293333335,13.357523979760042,70,0.081
2,test_20231031_122821,1254659.png,342646,160664,181982,0.5311079072862371,6,7,80080,20933,59147,0.7385989010989011,16.930574222222223,2174.848512,14.756513490916083,70,0.081
3,test_20231031_122821,10188041.png,221231,8394,212837,0.9620577586323797,3,6,41731,1207,40524,0.9710766576406029,12.433523555555556,1466.0635893333333,16.469275529791425,70,0.081
4,test_20231031_122821,10287332.png,216980,8254,208726,0.9619596276154484,2,6,22337,1174,21163,0.9474414648341317,14.798620444444444,2327.9090986666665,14.461143431023583,70,0.081
5,test_20231031_122821,11610969.png,368720,63472,305248,0.8278585376437405,5,6,84111,8928,75183,0.8938545493455077,17.58339022222222,2074.63832,14.961379655158137,70,0.081
6,test_20231031_122821,10350842.png,212614,14584,198030,0.9314062103154073,2,9,42529,2090,40439,0.9508570622398834,19.79750222222222,2459.7726773333334,14.221853877244886,70,0.081
7,test_20231031_122821,10863862.png,317432,26292,291140,0.9171728118148139,4,7,66058,3516,62542,0.9467740470495625,23.862069333333334,3218.5225066666667,13.054238104332274,70,0.081
8,test_20231031_122821,11382381.png,312486,2337,310149,0.9925212649526699,2,5,46745,313,46432,0.9933040966948337,20.69244266666667,2303.7098293333333,14.50652585533226,70,0.081
9,test_20231031_122821,11079715.png,443815,226012,217803,0.49075177720446583,8,8,124136,30562,93574,0.7538022813688213,12.557502222222222,1306.557872,16.969517099629098,70,0.081
10,test_20231031_122821,11551286.png,271883,987,270896,0.9963697619932104,2,6,40092,143,39949,0.9964332036316472,17.681132444444444,1795.4832693333333,15.588989982284666,70,0.081
1,test_20231031_122822,10404007.png,502730,63292,439438,0.8741033954607841,5,6,61265,8881,52384,0.8550395821431487,23.997079111111113,3054.2863626666667,13.28170607814942,70,0.091
2,test_20231031_122822,1254659.png,342646,155942,186704,0.5448888940772693,7,7,80080,20346,59734,0.7459290709290709,17.737509333333332,2382.371866666667,14.360708089955573,70,0.091
3,test_20231031_122822,10188041.png,221231,7492,213739,0.9661349449218238,3,6,41731,1078,40653,0.9741678847858906,13.038426666666666,1556.3241866666667,16.209802940396333,70,0.091
4,test_20231031_122822,10287332.png,216980,8254,208726,0.9619596276154484,2,6,22337,1174,21163,0.9474414648341317,14.798620444444444,2327.9090986666665,14.461143431023583,70,0.091
5,test_20231031_122822,11610969.png,368720,57997,310723,0.8427072032978954,5,6,84111,8186,75925,0.9026762254639702,18.164149333333334,2215.5835946666666,14.675922201235938,70,0.091
6,test_20231031_122822,10350842.png,212614,13922,198692,0.9345198340654896,2,5,42529,1995,40534,0.9530908321380704,20.11253333333333,2514.135349333333,14.126917064971652,70,0.091
7,test_20231031_122822,10863862.png,317432,25227,292205,0.9205278610852088,3,6,66058,3378,62680,0.9488631202882316,23.990970666666666,3248.6542773333335,13.013768648000523,70,0.091
8,test_20231031_122822,11382381.png,312486,2194,310292,0.9929788854540683,2,6,46745,292,46453,0.993753342603487,20.71507377777778,2308.572048,14.49736927915096,70,0.091
9,test_20231031_122822,11079715.png,443815,223932,219883,0.4954384146547548,7,7,124136,30272,93864,0.7561384288200039,12.72592888888889,1349.6233333333332,16.82867782802615,70,0.091
10,test_20231031_122822,11551286.png,271883,104,271779,0.9996174825200546,2,5,40092,13,40079,0.9996757457846952,18.357187555555555,1944.76624,15.24212954064392,70,0.091
1,test_20231031_122823,10404007.png,502730,147772,354958,0.7060609074453483,6,7,61265,19328,41937,0.6845180772055823,20.153758222222223,2081.374885333333,14.947300509741723,80,0.001
2,test_20231031_122823,1254659.png,342646,175957,166689,0.4864758380369244,6,7,80080,22874,57206,0.7143606393606394,12.540334222222222,1190.506336,17.373486497599263,80,0.001
3,test_20231031_122823,10188041.png,221231,25749,195482,0.8836103439391405,3,6,41731,3549,38182,0.9149553090028996,7.598424888888889,482.15661866666665,21.298922280766245,80,0.001
4,test_20231031_122823,10287332.png,216980,25207,191773,0.883828002580883,3,6,22337,3404,18933,0.8476071092805659,8.303797333333334,538.0042773333333,20.8229463238576,80,0.001
5,test_20231031_122823,11610969.png,368720,93227,275493,0.7471604469516164,5,6,84111,13207,70904,0.842981298522191,13.393002666666666,1211.092,17.299032255079197,80,0.001
6,test_20231031_122823,10350842.png,212614,28884,183730,0.8641481746263181,2,6,42529,4156,38373,0.9022784452961509,12.547457777777778,947.6349173333333,18.36439306151706,80,0.001
7,test_20231031_122823,10863862.png,317432,57302,260130,0.819482597847728,7,6,66058,7850,58208,0.8811650367858549,14.825614222222223,1373.453472,16.752664093034813,80,0.001
8,test_20231031_122823,11382381.png,312486,8404,304082,0.9731059951485826,3,5,46745,1206,45539,0.9742004492459087,12.428926222222222,910.2998133333333,18.538959071934162,80,0.001
9,test_20231031_122823,11079715.png,443815,245104,198711,0.4477338530694096,7,7,124136,33210,90926,0.7324708384352645,11.089923555555556,923.9867626666667,18.47414611446507,80,0.001
10,test_20231031_122823,11551286.png,271883,8182,263701,0.9699061728758326,3,6,40092,1192,38900,0.9702683827197446,12.667880888888888,1019.9304586666667,18.045097993480617,80,0.001
1,test_20231031_122824,10404007.png,502730,137482,365248,0.7265291508364331,6,6,61265,18162,43103,0.7035501509834327,20.557763555555557,2158.613418666667,14.789054884144178,80,0.011
2,test_20231031_122824,1254659.png,342646,172934,169712,0.4952983545700227,6,8,80080,22566,57514,0.7182067932067933,13.204490666666667,1288.5826666666667,17.02968075718245,80,0.011
3,test_20231031_122824,10188041.png,221231,21729,199502,0.9017813959164855,3,5,41731,3092,38639,0.9259064005176009,8.804273777777778,653.8322133333334,19.97614047058143,80,0.011
4,test_20231031_122824,10287332.png,216980,21992,194988,0.8986450364088856,3,6,22337,3002,19335,0.8656041545417916,8.965959111111111,629.6908053333333,20.13953009033451,80,0.011
5,test_20231031_122824,11610969.png,368720,88272,280448,0.760598828379258,4,6,84111,12537,71574,0.8509469629418269,14.061816888888888,1312.8559573333334,16.948632816687184,80,0.011
6,test_20231031_122824,10350842.png,212614,26794,185820,0.8739781952270311,4,6,42529,3859,38670,0.9092619153989043,13.111836444444444,1035.397312,17.979733276946273,80,0.011
7,test_20231031_122824,10863862.png,317432,51524,265908,0.8376849214949973,4,6,66058,7062,58996,0.8930939477428926,17.22237688888889,1711.4420426666666,15.797181643623134,80,0.011
8,test_20231031_122824,11382381.png,312486,4407,308079,0.9858969681841746,3,6,46745,621,46124,0.9867151567012514,16.44784177777778,1501.5090826666667,16.365523972665873,80,0.011
9,test_20231031_122824,11079715.png,443815,242392,201423,0.45384450728344017,6,7,124136,32841,91295,0.7354433846748727,11.343539555555555,961.7594933333334,18.300138790349546,80,0.011
10,test_20231031_122824,11551286.png,271883,5442,266441,0.9799840372513177,2,6,40092,789,39303,0.9803202633941933,14.887484444444445,1321.13296,16.921338332696415,80,0.011
1,test_20231031_122825,10404007.png,502730,115697,387033,0.7698625504744097,6,7,61265,15535,45730,0.7464294458499959,21.464650666666667,2370.1402026666665,14.383063239533625,80,0.020999999999999998
2,test_20231031_122825,1254659.png,342646,168442,174204,0.508408094651623,6,18,80080,22046,58034,0.7247002997002997,13.580855111111111,1357.3947573333332,16.803741933850873,80,0.020999999999999998
3,test_20231031_122825,10188041.png,221231,18132,203099,0.9180404192902442,3,8,41731,2597,39134,0.9377680860751001,9.680529777777778,787.1504426666667,19.170226168494718,80,0.020999999999999998
4,test_20231031_122825,10287332.png,216980,13872,203108,0.9360678403539496,20,13,22337,1889,20448,0.9154317947799615,11.902668444444444,1352.991664,16.81785240020438,80,0.020999999999999998
5,test_20231031_122825,11610969.png,368720,80032,288688,0.7829464091993925,6,8,84111,11357,72754,0.8649760435614842,14.849973333333333,1450.304256,16.516212394325294,80,0.020999999999999998
6,test_20231031_122825,10350842.png,212614,23819,188795,0.8879706886658452,4,6,42529,3430,39099,0.9193491499917703,14.597075555555556,1335.415216,16.87464040500184,80,0.020999999999999998
7,test_20231031_122825,10863862.png,317432,46277,271155,0.8542144459285768,10,16,66058,6340,59718,0.904023736716219,18.46833422222222,1927.9888106666667,15.279758517781854,80,0.020999999999999998
8,test_20231031_122825,11382381.png,312486,3462,309024,0.9889211036654442,4,10,46745,487,46258,0.9895817734517061,17.06784711111111,1616.640416,16.044669289104053,80,0.020999999999999998
9,test_20231031_122825,11079715.png,443815,234452,209363,0.47173484447348557,11,12,124136,31774,92362,0.7440387961590513,11.84386488888889,1056.402368,17.892509948303918,80,0.020999999999999998
10,test_20231031_122825,11551286.png,271883,2757,269126,0.9898596087287547,3,7,40092,397,39695,0.9900977751172304,15.837857777777778,1476.4830133333332,16.438519060165497,80,0.020999999999999998
1,test_20231031_122827,10404007.png,502730,99767,402963,0.8015495395142522,6,8,61265,13635,47630,0.7774422590386028,22.401303111111112,2597.6597173333334,13.984981011838155,80,0.031
2,test_20231031_122827,1254659.png,342646,161117,181529,0.5297858431150517,6,8,80080,21197,58883,0.7353021978021979,16.223022222222223,1914.3090346666668,15.310683118488884,80,0.031
3,test_20231031_122827,10188041.png,221231,14494,206737,0.934484769313523,3,6,41731,2079,39652,0.9501809206585032,11.29228088888889,1138.0120853333333,17.569334867124525,80,0.031
4,test_20231031_122827,10287332.png,216980,13652,203328,0.9370817586874366,2,5,22337,1862,20475,0.9166405515512379,11.918135111111111,1358.7404106666668,16.799438688033646,80,0.031
5,test_20231031_122827,11610969.png,368720,75912,292808,0.7941201996094598,5,6,84111,10781,73330,0.8718241371520966,15.811361777777778,1622.3998773333333,16.02922456050873,80,0.031
6,test_20231031_122827,10350842.png,212614,22102,190512,0.8960463563076749,3,5,42529,3187,39342,0.9250628982576595,15.069552,1418.2402613333334,16.613305508019554,80,0.031
7,test_20231031_122827,10863862.png,317432,43587,273845,0.8626887018322034,3,6,66058,5975,60083,0.90954918405038,19.321498666666667,2068.853232,14.973506787055095,80,0.031
8,test_20231031_122827,11382381.png,312486,3017,309469,0.9903451674635023,2,5,46745,421,46324,0.9909936891646165,18.140165333333332,1809.4200373333333,15.555409655277117,80,0.031
9,test_20231031_122827,11079715.png,443815,230997,212818,0.4795196196613454,7,8,124136,31336,92800,0.7475671843784237,12.224168888888888,1145.0040586666667,17.54273334756708,80,0.031
10,test_20231031_122827,11551286.png,271883,1492,270391,0.99451234538386,2,6,40092,218,39874,0.994562506235658,17.75233777777778,1814.8619733333333,15.542367598699476,80,0.031
1,test_20231031_122828,10404007.png,502730,63692,439038,0.873307739741014,4,6,61265,8962,52303,0.8537174569493186,24.002352,3019.7439626666664,13.331102392070868,80,0.041
2,test_20231031_122828,1254659.png,342646,155992,186654,0.5447429708795667,7,7,80080,20514,59566,0.7438311688311688,16.702211555555557,2017.231616,15.083245946453696,80,0.041
3,test_20231031_122828,10188041.png,221231,11127,210104,0.9497041553850952,2,5,41731,1596,40135,0.9617550502024874,11.884634666666667,1272.0350346666667,17.085812879573435,80,0.041
4,test_20231031_122828,10287332.png,216980,12907,204073,0.9405152548621993,3,6,22337,1764,20573,0.921027890943278,12.143895111111112,1424.1756106666667,16.59516816762862,80,0.041
5,test_20231031_122828,11610969.png,368720,68747,299973,0.813552288999783,5,7,84111,9756,74355,0.8840104148090024,16.438469333333334,1761.5040266666667,15.67196720584759,80,0.041
6,test_20231031_122828,10350842.png,212614,19789,192825,0.9069252259964067,3,6,42529,2863,39666,0.932681229278845,15.449089777777777,1488.105168,16.404467359294934,80,0.041
7,test_20231031_122828,10863862.png,317432,40169,277263,0.8734563623075178,4,6,66058,5508,60550,0.916618728995731,19.875285333333334,2183.0597333333335,14.74014741740477,80,0.041
8,test_20231031_122828,11382381.png,312486,2737,309749,0.9912412076061008,3,6,46745,380,46365,0.9918707883196064,18.396144,1859.208656,15.437522281889322,80,0.041
9,test_20231031_122828,11079715.png,443815,225982,217833,0.4908193729369219,7,8,124136,30656,93480,0.7530450473674035,12.515082666666666,1210.9264533333333,17.29962594175276,80,0.041
10,test_20231031_122828,11551286.png,271883,1069,270814,0.9960681616724841,2,7,40092,155,39937,0.996133892048289,17.857000888888887,1835.6208053333332,15.492973894274119,80,0.041
1,test_20231031_122829,10404007.png,502730,56257,446473,0.88809699043224,5,7,61265,7946,53319,0.8703011507385946,24.329829333333333,3101.3882613333335,13.215242221057697,80,0.051000000000000004
2,test_20231031_122829,1254659.png,342646,151137,191509,0.5589121133764876,6,8,80080,19938,60142,0.7510239760239761,17.126890666666668,2122.6133973333335,14.86209459822068,80,0.051000000000000004
3,test_20231031_122829,10188041.png,221231,9177,212054,0.9585184716427625,3,6,41731,1326,40405,0.9682250605065779,12.40874311111111,1390.850176,16.69800011063439,80,0.051000000000000004
4,test_20231031_122829,10287332.png,216980,12162,204818,0.943948751036962,3,6,22337,1671,20666,0.9251913864887854,12.232748444444445,1451.79544,16.5117493289069,80,0.051000000000000004
5,test_20231031_122829,11610969.png,368720,61372,307348,0.8335539162508137,4,6,84111,8715,75396,0.8963869172878696,17.41582222222222,1961.8050346666666,15.204245161194365,80,0.051000000000000004
6,test_20231031_122829,10350842.png,212614,17822,194792,0.9161767334230108,4,6,42529,2588,39941,0.939147405299913,15.621578666666666,1526.0940906666667,16.294990501863953,80,0.051000000000000004
7,test_20231031_122829,10863862.png,317432,36412,281020,0.8852919680435495,24,14,66058,4975,61083,0.9246873959247933,20.85816711111111,2354.2107786666666,14.412350170954964,80,0.051000000000000004
8,test_20231031_122829,11382381.png,312486,2417,310069,0.992265253483356,3,8,46745,332,46413,0.9928976361108139,19.062211555555557,1972.115104,15.181481015947703,80,0.051000000000000004
9,test_20231031_122829,11079715.png,443815,219482,224333,0.505465114969075,9,8,124136,29803,94333,0.7599165431462267,12.864981333333333,1284.2728213333332,17.044230690558642,80,0.051000000000000004
10,test_20231031_122829,11551286.png,271883,104,271779,0.9996174825200546,3,6,40092,13,40079,0.9996757457846952,18.357187555555555,1944.76624,15.24212954064392,80,0.051000000000000004
1,test_20231031_122831,10404007.png,502730,52117,450613,0.89633202713186,4,6,61265,7392,53873,0.8793438341630622,24.595772444444446,3168.4469653333335,13.122339187315205,80,0.061000000000000006
2,test_20231031_122831,1254659.png,342646,149349,193297,0.5641303269263321,7,7,80080,19704,60376,0.753946053946054,17.371616,2179.105973333333,14.748020096878427,80,0.061000000000000006
3,test_20231031_122831,10188041.png,221231,8557,212674,0.9613209721964824,3,6,41731,1237,40494,0.970357767606815,13.311847111111112,1566.7815893333334,16.18071901194736,80,0.061000000000000006
4,test_20231031_122831,10287332.png,216980,11982,204998,0.9447783205825422,2,6,22337,1654,20683,0.9259524555669965,12.240869333333332,1453.4398773333332,16.506832893176473,80,0.061000000000000006
5,test_20231031_122831,11610969.png,368720,57272,311448,0.8446734649598612,4,6,84111,8150,75961,0.9031042313133835,18.18207288888889,2142.205205333333,14.822192906020764,80,0.061000000000000006
6,test_20231031_122831,10350842.png,212614,14172,198442,0.9333439942807152,3,5,42529,2063,40466,0.9514919231583155,17.325895111111112,1832.9231146666666,15.499361128049392,80,0.061000000000000006
7,test_20231031_122831,10863862.png,317432,24612,292820,0.9224652839033242,3,5,66058,3318,62740,0.9497714130006963,24.114144,3254.3624213333333,13.006144444672572,80,0.061000000000000006
8,test_20231031_122831,11382381.png,312486,2417,310069,0.992265253483356,2,6,46745,332,46413,0.9928976361108139,19.062211555555557,1972.115104,15.181481015947703,80,0.061000000000000006
9,test_20231031_122831,11079715.png,443815,217107,226708,0.5108164437885154,8,7,124136,29486,94650,0.7624701939807953,13.449914666666666,1415.4085706666667,16.62198539824777,80,0.061000000000000006
10,test_20231031_122831,11551286.png,271883,104,271779,0.9996174825200546,2,5,40092,13,40079,0.9996757457846952,18.357187555555555,1944.76624,15.24212954064392,80,0.061000000000000006
1,test_20231031_122832,10404007.png,502730,36372,466358,0.9276510254013088,4,6,61265,5202,56063,0.9150901819962458,25.29032,3343.262149333333,12.889099293709972,80,0.07100000000000001
2,test_20231031_122832,1254659.png,342646,132567,210079,0.6131079890032278,7,7,80080,17506,62574,0.7813936063936064,18.50864,2485.5140906666666,14.176641313202978,80,0.07100000000000001
3,test_20231031_122832,10188041.png,221231,6947,214284,0.9685984333117872,3,12,41731,1009,40722,0.9758213318636026,13.495404444444445,1614.6532853333333,16.050010802887144,80,0.07100000000000001
4,test_20231031_122832,10287332.png,216980,7369,209611,0.9660383445478846,2,5,22337,1044,21293,0.9532614048439808,14.741701333333333,2302.4907253333336,14.50882471377815,80,0.07100000000000001
5,test_20231031_122832,11610969.png,368720,39527,329193,0.8927994141896289,5,6,84111,5624,78487,0.9331359750805484,19.854241777777776,2543.990992,14.075647916791203,80,0.07100000000000001
6,test_20231031_122832,10350842.png,212614,8997,203617,0.957683877825543,2,9,42529,1309,41220,0.9692210021397164,21.411025777777777,2760.2603733333335,13.72130310190947,80,0.07100000000000001
7,test_20231031_122832,10863862.png,317432,18462,298970,0.9418395120844779,4,7,66058,2480,63578,0.9624572345514548,24.772833777777777,3407.111472,12.806940180594914,80,0.07100000000000001
8,test_20231031_122832,11382381.png,312486,1732,310754,0.9944573516893557,5,13,46745,232,46513,0.9950369023424965,21.61512711111111,2462.5003253333334,14.217040643214236,80,0.07100000000000001
9,test_20231031_122832,11079715.png,443815,189404,254411,0.5732365963295517,17,25,124136,25789,98347,0.79225204614294,14.34268088888889,1623.803296,16.02546942265591,80,0.07100000000000001
10,test_20231031_122832,11551286.png,271883,84,271799,0.9996910435738903,4,10,40092,10,40082,0.9997505736805348,20.692032,2552.372533333333,14.061362984350119,80,0.07100000000000001
1,test_20231031_122833,10404007.png,502730,24,502706,0.9999522606568138,1,6,61265,1,61264,0.9999836774667429,31.611185777777777,5234.651008,10.941926281199287,80,0.081
2,test_20231031_122833,1254659.png,342646,125542,217104,0.633610198280441,7,19,80080,16586,63494,0.7928821178821179,19.78817777777778,2825.605536,13.619688280885358,80,0.081
3,test_20231031_122833,10188041.png,221231,4987,216244,0.9774579511912888,4,10,41731,724,41007,0.982650787184587,15.909776,2359.8689973333335,14.401924660818633,80,0.081
4,test_20231031_122833,10287332.png,216980,6947,210033,0.9679832242603005,4,11,22337,987,21350,0.9558132246944532,14.870049777777778,2343.5852,14.431996141415057,80,0.081
5,test_20231031_122833,11610969.png,368720,30944,337776,0.9160772401822521,6,8,84111,4401,79710,0.9476762849092271,21.164295111111112,2866.6808213333334,13.557010199445457,80,0.081
6,test_20231031_122833,10350842.png,212614,7429,205185,0.9650587449556474,3,14,42529,1080,41449,0.9746055632627149,21.830092444444446,2848.656090666667,13.584403394772,80,0.081
7,test_20231031_122833,10863862.png,317432,16312,301120,0.9486126162453691,4,7,66058,2186,63872,0.9669078688425323,25.416938666666667,3547.368597333333,12.631740437038623,80,0.081
8,test_20231031_122833,11382381.png,312486,24,312462,0.9999231965592058,1,8,46745,1,46744,0.9999786073376832,30.521228444444443,5261.919984,10.919361212177094,80,0.081
9,test_20231031_122833,11079715.png,443815,183597,260218,0.586320876941969,13,14,124136,25007,99129,0.7985515885802668,15.055543111111112,1773.4902346666668,15.642515594002685,80,0.081
10,test_20231031_122833,11551286.png,271883,24,271859,0.9999117267353972,1,8,40092,1,40091,0.9999750573680535,24.866876444444443,3470.407338666667,12.72699907819776,80,0.081
1,test_20231031_122835,10404007.png,502730,24,502706,0.9999522606568138,2,10,61265,1,61264,0.9999836774667429,31.611185777777777,5234.651008,10.941926281199287,80,0.091
2,test_20231031_122835,1254659.png,342646,115364,227282,0.6633143244047792,8,10,80080,15265,64815,0.8093781218781219,26.339045333333335,4806.322224,11.312674775847729,80,0.091
3,test_20231031_122835,10188041.png,221231,4867,216364,0.978000370653299,3,6,41731,709,41022,0.9830102322014809,15.991671111111112,2373.6586293333335,14.376621003593097,80,0.091
4,test_20231031_122835,10287332.png,216980,6947,210033,0.9679832242603005,3,6,22337,987,21350,0.9558132246944532,14.870049777777778,2343.5852,14.431996141415057,80,0.091
5,test_20231031_122835,11610969.png,368720,26202,342518,0.9289379474940334,4,6,84111,3719,80392,0.9557846179453341,24.370906666666666,3659.288069333333,12.496837611661181,80,0.091
6,test_20231031_122835,10350842.png,212614,4234,208380,0.9800859774050626,2,5,42529,613,41916,0.9855863058148557,22.751749333333333,3070.547408,13.25864553768237,80,0.091
7,test_20231031_122835,10863862.png,317432,12352,305080,0.961087729025429,4,6,66058,1646,64412,0.9750825032547156,27.33550577777778,4055.8317866666666,12.050004262875438,80,0.091
8,test_20231031_122835,11382381.png,312486,24,312462,0.9999231965592058,0,5,46745,1,46744,0.9999786073376832,30.521228444444443,5261.919984,10.919361212177094,80,0.091
9,test_20231031_122835,11079715.png,443815,171327,272488,0.6139675315165103,6,7,124136,23349,100787,0.8119079074563382,18.045790222222223,2638.4480266666665,13.917318171981204,80,0.091
10,test_20231031_122835,11551286.png,271883,24,271859,0.9999117267353972,1,5,40092,1,40091,0.9999750573680535,24.866876444444443,3470.407338666667,12.72699907819776,80,0.091
1,test_20231031_122836,10404007.png,502730,101427,401303,0.7982475682772064,5,7,61265,13789,47476,0.7749285889169999,21.729612444444445,2417.4877813333333,14.297160731544096,90,0.001
2,test_20231031_122836,1254659.png,342646,148807,193839,0.5657121343894281,6,8,80080,19618,60462,0.75501998001998,14.254496,1534.0478933333334,16.272414422681845,90,0.001
3,test_20231031_122836,10188041.png,221231,20272,200959,0.9083672722177272,4,6,41731,2817,38914,0.9324962258273226,8.512864,618.4507733333334,20.2177522395292,90,0.001
4,test_20231031_122836,10287332.png,216980,21992,194988,0.8986450364088856,3,7,22337,2962,19375,0.8673949053140529,8.608741333333333,590.932496,20.41542487920843,90,0.001
5,test_20231031_122836,11610969.png,368720,72264,296456,0.8040138858754611,5,6,84111,10299,73812,0.8775546599136855,14.724718222222222,1469.902304,16.45791890231077,90,0.001
6,test_20231031_122836,10350842.png,212614,21577,191037,0.8985156198557009,2,8,42529,3113,39416,0.9268028874415105,14.503038222222223,1337.3248373333333,16.86843450295253,90,0.001
7,test_20231031_122836,10863862.png,317432,41747,275685,0.8684852188815242,4,6,66058,5723,60335,0.9133640134427321,17.73799288888889,1840.433392,15.481602565589052,90,0.001
8,test_20231031_122836,11382381.png,312486,5229,307257,0.9832664503369751,3,6,46745,747,45998,0.9840196812493315,14.377752888888889,1191.5885653333332,17.36954033861379,90,0.001
9,test_20231031_122836,11079715.png,443815,210817,232998,0.5249890156934759,23,8,124136,28703,95433,0.7687777920989882,12.307475555555556,1130.293616,17.59889086194407,90,0.001
10,test_20231031_122836,11551286.png,271883,5432,266451,0.9800208177782355,2,5,40092,794,39298,0.9801955502344607,13.821470222222223,1180.0243146666667,17.411894047340144,90,0.001
1,test_20231031_122837,10404007.png,502730,87762,414968,0.825429156803851,5,6,61265,12084,49181,0.8027585081204602,22.42655288888889,2565.5783573333333,14.038950775468216,90,0.011
2,test_20231031_122837,1254659.png,342646,146224,196422,0.5732505267827437,5,7,80080,19363,60717,0.7582042957042957,14.851404444444444,1626.058704,16.019441404197913,90,0.011
3,test_20231031_122837,10188041.png,221231,16474,204757,0.925534848190353,3,8,41731,2369,39362,0.9432316503318876,9.929256888888888,829.3754186666666,18.943292014285603,90,0.011
4,test_20231031_122837,10287332.png,216980,18797,198183,0.9133698958429348,2,6,22337,2562,19775,0.8853024130366656,9.230693333333333,680.4348,19.802938439028576,90,0.011
5,test_20231031_122837,11610969.png,368720,67532,301188,0.8168474723367325,4,6,84111,9649,74462,0.8852825433058696,15.756940444444444,1630.57592,16.007393364015122,90,0.011
6,test_20231031_122837,10350842.png,212614,18797,193817,0.911590958262391,4,7,42529,2713,39816,0.9362082343812458,15.43744711111111,1496.413536,16.380287328577015,90,0.011
7,test_20231031_122837,10863862.png,317432,37387,280045,0.8822204440636104,6,12,66058,5147,60911,0.9220836234823943,19.205189333333333,2079.2916426666666,14.95164952865067,90,0.011
8,test_20231031_122837,11382381.png,312486,2817,309669,0.9909851961367869,4,9,46745,390,46355,0.9916568616964381,18.79158222222222,1911.5095733333333,15.317038834485533,90,0.011
9,test_20231031_122837,11079715.png,443815,207822,235993,0.5317373229836757,7,8,124136,28297,95839,0.7720483985306438,12.951411555555556,1242.8745973333334,17.186530491478862,90,0.011
10,test_20231031_122837,11551286.png,271883,1672,270211,0.993850295899339,2,5,40092,240,39852,0.9940137683328345,16.55832711111111,1608.6751306666667,16.066120129803107,90,0.011
1,test_20231031_122838,10404007.png,502730,64207,438523,0.8722833330018102,4,6,61265,9054,52211,0.8522157838896597,23.794890666666667,2911.559125333333,13.489547470712012,90,0.020999999999999998
2,test_20231031_122838,1254659.png,342646,136084,206562,0.602843751276828,6,7,80080,18111,61969,0.7738386613386613,17.81815111111111,2244.411392,14.619778964744423,90,0.020999999999999998
3,test_20231031_122838,10188041.png,221231,13419,207812,0.9393439436606985,3,5,41731,1944,39787,0.9534159258105486,11.189626666666667,1041.5530293333334,17.95398974476075,90,0.020999999999999998
4,test_20231031_122838,10287332.png,216980,12514,204466,0.9423264817033828,2,6,22337,1711,20626,0.9234006357165242,11.970833777777777,1366.932544,16.77333277530088,90,0.020999999999999998
5,test_20231031_122838,11610969.png,368720,58669,310051,0.840884682143632,4,6,84111,8379,75732,0.9003816385490602,17.054805333333334,1871.8823146666666,15.408018197230254,90,0.020999999999999998
6,test_20231031_122838,10350842.png,212614,15157,197457,0.9287111855287046,3,6,42529,2200,40329,0.9482705918314562,16.58979377777778,1708.029264,15.805850535987396,90,0.020999999999999998
7,test_20231031_122838,10863862.png,317432,34209,283223,0.8922320370977092,4,6,66058,4691,61367,0.9289866480971267,20.106910222222222,2236.0533066666667,14.6359820811362,90,0.020999999999999998
8,test_20231031_122838,11382381.png,312486,1952,310534,0.9937533201487426,2,6,46745,269,46476,0.994245373836774,20.148151111111112,2167.81736,14.770576710483518,90,0.020999999999999998
9,test_20231031_122838,11079715.png,443815,200397,243418,0.5484672667665582,7,7,124136,27295,96841,0.7801201907585229,13.555370666666667,1356.312544,16.807205824769348,90,0.020999999999999998
10,test_20231031_122838,11551286.png,271883,104,271779,0.9996174825200546,2,6,40092,13,40079,0.9996757457846952,18.357187555555555,1944.76624,15.24212954064392,90,0.020999999999999998
1,test_20231031_122839,10404007.png,502730,44479,458251,0.9115250731008693,3,5,61265,6377,54888,0.895911205419081,24.819333333333333,3201.1796,13.07770320244284,90,0.031
2,test_20231031_122839,1254659.png,342646,133382,209264,0.6107294408806756,6,7,80080,17797,62283,0.7777597402597403,18.163216,2319.981072,14.475959192354102,90,0.031
3,test_20231031_122839,10188041.png,221231,10142,211089,0.954156515135763,3,5,41731,1468,40263,0.9648223143466488,12.393836444444444,1349.2313226666668,16.829939460031408,90,0.031
4,test_20231031_122839,10287332.png,216980,12312,204668,0.9432574430823117,2,6,22337,1685,20652,0.924564623718494,11.98551111111111,1372.56112,16.755486682283145,90,0.031
5,test_20231031_122839,11610969.png,368720,54467,314253,0.8522808635278802,4,6,84111,7784,76327,0.9074556241157518,17.609514666666666,1993.4499306666667,15.134750288746432,90,0.031
6,test_20231031_122839,10350842.png,212614,13157,199457,0.9381179038068989,4,6,42529,1917,40612,0.9549248747913188,17.873761777777776,1932.9256693333334,15.268652073148113,90,0.031
7,test_20231031_122839,10863862.png,317432,32872,284560,0.8964439628014819,3,6,66058,4500,61558,0.9318780465651397,22.59953422222222,2731.0776533333333,13.767463121618215,90,0.031
8,test_20231031_122839,11382381.png,312486,1892,310594,0.993945328750728,3,6,46745,260,46485,0.9944379077976254,20.231333333333332,2184.589818666667,14.73710455585473,90,0.031
9,test_20231031_122839,11079715.png,443815,197382,246433,0.5552606378783953,7,7,124136,26896,97240,0.7833344074241155,13.877432888888888,1440.5987306666666,16.545373330905086,90,0.031
10,test_20231031_122839,11551286.png,271883,104,271779,0.9996174825200546,2,6,40092,13,40079,0.9996757457846952,18.357187555555555,1944.76624,15.24212954064392,90,0.031
1,test_20231031_122840,10404007.png,502730,36482,466248,0.9274322200783721,4,6,61265,5274,55991,0.9139149596017302,25.34108977777778,3336.5581813333333,12.897816585920417,90,0.041
2,test_20231031_122840,1254659.png,342646,127634,215012,0.6275047716885649,6,7,80080,17063,63017,0.7869255744255744,19.001751111111112,2512.8746613333333,14.12909533735272,90,0.041
3,test_20231031_122840,10188041.png,221231,7269,213962,0.9671429410887262,3,5,41731,1065,40666,0.974479403800532,13.428087111111111,1586.9864906666667,16.125071310594343,90,0.041
4,test_20231031_122840,10287332.png,216980,11712,205268,0.9460226749009125,3,6,22337,1604,20733,0.928190894032323,12.205171555555555,1436.5239946666666,16.55767476335769,90,0.041
5,test_20231031_122840,11610969.png,368720,45222,323498,0.8773540898242569,4,6,84111,6472,77639,0.9230540595165911,19.651217777777777,2450.551925333333,14.238164515516766,90,0.041
6,test_20231031_122840,10350842.png,212614,10262,202352,0.9517341285145852,2,5,42529,1500,41029,0.9647299489759928,19.200106666666667,2233.9919786666665,14.639987514558484,90,0.041
7,test_20231031_122840,10863862.png,317432,27167,290265,0.9144163159353814,4,6,66058,3715,62343,0.9437615428865542,23.99720177777778,3045.615776,13.294052474516697,90,0.041
8,test_20231031_122840,11382381.png,312486,1772,310714,0.9943293459546988,3,5,46745,242,46503,0.9948229757193283,20.27032,2189.2615413333333,14.727827129716179,90,0.041
9,test_20231031_122840,11079715.png,443815,191594,252221,0.568302107860257,7,7,124136,26120,98016,0.7895856157762454,14.564890666666667,1576.234288,16.154595903392124,90,0.041
10,test_20231031_122840,11551286.png,271883,24,271859,0.9999117267353972,2,5,40092,1,40091,0.9999750573680535,24.866876444444443,3470.407338666667,12.72699907819776,90,0.041
1,test_20231031_122841,10404007.png,502730,23919,478811,0.9524217770970501,3,6,61265,3453,57812,0.9436382926630213,27.205969777777778,3872.079232,12.251361254370469,90,0.051000000000000004
2,test_20231031_122841,1254659.png,342646,121464,221182,0.6455116942850638,5,6,80080,16253,63827,0.7970404595404595,19.81576,2714.0700533333334,13.794593077492527,90,0.051000000000000004
3,test_20231031_122841,10188041.png,221231,6467,214764,0.9707681111598284,2,10,41731,946,40785,0.977331000934557,14.134636444444444,1734.3477066666667,15.739441904794546,90,0.051000000000000004
4,test_20231031_122841,10287332.png,216980,10867,206113,0.949917043045442,4,6,22337,1501,20836,0.9328020772708958,12.305004444444444,1467.2296906666666,16.465822541271397,90,0.051000000000000004
5,test_20231031_122841,11610969.png,368720,38027,330693,0.8968675417661098,4,6,84111,5449,78662,0.9352165590707517,21.151726222222223,2782.9839786666666,13.685696547123394,90,0.051000000000000004
6,test_20231031_122841,10350842.png,212614,8597,204017,0.9595652214811818,3,5,42529,1253,41276,0.9705377507112793,19.85475911111111,2370.970901333333,14.381541369057125,90,0.051000000000000004
7,test_20231031_122841,10863862.png,317432,16927,300505,0.9466751934272537,4,6,66058,2277,63781,0.9655302915619607,26.973411555555554,3878.9450133333335,12.243667376419635,90,0.051000000000000004
8,test_20231031_122841,11382381.png,312486,24,312462,0.9999231965592058,1,5,46745,1,46744,0.9999786073376832,30.521228444444443,5261.919984,10.919361212177094,90,0.051000000000000004
9,test_20231031_122841,11079715.png,443815,184209,259606,0.5849419239998648,8,7,124136,25121,99015,0.7976332409615261,15.06940088888889,1710.8559146666666,15.798669253186947,90,0.051000000000000004
10,test_20231031_122841,11551286.png,271883,24,271859,0.9999117267353972,1,6,40092,1,40091,0.9999750573680535,24.866876444444443,3470.407338666667,12.72699907819776,90,0.051000000000000004
1,test_20231031_122842,10404007.png,502730,24,502706,0.9999522606568138,1,6,61265,1,61264,0.9999836774667429,31.611185777777777,5234.651008,10.941926281199287,90,0.061000000000000006
2,test_20231031_122842,1254659.png,342646,117122,225524,0.6581836647735564,6,6,80080,15676,64404,0.8042457542457543,20.51391288888889,2918.8209813333333,13.478729014411318,90,0.061000000000000006
3,test_20231031_122842,10188041.png,221231,6142,215089,0.9722371638694396,2,6,41731,902,40829,0.9783853729841125,14.481164444444444,1795.708496,15.588445234440327,90,0.061000000000000006
4,test_20231031_122842,10287332.png,216980,9107,207873,0.9580283897133376,2,5,22337,1268,21069,0.9432332005193177,12.670970666666667,1580.175632,16.143750006417417,90,0.061000000000000006
5,test_20231031_122842,11610969.png,368720,27969,340751,0.924145693208939,4,6,84111,3998,80113,0.9524675726123812,25.576528,3867.513808,12.256484879528722,90,0.061000000000000006
6,test_20231031_122842,10350842.png,212614,5692,206922,0.9732284797802591,2,5,42529,828,41701,0.980530931834748,24.302707555555557,3428.620848,12.779608992950138,90,0.061000000000000006
7,test_20231031_122842,10863862.png,317432,14302,303130,0.9549446810655511,3,5,66058,1908,64150,0.9711162917436192,28.505232,4266.533968,11.83005153251008,90,0.061000000000000006
8,test_20231031_122842,11382381.png,312486,24,312462,0.9999231965592058,0,5,46745,1,46744,0.9999786073376832,30.521228444444443,5261.919984,10.919361212177094,90,0.061000000000000006
9,test_20231031_122842,11079715.png,443815,173797,270018,0.6084021495442922,6,13,124136,23687,100449,0.8091850873235806,17.58184177777778,2455.6154453333334,14.22920004525043,90,0.061000000000000006
10,test_20231031_122842,11551286.png,271883,24,271859,0.9999117267353972,1,6,40092,1,40091,0.9999750573680535,24.866876444444443,3470.407338666667,12.72699907819776,90,0.061000000000000006
1,test_20231031_122843,10404007.png,502730,24,502706,0.9999522606568138,1,6,61265,1,61264,0.9999836774667429,31.611185777777777,5234.651008,10.941926281199287,90,0.07100000000000001
2,test_20231031_122843,1254659.png,342646,101969,240677,0.7024071490693018,7,15,80080,13642,66438,0.8296453546453546,22.122528,3344.1506026666666,12.887945333586154,90,0.07100000000000001
3,test_20231031_122843,10188041.png,221231,3279,217952,0.9851783882005687,2,6,41731,480,41251,0.9884977594593947,16.910663111111113,2592.9747733333334,13.992820692645534,90,0.07100000000000001
4,test_20231031_122843,10287332.png,216980,6457,210523,0.9702414969121578,2,5,22337,916,21421,0.9589918073152169,14.840574222222223,2324.6899893333334,14.467153154263244,90,0.07100000000000001
5,test_20231031_122843,11610969.png,368720,14352,354368,0.9610761553482318,3,5,84111,2034,82077,0.97581766950815,30.25143466666667,5057.995648,11.09101909534969,90,0.07100000000000001
6,test_20231031_122843,10350842.png,212614,2012,210602,0.9905368414121365,2,5,42529,294,42235,0.9930870699992946,25.480984888888887,3701.514133333333,12.447009488984513,90,0.07100000000000001
7,test_20231031_122843,10863862.png,317432,10314,307118,0.9675080017137528,3,6,66058,1379,64679,0.9791244058251839,29.17610311111111,4440.818645333334,11.656173231004967,90,0.07100000000000001
8,test_20231031_122843,11382381.png,312486,24,312462,0.9999231965592058,1,5,46745,1,46744,0.9999786073376832,30.521228444444443,5261.919984,10.919361212177094,90,0.07100000000000001
9,test_20231031_122843,11079715.png,443815,147892,295923,0.6667710645201266,6,8,124136,20203,103933,0.837251079461236,19.138101333333335,2853.9071893333335,13.576405153604084,90,0.07100000000000001
10,test_20231031_122843,11551286.png,271883,24,271859,0.9999117267353972,1,6,40092,1,40091,0.9999750573680535,24.866876444444443,3470.407338666667,12.72699907819776,90,0.07100000000000001
1,test_20231031_122844,10404007.png,502730,24,502706,0.9999522606568138,1,5,61265,1,61264,0.9999836774667429,31.611185777777777,5234.651008,10.941926281199287,90,0.081
2,test_20231031_122844,1254659.png,342646,94512,248134,0.7241701347746654,5,6,80080,12611,67469,0.8425199800199801,28.265141333333332,5250.537813333333,10.928765703380904,90,0.081
3,test_20231031_122844,10188041.png,221231,3139,218092,0.9858112109062473,2,5,41731,459,41272,0.9890009824830461,16.930602666666665,2600.416864,13.980373870420786,90,0.081
4,test_20231031_122844,10287332.png,216980,5912,211068,0.9727532491473868,2,5,22337,841,21496,0.9623494650132067,14.985441777777778,2370.0227786666665,14.383278407642628,90,0.081
5,test_20231031_122844,11610969.png,368720,9047,359673,0.9754637665437188,3,6,84111,1280,82831,0.9847820142430835,31.442385777777776,5381.965877333333,10.821394209393977,90,0.081
6,test_20231031_122844,10350842.png,212614,1169,211445,0.9945017731663954,2,6,42529,170,42359,0.9960027275506125,26.418056888888888,3903.505904,12.216255203021644,90,0.081
7,test_20231031_122844,10863862.png,317432,7642,309790,0.9759255525592883,3,5,66058,997,65061,0.9849072027612098,29.720474666666668,4611.390074666667,11.492485003899834,90,0.081
8,test_20231031_122844,11382381.png,312486,24,312462,0.9999231965592058,1,5,46745,1,46744,0.9999786073376832,30.521228444444443,5261.919984,10.919361212177094,90,0.081
9,test_20231031_122844,11079715.png,443815,142527,301288,0.6788594346743575,7,6,124136,19483,104653,0.8430511696848617,19.562035555555557,2970.780304,13.402098249472505,90,0.081
10,test_20231031_122844,11551286.png,271883,24,271859,0.9999117267353972,1,6,40092,1,40091,0.9999750573680535,24.866876444444443,3470.407338666667,12.72699907819776,90,0.081
1,test_20231031_122845,10404007.png,502730,24,502706,0.9999522606568138,1,6,61265,1,61264,0.9999836774667429,31.611185777777777,5234.651008,10.941926281199287,90,0.091
2,test_20231031_122845,1254659.png,342646,91437,251209,0.7331444114333744,5,6,80080,12223,67857,0.8473651348651349,29.494629333333332,5571.353968,10.671196092536164,90,0.091
3,test_20231031_122845,10188041.png,221231,3057,218174,0.9861818642052876,2,5,41731,447,41284,0.9892885384965613,18.547701333333332,2931.962805333333,13.459219042920498,90,0.091
4,test_20231031_122845,10287332.png,216980,5772,211208,0.9733984699050604,2,6,22337,820,21517,0.9632896091686439,15.020433777777777,2380.2594773333335,14.364560578317542,90,0.091
5,test_20231031_122845,11610969.png,368720,6697,362023,0.9818371664135387,3,6,84111,956,83155,0.988634066887803,32.547281777777776,5626.6196586666665,10.628328016273711,90,0.091
6,test_20231031_122845,10350842.png,212614,727,211887,0.9965806579058764,3,6,42529,104,42425,0.9975546097956688,26.73971911111111,3963.2258133333335,12.150315429645325,90,0.091
7,test_20231031_122845,10863862.png,317432,5732,311700,0.9819425892789637,3,6,66058,768,65290,0.9883738532804505,30.402126222222222,4786.486005333333,11.330635674015234,90,0.091
8,test_20231031_122845,11382381.png,312486,24,312462,0.9999231965592058,0,5,46745,1,46744,0.9999786073376832,30.521228444444443,5261.919984,10.919361212177094,90,0.091
9,test_20231031_122845,11079715.png,443815,138867,304948,0.6871061140340007,6,7,124136,18974,105162,0.8471515112457305,19.99391111111111,3092.751685333333,13.227353086366861,90,0.091
10,test_20231031_122845,11551286.png,271883,24,271859,0.9999117267353972,0,5,40092,1,40091,0.9999750573680535,24.866876444444443,3470.407338666667,12.72699907819776,90,0.091
1,test_20231031_122846,10404007.png,502730,67772,434958,0.8651920513993595,4,6,61265,9462,51803,0.8455561903207378,23.058176,2727.90672,13.772508452067445,100,0.001
2,test_20231031_122846,1254659.png,342646,124882,217764,0.6355363844901152,5,7,80080,16697,63383,0.791496003996004,15.886408888888889,1906.5729546666666,15.328269327410602,100,0.001
3,test_20231031_122846,10188041.png,221231,15952,205279,0.9278943728500979,3,6,41731,2239,39492,0.9463468404783015,9.186935111111111,739.7738186666667,19.43981403731463,100,0.001
4,test_20231031_122846,10287332.png,216980,18502,198478,0.9147294681537469,2,6,22337,2510,19827,0.8876303890406053,8.827569777777779,636.149792,20.095209713524675,100,0.001
5,test_20231031_122846,11610969.png,368720,55824,312896,0.8486005641136907,4,6,84111,8032,76079,0.9045071393753492,16.415354666666666,1803.23128,15.570289285514331,100,0.001
6,test_20231031_122846,10350842.png,212614,15307,197307,0.92800568165784,2,6,42529,2223,40306,0.9477297843824214,15.46543288888889,1525.739488,16.295999744197292,100,0.001
7,test_20231031_122846,10863862.png,317432,31397,286035,0.9010906272839537,3,6,66058,4320,61738,0.9346029247025341,19.262922666666668,2158.2171946666667,14.789852125975951,100,0.001
8,test_20231031_122846,11382381.png,312486,2747,309739,0.9912092061724366,2,5,46745,381,46364,0.9918493956572896,18.19576888888889,1808.8638186666667,15.55674488882529,100,0.001
9,test_20231031_122846,11079715.png,443815,182097,261718,0.5897006635647737,6,7,124136,24955,99181,0.7989704839853065,13.536016,1361.429072,16.790853405620375,100,0.001
10,test_20231031_122846,11551286.png,271883,3412,268471,0.9874504842156369,3,6,40092,499,39593,0.9875536266586851,15.161953777777779,1377.448176,16.74005092582284,100,0.001
1,test_20231031_122847,10404007.png,502730,51322,451408,0.897913392874903,4,6,61265,7296,53969,0.8809107973557496,24.39056711111111,3042.5492053333332,13.298427503234258,100,0.011
2,test_20231031_122847,1254659.png,342646,120157,222489,0.6493261266730095,5,6,80080,16156,63924,0.7982517482517483,18.059921777777777,2291.4575786666664,14.529685392266707,100,0.011
3,test_20231031_122847,10188041.png,221231,12272,208959,0.9445285696850803,3,6,41731,1778,39953,0.9573937839975079,11.391541333333333,1089.284864,17.759388918694768,100,0.011
4,test_20231031_122847,10287332.png,216980,15812,201168,0.9271269241404738,2,6,22337,2160,20177,0.9032994582978914,9.534773333333334,745.6240853333334,19.405604326077995,100,0.011
5,test_20231031_122847,11610969.png,368720,50599,318121,0.8627712085050987,5,6,84111,7297,76814,0.9132455921342036,17.31749688888889,1953.7353386666666,15.222146288861204,100,0.011
6,test_20231031_122847,10350842.png,212614,9902,202712,0.95342733780466,2,6,42529,1444,41085,0.9660466975475558,19.870768,2433.8582666666666,14.267850769478995,100,0.011
7,test_20231031_122847,10863862.png,317432,27477,289955,0.9134397288238111,5,6,66058,3800,62258,0.9424747948772291,22.255132444444445,2788.980736,13.67634846342912,100,0.011
8,test_20231031_122847,11382381.png,312486,1712,310774,0.9945213545566841,2,10,46745,230,46515,0.9950796876671302,20.15698311111111,2163.184496,14.779867992754593,100,0.011
9,test_20231031_122847,11079715.png,443815,179002,264813,0.5966742899631603,7,7,124136,24548,99588,0.8022491460978282,14.524238222222221,1531.5777173333333,16.279413216236858,100,0.011
10,test_20231031_122847,11551286.png,271883,807,271076,0.9970318114777312,2,6,40092,118,39974,0.9970567694303103,17.05263111111111,1701.884432,15.821502952772516,100,0.011
1,test_20231031_122848,10404007.png,502730,28342,474388,0.9436238139756927,3,5,61265,4115,57150,0.9328327756467804,25.870083555555556,3455.5346133333333,12.745651133084358,100,0.020999999999999998
2,test_20231031_122848,1254659.png,342646,111214,231432,0.6754259498140939,5,7,80080,15025,65055,0.8123751248751249,20.072131555555554,2767.371882666667,13.710128368054402,100,0.020999999999999998
3,test_20231031_122848,10188041.png,221231,9922,211309,0.9551509508161153,3,6,41731,1445,40286,0.9653734633725528,12.146481777777778,1226.365248,17.244605256227622,100,0.020999999999999998
4,test_20231031_122848,10287332.png,216980,10917,206063,0.9496866070605585,2,6,22337,1505,20832,0.9326230021936697,12.100412444444444,1396.209888,16.681296515001932,100,0.020999999999999998
5,test_20231031_122848,11610969.png,368720,41354,327366,0.8878444348014753,4,6,84111,5970,78141,0.9290223633056318,20.356983111111113,2613.912688,13.957892840323748,100,0.020999999999999998
6,test_20231031_122848,10350842.png,212614,8152,204462,0.9616582162980801,2,5,42529,1192,41337,0.971972066119589,20.675157333333335,2584.4805226666667,14.007070973107137,100,0.020999999999999998
7,test_20231031_122848,10863862.png,317432,24262,293170,0.9235678822550971,3,5,66058,3345,62713,0.9493626812800872,25.36408888888889,3416.908288,12.794470386538858,100,0.020999999999999998
8,test_20231031_122848,11382381.png,312486,1269,311217,0.9959390180680094,2,6,46745,171,46574,0.9963418547438229,20.565045333333334,2247.2447466666667,14.61429987007541,100,0.020999999999999998
9,test_20231031_122848,11079715.png,443815,170672,273143,0.6154433716751349,8,7,124136,23418,100718,0.811352065476574,15.252638222222222,1690.7865973333332,15.849915642986073,100,0.020999999999999998
10,test_20231031_122848,11551286.png,271883,104,271779,0.9996174825200546,2,6,40092,13,40079,0.9996757457846952,18.357187555555555,1944.76624,15.24212954064392,100,0.020999999999999998
1,test_20231031_122850,10404007.png,502730,18734,483996,0.9627354643645695,2,5,61265,2722,58543,0.9555700644740064,27.76827377777778,3996.5331946666665,12.113969363555357,100,0.031
2,test_20231031_122850,1254659.png,342646,108139,234507,0.6844002264728029,6,13,80080,14641,65439,0.8171703296703297,20.681795555555556,2903.4474666666665,13.501663883057592,100,0.031
3,test_20231031_122850,10188041.png,221231,7532,213699,0.9659541384344871,3,6,41731,1100,40631,0.9736406987611128,13.508238222222221,1555.3645226666667,16.212481722445737,100,0.031
4,test_20231031_122850,10287332.png,216980,10777,206203,0.9503318278182321,2,5,22337,1487,20850,0.9334288400411873,12.111240888888888,1400.940816,16.666605723541117,100,0.031
5,test_20231031_122850,11610969.png,368720,35224,333496,0.9044695161640269,5,6,84111,5092,79019,0.9394609504107667,22.623308444444444,3097.449989333333,13.220760577752271,100,0.031
6,test_20231031_122850,10350842.png,212614,4877,207737,0.9770617174786232,3,6,42529,715,41814,0.9831879423452232,25.007861333333334,3616.8999573333335,12.547438644311356,100,0.031
7,test_20231031_122850,10863862.png,317432,22512,294920,0.929080874013962,4,6,66058,3115,62943,0.9528444700112023,25.890723555555557,3533.9776853333333,12.64816557962925,100,0.031
8,test_20231031_122850,11382381.png,312486,24,312462,0.9999231965592058,0,5,46745,1,46744,0.9999786073376832,30.521228444444443,5261.919984,10.919361212177094,100,0.031
9,test_20231031_122850,11079715.png,443815,168402,275413,0.6205581154309792,6,7,124136,23096,101040,0.8139459947154734,15.472657777777778,1754.37744,15.689573268692754,100,0.031
10,test_20231031_122850,11551286.png,271883,24,271859,0.9999117267353972,1,6,40092,1,40091,0.9999750573680535,24.866876444444443,3470.407338666667,12.72699907819776,100,0.031
1,test_20231031_122851,10404007.png,502730,24,502706,0.9999522606568138,1,6,61265,1,61264,0.9999836774667429,31.611185777777777,5234.651008,10.941926281199287,100,0.041
2,test_20231031_122851,1254659.png,342646,102462,240184,0.7009683463399543,6,7,80080,13880,66200,0.8266733266733267,21.292730666666667,3058.6953866666668,13.27544132813271,100,0.041
3,test_20231031_122851,10188041.png,221231,4857,216374,0.9780455722751332,2,6,41731,714,41017,0.9828904171958496,14.639351111111111,1849.27016,15.460799989642737,100,0.041
4,test_20231031_122851,10287332.png,216980,10012,206968,0.9538574983869481,3,6,22337,1384,20953,0.93804002327976,12.352017777777778,1470.190112,16.45706863361876,100,0.041
5,test_20231031_122851,11610969.png,368720,18574,350146,0.9496257322629638,4,6,84111,2675,81436,0.9681967875783192,29.321893333333332,4810.40584,11.308986427815416,100,0.041
6,test_20231031_122851,10350842.png,212614,3992,208622,0.9812241903167243,2,6,42529,585,41944,0.9862446801006373,25.336958222222222,3693.292624,12.456666421815154,100,0.041
7,test_20231031_122851,10863862.png,317432,17549,299883,0.9447157186421029,3,6,66058,2422,63636,0.9633352508401708,26.96344,3791.4685386666665,12.342729042747628,100,0.041
8,test_20231031_122851,11382381.png,312486,24,312462,0.9999231965592058,1,6,46745,1,46744,0.9999786073376832,30.521228444444443,5261.919984,10.919361212177094,100,0.041
9,test_20231031_122851,11079715.png,443815,163257,280558,0.6321507835471987,7,7,124136,22404,101732,0.8195205258748469,15.799473777777777,1834.0607573333334,15.496666423269614,100,0.041
10,test_20231031_122851,11551286.png,271883,24,271859,0.9999117267353972,1,6,40092,1,40091,0.9999750573680535,24.866876444444443,3470.407338666667,12.72699907819776,100,0.041
1,test_20231031_122852,10404007.png,502730,24,502706,0.9999522606568138,1,5,61265,1,61264,0.9999836774667429,31.611185777777777,5234.651008,10.941926281199287,100,0.051000000000000004
2,test_20231031_122852,1254659.png,342646,96432,246214,0.7185666839828861,6,7,80080,13033,67047,0.8372502497502498,22.306769777777777,3339.274336,12.894282611556152,100,0.051000000000000004
3,test_20231031_122852,10188041.png,221231,4354,216877,0.980319213853393,3,6,41731,641,41090,0.9846397162780667,15.546524444444444,2047.9124586666667,15.017689727880327,100,0.051000000000000004
4,test_20231031_122852,10287332.png,216980,9329,207651,0.9570052539404553,3,6,22337,1295,21042,0.9420244437480414,12.43453688888889,1497.135312,16.378193069515543,100,0.051000000000000004
5,test_20231031_122852,11610969.png,368720,24,368696,0.9999349099587763,1,5,84111,1,84110,0.9999881109486274,49.21503644444444,9843.652661333334,8.199240798850546,100,0.051000000000000004
6,test_20231031_122852,10350842.png,212614,1582,211032,0.9925592858419483,2,5,42529,231,42298,0.9945684121423028,26.145738666666666,3880.2293546666665,12.242229640050823,100,0.051000000000000004
7,test_20231031_122852,10863862.png,317432,9449,307983,0.9702329947831346,3,5,66058,1264,64794,0.9808653001907415,30.709354666666666,4841.9687146666665,11.2805838185297,100,0.051000000000000004
8,test_20231031_122852,11382381.png,312486,24,312462,0.9999231965592058,1,5,46745,1,46744,0.9999786073376832,30.521228444444443,5261.919984,10.919361212177094,100,0.051000000000000004
9,test_20231031_122852,11079715.png,443815,149572,294243,0.6629857035025855,6,7,124136,20526,103610,0.8346490945414706,18.63762311111111,2670.649136,13.86463525751151,100,0.051000000000000004
10,test_20231031_122852,11551286.png,271883,24,271859,0.9999117267353972,1,5,40092,1,40091,0.9999750573680535,24.866876444444443,3470.407338666667,12.72699907819776,100,0.051000000000000004
1,test_20231031_122853,10404007.png,502730,24,502706,0.9999522606568138,1,6,61265,1,61264,0.9999836774667429,31.611185777777777,5234.651008,10.941926281199287,100,0.061000000000000006
2,test_20231031_122853,1254659.png,342646,88694,253952,0.7411497580593382,5,6,80080,11979,68101,0.8504120879120879,29.214264888888888,5457.084448,10.761196863560428,100,0.061000000000000006
3,test_20231031_122853,10188041.png,221231,3159,218072,0.985720807662579,2,6,41731,465,41266,0.9888572044762887,17.286019555555555,2666.4651306666665,13.871444520757429,100,0.061000000000000006
4,test_20231031_122853,10287332.png,216980,7832,209148,0.9639045073278644,2,6,22337,1094,21243,0.9510229663786542,12.787616,1606.828096,16.07110943937798,100,0.061000000000000006
5,test_20231031_122853,11610969.png,368720,24,368696,0.9999349099587763,1,5,84111,1,84110,0.9999881109486274,49.21503644444444,9843.652661333334,8.199240798850546,100,0.061000000000000006
6,test_20231031_122853,10350842.png,212614,144,212470,0.99932271628397,2,6,42529,19,42510,0.9995532460203626,29.639073777777778,4698.456229333333,11.41125175531081,100,0.061000000000000006
7,test_20231031_122853,10863862.png,317432,5097,312335,0.9839430177171804,2,5,66058,721,65337,0.989085349238548,35.768135111111114,6324.135104,10.120792215724867,100,0.061000000000000006
8,test_20231031_122853,11382381.png,312486,24,312462,0.9999231965592058,1,6,46745,1,46744,0.9999786073376832,30.521228444444443,5261.919984,10.919361212177094,100,0.061000000000000006
9,test_20231031_122853,11079715.png,443815,146467,297348,0.669981861811791,6,7,124136,20104,104032,0.8380485918669847,19.10135111111111,2799.891776,13.659391159522492,100,0.061000000000000006
10,test_20231031_122853,11551286.png,271883,24,271859,0.9999117267353972,1,6,40092,1,40091,0.9999750573680535,24.866876444444443,3470.407338666667,12.72699907819776,100,0.061000000000000006
1,test_20231031_122854,10404007.png,502730,24,502706,0.9999522606568138,1,5,61265,1,61264,0.9999836774667429,31.611185777777777,5234.651008,10.941926281199287,100,0.07100000000000001
2,test_20231031_122854,1254659.png,342646,75762,266884,0.7788913339131348,5,7,80080,10235,69845,0.8721903096903096,30.678474666666666,5877.572597333334,10.438823588129065,100,0.07100000000000001
3,test_20231031_122854,10188041.png,221231,2697,218534,0.9878091225913186,2,5,41731,397,41334,0.9904866885528744,17.40133688888889,2700.8276373333333,13.815834918021075,100,0.07100000000000001
4,test_20231031_122854,10287332.png,216980,5269,211711,0.9757166559129874,2,6,22337,754,21583,0.9662443479428751,15.021441777777778,2377.276912,14.370005883323646,100,0.07100000000000001
5,test_20231031_122854,11610969.png,368720,24,368696,0.9999349099587763,1,5,84111,1,84110,0.9999881109486274,49.21503644444444,9843.652661333334,8.199240798850546,100,0.07100000000000001
6,test_20231031_122854,10350842.png,212614,104,212510,0.9995108506495339,2,6,42529,13,42516,0.9996943262244586,30.407361777777776,4870.010042666667,11.255505040741753,100,0.07100000000000001
7,test_20231031_122854,10863862.png,317432,2687,314745,0.9915351949393886,3,6,66058,387,65671,0.994141512004602,36.47226311111111,6530.827712,9.981121339613324,100,0.07100000000000001
8,test_20231031_122854,11382381.png,312486,24,312462,0.9999231965592058,1,6,46745,1,46744,0.9999786073376832,30.521228444444443,5261.919984,10.919361212177094,100,0.07100000000000001
9,test_20231031_122854,11079715.png,443815,121524,322291,0.7261832069668668,5,6,124136,16739,107397,0.8651559579815686,20.404675555555556,3141.9117013333334,13.158863851806773,100,0.07100000000000001
10,test_20231031_122854,11551286.png,271883,24,271859,0.9999117267353972,1,5,40092,1,40091,0.9999750573680535,24.866876444444443,3470.407338666667,12.72699907819776,100,0.07100000000000001
1,test_20231031_122855,10404007.png,502730,24,502706,0.9999522606568138,1,5,61265,1,61264,0.9999836774667429,31.611185777777777,5234.651008,10.941926281199287,100,0.081
2,test_20231031_122855,1254659.png,342646,70897,271749,0.7930896610495963,5,6,80080,9585,70495,0.8803071928071928,32.254908444444446,6321.826624,10.122377797206584,100,0.081
3,test_20231031_122855,10188041.png,221231,2397,218834,0.9891651712463443,2,6,41731,353,41378,0.9915410606024299,19.02848,3037.2061226666665,13.306060941722158,100,0.081
4,test_20231031_122855,10287332.png,216980,4987,211993,0.9770163148677298,2,6,22337,712,21625,0.9681246362537493,15.08472,2395.2616906666667,14.337273923432575,100,0.081
5,test_20231031_122855,11610969.png,368720,24,368696,0.9999349099587763,1,5,84111,1,84110,0.9999881109486274,49.21503644444444,9843.652661333334,8.199240798850546,100,0.081
6,test_20231031_122855,10350842.png,212614,104,212510,0.9995108506495339,2,5,42529,13,42516,0.9996943262244586,30.407361777777776,4870.010042666667,11.255505040741753,100,0.081
7,test_20231031_122855,10863862.png,317432,1502,315930,0.9952682779303914,3,5,66058,217,65841,0.9967150080232523,37.47612977777778,6785.630490666666,9.814901542817307,100,0.081
8,test_20231031_122855,11382381.png,312486,24,312462,0.9999231965592058,0,5,46745,1,46744,0.9999786073376832,30.521228444444443,5261.919984,10.919361212177094,100,0.081
9,test_20231031_122855,11079715.png,443815,115314,328501,0.7401755235852776,6,7,124136,15871,108265,0.872148288973384,21.165939555555557,3363.384592,12.863038305638096,100,0.081
10,test_20231031_122855,11551286.png,271883,24,271859,0.9999117267353972,1,6,40092,1,40091,0.9999750573680535,24.866876444444443,3470.407338666667,12.72699907819776,100,0.081
1,test_20231031_122856,10404007.png,502730,24,502706,0.9999522606568138,2,5,61265,1,61264,0.9999836774667429,31.611185777777777,5234.651008,10.941926281199287,100,0.091
2,test_20231031_122856,1254659.png,342646,68887,273759,0.7989557735972403,4,6,80080,9341,70739,0.8833541458541458,33.45248711111111,6664.195338666666,9.893326423878912,100,0.091
3,test_20231031_122856,10188041.png,221231,2357,218874,0.989345977733681,2,5,41731,347,41384,0.9916848386091874,19.07170488888889,3046.5502933333332,13.292720088893347,100,0.091
4,test_20231031_122856,10287332.png,216980,4667,212313,0.9784911051709835,3,6,22337,664,21673,0.9702735371804629,15.167322666666667,2423.478138666667,14.286412544073396,100,0.091
5,test_20231031_122856,11610969.png,368720,24,368696,0.9999349099587763,1,6,84111,1,84110,0.9999881109486274,49.21503644444444,9843.652661333334,8.199240798850546,100,0.091
6,test_20231031_122856,10350842.png,212614,24,212590,0.9998871193806617,3,6,42529,1,42528,0.9999764866326507,55.22670577777778,11938.01408,7.361482740939017,100,0.091
7,test_20231031_122856,10863862.png,317432,827,316605,0.9973947176088107,3,5,66058,119,65939,0.9981985527869448,39.30169955555556,7356.285749333333,9.464217701348815,100,0.091
8,test_20231031_122856,11382381.png,312486,24,312462,0.9999231965592058,0,5,46745,1,46744,0.9999786073376832,30.521228444444443,5261.919984,10.919361212177094,100,0.091
9,test_20231031_122856,11079715.png,443815,111757,332058,0.7481901242634882,6,7,124136,15386,108750,0.8760552941934652,21.56324088888889,3484.747248,12.709090770793946,100,0.091
10,test_20231031_122856,11551286.png,271883,24,271859,0.9999117267353972,1,6,40092,1,40091,0.9999750573680535,24.866876444444443,3470.407338666667,12.72699907819776,100,0.091
1,test_20231031_122857,10404007.png,502730,43567,459163,0.9133391681419449,4,6,61265,6190,55075,0.8989635191381702,24.104625777777777,2998.838688,13.361272558271775,110,0.001
2,test_20231031_122857,1254659.png,342646,103597,239049,0.6976558897521057,5,6,80080,14101,65979,0.8239135864135865,18.053664,2408.430272,14.31346283571825,110,0.001
3,test_20231031_122857,10188041.png,221231,13137,208094,0.9406186293964227,3,6,41731,1853,39878,0.9555965589130383,9.965080888888888,868.677536,18.742217700644726,110,0.001
4,test_20231031_122857,10287332.png,216980,15932,201048,0.9265738777767536,2,6,22337,2170,20167,0.902851770604826,9.076064,685.2587413333333,19.77225776651095,110,0.001
5,test_20231031_122857,11610969.png,368720,41947,326773,0.88623616836624,4,6,84111,6076,78035,0.9277621238601372,17.722387555555557,2108.2881013333335,14.891504031557151,110,0.001
6,test_20231031_122857,10350842.png,212614,10282,202332,0.9516400613318031,3,6,42529,1505,41024,0.9646123821392462,16.577134222222224,1766.8085333333333,15.658908727206391,110,0.001
7,test_20231031_122857,10863862.png,317432,22794,294638,0.9281924947705336,4,7,66058,3166,62892,0.9520724212056072,20.663123555555554,2482.51064,14.181892423174563,110,0.001
8,test_20231031_122857,11382381.png,312486,1472,311014,0.9952893889646256,3,6,46745,199,46546,0.9957428601989518,19.922248888888888,2126.2597386666666,14.854640450929011,110,0.001
9,test_20231031_122857,11079715.png,443815,156022,287793,0.648452621024526,7,7,124136,21524,102612,0.8266095250370561,14.752165333333334,1614.4291466666666,16.05061371215515,110,0.001
10,test_20231031_122857,11551286.png,271883,1512,270371,0.9944387843300243,2,6,40092,218,39874,0.994562506235658,16.194019555555556,1548.9073813333334,16.230549114614764,110,0.001
1,test_20231031_122858,10404007.png,502730,20624,482106,0.9589759910886559,3,7,61265,3013,58252,0.9508202072961723,26.43448,3601.469264,12.56600648136475,110,0.011
2,test_20231031_122858,1254659.png,342646,98652,243994,0.7120876940048914,5,7,80080,13503,66577,0.8313811188811189,20.111057777777777,2788.028202666667,13.677831982566593,110,0.011
3,test_20231031_122858,10188041.png,221231,9299,211932,0.9579670118563854,4,10,41731,1358,40373,0.9674582444705375,12.327939555555556,1265.078944,17.10962733479532,110,0.011
4,test_20231031_122858,10287332.png,216980,13337,203643,0.938533505392202,4,7,22337,1829,20508,0.9181179209383534,9.927393777777779,820.7381066666667,18.988757627914946,110,0.011
5,test_20231031_122858,11610969.png,368720,35387,333333,0.904027446300716,4,6,84111,5143,78968,0.9388546087907645,22.155765333333335,2999.1951893333335,13.360756300560642,110,0.011
6,test_20231031_122858,10350842.png,212614,4374,208240,0.9794275071255891,2,5,42529,638,41891,0.9849984716311223,24.976124444444444,3630.632682666667,12.530980480498554,110,0.011
7,test_20231031_122858,10863862.png,317432,19497,297935,0.938578971244235,3,6,66058,2722,63336,0.9587937872778467,25.73954311111111,3576.5247306666665,12.596191284523893,110,0.011
8,test_20231031_122858,11382381.png,312486,827,311659,0.9973534814359684,3,6,46745,108,46637,0.9976895924697828,21.98863822222222,2588.3288693333334,14.000609045348071,110,0.011
9,test_20231031_122858,11079715.png,443815,152597,291218,0.6561698004799297,5,7,124136,21062,103074,0.8303312495972159,15.864736,1823.4341013333333,15.521902882794993,110,0.011
10,test_20231031_122858,11551286.png,271883,84,271799,0.9996910435738903,2,6,40092,10,40082,0.9997505736805348,18.597185777777778,1989.75912,15.142798569138595,110,0.011
1,test_20231031_122859,10404007.png,502730,13589,489141,0.9729695860601117,2,6,61265,1984,59281,0.9676160940177916,28.04235911111111,4069.7012426666665,12.035178320907523,110,0.020999999999999998
2,test_20231031_122859,1254659.png,342646,89287,253359,0.7394191089345856,5,7,80080,12284,67796,0.8466033966033966,22.326074666666667,3325.2498506666666,12.912560782395545,110,0.020999999999999998
3,test_20231031_122859,10188041.png,221231,7662,213569,0.9653665173506425,3,6,41731,1123,40608,0.9730895497352088,13.121770666666666,1427.3653653333333,16.585452063670687,110,0.020999999999999998
4,test_20231031_122859,10287332.png,216980,9532,207448,0.9560696838418288,2,6,22337,1326,21011,0.9406366118995388,12.216110222222222,1425.4709653333334,16.59121985047711,110,0.020999999999999998
5,test_20231031_122859,11610969.png,368720,16082,352638,0.9563842482100239,3,6,84111,2382,81729,0.9716802796304883,37.32954133333333,6671.651749333333,9.888469921965804,110,0.020999999999999998
6,test_20231031_122859,10350842.png,212614,3309,209305,0.9844365846087275,2,6,42529,483,42046,0.9886430435702697,25.890974222222223,3821.7049546666667,12.308232054922666,110,0.020999999999999998
7,test_20231031_122859,10863862.png,317432,13067,304365,0.9588352781068071,4,6,66058,1875,64183,0.9716158527354749,31.908922666666665,5289.424741333333,10.896719185585283,110,0.020999999999999998
8,test_20231031_122859,11382381.png,312486,24,312462,0.9999231965592058,1,6,46745,1,46744,0.9999786073376832,30.521228444444443,5261.919984,10.919361212177094,110,0.020999999999999998
9,test_20231031_122859,11079715.png,443815,144377,299438,0.6746910311728986,6,6,124136,19934,104202,0.8394180576142296,16.590714666666667,1994.3752906666666,15.13273476034846,110,0.020999999999999998
10,test_20231031_122859,11551286.png,271883,24,271859,0.9999117267353972,0,6,40092,1,40091,0.9999750573680535,24.866876444444443,3470.407338666667,12.72699907819776,110,0.020999999999999998
1,test_20231031_122900,10404007.png,502730,24,502706,0.9999522606568138,1,6,61265,1,61264,0.9999836774667429,31.611185777777777,5234.651008,10.941926281199287,110,0.031
2,test_20231031_122900,1254659.png,342646,87037,255609,0.7459856528312019,5,6,80080,12002,68078,0.8501248751248751,22.737585777777777,3425.173088,12.783978378091305,110,0.031
3,test_20231031_122900,10188041.png,221231,4417,216814,0.9800344436358377,2,5,41731,652,41079,0.9843761232656778,15.004353777777778,1934.133712,15.265938661072589,110,0.031
4,test_20231031_122900,10287332.png,216980,9269,207711,0.9572817771223154,3,6,22337,1294,21043,0.9420692125173479,12.241084444444445,1433.6251306666666,16.56644755537723,110,0.031
5,test_20231031_122900,11610969.png,368720,24,368696,0.9999349099587763,1,5,84111,1,84110,0.9999881109486274,49.21503644444444,9843.652661333334,8.199240798850546,110,0.031
6,test_20231031_122900,10350842.png,212614,3047,209567,0.985668864703171,3,5,42529,446,42083,0.9895130381621952,26.085402666666667,3864.3892533333333,12.259994951792281,110,0.031
7,test_20231031_122900,10863862.png,317432,10617,306815,0.9665534665692179,3,6,66058,1523,64535,0.9769445033152684,33.370871111111114,5626.522021333333,10.628403378970283,110,0.031
8,test_20231031_122900,11382381.png,312486,24,312462,0.9999231965592058,1,5,46745,1,46744,0.9999786073376832,30.521228444444443,5261.919984,10.919361212177094,110,0.031
9,test_20231031_122900,11079715.png,443815,140937,302878,0.6824420084945304,6,6,124136,19454,104682,0.84328478442998,17.39329777777778,2181.218912,14.743811063379813,110,0.031
10,test_20231031_122900,11551286.png,271883,24,271859,0.9999117267353972,1,6,40092,1,40091,0.9999750573680535,24.866876444444443,3470.407338666667,12.72699907819776,110,0.031
1,test_20231031_122901,10404007.png,502730,24,502706,0.9999522606568138,1,5,61265,1,61264,0.9999836774667429,31.611185777777777,5234.651008,10.941926281199287,110,0.041
2,test_20231031_122901,1254659.png,342646,80464,262182,0.7651687164011838,6,7,80080,11085,68995,0.8615759240759241,23.972896,3758.9067306666666,12.380188111209332,110,0.041
3,test_20231031_122901,10188041.png,221231,3772,217459,0.9829499482441431,4,9,41731,557,41174,0.9866526083726725,15.657648,2073.3191413333334,14.96414203659639,110,0.041
4,test_20231031_122901,10287332.png,216980,8687,208293,0.9599640519863581,3,8,22337,1212,21125,0.9457402516004835,12.448528,1493.9774986666666,16.38736304404925,110,0.041
5,test_20231031_122901,11610969.png,368720,24,368696,0.9999349099587763,1,7,84111,1,84110,0.9999881109486274,49.21503644444444,9843.652661333334,8.199240798850546,110,0.041
6,test_20231031_122901,10350842.png,212614,937,211677,0.995592952486666,3,6,42529,137,42392,0.9967786686731407,26.89381511111111,4047.039034666667,12.059429675812163,110,0.041
7,test_20231031_122901,10863862.png,317432,7762,309670,0.9755475188386804,3,6,66058,1132,64926,0.982863544158164,34.93138666666667,6049.223568,10.313807253513854,110,0.041
8,test_20231031_122901,11382381.png,312486,24,312462,0.9999231965592058,1,6,46745,1,46744,0.9999786073376832,30.521228444444443,5261.919984,10.919361212177094,110,0.041
9,test_20231031_122901,11079715.png,443815,129302,314513,0.7086578867320843,6,7,124136,17866,106270,0.8560772056454211,19.528254222222223,2865.7647946666666,13.558398177131231,110,0.041
10,test_20231031_122901,11551286.png,271883,24,271859,0.9999117267353972,1,5,40092,1,40091,0.9999750573680535,24.866876444444443,3470.407338666667,12.72699907819776,110,0.041
1,test_20231031_122902,10404007.png,502730,24,502706,0.9999522606568138,1,5,61265,1,61264,0.9999836774667429,31.611185777777777,5234.651008,10.941926281199287,110,0.051000000000000004
2,test_20231031_122902,1254659.png,342646,73249,269397,0.7862254338296668,5,6,80080,10071,70009,0.8742382617382618,30.850608,5853.013765333333,10.457008153627715,110,0.051000000000000004
3,test_20231031_122902,10188041.png,221231,2777,218454,0.9874475096166451,2,5,41731,411,41320,0.9901512065371068,17.35544711111111,2676.1459786666665,13.855705611890663,110,0.051000000000000004
4,test_20231031_122902,10287332.png,216980,7207,209773,0.9667849571389068,3,6,22337,1009,21328,0.9548283117697094,12.630037333333334,1548.3228906666666,16.232188263479898,110,0.051000000000000004
5,test_20231031_122902,11610969.png,368720,24,368696,0.9999349099587763,1,6,84111,1,84110,0.9999881109486274,49.21503644444444,9843.652661333334,8.199240798850546,110,0.051000000000000004
6,test_20231031_122902,10350842.png,212614,104,212510,0.9995108506495339,2,6,42529,13,42516,0.9996943262244586,30.407361777777776,4870.010042666667,11.255505040741753,110,0.051000000000000004
7,test_20231031_122902,10863862.png,317432,527,316905,0.9983398019103304,2,5,66058,74,65984,0.9988797723212934,42.02362844444445,8138.263376,9.025486201905824,110,0.051000000000000004
8,test_20231031_122902,11382381.png,312486,24,312462,0.9999231965592058,1,5,46745,1,46744,0.9999786073376832,30.521228444444443,5261.919984,10.919361212177094,110,0.051000000000000004
9,test_20231031_122902,11079715.png,443815,123152,320663,0.722515011885583,7,7,124136,17029,107107,0.862819810530386,20.146506666666667,3040.0004693333335,13.302067102101894,110,0.051000000000000004
10,test_20231031_122902,11551286.png,271883,24,271859,0.9999117267353972,1,6,40092,1,40091,0.9999750573680535,24.866876444444443,3470.407338666667,12.72699907819776,110,0.051000000000000004
1,test_20231031_122903,10404007.png,502730,24,502706,0.9999522606568138,1,12,61265,1,61264,0.9999836774667429,31.611185777777777,5234.651008,10.941926281199287,110,0.061000000000000006
2,test_20231031_122903,1254659.png,342646,69252,273394,0.7978905342540115,5,6,80080,9547,70533,0.8807817182817183,32.57650844444444,6348.211242666666,10.104289909895632,110,0.061000000000000006
3,test_20231031_122903,10188041.png,221231,2357,218874,0.989345977733681,2,6,41731,349,41382,0.9916369126069349,19.694913777777778,3210.643024,13.064883397378214,110,0.061000000000000006
4,test_20231031_122903,10287332.png,216980,5952,211028,0.9725689003594802,4,5,22337,830,21507,0.9628419214755787,13.958389333333333,1896.2947306666667,15.351745226155966,110,0.061000000000000006
5,test_20231031_122903,11610969.png,368720,24,368696,0.9999349099587763,1,5,84111,1,84110,0.9999881109486274,49.21503644444444,9843.652661333334,8.199240798850546,110,0.061000000000000006
6,test_20231031_122903,10350842.png,212614,24,212590,0.9998871193806617,1,5,42529,1,42528,0.9999764866326507,55.22670577777778,11938.01408,7.361482740939017,110,0.061000000000000006
7,test_20231031_122903,10863862.png,317432,64,317368,0.9997983820156758,2,5,66058,7,66051,0.9998940325168791,49.54117155555556,10389.180058666667,7.964990876175852,110,0.061000000000000006
8,test_20231031_122903,11382381.png,312486,24,312462,0.9999231965592058,1,5,46745,1,46744,0.9999786073376832,30.521228444444443,5261.919984,10.919361212177094,110,0.061000000000000006
9,test_20231031_122903,11079715.png,443815,119837,323978,0.729984340321981,6,6,124136,16587,107549,0.8663804214732229,20.945164444444444,3257.9757706666664,13.001325107004826,110,0.061000000000000006
10,test_20231031_122903,11551286.png,271883,24,271859,0.9999117267353972,1,6,40092,1,40091,0.9999750573680535,24.866876444444443,3470.407338666667,12.72699907819776,110,0.061000000000000006
1,test_20231031_122904,10404007.png,502730,24,502706,0.9999522606568138,1,6,61265,1,61264,0.9999836774667429,31.611185777777777,5234.651008,10.941926281199287,110,0.07100000000000001
2,test_20231031_122904,1254659.png,342646,57262,285384,0.8328829170630914,4,6,80080,7899,72181,0.9013611388611389,34.09487111111111,6825.778693333334,9.789281574735192,110,0.07100000000000001
3,test_20231031_122904,10188041.png,221231,1972,219259,0.9910862401742975,2,6,41731,292,41439,0.9930028036711318,19.783429333333334,3238.616122666667,13.027208872904978,110,0.07100000000000001
4,test_20231031_122904,10287332.png,216980,3742,213238,0.9827541708913264,4,11,22337,535,21802,0.9760487084210056,16.215616,2675.171136,13.857287909431506,110,0.07100000000000001
5,test_20231031_122904,11610969.png,368720,24,368696,0.9999349099587763,1,10,84111,1,84110,0.9999881109486274,49.21503644444444,9843.652661333334,8.199240798850546,110,0.07100000000000001
6,test_20231031_122904,10350842.png,212614,24,212590,0.9998871193806617,1,6,42529,1,42528,0.9999764866326507,55.22670577777778,11938.01408,7.361482740939017,110,0.07100000000000001
7,test_20231031_122904,10863862.png,317432,24,317408,0.9999243932558785,1,6,66058,1,66057,0.9999848617881256,55.749475555555556,12668.007861333333,7.10372036659619,110,0.07100000000000001
8,test_20231031_122904,11382381.png,312486,24,312462,0.9999231965592058,1,5,46745,1,46744,0.9999786073376832,30.521228444444443,5261.919984,10.919361212177094,110,0.07100000000000001
9,test_20231031_122904,11079715.png,443815,97969,345846,0.7792571229003076,6,6,124136,13592,110544,0.8905071856673326,21.923498666666667,3529.1167146666667,12.654143393179446,110,0.07100000000000001
10,test_20231031_122904,11551286.png,271883,24,271859,0.9999117267353972,1,6,40092,1,40091,0.9999750573680535,24.866876444444443,3470.407338666667,12.72699907819776,110,0.07100000000000001
1,test_20231031_122905,10404007.png,502730,24,502706,0.9999522606568138,1,5,61265,1,61264,0.9999836774667429,31.611185777777777,5234.651008,10.941926281199287,110,0.081
2,test_20231031_122905,1254659.png,342646,54327,288319,0.8414486087682331,4,6,80080,7496,72584,0.9063936063936064,35.013511111111114,7113.839221333334,9.6097631532273,110,0.081
3,test_20231031_122905,10188041.png,221231,1772,219459,0.9919902726109813,2,5,41731,262,41469,0.9937216937049196,19.81144711111111,3248.3392266666665,13.014189842099228,110,0.081
4,test_20231031_122905,10287332.png,216980,3339,213641,0.9846114849294866,2,6,22337,475,21862,0.9787348345793974,16.315795555555557,2708.831845333333,13.802983144580246,110,0.081
5,test_20231031_122905,11610969.png,368720,24,368696,0.9999349099587763,1,6,84111,1,84110,0.9999881109486274,49.21503644444444,9843.652661333334,8.199240798850546,110,0.081
6,test_20231031_122905,10350842.png,212614,24,212590,0.9998871193806617,1,6,42529,1,42528,0.9999764866326507,55.22670577777778,11938.01408,7.361482740939017,110,0.081
7,test_20231031_122905,10863862.png,317432,24,317408,0.9999243932558785,1,6,66058,1,66057,0.9999848617881256,55.749475555555556,12668.007861333333,7.10372036659619,110,0.081
8,test_20231031_122905,11382381.png,312486,24,312462,0.9999231965592058,0,5,46745,1,46744,0.9999786073376832,30.521228444444443,5261.919984,10.919361212177094,110,0.081
9,test_20231031_122905,11079715.png,443815,90452,353363,0.7961943602627221,6,7,124136,12529,111607,0.8990703744280466,22.99411911111111,3850.036256,12.276155415654886,110,0.081
10,test_20231031_122905,11551286.png,271883,24,271859,0.9999117267353972,1,6,40092,1,40091,0.9999750573680535,24.866876444444443,3470.407338666667,12.72699907819776,110,0.081
1,test_20231031_122906,10404007.png,502730,24,502706,0.9999522606568138,1,7,61265,1,61264,0.9999836774667429,31.611185777777777,5234.651008,10.941926281199287,110,0.091
2,test_20231031_122906,1254659.png,342646,51272,291374,0.850364516147861,4,6,80080,7099,72981,0.9113511488511489,35.65756088888889,7341.872533333333,9.472735206823055,110,0.091
3,test_20231031_122906,10188041.png,221231,24,221207,0.999891516107598,1,6,41731,1,41730,0.9999760369988737,32.19604977777778,6734.978176,9.847441680929638,110,0.091
4,test_20231031_122906,10287332.png,216980,3139,213841,0.9855332288690202,2,6,22337,445,21892,0.9800778976585933,16.370922666666665,2725.020032,13.777106616845758,110,0.091
5,test_20231031_122906,11610969.png,368720,24,368696,0.9999349099587763,1,6,84111,1,84110,0.9999881109486274,49.21503644444444,9843.652661333334,8.199240798850546,110,0.091
6,test_20231031_122906,10350842.png,212614,24,212590,0.9998871193806617,1,6,42529,1,42528,0.9999764866326507,55.22670577777778,11938.01408,7.361482740939017,110,0.091
7,test_20231031_122906,10863862.png,317432,24,317408,0.9999243932558785,1,5,66058,1,66057,0.9999848617881256,55.749475555555556,12668.007861333333,7.10372036659619,110,0.091
8,test_20231031_122906,11382381.png,312486,24,312462,0.9999231965592058,1,6,46745,1,46744,0.9999786073376832,30.521228444444443,5261.919984,10.919361212177094,110,0.091
9,test_20231031_122906,11079715.png,443815,85529,358286,0.8072868199587666,7,9,124136,11875,112261,0.9043387897145067,23.670618666666666,4061.442128,12.044000915701854,110,0.091
10,test_20231031_122906,11551286.png,271883,24,271859,0.9999117267353972,2,10,40092,1,40091,0.9999750573680535,24.866876444444443,3470.407338666667,12.72699907819776,110,0.091
1,test_20231031_122908,10404007.png,502730,25769,476961,0.9487418693931136,4,6,61265,3726,57539,0.9391822410838162,25.164213333333333,3281.9456746666665,12.969489728734926,120,0.001
2,test_20231031_122908,1254659.png,342646,84152,258494,0.7544054213386411,4,6,80080,11662,68418,0.8543706293706294,20.031966222222223,2929.3778613333334,13.463049657968673,120,0.001
3,test_20231031_122908,10188041.png,221231,10504,210727,0.9525202164253653,3,6,41731,1483,40248,0.9644628693297549,10.761733333333334,1020.367216,18.04323864418027,120,0.001
4,test_20231031_122908,10287332.png,216980,13559,203421,0.9375103696193198,2,6,22337,1850,20487,0.9171777767829162,9.35664,750.804448,19.375535240148544,120,0.001
5,test_20231031_122908,11610969.png,368720,30692,338028,0.9167606856151009,4,6,84111,4481,79630,0.9467251607994198,20.176567111111112,2670.363557333333,13.865099683440906,120,0.001
6,test_20231031_122908,10350842.png,212614,7047,205567,0.9668554281467824,2,6,42529,1033,41496,0.9757106915281337,18.897082666666666,2271.0700746666666,14.568498261323061,120,0.001
7,test_20231031_122908,10863862.png,317432,14797,302635,0.9533852919680436,3,6,66058,2114,63944,0.9679978200974901,23.30008,3113.238448,13.198679755902349,120,0.001
8,test_20231031_122908,11382381.png,312486,767,311719,0.9975454900379537,2,5,46745,101,46644,0.9978393411060006,21.620851555555557,2482.477712,14.181950028339719,120,0.001
9,test_20231031_122908,11079715.png,443815,132167,311648,0.7022024942825276,5,7,124136,18379,105757,0.8519446413610878,16.32134222222222,1955.1006453333334,15.219112418020991,120,0.001
10,test_20231031_122908,11551286.png,271883,487,271396,0.9982087883391018,2,6,40092,70,40022,0.9982540157637434,17.985697777777776,1870.2736906666667,15.411751962304145,120,0.001
1,test_20231031_122909,10404007.png,502730,10232,492498,0.979647126688282,2,6,61265,1507,59758,0.9754019423814576,28.228097777777776,4124.118885333333,11.977491847365343,120,0.011
2,test_20231031_122909,1254659.png,342646,75862,266784,0.7785994875177297,5,6,80080,10600,69480,0.8676323676323676,23.42231288888889,3644.680176,12.514209362776771,120,0.011
3,test_20231031_122909,10188041.png,221231,7219,214012,0.9673689491978972,3,6,41731,1056,40675,0.9746950708106683,12.931992888888889,1390.6065813333332,16.698760804249673,120,0.011
4,test_20231031_122909,10287332.png,216980,11147,205833,0.9486266015300949,3,6,22337,1540,20797,0.9310560952679411,10.141160888888889,878.0641013333334,18.695541389946506,120,0.011
5,test_20231031_122909,11610969.png,368720,13177,355543,0.9642628552831417,3,6,84111,1956,82155,0.9767450155152121,37.71244977777778,6783.1912053333335,9.816463016901352,120,0.011
6,test_20231031_122909,10350842.png,212614,2767,209847,0.9869858052621182,2,6,42529,405,42124,0.990477086223518,26.432816,3966.042224,12.147230273091186,120,0.011
7,test_20231031_122909,10863862.png,317432,8797,308635,0.9722869779984374,2,6,66058,1281,64777,0.9806079505888764,35.295431111111114,6222.461376,10.191181513272763,120,0.011
8,test_20231031_122909,11382381.png,312486,367,312119,0.9988255473845228,1,6,46745,47,46698,0.9989945448711092,23.250945777777776,2860.806096,13.565919383269115,120,0.011
9,test_20231031_122909,11079715.png,443815,129302,314513,0.7086578867320843,5,7,124136,17979,106157,0.8551669137075466,17.01976711111111,2096.5766986666667,14.915696061252648,120,0.011
10,test_20231031_122909,11551286.png,271883,24,271859,0.9999117267353972,1,6,40092,1,40091,0.9999750573680535,24.866876444444443,3470.407338666667,12.72699907819776,120,0.011
1,test_20231031_122910,10404007.png,502730,24,502706,0.9999522606568138,1,6,61265,1,61264,0.9999836774667429,31.611185777777777,5234.651008,10.941926281199287,120,0.020999999999999998
2,test_20231031_122910,1254659.png,342646,70154,272492,0.7952580797674568,5,6,80080,9816,70264,0.8774225774225775,24.463347555555554,3907.9615306666665,12.211300809238923,120,0.020999999999999998
3,test_20231031_122910,10188041.png,221231,5349,215882,0.975821652480891,3,6,41731,786,40945,0.9811650811147589,13.972179555555556,1646.49352,15.965203350418363,120,0.020999999999999998
4,test_20231031_122910,10287332.png,216980,8162,208818,0.9623836298276339,2,6,22337,1136,21201,0.94914267806778,12.368256,1469.0344746666667,16.460483731227068,120,0.020999999999999998
5,test_20231031_122910,11610969.png,368720,24,368696,0.9999349099587763,1,5,84111,1,84110,0.9999881109486274,49.21503644444444,9843.652661333334,8.199240798850546,120,0.020999999999999998
6,test_20231031_122910,10350842.png,212614,2164,210450,0.9898219308229937,2,5,42529,316,42213,0.9925697759176092,26.508842666666666,3987.5632,12.123727814938967,120,0.020999999999999998
7,test_20231031_122910,10863862.png,317432,4112,313320,0.98704604450717,2,6,66058,605,65453,0.9908413818159799,42.970181333333336,8433.226981333333,8.870865712945191,120,0.020999999999999998
8,test_20231031_122910,11382381.png,312486,24,312462,0.9999231965592058,1,6,46745,1,46744,0.9999786073376832,30.521228444444443,5261.919984,10.919361212177094,120,0.020999999999999998
9,test_20231031_122910,11079715.png,443815,121162,322653,0.7269988621385037,6,7,124136,16850,107286,0.8642617774054263,17.947683555555557,2319.5613653333335,14.47674494350224,120,0.020999999999999998
10,test_20231031_122910,11551286.png,271883,24,271859,0.9999117267353972,1,6,40092,1,40091,0.9999750573680535,24.866876444444443,3470.407338666667,12.72699907819776,120,0.020999999999999998
1,test_20231031_122911,10404007.png,502730,24,502706,0.9999522606568138,1,5,61265,1,61264,0.9999836774667429,31.611185777777777,5234.651008,10.941926281199287,120,0.031
2,test_20231031_122911,1254659.png,342646,66887,275759,0.8047927015053438,4,6,80080,9366,70714,0.8830419580419581,25.860064,4282.5402773333335,11.813789046672905,120,0.031
3,test_20231031_122911,10188041.png,221231,3209,218022,0.985494799553408,2,5,41731,473,41258,0.9886655004672785,15.793338666666667,2106.6143093333335,14.894953310315422,120,0.031
4,test_20231031_122911,10287332.png,216980,7399,209581,0.9659000829569545,3,6,22337,1032,21305,0.9537986300756592,13.429212444444444,1730.2872426666668,15.749621551091085,120,0.031
5,test_20231031_122911,11610969.png,368720,24,368696,0.9999349099587763,0,5,84111,1,84110,0.9999881109486274,49.21503644444444,9843.652661333334,8.199240798850546,120,0.031
6,test_20231031_122911,10350842.png,212614,24,212590,0.9998871193806617,1,6,42529,1,42528,0.9999764866326507,55.22670577777778,11938.01408,7.361482740939017,120,0.031
7,test_20231031_122911,10863862.png,317432,2807,314625,0.9911571612187807,2,6,66058,413,65645,0.9937479184958673,48.223776,9978.001408,8.140367999812652,120,0.031
8,test_20231031_122911,11382381.png,312486,24,312462,0.9999231965592058,1,6,46745,1,46744,0.9999786073376832,30.521228444444443,5261.919984,10.919361212177094,120,0.031
9,test_20231031_122911,11079715.png,443815,118007,325808,0.7341076800018025,6,7,124136,16422,107714,0.8677096088161371,18.655964444444443,2489.970058666667,14.16886236034836,120,0.031
10,test_20231031_122911,11551286.png,271883,24,271859,0.9999117267353972,1,17,40092,1,40091,0.9999750573680535,24.866876444444443,3470.407338666667,12.72699907819776,120,0.031
1,test_20231031_122912,10404007.png,502730,24,502706,0.9999522606568138,1,6,61265,1,61264,0.9999836774667429,31.611185777777777,5234.651008,10.941926281199287,120,0.041
2,test_20231031_122912,1254659.png,342646,61212,281434,0.8213549844445871,5,7,80080,8580,71500,0.8928571428571429,27.529936,4767.120570666667,11.348242245664151,120,0.041
3,test_20231031_122912,10188041.png,221231,2367,218864,0.9893007761118469,2,6,41731,350,41381,0.9916129496058086,18.281512888888887,2679.7901386666667,13.849795762375196,120,0.041
4,test_20231031_122912,10287332.png,216980,6434,210546,0.9703474974652042,3,6,22337,898,21439,0.9597976451627345,13.70357688888889,1812.882336,15.547107434708112,120,0.041
5,test_20231031_122912,11610969.png,368720,24,368696,0.9999349099587763,1,6,84111,1,84110,0.9999881109486274,49.21503644444444,9843.652661333334,8.199240798850546,120,0.041
6,test_20231031_122912,10350842.png,212614,24,212590,0.9998871193806617,1,6,42529,1,42528,0.9999764866326507,55.22670577777778,11938.01408,7.361482740939017,120,0.041
7,test_20231031_122912,10863862.png,317432,64,317368,0.9997983820156758,2,6,66058,7,66051,0.9998940325168791,49.54117155555556,10389.180058666667,7.964990876175852,120,0.041
8,test_20231031_122912,11382381.png,312486,24,312462,0.9999231965592058,1,6,46745,1,46744,0.9999786073376832,30.521228444444443,5261.919984,10.919361212177094,120,0.041
9,test_20231031_122912,11079715.png,443815,106342,337473,0.7603911539718126,6,7,124136,14793,109343,0.8808323129470903,21.07216711111111,3262.670645333333,12.995071253067,120,0.041
10,test_20231031_122912,11551286.png,271883,24,271859,0.9999117267353972,1,6,40092,1,40091,0.9999750573680535,24.866876444444443,3470.407338666667,12.72699907819776,120,0.041
1,test_20231031_122913,10404007.png,502730,24,502706,0.9999522606568138,1,6,61265,1,61264,0.9999836774667429,31.611185777777777,5234.651008,10.941926281199287,120,0.051000000000000004
2,test_20231031_122913,1254659.png,342646,53432,289214,0.8440606340071094,12,7,80080,7498,72582,0.9063686313686313,34.55402844444444,6950.713936,9.710509458402417,120,0.051000000000000004
3,test_20231031_122913,10188041.png,221231,2114,219117,0.9904443771442519,2,6,41731,313,41418,0.9924995806474803,19.751105777777777,3222.372954666667,13.049045570068982,120,0.051000000000000004
4,test_20231031_122913,10287332.png,216980,4987,211993,0.9770163148677298,3,6,22337,695,21642,0.9688857053319604,14.088956444444445,1935.6087253333333,15.262627897150713,120,0.051000000000000004
5,test_20231031_122913,11610969.png,368720,24,368696,0.9999349099587763,1,7,84111,1,84110,0.9999881109486274,49.21503644444444,9843.652661333334,8.199240798850546,120,0.051000000000000004
6,test_20231031_122913,10350842.png,212614,24,212590,0.9998871193806617,1,7,42529,1,42528,0.9999764866326507,55.22670577777778,11938.01408,7.361482740939017,120,0.051000000000000004
7,test_20231031_122913,10863862.png,317432,24,317408,0.9999243932558785,2,10,66058,1,66057,0.9999848617881256,55.749475555555556,12668.007861333333,7.10372036659619,120,0.051000000000000004
8,test_20231031_122913,11382381.png,312486,24,312462,0.9999231965592058,1,8,46745,1,46744,0.9999786073376832,30.521228444444443,5261.919984,10.919361212177094,120,0.051000000000000004
9,test_20231031_122913,11079715.png,443815,100632,343183,0.7732568750492885,6,7,124136,14004,110132,0.8871882451504801,21.86672711111111,3492.838186666667,12.699018944016213,120,0.051000000000000004
10,test_20231031_122913,11551286.png,271883,24,271859,0.9999117267353972,1,5,40092,1,40091,0.9999750573680535,24.866876444444443,3470.407338666667,12.72699907819776,120,0.051000000000000004
1,test_20231031_122914,10404007.png,502730,24,502706,0.9999522606568138,1,17,61265,1,61264,0.9999836774667429,31.611185777777777,5234.651008,10.941926281199287,120,0.061000000000000006
2,test_20231031_122914,1254659.png,342646,49667,292979,0.8550486507941141,4,6,80080,6977,73103,0.9128746253746254,35.70025777777778,7315.247322666667,9.48851347008956,120,0.061000000000000006
3,test_20231031_122914,10188041.png,221231,1872,219359,0.9915382563926394,2,6,41731,277,41454,0.9933622486880257,19.927130666666667,3283.704592,12.967162805797399,120,0.061000000000000006
4,test_20231031_122914,10287332.png,216980,4827,212153,0.9777537100193566,3,6,22337,673,21664,0.9698706182567042,14.147822222222223,1955.2949546666666,15.218680812219683,120,0.061000000000000006
5,test_20231031_122914,11610969.png,368720,24,368696,0.9999349099587763,1,6,84111,1,84110,0.9999881109486274,49.21503644444444,9843.652661333334,8.199240798850546,120,0.061000000000000006
6,test_20231031_122914,10350842.png,212614,24,212590,0.9998871193806617,1,5,42529,1,42528,0.9999764866326507,55.22670577777778,11938.01408,7.361482740939017,120,0.061000000000000006
7,test_20231031_122914,10863862.png,317432,24,317408,0.9999243932558785,1,6,66058,1,66057,0.9999848617881256,55.749475555555556,12668.007861333333,7.10372036659619,120,0.061000000000000006
8,test_20231031_122914,11382381.png,312486,24,312462,0.9999231965592058,1,6,46745,1,46744,0.9999786073376832,30.521228444444443,5261.919984,10.919361212177094,120,0.061000000000000006
9,test_20231031_122914,11079715.png,443815,96312,347503,0.7829906605229656,6,15,124136,13415,110721,0.8919330411806405,22.781585777777778,3767.209408,12.370605988512246,120,0.061000000000000006
10,test_20231031_122914,11551286.png,271883,24,271859,0.9999117267353972,1,6,40092,1,40091,0.9999750573680535,24.866876444444443,3470.407338666667,12.72699907819776,120,0.061000000000000006
1,test_20231031_122915,10404007.png,502730,24,502706,0.9999522606568138,1,5,61265,1,61264,0.9999836774667429,31.611185777777777,5234.651008,10.941926281199287,120,0.07100000000000001
2,test_20231031_122915,1254659.png,342646,40259,302387,0.8825055596738325,4,6,80080,5665,74415,0.9292582417582418,37.548094222222225,7911.801744,9.148049648072973,120,0.07100000000000001
3,test_20231031_122915,10188041.png,221231,1372,219859,0.993798337484349,2,11,41731,202,41529,0.9951594737724953,20.047792,3323.029488,12.915461657165357,120,0.07100000000000001
4,test_20231031_122915,10287332.png,216980,2437,214543,0.9887685500967831,2,7,22337,349,21988,0.9843756995120204,19.569664,3542.500032,12.63770498025357,120,0.07100000000000001
5,test_20231031_122915,11610969.png,368720,24,368696,0.9999349099587763,1,6,84111,1,84110,0.9999881109486274,49.21503644444444,9843.652661333334,8.199240798850546,120,0.07100000000000001
6,test_20231031_122915,10350842.png,212614,24,212590,0.9998871193806617,1,5,42529,1,42528,0.9999764866326507,55.22670577777778,11938.01408,7.361482740939017,120,0.07100000000000001
7,test_20231031_122915,10863862.png,317432,24,317408,0.9999243932558785,1,5,66058,1,66057,0.9999848617881256,55.749475555555556,12668.007861333333,7.10372036659619,120,0.07100000000000001
8,test_20231031_122915,11382381.png,312486,24,312462,0.9999231965592058,1,6,46745,1,46744,0.9999786073376832,30.521228444444443,5261.919984,10.919361212177094,120,0.07100000000000001
9,test_20231031_122915,11079715.png,443815,68567,375248,0.8455054470894404,6,7,124136,9571,114565,0.9228990784301089,26.389601777777777,4837.166010666667,11.284893683152482,120,0.07100000000000001
10,test_20231031_122915,11551286.png,271883,24,271859,0.9999117267353972,1,7,40092,1,40091,0.9999750573680535,24.866876444444443,3470.407338666667,12.72699907819776,120,0.07100000000000001
1,test_20231031_122916,10404007.png,502730,24,502706,0.9999522606568138,1,6,61265,1,61264,0.9999836774667429,31.611185777777777,5234.651008,10.941926281199287,120,0.081
2,test_20231031_122916,1254659.png,342646,39092,303554,0.8859114071082108,4,7,80080,5506,74574,0.9312437562437562,38.084272,8095.638917333334,9.048292313952546,120,0.081
3,test_20231031_122916,10188041.png,221231,24,221207,0.999891516107598,1,8,41731,1,41730,0.9999760369988737,32.19604977777778,6734.978176,9.847441680929638,120,0.081
4,test_20231031_122916,10287332.png,216980,2154,214826,0.9900728177712231,2,7,22337,307,22030,0.9862559878228947,19.639080888888888,3565.3897333333334,12.609733512845487,120,0.081
5,test_20231031_122916,11610969.png,368720,24,368696,0.9999349099587763,1,6,84111,1,84110,0.9999881109486274,49.21503644444444,9843.652661333334,8.199240798850546,120,0.081
6,test_20231031_122916,10350842.png,212614,24,212590,0.9998871193806617,1,7,42529,1,42528,0.9999764866326507,55.22670577777778,11938.01408,7.361482740939017,120,0.081
7,test_20231031_122916,10863862.png,317432,24,317408,0.9999243932558785,1,5,66058,1,66057,0.9999848617881256,55.749475555555556,12668.007861333333,7.10372036659619,120,0.081
8,test_20231031_122916,11382381.png,312486,24,312462,0.9999231965592058,1,6,46745,1,46744,0.9999786073376832,30.521228444444443,5261.919984,10.919361212177094,120,0.081
9,test_20231031_122916,11079715.png,443815,62779,381036,0.8585469170713023,5,6,124136,8783,115353,0.9292469549526325,27.13067911111111,5084.2731146666665,11.06851489126218,120,0.081
10,test_20231031_122916,11551286.png,271883,24,271859,0.9999117267353972,1,5,40092,1,40091,0.9999750573680535,24.866876444444443,3470.407338666667,12.72699907819776,120,0.081
1,test_20231031_122917,10404007.png,502730,24,502706,0.9999522606568138,1,6,61265,1,61264,0.9999836774667429,31.611185777777777,5234.651008,10.941926281199287,120,0.091
2,test_20231031_122917,1254659.png,342646,36722,305924,0.8928281666793133,4,7,80080,5200,74880,0.935064935064935,38.86042311111111,8372.420490666667,8.902293289472794,120,0.091
3,test_20231031_122917,10188041.png,221231,24,221207,0.999891516107598,1,11,41731,1,41730,0.9999760369988737,32.19604977777778,6734.978176,9.847441680929638,120,0.091
4,test_20231031_122917,10287332.png,216980,1932,215048,0.9910959535441054,3,6,22337,275,22062,0.9876885884407037,19.75100088888889,3601.2163626666666,12.566311461088343,120,0.091
5,test_20231031_122917,11610969.png,368720,24,368696,0.9999349099587763,2,6,84111,1,84110,0.9999881109486274,49.21503644444444,9843.652661333334,8.199240798850546,120,0.091
6,test_20231031_122917,10350842.png,212614,24,212590,0.9998871193806617,1,6,42529,1,42528,0.9999764866326507,55.22670577777778,11938.01408,7.361482740939017,120,0.091
7,test_20231031_122917,10863862.png,317432,24,317408,0.9999243932558785,1,6,66058,1,66057,0.9999848617881256,55.749475555555556,12668.007861333333,7.10372036659619,120,0.091
8,test_20231031_122917,11382381.png,312486,24,312462,0.9999231965592058,1,6,46745,1,46744,0.9999786073376832,30.521228444444443,5261.919984,10.919361212177094,120,0.091
9,test_20231031_122917,11079715.png,443815,60447,383368,0.8638013586742224,7,6,124136,8450,115686,0.9319294966810595,27.627457777777778,5237.022789333333,10.939958970943263,120,0.091
10,test_20231031_122917,11551286.png,271883,24,271859,0.9999117267353972,1,5,40092,1,40091,0.9999750573680535,24.866876444444443,3470.407338666667,12.72699907819776,120,0.091
1,test_20231031_122918,10404007.png,502730,14797,487933,0.9705667057864062,3,5,61265,2153,59112,0.9648575858973313,26.675523555555557,3677.0935466666665,12.475756822407263,130,0.001
2,test_20231031_122918,1254659.png,342646,65009,277637,0.8102735768110528,5,6,80080,9147,70933,0.8857767232767233,21.97528888888889,3512.2054293333335,12.67500450952557,130,0.001
3,test_20231031_122918,10188041.png,221231,7982,213249,0.9639200654519484,3,6,41731,1142,40589,0.9726342527138099,12.194165333333334,1410.783392,16.63620022436401,130,0.001
4,test_20231031_122918,10287332.png,216980,11177,205803,0.9484883399391649,3,6,22337,1538,20799,0.9311456328065542,9.715194666666667,854.379088,18.814297509556095,130,0.001
5,test_20231031_122918,11610969.png,368720,20724,347996,0.9437947494033413,3,5,84111,3041,81070,0.9638453947759509,23.702741333333332,3441.175072,12.763735926731954,130,0.001
6,test_20231031_122918,10350842.png,212614,3027,209587,0.985762931885953,2,5,42529,441,42088,0.9896306049989418,24.490901333333333,3586.0659306666666,12.584620909620183,130,0.001
7,test_20231031_122918,10863862.png,317432,6977,310455,0.978020489427657,3,5,66058,1024,65034,0.9844984710406007,36.437904,6694.791408,9.873433107769149,130,0.001
8,test_20231031_122918,11382381.png,312486,367,312119,0.9988255473845228,2,5,46745,48,46697,0.9989731522087923,23.28773511111111,2886.24232,13.527475705549977,130,0.001
9,test_20231031_122918,11079715.png,443815,107537,336278,0.7576985906289783,5,7,124136,15092,109044,0.8784236643681124,18.001861333333334,2370.5821066666667,14.382253588780998,130,0.001
10,test_20231031_122918,11551286.png,271883,164,271719,0.9993967993585476,2,6,40092,22,40070,0.9994512620971765,18.120286222222223,1899.5769013333334,15.344234809036362,130,0.001
1,test_20231031_122919,10404007.png,502730,6477,496253,0.9871163447576233,2,11,61265,955,60310,0.9844119807394107,28.713781333333333,4277.583808,11.81881833713713,130,0.011
2,test_20231031_122919,1254659.png,342646,57582,285064,0.8319490085977947,4,6,80080,8162,71918,0.8980769230769231,25.629578666666667,4322.616266666667,11.773336774198842,130,0.011
3,test_20231031_122919,10188041.png,221231,5229,216002,0.9763640719429013,3,6,41731,767,40964,0.9816203781361578,14.423552,1832.788064,15.49968113012527,130,0.011
4,test_20231031_122919,10287332.png,216980,7582,209398,0.9650566872522813,2,5,22337,1051,21286,0.9529480234588351,15.079568,2168.716250666667,14.768776271252522,130,0.011
5,test_20231031_122919,11610969.png,368720,24,368696,0.9999349099587763,1,5,84111,1,84110,0.9999881109486274,49.21503644444444,9843.652661333334,8.199240798850546,130,0.011
6,test_20231031_122919,10350842.png,212614,24,212590,0.9998871193806617,1,6,42529,1,42528,0.9999764866326507,55.22670577777778,11938.01408,7.361482740939017,130,0.011
7,test_20231031_122919,10863862.png,317432,3492,313940,0.9889992187303107,2,5,66058,512,65546,0.9922492355203003,47.985098666666666,9940.397578666667,8.156766059707973,130,0.011
8,test_20231031_122919,11382381.png,312486,287,312199,0.9990815588538366,2,5,46745,36,46709,0.9992298641565943,23.638037333333333,2954.0109653333334,13.426682577813091,130,0.011
9,test_20231031_122919,11079715.png,443815,104342,339473,0.764897536135552,5,6,124136,14659,109477,0.8819117741831539,18.57570488888889,2500.6568426666668,14.150262619248434,130,0.011
10,test_20231031_122919,11551286.png,271883,24,271859,0.9999117267353972,1,11,40092,1,40091,0.9999750573680535,24.866876444444443,3470.407338666667,12.72699907819776,130,0.011
1,test_20231031_122920,10404007.png,502730,24,502706,0.9999522606568138,1,5,61265,1,61264,0.9999836774667429,31.611185777777777,5234.651008,10.941926281199287,130,0.020999999999999998
2,test_20231031_122920,1254659.png,342646,50732,291914,0.851940486683049,5,6,80080,7210,72870,0.909965034965035,27.921953777777777,4976.321370666667,11.161719415564535,130,0.020999999999999998
3,test_20231031_122920,10188041.png,221231,3259,217972,0.9852687914442371,2,5,41731,479,41252,0.988521722460521,16.574353777777777,2394.7949653333335,14.33812024426771,130,0.020999999999999998
4,test_20231031_122920,10287332.png,216980,3772,213208,0.9826159093003963,3,7,22337,526,21811,0.9764516273447643,18.63936,3219.883008,13.052402686450822,130,0.020999999999999998
5,test_20231031_122920,11610969.png,368720,24,368696,0.9999349099587763,0,5,84111,1,84110,0.9999881109486274,49.21503644444444,9843.652661333334,8.199240798850546,130,0.020999999999999998
6,test_20231031_122920,10350842.png,212614,24,212590,0.9998871193806617,1,9,42529,1,42528,0.9999764866326507,55.22670577777778,11938.01408,7.361482740939017,130,0.020999999999999998
7,test_20231031_122920,10863862.png,317432,2304,315128,0.9927417525643287,1,5,66058,338,65720,0.9948832843864482,51.520912,11039.537146666667,7.701294957050289,130,0.020999999999999998
8,test_20231031_122920,11382381.png,312486,24,312462,0.9999231965592058,1,6,46745,1,46744,0.9999786073376832,30.521228444444443,5261.919984,10.919361212177094,130,0.020999999999999998
9,test_20231031_122920,11079715.png,443815,93952,349863,0.7883081914761781,5,11,124136,13193,110943,0.8937214023329252,20.532414222222222,3023.7557706666666,13.325336506707568,130,0.020999999999999998
10,test_20231031_122920,11551286.png,271883,24,271859,0.9999117267353972,1,6,40092,1,40091,0.9999750573680535,24.866876444444443,3470.407338666667,12.72699907819776,130,0.020999999999999998
1,test_20231031_122921,10404007.png,502730,24,502706,0.9999522606568138,1,5,61265,1,61264,0.9999836774667429,31.611185777777777,5234.651008,10.941926281199287,130,0.031
2,test_20231031_122921,1254659.png,342646,47494,295152,0.8613904729662684,5,13,80080,6764,73316,0.9155344655344655,29.372485333333334,5376.524634666666,10.825787208325723,130,0.031
3,test_20231031_122921,10188041.png,221231,1742,219489,0.9921258774764838,2,6,41731,256,41475,0.9938654717116772,19.517123555555557,3067.6957866666667,13.262680710155543,130,0.031
4,test_20231031_122921,10287332.png,216980,3512,213468,0.98381417642179,2,6,22337,495,21842,0.9778394591932668,18.689550222222223,3237.459264,13.028760483442598,130,0.031
5,test_20231031_122921,11610969.png,368720,24,368696,0.9999349099587763,1,6,84111,1,84110,0.9999881109486274,49.21503644444444,9843.652661333334,8.199240798850546,130,0.031
6,test_20231031_122921,10350842.png,212614,24,212590,0.9998871193806617,1,6,42529,1,42528,0.9999764866326507,55.22670577777778,11938.01408,7.361482740939017,130,0.031
7,test_20231031_122921,10863862.png,317432,24,317408,0.9999243932558785,1,6,66058,1,66057,0.9999848617881256,55.749475555555556,12668.007861333333,7.10372036659619,130,0.031
8,test_20231031_122921,11382381.png,312486,24,312462,0.9999231965592058,1,6,46745,1,46744,0.9999786073376832,30.521228444444443,5261.919984,10.919361212177094,130,0.031
9,test_20231031_122921,11079715.png,443815,87347,356468,0.8031905185719275,5,7,124136,12259,111877,0.9012454082619064,22.656586666666666,3714.0114986666667,12.432371168761701,130,0.031
10,test_20231031_122921,11551286.png,271883,24,271859,0.9999117267353972,1,6,40092,1,40091,0.9999750573680535,24.866876444444443,3470.407338666667,12.72699907819776,130,0.031
1,test_20231031_122922,10404007.png,502730,24,502706,0.9999522606568138,1,5,61265,1,61264,0.9999836774667429,31.611185777777777,5234.651008,10.941926281199287,130,0.041
2,test_20231031_122922,1254659.png,342646,41142,301504,0.8799285560024048,4,6,80080,5860,74220,0.9268231768231768,36.03475022222222,7475.9352266666665,9.394148309785459,130,0.041
3,test_20231031_122922,10188041.png,221231,1189,220042,0.9946255271639146,2,6,41731,175,41556,0.9958064748029043,21.09402311111111,3642.4954986666667,12.516813371192075,130,0.041
4,test_20231031_122922,10287332.png,216980,3047,213933,0.9859572310812056,3,6,22337,428,21909,0.9808389667368044,18.891909333333334,3299.036122666667,12.946932900061318,130,0.041
5,test_20231031_122922,11610969.png,368720,24,368696,0.9999349099587763,1,6,84111,1,84110,0.9999881109486274,49.21503644444444,9843.652661333334,8.199240798850546,130,0.041
6,test_20231031_122922,10350842.png,212614,24,212590,0.9998871193806617,1,14,42529,1,42528,0.9999764866326507,55.22670577777778,11938.01408,7.361482740939017,130,0.041
7,test_20231031_122922,10863862.png,317432,24,317408,0.9999243932558785,1,6,66058,1,66057,0.9999848617881256,55.749475555555556,12668.007861333333,7.10372036659619,130,0.041
8,test_20231031_122922,11382381.png,312486,24,312462,0.9999231965592058,1,5,46745,1,46744,0.9999786073376832,30.521228444444443,5261.919984,10.919361212177094,130,0.041
9,test_20231031_122922,11079715.png,443815,80152,363663,0.81940222840598,4,6,124136,11237,112899,0.9094783141071083,23.97975288888889,4111.613445333333,11.990680832975244,130,0.041
10,test_20231031_122922,11551286.png,271883,24,271859,0.9999117267353972,0,5,40092,1,40091,0.9999750573680535,24.866876444444443,3470.407338666667,12.72699907819776,130,0.041
1,test_20231031_122924,10404007.png,502730,24,502706,0.9999522606568138,1,6,61265,1,61264,0.9999836774667429,31.611185777777777,5234.651008,10.941926281199287,130,0.051000000000000004
2,test_20231031_122924,1254659.png,342646,36662,305984,0.8930032745165565,5,5,80080,5229,74851,0.9347027972027973,38.42077511111111,8194.678997333333,8.995484148487945,130,0.051000000000000004
3,test_20231031_122924,10188041.png,221231,1149,220082,0.9948063336512514,2,14,41731,169,41562,0.9959502528096619,21.095562666666666,3642.898698666667,12.51633266272102,130,0.051000000000000004
4,test_20231031_122924,10287332.png,216980,1972,215008,0.9909116047561988,2,5,22337,277,22060,0.9875990509020907,19.177041777777777,3386.439328,12.833370617466866,130,0.051000000000000004
5,test_20231031_122924,11610969.png,368720,24,368696,0.9999349099587763,1,5,84111,1,84110,0.9999881109486274,49.21503644444444,9843.652661333334,8.199240798850546,130,0.051000000000000004
6,test_20231031_122924,10350842.png,212614,24,212590,0.9998871193806617,1,6,42529,1,42528,0.9999764866326507,55.22670577777778,11938.01408,7.361482740939017,130,0.051000000000000004
7,test_20231031_122924,10863862.png,317432,24,317408,0.9999243932558785,1,5,66058,1,66057,0.9999848617881256,55.749475555555556,12668.007861333333,7.10372036659619,130,0.051000000000000004
8,test_20231031_122924,11382381.png,312486,24,312462,0.9999231965592058,1,6,46745,1,46744,0.9999786073376832,30.521228444444443,5261.919984,10.919361212177094,130,0.051000000000000004
9,test_20231031_122924,11079715.png,443815,72537,371278,0.8365602784944177,4,6,124136,10169,113967,0.9180817812721531,24.79848888888889,4367.944181333333,11.728032810553444,130,0.051000000000000004
10,test_20231031_122924,11551286.png,271883,24,271859,0.9999117267353972,0,5,40092,1,40091,0.9999750573680535,24.866876444444443,3470.407338666667,12.72699907819776,130,0.051000000000000004
1,test_20231031_122925,10404007.png,502730,24,502706,0.9999522606568138,1,6,61265,1,61264,0.9999836774667429,31.611185777777777,5234.651008,10.941926281199287,130,0.061000000000000006
2,test_20231031_122925,1254659.png,342646,35497,307149,0.8964032850230267,4,5,80080,5062,75018,0.9367882117882118,38.93506844444445,8374.494890666667,8.901217389275827,130,0.061000000000000006
3,test_20231031_122925,10188041.png,221231,987,220244,0.9955385999249653,2,6,41731,145,41586,0.9965253648366922,21.152672,3663.5551253333333,12.491776301360655,130,0.061000000000000006
4,test_20231031_122925,10287332.png,216980,1972,215008,0.9909116047561988,2,11,22337,277,22060,0.9875990509020907,19.177041777777777,3386.439328,12.833370617466866,130,0.061000000000000006
5,test_20231031_122925,11610969.png,368720,24,368696,0.9999349099587763,1,6,84111,1,84110,0.9999881109486274,49.21503644444444,9843.652661333334,8.199240798850546,130,0.061000000000000006
6,test_20231031_122925,10350842.png,212614,24,212590,0.9998871193806617,1,6,42529,1,42528,0.9999764866326507,55.22670577777778,11938.01408,7.361482740939017,130,0.061000000000000006
7,test_20231031_122925,10863862.png,317432,24,317408,0.9999243932558785,1,5,66058,1,66057,0.9999848617881256,55.749475555555556,12668.007861333333,7.10372036659619,130,0.061000000000000006
8,test_20231031_122925,11382381.png,312486,24,312462,0.9999231965592058,0,5,46745,1,46744,0.9999786073376832,30.521228444444443,5261.919984,10.919361212177094,130,0.061000000000000006
9,test_20231031_122925,11079715.png,443815,64077,379738,0.8556222750470354,4,6,124136,8983,115153,0.9276358187794033,27.804796444444445,5270.0705493333335,10.912639318069601,130,0.061000000000000006
10,test_20231031_122925,11551286.png,271883,24,271859,0.9999117267353972,1,6,40092,1,40091,0.9999750573680535,24.866876444444443,3470.407338666667,12.72699907819776,130,0.061000000000000006
1,test_20231031_122926,10404007.png,502730,24,502706,0.9999522606568138,1,6,61265,1,61264,0.9999836774667429,31.611185777777777,5234.651008,10.941926281199287,130,0.07100000000000001
2,test_20231031_122926,1254659.png,342646,29327,313319,0.9144102076195257,4,6,80080,4214,75866,0.9473776223776224,40.46582933333333,8899.556826666667,8.63711980349435,130,0.07100000000000001
3,test_20231031_122926,10188041.png,221231,787,220444,0.9964426323616491,2,6,41731,115,41616,0.99724425487048,21.230627555555557,3690.6434026666666,12.45978276044978,130,0.07100000000000001
4,test_20231031_122926,10287332.png,216980,24,216956,0.999889390727256,1,5,22337,1,22336,0.9999552312306935,86.39651022222222,25107.6716,4.132739212795741,130,0.07100000000000001
5,test_20231031_122926,11610969.png,368720,24,368696,0.9999349099587763,0,10,84111,1,84110,0.9999881109486274,49.21503644444444,9843.652661333334,8.199240798850546,130,0.07100000000000001
6,test_20231031_122926,10350842.png,212614,24,212590,0.9998871193806617,1,5,42529,1,42528,0.9999764866326507,55.22670577777778,11938.01408,7.361482740939017,130,0.07100000000000001
7,test_20231031_122926,10863862.png,317432,24,317408,0.9999243932558785,1,6,66058,1,66057,0.9999848617881256,55.749475555555556,12668.007861333333,7.10372036659619,130,0.07100000000000001
8,test_20231031_122926,11382381.png,312486,24,312462,0.9999231965592058,1,5,46745,1,46744,0.9999786073376832,30.521228444444443,5261.919984,10.919361212177094,130,0.07100000000000001
9,test_20231031_122926,11079715.png,443815,45052,398763,0.8984892353796063,4,6,124136,6388,117748,0.9485403106270542,29.15245511111111,5704.170261333334,10.568878807607803,130,0.07100000000000001
10,test_20231031_122926,11551286.png,271883,24,271859,0.9999117267353972,1,6,40092,1,40091,0.9999750573680535,24.866876444444443,3470.407338666667,12.72699907819776,130,0.07100000000000001
1,test_20231031_122927,10404007.png,502730,24,502706,0.9999522606568138,1,6,61265,1,61264,0.9999836774667429,31.611185777777777,5234.651008,10.941926281199287,130,0.081
2,test_20231031_122927,1254659.png,342646,26994,315652,0.9212189840243283,4,6,80080,3885,76195,0.951486013986014,41.08639111111111,9127.453424,8.52730735378865,130,0.081
3,test_20231031_122927,10188041.png,221231,24,221207,0.999891516107598,1,6,41731,1,41730,0.9999760369988737,32.19604977777778,6734.978176,9.847441680929638,130,0.081
4,test_20231031_122927,10287332.png,216980,24,216956,0.999889390727256,1,6,22337,1,22336,0.9999552312306935,86.39651022222222,25107.6716,4.132739212795741,130,0.081
5,test_20231031_122927,11610969.png,368720,24,368696,0.9999349099587763,0,5,84111,1,84110,0.9999881109486274,49.21503644444444,9843.652661333334,8.199240798850546,130,0.081
6,test_20231031_122927,10350842.png,212614,24,212590,0.9998871193806617,1,6,42529,1,42528,0.9999764866326507,55.22670577777778,11938.01408,7.361482740939017,130,0.081
7,test_20231031_122927,10863862.png,317432,24,317408,0.9999243932558785,1,5,66058,1,66057,0.9999848617881256,55.749475555555556,12668.007861333333,7.10372036659619,130,0.081
8,test_20231031_122927,11382381.png,312486,24,312462,0.9999231965592058,1,6,46745,1,46744,0.9999786073376832,30.521228444444443,5261.919984,10.919361212177094,130,0.081
9,test_20231031_122927,11079715.png,443815,40832,402983,0.9079977017450965,5,6,124136,5806,118330,0.9532287168911516,29.796981333333335,5920.100170666667,10.407513056315228,130,0.081
10,test_20231031_122927,11551286.png,271883,24,271859,0.9999117267353972,1,6,40092,1,40091,0.9999750573680535,24.866876444444443,3470.407338666667,12.72699907819776,130,0.081
1,test_20231031_122928,10404007.png,502730,24,502706,0.9999522606568138,1,6,61265,1,61264,0.9999836774667429,31.611185777777777,5234.651008,10.941926281199287,130,0.091
2,test_20231031_122928,1254659.png,342646,24442,318204,0.9286669040350682,5,7,80080,3523,76557,0.9560064935064935,42.32556088888889,9540.039210666666,8.335302011594997,130,0.091
3,test_20231031_122928,10188041.png,221231,24,221207,0.999891516107598,1,6,41731,1,41730,0.9999760369988737,32.19604977777778,6734.978176,9.847441680929638,130,0.091
4,test_20231031_122928,10287332.png,216980,24,216956,0.999889390727256,2,6,22337,1,22336,0.9999552312306935,86.39651022222222,25107.6716,4.132739212795741,130,0.091
5,test_20231031_122928,11610969.png,368720,24,368696,0.9999349099587763,1,6,84111,1,84110,0.9999881109486274,49.21503644444444,9843.652661333334,8.199240798850546,130,0.091
6,test_20231031_122928,10350842.png,212614,24,212590,0.9998871193806617,1,6,42529,1,42528,0.9999764866326507,55.22670577777778,11938.01408,7.361482740939017,130,0.091
7,test_20231031_122928,10863862.png,317432,24,317408,0.9999243932558785,1,9,66058,1,66057,0.9999848617881256,55.749475555555556,12668.007861333333,7.10372036659619,130,0.091
8,test_20231031_122928,11382381.png,312486,24,312462,0.9999231965592058,1,8,46745,1,46744,0.9999786073376832,30.521228444444443,5261.919984,10.919361212177094,130,0.091
9,test_20231031_122928,11079715.png,443815,32442,411373,0.9269019749219832,5,6,124136,4620,119516,0.9627827543984018,34.62063111111111,7638.856453333334,9.300520118705977,130,0.091
10,test_20231031_122928,11551286.png,271883,24,271859,0.9999117267353972,1,5,40092,1,40091,0.9999750573680535,24.866876444444443,3470.407338666667,12.72699907819776,130,0.091
1,test_20231031_122929,10404007.png,502730,5642,497088,0.9887772760726433,3,6,61265,824,60441,0.9865502325960989,28.373376,4170.304,11.92912646251397,140,0.001
2,test_20231031_122929,1254659.png,342646,28092,314554,0.9180145106027795,3,6,80080,4020,76060,0.9498001998001998,41.274213333333336,10624.02136,7.867914256774763,140,0.001
3,test_20231031_122929,10188041.png,221231,5712,215519,0.9741808336083099,3,6,41731,813,40918,0.9805180800843498,13.05619911111111,1653.1740266666666,15.947617874883115,140,0.001
4,test_20231031_122929,10287332.png,216980,6527,210453,0.969918886533321,3,6,22337,888,21449,0.9602453328557998,13.158252444444445,1901.648112,15.339502042892512,140,0.001
5,test_20231031_122929,11610969.png,368720,6757,361963,0.9816744413104795,2,6,84111,998,83113,0.9881347267301542,40.764990222222224,7618.395909333333,9.312168227384356,140,0.001
6,test_20231031_122929,10350842.png,212614,24,212590,0.9998871193806617,1,5,42529,1,42528,0.9999764866326507,55.22670577777778,11938.01408,7.361482740939017,140,0.001
7,test_20231031_122929,10863862.png,317432,3462,313970,0.9890937271604627,2,6,66058,508,65550,0.992309788367798,44.97022577777778,9093.73648,8.543379958833672,140,0.001
8,test_20231031_122929,11382381.png,312486,327,312159,0.9989535531191798,1,5,46745,44,46701,0.9990587228580596,23.441726222222222,2963.055792,13.413405318888326,140,0.001
9,test_20231031_122929,11079715.png,443815,82767,361048,0.8135101337268907,4,7,124136,11708,112428,0.9056840884191532,20.16080711111111,2995.252288,13.366469522822351,140,0.001
10,test_20231031_122929,11551286.png,271883,24,271859,0.9999117267353972,1,5,40092,1,40091,0.9999750573680535,24.866876444444443,3470.407338666667,12.72699907819776,140,0.001
1,test_20231031_122930,10404007.png,502730,24,502706,0.9999522606568138,1,6,61265,1,61264,0.9999836774667429,31.611185777777777,5234.651008,10.941926281199287,140,0.011
2,test_20231031_122930,1254659.png,342646,21719,320927,0.936613881381951,3,6,80080,3147,76933,0.9607017982017982,44.470448,11332.928314666668,7.587382191790022,140,0.011
3,test_20231031_122930,10188041.png,221231,2797,218434,0.9873571063729767,2,8,41731,409,41322,0.9901991325393592,16.250300444444445,2344.3567786666667,14.4305665488056,140,0.011
4,test_20231031_122930,10287332.png,216980,3179,213801,0.9853488800811134,2,6,22337,438,21899,0.9803912790437391,18.86872711111111,3297.7965066666666,12.948565072423616,140,0.011
5,test_20231031_122930,11610969.png,368720,24,368696,0.9999349099587763,0,8,84111,1,84110,0.9999881109486274,49.21503644444444,9843.652661333334,8.199240798850546,140,0.011
6,test_20231031_122930,10350842.png,212614,24,212590,0.9998871193806617,1,6,42529,1,42528,0.9999764866326507,55.22670577777778,11938.01408,7.361482740939017,140,0.011
7,test_20231031_122930,10863862.png,317432,2647,314785,0.9916612061795912,2,5,66058,388,65670,0.9941263737927276,51.300581333333334,11015.571642666666,7.710733214951503,140,0.011
8,test_20231031_122930,11382381.png,312486,84,312402,0.9997311879572205,2,6,46745,10,46735,0.9997860733768318,24.43767111111111,3217.2312533333334,13.055980819252213,140,0.011
9,test_20231031_122930,11079715.png,443815,78172,365643,0.8238635467480819,6,6,124136,11070,113066,0.9108236128117548,21.72542577777778,3392.125376,12.826084650725358,140,0.011
10,test_20231031_122930,11551286.png,271883,24,271859,0.9999117267353972,1,5,40092,1,40091,0.9999750573680535,24.866876444444443,3470.407338666667,12.72699907819776,140,0.011
1,test_20231031_122931,10404007.png,502730,24,502706,0.9999522606568138,1,6,61265,1,61264,0.9999836774667429,31.611185777777777,5234.651008,10.941926281199287,140,0.020999999999999998
2,test_20231031_122931,1254659.png,342646,18744,323902,0.9452963116452548,3,6,80080,2707,77373,0.9661963036963037,45.33798044444445,11576.493728,7.495033200570845,140,0.020999999999999998
3,test_20231031_122931,10188041.png,221231,1442,219789,0.9934819261315097,2,6,41731,209,41522,0.9949917327646114,19.06071111111111,2992.5621226666667,13.37037186166639,140,0.020999999999999998
4,test_20231031_122931,10287332.png,216980,24,216956,0.999889390727256,1,5,22337,1,22336,0.9999552312306935,86.39651022222222,25107.6716,4.132739212795741,140,0.020999999999999998
5,test_20231031_122931,11610969.png,368720,24,368696,0.9999349099587763,1,6,84111,1,84110,0.9999881109486274,49.21503644444444,9843.652661333334,8.199240798850546,140,0.020999999999999998
6,test_20231031_122931,10350842.png,212614,24,212590,0.9998871193806617,1,6,42529,1,42528,0.9999764866326507,55.22670577777778,11938.01408,7.361482740939017,140,0.020999999999999998
7,test_20231031_122931,10863862.png,317432,24,317408,0.9999243932558785,1,6,66058,1,66057,0.9999848617881256,55.749475555555556,12668.007861333333,7.10372036659619,140,0.020999999999999998
8,test_20231031_122931,11382381.png,312486,24,312462,0.9999231965592058,1,5,46745,1,46744,0.9999786073376832,30.521228444444443,5261.919984,10.919361212177094,140,0.020999999999999998
9,test_20231031_122931,11079715.png,443815,66014,377801,0.8512578439214538,4,6,124136,9357,114779,0.9246229941354643,23.975121777777776,4046.3806186666666,12.060136290441024,140,0.020999999999999998
10,test_20231031_122931,11551286.png,271883,24,271859,0.9999117267353972,7,6,40092,1,40091,0.9999750573680535,24.866876444444443,3470.407338666667,12.72699907819776,140,0.020999999999999998
1,test_20231031_122932,10404007.png,502730,24,502706,0.9999522606568138,0,5,61265,1,61264,0.9999836774667429,31.611185777777777,5234.651008,10.941926281199287,140,0.031
2,test_20231031_122932,1254659.png,342646,18102,324544,0.9471699655037561,3,6,80080,2614,77466,0.9673576423576423,46.663619555555556,11878.372885333334,7.383234063605846,140,0.031
3,test_20231031_122932,10188041.png,221231,897,220334,0.995945414521473,2,5,41731,131,41600,0.9968608468524598,19.688272,3117.700944,13.192459063972155,140,0.031
4,test_20231031_122932,10287332.png,216980,24,216956,0.999889390727256,1,6,22337,1,22336,0.9999552312306935,86.39651022222222,25107.6716,4.132739212795741,140,0.031
5,test_20231031_122932,11610969.png,368720,24,368696,0.9999349099587763,1,6,84111,1,84110,0.9999881109486274,49.21503644444444,9843.652661333334,8.199240798850546,140,0.031
6,test_20231031_122932,10350842.png,212614,24,212590,0.9998871193806617,1,5,42529,1,42528,0.9999764866326507,55.22670577777778,11938.01408,7.361482740939017,140,0.031
7,test_20231031_122932,10863862.png,317432,24,317408,0.9999243932558785,1,6,66058,1,66057,0.9999848617881256,55.749475555555556,12668.007861333333,7.10372036659619,140,0.031
8,test_20231031_122932,11382381.png,312486,24,312462,0.9999231965592058,2,6,46745,1,46744,0.9999786073376832,30.521228444444443,5261.919984,10.919361212177094,140,0.031
9,test_20231031_122932,11079715.png,443815,59977,383838,0.8648603584827012,5,7,124136,8484,115652,0.9316556035316105,26.402060444444444,4850.724528,11.272737490673489,140,0.031
10,test_20231031_122932,11551286.png,271883,24,271859,0.9999117267353972,1,6,40092,1,40091,0.9999750573680535,24.866876444444443,3470.407338666667,12.72699907819776,140,0.031
1,test_20231031_122933,10404007.png,502730,24,502706,0.9999522606568138,1,7,61265,1,61264,0.9999836774667429,31.611185777777777,5234.651008,10.941926281199287,140,0.041
2,test_20231031_122933,1254659.png,342646,16102,326544,0.9530068934118595,3,6,80080,2321,77759,0.9710164835164835,52.287959111111114,13718.114693333333,6.757859313151499,140,0.041
3,test_20231031_122933,10188041.png,221231,667,220564,0.9969850518236595,2,6,41731,97,41634,0.9976755888907527,21.147381333333332,3662.316032,12.493245427395783,140,0.041
4,test_20231031_122933,10287332.png,216980,24,216956,0.999889390727256,1,5,22337,1,22336,0.9999552312306935,86.39651022222222,25107.6716,4.132739212795741,140,0.041
5,test_20231031_122933,11610969.png,368720,24,368696,0.9999349099587763,1,6,84111,1,84110,0.9999881109486274,49.21503644444444,9843.652661333334,8.199240798850546,140,0.041
6,test_20231031_122933,10350842.png,212614,24,212590,0.9998871193806617,1,6,42529,1,42528,0.9999764866326507,55.22670577777778,11938.01408,7.361482740939017,140,0.041
7,test_20231031_122933,10863862.png,317432,24,317408,0.9999243932558785,1,5,66058,1,66057,0.9999848617881256,55.749475555555556,12668.007861333333,7.10372036659619,140,0.041
8,test_20231031_122933,11382381.png,312486,24,312462,0.9999231965592058,1,6,46745,1,46744,0.9999786073376832,30.521228444444443,5261.919984,10.919361212177094,140,0.041
9,test_20231031_122933,11079715.png,443815,50107,393708,0.887099354460755,5,6,124136,7095,117041,0.9428449442546885,29.113610666666666,5673.160768,10.592552699409739,140,0.041
10,test_20231031_122933,11551286.png,271883,24,271859,0.9999117267353972,1,6,40092,1,40091,0.9999750573680535,24.866876444444443,3470.407338666667,12.72699907819776,140,0.041
1,test_20231031_122934,10404007.png,502730,24,502706,0.9999522606568138,1,6,61265,1,61264,0.9999836774667429,31.611185777777777,5234.651008,10.941926281199287,140,0.051000000000000004
2,test_20231031_122934,1254659.png,342646,14757,327889,0.956932227430059,3,6,80080,2123,77957,0.973489010989011,52.82443022222222,13898.525397333333,6.701116358492878,140,0.051000000000000004
3,test_20231031_122934,10188041.png,221231,667,220564,0.9969850518236595,2,6,41731,97,41634,0.9976755888907527,21.147381333333332,3662.316032,12.493245427395783,140,0.051000000000000004
4,test_20231031_122934,10287332.png,216980,24,216956,0.999889390727256,1,6,22337,1,22336,0.9999552312306935,86.39651022222222,25107.6716,4.132739212795741,140,0.051000000000000004
5,test_20231031_122934,11610969.png,368720,24,368696,0.9999349099587763,1,7,84111,1,84110,0.9999881109486274,49.21503644444444,9843.652661333334,8.199240798850546,140,0.051000000000000004
6,test_20231031_122934,10350842.png,212614,24,212590,0.9998871193806617,1,6,42529,1,42528,0.9999764866326507,55.22670577777778,11938.01408,7.361482740939017,140,0.051000000000000004
7,test_20231031_122934,10863862.png,317432,24,317408,0.9999243932558785,1,7,66058,1,66057,0.9999848617881256,55.749475555555556,12668.007861333333,7.10372036659619,140,0.051000000000000004
8,test_20231031_122934,11382381.png,312486,24,312462,0.9999231965592058,1,6,46745,1,46744,0.9999786073376832,30.521228444444443,5261.919984,10.919361212177094,140,0.051000000000000004
9,test_20231031_122934,11079715.png,443815,40482,403333,0.9087863186237509,5,7,124136,5740,118396,0.9537603918283173,31.26277511111111,6372.052389333333,10.088010230695062,140,0.051000000000000004
10,test_20231031_122934,11551286.png,271883,24,271859,0.9999117267353972,1,6,40092,1,40091,0.9999750573680535,24.866876444444443,3470.407338666667,12.72699907819776,140,0.051000000000000004
1,test_20231031_122935,10404007.png,502730,24,502706,0.9999522606568138,0,5,61265,1,61264,0.9999836774667429,31.611185777777777,5234.651008,10.941926281199287,140,0.061000000000000006
2,test_20231031_122935,1254659.png,342646,14614,328032,0.9573495677754884,3,6,80080,2103,77977,0.9737387612387612,52.87696,13917.944757333333,6.695052524934315,140,0.061000000000000006
3,test_20231031_122935,10188041.png,221231,487,220744,0.9977986810166749,3,5,41731,70,41661,0.9983225899211617,21.260768,3701.462261333333,12.447070350243996,140,0.061000000000000006
4,test_20231031_122935,10287332.png,216980,24,216956,0.999889390727256,1,5,22337,1,22336,0.9999552312306935,86.39651022222222,25107.6716,4.132739212795741,140,0.061000000000000006
5,test_20231031_122935,11610969.png,368720,24,368696,0.9999349099587763,1,10,84111,1,84110,0.9999881109486274,49.21503644444444,9843.652661333334,8.199240798850546,140,0.061000000000000006
6,test_20231031_122935,10350842.png,212614,24,212590,0.9998871193806617,1,5,42529,1,42528,0.9999764866326507,55.22670577777778,11938.01408,7.361482740939017,140,0.061000000000000006
7,test_20231031_122935,10863862.png,317432,24,317408,0.9999243932558785,1,6,66058,1,66057,0.9999848617881256,55.749475555555556,12668.007861333333,7.10372036659619,140,0.061000000000000006
8,test_20231031_122935,11382381.png,312486,24,312462,0.9999231965592058,1,6,46745,1,46744,0.9999786073376832,30.521228444444443,5261.919984,10.919361212177094,140,0.061000000000000006
9,test_20231031_122935,11079715.png,443815,37064,406751,0.9164877257415815,4,7,124136,5269,118867,0.9575546175162725,32.125966222222225,6671.224832,9.888747834814698,140,0.061000000000000006
10,test_20231031_122935,11551286.png,271883,24,271859,0.9999117267353972,1,7,40092,1,40091,0.9999750573680535,24.866876444444443,3470.407338666667,12.72699907819776,140,0.061000000000000006
1,test_20231031_122936,10404007.png,502730,24,502706,0.9999522606568138,1,7,61265,1,61264,0.9999836774667429,31.611185777777777,5234.651008,10.941926281199287,140,0.07100000000000001
2,test_20231031_122936,1254659.png,342646,12504,330142,0.9635075267185375,4,7,80080,1799,78281,0.9775349650349651,53.14727288888889,14016.090192,6.664534773976517,140,0.07100000000000001
3,test_20231031_122936,10188041.png,221231,24,221207,0.999891516107598,1,6,41731,1,41730,0.9999760369988737,32.19604977777778,6734.978176,9.847441680929638,140,0.07100000000000001
4,test_20231031_122936,10287332.png,216980,24,216956,0.999889390727256,1,6,22337,1,22336,0.9999552312306935,86.39651022222222,25107.6716,4.132739212795741,140,0.07100000000000001
5,test_20231031_122936,11610969.png,368720,24,368696,0.9999349099587763,2,5,84111,1,84110,0.9999881109486274,49.21503644444444,9843.652661333334,8.199240798850546,140,0.07100000000000001
6,test_20231031_122936,10350842.png,212614,24,212590,0.9998871193806617,1,6,42529,1,42528,0.9999764866326507,55.22670577777778,11938.01408,7.361482740939017,140,0.07100000000000001
7,test_20231031_122936,10863862.png,317432,24,317408,0.9999243932558785,1,6,66058,1,66057,0.9999848617881256,55.749475555555556,12668.007861333333,7.10372036659619,140,0.07100000000000001
8,test_20231031_122936,11382381.png,312486,24,312462,0.9999231965592058,1,5,46745,1,46744,0.9999786073376832,30.521228444444443,5261.919984,10.919361212177094,140,0.07100000000000001
9,test_20231031_122936,11079715.png,443815,22704,421111,0.9488435496772304,4,6,124136,3280,120856,0.9735773667590385,34.08474488888889,7307.229722666667,9.493276000782897,140,0.07100000000000001
10,test_20231031_122936,11551286.png,271883,24,271859,0.9999117267353972,1,6,40092,1,40091,0.9999750573680535,24.866876444444443,3470.407338666667,12.72699907819776,140,0.07100000000000001
1,test_20231031_122937,10404007.png,502730,24,502706,0.9999522606568138,1,6,61265,1,61264,0.9999836774667429,31.611185777777777,5234.651008,10.941926281199287,140,0.081
2,test_20231031_122937,1254659.png,342646,11037,331609,0.9677889133391313,3,6,80080,1591,78489,0.9801323676323677,53.51708977777778,14160.085210666666,6.620144940670566,140,0.081
3,test_20231031_122937,10188041.png,221231,24,221207,0.999891516107598,1,6,41731,1,41730,0.9999760369988737,32.19604977777778,6734.978176,9.847441680929638,140,0.081
4,test_20231031_122937,10287332.png,216980,24,216956,0.999889390727256,1,5,22337,1,22336,0.9999552312306935,86.39651022222222,25107.6716,4.132739212795741,140,0.081
5,test_20231031_122937,11610969.png,368720,24,368696,0.9999349099587763,0,5,84111,1,84110,0.9999881109486274,49.21503644444444,9843.652661333334,8.199240798850546,140,0.081
6,test_20231031_122937,10350842.png,212614,24,212590,0.9998871193806617,2,6,42529,1,42528,0.9999764866326507,55.22670577777778,11938.01408,7.361482740939017,140,0.081
7,test_20231031_122937,10863862.png,317432,24,317408,0.9999243932558785,1,6,66058,1,66057,0.9999848617881256,55.749475555555556,12668.007861333333,7.10372036659619,140,0.081
8,test_20231031_122937,11382381.png,312486,24,312462,0.9999231965592058,0,5,46745,1,46744,0.9999786073376832,30.521228444444443,5261.919984,10.919361212177094,140,0.081
9,test_20231031_122937,11079715.png,443815,15097,428718,0.9659835742370132,4,5,124136,2194,121942,0.982325836179674,38.81098488888889,8998.319717333334,8.589189409418015,140,0.081
10,test_20231031_122937,11551286.png,271883,24,271859,0.9999117267353972,1,6,40092,1,40091,0.9999750573680535,24.866876444444443,3470.407338666667,12.72699907819776,140,0.081
1,test_20231031_122938,10404007.png,502730,24,502706,0.9999522606568138,1,5,61265,1,61264,0.9999836774667429,31.611185777777777,5234.651008,10.941926281199287,140,0.091
2,test_20231031_122938,1254659.png,342646,10072,332574,0.9706052310547912,3,5,80080,1453,78627,0.9818556443556443,53.86840711111111,14302.619397333334,6.576647789530794,140,0.091
3,test_20231031_122938,10188041.png,221231,24,221207,0.999891516107598,1,5,41731,1,41730,0.9999760369988737,32.19604977777778,6734.978176,9.847441680929638,140,0.091
4,test_20231031_122938,10287332.png,216980,24,216956,0.999889390727256,1,5,22337,1,22336,0.9999552312306935,86.39651022222222,25107.6716,4.132739212795741,140,0.091
5,test_20231031_122938,11610969.png,368720,24,368696,0.9999349099587763,1,5,84111,1,84110,0.9999881109486274,49.21503644444444,9843.652661333334,8.199240798850546,140,0.091
6,test_20231031_122938,10350842.png,212614,24,212590,0.9998871193806617,1,5,42529,1,42528,0.9999764866326507,55.22670577777778,11938.01408,7.361482740939017,140,0.091
7,test_20231031_122938,10863862.png,317432,24,317408,0.9999243932558785,1,6,66058,1,66057,0.9999848617881256,55.749475555555556,12668.007861333333,7.10372036659619,140,0.091
8,test_20231031_122938,11382381.png,312486,24,312462,0.9999231965592058,1,6,46745,1,46744,0.9999786073376832,30.521228444444443,5261.919984,10.919361212177094,140,0.091
9,test_20231031_122938,11079715.png,443815,12927,430888,0.9708729988846704,8,9,124136,1881,122255,0.9848472642907778,41.37680711111111,9812.315082666666,8.213088755053473,140,0.091
10,test_20231031_122938,11551286.png,271883,24,271859,0.9999117267353972,2,14,40092,1,40091,0.9999750573680535,24.866876444444443,3470.407338666667,12.72699907819776,140,0.091
1,test_20231031_122939,10404007.png,502730,1179,501551,0.9976548047659778,3,8,61265,169,61096,0.9972414918795397,29.43210488888889,4503.833029333333,11.594980793317522,150,0.001
2,test_20231031_122939,1254659.png,342646,17619,325027,0.9485795835935631,3,6,80080,2553,77527,0.9681193806193806,43.94781688888889,11457.804218666666,7.539789637501934,150,0.001
3,test_20231031_122939,10188041.png,221231,4042,217189,0.9817295044546198,3,6,41731,577,41154,0.9861733483501474,14.516158222222222,2023.1226826666666,15.07058141572312,150,0.001
4,test_20231031_122939,10287332.png,216980,3972,213008,0.9816941653608627,2,5,22337,546,21791,0.9755562519586336,18.896412444444444,3584.407616,12.586629694443516,150,0.001
5,test_20231031_122939,11610969.png,368720,24,368696,0.9999349099587763,1,5,84111,1,84110,0.9999881109486274,49.21503644444444,9843.652661333334,8.199240798850546,150,0.001
6,test_20231031_122939,10350842.png,212614,24,212590,0.9998871193806617,1,5,42529,1,42528,0.9999764866326507,55.22670577777778,11938.01408,7.361482740939017,150,0.001
7,test_20231031_122939,10863862.png,317432,2154,315278,0.9932142947150886,2,5,66058,317,65741,0.9952011868358109,46.502296888888885,9541.028853333333,8.334851516530327,150,0.001
8,test_20231031_122939,11382381.png,312486,104,312382,0.999667185089892,2,5,46745,13,46732,0.9997218953898813,25.365278222222223,3676.478896,12.476482835227657,150,0.001
9,test_20231031_122939,11079715.png,443815,62869,380946,0.8583441298739339,4,6,124136,8978,115158,0.927676097183734,22.383219555555556,3679.5221493333333,12.472889393092563,150,0.001
10,test_20231031_122939,11551286.png,271883,24,271859,0.9999117267353972,1,5,40092,1,40091,0.9999750573680535,24.866876444444443,3470.407338666667,12.72699907819776,150,0.001
1,test_20231031_122940,10404007.png,502730,24,502706,0.9999522606568138,1,6,61265,1,61264,0.9999836774667429,31.611185777777777,5234.651008,10.941926281199287,150,0.011
2,test_20231031_122940,1254659.png,342646,13357,329289,0.9610180769657314,2,5,80080,1951,78129,0.9756368631368632,46.59738133333333,12056.824272,7.318474297444587,150,0.011
3,test_20231031_122940,10188041.png,221231,2154,219077,0.9902635706569152,2,5,41731,314,41417,0.9924756176463541,16.634451555555554,2451.210384,14.23699773120872,150,0.011
4,test_20231031_122940,10287332.png,216980,24,216956,0.999889390727256,1,6,22337,1,22336,0.9999552312306935,86.39651022222222,25107.6716,4.132739212795741,150,0.011
5,test_20231031_122940,11610969.png,368720,24,368696,0.9999349099587763,0,5,84111,1,84110,0.9999881109486274,49.21503644444444,9843.652661333334,8.199240798850546,150,0.011
6,test_20231031_122940,10350842.png,212614,24,212590,0.9998871193806617,1,5,42529,1,42528,0.9999764866326507,55.22670577777778,11938.01408,7.361482740939017,150,0.011
7,test_20231031_122940,10863862.png,317432,24,317408,0.9999243932558785,1,6,66058,1,66057,0.9999848617881256,55.749475555555556,12668.007861333333,7.10372036659619,150,0.011
8,test_20231031_122940,11382381.png,312486,64,312422,0.9997951908245489,2,6,46745,7,46738,0.9998502513637822,25.939884444444445,3840.3579466666665,12.287086555063059,150,0.011
9,test_20231031_122940,11079715.png,443815,55967,387848,0.8738956547209986,5,6,124136,8010,116126,0.9354739962621641,24.704789333333334,4316.4852906666665,11.779500955681875,150,0.011
10,test_20231031_122940,11551286.png,271883,24,271859,0.9999117267353972,1,16,40092,1,40091,0.9999750573680535,24.866876444444443,3470.407338666667,12.72699907819776,150,0.011
1,test_20231031_122941,10404007.png,502730,24,502706,0.9999522606568138,1,6,61265,1,61264,0.9999836774667429,31.611185777777777,5234.651008,10.941926281199287,150,0.020999999999999998
2,test_20231031_122941,1254659.png,342646,11349,331297,0.9668783525854672,2,5,80080,1653,78427,0.9793581418581419,48.48311288888889,12529.701072,7.15139650953529,150,0.020999999999999998
3,test_20231031_122941,10188041.png,221231,757,220474,0.9965782372271517,2,6,41731,109,41622,0.9973880328772375,20.153159111111112,3336.813664,12.897484056233832,150,0.020999999999999998
4,test_20231031_122941,10287332.png,216980,24,216956,0.999889390727256,1,14,22337,1,22336,0.9999552312306935,86.39651022222222,25107.6716,4.132739212795741,150,0.020999999999999998
5,test_20231031_122941,11610969.png,368720,24,368696,0.9999349099587763,1,6,84111,1,84110,0.9999881109486274,49.21503644444444,9843.652661333334,8.199240798850546,150,0.020999999999999998
6,test_20231031_122941,10350842.png,212614,24,212590,0.9998871193806617,1,6,42529,1,42528,0.9999764866326507,55.22670577777778,11938.01408,7.361482740939017,150,0.020999999999999998
7,test_20231031_122941,10863862.png,317432,24,317408,0.9999243932558785,0,5,66058,1,66057,0.9999848617881256,55.749475555555556,12668.007861333333,7.10372036659619,150,0.020999999999999998
8,test_20231031_122941,11382381.png,312486,24,312462,0.9999231965592058,1,6,46745,1,46744,0.9999786073376832,30.521228444444443,5261.919984,10.919361212177094,150,0.020999999999999998
9,test_20231031_122941,11079715.png,443815,44379,399436,0.9000056329777046,4,11,124136,6345,117791,0.9488867049042985,28.361075555555555,5466.449434666667,10.753750256862315,150,0.020999999999999998
10,test_20231031_122941,11551286.png,271883,24,271859,0.9999117267353972,1,6,40092,1,40091,0.9999750573680535,24.866876444444443,3470.407338666667,12.72699907819776,150,0.020999999999999998
1,test_20231031_122942,10404007.png,502730,24,502706,0.9999522606568138,0,5,61265,1,61264,0.9999836774667429,31.611185777777777,5234.651008,10.941926281199287,150,0.031
2,test_20231031_122942,1254659.png,342646,10587,332059,0.9691022221184546,3,6,80080,1539,78541,0.9807817182817182,49.50904711111111,12805.633754666667,7.056792841670353,150,0.031
3,test_20231031_122942,10188041.png,221231,547,220684,0.9975274712856698,2,6,41731,79,41652,0.9981069229110254,21.62936,3887.1075786666665,12.234538006393246,150,0.031
4,test_20231031_122942,10287332.png,216980,24,216956,0.999889390727256,1,16,22337,1,22336,0.9999552312306935,86.39651022222222,25107.6716,4.132739212795741,150,0.031
5,test_20231031_122942,11610969.png,368720,24,368696,0.9999349099587763,0,6,84111,1,84110,0.9999881109486274,49.21503644444444,9843.652661333334,8.199240798850546,150,0.031
6,test_20231031_122942,10350842.png,212614,24,212590,0.9998871193806617,1,6,42529,1,42528,0.9999764866326507,55.22670577777778,11938.01408,7.361482740939017,150,0.031
7,test_20231031_122942,10863862.png,317432,24,317408,0.9999243932558785,1,5,66058,1,66057,0.9999848617881256,55.749475555555556,12668.007861333333,7.10372036659619,150,0.031
8,test_20231031_122942,11382381.png,312486,24,312462,0.9999231965592058,1,6,46745,1,46744,0.9999786073376832,30.521228444444443,5261.919984,10.919361212177094,150,0.031
9,test_20231031_122942,11079715.png,443815,39334,404481,0.9113729819857372,4,6,124136,5621,118515,0.9547190178513888,29.957619555555556,5998.066149333334,10.350691098258569,150,0.031
10,test_20231031_122942,11551286.png,271883,24,271859,0.9999117267353972,1,5,40092,1,40091,0.9999750573680535,24.866876444444443,3470.407338666667,12.72699907819776,150,0.031
1,test_20231031_122943,10404007.png,502730,24,502706,0.9999522606568138,1,6,61265,1,61264,0.9999836774667429,31.611185777777777,5234.651008,10.941926281199287,150,0.041
2,test_20231031_122943,1254659.png,342646,9612,333034,0.9719477244736551,3,6,80080,1397,78683,0.982554945054945,53.56242133333333,14201.452992,6.607475802788205,150,0.041
3,test_20231031_122943,10188041.png,221231,507,220724,0.9977082777730065,2,5,41731,73,41658,0.9982507009177829,21.63336,3888.665765333333,12.232797441563923,150,0.041
4,test_20231031_122943,10287332.png,216980,24,216956,0.999889390727256,0,5,22337,1,22336,0.9999552312306935,86.39651022222222,25107.6716,4.132739212795741,150,0.041
5,test_20231031_122943,11610969.png,368720,24,368696,0.9999349099587763,1,6,84111,1,84110,0.9999881109486274,49.21503644444444,9843.652661333334,8.199240798850546,150,0.041
6,test_20231031_122943,10350842.png,212614,24,212590,0.9998871193806617,1,5,42529,1,42528,0.9999764866326507,55.22670577777778,11938.01408,7.361482740939017,150,0.041
7,test_20231031_122943,10863862.png,317432,24,317408,0.9999243932558785,1,6,66058,1,66057,0.9999848617881256,55.749475555555556,12668.007861333333,7.10372036659619,150,0.041
8,test_20231031_122943,11382381.png,312486,24,312462,0.9999231965592058,1,5,46745,1,46744,0.9999786073376832,30.521228444444443,5261.919984,10.919361212177094,150,0.041
9,test_20231031_122943,11079715.png,443815,28984,414831,0.9346935096830886,4,6,124136,4151,119985,0.9665608687246247,33.93357511111111,7274.642805333333,9.512686871248965,150,0.041
10,test_20231031_122943,11551286.png,271883,24,271859,0.9999117267353972,0,5,40092,1,40091,0.9999750573680535,24.866876444444443,3470.407338666667,12.72699907819776,150,0.041
1,test_20231031_122944,10404007.png,502730,24,502706,0.9999522606568138,1,6,61265,1,61264,0.9999836774667429,31.611185777777777,5234.651008,10.941926281199287,150,0.051000000000000004
2,test_20231031_122944,1254659.png,342646,8464,334182,0.9752981210929064,3,6,80080,1229,78851,0.9846528471528472,54.00077155555555,14350.3288,6.562185089693458,150,0.051000000000000004
3,test_20231031_122944,10188041.png,221231,447,220784,0.9979794875040117,2,6,41731,64,41667,0.9984663679279193,21.645164444444443,3893.0230346666667,12.22793387460812,150,0.051000000000000004
4,test_20231031_122944,10287332.png,216980,24,216956,0.999889390727256,1,6,22337,1,22336,0.9999552312306935,86.39651022222222,25107.6716,4.132739212795741,150,0.051000000000000004
5,test_20231031_122944,11610969.png,368720,24,368696,0.9999349099587763,0,5,84111,1,84110,0.9999881109486274,49.21503644444444,9843.652661333334,8.199240798850546,150,0.051000000000000004
6,test_20231031_122944,10350842.png,212614,24,212590,0.9998871193806617,1,6,42529,1,42528,0.9999764866326507,55.22670577777778,11938.01408,7.361482740939017,150,0.051000000000000004
7,test_20231031_122944,10863862.png,317432,24,317408,0.9999243932558785,1,5,66058,1,66057,0.9999848617881256,55.749475555555556,12668.007861333333,7.10372036659619,150,0.051000000000000004
8,test_20231031_122944,11382381.png,312486,24,312462,0.9999231965592058,1,7,46745,1,46744,0.9999786073376832,30.521228444444443,5261.919984,10.919361212177094,150,0.051000000000000004
9,test_20231031_122944,11079715.png,443815,20342,423473,0.9541655870126066,3,5,124136,2947,121189,0.9762599084874654,36.407045333333336,8103.832197333333,9.043899211769254,150,0.051000000000000004
10,test_20231031_122944,11551286.png,271883,24,271859,0.9999117267353972,0,5,40092,1,40091,0.9999750573680535,24.866876444444443,3470.407338666667,12.72699907819776,150,0.051000000000000004
1,test_20231031_122945,10404007.png,502730,24,502706,0.9999522606568138,1,5,61265,1,61264,0.9999836774667429,31.611185777777777,5234.651008,10.941926281199287,150,0.061000000000000006
2,test_20231031_122945,1254659.png,342646,8444,334202,0.9753564903719875,2,6,80080,1226,78854,0.9846903096903097,54.01020444444445,14352.643146666667,6.561484738530806,150,0.061000000000000006
3,test_20231031_122945,10188041.png,221231,24,221207,0.999891516107598,0,5,41731,1,41730,0.9999760369988737,32.19604977777778,6734.978176,9.847441680929638,150,0.061000000000000006
4,test_20231031_122945,10287332.png,216980,24,216956,0.999889390727256,1,5,22337,1,22336,0.9999552312306935,86.39651022222222,25107.6716,4.132739212795741,150,0.061000000000000006
5,test_20231031_122945,11610969.png,368720,24,368696,0.9999349099587763,1,5,84111,1,84110,0.9999881109486274,49.21503644444444,9843.652661333334,8.199240798850546,150,0.061000000000000006
6,test_20231031_122945,10350842.png,212614,24,212590,0.9998871193806617,1,6,42529,1,42528,0.9999764866326507,55.22670577777778,11938.01408,7.361482740939017,150,0.061000000000000006
7,test_20231031_122945,10863862.png,317432,24,317408,0.9999243932558785,1,5,66058,1,66057,0.9999848617881256,55.749475555555556,12668.007861333333,7.10372036659619,150,0.061000000000000006
8,test_20231031_122945,11382381.png,312486,24,312462,0.9999231965592058,1,6,46745,1,46744,0.9999786073376832,30.521228444444443,5261.919984,10.919361212177094,150,0.061000000000000006
9,test_20231031_122945,11079715.png,443815,13852,429963,0.968788797133941,3,6,124136,2004,122132,0.9838564155442417,40.822448,9684.505466666667,8.270029122279919,150,0.061000000000000006
10,test_20231031_122945,11551286.png,271883,24,271859,0.9999117267353972,0,5,40092,1,40091,0.9999750573680535,24.866876444444443,3470.407338666667,12.72699907819776,150,0.061000000000000006
1,test_20231031_122946,10404007.png,502730,24,502706,0.9999522606568138,1,6,61265,1,61264,0.9999836774667429,31.611185777777777,5234.651008,10.941926281199287,150,0.07100000000000001
2,test_20231031_122946,1254659.png,342646,6677,335969,0.9805134161787967,2,5,80080,968,79112,0.987912087912088,54.36990577777778,14493.912992,6.518947109787722,150,0.07100000000000001
3,test_20231031_122946,10188041.png,221231,24,221207,0.999891516107598,1,6,41731,1,41730,0.9999760369988737,32.19604977777778,6734.978176,9.847441680929638,150,0.07100000000000001
4,test_20231031_122946,10287332.png,216980,24,216956,0.999889390727256,1,5,22337,1,22336,0.9999552312306935,86.39651022222222,25107.6716,4.132739212795741,150,0.07100000000000001
5,test_20231031_122946,11610969.png,368720,24,368696,0.9999349099587763,1,6,84111,1,84110,0.9999881109486274,49.21503644444444,9843.652661333334,8.199240798850546,150,0.07100000000000001
6,test_20231031_122946,10350842.png,212614,24,212590,0.9998871193806617,1,6,42529,1,42528,0.9999764866326507,55.22670577777778,11938.01408,7.361482740939017,150,0.07100000000000001
7,test_20231031_122946,10863862.png,317432,24,317408,0.9999243932558785,1,6,66058,1,66057,0.9999848617881256,55.749475555555556,12668.007861333333,7.10372036659619,150,0.07100000000000001
8,test_20231031_122946,11382381.png,312486,24,312462,0.9999231965592058,0,6,46745,1,46744,0.9999786073376832,30.521228444444443,5261.919984,10.919361212177094,150,0.07100000000000001
9,test_20231031_122946,11079715.png,443815,6577,437238,0.985180762254543,4,6,124136,958,123178,0.9922826577302314,42.805075555555554,10376.3876,7.970341748353334,150,0.07100000000000001
10,test_20231031_122946,11551286.png,271883,24,271859,0.9999117267353972,1,5,40092,1,40091,0.9999750573680535,24.866876444444443,3470.407338666667,12.72699907819776,150,0.07100000000000001
1,test_20231031_122947,10404007.png,502730,24,502706,0.9999522606568138,1,5,61265,1,61264,0.9999836774667429,31.611185777777777,5234.651008,10.941926281199287,150,0.081
2,test_20231031_122947,1254659.png,342646,5872,336774,0.9828627796618084,2,5,80080,853,79227,0.9893481518481518,55.45281777777778,14841.750218666666,6.415952425738808,150,0.081
3,test_20231031_122947,10188041.png,221231,24,221207,0.999891516107598,1,7,41731,1,41730,0.9999760369988737,32.19604977777778,6734.978176,9.847441680929638,150,0.081
4,test_20231031_122947,10287332.png,216980,24,216956,0.999889390727256,1,7,22337,1,22336,0.9999552312306935,86.39651022222222,25107.6716,4.132739212795741,150,0.081
5,test_20231031_122947,11610969.png,368720,24,368696,0.9999349099587763,1,6,84111,1,84110,0.9999881109486274,49.21503644444444,9843.652661333334,8.199240798850546,150,0.081
6,test_20231031_122947,10350842.png,212614,24,212590,0.9998871193806617,0,6,42529,1,42528,0.9999764866326507,55.22670577777778,11938.01408,7.361482740939017,150,0.081
7,test_20231031_122947,10863862.png,317432,24,317408,0.9999243932558785,1,6,66058,1,66057,0.9999848617881256,55.749475555555556,12668.007861333333,7.10372036659619,150,0.081
8,test_20231031_122947,11382381.png,312486,24,312462,0.9999231965592058,1,25,46745,1,46744,0.9999786073376832,30.521228444444443,5261.919984,10.919361212177094,150,0.081
9,test_20231031_122947,11079715.png,443815,4324,439491,0.9902572017619954,4,6,124136,630,123506,0.9949249210543275,44.416403555555554,10915.460272,7.750383075497096,150,0.081
10,test_20231031_122947,11551286.png,271883,24,271859,0.9999117267353972,1,6,40092,1,40091,0.9999750573680535,24.866876444444443,3470.407338666667,12.72699907819776,150,0.081
1,test_20231031_122948,10404007.png,502730,24,502706,0.9999522606568138,2,5,61265,1,61264,0.9999836774667429,31.611185777777777,5234.651008,10.941926281199287,150,0.091
2,test_20231031_122948,1254659.png,342646,4907,337739,0.9856790973774683,2,5,80080,713,79367,0.9910964035964036,55.88786133333333,15007.438581333334,6.367737862074886,150,0.091
3,test_20231031_122948,10188041.png,221231,24,221207,0.999891516107598,1,8,41731,1,41730,0.9999760369988737,32.19604977777778,6734.978176,9.847441680929638,150,0.091
4,test_20231031_122948,10287332.png,216980,24,216956,0.999889390727256,0,5,22337,1,22336,0.9999552312306935,86.39651022222222,25107.6716,4.132739212795741,150,0.091
5,test_20231031_122948,11610969.png,368720,24,368696,0.9999349099587763,1,5,84111,1,84110,0.9999881109486274,49.21503644444444,9843.652661333334,8.199240798850546,150,0.091
6,test_20231031_122948,10350842.png,212614,24,212590,0.9998871193806617,1,9,42529,1,42528,0.9999764866326507,55.22670577777778,11938.01408,7.361482740939017,150,0.091
7,test_20231031_122948,10863862.png,317432,24,317408,0.9999243932558785,1,6,66058,1,66057,0.9999848617881256,55.749475555555556,12668.007861333333,7.10372036659619,150,0.091
8,test_20231031_122948,11382381.png,312486,24,312462,0.9999231965592058,1,7,46745,1,46744,0.9999786073376832,30.521228444444443,5261.919984,10.919361212177094,150,0.091
9,test_20231031_122948,11079715.png,443815,3442,440373,0.9922445162962045,3,6,124136,500,123636,0.9959721595669266,45.30677688888889,11242.343456,7.622235119188989,150,0.091
10,test_20231031_122948,11551286.png,271883,24,271859,0.9999117267353972,1,6,40092,1,40091,0.9999750573680535,24.866876444444443,3470.407338666667,12.72699907819776,150,0.091
1,test_20231031_122949,10404007.png,502730,24,502706,0.9999522606568138,1,5,61265,1,61264,0.9999836774667429,31.611185777777777,5234.651008,10.941926281199287,160,0.001
2,test_20231031_122949,1254659.png,342646,10344,332302,0.9698114088592892,2,5,80080,1503,78577,0.9812312687312688,46.464158222222224,12350.7324,7.213876487906593,160,0.001
3,test_20231031_122949,10188041.png,221231,2697,218534,0.9878091225913186,2,5,41731,384,41347,0.9907982075675158,15.866576,2463.8637493333335,14.214636730203187,160,0.001
4,test_20231031_122949,10287332.png,216980,24,216956,0.999889390727256,1,6,22337,1,22336,0.9999552312306935,86.39651022222222,25107.6716,4.132739212795741,160,0.001
5,test_20231031_122949,11610969.png,368720,24,368696,0.9999349099587763,1,6,84111,1,84110,0.9999881109486274,49.21503644444444,9843.652661333334,8.199240798850546,160,0.001
6,test_20231031_122949,10350842.png,212614,24,212590,0.9998871193806617,1,5,42529,1,42528,0.9999764866326507,55.22670577777778,11938.01408,7.361482740939017,160,0.001
7,test_20231031_122949,10863862.png,317432,24,317408,0.9999243932558785,1,5,66058,1,66057,0.9999848617881256,55.749475555555556,12668.007861333333,7.10372036659619,160,0.001
8,test_20231031_122949,11382381.png,312486,104,312382,0.999667185089892,2,6,46745,13,46732,0.9997218953898813,25.365278222222223,3676.478896,12.476482835227657,160,0.001
9,test_20231031_122949,11079715.png,443815,45647,398168,0.8971485866858939,4,6,124136,6576,117560,0.9470258426242186,25.10672,4515.039413333333,11.584188150958013,160,0.001
10,test_20231031_122949,11551286.png,271883,24,271859,0.9999117267353972,1,5,40092,1,40091,0.9999750573680535,24.866876444444443,3470.407338666667,12.72699907819776,160,0.001
1,test_20231031_122950,10404007.png,502730,24,502706,0.9999522606568138,1,6,61265,1,61264,0.9999836774667429,31.611185777777777,5234.651008,10.941926281199287,160,0.011
2,test_20231031_122950,1254659.png,342646,7672,334974,0.9776095445445153,2,5,80080,1128,78952,0.9859140859140859,48.83432355555556,12871.977786666666,7.0343507924371895,160,0.011
3,test_20231031_122950,10188041.png,221231,777,220454,0.9964878339834833,3,5,41731,110,41621,0.9973640698761113,19.90529777777778,3329.1210026666668,12.907507802395116,160,0.011
4,test_20231031_122950,10287332.png,216980,24,216956,0.999889390727256,1,7,22337,1,22336,0.9999552312306935,86.39651022222222,25107.6716,4.132739212795741,160,0.011
5,test_20231031_122950,11610969.png,368720,24,368696,0.9999349099587763,1,5,84111,1,84110,0.9999881109486274,49.21503644444444,9843.652661333334,8.199240798850546,160,0.011
6,test_20231031_122950,10350842.png,212614,24,212590,0.9998871193806617,1,6,42529,1,42528,0.9999764866326507,55.22670577777778,11938.01408,7.361482740939017,160,0.011
7,test_20231031_122950,10863862.png,317432,24,317408,0.9999243932558785,0,5,66058,1,66057,0.9999848617881256,55.749475555555556,12668.007861333333,7.10372036659619,160,0.011
8,test_20231031_122950,11382381.png,312486,64,312422,0.9997951908245489,2,6,46745,7,46738,0.9998502513637822,25.939884444444445,3840.3579466666665,12.287086555063059,160,0.011
9,test_20231031_122950,11079715.png,443815,33999,409816,0.9233937564075121,4,6,124136,4928,119208,0.9603016046916285,34.08329066666667,7470.1574986666665,9.397506024151937,160,0.011
10,test_20231031_122950,11551286.png,271883,24,271859,0.9999117267353972,1,5,40092,1,40091,0.9999750573680535,24.866876444444443,3470.407338666667,12.72699907819776,160,0.011
1,test_20231031_122951,10404007.png,502730,24,502706,0.9999522606568138,0,5,61265,1,61264,0.9999836774667429,31.611185777777777,5234.651008,10.941926281199287,160,0.020999999999999998
2,test_20231031_122951,1254659.png,342646,6424,336222,0.9812517875591719,3,6,80080,942,79138,0.9882367632367632,50.220940444444444,13202.685306666666,6.92418089111997,160,0.020999999999999998
3,test_20231031_122951,10188041.png,221231,277,220954,0.9987479150751929,2,6,41731,38,41693,0.9990894059572021,21.747168,3888.1013653333334,12.233427821262577,160,0.020999999999999998
4,test_20231031_122951,10287332.png,216980,24,216956,0.999889390727256,1,6,22337,1,22336,0.9999552312306935,86.39651022222222,25107.6716,4.132739212795741,160,0.020999999999999998
5,test_20231031_122951,11610969.png,368720,24,368696,0.9999349099587763,1,6,84111,1,84110,0.9999881109486274,49.21503644444444,9843.652661333334,8.199240798850546,160,0.020999999999999998
6,test_20231031_122951,10350842.png,212614,24,212590,0.9998871193806617,1,6,42529,1,42528,0.9999764866326507,55.22670577777778,11938.01408,7.361482740939017,160,0.020999999999999998
7,test_20231031_122951,10863862.png,317432,24,317408,0.9999243932558785,1,5,66058,1,66057,0.9999848617881256,55.749475555555556,12668.007861333333,7.10372036659619,160,0.020999999999999998
8,test_20231031_122951,11382381.png,312486,24,312462,0.9999231965592058,1,5,46745,1,46744,0.9999786073376832,30.521228444444443,5261.919984,10.919361212177094,160,0.020999999999999998
9,test_20231031_122951,11079715.png,443815,21669,422146,0.9511756024469655,3,6,124136,3144,120992,0.9746729393568344,37.983678222222224,8791.202330666667,8.690320853544018,160,0.020999999999999998
10,test_20231031_122951,11551286.png,271883,24,271859,0.9999117267353972,1,6,40092,1,40091,0.9999750573680535,24.866876444444443,3470.407338666667,12.72699907819776,160,0.020999999999999998
1,test_20231031_122952,10404007.png,502730,24,502706,0.9999522606568138,0,5,61265,1,61264,0.9999836774667429,31.611185777777777,5234.651008,10.941926281199287,160,0.031
2,test_20231031_122952,1254659.png,342646,5592,337054,0.9836799495689429,2,6,80080,819,79261,0.9897727272727272,54.39909333333333,14538.031072,6.505747681321697,160,0.031
3,test_20231031_122952,10188041.png,221231,267,220964,0.9987931166970271,2,5,41731,37,41694,0.9991133689583284,21.793957333333335,3946.0300426666668,12.169199734857754,160,0.031
4,test_20231031_122952,10287332.png,216980,24,216956,0.999889390727256,1,6,22337,1,22336,0.9999552312306935,86.39651022222222,25107.6716,4.132739212795741,160,0.031
5,test_20231031_122952,11610969.png,368720,24,368696,0.9999349099587763,1,6,84111,1,84110,0.9999881109486274,49.21503644444444,9843.652661333334,8.199240798850546,160,0.031
6,test_20231031_122952,10350842.png,212614,24,212590,0.9998871193806617,1,5,42529,1,42528,0.9999764866326507,55.22670577777778,11938.01408,7.361482740939017,160,0.031
7,test_20231031_122952,10863862.png,317432,24,317408,0.9999243932558785,1,5,66058,1,66057,0.9999848617881256,55.749475555555556,12668.007861333333,7.10372036659619,160,0.031
8,test_20231031_122952,11382381.png,312486,24,312462,0.9999231965592058,1,5,46745,1,46744,0.9999786073376832,30.521228444444443,5261.919984,10.919361212177094,160,0.031
9,test_20231031_122952,11079715.png,443815,13429,430386,0.9697418969615719,3,5,124136,1953,122183,0.9842672552684153,41.91757333333333,10121.435749333334,8.078382383062635,160,0.031
10,test_20231031_122952,11551286.png,271883,24,271859,0.9999117267353972,1,6,40092,1,40091,0.9999750573680535,24.866876444444443,3470.407338666667,12.72699907819776,160,0.031
1,test_20231031_122953,10404007.png,502730,24,502706,0.9999522606568138,1,6,61265,1,61264,0.9999836774667429,31.611185777777777,5234.651008,10.941926281199287,160,0.041
2,test_20231031_122953,1254659.png,342646,5007,337639,0.9853872509820631,3,6,80080,733,79347,0.9908466533466533,54.555484444444446,14592.781557333334,6.4894227940196725,160,0.041
3,test_20231031_122953,10188041.png,221231,267,220964,0.9987931166970271,2,6,41731,37,41694,0.9991133689583284,21.793957333333335,3946.0300426666668,12.169199734857754,160,0.041
4,test_20231031_122953,10287332.png,216980,24,216956,0.999889390727256,1,6,22337,1,22336,0.9999552312306935,86.39651022222222,25107.6716,4.132739212795741,160,0.041
5,test_20231031_122953,11610969.png,368720,24,368696,0.9999349099587763,1,5,84111,1,84110,0.9999881109486274,49.21503644444444,9843.652661333334,8.199240798850546,160,0.041
6,test_20231031_122953,10350842.png,212614,24,212590,0.9998871193806617,1,5,42529,1,42528,0.9999764866326507,55.22670577777778,11938.01408,7.361482740939017,160,0.041
7,test_20231031_122953,10863862.png,317432,24,317408,0.9999243932558785,1,6,66058,1,66057,0.9999848617881256,55.749475555555556,12668.007861333333,7.10372036659619,160,0.041
8,test_20231031_122953,11382381.png,312486,24,312462,0.9999231965592058,2,6,46745,1,46744,0.9999786073376832,30.521228444444443,5261.919984,10.919361212177094,160,0.041
9,test_20231031_122953,11079715.png,443815,9932,433883,0.9776213061748702,3,5,124136,1451,122685,0.988311207063221,43.17384177777778,10519.729205333333,7.910758003413607,160,0.041
10,test_20231031_122953,11551286.png,271883,24,271859,0.9999117267353972,1,5,40092,1,40091,0.9999750573680535,24.866876444444443,3470.407338666667,12.72699907819776,160,0.041
1,test_20231031_122954,10404007.png,502730,24,502706,0.9999522606568138,1,5,61265,1,61264,0.9999836774667429,31.611185777777777,5234.651008,10.941926281199287,160,0.051000000000000004
2,test_20231031_122954,1254659.png,342646,4364,338282,0.9872638233045183,2,5,80080,640,79440,0.9920079920079921,54.92465422222222,14713.975082666666,6.453503446153878,160,0.051000000000000004
3,test_20231031_122954,10188041.png,221231,24,221207,0.999891516107598,1,6,41731,1,41730,0.9999760369988737,32.19604977777778,6734.978176,9.847441680929638,160,0.051000000000000004
4,test_20231031_122954,10287332.png,216980,24,216956,0.999889390727256,1,6,22337,1,22336,0.9999552312306935,86.39651022222222,25107.6716,4.132739212795741,160,0.051000000000000004
5,test_20231031_122954,11610969.png,368720,24,368696,0.9999349099587763,0,5,84111,1,84110,0.9999881109486274,49.21503644444444,9843.652661333334,8.199240798850546,160,0.051000000000000004
6,test_20231031_122954,10350842.png,212614,24,212590,0.9998871193806617,1,5,42529,1,42528,0.9999764866326507,55.22670577777778,11938.01408,7.361482740939017,160,0.051000000000000004
7,test_20231031_122954,10863862.png,317432,24,317408,0.9999243932558785,1,6,66058,1,66057,0.9999848617881256,55.749475555555556,12668.007861333333,7.10372036659619,160,0.051000000000000004
8,test_20231031_122954,11382381.png,312486,24,312462,0.9999231965592058,1,6,46745,1,46744,0.9999786073376832,30.521228444444443,5261.919984,10.919361212177094,160,0.051000000000000004
9,test_20231031_122954,11079715.png,443815,5832,437983,0.9868593896105359,4,6,124136,852,123284,0.993136559902043,44.67882488888889,11038.291162666666,7.701785153793131,160,0.051000000000000004
10,test_20231031_122954,11551286.png,271883,24,271859,0.9999117267353972,1,5,40092,1,40091,0.9999750573680535,24.866876444444443,3470.407338666667,12.72699907819776,160,0.051000000000000004
1,test_20231031_122955,10404007.png,502730,24,502706,0.9999522606568138,1,6,61265,1,61264,0.9999836774667429,31.611185777777777,5234.651008,10.941926281199287,160,0.061000000000000006
2,test_20231031_122955,1254659.png,342646,3902,338744,0.9886121536512903,2,6,80080,571,79509,0.9928696303696304,55.97599288888889,15049.298688,6.355640990130217,160,0.061000000000000006
3,test_20231031_122955,10188041.png,221231,24,221207,0.999891516107598,1,5,41731,1,41730,0.9999760369988737,32.19604977777778,6734.978176,9.847441680929638,160,0.061000000000000006
4,test_20231031_122955,10287332.png,216980,24,216956,0.999889390727256,1,5,22337,1,22336,0.9999552312306935,86.39651022222222,25107.6716,4.132739212795741,160,0.061000000000000006
5,test_20231031_122955,11610969.png,368720,24,368696,0.9999349099587763,1,5,84111,1,84110,0.9999881109486274,49.21503644444444,9843.652661333334,8.199240798850546,160,0.061000000000000006
6,test_20231031_122955,10350842.png,212614,24,212590,0.9998871193806617,1,5,42529,1,42528,0.9999764866326507,55.22670577777778,11938.01408,7.361482740939017,160,0.061000000000000006
7,test_20231031_122955,10863862.png,317432,24,317408,0.9999243932558785,1,6,66058,1,66057,0.9999848617881256,55.749475555555556,12668.007861333333,7.10372036659619,160,0.061000000000000006
8,test_20231031_122955,11382381.png,312486,24,312462,0.9999231965592058,0,5,46745,1,46744,0.9999786073376832,30.521228444444443,5261.919984,10.919361212177094,160,0.061000000000000006
9,test_20231031_122955,11079715.png,443815,1412,442403,0.9968184941924,3,6,124136,207,123929,0.9983324740607076,54.813868444444445,14832.809093333333,6.418569537232162,160,0.061000000000000006
10,test_20231031_122955,11551286.png,271883,24,271859,0.9999117267353972,1,6,40092,1,40091,0.9999750573680535,24.866876444444443,3470.407338666667,12.72699907819776,160,0.061000000000000006
1,test_20231031_122956,10404007.png,502730,24,502706,0.9999522606568138,1,6,61265,1,61264,0.9999836774667429,31.611185777777777,5234.651008,10.941926281199287,160,0.07100000000000001
2,test_20231031_122956,1254659.png,342646,2997,339649,0.991253363529707,3,7,80080,440,79640,0.9945054945054945,56.221237333333335,15140.927296,6.329278868132688,160,0.07100000000000001
3,test_20231031_122956,10188041.png,221231,24,221207,0.999891516107598,1,7,41731,1,41730,0.9999760369988737,32.19604977777778,6734.978176,9.847441680929638,160,0.07100000000000001
4,test_20231031_122956,10287332.png,216980,24,216956,0.999889390727256,1,5,22337,1,22336,0.9999552312306935,86.39651022222222,25107.6716,4.132739212795741,160,0.07100000000000001
5,test_20231031_122956,11610969.png,368720,24,368696,0.9999349099587763,1,6,84111,1,84110,0.9999881109486274,49.21503644444444,9843.652661333334,8.199240798850546,160,0.07100000000000001
6,test_20231031_122956,10350842.png,212614,24,212590,0.9998871193806617,1,5,42529,1,42528,0.9999764866326507,55.22670577777778,11938.01408,7.361482740939017,160,0.07100000000000001
7,test_20231031_122956,10863862.png,317432,24,317408,0.9999243932558785,1,6,66058,1,66057,0.9999848617881256,55.749475555555556,12668.007861333333,7.10372036659619,160,0.07100000000000001
8,test_20231031_122956,11382381.png,312486,24,312462,0.9999231965592058,1,6,46745,1,46744,0.9999786073376832,30.521228444444443,5261.919984,10.919361212177094,160,0.07100000000000001
9,test_20231031_122956,11079715.png,443815,667,443148,0.9984971215483929,3,6,124136,97,124039,0.9992185989559838,55.46070755555556,15033.483402666667,6.360207384130665,160,0.07100000000000001
10,test_20231031_122956,11551286.png,271883,24,271859,0.9999117267353972,1,7,40092,1,40091,0.9999750573680535,24.866876444444443,3470.407338666667,12.72699907819776,160,0.07100000000000001
1,test_20231031_122957,10404007.png,502730,24,502706,0.9999522606568138,1,8,61265,1,61264,0.9999836774667429,31.611185777777777,5234.651008,10.941926281199287,160,0.081
2,test_20231031_122957,1254659.png,342646,2557,340089,0.9925374876694898,3,7,80080,374,79706,0.9953296703296703,56.38148622222222,15208.085429333334,6.310058174140051,160,0.081
3,test_20231031_122957,10188041.png,221231,24,221207,0.999891516107598,1,7,41731,1,41730,0.9999760369988737,32.19604977777778,6734.978176,9.847441680929638,160,0.081
4,test_20231031_122957,10287332.png,216980,24,216956,0.999889390727256,1,6,22337,1,22336,0.9999552312306935,86.39651022222222,25107.6716,4.132739212795741,160,0.081
5,test_20231031_122957,11610969.png,368720,24,368696,0.9999349099587763,0,6,84111,1,84110,0.9999881109486274,49.21503644444444,9843.652661333334,8.199240798850546,160,0.081
6,test_20231031_122957,10350842.png,212614,24,212590,0.9998871193806617,1,6,42529,1,42528,0.9999764866326507,55.22670577777778,11938.01408,7.361482740939017,160,0.081
7,test_20231031_122957,10863862.png,317432,24,317408,0.9999243932558785,1,6,66058,1,66057,0.9999848617881256,55.749475555555556,12668.007861333333,7.10372036659619,160,0.081
8,test_20231031_122957,11382381.png,312486,24,312462,0.9999231965592058,1,6,46745,1,46744,0.9999786073376832,30.521228444444443,5261.919984,10.919361212177094,160,0.081
9,test_20231031_122957,11079715.png,443815,24,443791,0.9999459234140351,1,5,124136,1,124135,0.9999919443191339,73.08021333333333,22147.38112,4.677579816576078,160,0.081
10,test_20231031_122957,11551286.png,271883,24,271859,0.9999117267353972,0,5,40092,1,40091,0.9999750573680535,24.866876444444443,3470.407338666667,12.72699907819776,160,0.081
1,test_20231031_122959,10404007.png,502730,24,502706,0.9999522606568138,0,5,61265,1,61264,0.9999836774667429,31.611185777777777,5234.651008,10.941926281199287,160,0.091
2,test_20231031_122959,1254659.png,342646,24,342622,0.9999299568651028,2,5,80080,1,80079,0.9999875124875125,72.18819377777778,21636.542586666666,4.77892497016324,160,0.091
3,test_20231031_122959,10188041.png,221231,24,221207,0.999891516107598,1,6,41731,1,41730,0.9999760369988737,32.19604977777778,6734.978176,9.847441680929638,160,0.091
4,test_20231031_122959,10287332.png,216980,24,216956,0.999889390727256,2,6,22337,1,22336,0.9999552312306935,86.39651022222222,25107.6716,4.132739212795741,160,0.091
5,test_20231031_122959,11610969.png,368720,24,368696,0.9999349099587763,1,6,84111,1,84110,0.9999881109486274,49.21503644444444,9843.652661333334,8.199240798850546,160,0.091
6,test_20231031_122959,10350842.png,212614,24,212590,0.9998871193806617,1,6,42529,1,42528,0.9999764866326507,55.22670577777778,11938.01408,7.361482740939017,160,0.091
7,test_20231031_122959,10863862.png,317432,24,317408,0.9999243932558785,1,6,66058,1,66057,0.9999848617881256,55.749475555555556,12668.007861333333,7.10372036659619,160,0.091
8,test_20231031_122959,11382381.png,312486,24,312462,0.9999231965592058,2,5,46745,1,46744,0.9999786073376832,30.521228444444443,5261.919984,10.919361212177094,160,0.091
9,test_20231031_122959,11079715.png,443815,24,443791,0.9999459234140351,1,6,124136,1,124135,0.9999919443191339,73.08021333333333,22147.38112,4.677579816576078,160,0.091
10,test_20231031_122959,11551286.png,271883,24,271859,0.9999117267353972,1,6,40092,1,40091,0.9999750573680535,24.866876444444443,3470.407338666667,12.72699907819776,160,0.091
1,test_20231031_123000,10404007.png,502730,24,502706,0.9999522606568138,1,6,61265,1,61264,0.9999836774667429,31.611185777777777,5234.651008,10.941926281199287,170,0.001
2,test_20231031_123000,1254659.png,342646,6092,336554,0.982220717591917,2,6,80080,888,79192,0.9889110889110889,48.01548977777778,12897.848634666667,7.02563084988153,170,0.001
3,test_20231031_123000,10188041.png,221231,2074,219157,0.9906251836315887,2,5,41731,297,41434,0.9928829886655005,16.484597333333333,2604.8409813333333,13.97299144954979,170,0.001
4,test_20231031_123000,10287332.png,216980,24,216956,0.999889390727256,1,5,22337,1,22336,0.9999552312306935,86.39651022222222,25107.6716,4.132739212795741,170,0.001
5,test_20231031_123000,11610969.png,368720,24,368696,0.9999349099587763,1,6,84111,1,84110,0.9999881109486274,49.21503644444444,9843.652661333334,8.199240798850546,170,0.001
6,test_20231031_123000,10350842.png,212614,24,212590,0.9998871193806617,1,6,42529,1,42528,0.9999764866326507,55.22670577777778,11938.01408,7.361482740939017,170,0.001
7,test_20231031_123000,10863862.png,317432,24,317408,0.9999243932558785,1,5,66058,1,66057,0.9999848617881256,55.749475555555556,12668.007861333333,7.10372036659619,170,0.001
8,test_20231031_123000,11382381.png,312486,84,312402,0.9997311879572205,2,6,46745,10,46735,0.9997860733768318,25.455066666666667,3715.3108213333335,12.430852083585982,170,0.001
9,test_20231031_123000,11079715.png,443815,29137,414678,0.9343487714475626,4,6,124136,4215,119921,0.9660453051491912,32.46083022222222,7049.354981333333,9.64930980169161,170,0.001
10,test_20231031_123000,11551286.png,271883,24,271859,0.9999117267353972,1,6,40092,1,40091,0.9999750573680535,24.866876444444443,3470.407338666667,12.72699907819776,170,0.001
1,test_20231031_123001,10404007.png,502730,24,502706,0.9999522606568138,1,5,61265,1,61264,0.9999836774667429,31.611185777777777,5234.651008,10.941926281199287,170,0.011
2,test_20231031_123001,1254659.png,342646,4314,338332,0.9874097465022209,2,5,80080,633,79447,0.9920954045954046,51.22159822222222,13583.331109333334,6.800740736186453,170,0.011
3,test_20231031_123001,10188041.png,221231,677,220554,0.9969398502018253,2,5,41731,95,41636,0.9977235148930051,19.944522666666668,3340.578229333333,12.892587143935241,170,0.011
4,test_20231031_123001,10287332.png,216980,24,216956,0.999889390727256,1,6,22337,1,22336,0.9999552312306935,86.39651022222222,25107.6716,4.132739212795741,170,0.011
5,test_20231031_123001,11610969.png,368720,24,368696,0.9999349099587763,1,6,84111,1,84110,0.9999881109486274,49.21503644444444,9843.652661333334,8.199240798850546,170,0.011
6,test_20231031_123001,10350842.png,212614,24,212590,0.9998871193806617,0,5,42529,1,42528,0.9999764866326507,55.22670577777778,11938.01408,7.361482740939017,170,0.011
7,test_20231031_123001,10863862.png,317432,24,317408,0.9999243932558785,1,6,66058,1,66057,0.9999848617881256,55.749475555555556,12668.007861333333,7.10372036659619,170,0.011
8,test_20231031_123001,11382381.png,312486,64,312422,0.9997951908245489,2,5,46745,7,46738,0.9998502513637822,25.939884444444445,3840.3579466666665,12.287086555063059,170,0.011
9,test_20231031_123001,11079715.png,443815,12192,431623,0.9725290943298447,3,6,124136,1773,122363,0.9857172778243217,50.86330844444444,13482.312698666667,6.833159652472651,170,0.011
10,test_20231031_123001,11551286.png,271883,24,271859,0.9999117267353972,1,5,40092,1,40091,0.9999750573680535,24.866876444444443,3470.407338666667,12.72699907819776,170,0.011
1,test_20231031_123002,10404007.png,502730,24,502706,0.9999522606568138,1,6,61265,1,61264,0.9999836774667429,31.611185777777777,5234.651008,10.941926281199287,170,0.020999999999999998
2,test_20231031_123002,1254659.png,342646,3572,339074,0.9895752467561273,2,5,80080,522,79558,0.9934815184815184,52.208584888888886,13838.959930666666,6.719769089946782,170,0.020999999999999998
3,test_20231031_123002,10188041.png,221231,244,220987,0.9988970804272457,2,5,41731,34,41697,0.9991852579617071,21.797253333333334,3947.150832,12.16796638512501,170,0.020999999999999998
4,test_20231031_123002,10287332.png,216980,24,216956,0.999889390727256,2,5,22337,1,22336,0.9999552312306935,86.39651022222222,25107.6716,4.132739212795741,170,0.020999999999999998
5,test_20231031_123002,11610969.png,368720,24,368696,0.9999349099587763,1,5,84111,1,84110,0.9999881109486274,49.21503644444444,9843.652661333334,8.199240798850546,170,0.020999999999999998
6,test_20231031_123002,10350842.png,212614,24,212590,0.9998871193806617,0,5,42529,1,42528,0.9999764866326507,55.22670577777778,11938.01408,7.361482740939017,170,0.020999999999999998
7,test_20231031_123002,10863862.png,317432,24,317408,0.9999243932558785,1,6,66058,1,66057,0.9999848617881256,55.749475555555556,12668.007861333333,7.10372036659619,170,0.020999999999999998
8,test_20231031_123002,11382381.png,312486,24,312462,0.9999231965592058,1,5,46745,1,46744,0.9999786073376832,30.521228444444443,5261.919984,10.919361212177094,170,0.020999999999999998
9,test_20231031_123002,11079715.png,443815,4637,439178,0.9895519529533702,2,5,124136,675,123461,0.994562415415351,54.53823644444444,14824.673290666668,6.420952298011967,170,0.020999999999999998
10,test_20231031_123002,11551286.png,271883,24,271859,0.9999117267353972,1,5,40092,1,40091,0.9999750573680535,24.866876444444443,3470.407338666667,12.72699907819776,170,0.020999999999999998
1,test_20231031_123003,10404007.png,502730,24,502706,0.9999522606568138,1,5,61265,1,61264,0.9999836774667429,31.611185777777777,5234.651008,10.941926281199287,170,0.031
2,test_20231031_123003,1254659.png,342646,2837,339809,0.9917203177623554,2,6,80080,414,79666,0.9948301698301698,56.666048,15311.723477333333,6.280562835224366,170,0.031
3,test_20231031_123003,10188041.png,221231,244,220987,0.9988970804272457,2,6,41731,34,41697,0.9991852579617071,21.797253333333334,3947.150832,12.16796638512501,170,0.031
4,test_20231031_123003,10287332.png,216980,24,216956,0.999889390727256,1,5,22337,1,22336,0.9999552312306935,86.39651022222222,25107.6716,4.132739212795741,170,0.031
5,test_20231031_123003,11610969.png,368720,24,368696,0.9999349099587763,0,5,84111,1,84110,0.9999881109486274,49.21503644444444,9843.652661333334,8.199240798850546,170,0.031
6,test_20231031_123003,10350842.png,212614,24,212590,0.9998871193806617,1,7,42529,1,42528,0.9999764866326507,55.22670577777778,11938.01408,7.361482740939017,170,0.031
7,test_20231031_123003,10863862.png,317432,24,317408,0.9999243932558785,1,8,66058,1,66057,0.9999848617881256,55.749475555555556,12668.007861333333,7.10372036659619,170,0.031
8,test_20231031_123003,11382381.png,312486,24,312462,0.9999231965592058,1,7,46745,1,46744,0.9999786073376832,30.521228444444443,5261.919984,10.919361212177094,170,0.031
9,test_20231031_123003,11079715.png,443815,2367,441448,0.9946666967092144,3,6,124136,344,123792,0.9972288457820455,56.607276444444445,15478.496784,6.233515795929709,170,0.031
10,test_20231031_123003,11551286.png,271883,24,271859,0.9999117267353972,0,5,40092,1,40091,0.9999750573680535,24.866876444444443,3470.407338666667,12.72699907819776,170,0.031
1,test_20231031_123004,10404007.png,502730,24,502706,0.9999522606568138,1,5,61265,1,61264,0.9999836774667429,31.611185777777777,5234.651008,10.941926281199287,170,0.041
2,test_20231031_123004,1254659.png,342646,2517,340129,0.9926542262276519,3,6,80080,368,79712,0.9954045954045954,56.776736,15351.398912,6.269324037204975,170,0.041
3,test_20231031_123004,10188041.png,221231,104,221127,0.9995299031329244,2,6,41731,13,41718,0.9996884809853586,23.272928,4371.861546666667,11.724139611288509,170,0.041
4,test_20231031_123004,10287332.png,216980,24,216956,0.999889390727256,0,5,22337,1,22336,0.9999552312306935,86.39651022222222,25107.6716,4.132739212795741,170,0.041
5,test_20231031_123004,11610969.png,368720,24,368696,0.9999349099587763,1,5,84111,1,84110,0.9999881109486274,49.21503644444444,9843.652661333334,8.199240798850546,170,0.041
6,test_20231031_123004,10350842.png,212614,24,212590,0.9998871193806617,0,5,42529,1,42528,0.9999764866326507,55.22670577777778,11938.01408,7.361482740939017,170,0.041
7,test_20231031_123004,10863862.png,317432,24,317408,0.9999243932558785,0,5,66058,1,66057,0.9999848617881256,55.749475555555556,12668.007861333333,7.10372036659619,170,0.041
8,test_20231031_123004,11382381.png,312486,24,312462,0.9999231965592058,1,5,46745,1,46744,0.9999786073376832,30.521228444444443,5261.919984,10.919361212177094,170,0.041
9,test_20231031_123004,11079715.png,443815,1882,441933,0.9957594943839212,3,6,124136,277,123859,0.9977685764000773,56.99688,15584.163461333334,6.203968660213343,170,0.041
10,test_20231031_123004,11551286.png,271883,24,271859,0.9999117267353972,1,6,40092,1,40091,0.9999750573680535,24.866876444444443,3470.407338666667,12.72699907819776,170,0.041
1,test_20231031_123005,10404007.png,502730,24,502706,0.9999522606568138,0,5,61265,1,61264,0.9999836774667429,31.611185777777777,5234.651008,10.941926281199287,170,0.051000000000000004
2,test_20231031_123005,1254659.png,342646,2214,340432,0.9935385208057296,2,5,80080,323,79757,0.9959665334665335,56.87595377777778,15387.507232,6.259120908137069,170,0.051000000000000004
3,test_20231031_123005,10188041.png,221231,24,221207,0.999891516107598,1,5,41731,1,41730,0.9999760369988737,32.19604977777778,6734.978176,9.847441680929638,170,0.051000000000000004
4,test_20231031_123005,10287332.png,216980,24,216956,0.999889390727256,0,5,22337,1,22336,0.9999552312306935,86.39651022222222,25107.6716,4.132739212795741,170,0.051000000000000004
5,test_20231031_123005,11610969.png,368720,24,368696,0.9999349099587763,1,5,84111,1,84110,0.9999881109486274,49.21503644444444,9843.652661333334,8.199240798850546,170,0.051000000000000004
6,test_20231031_123005,10350842.png,212614,24,212590,0.9998871193806617,1,6,42529,1,42528,0.9999764866326507,55.22670577777778,11938.01408,7.361482740939017,170,0.051000000000000004
7,test_20231031_123005,10863862.png,317432,24,317408,0.9999243932558785,1,5,66058,1,66057,0.9999848617881256,55.749475555555556,12668.007861333333,7.10372036659619,170,0.051000000000000004
8,test_20231031_123005,11382381.png,312486,24,312462,0.9999231965592058,1,5,46745,1,46744,0.9999786073376832,30.521228444444443,5261.919984,10.919361212177094,170,0.051000000000000004
9,test_20231031_123005,11079715.png,443815,44,443771,0.9999008595923977,2,5,124136,4,124132,0.9999677772765354,64.09058488888888,18232.105269333333,5.522435411397226,170,0.051000000000000004
10,test_20231031_123005,11551286.png,271883,24,271859,0.9999117267353972,1,5,40092,1,40091,0.9999750573680535,24.866876444444443,3470.407338666667,12.72699907819776,170,0.051000000000000004
1,test_20231031_123006,10404007.png,502730,24,502706,0.9999522606568138,1,5,61265,1,61264,0.9999836774667429,31.611185777777777,5234.651008,10.941926281199287,170,0.061000000000000006
2,test_20231031_123006,1254659.png,342646,2074,340572,0.9939471057592968,2,6,80080,304,79776,0.9962037962037962,56.910122666666666,15397.871701333333,6.256196642030661,170,0.061000000000000006
3,test_20231031_123006,10188041.png,221231,24,221207,0.999891516107598,1,5,41731,1,41730,0.9999760369988737,32.19604977777778,6734.978176,9.847441680929638,170,0.061000000000000006
4,test_20231031_123006,10287332.png,216980,24,216956,0.999889390727256,1,5,22337,1,22336,0.9999552312306935,86.39651022222222,25107.6716,4.132739212795741,170,0.061000000000000006
5,test_20231031_123006,11610969.png,368720,24,368696,0.9999349099587763,1,5,84111,1,84110,0.9999881109486274,49.21503644444444,9843.652661333334,8.199240798850546,170,0.061000000000000006
6,test_20231031_123006,10350842.png,212614,24,212590,0.9998871193806617,1,6,42529,1,42528,0.9999764866326507,55.22670577777778,11938.01408,7.361482740939017,170,0.061000000000000006
7,test_20231031_123006,10863862.png,317432,24,317408,0.9999243932558785,1,6,66058,1,66057,0.9999848617881256,55.749475555555556,12668.007861333333,7.10372036659619,170,0.061000000000000006
8,test_20231031_123006,11382381.png,312486,24,312462,0.9999231965592058,1,5,46745,1,46744,0.9999786073376832,30.521228444444443,5261.919984,10.919361212177094,170,0.061000000000000006
9,test_20231031_123006,11079715.png,443815,24,443791,0.9999459234140351,1,10,124136,1,124135,0.9999919443191339,73.08021333333333,22147.38112,4.677579816576078,170,0.061000000000000006
10,test_20231031_123006,11551286.png,271883,24,271859,0.9999117267353972,1,14,40092,1,40091,0.9999750573680535,24.866876444444443,3470.407338666667,12.72699907819776,170,0.061000000000000006
1,test_20231031_123007,10404007.png,502730,24,502706,0.9999522606568138,1,6,61265,1,61264,0.9999836774667429,31.611185777777777,5234.651008,10.941926281199287,170,0.07100000000000001
2,test_20231031_123007,1254659.png,342646,24,342622,0.9999299568651028,1,5,80080,1,80079,0.9999875124875125,72.18819377777778,21636.542586666666,4.77892497016324,170,0.07100000000000001
3,test_20231031_123007,10188041.png,221231,24,221207,0.999891516107598,1,6,41731,1,41730,0.9999760369988737,32.19604977777778,6734.978176,9.847441680929638,170,0.07100000000000001
4,test_20231031_123007,10287332.png,216980,24,216956,0.999889390727256,0,5,22337,1,22336,0.9999552312306935,86.39651022222222,25107.6716,4.132739212795741,170,0.07100000000000001
5,test_20231031_123007,11610969.png,368720,24,368696,0.9999349099587763,1,6,84111,1,84110,0.9999881109486274,49.21503644444444,9843.652661333334,8.199240798850546,170,0.07100000000000001
6,test_20231031_123007,10350842.png,212614,24,212590,0.9998871193806617,1,5,42529,1,42528,0.9999764866326507,55.22670577777778,11938.01408,7.361482740939017,170,0.07100000000000001
7,test_20231031_123007,10863862.png,317432,24,317408,0.9999243932558785,0,5,66058,1,66057,0.9999848617881256,55.749475555555556,12668.007861333333,7.10372036659619,170,0.07100000000000001
8,test_20231031_123007,11382381.png,312486,24,312462,0.9999231965592058,0,6,46745,1,46744,0.9999786073376832,30.521228444444443,5261.919984,10.919361212177094,170,0.07100000000000001
9,test_20231031_123007,11079715.png,443815,24,443791,0.9999459234140351,1,7,124136,1,124135,0.9999919443191339,73.08021333333333,22147.38112,4.677579816576078,170,0.07100000000000001
10,test_20231031_123007,11551286.png,271883,24,271859,0.9999117267353972,1,5,40092,1,40091,0.9999750573680535,24.866876444444443,3470.407338666667,12.72699907819776,170,0.07100000000000001
1,test_20231031_123008,10404007.png,502730,24,502706,0.9999522606568138,0,5,61265,1,61264,0.9999836774667429,31.611185777777777,5234.651008,10.941926281199287,170,0.081
2,test_20231031_123008,1254659.png,342646,24,342622,0.9999299568651028,1,5,80080,1,80079,0.9999875124875125,72.18819377777778,21636.542586666666,4.77892497016324,170,0.081
3,test_20231031_123008,10188041.png,221231,24,221207,0.999891516107598,1,6,41731,1,41730,0.9999760369988737,32.19604977777778,6734.978176,9.847441680929638,170,0.081
4,test_20231031_123008,10287332.png,216980,24,216956,0.999889390727256,1,6,22337,1,22336,0.9999552312306935,86.39651022222222,25107.6716,4.132739212795741,170,0.081
5,test_20231031_123008,11610969.png,368720,24,368696,0.9999349099587763,1,6,84111,1,84110,0.9999881109486274,49.21503644444444,9843.652661333334,8.199240798850546,170,0.081
6,test_20231031_123008,10350842.png,212614,24,212590,0.9998871193806617,1,6,42529,1,42528,0.9999764866326507,55.22670577777778,11938.01408,7.361482740939017,170,0.081
7,test_20231031_123008,10863862.png,317432,24,317408,0.9999243932558785,1,5,66058,1,66057,0.9999848617881256,55.749475555555556,12668.007861333333,7.10372036659619,170,0.081
8,test_20231031_123008,11382381.png,312486,24,312462,0.9999231965592058,1,5,46745,1,46744,0.9999786073376832,30.521228444444443,5261.919984,10.919361212177094,170,0.081
9,test_20231031_123008,11079715.png,443815,24,443791,0.9999459234140351,1,6,124136,1,124135,0.9999919443191339,73.08021333333333,22147.38112,4.677579816576078,170,0.081
10,test_20231031_123008,11551286.png,271883,24,271859,0.9999117267353972,1,6,40092,1,40091,0.9999750573680535,24.866876444444443,3470.407338666667,12.72699907819776,170,0.081
1,test_20231031_123009,10404007.png,502730,24,502706,0.9999522606568138,1,6,61265,1,61264,0.9999836774667429,31.611185777777777,5234.651008,10.941926281199287,170,0.091
2,test_20231031_123009,1254659.png,342646,24,342622,0.9999299568651028,1,5,80080,1,80079,0.9999875124875125,72.18819377777778,21636.542586666666,4.77892497016324,170,0.091
3,test_20231031_123009,10188041.png,221231,24,221207,0.999891516107598,1,5,41731,1,41730,0.9999760369988737,32.19604977777778,6734.978176,9.847441680929638,170,0.091
4,test_20231031_123009,10287332.png,216980,24,216956,0.999889390727256,1,5,22337,1,22336,0.9999552312306935,86.39651022222222,25107.6716,4.132739212795741,170,0.091
5,test_20231031_123009,11610969.png,368720,24,368696,0.9999349099587763,1,8,84111,1,84110,0.9999881109486274,49.21503644444444,9843.652661333334,8.199240798850546,170,0.091
6,test_20231031_123009,10350842.png,212614,24,212590,0.9998871193806617,1,6,42529,1,42528,0.9999764866326507,55.22670577777778,11938.01408,7.361482740939017,170,0.091
7,test_20231031_123009,10863862.png,317432,24,317408,0.9999243932558785,1,5,66058,1,66057,0.9999848617881256,55.749475555555556,12668.007861333333,7.10372036659619,170,0.091
8,test_20231031_123009,11382381.png,312486,24,312462,0.9999231965592058,1,6,46745,1,46744,0.9999786073376832,30.521228444444443,5261.919984,10.919361212177094,170,0.091
9,test_20231031_123009,11079715.png,443815,24,443791,0.9999459234140351,1,6,124136,1,124135,0.9999919443191339,73.08021333333333,22147.38112,4.677579816576078,170,0.091
10,test_20231031_123009,11551286.png,271883,24,271859,0.9999117267353972,1,6,40092,1,40091,0.9999750573680535,24.866876444444443,3470.407338666667,12.72699907819776,170,0.091
1,test_20231031_123010,10404007.png,502730,24,502706,0.9999522606568138,1,6,61265,1,61264,0.9999836774667429,31.611185777777777,5234.651008,10.941926281199287,180,0.001
2,test_20231031_123010,1254659.png,342646,24,342622,0.9999299568651028,1,6,80080,1,80079,0.9999875124875125,72.18819377777778,21636.542586666666,4.77892497016324,180,0.001
3,test_20231031_123010,10188041.png,221231,1632,219599,0.9926230953166599,2,6,41731,232,41499,0.9944405837387075,16.778144,2662.381717333333,13.878100385621597,180,0.001
4,test_20231031_123010,10287332.png,216980,24,216956,0.999889390727256,1,5,22337,1,22336,0.9999552312306935,86.39651022222222,25107.6716,4.132739212795741,180,0.001
5,test_20231031_123010,11610969.png,368720,24,368696,0.9999349099587763,1,11,84111,1,84110,0.9999881109486274,49.21503644444444,9843.652661333334,8.199240798850546,180,0.001
6,test_20231031_123010,10350842.png,212614,24,212590,0.9998871193806617,0,6,42529,1,42528,0.9999764866326507,55.22670577777778,11938.01408,7.361482740939017,180,0.001
7,test_20231031_123010,10863862.png,317432,24,317408,0.9999243932558785,1,6,66058,1,66057,0.9999848617881256,55.749475555555556,12668.007861333333,7.10372036659619,180,0.001
8,test_20231031_123010,11382381.png,312486,44,312442,0.9998591936918774,2,6,46745,4,46741,0.9999144293507327,26.483056,4132.547450666667,11.968625119470179,180,0.001
9,test_20231031_123010,11079715.png,443815,11247,432568,0.9746583599022115,3,5,124136,1629,122507,0.9868772958690468,50.02864177777778,13235.043429333333,6.913549901388264,180,0.001
10,test_20231031_123010,11551286.png,271883,24,271859,0.9999117267353972,1,6,40092,1,40091,0.9999750573680535,24.866876444444443,3470.407338666667,12.72699907819776,180,0.001
1,test_20231031_123011,10404007.png,502730,24,502706,0.9999522606568138,1,6,61265,1,61264,0.9999836774667429,31.611185777777777,5234.651008,10.941926281199287,180,0.011
2,test_20231031_123011,1254659.png,342646,24,342622,0.9999299568651028,1,6,80080,1,80079,0.9999875124875125,72.18819377777778,21636.542586666666,4.77892497016324,180,0.011
3,test_20231031_123011,10188041.png,221231,244,220987,0.9988970804272457,2,6,41731,34,41697,0.9991852579617071,21.797253333333334,3947.150832,12.16796638512501,180,0.011
4,test_20231031_123011,10287332.png,216980,24,216956,0.999889390727256,1,6,22337,1,22336,0.9999552312306935,86.39651022222222,25107.6716,4.132739212795741,180,0.011
5,test_20231031_123011,11610969.png,368720,24,368696,0.9999349099587763,1,5,84111,1,84110,0.9999881109486274,49.21503644444444,9843.652661333334,8.199240798850546,180,0.011
6,test_20231031_123011,10350842.png,212614,24,212590,0.9998871193806617,1,6,42529,1,42528,0.9999764866326507,55.22670577777778,11938.01408,7.361482740939017,180,0.011
7,test_20231031_123011,10863862.png,317432,24,317408,0.9999243932558785,1,6,66058,1,66057,0.9999848617881256,55.749475555555556,12668.007861333333,7.10372036659619,180,0.011
8,test_20231031_123011,11382381.png,312486,44,312442,0.9998591936918774,1,5,46745,4,46741,0.9999144293507327,26.483056,4132.547450666667,11.968625119470179,180,0.011
9,test_20231031_123011,11079715.png,443815,4817,438998,0.9891463785586336,2,6,124136,701,123435,0.9943529677128311,54.878179555555555,14936.100586666667,6.388431311754696,180,0.011
10,test_20231031_123011,11551286.png,271883,24,271859,0.9999117267353972,1,6,40092,1,40091,0.9999750573680535,24.866876444444443,3470.407338666667,12.72699907819776,180,0.011
1,test_20231031_123012,10404007.png,502730,24,502706,0.9999522606568138,1,6,61265,1,61264,0.9999836774667429,31.611185777777777,5234.651008,10.941926281199287,180,0.020999999999999998
2,test_20231031_123012,1254659.png,342646,24,342622,0.9999299568651028,1,15,80080,1,80079,0.9999875124875125,72.18819377777778,21636.542586666666,4.77892497016324,180,0.020999999999999998
3,test_20231031_123012,10188041.png,221231,244,220987,0.9988970804272457,2,5,41731,34,41697,0.9991852579617071,21.797253333333334,3947.150832,12.16796638512501,180,0.020999999999999998
4,test_20231031_123012,10287332.png,216980,24,216956,0.999889390727256,1,6,22337,1,22336,0.9999552312306935,86.39651022222222,25107.6716,4.132739212795741,180,0.020999999999999998
5,test_20231031_123012,11610969.png,368720,24,368696,0.9999349099587763,1,6,84111,1,84110,0.9999881109486274,49.21503644444444,9843.652661333334,8.199240798850546,180,0.020999999999999998
6,test_20231031_123012,10350842.png,212614,24,212590,0.9998871193806617,1,6,42529,1,42528,0.9999764866326507,55.22670577777778,11938.01408,7.361482740939017,180,0.020999999999999998
7,test_20231031_123012,10863862.png,317432,24,317408,0.9999243932558785,0,5,66058,1,66057,0.9999848617881256,55.749475555555556,12668.007861333333,7.10372036659619,180,0.020999999999999998
8,test_20231031_123012,11382381.png,312486,24,312462,0.9999231965592058,1,5,46745,1,46744,0.9999786073376832,30.521228444444443,5261.919984,10.919361212177094,180,0.020999999999999998
9,test_20231031_123012,11079715.png,443815,1822,441993,0.9958946858488334,2,6,124136,262,123874,0.9978894116130695,56.787802666666664,15619.962789333333,6.1940036592371275,180,0.020999999999999998
10,test_20231031_123012,11551286.png,271883,24,271859,0.9999117267353972,0,5,40092,1,40091,0.9999750573680535,24.866876444444443,3470.407338666667,12.72699907819776,180,0.020999999999999998
1,test_20231031_123013,10404007.png,502730,24,502706,0.9999522606568138,1,6,61265,1,61264,0.9999836774667429,31.611185777777777,5234.651008,10.941926281199287,180,0.031
2,test_20231031_123013,1254659.png,342646,24,342622,0.9999299568651028,1,6,80080,1,80079,0.9999875124875125,72.18819377777778,21636.542586666666,4.77892497016324,180,0.031
3,test_20231031_123013,10188041.png,221231,44,221187,0.9998011128639296,1,5,41731,4,41727,0.999904147995495,28.297372444444445,5862.02576,10.450326383040004,180,0.031
4,test_20231031_123013,10287332.png,216980,24,216956,0.999889390727256,1,5,22337,1,22336,0.9999552312306935,86.39651022222222,25107.6716,4.132739212795741,180,0.031
5,test_20231031_123013,11610969.png,368720,24,368696,0.9999349099587763,1,6,84111,1,84110,0.9999881109486274,49.21503644444444,9843.652661333334,8.199240798850546,180,0.031
6,test_20231031_123013,10350842.png,212614,24,212590,0.9998871193806617,1,6,42529,1,42528,0.9999764866326507,55.22670577777778,11938.01408,7.361482740939017,180,0.031
7,test_20231031_123013,10863862.png,317432,24,317408,0.9999243932558785,1,6,66058,1,66057,0.9999848617881256,55.749475555555556,12668.007861333333,7.10372036659619,180,0.031
8,test_20231031_123013,11382381.png,312486,24,312462,0.9999231965592058,1,5,46745,1,46744,0.9999786073376832,30.521228444444443,5261.919984,10.919361212177094,180,0.031
9,test_20231031_123013,11079715.png,443815,1199,442616,0.9972984238928382,2,5,124136,175,123961,0.9985902558484243,58.087824,16019.589466666666,6.084289786231766,180,0.031
10,test_20231031_123013,11551286.png,271883,24,271859,0.9999117267353972,1,6,40092,1,40091,0.9999750573680535,24.866876444444443,3470.407338666667,12.72699907819776,180,0.031
1,test_20231031_123014,10404007.png,502730,24,502706,0.9999522606568138,1,5,61265,1,61264,0.9999836774667429,31.611185777777777,5234.651008,10.941926281199287,180,0.041
2,test_20231031_123014,1254659.png,342646,24,342622,0.9999299568651028,1,6,80080,1,80079,0.9999875124875125,72.18819377777778,21636.542586666666,4.77892497016324,180,0.041
3,test_20231031_123014,10188041.png,221231,24,221207,0.999891516107598,0,5,41731,1,41730,0.9999760369988737,32.19604977777778,6734.978176,9.847441680929638,180,0.041
4,test_20231031_123014,10287332.png,216980,24,216956,0.999889390727256,0,5,22337,1,22336,0.9999552312306935,86.39651022222222,25107.6716,4.132739212795741,180,0.041
5,test_20231031_123014,11610969.png,368720,24,368696,0.9999349099587763,1,6,84111,1,84110,0.9999881109486274,49.21503644444444,9843.652661333334,8.199240798850546,180,0.041
6,test_20231031_123014,10350842.png,212614,24,212590,0.9998871193806617,1,6,42529,1,42528,0.9999764866326507,55.22670577777778,11938.01408,7.361482740939017,180,0.041
7,test_20231031_123014,10863862.png,317432,24,317408,0.9999243932558785,1,5,66058,1,66057,0.9999848617881256,55.749475555555556,12668.007861333333,7.10372036659619,180,0.041
8,test_20231031_123014,11382381.png,312486,24,312462,0.9999231965592058,1,6,46745,1,46744,0.9999786073376832,30.521228444444443,5261.919984,10.919361212177094,180,0.041
9,test_20231031_123014,11079715.png,443815,577,443238,0.9986999087457612,2,6,124136,83,124053,0.9993313784881098,62.41313777777778,17630.763722666667,5.668092355591766,180,0.041
10,test_20231031_123014,11551286.png,271883,24,271859,0.9999117267353972,1,6,40092,1,40091,0.9999750573680535,24.866876444444443,3470.407338666667,12.72699907819776,180,0.041
1,test_20231031_123015,10404007.png,502730,24,502706,0.9999522606568138,1,6,61265,1,61264,0.9999836774667429,31.611185777777777,5234.651008,10.941926281199287,180,0.051000000000000004
2,test_20231031_123015,1254659.png,342646,24,342622,0.9999299568651028,1,5,80080,1,80079,0.9999875124875125,72.18819377777778,21636.542586666666,4.77892497016324,180,0.051000000000000004
3,test_20231031_123015,10188041.png,221231,24,221207,0.999891516107598,1,6,41731,1,41730,0.9999760369988737,32.19604977777778,6734.978176,9.847441680929638,180,0.051000000000000004
4,test_20231031_123015,10287332.png,216980,24,216956,0.999889390727256,1,5,22337,1,22336,0.9999552312306935,86.39651022222222,25107.6716,4.132739212795741,180,0.051000000000000004
5,test_20231031_123015,11610969.png,368720,24,368696,0.9999349099587763,1,6,84111,1,84110,0.9999881109486274,49.21503644444444,9843.652661333334,8.199240798850546,180,0.051000000000000004
6,test_20231031_123015,10350842.png,212614,24,212590,0.9998871193806617,1,6,42529,1,42528,0.9999764866326507,55.22670577777778,11938.01408,7.361482740939017,180,0.051000000000000004
7,test_20231031_123015,10863862.png,317432,24,317408,0.9999243932558785,1,6,66058,1,66057,0.9999848617881256,55.749475555555556,12668.007861333333,7.10372036659619,180,0.051000000000000004
8,test_20231031_123015,11382381.png,312486,24,312462,0.9999231965592058,1,6,46745,1,46744,0.9999786073376832,30.521228444444443,5261.919984,10.919361212177094,180,0.051000000000000004
9,test_20231031_123015,11079715.png,443815,24,443791,0.9999459234140351,1,6,124136,1,124135,0.9999919443191339,73.08021333333333,22147.38112,4.677579816576078,180,0.051000000000000004
10,test_20231031_123015,11551286.png,271883,24,271859,0.9999117267353972,1,6,40092,1,40091,0.9999750573680535,24.866876444444443,3470.407338666667,12.72699907819776,180,0.051000000000000004
1,test_20231031_123016,10404007.png,502730,24,502706,0.9999522606568138,2,6,61265,1,61264,0.9999836774667429,31.611185777777777,5234.651008,10.941926281199287,180,0.061000000000000006
2,test_20231031_123016,1254659.png,342646,24,342622,0.9999299568651028,1,6,80080,1,80079,0.9999875124875125,72.18819377777778,21636.542586666666,4.77892497016324,180,0.061000000000000006
3,test_20231031_123016,10188041.png,221231,24,221207,0.999891516107598,1,7,41731,1,41730,0.9999760369988737,32.19604977777778,6734.978176,9.847441680929638,180,0.061000000000000006
4,test_20231031_123016,10287332.png,216980,24,216956,0.999889390727256,1,7,22337,1,22336,0.9999552312306935,86.39651022222222,25107.6716,4.132739212795741,180,0.061000000000000006
5,test_20231031_123016,11610969.png,368720,24,368696,0.9999349099587763,1,5,84111,1,84110,0.9999881109486274,49.21503644444444,9843.652661333334,8.199240798850546,180,0.061000000000000006
6,test_20231031_123016,10350842.png,212614,24,212590,0.9998871193806617,1,6,42529,1,42528,0.9999764866326507,55.22670577777778,11938.01408,7.361482740939017,180,0.061000000000000006
7,test_20231031_123016,10863862.png,317432,24,317408,0.9999243932558785,1,6,66058,1,66057,0.9999848617881256,55.749475555555556,12668.007861333333,7.10372036659619,180,0.061000000000000006
8,test_20231031_123016,11382381.png,312486,24,312462,0.9999231965592058,1,5,46745,1,46744,0.9999786073376832,30.521228444444443,5261.919984,10.919361212177094,180,0.061000000000000006
9,test_20231031_123016,11079715.png,443815,24,443791,0.9999459234140351,1,6,124136,1,124135,0.9999919443191339,73.08021333333333,22147.38112,4.677579816576078,180,0.061000000000000006
10,test_20231031_123016,11551286.png,271883,24,271859,0.9999117267353972,1,5,40092,1,40091,0.9999750573680535,24.866876444444443,3470.407338666667,12.72699907819776,180,0.061000000000000006
1,test_20231031_123017,10404007.png,502730,24,502706,0.9999522606568138,1,6,61265,1,61264,0.9999836774667429,31.611185777777777,5234.651008,10.941926281199287,180,0.07100000000000001
2,test_20231031_123017,1254659.png,342646,24,342622,0.9999299568651028,1,5,80080,1,80079,0.9999875124875125,72.18819377777778,21636.542586666666,4.77892497016324,180,0.07100000000000001
3,test_20231031_123017,10188041.png,221231,24,221207,0.999891516107598,1,5,41731,1,41730,0.9999760369988737,32.19604977777778,6734.978176,9.847441680929638,180,0.07100000000000001
4,test_20231031_123017,10287332.png,216980,24,216956,0.999889390727256,1,5,22337,1,22336,0.9999552312306935,86.39651022222222,25107.6716,4.132739212795741,180,0.07100000000000001
5,test_20231031_123017,11610969.png,368720,24,368696,0.9999349099587763,1,5,84111,1,84110,0.9999881109486274,49.21503644444444,9843.652661333334,8.199240798850546,180,0.07100000000000001
6,test_20231031_123017,10350842.png,212614,24,212590,0.9998871193806617,1,6,42529,1,42528,0.9999764866326507,55.22670577777778,11938.01408,7.361482740939017,180,0.07100000000000001
7,test_20231031_123017,10863862.png,317432,24,317408,0.9999243932558785,0,5,66058,1,66057,0.9999848617881256,55.749475555555556,12668.007861333333,7.10372036659619,180,0.07100000000000001
8,test_20231031_123017,11382381.png,312486,24,312462,0.9999231965592058,1,6,46745,1,46744,0.9999786073376832,30.521228444444443,5261.919984,10.919361212177094,180,0.07100000000000001
9,test_20231031_123017,11079715.png,443815,24,443791,0.9999459234140351,1,12,124136,1,124135,0.9999919443191339,73.08021333333333,22147.38112,4.677579816576078,180,0.07100000000000001
10,test_20231031_123017,11551286.png,271883,24,271859,0.9999117267353972,1,6,40092,1,40091,0.9999750573680535,24.866876444444443,3470.407338666667,12.72699907819776,180,0.07100000000000001
1,test_20231031_123018,10404007.png,502730,24,502706,0.9999522606568138,1,6,61265,1,61264,0.9999836774667429,31.611185777777777,5234.651008,10.941926281199287,180,0.081
2,test_20231031_123018,1254659.png,342646,24,342622,0.9999299568651028,1,6,80080,1,80079,0.9999875124875125,72.18819377777778,21636.542586666666,4.77892497016324,180,0.081
3,test_20231031_123018,10188041.png,221231,24,221207,0.999891516107598,1,17,41731,1,41730,0.9999760369988737,32.19604977777778,6734.978176,9.847441680929638,180,0.081
4,test_20231031_123018,10287332.png,216980,24,216956,0.999889390727256,1,6,22337,1,22336,0.9999552312306935,86.39651022222222,25107.6716,4.132739212795741,180,0.081
5,test_20231031_123018,11610969.png,368720,24,368696,0.9999349099587763,1,6,84111,1,84110,0.9999881109486274,49.21503644444444,9843.652661333334,8.199240798850546,180,0.081
6,test_20231031_123018,10350842.png,212614,24,212590,0.9998871193806617,1,5,42529,1,42528,0.9999764866326507,55.22670577777778,11938.01408,7.361482740939017,180,0.081
7,test_20231031_123018,10863862.png,317432,24,317408,0.9999243932558785,1,5,66058,1,66057,0.9999848617881256,55.749475555555556,12668.007861333333,7.10372036659619,180,0.081
8,test_20231031_123018,11382381.png,312486,24,312462,0.9999231965592058,1,6,46745,1,46744,0.9999786073376832,30.521228444444443,5261.919984,10.919361212177094,180,0.081
9,test_20231031_123018,11079715.png,443815,24,443791,0.9999459234140351,1,6,124136,1,124135,0.9999919443191339,73.08021333333333,22147.38112,4.677579816576078,180,0.081
10,test_20231031_123018,11551286.png,271883,24,271859,0.9999117267353972,1,6,40092,1,40091,0.9999750573680535,24.866876444444443,3470.407338666667,12.72699907819776,180,0.081
1,test_20231031_123019,10404007.png,502730,24,502706,0.9999522606568138,1,15,61265,1,61264,0.9999836774667429,31.611185777777777,5234.651008,10.941926281199287,180,0.091
2,test_20231031_123019,1254659.png,342646,24,342622,0.9999299568651028,1,5,80080,1,80079,0.9999875124875125,72.18819377777778,21636.542586666666,4.77892497016324,180,0.091
3,test_20231031_123019,10188041.png,221231,24,221207,0.999891516107598,0,5,41731,1,41730,0.9999760369988737,32.19604977777778,6734.978176,9.847441680929638,180,0.091
4,test_20231031_123019,10287332.png,216980,24,216956,0.999889390727256,1,6,22337,1,22336,0.9999552312306935,86.39651022222222,25107.6716,4.132739212795741,180,0.091
5,test_20231031_123019,11610969.png,368720,24,368696,0.9999349099587763,1,6,84111,1,84110,0.9999881109486274,49.21503644444444,9843.652661333334,8.199240798850546,180,0.091
6,test_20231031_123019,10350842.png,212614,24,212590,0.9998871193806617,1,6,42529,1,42528,0.9999764866326507,55.22670577777778,11938.01408,7.361482740939017,180,0.091
7,test_20231031_123019,10863862.png,317432,24,317408,0.9999243932558785,1,5,66058,1,66057,0.9999848617881256,55.749475555555556,12668.007861333333,7.10372036659619,180,0.091
8,test_20231031_123019,11382381.png,312486,24,312462,0.9999231965592058,1,5,46745,1,46744,0.9999786073376832,30.521228444444443,5261.919984,10.919361212177094,180,0.091
9,test_20231031_123019,11079715.png,443815,24,443791,0.9999459234140351,1,11,124136,1,124135,0.9999919443191339,73.08021333333333,22147.38112,4.677579816576078,180,0.091
10,test_20231031_123019,11551286.png,271883,24,271859,0.9999117267353972,1,6,40092,1,40091,0.9999750573680535,24.866876444444443,3470.407338666667,12.72699907819776,180,0.091
1,test_20231031_123020,10404007.png,502730,24,502706,0.9999522606568138,1,6,61265,1,61264,0.9999836774667429,31.611185777777777,5234.651008,10.941926281199287,190,0.001
2,test_20231031_123020,1254659.png,342646,24,342622,0.9999299568651028,1,8,80080,1,80079,0.9999875124875125,72.18819377777778,21636.542586666666,4.77892497016324,190,0.001
3,test_20231031_123020,10188041.png,221231,1229,220002,0.9944447206765779,3,17,41731,174,41557,0.9958304378040306,18.196908444444446,3191.5978933333336,13.09072191129983,190,0.001
4,test_20231031_123020,10287332.png,216980,24,216956,0.999889390727256,1,6,22337,1,22336,0.9999552312306935,86.39651022222222,25107.6716,4.132739212795741,190,0.001
5,test_20231031_123020,11610969.png,368720,24,368696,0.9999349099587763,1,6,84111,1,84110,0.9999881109486274,49.21503644444444,9843.652661333334,8.199240798850546,190,0.001
6,test_20231031_123020,10350842.png,212614,24,212590,0.9998871193806617,0,5,42529,1,42528,0.9999764866326507,55.22670577777778,11938.01408,7.361482740939017,190,0.001
7,test_20231031_123020,10863862.png,317432,24,317408,0.9999243932558785,1,5,66058,1,66057,0.9999848617881256,55.749475555555556,12668.007861333333,7.10372036659619,190,0.001
8,test_20231031_123020,11382381.png,312486,44,312442,0.9998591936918774,1,5,46745,4,46741,0.9999144293507327,26.483056,4132.547450666667,11.968625119470179,190,0.001
9,test_20231031_123020,11079715.png,443815,4627,439188,0.9895744848641889,3,5,124136,670,123466,0.9946026938196817,53.92015822222222,14578.996837333334,6.493527191218344,190,0.001
10,test_20231031_123020,11551286.png,271883,24,271859,0.9999117267353972,1,6,40092,1,40091,0.9999750573680535,24.866876444444443,3470.407338666667,12.72699907819776,190,0.001
1,test_20231031_123021,10404007.png,502730,24,502706,0.9999522606568138,1,6,61265,1,61264,0.9999836774667429,31.611185777777777,5234.651008,10.941926281199287,190,0.011
2,test_20231031_123021,1254659.png,342646,24,342622,0.9999299568651028,0,5,80080,1,80079,0.9999875124875125,72.18819377777778,21636.542586666666,4.77892497016324,190,0.011
3,test_20231031_123021,10188041.png,221231,144,221087,0.9993490966455877,2,5,41731,19,41712,0.999544702978601,22.45528,4244.582618666666,11.852453695439657,190,0.011
4,test_20231031_123021,10287332.png,216980,24,216956,0.999889390727256,1,6,22337,1,22336,0.9999552312306935,86.39651022222222,25107.6716,4.132739212795741,190,0.011
5,test_20231031_123021,11610969.png,368720,24,368696,0.9999349099587763,1,5,84111,1,84110,0.9999881109486274,49.21503644444444,9843.652661333334,8.199240798850546,190,0.011
6,test_20231031_123021,10350842.png,212614,24,212590,0.9998871193806617,1,5,42529,1,42528,0.9999764866326507,55.22670577777778,11938.01408,7.361482740939017,190,0.011
7,test_20231031_123021,10863862.png,317432,24,317408,0.9999243932558785,1,6,66058,1,66057,0.9999848617881256,55.749475555555556,12668.007861333333,7.10372036659619,190,0.011
8,test_20231031_123021,11382381.png,312486,24,312462,0.9999231965592058,1,9,46745,1,46744,0.9999786073376832,30.521228444444443,5261.919984,10.919361212177094,190,0.011
9,test_20231031_123021,11079715.png,443815,2124,441691,0.9952142221421088,5,10,124136,309,123827,0.9975107946123606,56.453011555555555,15483.618608,6.232078956170792,190,0.011
10,test_20231031_123021,11551286.png,271883,24,271859,0.9999117267353972,1,6,40092,1,40091,0.9999750573680535,24.866876444444443,3470.407338666667,12.72699907819776,190,0.011
1,test_20231031_123022,10404007.png,502730,24,502706,0.9999522606568138,1,6,61265,1,61264,0.9999836774667429,31.611185777777777,5234.651008,10.941926281199287,190,0.020999999999999998
2,test_20231031_123022,1254659.png,342646,24,342622,0.9999299568651028,1,6,80080,1,80079,0.9999875124875125,72.18819377777778,21636.542586666666,4.77892497016324,190,0.020999999999999998
3,test_20231031_123022,10188041.png,221231,144,221087,0.9993490966455877,2,6,41731,19,41712,0.999544702978601,22.45528,4244.582618666666,11.852453695439657,190,0.020999999999999998
4,test_20231031_123022,10287332.png,216980,24,216956,0.999889390727256,1,5,22337,1,22336,0.9999552312306935,86.39651022222222,25107.6716,4.132739212795741,190,0.020999999999999998
5,test_20231031_123022,11610969.png,368720,24,368696,0.9999349099587763,1,7,84111,1,84110,0.9999881109486274,49.21503644444444,9843.652661333334,8.199240798850546,190,0.020999999999999998
6,test_20231031_123022,10350842.png,212614,24,212590,0.9998871193806617,1,6,42529,1,42528,0.9999764866326507,55.22670577777778,11938.01408,7.361482740939017,190,0.020999999999999998
7,test_20231031_123022,10863862.png,317432,24,317408,0.9999243932558785,1,6,66058,1,66057,0.9999848617881256,55.749475555555556,12668.007861333333,7.10372036659619,190,0.020999999999999998
8,test_20231031_123022,11382381.png,312486,24,312462,0.9999231965592058,1,6,46745,1,46744,0.9999786073376832,30.521228444444443,5261.919984,10.919361212177094,190,0.020999999999999998
9,test_20231031_123022,11079715.png,443815,357,443458,0.9991956107837725,3,6,124136,50,124086,0.9995972159566927,58.716192,16233.54496,6.026669927079809,190,0.020999999999999998
10,test_20231031_123022,11551286.png,271883,24,271859,0.9999117267353972,1,6,40092,1,40091,0.9999750573680535,24.866876444444443,3470.407338666667,12.72699907819776,190,0.020999999999999998
1,test_20231031_123023,10404007.png,502730,24,502706,0.9999522606568138,2,5,61265,1,61264,0.9999836774667429,31.611185777777777,5234.651008,10.941926281199287,190,0.031
2,test_20231031_123023,1254659.png,342646,24,342622,0.9999299568651028,1,5,80080,1,80079,0.9999875124875125,72.18819377777778,21636.542586666666,4.77892497016324,190,0.031
3,test_20231031_123023,10188041.png,221231,24,221207,0.999891516107598,1,6,41731,1,41730,0.9999760369988737,32.19604977777778,6734.978176,9.847441680929638,190,0.031
4,test_20231031_123023,10287332.png,216980,24,216956,0.999889390727256,1,6,22337,1,22336,0.9999552312306935,86.39651022222222,25107.6716,4.132739212795741,190,0.031
5,test_20231031_123023,11610969.png,368720,24,368696,0.9999349099587763,1,5,84111,1,84110,0.9999881109486274,49.21503644444444,9843.652661333334,8.199240798850546,190,0.031
6,test_20231031_123023,10350842.png,212614,24,212590,0.9998871193806617,0,5,42529,1,42528,0.9999764866326507,55.22670577777778,11938.01408,7.361482740939017,190,0.031
7,test_20231031_123023,10863862.png,317432,24,317408,0.9999243932558785,1,5,66058,1,66057,0.9999848617881256,55.749475555555556,12668.007861333333,7.10372036659619,190,0.031
8,test_20231031_123023,11382381.png,312486,24,312462,0.9999231965592058,1,5,46745,1,46744,0.9999786073376832,30.521228444444443,5261.919984,10.919361212177094,190,0.031
9,test_20231031_123023,11079715.png,443815,24,443791,0.9999459234140351,1,6,124136,1,124135,0.9999919443191339,73.08021333333333,22147.38112,4.677579816576078,190,0.031
10,test_20231031_123023,11551286.png,271883,24,271859,0.9999117267353972,1,5,40092,1,40091,0.9999750573680535,24.866876444444443,3470.407338666667,12.72699907819776,190,0.031
1,test_20231031_123024,10404007.png,502730,24,502706,0.9999522606568138,1,6,61265,1,61264,0.9999836774667429,31.611185777777777,5234.651008,10.941926281199287,190,0.041
2,test_20231031_123024,1254659.png,342646,24,342622,0.9999299568651028,2,6,80080,1,80079,0.9999875124875125,72.18819377777778,21636.542586666666,4.77892497016324,190,0.041
3,test_20231031_123024,10188041.png,221231,24,221207,0.999891516107598,1,5,41731,1,41730,0.9999760369988737,32.19604977777778,6734.978176,9.847441680929638,190,0.041
4,test_20231031_123024,10287332.png,216980,24,216956,0.999889390727256,1,8,22337,1,22336,0.9999552312306935,86.39651022222222,25107.6716,4.132739212795741,190,0.041
5,test_20231031_123024,11610969.png,368720,24,368696,0.9999349099587763,1,5,84111,1,84110,0.9999881109486274,49.21503644444444,9843.652661333334,8.199240798850546,190,0.041
6,test_20231031_123024,10350842.png,212614,24,212590,0.9998871193806617,1,5,42529,1,42528,0.9999764866326507,55.22670577777778,11938.01408,7.361482740939017,190,0.041
7,test_20231031_123024,10863862.png,317432,24,317408,0.9999243932558785,1,6,66058,1,66057,0.9999848617881256,55.749475555555556,12668.007861333333,7.10372036659619,190,0.041
8,test_20231031_123024,11382381.png,312486,24,312462,0.9999231965592058,1,5,46745,1,46744,0.9999786073376832,30.521228444444443,5261.919984,10.919361212177094,190,0.041
9,test_20231031_123024,11079715.png,443815,24,443791,0.9999459234140351,1,6,124136,1,124135,0.9999919443191339,73.08021333333333,22147.38112,4.677579816576078,190,0.041
10,test_20231031_123024,11551286.png,271883,24,271859,0.9999117267353972,1,6,40092,1,40091,0.9999750573680535,24.866876444444443,3470.407338666667,12.72699907819776,190,0.041
1,test_20231031_123025,10404007.png,502730,24,502706,0.9999522606568138,1,6,61265,1,61264,0.9999836774667429,31.611185777777777,5234.651008,10.941926281199287,190,0.051000000000000004
2,test_20231031_123025,1254659.png,342646,24,342622,0.9999299568651028,0,5,80080,1,80079,0.9999875124875125,72.18819377777778,21636.542586666666,4.77892497016324,190,0.051000000000000004
3,test_20231031_123025,10188041.png,221231,24,221207,0.999891516107598,1,6,41731,1,41730,0.9999760369988737,32.19604977777778,6734.978176,9.847441680929638,190,0.051000000000000004
4,test_20231031_123025,10287332.png,216980,24,216956,0.999889390727256,1,5,22337,1,22336,0.9999552312306935,86.39651022222222,25107.6716,4.132739212795741,190,0.051000000000000004
5,test_20231031_123025,11610969.png,368720,24,368696,0.9999349099587763,1,5,84111,1,84110,0.9999881109486274,49.21503644444444,9843.652661333334,8.199240798850546,190,0.051000000000000004
6,test_20231031_123025,10350842.png,212614,24,212590,0.9998871193806617,1,5,42529,1,42528,0.9999764866326507,55.22670577777778,11938.01408,7.361482740939017,190,0.051000000000000004
7,test_20231031_123025,10863862.png,317432,24,317408,0.9999243932558785,1,6,66058,1,66057,0.9999848617881256,55.749475555555556,12668.007861333333,7.10372036659619,190,0.051000000000000004
8,test_20231031_123025,11382381.png,312486,24,312462,0.9999231965592058,0,5,46745,1,46744,0.9999786073376832,30.521228444444443,5261.919984,10.919361212177094,190,0.051000000000000004
9,test_20231031_123025,11079715.png,443815,24,443791,0.9999459234140351,1,7,124136,1,124135,0.9999919443191339,73.08021333333333,22147.38112,4.677579816576078,190,0.051000000000000004
10,test_20231031_123025,11551286.png,271883,24,271859,0.9999117267353972,0,5,40092,1,40091,0.9999750573680535,24.866876444444443,3470.407338666667,12.72699907819776,190,0.051000000000000004
1,test_20231031_123026,10404007.png,502730,24,502706,0.9999522606568138,1,13,61265,1,61264,0.9999836774667429,31.611185777777777,5234.651008,10.941926281199287,190,0.061000000000000006
2,test_20231031_123026,1254659.png,342646,24,342622,0.9999299568651028,1,5,80080,1,80079,0.9999875124875125,72.18819377777778,21636.542586666666,4.77892497016324,190,0.061000000000000006
3,test_20231031_123026,10188041.png,221231,24,221207,0.999891516107598,0,5,41731,1,41730,0.9999760369988737,32.19604977777778,6734.978176,9.847441680929638,190,0.061000000000000006
4,test_20231031_123026,10287332.png,216980,24,216956,0.999889390727256,1,5,22337,1,22336,0.9999552312306935,86.39651022222222,25107.6716,4.132739212795741,190,0.061000000000000006
5,test_20231031_123026,11610969.png,368720,24,368696,0.9999349099587763,1,6,84111,1,84110,0.9999881109486274,49.21503644444444,9843.652661333334,8.199240798850546,190,0.061000000000000006
6,test_20231031_123026,10350842.png,212614,24,212590,0.9998871193806617,1,7,42529,1,42528,0.9999764866326507,55.22670577777778,11938.01408,7.361482740939017,190,0.061000000000000006
7,test_20231031_123026,10863862.png,317432,24,317408,0.9999243932558785,1,6,66058,1,66057,0.9999848617881256,55.749475555555556,12668.007861333333,7.10372036659619,190,0.061000000000000006
8,test_20231031_123026,11382381.png,312486,24,312462,0.9999231965592058,1,6,46745,1,46744,0.9999786073376832,30.521228444444443,5261.919984,10.919361212177094,190,0.061000000000000006
9,test_20231031_123026,11079715.png,443815,24,443791,0.9999459234140351,1,6,124136,1,124135,0.9999919443191339,73.08021333333333,22147.38112,4.677579816576078,190,0.061000000000000006
10,test_20231031_123026,11551286.png,271883,24,271859,0.9999117267353972,1,6,40092,1,40091,0.9999750573680535,24.866876444444443,3470.407338666667,12.72699907819776,190,0.061000000000000006
1,test_20231031_123027,10404007.png,502730,24,502706,0.9999522606568138,1,5,61265,1,61264,0.9999836774667429,31.611185777777777,5234.651008,10.941926281199287,190,0.07100000000000001
2,test_20231031_123027,1254659.png,342646,24,342622,0.9999299568651028,3,6,80080,1,80079,0.9999875124875125,72.18819377777778,21636.542586666666,4.77892497016324,190,0.07100000000000001
3,test_20231031_123027,10188041.png,221231,24,221207,0.999891516107598,1,6,41731,1,41730,0.9999760369988737,32.19604977777778,6734.978176,9.847441680929638,190,0.07100000000000001
4,test_20231031_123027,10287332.png,216980,24,216956,0.999889390727256,1,7,22337,1,22336,0.9999552312306935,86.39651022222222,25107.6716,4.132739212795741,190,0.07100000000000001
5,test_20231031_123027,11610969.png,368720,24,368696,0.9999349099587763,2,9,84111,1,84110,0.9999881109486274,49.21503644444444,9843.652661333334,8.199240798850546,190,0.07100000000000001
6,test_20231031_123027,10350842.png,212614,24,212590,0.9998871193806617,2,9,42529,1,42528,0.9999764866326507,55.22670577777778,11938.01408,7.361482740939017,190,0.07100000000000001
7,test_20231031_123027,10863862.png,317432,24,317408,0.9999243932558785,1,6,66058,1,66057,0.9999848617881256,55.749475555555556,12668.007861333333,7.10372036659619,190,0.07100000000000001
8,test_20231031_123027,11382381.png,312486,24,312462,0.9999231965592058,1,5,46745,1,46744,0.9999786073376832,30.521228444444443,5261.919984,10.919361212177094,190,0.07100000000000001
9,test_20231031_123027,11079715.png,443815,24,443791,0.9999459234140351,0,6,124136,1,124135,0.9999919443191339,73.08021333333333,22147.38112,4.677579816576078,190,0.07100000000000001
10,test_20231031_123027,11551286.png,271883,24,271859,0.9999117267353972,1,5,40092,1,40091,0.9999750573680535,24.866876444444443,3470.407338666667,12.72699907819776,190,0.07100000000000001
1,test_20231031_123028,10404007.png,502730,24,502706,0.9999522606568138,1,6,61265,1,61264,0.9999836774667429,31.611185777777777,5234.651008,10.941926281199287,190,0.081
2,test_20231031_123028,1254659.png,342646,24,342622,0.9999299568651028,0,5,80080,1,80079,0.9999875124875125,72.18819377777778,21636.542586666666,4.77892497016324,190,0.081
3,test_20231031_123028,10188041.png,221231,24,221207,0.999891516107598,1,5,41731,1,41730,0.9999760369988737,32.19604977777778,6734.978176,9.847441680929638,190,0.081
4,test_20231031_123028,10287332.png,216980,24,216956,0.999889390727256,1,6,22337,1,22336,0.9999552312306935,86.39651022222222,25107.6716,4.132739212795741,190,0.081
5,test_20231031_123028,11610969.png,368720,24,368696,0.9999349099587763,0,13,84111,1,84110,0.9999881109486274,49.21503644444444,9843.652661333334,8.199240798850546,190,0.081
6,test_20231031_123028,10350842.png,212614,24,212590,0.9998871193806617,1,6,42529,1,42528,0.9999764866326507,55.22670577777778,11938.01408,7.361482740939017,190,0.081
7,test_20231031_123028,10863862.png,317432,24,317408,0.9999243932558785,1,5,66058,1,66057,0.9999848617881256,55.749475555555556,12668.007861333333,7.10372036659619,190,0.081
8,test_20231031_123028,11382381.png,312486,24,312462,0.9999231965592058,1,6,46745,1,46744,0.9999786073376832,30.521228444444443,5261.919984,10.919361212177094,190,0.081
9,test_20231031_123028,11079715.png,443815,24,443791,0.9999459234140351,1,6,124136,1,124135,0.9999919443191339,73.08021333333333,22147.38112,4.677579816576078,190,0.081
10,test_20231031_123028,11551286.png,271883,24,271859,0.9999117267353972,1,5,40092,1,40091,0.9999750573680535,24.866876444444443,3470.407338666667,12.72699907819776,190,0.081
1,test_20231031_123029,10404007.png,502730,24,502706,0.9999522606568138,1,6,61265,1,61264,0.9999836774667429,31.611185777777777,5234.651008,10.941926281199287,190,0.091
2,test_20231031_123029,1254659.png,342646,24,342622,0.9999299568651028,1,6,80080,1,80079,0.9999875124875125,72.18819377777778,21636.542586666666,4.77892497016324,190,0.091
3,test_20231031_123029,10188041.png,221231,24,221207,0.999891516107598,0,5,41731,1,41730,0.9999760369988737,32.19604977777778,6734.978176,9.847441680929638,190,0.091
4,test_20231031_123029,10287332.png,216980,24,216956,0.999889390727256,1,5,22337,1,22336,0.9999552312306935,86.39651022222222,25107.6716,4.132739212795741,190,0.091
5,test_20231031_123029,11610969.png,368720,24,368696,0.9999349099587763,1,6,84111,1,84110,0.9999881109486274,49.21503644444444,9843.652661333334,8.199240798850546,190,0.091
6,test_20231031_123029,10350842.png,212614,24,212590,0.9998871193806617,1,6,42529,1,42528,0.9999764866326507,55.22670577777778,11938.01408,7.361482740939017,190,0.091
7,test_20231031_123029,10863862.png,317432,24,317408,0.9999243932558785,1,6,66058,1,66057,0.9999848617881256,55.749475555555556,12668.007861333333,7.10372036659619,190,0.091
8,test_20231031_123029,11382381.png,312486,24,312462,0.9999231965592058,1,6,46745,1,46744,0.9999786073376832,30.521228444444443,5261.919984,10.919361212177094,190,0.091
9,test_20231031_123029,11079715.png,443815,24,443791,0.9999459234140351,1,6,124136,1,124135,0.9999919443191339,73.08021333333333,22147.38112,4.677579816576078,190,0.091
10,test_20231031_123029,11551286.png,271883,24,271859,0.9999117267353972,1,6,40092,1,40091,0.9999750573680535,24.866876444444443,3470.407338666667,12.72699907819776,190,0.091
1,test_20231031_123030,10404007.png,502730,24,502706,0.9999522606568138,1,5,61265,1,61264,0.9999836774667429,31.611185777777777,5234.651008,10.941926281199287,200,0.001
2,test_20231031_123030,1254659.png,342646,24,342622,0.9999299568651028,0,5,80080,1,80079,0.9999875124875125,72.18819377777778,21636.542586666666,4.77892497016324,200,0.001
3,test_20231031_123030,10188041.png,221231,1049,220182,0.9952583498695933,3,5,41731,148,41583,0.9964534758333133,18.478316444444445,3274.735002666667,12.979041989938418,200,0.001
4,test_20231031_123030,10287332.png,216980,24,216956,0.999889390727256,1,6,22337,1,22336,0.9999552312306935,86.39651022222222,25107.6716,4.132739212795741,200,0.001
5,test_20231031_123030,11610969.png,368720,24,368696,0.9999349099587763,1,5,84111,1,84110,0.9999881109486274,49.21503644444444,9843.652661333334,8.199240798850546,200,0.001
6,test_20231031_123030,10350842.png,212614,24,212590,0.9998871193806617,1,6,42529,1,42528,0.9999764866326507,55.22670577777778,11938.01408,7.361482740939017,200,0.001
7,test_20231031_123030,10863862.png,317432,24,317408,0.9999243932558785,1,5,66058,1,66057,0.9999848617881256,55.749475555555556,12668.007861333333,7.10372036659619,200,0.001
8,test_20231031_123030,11382381.png,312486,24,312462,0.9999231965592058,1,5,46745,1,46744,0.9999786073376832,30.521228444444443,5261.919984,10.919361212177094,200,0.001
9,test_20231031_123030,11079715.png,443815,24,443791,0.9999459234140351,1,6,124136,1,124135,0.9999919443191339,73.08021333333333,22147.38112,4.677579816576078,200,0.001
10,test_20231031_123030,11551286.png,271883,24,271859,0.9999117267353972,0,6,40092,1,40091,0.9999750573680535,24.866876444444443,3470.407338666667,12.72699907819776,200,0.001
1,test_20231031_123031,10404007.png,502730,24,502706,0.9999522606568138,1,5,61265,1,61264,0.9999836774667429,31.611185777777777,5234.651008,10.941926281199287,200,0.011
2,test_20231031_123031,1254659.png,342646,24,342622,0.9999299568651028,1,5,80080,1,80079,0.9999875124875125,72.18819377777778,21636.542586666666,4.77892497016324,200,0.011
3,test_20231031_123031,10188041.png,221231,24,221207,0.999891516107598,1,5,41731,1,41730,0.9999760369988737,32.19604977777778,6734.978176,9.847441680929638,200,0.011
4,test_20231031_123031,10287332.png,216980,24,216956,0.999889390727256,1,6,22337,1,22336,0.9999552312306935,86.39651022222222,25107.6716,4.132739212795741,200,0.011
5,test_20231031_123031,11610969.png,368720,24,368696,0.9999349099587763,1,6,84111,1,84110,0.9999881109486274,49.21503644444444,9843.652661333334,8.199240798850546,200,0.011
6,test_20231031_123031,10350842.png,212614,24,212590,0.9998871193806617,1,5,42529,1,42528,0.9999764866326507,55.22670577777778,11938.01408,7.361482740939017,200,0.011
7,test_20231031_123031,10863862.png,317432,24,317408,0.9999243932558785,1,5,66058,1,66057,0.9999848617881256,55.749475555555556,12668.007861333333,7.10372036659619,200,0.011
8,test_20231031_123031,11382381.png,312486,24,312462,0.9999231965592058,1,5,46745,1,46744,0.9999786073376832,30.521228444444443,5261.919984,10.919361212177094,200,0.011
9,test_20231031_123031,11079715.png,443815,24,443791,0.9999459234140351,0,5,124136,1,124135,0.9999919443191339,73.08021333333333,22147.38112,4.677579816576078,200,0.011
10,test_20231031_123031,11551286.png,271883,24,271859,0.9999117267353972,1,6,40092,1,40091,0.9999750573680535,24.866876444444443,3470.407338666667,12.72699907819776,200,0.011
1,test_20231031_123032,10404007.png,502730,24,502706,0.9999522606568138,1,5,61265,1,61264,0.9999836774667429,31.611185777777777,5234.651008,10.941926281199287,200,0.020999999999999998
2,test_20231031_123032,1254659.png,342646,24,342622,0.9999299568651028,1,6,80080,1,80079,0.9999875124875125,72.18819377777778,21636.542586666666,4.77892497016324,200,0.020999999999999998
3,test_20231031_123032,10188041.png,221231,24,221207,0.999891516107598,1,6,41731,1,41730,0.9999760369988737,32.19604977777778,6734.978176,9.847441680929638,200,0.020999999999999998
4,test_20231031_123032,10287332.png,216980,24,216956,0.999889390727256,1,6,22337,1,22336,0.9999552312306935,86.39651022222222,25107.6716,4.132739212795741,200,0.020999999999999998
5,test_20231031_123032,11610969.png,368720,24,368696,0.9999349099587763,1,5,84111,1,84110,0.9999881109486274,49.21503644444444,9843.652661333334,8.199240798850546,200,0.020999999999999998
6,test_20231031_123032,10350842.png,212614,24,212590,0.9998871193806617,1,5,42529,1,42528,0.9999764866326507,55.22670577777778,11938.01408,7.361482740939017,200,0.020999999999999998
7,test_20231031_123032,10863862.png,317432,24,317408,0.9999243932558785,1,6,66058,1,66057,0.9999848617881256,55.749475555555556,12668.007861333333,7.10372036659619,200,0.020999999999999998
8,test_20231031_123032,11382381.png,312486,24,312462,0.9999231965592058,1,6,46745,1,46744,0.9999786073376832,30.521228444444443,5261.919984,10.919361212177094,200,0.020999999999999998
9,test_20231031_123032,11079715.png,443815,24,443791,0.9999459234140351,1,6,124136,1,124135,0.9999919443191339,73.08021333333333,22147.38112,4.677579816576078,200,0.020999999999999998
10,test_20231031_123032,11551286.png,271883,24,271859,0.9999117267353972,1,9,40092,1,40091,0.9999750573680535,24.866876444444443,3470.407338666667,12.72699907819776,200,0.020999999999999998
1,test_20231031_123033,10404007.png,502730,24,502706,0.9999522606568138,1,6,61265,1,61264,0.9999836774667429,31.611185777777777,5234.651008,10.941926281199287,200,0.031
2,test_20231031_123033,1254659.png,342646,24,342622,0.9999299568651028,1,6,80080,1,80079,0.9999875124875125,72.18819377777778,21636.542586666666,4.77892497016324,200,0.031
3,test_20231031_123033,10188041.png,221231,24,221207,0.999891516107598,1,5,41731,1,41730,0.9999760369988737,32.19604977777778,6734.978176,9.847441680929638,200,0.031
4,test_20231031_123033,10287332.png,216980,24,216956,0.999889390727256,1,6,22337,1,22336,0.9999552312306935,86.39651022222222,25107.6716,4.132739212795741,200,0.031
5,test_20231031_123033,11610969.png,368720,24,368696,0.9999349099587763,1,6,84111,1,84110,0.9999881109486274,49.21503644444444,9843.652661333334,8.199240798850546,200,0.031
6,test_20231031_123033,10350842.png,212614,24,212590,0.9998871193806617,1,6,42529,1,42528,0.9999764866326507,55.22670577777778,11938.01408,7.361482740939017,200,0.031
7,test_20231031_123033,10863862.png,317432,24,317408,0.9999243932558785,1,6,66058,1,66057,0.9999848617881256,55.749475555555556,12668.007861333333,7.10372036659619,200,0.031
8,test_20231031_123033,11382381.png,312486,24,312462,0.9999231965592058,1,5,46745,1,46744,0.9999786073376832,30.521228444444443,5261.919984,10.919361212177094,200,0.031
9,test_20231031_123033,11079715.png,443815,24,443791,0.9999459234140351,1,5,124136,1,124135,0.9999919443191339,73.08021333333333,22147.38112,4.677579816576078,200,0.031
10,test_20231031_123033,11551286.png,271883,24,271859,0.9999117267353972,1,6,40092,1,40091,0.9999750573680535,24.866876444444443,3470.407338666667,12.72699907819776,200,0.031
1,test_20231031_123034,10404007.png,502730,24,502706,0.9999522606568138,0,5,61265,1,61264,0.9999836774667429,31.611185777777777,5234.651008,10.941926281199287,200,0.041
2,test_20231031_123034,1254659.png,342646,24,342622,0.9999299568651028,1,14,80080,1,80079,0.9999875124875125,72.18819377777778,21636.542586666666,4.77892497016324,200,0.041
3,test_20231031_123034,10188041.png,221231,24,221207,0.999891516107598,0,5,41731,1,41730,0.9999760369988737,32.19604977777778,6734.978176,9.847441680929638,200,0.041
4,test_20231031_123034,10287332.png,216980,24,216956,0.999889390727256,1,5,22337,1,22336,0.9999552312306935,86.39651022222222,25107.6716,4.132739212795741,200,0.041
5,test_20231031_123034,11610969.png,368720,24,368696,0.9999349099587763,2,6,84111,1,84110,0.9999881109486274,49.21503644444444,9843.652661333334,8.199240798850546,200,0.041
6,test_20231031_123034,10350842.png,212614,24,212590,0.9998871193806617,1,5,42529,1,42528,0.9999764866326507,55.22670577777778,11938.01408,7.361482740939017,200,0.041
7,test_20231031_123034,10863862.png,317432,24,317408,0.9999243932558785,1,5,66058,1,66057,0.9999848617881256,55.749475555555556,12668.007861333333,7.10372036659619,200,0.041
8,test_20231031_123034,11382381.png,312486,24,312462,0.9999231965592058,1,6,46745,1,46744,0.9999786073376832,30.521228444444443,5261.919984,10.919361212177094,200,0.041
9,test_20231031_123034,11079715.png,443815,24,443791,0.9999459234140351,1,6,124136,1,124135,0.9999919443191339,73.08021333333333,22147.38112,4.677579816576078,200,0.041
10,test_20231031_123034,11551286.png,271883,24,271859,0.9999117267353972,1,14,40092,1,40091,0.9999750573680535,24.866876444444443,3470.407338666667,12.72699907819776,200,0.041
1,test_20231031_123035,10404007.png,502730,24,502706,0.9999522606568138,1,6,61265,1,61264,0.9999836774667429,31.611185777777777,5234.651008,10.941926281199287,200,0.051000000000000004
2,test_20231031_123035,1254659.png,342646,24,342622,0.9999299568651028,1,7,80080,1,80079,0.9999875124875125,72.18819377777778,21636.542586666666,4.77892497016324,200,0.051000000000000004
3,test_20231031_123035,10188041.png,221231,24,221207,0.999891516107598,1,7,41731,1,41730,0.9999760369988737,32.19604977777778,6734.978176,9.847441680929638,200,0.051000000000000004
4,test_20231031_123035,10287332.png,216980,24,216956,0.999889390727256,2,14,22337,1,22336,0.9999552312306935,86.39651022222222,25107.6716,4.132739212795741,200,0.051000000000000004
5,test_20231031_123035,11610969.png,368720,24,368696,0.9999349099587763,3,13,84111,1,84110,0.9999881109486274,49.21503644444444,9843.652661333334,8.199240798850546,200,0.051000000000000004
6,test_20231031_123035,10350842.png,212614,24,212590,0.9998871193806617,1,6,42529,1,42528,0.9999764866326507,55.22670577777778,11938.01408,7.361482740939017,200,0.051000000000000004
7,test_20231031_123035,10863862.png,317432,24,317408,0.9999243932558785,2,6,66058,1,66057,0.9999848617881256,55.749475555555556,12668.007861333333,7.10372036659619,200,0.051000000000000004
8,test_20231031_123035,11382381.png,312486,24,312462,0.9999231965592058,2,6,46745,1,46744,0.9999786073376832,30.521228444444443,5261.919984,10.919361212177094,200,0.051000000000000004
9,test_20231031_123035,11079715.png,443815,24,443791,0.9999459234140351,1,6,124136,1,124135,0.9999919443191339,73.08021333333333,22147.38112,4.677579816576078,200,0.051000000000000004
10,test_20231031_123035,11551286.png,271883,24,271859,0.9999117267353972,1,6,40092,1,40091,0.9999750573680535,24.866876444444443,3470.407338666667,12.72699907819776,200,0.051000000000000004
1,test_20231031_123037,10404007.png,502730,24,502706,0.9999522606568138,1,6,61265,1,61264,0.9999836774667429,31.611185777777777,5234.651008,10.941926281199287,200,0.061000000000000006
2,test_20231031_123037,1254659.png,342646,24,342622,0.9999299568651028,1,7,80080,1,80079,0.9999875124875125,72.18819377777778,21636.542586666666,4.77892497016324,200,0.061000000000000006
3,test_20231031_123037,10188041.png,221231,24,221207,0.999891516107598,1,8,41731,1,41730,0.9999760369988737,32.19604977777778,6734.978176,9.847441680929638,200,0.061000000000000006
4,test_20231031_123037,10287332.png,216980,24,216956,0.999889390727256,1,10,22337,1,22336,0.9999552312306935,86.39651022222222,25107.6716,4.132739212795741,200,0.061000000000000006
5,test_20231031_123037,11610969.png,368720,24,368696,0.9999349099587763,1,10,84111,1,84110,0.9999881109486274,49.21503644444444,9843.652661333334,8.199240798850546,200,0.061000000000000006
6,test_20231031_123037,10350842.png,212614,24,212590,0.9998871193806617,1,8,42529,1,42528,0.9999764866326507,55.22670577777778,11938.01408,7.361482740939017,200,0.061000000000000006
7,test_20231031_123037,10863862.png,317432,24,317408,0.9999243932558785,1,6,66058,1,66057,0.9999848617881256,55.749475555555556,12668.007861333333,7.10372036659619,200,0.061000000000000006
8,test_20231031_123037,11382381.png,312486,24,312462,0.9999231965592058,1,6,46745,1,46744,0.9999786073376832,30.521228444444443,5261.919984,10.919361212177094,200,0.061000000000000006
9,test_20231031_123037,11079715.png,443815,24,443791,0.9999459234140351,1,5,124136,1,124135,0.9999919443191339,73.08021333333333,22147.38112,4.677579816576078,200,0.061000000000000006
10,test_20231031_123037,11551286.png,271883,24,271859,0.9999117267353972,1,5,40092,1,40091,0.9999750573680535,24.866876444444443,3470.407338666667,12.72699907819776,200,0.061000000000000006
1,test_20231031_123038,10404007.png,502730,24,502706,0.9999522606568138,1,7,61265,1,61264,0.9999836774667429,31.611185777777777,5234.651008,10.941926281199287,200,0.07100000000000001
2,test_20231031_123038,1254659.png,342646,24,342622,0.9999299568651028,0,5,80080,1,80079,0.9999875124875125,72.18819377777778,21636.542586666666,4.77892497016324,200,0.07100000000000001
3,test_20231031_123038,10188041.png,221231,24,221207,0.999891516107598,1,5,41731,1,41730,0.9999760369988737,32.19604977777778,6734.978176,9.847441680929638,200,0.07100000000000001
4,test_20231031_123038,10287332.png,216980,24,216956,0.999889390727256,1,6,22337,1,22336,0.9999552312306935,86.39651022222222,25107.6716,4.132739212795741,200,0.07100000000000001
5,test_20231031_123038,11610969.png,368720,24,368696,0.9999349099587763,1,5,84111,1,84110,0.9999881109486274,49.21503644444444,9843.652661333334,8.199240798850546,200,0.07100000000000001
6,test_20231031_123038,10350842.png,212614,24,212590,0.9998871193806617,1,7,42529,1,42528,0.9999764866326507,55.22670577777778,11938.01408,7.361482740939017,200,0.07100000000000001
7,test_20231031_123038,10863862.png,317432,24,317408,0.9999243932558785,2,6,66058,1,66057,0.9999848617881256,55.749475555555556,12668.007861333333,7.10372036659619,200,0.07100000000000001
8,test_20231031_123038,11382381.png,312486,24,312462,0.9999231965592058,2,6,46745,1,46744,0.9999786073376832,30.521228444444443,5261.919984,10.919361212177094,200,0.07100000000000001
9,test_20231031_123038,11079715.png,443815,24,443791,0.9999459234140351,1,6,124136,1,124135,0.9999919443191339,73.08021333333333,22147.38112,4.677579816576078,200,0.07100000000000001
10,test_20231031_123038,11551286.png,271883,24,271859,0.9999117267353972,2,7,40092,1,40091,0.9999750573680535,24.866876444444443,3470.407338666667,12.72699907819776,200,0.07100000000000001
1,test_20231031_123039,10404007.png,502730,24,502706,0.9999522606568138,1,8,61265,1,61264,0.9999836774667429,31.611185777777777,5234.651008,10.941926281199287,200,0.081
2,test_20231031_123039,1254659.png,342646,24,342622,0.9999299568651028,1,8,80080,1,80079,0.9999875124875125,72.18819377777778,21636.542586666666,4.77892497016324,200,0.081
3,test_20231031_123039,10188041.png,221231,24,221207,0.999891516107598,2,7,41731,1,41730,0.9999760369988737,32.19604977777778,6734.978176,9.847441680929638,200,0.081
4,test_20231031_123039,10287332.png,216980,24,216956,0.999889390727256,1,7,22337,1,22336,0.9999552312306935,86.39651022222222,25107.6716,4.132739212795741,200,0.081
5,test_20231031_123039,11610969.png,368720,24,368696,0.9999349099587763,1,6,84111,1,84110,0.9999881109486274,49.21503644444444,9843.652661333334,8.199240798850546,200,0.081
6,test_20231031_123039,10350842.png,212614,24,212590,0.9998871193806617,1,6,42529,1,42528,0.9999764866326507,55.22670577777778,11938.01408,7.361482740939017,200,0.081
7,test_20231031_123039,10863862.png,317432,24,317408,0.9999243932558785,1,6,66058,1,66057,0.9999848617881256,55.749475555555556,12668.007861333333,7.10372036659619,200,0.081
8,test_20231031_123039,11382381.png,312486,24,312462,0.9999231965592058,1,6,46745,1,46744,0.9999786073376832,30.521228444444443,5261.919984,10.919361212177094,200,0.081
9,test_20231031_123039,11079715.png,443815,24,443791,0.9999459234140351,1,6,124136,1,124135,0.9999919443191339,73.08021333333333,22147.38112,4.677579816576078,200,0.081
10,test_20231031_123039,11551286.png,271883,24,271859,0.9999117267353972,2,10,40092,1,40091,0.9999750573680535,24.866876444444443,3470.407338666667,12.72699907819776,200,0.081
1,test_20231031_123040,10404007.png,502730,24,502706,0.9999522606568138,2,10,61265,1,61264,0.9999836774667429,31.611185777777777,5234.651008,10.941926281199287,200,0.091
2,test_20231031_123040,1254659.png,342646,24,342622,0.9999299568651028,1,7,80080,1,80079,0.9999875124875125,72.18819377777778,21636.542586666666,4.77892497016324,200,0.091
3,test_20231031_123040,10188041.png,221231,24,221207,0.999891516107598,1,7,41731,1,41730,0.9999760369988737,32.19604977777778,6734.978176,9.847441680929638,200,0.091
4,test_20231031_123040,10287332.png,216980,24,216956,0.999889390727256,1,6,22337,1,22336,0.9999552312306935,86.39651022222222,25107.6716,4.132739212795741,200,0.091
5,test_20231031_123040,11610969.png,368720,24,368696,0.9999349099587763,1,6,84111,1,84110,0.9999881109486274,49.21503644444444,9843.652661333334,8.199240798850546,200,0.091
6,test_20231031_123040,10350842.png,212614,24,212590,0.9998871193806617,1,6,42529,1,42528,0.9999764866326507,55.22670577777778,11938.01408,7.361482740939017,200,0.091
7,test_20231031_123040,10863862.png,317432,24,317408,0.9999243932558785,1,6,66058,1,66057,0.9999848617881256,55.749475555555556,12668.007861333333,7.10372036659619,200,0.091
8,test_20231031_123040,11382381.png,312486,24,312462,0.9999231965592058,1,6,46745,1,46744,0.9999786073376832,30.521228444444443,5261.919984,10.919361212177094,200,0.091
9,test_20231031_123040,11079715.png,443815,24,443791,0.9999459234140351,1,6,124136,1,124135,0.9999919443191339,73.08021333333333,22147.38112,4.677579816576078,200,0.091
10,test_20231031_123040,11551286.png,271883,24,271859,0.9999117267353972,1,13,40092,1,40091,0.9999750573680535,24.866876444444443,3470.407338666667,12.72699907819776,200,0.091
