SN,TestID,FileName,OriginalFileSize,CompressedBinSize,FileSizeDifference,CompressionRate,CompressionTime,DecompressionTime,UniquePixelCountBefore,UniquePixelCountAfter,UniquePixelCountReduction,UniquePixelCountReductionRate,MAE,MSE,PSNR,QuadtreeThreshold,AllowedExceedingThresholdFactor
1,test_20231031_154932,10404007.png,502730,27377,475353,0.9455433333996379,29,17,61265,3948,57317,0.9355586387007263,24.98091911111111,3241.6444,13.02314988723095,120,1.0E-5
2,test_20231031_154932,1254659.png,342646,84372,258274,0.7537633592687497,44,9,80080,11681,68399,0.8541333666333666,19.952688,2913.615216,13.48648164361196,120,1.0E-5
3,test_20231031_154932,10188041.png,221231,11047,210184,0.9500657683597687,11,8,41731,1550,40181,0.9628573482542954,10.226010666666667,952.9778293333334,18.33997563807963,120,1.0E-5
4,test_20231031_154932,10287332.png,216980,13912,203068,0.935883491566043,3,6,22337,1894,20443,0.9152079509334289,9.119530666666666,704.3960426666666,19.65263453454638,120,1.0E-5
5,test_20231031_154932,11610969.png,368720,31817,336903,0.9137095899327403,5,7,84111,4634,79477,0.9449061359394134,18.97863288888889,2421.380016,14.290174070724388,120,1.0E-5
6,test_20231031_154932,10350842.png,212614,7712,204902,0.9637276943192828,3,8,42529,1131,41398,0.9734063815278986,16.956055111111112,1855.6201013333334,15.445912924238282,120,1.0E-5
7,test_20231031_154932,10863862.png,317432,15377,302055,0.9515581289851055,4,7,66058,2195,63863,0.9667716249356626,23.047130666666668,3065.621008,13.26561897338453,120,1.0E-5
8,test_20231031_154932,11382381.png,312486,1432,311054,0.9954173946992825,3,6,46745,194,46551,0.9958498235105359,18.314965333333333,1924.6423786666667,15.28730316581977,120,1.0E-5
9,test_20231031_154932,11079715.png,443815,132247,311568,0.702022238995978,6,8,124136,18385,105751,0.8518963072758909,16.302611555555554,1952.235056,15.225482537985677,120,1.0E-5
10,test_20231031_154932,11551286.png,271883,1602,270281,0.9941077595877639,4,6,40092,236,39856,0.9941135388606206,15.576856888888889,1453.958336,16.50528399121057,120,1.0E-5
1,test_20231031_154934,10404007.png,502730,27377,475353,0.9455433333996379,4,6,61265,3948,57317,0.9355586387007263,24.98091911111111,3241.6444,13.02314988723095,120,2.0E-5
2,test_20231031_154934,1254659.png,342646,84372,258274,0.7537633592687497,5,7,80080,11681,68399,0.8541333666333666,19.952688,2913.615216,13.48648164361196,120,2.0E-5
3,test_20231031_154934,10188041.png,221231,11047,210184,0.9500657683597687,4,6,41731,1550,40181,0.9628573482542954,10.226010666666667,952.9778293333334,18.33997563807963,120,2.0E-5
4,test_20231031_154934,10287332.png,216980,13912,203068,0.935883491566043,3,7,22337,1894,20443,0.9152079509334289,9.119530666666666,704.3960426666666,19.65263453454638,120,2.0E-5
5,test_20231031_154934,11610969.png,368720,31817,336903,0.9137095899327403,5,8,84111,4634,79477,0.9449061359394134,18.97863288888889,2421.380016,14.290174070724388,120,2.0E-5
6,test_20231031_154934,10350842.png,212614,7712,204902,0.9637276943192828,3,8,42529,1131,41398,0.9734063815278986,16.956055111111112,1855.6201013333334,15.445912924238282,120,2.0E-5
7,test_20231031_154934,10863862.png,317432,15377,302055,0.9515581289851055,5,7,66058,2195,63863,0.9667716249356626,23.047130666666668,3065.621008,13.26561897338453,120,2.0E-5
8,test_20231031_154934,11382381.png,312486,1432,311054,0.9954173946992825,3,6,46745,194,46551,0.9958498235105359,18.314965333333333,1924.6423786666667,15.28730316581977,120,2.0E-5
9,test_20231031_154934,11079715.png,443815,132247,311568,0.702022238995978,6,10,124136,18385,105751,0.8518963072758909,16.302611555555554,1952.235056,15.225482537985677,120,2.0E-5
10,test_20231031_154934,11551286.png,271883,1602,270281,0.9941077595877639,4,8,40092,236,39856,0.9941135388606206,15.576856888888889,1453.958336,16.50528399121057,120,2.0E-5
1,test_20231031_154935,10404007.png,502730,27377,475353,0.9455433333996379,5,8,61265,3948,57317,0.9355586387007263,24.98091911111111,3241.6444,13.02314988723095,120,3.0000000000000004E-5
2,test_20231031_154935,1254659.png,342646,84372,258274,0.7537633592687497,5,7,80080,11681,68399,0.8541333666333666,19.952688,2913.615216,13.48648164361196,120,3.0000000000000004E-5
3,test_20231031_154935,10188041.png,221231,11047,210184,0.9500657683597687,3,6,41731,1550,40181,0.9628573482542954,10.226010666666667,952.9778293333334,18.33997563807963,120,3.0000000000000004E-5
4,test_20231031_154935,10287332.png,216980,13912,203068,0.935883491566043,3,5,22337,1894,20443,0.9152079509334289,9.119530666666666,704.3960426666666,19.65263453454638,120,3.0000000000000004E-5
5,test_20231031_154935,11610969.png,368720,31817,336903,0.9137095899327403,4,6,84111,4634,79477,0.9449061359394134,18.97863288888889,2421.380016,14.290174070724388,120,3.0000000000000004E-5
6,test_20231031_154935,10350842.png,212614,7712,204902,0.9637276943192828,2,5,42529,1131,41398,0.9734063815278986,16.956055111111112,1855.6201013333334,15.445912924238282,120,3.0000000000000004E-5
7,test_20231031_154935,10863862.png,317432,15377,302055,0.9515581289851055,3,6,66058,2195,63863,0.9667716249356626,23.047130666666668,3065.621008,13.26561897338453,120,3.0000000000000004E-5
8,test_20231031_154935,11382381.png,312486,1432,311054,0.9954173946992825,3,5,46745,194,46551,0.9958498235105359,18.314965333333333,1924.6423786666667,15.28730316581977,120,3.0000000000000004E-5
9,test_20231031_154935,11079715.png,443815,132247,311568,0.702022238995978,5,6,124136,18385,105751,0.8518963072758909,16.302611555555554,1952.235056,15.225482537985677,120,3.0000000000000004E-5
10,test_20231031_154935,11551286.png,271883,1602,270281,0.9941077595877639,3,6,40092,236,39856,0.9941135388606206,15.576856888888889,1453.958336,16.50528399121057,120,3.0000000000000004E-5
1,test_20231031_154937,10404007.png,502730,27377,475353,0.9455433333996379,4,6,61265,3948,57317,0.9355586387007263,24.98091911111111,3241.6444,13.02314988723095,120,4.0E-5
2,test_20231031_154937,1254659.png,342646,84372,258274,0.7537633592687497,5,6,80080,11681,68399,0.8541333666333666,19.952688,2913.615216,13.48648164361196,120,4.0E-5
3,test_20231031_154937,10188041.png,221231,11047,210184,0.9500657683597687,3,6,41731,1550,40181,0.9628573482542954,10.226010666666667,952.9778293333334,18.33997563807963,120,4.0E-5
4,test_20231031_154937,10287332.png,216980,13912,203068,0.935883491566043,3,5,22337,1894,20443,0.9152079509334289,9.119530666666666,704.3960426666666,19.65263453454638,120,4.0E-5
5,test_20231031_154937,11610969.png,368720,31817,336903,0.9137095899327403,4,6,84111,4634,79477,0.9449061359394134,18.97863288888889,2421.380016,14.290174070724388,120,4.0E-5
6,test_20231031_154937,10350842.png,212614,7712,204902,0.9637276943192828,3,6,42529,1131,41398,0.9734063815278986,16.956055111111112,1855.6201013333334,15.445912924238282,120,4.0E-5
7,test_20231031_154937,10863862.png,317432,15377,302055,0.9515581289851055,3,6,66058,2195,63863,0.9667716249356626,23.047130666666668,3065.621008,13.26561897338453,120,4.0E-5
8,test_20231031_154937,11382381.png,312486,1432,311054,0.9954173946992825,3,6,46745,194,46551,0.9958498235105359,18.314965333333333,1924.6423786666667,15.28730316581977,120,4.0E-5
9,test_20231031_154937,11079715.png,443815,132247,311568,0.702022238995978,6,7,124136,18385,105751,0.8518963072758909,16.302611555555554,1952.235056,15.225482537985677,120,4.0E-5
10,test_20231031_154937,11551286.png,271883,1602,270281,0.9941077595877639,2,6,40092,236,39856,0.9941135388606206,15.576856888888889,1453.958336,16.50528399121057,120,4.0E-5
1,test_20231031_154938,10404007.png,502730,27377,475353,0.9455433333996379,4,17,61265,3948,57317,0.9355586387007263,24.98091911111111,3241.6444,13.02314988723095,120,5.0E-5
2,test_20231031_154938,1254659.png,342646,84372,258274,0.7537633592687497,5,7,80080,11681,68399,0.8541333666333666,19.952688,2913.615216,13.48648164361196,120,5.0E-5
3,test_20231031_154938,10188041.png,221231,11047,210184,0.9500657683597687,3,6,41731,1550,40181,0.9628573482542954,10.226010666666667,952.9778293333334,18.33997563807963,120,5.0E-5
4,test_20231031_154938,10287332.png,216980,13912,203068,0.935883491566043,3,7,22337,1894,20443,0.9152079509334289,9.119530666666666,704.3960426666666,19.65263453454638,120,5.0E-5
5,test_20231031_154938,11610969.png,368720,31817,336903,0.9137095899327403,4,6,84111,4634,79477,0.9449061359394134,18.97863288888889,2421.380016,14.290174070724388,120,5.0E-5
6,test_20231031_154938,10350842.png,212614,7712,204902,0.9637276943192828,3,6,42529,1131,41398,0.9734063815278986,16.956055111111112,1855.6201013333334,15.445912924238282,120,5.0E-5
7,test_20231031_154938,10863862.png,317432,15377,302055,0.9515581289851055,3,5,66058,2195,63863,0.9667716249356626,23.047130666666668,3065.621008,13.26561897338453,120,5.0E-5
8,test_20231031_154938,11382381.png,312486,1432,311054,0.9954173946992825,3,6,46745,194,46551,0.9958498235105359,18.314965333333333,1924.6423786666667,15.28730316581977,120,5.0E-5
9,test_20231031_154938,11079715.png,443815,132247,311568,0.702022238995978,5,7,124136,18385,105751,0.8518963072758909,16.302611555555554,1952.235056,15.225482537985677,120,5.0E-5
10,test_20231031_154938,11551286.png,271883,1602,270281,0.9941077595877639,3,5,40092,236,39856,0.9941135388606206,15.576856888888889,1453.958336,16.50528399121057,120,5.0E-5
1,test_20231031_154939,10404007.png,502730,27377,475353,0.9455433333996379,3,6,61265,3948,57317,0.9355586387007263,24.98091911111111,3241.6444,13.02314988723095,120,6.0E-5
2,test_20231031_154939,1254659.png,342646,84372,258274,0.7537633592687497,5,7,80080,11681,68399,0.8541333666333666,19.952688,2913.615216,13.48648164361196,120,6.0E-5
3,test_20231031_154939,10188041.png,221231,11047,210184,0.9500657683597687,3,5,41731,1550,40181,0.9628573482542954,10.226010666666667,952.9778293333334,18.33997563807963,120,6.0E-5
4,test_20231031_154939,10287332.png,216980,13912,203068,0.935883491566043,3,5,22337,1894,20443,0.9152079509334289,9.119530666666666,704.3960426666666,19.65263453454638,120,6.0E-5
5,test_20231031_154939,11610969.png,368720,31817,336903,0.9137095899327403,3,6,84111,4634,79477,0.9449061359394134,18.97863288888889,2421.380016,14.290174070724388,120,6.0E-5
6,test_20231031_154939,10350842.png,212614,7712,204902,0.9637276943192828,3,6,42529,1131,41398,0.9734063815278986,16.956055111111112,1855.6201013333334,15.445912924238282,120,6.0E-5
7,test_20231031_154939,10863862.png,317432,15377,302055,0.9515581289851055,3,5,66058,2195,63863,0.9667716249356626,23.047130666666668,3065.621008,13.26561897338453,120,6.0E-5
8,test_20231031_154939,11382381.png,312486,1432,311054,0.9954173946992825,3,6,46745,194,46551,0.9958498235105359,18.314965333333333,1924.6423786666667,15.28730316581977,120,6.0E-5
9,test_20231031_154939,11079715.png,443815,132247,311568,0.702022238995978,6,7,124136,18385,105751,0.8518963072758909,16.302611555555554,1952.235056,15.225482537985677,120,6.0E-5
10,test_20231031_154939,11551286.png,271883,1602,270281,0.9941077595877639,2,5,40092,236,39856,0.9941135388606206,15.576856888888889,1453.958336,16.50528399121057,120,6.0E-5
1,test_20231031_154940,10404007.png,502730,27377,475353,0.9455433333996379,4,12,61265,3948,57317,0.9355586387007263,24.98091911111111,3241.6444,13.02314988723095,120,7.000000000000001E-5
2,test_20231031_154940,1254659.png,342646,84372,258274,0.7537633592687497,5,6,80080,11681,68399,0.8541333666333666,19.952688,2913.615216,13.48648164361196,120,7.000000000000001E-5
3,test_20231031_154940,10188041.png,221231,11047,210184,0.9500657683597687,3,5,41731,1550,40181,0.9628573482542954,10.226010666666667,952.9778293333334,18.33997563807963,120,7.000000000000001E-5
4,test_20231031_154940,10287332.png,216980,13912,203068,0.935883491566043,2,5,22337,1894,20443,0.9152079509334289,9.119530666666666,704.3960426666666,19.65263453454638,120,7.000000000000001E-5
5,test_20231031_154940,11610969.png,368720,31817,336903,0.9137095899327403,3,6,84111,4634,79477,0.9449061359394134,18.97863288888889,2421.380016,14.290174070724388,120,7.000000000000001E-5
6,test_20231031_154940,10350842.png,212614,7712,204902,0.9637276943192828,3,6,42529,1131,41398,0.9734063815278986,16.956055111111112,1855.6201013333334,15.445912924238282,120,7.000000000000001E-5
7,test_20231031_154940,10863862.png,317432,15377,302055,0.9515581289851055,4,6,66058,2195,63863,0.9667716249356626,23.047130666666668,3065.621008,13.26561897338453,120,7.000000000000001E-5
8,test_20231031_154940,11382381.png,312486,1362,311124,0.9956414047349321,3,6,46745,184,46561,0.9960637501337042,19.183123555555557,2043.048048,15.028017804636116,120,7.000000000000001E-5
9,test_20231031_154940,11079715.png,443815,132247,311568,0.702022238995978,6,7,124136,18385,105751,0.8518963072758909,16.302611555555554,1952.235056,15.225482537985677,120,7.000000000000001E-5
10,test_20231031_154940,11551286.png,271883,1462,270421,0.9946226869646134,2,5,40092,215,39877,0.9946373341314976,15.664478222222222,1460.3968373333332,16.48609477106633,120,7.000000000000001E-5
1,test_20231031_154941,10404007.png,502730,27377,475353,0.9455433333996379,4,6,61265,3948,57317,0.9355586387007263,24.98091911111111,3241.6444,13.02314988723095,120,8.0E-5
2,test_20231031_154941,1254659.png,342646,84372,258274,0.7537633592687497,5,7,80080,11681,68399,0.8541333666333666,19.952688,2913.615216,13.48648164361196,120,8.0E-5
3,test_20231031_154941,10188041.png,221231,11047,210184,0.9500657683597687,3,6,41731,1550,40181,0.9628573482542954,10.226010666666667,952.9778293333334,18.33997563807963,120,8.0E-5
4,test_20231031_154941,10287332.png,216980,13912,203068,0.935883491566043,3,6,22337,1894,20443,0.9152079509334289,9.119530666666666,704.3960426666666,19.65263453454638,120,8.0E-5
5,test_20231031_154941,11610969.png,368720,31817,336903,0.9137095899327403,10,6,84111,4634,79477,0.9449061359394134,18.97863288888889,2421.380016,14.290174070724388,120,8.0E-5
6,test_20231031_154941,10350842.png,212614,7712,204902,0.9637276943192828,3,6,42529,1131,41398,0.9734063815278986,16.956055111111112,1855.6201013333334,15.445912924238282,120,8.0E-5
7,test_20231031_154941,10863862.png,317432,15377,302055,0.9515581289851055,3,6,66058,2195,63863,0.9667716249356626,23.047130666666668,3065.621008,13.26561897338453,120,8.0E-5
8,test_20231031_154941,11382381.png,312486,1362,311124,0.9956414047349321,2,5,46745,184,46561,0.9960637501337042,19.183123555555557,2043.048048,15.028017804636116,120,8.0E-5
9,test_20231031_154941,11079715.png,443815,132247,311568,0.702022238995978,5,7,124136,18385,105751,0.8518963072758909,16.302611555555554,1952.235056,15.225482537985677,120,8.0E-5
10,test_20231031_154941,11551286.png,271883,1462,270421,0.9946226869646134,3,6,40092,215,39877,0.9946373341314976,15.664478222222222,1460.3968373333332,16.48609477106633,120,8.0E-5
1,test_20231031_154942,10404007.png,502730,27377,475353,0.9455433333996379,4,6,61265,3948,57317,0.9355586387007263,24.98091911111111,3241.6444,13.02314988723095,120,9.0E-5
2,test_20231031_154942,1254659.png,342646,84372,258274,0.7537633592687497,5,6,80080,11681,68399,0.8541333666333666,19.952688,2913.615216,13.48648164361196,120,9.0E-5
3,test_20231031_154942,10188041.png,221231,11047,210184,0.9500657683597687,4,6,41731,1550,40181,0.9628573482542954,10.226010666666667,952.9778293333334,18.33997563807963,120,9.0E-5
4,test_20231031_154942,10287332.png,216980,13912,203068,0.935883491566043,3,6,22337,1894,20443,0.9152079509334289,9.119530666666666,704.3960426666666,19.65263453454638,120,9.0E-5
5,test_20231031_154942,11610969.png,368720,31817,336903,0.9137095899327403,4,5,84111,4634,79477,0.9449061359394134,18.97863288888889,2421.380016,14.290174070724388,120,9.0E-5
6,test_20231031_154942,10350842.png,212614,7712,204902,0.9637276943192828,3,6,42529,1131,41398,0.9734063815278986,16.956055111111112,1855.6201013333334,15.445912924238282,120,9.0E-5
7,test_20231031_154942,10863862.png,317432,15377,302055,0.9515581289851055,3,6,66058,2195,63863,0.9667716249356626,23.047130666666668,3065.621008,13.26561897338453,120,9.0E-5
8,test_20231031_154942,11382381.png,312486,1362,311124,0.9956414047349321,2,5,46745,184,46561,0.9960637501337042,19.183123555555557,2043.048048,15.028017804636116,120,9.0E-5
9,test_20231031_154942,11079715.png,443815,132247,311568,0.702022238995978,5,6,124136,18385,105751,0.8518963072758909,16.302611555555554,1952.235056,15.225482537985677,120,9.0E-5
10,test_20231031_154942,11551286.png,271883,1462,270421,0.9946226869646134,2,6,40092,215,39877,0.9946373341314976,15.664478222222222,1460.3968373333332,16.48609477106633,120,9.0E-5
1,test_20231031_154943,10404007.png,502730,27377,475353,0.9455433333996379,4,6,61265,3948,57317,0.9355586387007263,24.98091911111111,3241.6444,13.02314988723095,120,1.0E-4
2,test_20231031_154943,1254659.png,342646,84372,258274,0.7537633592687497,5,6,80080,11681,68399,0.8541333666333666,19.952688,2913.615216,13.48648164361196,120,1.0E-4
3,test_20231031_154943,10188041.png,221231,11047,210184,0.9500657683597687,3,6,41731,1550,40181,0.9628573482542954,10.226010666666667,952.9778293333334,18.33997563807963,120,1.0E-4
4,test_20231031_154943,10287332.png,216980,13912,203068,0.935883491566043,3,6,22337,1894,20443,0.9152079509334289,9.119530666666666,704.3960426666666,19.65263453454638,120,1.0E-4
5,test_20231031_154943,11610969.png,368720,31817,336903,0.9137095899327403,4,6,84111,4634,79477,0.9449061359394134,18.97863288888889,2421.380016,14.290174070724388,120,1.0E-4
6,test_20231031_154943,10350842.png,212614,7712,204902,0.9637276943192828,3,6,42529,1131,41398,0.9734063815278986,16.956055111111112,1855.6201013333334,15.445912924238282,120,1.0E-4
7,test_20231031_154943,10863862.png,317432,15377,302055,0.9515581289851055,3,6,66058,2195,63863,0.9667716249356626,23.047130666666668,3065.621008,13.26561897338453,120,1.0E-4
8,test_20231031_154943,11382381.png,312486,1362,311124,0.9956414047349321,3,6,46745,184,46561,0.9960637501337042,19.183123555555557,2043.048048,15.028017804636116,120,1.0E-4
9,test_20231031_154943,11079715.png,443815,132247,311568,0.702022238995978,6,7,124136,18385,105751,0.8518963072758909,16.302611555555554,1952.235056,15.225482537985677,120,1.0E-4
10,test_20231031_154943,11551286.png,271883,1462,270421,0.9946226869646134,2,5,40092,215,39877,0.9946373341314976,15.664478222222222,1460.3968373333332,16.48609477106633,120,1.0E-4
1,test_20231031_154944,10404007.png,502730,27377,475353,0.9455433333996379,3,6,61265,3948,57317,0.9355586387007263,24.98091911111111,3241.6444,13.02314988723095,120,1.1E-4
2,test_20231031_154944,1254659.png,342646,84372,258274,0.7537633592687497,5,6,80080,11681,68399,0.8541333666333666,19.952688,2913.615216,13.48648164361196,120,1.1E-4
3,test_20231031_154944,10188041.png,221231,11047,210184,0.9500657683597687,3,5,41731,1550,40181,0.9628573482542954,10.226010666666667,952.9778293333334,18.33997563807963,120,1.1E-4
4,test_20231031_154944,10287332.png,216980,13912,203068,0.935883491566043,3,6,22337,1894,20443,0.9152079509334289,9.119530666666666,704.3960426666666,19.65263453454638,120,1.1E-4
5,test_20231031_154944,11610969.png,368720,31817,336903,0.9137095899327403,3,6,84111,4634,79477,0.9449061359394134,18.97863288888889,2421.380016,14.290174070724388,120,1.1E-4
6,test_20231031_154944,10350842.png,212614,7712,204902,0.9637276943192828,2,6,42529,1131,41398,0.9734063815278986,16.956055111111112,1855.6201013333334,15.445912924238282,120,1.1E-4
7,test_20231031_154944,10863862.png,317432,15377,302055,0.9515581289851055,3,6,66058,2195,63863,0.9667716249356626,23.047130666666668,3065.621008,13.26561897338453,120,1.1E-4
8,test_20231031_154944,11382381.png,312486,1362,311124,0.9956414047349321,3,5,46745,184,46561,0.9960637501337042,19.183123555555557,2043.048048,15.028017804636116,120,1.1E-4
9,test_20231031_154944,11079715.png,443815,132247,311568,0.702022238995978,6,7,124136,18385,105751,0.8518963072758909,16.302611555555554,1952.235056,15.225482537985677,120,1.1E-4
10,test_20231031_154944,11551286.png,271883,1462,270421,0.9946226869646134,3,6,40092,215,39877,0.9946373341314976,15.664478222222222,1460.3968373333332,16.48609477106633,120,1.1E-4
1,test_20231031_154945,10404007.png,502730,27377,475353,0.9455433333996379,4,6,61265,3948,57317,0.9355586387007263,24.98091911111111,3241.6444,13.02314988723095,120,1.2E-4
2,test_20231031_154945,1254659.png,342646,84372,258274,0.7537633592687497,4,6,80080,11681,68399,0.8541333666333666,19.952688,2913.615216,13.48648164361196,120,1.2E-4
3,test_20231031_154945,10188041.png,221231,11047,210184,0.9500657683597687,3,6,41731,1550,40181,0.9628573482542954,10.226010666666667,952.9778293333334,18.33997563807963,120,1.2E-4
4,test_20231031_154945,10287332.png,216980,13912,203068,0.935883491566043,3,6,22337,1894,20443,0.9152079509334289,9.119530666666666,704.3960426666666,19.65263453454638,120,1.2E-4
5,test_20231031_154945,11610969.png,368720,31817,336903,0.9137095899327403,4,6,84111,4634,79477,0.9449061359394134,18.97863288888889,2421.380016,14.290174070724388,120,1.2E-4
6,test_20231031_154945,10350842.png,212614,7712,204902,0.9637276943192828,3,6,42529,1131,41398,0.9734063815278986,16.956055111111112,1855.6201013333334,15.445912924238282,120,1.2E-4
7,test_20231031_154945,10863862.png,317432,15377,302055,0.9515581289851055,3,5,66058,2195,63863,0.9667716249356626,23.047130666666668,3065.621008,13.26561897338453,120,1.2E-4
8,test_20231031_154945,11382381.png,312486,1362,311124,0.9956414047349321,2,6,46745,184,46561,0.9960637501337042,19.183123555555557,2043.048048,15.028017804636116,120,1.2E-4
9,test_20231031_154945,11079715.png,443815,132247,311568,0.702022238995978,5,7,124136,18385,105751,0.8518963072758909,16.302611555555554,1952.235056,15.225482537985677,120,1.2E-4
10,test_20231031_154945,11551286.png,271883,1462,270421,0.9946226869646134,2,5,40092,215,39877,0.9946373341314976,15.664478222222222,1460.3968373333332,16.48609477106633,120,1.2E-4
1,test_20231031_154946,10404007.png,502730,27377,475353,0.9455433333996379,4,6,61265,3948,57317,0.9355586387007263,24.98091911111111,3241.6444,13.02314988723095,120,1.3000000000000002E-4
2,test_20231031_154946,1254659.png,342646,84372,258274,0.7537633592687497,5,6,80080,11681,68399,0.8541333666333666,19.952688,2913.615216,13.48648164361196,120,1.3000000000000002E-4
3,test_20231031_154946,10188041.png,221231,11047,210184,0.9500657683597687,3,6,41731,1550,40181,0.9628573482542954,10.226010666666667,952.9778293333334,18.33997563807963,120,1.3000000000000002E-4
4,test_20231031_154946,10287332.png,216980,13912,203068,0.935883491566043,3,5,22337,1894,20443,0.9152079509334289,9.119530666666666,704.3960426666666,19.65263453454638,120,1.3000000000000002E-4
5,test_20231031_154946,11610969.png,368720,31817,336903,0.9137095899327403,4,6,84111,4634,79477,0.9449061359394134,18.97863288888889,2421.380016,14.290174070724388,120,1.3000000000000002E-4
6,test_20231031_154946,10350842.png,212614,7712,204902,0.9637276943192828,3,6,42529,1131,41398,0.9734063815278986,16.956055111111112,1855.6201013333334,15.445912924238282,120,1.3000000000000002E-4
7,test_20231031_154946,10863862.png,317432,15377,302055,0.9515581289851055,4,6,66058,2195,63863,0.9667716249356626,23.047130666666668,3065.621008,13.26561897338453,120,1.3000000000000002E-4
8,test_20231031_154946,11382381.png,312486,1259,311227,0.9959710195016737,2,5,46745,169,46576,0.9963846400684565,20.086165333333334,2234.270282666667,14.639446517255376,120,1.3000000000000002E-4
9,test_20231031_154946,11079715.png,443815,132247,311568,0.702022238995978,6,7,124136,18385,105751,0.8518963072758909,16.302611555555554,1952.235056,15.225482537985677,120,1.3000000000000002E-4
10,test_20231031_154946,11551286.png,271883,1462,270421,0.9946226869646134,2,5,40092,215,39877,0.9946373341314976,15.664478222222222,1460.3968373333332,16.48609477106633,120,1.3000000000000002E-4
1,test_20231031_154947,10404007.png,502730,27377,475353,0.9455433333996379,3,5,61265,3948,57317,0.9355586387007263,24.98091911111111,3241.6444,13.02314988723095,120,1.4000000000000001E-4
2,test_20231031_154947,1254659.png,342646,84372,258274,0.7537633592687497,5,6,80080,11681,68399,0.8541333666333666,19.952688,2913.615216,13.48648164361196,120,1.4000000000000001E-4
3,test_20231031_154947,10188041.png,221231,11047,210184,0.9500657683597687,3,14,41731,1550,40181,0.9628573482542954,10.226010666666667,952.9778293333334,18.33997563807963,120,1.4000000000000001E-4
4,test_20231031_154947,10287332.png,216980,13912,203068,0.935883491566043,3,6,22337,1894,20443,0.9152079509334289,9.119530666666666,704.3960426666666,19.65263453454638,120,1.4000000000000001E-4
5,test_20231031_154947,11610969.png,368720,31817,336903,0.9137095899327403,3,6,84111,4634,79477,0.9449061359394134,18.97863288888889,2421.380016,14.290174070724388,120,1.4000000000000001E-4
6,test_20231031_154947,10350842.png,212614,7712,204902,0.9637276943192828,2,5,42529,1131,41398,0.9734063815278986,16.956055111111112,1855.6201013333334,15.445912924238282,120,1.4000000000000001E-4
7,test_20231031_154947,10863862.png,317432,15377,302055,0.9515581289851055,3,6,66058,2195,63863,0.9667716249356626,23.047130666666668,3065.621008,13.26561897338453,120,1.4000000000000001E-4
8,test_20231031_154947,11382381.png,312486,1259,311227,0.9959710195016737,3,6,46745,169,46576,0.9963846400684565,20.086165333333334,2234.270282666667,14.639446517255376,120,1.4000000000000001E-4
9,test_20231031_154947,11079715.png,443815,132247,311568,0.702022238995978,5,6,124136,18385,105751,0.8518963072758909,16.302611555555554,1952.235056,15.225482537985677,120,1.4000000000000001E-4
10,test_20231031_154947,11551286.png,271883,1462,270421,0.9946226869646134,2,6,40092,215,39877,0.9946373341314976,15.664478222222222,1460.3968373333332,16.48609477106633,120,1.4000000000000001E-4
1,test_20231031_154948,10404007.png,502730,27377,475353,0.9455433333996379,4,6,61265,3948,57317,0.9355586387007263,24.98091911111111,3241.6444,13.02314988723095,120,1.5000000000000001E-4
2,test_20231031_154948,1254659.png,342646,84372,258274,0.7537633592687497,7,11,80080,11681,68399,0.8541333666333666,19.952688,2913.615216,13.48648164361196,120,1.5000000000000001E-4
3,test_20231031_154948,10188041.png,221231,11047,210184,0.9500657683597687,8,13,41731,1550,40181,0.9628573482542954,10.226010666666667,952.9778293333334,18.33997563807963,120,1.5000000000000001E-4
4,test_20231031_154948,10287332.png,216980,13912,203068,0.935883491566043,3,7,22337,1894,20443,0.9152079509334289,9.119530666666666,704.3960426666666,19.65263453454638,120,1.5000000000000001E-4
5,test_20231031_154948,11610969.png,368720,31817,336903,0.9137095899327403,4,6,84111,4634,79477,0.9449061359394134,18.97863288888889,2421.380016,14.290174070724388,120,1.5000000000000001E-4
6,test_20231031_154948,10350842.png,212614,7712,204902,0.9637276943192828,2,5,42529,1131,41398,0.9734063815278986,16.956055111111112,1855.6201013333334,15.445912924238282,120,1.5000000000000001E-4
7,test_20231031_154948,10863862.png,317432,15377,302055,0.9515581289851055,3,6,66058,2195,63863,0.9667716249356626,23.047130666666668,3065.621008,13.26561897338453,120,1.5000000000000001E-4
8,test_20231031_154948,11382381.png,312486,1259,311227,0.9959710195016737,3,6,46745,169,46576,0.9963846400684565,20.086165333333334,2234.270282666667,14.639446517255376,120,1.5000000000000001E-4
9,test_20231031_154948,11079715.png,443815,132247,311568,0.702022238995978,5,6,124136,18385,105751,0.8518963072758909,16.302611555555554,1952.235056,15.225482537985677,120,1.5000000000000001E-4
10,test_20231031_154948,11551286.png,271883,1462,270421,0.9946226869646134,3,6,40092,215,39877,0.9946373341314976,15.664478222222222,1460.3968373333332,16.48609477106633,120,1.5000000000000001E-4
1,test_20231031_154949,10404007.png,502730,27377,475353,0.9455433333996379,4,6,61265,3948,57317,0.9355586387007263,24.98091911111111,3241.6444,13.02314988723095,120,1.6E-4
2,test_20231031_154949,1254659.png,342646,84372,258274,0.7537633592687497,5,7,80080,11681,68399,0.8541333666333666,19.952688,2913.615216,13.48648164361196,120,1.6E-4
3,test_20231031_154949,10188041.png,221231,11047,210184,0.9500657683597687,3,5,41731,1550,40181,0.9628573482542954,10.226010666666667,952.9778293333334,18.33997563807963,120,1.6E-4
4,test_20231031_154949,10287332.png,216980,13662,203318,0.93703567149046,3,6,22337,1864,20473,0.9165510140126247,9.250581333333333,731.4470933333333,19.488974424426054,120,1.6E-4
5,test_20231031_154949,11610969.png,368720,31817,336903,0.9137095899327403,4,6,84111,4634,79477,0.9449061359394134,18.97863288888889,2421.380016,14.290174070724388,120,1.6E-4
6,test_20231031_154949,10350842.png,212614,7712,204902,0.9637276943192828,3,6,42529,1131,41398,0.9734063815278986,16.956055111111112,1855.6201013333334,15.445912924238282,120,1.6E-4
7,test_20231031_154949,10863862.png,317432,15377,302055,0.9515581289851055,3,6,66058,2195,63863,0.9667716249356626,23.047130666666668,3065.621008,13.26561897338453,120,1.6E-4
8,test_20231031_154949,11382381.png,312486,1259,311227,0.9959710195016737,2,5,46745,169,46576,0.9963846400684565,20.086165333333334,2234.270282666667,14.639446517255376,120,1.6E-4
9,test_20231031_154949,11079715.png,443815,132247,311568,0.702022238995978,6,7,124136,18385,105751,0.8518963072758909,16.302611555555554,1952.235056,15.225482537985677,120,1.6E-4
10,test_20231031_154949,11551286.png,271883,1462,270421,0.9946226869646134,2,5,40092,215,39877,0.9946373341314976,15.664478222222222,1460.3968373333332,16.48609477106633,120,1.6E-4
1,test_20231031_154950,10404007.png,502730,27377,475353,0.9455433333996379,4,5,61265,3948,57317,0.9355586387007263,24.98091911111111,3241.6444,13.02314988723095,120,1.7E-4
2,test_20231031_154950,1254659.png,342646,84372,258274,0.7537633592687497,5,7,80080,11681,68399,0.8541333666333666,19.952688,2913.615216,13.48648164361196,120,1.7E-4
3,test_20231031_154950,10188041.png,221231,11047,210184,0.9500657683597687,3,6,41731,1550,40181,0.9628573482542954,10.226010666666667,952.9778293333334,18.33997563807963,120,1.7E-4
4,test_20231031_154950,10287332.png,216980,13662,203318,0.93703567149046,3,5,22337,1864,20473,0.9165510140126247,9.250581333333333,731.4470933333333,19.488974424426054,120,1.7E-4
5,test_20231031_154950,11610969.png,368720,31817,336903,0.9137095899327403,3,6,84111,4634,79477,0.9449061359394134,18.97863288888889,2421.380016,14.290174070724388,120,1.7E-4
6,test_20231031_154950,10350842.png,212614,7712,204902,0.9637276943192828,3,6,42529,1131,41398,0.9734063815278986,16.956055111111112,1855.6201013333334,15.445912924238282,120,1.7E-4
7,test_20231031_154950,10863862.png,317432,15377,302055,0.9515581289851055,3,6,66058,2195,63863,0.9667716249356626,23.047130666666668,3065.621008,13.26561897338453,120,1.7E-4
8,test_20231031_154950,11382381.png,312486,1259,311227,0.9959710195016737,3,6,46745,169,46576,0.9963846400684565,20.086165333333334,2234.270282666667,14.639446517255376,120,1.7E-4
9,test_20231031_154950,11079715.png,443815,132247,311568,0.702022238995978,6,7,124136,18385,105751,0.8518963072758909,16.302611555555554,1952.235056,15.225482537985677,120,1.7E-4
10,test_20231031_154950,11551286.png,271883,1462,270421,0.9946226869646134,2,5,40092,215,39877,0.9946373341314976,15.664478222222222,1460.3968373333332,16.48609477106633,120,1.7E-4
1,test_20231031_154951,10404007.png,502730,27377,475353,0.9455433333996379,4,6,61265,3948,57317,0.9355586387007263,24.98091911111111,3241.6444,13.02314988723095,120,1.8E-4
2,test_20231031_154951,1254659.png,342646,84372,258274,0.7537633592687497,5,6,80080,11681,68399,0.8541333666333666,19.952688,2913.615216,13.48648164361196,120,1.8E-4
3,test_20231031_154951,10188041.png,221231,11047,210184,0.9500657683597687,3,6,41731,1550,40181,0.9628573482542954,10.226010666666667,952.9778293333334,18.33997563807963,120,1.8E-4
4,test_20231031_154951,10287332.png,216980,13662,203318,0.93703567149046,2,6,22337,1864,20473,0.9165510140126247,9.250581333333333,731.4470933333333,19.488974424426054,120,1.8E-4
5,test_20231031_154951,11610969.png,368720,31817,336903,0.9137095899327403,4,6,84111,4634,79477,0.9449061359394134,18.97863288888889,2421.380016,14.290174070724388,120,1.8E-4
6,test_20231031_154951,10350842.png,212614,7712,204902,0.9637276943192828,2,6,42529,1131,41398,0.9734063815278986,16.956055111111112,1855.6201013333334,15.445912924238282,120,1.8E-4
7,test_20231031_154951,10863862.png,317432,15377,302055,0.9515581289851055,3,5,66058,2195,63863,0.9667716249356626,23.047130666666668,3065.621008,13.26561897338453,120,1.8E-4
8,test_20231031_154951,11382381.png,312486,1259,311227,0.9959710195016737,3,6,46745,169,46576,0.9963846400684565,20.086165333333334,2234.270282666667,14.639446517255376,120,1.8E-4
9,test_20231031_154951,11079715.png,443815,132247,311568,0.702022238995978,5,7,124136,18385,105751,0.8518963072758909,16.302611555555554,1952.235056,15.225482537985677,120,1.8E-4
10,test_20231031_154951,11551286.png,271883,1462,270421,0.9946226869646134,2,5,40092,215,39877,0.9946373341314976,15.664478222222222,1460.3968373333332,16.48609477106633,120,1.8E-4
1,test_20231031_154953,10404007.png,502730,27377,475353,0.9455433333996379,3,6,61265,3948,57317,0.9355586387007263,24.98091911111111,3241.6444,13.02314988723095,120,1.9E-4
2,test_20231031_154953,1254659.png,342646,84372,258274,0.7537633592687497,4,6,80080,11681,68399,0.8541333666333666,19.952688,2913.615216,13.48648164361196,120,1.9E-4
3,test_20231031_154953,10188041.png,221231,11047,210184,0.9500657683597687,4,6,41731,1550,40181,0.9628573482542954,10.226010666666667,952.9778293333334,18.33997563807963,120,1.9E-4
4,test_20231031_154953,10287332.png,216980,13662,203318,0.93703567149046,3,6,22337,1864,20473,0.9165510140126247,9.250581333333333,731.4470933333333,19.488974424426054,120,1.9E-4
5,test_20231031_154953,11610969.png,368720,31817,336903,0.9137095899327403,3,6,84111,4634,79477,0.9449061359394134,18.97863288888889,2421.380016,14.290174070724388,120,1.9E-4
6,test_20231031_154953,10350842.png,212614,7712,204902,0.9637276943192828,2,5,42529,1131,41398,0.9734063815278986,16.956055111111112,1855.6201013333334,15.445912924238282,120,1.9E-4
7,test_20231031_154953,10863862.png,317432,15377,302055,0.9515581289851055,3,5,66058,2195,63863,0.9667716249356626,23.047130666666668,3065.621008,13.26561897338453,120,1.9E-4
8,test_20231031_154953,11382381.png,312486,1259,311227,0.9959710195016737,2,6,46745,169,46576,0.9963846400684565,20.086165333333334,2234.270282666667,14.639446517255376,120,1.9E-4
9,test_20231031_154953,11079715.png,443815,132247,311568,0.702022238995978,6,6,124136,18385,105751,0.8518963072758909,16.302611555555554,1952.235056,15.225482537985677,120,1.9E-4
10,test_20231031_154953,11551286.png,271883,1462,270421,0.9946226869646134,2,14,40092,215,39877,0.9946373341314976,15.664478222222222,1460.3968373333332,16.48609477106633,120,1.9E-4
1,test_20231031_154954,10404007.png,502730,27377,475353,0.9455433333996379,4,6,61265,3948,57317,0.9355586387007263,24.98091911111111,3241.6444,13.02314988723095,120,2.0E-4
2,test_20231031_154954,1254659.png,342646,84372,258274,0.7537633592687497,5,6,80080,11681,68399,0.8541333666333666,19.952688,2913.615216,13.48648164361196,120,2.0E-4
3,test_20231031_154954,10188041.png,221231,11047,210184,0.9500657683597687,3,5,41731,1550,40181,0.9628573482542954,10.226010666666667,952.9778293333334,18.33997563807963,120,2.0E-4
4,test_20231031_154954,10287332.png,216980,13662,203318,0.93703567149046,2,6,22337,1864,20473,0.9165510140126247,9.250581333333333,731.4470933333333,19.488974424426054,120,2.0E-4
5,test_20231031_154954,11610969.png,368720,31817,336903,0.9137095899327403,4,6,84111,4634,79477,0.9449061359394134,18.97863288888889,2421.380016,14.290174070724388,120,2.0E-4
6,test_20231031_154954,10350842.png,212614,7712,204902,0.9637276943192828,2,9,42529,1131,41398,0.9734063815278986,16.956055111111112,1855.6201013333334,15.445912924238282,120,2.0E-4
7,test_20231031_154954,10863862.png,317432,15377,302055,0.9515581289851055,3,6,66058,2195,63863,0.9667716249356626,23.047130666666668,3065.621008,13.26561897338453,120,2.0E-4
8,test_20231031_154954,11382381.png,312486,1259,311227,0.9959710195016737,3,6,46745,169,46576,0.9963846400684565,20.086165333333334,2234.270282666667,14.639446517255376,120,2.0E-4
9,test_20231031_154954,11079715.png,443815,132247,311568,0.702022238995978,5,7,124136,18385,105751,0.8518963072758909,16.302611555555554,1952.235056,15.225482537985677,120,2.0E-4
10,test_20231031_154954,11551286.png,271883,1462,270421,0.9946226869646134,3,6,40092,215,39877,0.9946373341314976,15.664478222222222,1460.3968373333332,16.48609477106633,120,2.0E-4
1,test_20231031_154955,10404007.png,502730,27377,475353,0.9455433333996379,4,6,61265,3948,57317,0.9355586387007263,24.98091911111111,3241.6444,13.02314988723095,120,2.1E-4
2,test_20231031_154955,1254659.png,342646,84372,258274,0.7537633592687497,5,6,80080,11681,68399,0.8541333666333666,19.952688,2913.615216,13.48648164361196,120,2.1E-4
3,test_20231031_154955,10188041.png,221231,11047,210184,0.9500657683597687,3,5,41731,1550,40181,0.9628573482542954,10.226010666666667,952.9778293333334,18.33997563807963,120,2.1E-4
4,test_20231031_154955,10287332.png,216980,13662,203318,0.93703567149046,3,6,22337,1864,20473,0.9165510140126247,9.250581333333333,731.4470933333333,19.488974424426054,120,2.1E-4
5,test_20231031_154955,11610969.png,368720,31817,336903,0.9137095899327403,4,6,84111,4634,79477,0.9449061359394134,18.97863288888889,2421.380016,14.290174070724388,120,2.1E-4
6,test_20231031_154955,10350842.png,212614,7712,204902,0.9637276943192828,2,6,42529,1131,41398,0.9734063815278986,16.956055111111112,1855.6201013333334,15.445912924238282,120,2.1E-4
7,test_20231031_154955,10863862.png,317432,15377,302055,0.9515581289851055,3,5,66058,2195,63863,0.9667716249356626,23.047130666666668,3065.621008,13.26561897338453,120,2.1E-4
8,test_20231031_154955,11382381.png,312486,1259,311227,0.9959710195016737,2,5,46745,169,46576,0.9963846400684565,20.086165333333334,2234.270282666667,14.639446517255376,120,2.1E-4
9,test_20231031_154955,11079715.png,443815,132247,311568,0.702022238995978,5,7,124136,18385,105751,0.8518963072758909,16.302611555555554,1952.235056,15.225482537985677,120,2.1E-4
10,test_20231031_154955,11551286.png,271883,1462,270421,0.9946226869646134,3,6,40092,215,39877,0.9946373341314976,15.664478222222222,1460.3968373333332,16.48609477106633,120,2.1E-4
1,test_20231031_154956,10404007.png,502730,27377,475353,0.9455433333996379,4,6,61265,3948,57317,0.9355586387007263,24.98091911111111,3241.6444,13.02314988723095,120,2.2E-4
2,test_20231031_154956,1254659.png,342646,84372,258274,0.7537633592687497,4,6,80080,11681,68399,0.8541333666333666,19.952688,2913.615216,13.48648164361196,120,2.2E-4
3,test_20231031_154956,10188041.png,221231,11047,210184,0.9500657683597687,4,5,41731,1550,40181,0.9628573482542954,10.226010666666667,952.9778293333334,18.33997563807963,120,2.2E-4
4,test_20231031_154956,10287332.png,216980,13662,203318,0.93703567149046,3,6,22337,1864,20473,0.9165510140126247,9.250581333333333,731.4470933333333,19.488974424426054,120,2.2E-4
5,test_20231031_154956,11610969.png,368720,31817,336903,0.9137095899327403,4,6,84111,4634,79477,0.9449061359394134,18.97863288888889,2421.380016,14.290174070724388,120,2.2E-4
6,test_20231031_154956,10350842.png,212614,7712,204902,0.9637276943192828,2,10,42529,1131,41398,0.9734063815278986,16.956055111111112,1855.6201013333334,15.445912924238282,120,2.2E-4
7,test_20231031_154956,10863862.png,317432,15377,302055,0.9515581289851055,4,7,66058,2195,63863,0.9667716249356626,23.047130666666668,3065.621008,13.26561897338453,120,2.2E-4
8,test_20231031_154956,11382381.png,312486,1259,311227,0.9959710195016737,2,9,46745,169,46576,0.9963846400684565,20.086165333333334,2234.270282666667,14.639446517255376,120,2.2E-4
9,test_20231031_154956,11079715.png,443815,132247,311568,0.702022238995978,5,7,124136,18385,105751,0.8518963072758909,16.302611555555554,1952.235056,15.225482537985677,120,2.2E-4
10,test_20231031_154956,11551286.png,271883,1462,270421,0.9946226869646134,2,12,40092,215,39877,0.9946373341314976,15.664478222222222,1460.3968373333332,16.48609477106633,120,2.2E-4
1,test_20231031_154957,10404007.png,502730,27377,475353,0.9455433333996379,4,6,61265,3948,57317,0.9355586387007263,24.98091911111111,3241.6444,13.02314988723095,120,2.3E-4
2,test_20231031_154957,1254659.png,342646,84372,258274,0.7537633592687497,5,6,80080,11681,68399,0.8541333666333666,19.952688,2913.615216,13.48648164361196,120,2.3E-4
3,test_20231031_154957,10188041.png,221231,11047,210184,0.9500657683597687,4,6,41731,1550,40181,0.9628573482542954,10.226010666666667,952.9778293333334,18.33997563807963,120,2.3E-4
4,test_20231031_154957,10287332.png,216980,13662,203318,0.93703567149046,2,6,22337,1864,20473,0.9165510140126247,9.250581333333333,731.4470933333333,19.488974424426054,120,2.3E-4
5,test_20231031_154957,11610969.png,368720,31817,336903,0.9137095899327403,4,6,84111,4634,79477,0.9449061359394134,18.97863288888889,2421.380016,14.290174070724388,120,2.3E-4
6,test_20231031_154957,10350842.png,212614,7712,204902,0.9637276943192828,2,5,42529,1131,41398,0.9734063815278986,16.956055111111112,1855.6201013333334,15.445912924238282,120,2.3E-4
7,test_20231031_154957,10863862.png,317432,15377,302055,0.9515581289851055,3,5,66058,2195,63863,0.9667716249356626,23.047130666666668,3065.621008,13.26561897338453,120,2.3E-4
8,test_20231031_154957,11382381.png,312486,1259,311227,0.9959710195016737,3,5,46745,169,46576,0.9963846400684565,20.086165333333334,2234.270282666667,14.639446517255376,120,2.3E-4
9,test_20231031_154957,11079715.png,443815,132247,311568,0.702022238995978,6,7,124136,18385,105751,0.8518963072758909,16.302611555555554,1952.235056,15.225482537985677,120,2.3E-4
10,test_20231031_154957,11551286.png,271883,1462,270421,0.9946226869646134,2,5,40092,215,39877,0.9946373341314976,15.664478222222222,1460.3968373333332,16.48609477106633,120,2.3E-4
1,test_20231031_154958,10404007.png,502730,27377,475353,0.9455433333996379,4,6,61265,3948,57317,0.9355586387007263,24.98091911111111,3241.6444,13.02314988723095,120,2.4E-4
2,test_20231031_154958,1254659.png,342646,84372,258274,0.7537633592687497,5,7,80080,11681,68399,0.8541333666333666,19.952688,2913.615216,13.48648164361196,120,2.4E-4
3,test_20231031_154958,10188041.png,221231,11047,210184,0.9500657683597687,3,6,41731,1550,40181,0.9628573482542954,10.226010666666667,952.9778293333334,18.33997563807963,120,2.4E-4
4,test_20231031_154958,10287332.png,216980,13662,203318,0.93703567149046,3,6,22337,1864,20473,0.9165510140126247,9.250581333333333,731.4470933333333,19.488974424426054,120,2.4E-4
5,test_20231031_154958,11610969.png,368720,31817,336903,0.9137095899327403,4,7,84111,4634,79477,0.9449061359394134,18.97863288888889,2421.380016,14.290174070724388,120,2.4E-4
6,test_20231031_154958,10350842.png,212614,7712,204902,0.9637276943192828,3,6,42529,1131,41398,0.9734063815278986,16.956055111111112,1855.6201013333334,15.445912924238282,120,2.4E-4
7,test_20231031_154958,10863862.png,317432,15377,302055,0.9515581289851055,4,5,66058,2195,63863,0.9667716249356626,23.047130666666668,3065.621008,13.26561897338453,120,2.4E-4
8,test_20231031_154958,11382381.png,312486,1259,311227,0.9959710195016737,2,6,46745,169,46576,0.9963846400684565,20.086165333333334,2234.270282666667,14.639446517255376,120,2.4E-4
9,test_20231031_154958,11079715.png,443815,132247,311568,0.702022238995978,6,7,124136,18385,105751,0.8518963072758909,16.302611555555554,1952.235056,15.225482537985677,120,2.4E-4
10,test_20231031_154958,11551286.png,271883,1462,270421,0.9946226869646134,3,6,40092,215,39877,0.9946373341314976,15.664478222222222,1460.3968373333332,16.48609477106633,120,2.4E-4
1,test_20231031_154959,10404007.png,502730,27377,475353,0.9455433333996379,4,6,61265,3948,57317,0.9355586387007263,24.98091911111111,3241.6444,13.02314988723095,120,2.5E-4
2,test_20231031_154959,1254659.png,342646,84372,258274,0.7537633592687497,4,6,80080,11681,68399,0.8541333666333666,19.952688,2913.615216,13.48648164361196,120,2.5E-4
3,test_20231031_154959,10188041.png,221231,11047,210184,0.9500657683597687,3,5,41731,1550,40181,0.9628573482542954,10.226010666666667,952.9778293333334,18.33997563807963,120,2.5E-4
4,test_20231031_154959,10287332.png,216980,13662,203318,0.93703567149046,2,6,22337,1864,20473,0.9165510140126247,9.250581333333333,731.4470933333333,19.488974424426054,120,2.5E-4
5,test_20231031_154959,11610969.png,368720,31817,336903,0.9137095899327403,4,6,84111,4634,79477,0.9449061359394134,18.97863288888889,2421.380016,14.290174070724388,120,2.5E-4
6,test_20231031_154959,10350842.png,212614,7712,204902,0.9637276943192828,2,5,42529,1131,41398,0.9734063815278986,16.956055111111112,1855.6201013333334,15.445912924238282,120,2.5E-4
7,test_20231031_154959,10863862.png,317432,15377,302055,0.9515581289851055,3,5,66058,2195,63863,0.9667716249356626,23.047130666666668,3065.621008,13.26561897338453,120,2.5E-4
8,test_20231031_154959,11382381.png,312486,1259,311227,0.9959710195016737,2,6,46745,169,46576,0.9963846400684565,20.086165333333334,2234.270282666667,14.639446517255376,120,2.5E-4
9,test_20231031_154959,11079715.png,443815,132247,311568,0.702022238995978,5,7,124136,18385,105751,0.8518963072758909,16.302611555555554,1952.235056,15.225482537985677,120,2.5E-4
10,test_20231031_154959,11551286.png,271883,1462,270421,0.9946226869646134,2,5,40092,215,39877,0.9946373341314976,15.664478222222222,1460.3968373333332,16.48609477106633,120,2.5E-4
1,test_20231031_155000,10404007.png,502730,27237,475493,0.9458218129015575,4,6,61265,3928,57337,0.9358850893658696,24.993056,3243.490410666667,13.020677425852345,120,2.6000000000000003E-4
2,test_20231031_155000,1254659.png,342646,84312,258334,0.7539384671059928,4,6,80080,11676,68404,0.8541958041958042,19.962241777777777,2914.6974026666667,13.484868869095994,120,2.6000000000000003E-4
3,test_20231031_155000,10188041.png,221231,10967,210264,0.9504273813344423,4,6,41731,1538,40193,0.9631449042678105,10.379212444444445,973.5932853333334,18.247027908726242,120,2.6000000000000003E-4
4,test_20231031_155000,10287332.png,216980,13642,203338,0.9371278458844133,3,6,22337,1861,20476,0.9166853203205444,9.321923555555555,744.2019093333333,19.413895809498406,120,2.6000000000000003E-4
5,test_20231031_155000,11610969.png,368720,31657,337063,0.9141435235408982,5,7,84111,4612,79499,0.9451676950696104,19.394017777777776,2513.8691893333335,14.127376856996587,120,2.6000000000000003E-4
6,test_20231031_155000,10350842.png,212614,7572,205042,0.9643861645987565,3,6,42529,1110,41419,0.9739001622422347,17.484805333333334,1967.9161866666666,15.190737629327984,120,2.6000000000000003E-4
7,test_20231031_155000,10863862.png,317432,15277,302155,0.951873157085612,4,6,66058,2180,63878,0.9669986981137788,23.077662222222223,3070.805008,13.258281206665272,120,2.6000000000000003E-4
8,test_20231031_155000,11382381.png,312486,1219,311267,0.9960990252363305,10,16,46745,163,46582,0.9965129960423574,20.394026666666665,2297.468352,14.518308232456395,120,2.6000000000000003E-4
9,test_20231031_155000,11079715.png,443815,132247,311568,0.702022238995978,8,9,124136,18385,105751,0.8518963072758909,16.302611555555554,1952.235056,15.225482537985677,120,2.6000000000000003E-4
10,test_20231031_155000,11551286.png,271883,1302,270581,0.9952111753952987,3,5,40092,191,39901,0.9952359572982141,16.06636622222222,1535.6389493333334,16.267912420109646,120,2.6000000000000003E-4
1,test_20231031_155001,10404007.png,502730,27237,475493,0.9458218129015575,6,6,61265,3928,57337,0.9358850893658696,24.993056,3243.490410666667,13.020677425852345,120,2.7000000000000006E-4
2,test_20231031_155001,1254659.png,342646,84312,258334,0.7539384671059928,6,7,80080,11676,68404,0.8541958041958042,19.962241777777777,2914.6974026666667,13.484868869095994,120,2.7000000000000006E-4
3,test_20231031_155001,10188041.png,221231,10967,210264,0.9504273813344423,4,6,41731,1538,40193,0.9631449042678105,10.379212444444445,973.5932853333334,18.247027908726242,120,2.7000000000000006E-4
4,test_20231031_155001,10287332.png,216980,13642,203338,0.9371278458844133,3,7,22337,1861,20476,0.9166853203205444,9.321923555555555,744.2019093333333,19.413895809498406,120,2.7000000000000006E-4
5,test_20231031_155001,11610969.png,368720,31657,337063,0.9141435235408982,6,8,84111,4612,79499,0.9451676950696104,19.394017777777776,2513.8691893333335,14.127376856996587,120,2.7000000000000006E-4
6,test_20231031_155001,10350842.png,212614,7572,205042,0.9643861645987565,3,8,42529,1110,41419,0.9739001622422347,17.484805333333334,1967.9161866666666,15.190737629327984,120,2.7000000000000006E-4
7,test_20231031_155001,10863862.png,317432,15277,302155,0.951873157085612,4,9,66058,2180,63878,0.9669986981137788,23.077662222222223,3070.805008,13.258281206665272,120,2.7000000000000006E-4
8,test_20231031_155001,11382381.png,312486,1219,311267,0.9960990252363305,4,10,46745,163,46582,0.9965129960423574,20.394026666666665,2297.468352,14.518308232456395,120,2.7000000000000006E-4
9,test_20231031_155001,11079715.png,443815,132247,311568,0.702022238995978,7,9,124136,18385,105751,0.8518963072758909,16.302611555555554,1952.235056,15.225482537985677,120,2.7000000000000006E-4
10,test_20231031_155001,11551286.png,271883,1302,270581,0.9952111753952987,3,6,40092,191,39901,0.9952359572982141,16.06636622222222,1535.6389493333334,16.267912420109646,120,2.7000000000000006E-4
1,test_20231031_155003,10404007.png,502730,27237,475493,0.9458218129015575,4,6,61265,3928,57337,0.9358850893658696,24.993056,3243.490410666667,13.020677425852345,120,2.800000000000001E-4
2,test_20231031_155003,1254659.png,342646,84312,258334,0.7539384671059928,6,7,80080,11676,68404,0.8541958041958042,19.962241777777777,2914.6974026666667,13.484868869095994,120,2.800000000000001E-4
3,test_20231031_155003,10188041.png,221231,10967,210264,0.9504273813344423,3,7,41731,1538,40193,0.9631449042678105,10.379212444444445,973.5932853333334,18.247027908726242,120,2.800000000000001E-4
4,test_20231031_155003,10287332.png,216980,13642,203338,0.9371278458844133,4,8,22337,1861,20476,0.9166853203205444,9.321923555555555,744.2019093333333,19.413895809498406,120,2.800000000000001E-4
5,test_20231031_155003,11610969.png,368720,31657,337063,0.9141435235408982,5,9,84111,4612,79499,0.9451676950696104,19.394017777777776,2513.8691893333335,14.127376856996587,120,2.800000000000001E-4
6,test_20231031_155003,10350842.png,212614,7572,205042,0.9643861645987565,4,9,42529,1110,41419,0.9739001622422347,17.484805333333334,1967.9161866666666,15.190737629327984,120,2.800000000000001E-4
7,test_20231031_155003,10863862.png,317432,15277,302155,0.951873157085612,5,9,66058,2180,63878,0.9669986981137788,23.077662222222223,3070.805008,13.258281206665272,120,2.800000000000001E-4
8,test_20231031_155003,11382381.png,312486,1219,311267,0.9960990252363305,3,7,46745,163,46582,0.9965129960423574,20.394026666666665,2297.468352,14.518308232456395,120,2.800000000000001E-4
9,test_20231031_155003,11079715.png,443815,132247,311568,0.702022238995978,6,8,124136,18385,105751,0.8518963072758909,16.302611555555554,1952.235056,15.225482537985677,120,2.800000000000001E-4
10,test_20231031_155003,11551286.png,271883,1302,270581,0.9952111753952987,3,6,40092,191,39901,0.9952359572982141,16.06636622222222,1535.6389493333334,16.267912420109646,120,2.800000000000001E-4
1,test_20231031_155004,10404007.png,502730,27237,475493,0.9458218129015575,4,6,61265,3928,57337,0.9358850893658696,24.993056,3243.490410666667,13.020677425852345,120,2.900000000000001E-4
2,test_20231031_155004,1254659.png,342646,84312,258334,0.7539384671059928,4,6,80080,11676,68404,0.8541958041958042,19.962241777777777,2914.6974026666667,13.484868869095994,120,2.900000000000001E-4
3,test_20231031_155004,10188041.png,221231,10967,210264,0.9504273813344423,4,6,41731,1538,40193,0.9631449042678105,10.379212444444445,973.5932853333334,18.247027908726242,120,2.900000000000001E-4
4,test_20231031_155004,10287332.png,216980,13642,203338,0.9371278458844133,3,6,22337,1861,20476,0.9166853203205444,9.321923555555555,744.2019093333333,19.413895809498406,120,2.900000000000001E-4
5,test_20231031_155004,11610969.png,368720,31657,337063,0.9141435235408982,6,7,84111,4612,79499,0.9451676950696104,19.394017777777776,2513.8691893333335,14.127376856996587,120,2.900000000000001E-4
6,test_20231031_155004,10350842.png,212614,7572,205042,0.9643861645987565,3,6,42529,1110,41419,0.9739001622422347,17.484805333333334,1967.9161866666666,15.190737629327984,120,2.900000000000001E-4
7,test_20231031_155004,10863862.png,317432,15277,302155,0.951873157085612,5,8,66058,2180,63878,0.9669986981137788,23.077662222222223,3070.805008,13.258281206665272,120,2.900000000000001E-4
8,test_20231031_155004,11382381.png,312486,987,311499,0.9968414584973406,4,9,46745,131,46614,0.9971975612364958,20.862908444444443,2370.7645866666667,14.381919295331382,120,2.900000000000001E-4
9,test_20231031_155004,11079715.png,443815,132247,311568,0.702022238995978,7,8,124136,18385,105751,0.8518963072758909,16.302611555555554,1952.235056,15.225482537985677,120,2.900000000000001E-4
10,test_20231031_155004,11551286.png,271883,1302,270581,0.9952111753952987,3,7,40092,191,39901,0.9952359572982141,16.06636622222222,1535.6389493333334,16.267912420109646,120,2.900000000000001E-4
1,test_20231031_155005,10404007.png,502730,26112,476618,0.9480595946134108,3,5,61265,3765,57500,0.9385456622867869,25.063852444444443,3263.948144,12.993371105880328,121,1.0E-5
2,test_20231031_155005,1254659.png,342646,82322,260324,0.7597462103745557,5,7,80080,11414,68666,0.8574675324675325,20.146789333333334,2968.9748,13.404738494515186,121,1.0E-5
3,test_20231031_155005,10188041.png,221231,10747,210484,0.9514218170147944,3,6,41731,1508,40223,0.9638637943015983,10.256744888888889,960.6228746666667,18.30527436879325,121,1.0E-5
4,test_20231031_155005,10287332.png,216980,13682,203298,0.9369434970965066,5,7,22337,1863,20474,0.9165957827819313,9.239728,729.57032,19.500132029302378,121,1.0E-5
5,test_20231031_155005,11610969.png,368720,30472,338248,0.9173573443263181,6,9,84111,4439,79672,0.9472245009570687,19.285690666666667,2490.9437173333336,14.167164460683386,121,1.0E-5
6,test_20231031_155005,10350842.png,212614,7329,205285,0.965529080869557,4,10,42529,1075,41454,0.9747231300994615,16.994460444444446,1865.2112533333334,15.423523338592997,121,1.0E-5
7,test_20231031_155005,10863862.png,317432,14797,302635,0.9533852919680436,4,7,66058,2120,63938,0.9679069908262437,23.245306666666668,3112.5087946666667,13.199697736252237,121,1.0E-5
8,test_20231031_155005,11382381.png,312486,1269,311217,0.9959390180680094,3,6,46745,174,46571,0.9962776767568724,19.43068977777778,2153.2964853333333,14.799765293355192,121,1.0E-5
9,test_20231031_155005,11079715.png,443815,130027,313788,0.7070243231977288,6,8,124136,18094,106042,0.8542405104079397,16.408837333333334,1978.80552,15.166772476828436,121,1.0E-5
10,test_20231031_155005,11551286.png,271883,1502,270381,0.9944755648569421,2,6,40092,221,39871,0.9944876783398184,15.668704,1481.5739733333332,16.423570206721926,121,1.0E-5
1,test_20231031_155006,10404007.png,502730,26112,476618,0.9480595946134108,4,6,61265,3765,57500,0.9385456622867869,25.063852444444443,3263.948144,12.993371105880328,121,2.0E-5
2,test_20231031_155006,1254659.png,342646,82322,260324,0.7597462103745557,4,6,80080,11414,68666,0.8574675324675325,20.146789333333334,2968.9748,13.404738494515186,121,2.0E-5
3,test_20231031_155006,10188041.png,221231,10747,210484,0.9514218170147944,3,16,41731,1508,40223,0.9638637943015983,10.256744888888889,960.6228746666667,18.30527436879325,121,2.0E-5
4,test_20231031_155006,10287332.png,216980,13682,203298,0.9369434970965066,2,6,22337,1863,20474,0.9165957827819313,9.239728,729.57032,19.500132029302378,121,2.0E-5
5,test_20231031_155006,11610969.png,368720,30472,338248,0.9173573443263181,3,6,84111,4439,79672,0.9472245009570687,19.285690666666667,2490.9437173333336,14.167164460683386,121,2.0E-5
6,test_20231031_155006,10350842.png,212614,7329,205285,0.965529080869557,3,6,42529,1075,41454,0.9747231300994615,16.994460444444446,1865.2112533333334,15.423523338592997,121,2.0E-5
7,test_20231031_155006,10863862.png,317432,14797,302635,0.9533852919680436,3,7,66058,2120,63938,0.9679069908262437,23.245306666666668,3112.5087946666667,13.199697736252237,121,2.0E-5
8,test_20231031_155006,11382381.png,312486,1269,311217,0.9959390180680094,3,6,46745,174,46571,0.9962776767568724,19.43068977777778,2153.2964853333333,14.799765293355192,121,2.0E-5
9,test_20231031_155006,11079715.png,443815,130027,313788,0.7070243231977288,8,9,124136,18094,106042,0.8542405104079397,16.408837333333334,1978.80552,15.166772476828436,121,2.0E-5
10,test_20231031_155006,11551286.png,271883,1502,270381,0.9944755648569421,3,9,40092,221,39871,0.9944876783398184,15.668704,1481.5739733333332,16.423570206721926,121,2.0E-5
1,test_20231031_155008,10404007.png,502730,26112,476618,0.9480595946134108,8,14,61265,3765,57500,0.9385456622867869,25.063852444444443,3263.948144,12.993371105880328,121,3.0000000000000004E-5
2,test_20231031_155008,1254659.png,342646,82322,260324,0.7597462103745557,7,9,80080,11414,68666,0.8574675324675325,20.146789333333334,2968.9748,13.404738494515186,121,3.0000000000000004E-5
3,test_20231031_155008,10188041.png,221231,10747,210484,0.9514218170147944,4,6,41731,1508,40223,0.9638637943015983,10.256744888888889,960.6228746666667,18.30527436879325,121,3.0000000000000004E-5
4,test_20231031_155008,10287332.png,216980,13682,203298,0.9369434970965066,3,6,22337,1863,20474,0.9165957827819313,9.239728,729.57032,19.500132029302378,121,3.0000000000000004E-5
5,test_20231031_155008,11610969.png,368720,30472,338248,0.9173573443263181,3,6,84111,4439,79672,0.9472245009570687,19.285690666666667,2490.9437173333336,14.167164460683386,121,3.0000000000000004E-5
6,test_20231031_155008,10350842.png,212614,7329,205285,0.965529080869557,3,6,42529,1075,41454,0.9747231300994615,16.994460444444446,1865.2112533333334,15.423523338592997,121,3.0000000000000004E-5
7,test_20231031_155008,10863862.png,317432,14797,302635,0.9533852919680436,3,5,66058,2120,63938,0.9679069908262437,23.245306666666668,3112.5087946666667,13.199697736252237,121,3.0000000000000004E-5
8,test_20231031_155008,11382381.png,312486,1269,311217,0.9959390180680094,3,6,46745,174,46571,0.9962776767568724,19.43068977777778,2153.2964853333333,14.799765293355192,121,3.0000000000000004E-5
9,test_20231031_155008,11079715.png,443815,130027,313788,0.7070243231977288,7,9,124136,18094,106042,0.8542405104079397,16.408837333333334,1978.80552,15.166772476828436,121,3.0000000000000004E-5
10,test_20231031_155008,11551286.png,271883,1502,270381,0.9944755648569421,7,12,40092,221,39871,0.9944876783398184,15.668704,1481.5739733333332,16.423570206721926,121,3.0000000000000004E-5
1,test_20231031_155009,10404007.png,502730,26112,476618,0.9480595946134108,6,8,61265,3765,57500,0.9385456622867869,25.063852444444443,3263.948144,12.993371105880328,121,4.0E-5
2,test_20231031_155009,1254659.png,342646,82322,260324,0.7597462103745557,5,7,80080,11414,68666,0.8574675324675325,20.146789333333334,2968.9748,13.404738494515186,121,4.0E-5
3,test_20231031_155009,10188041.png,221231,10747,210484,0.9514218170147944,3,5,41731,1508,40223,0.9638637943015983,10.256744888888889,960.6228746666667,18.30527436879325,121,4.0E-5
4,test_20231031_155009,10287332.png,216980,13682,203298,0.9369434970965066,3,6,22337,1863,20474,0.9165957827819313,9.239728,729.57032,19.500132029302378,121,4.0E-5
5,test_20231031_155009,11610969.png,368720,30472,338248,0.9173573443263181,4,6,84111,4439,79672,0.9472245009570687,19.285690666666667,2490.9437173333336,14.167164460683386,121,4.0E-5
6,test_20231031_155009,10350842.png,212614,7329,205285,0.965529080869557,3,6,42529,1075,41454,0.9747231300994615,16.994460444444446,1865.2112533333334,15.423523338592997,121,4.0E-5
7,test_20231031_155009,10863862.png,317432,14797,302635,0.9533852919680436,5,10,66058,2120,63938,0.9679069908262437,23.245306666666668,3112.5087946666667,13.199697736252237,121,4.0E-5
8,test_20231031_155009,11382381.png,312486,1269,311217,0.9959390180680094,5,22,46745,174,46571,0.9962776767568724,19.43068977777778,2153.2964853333333,14.799765293355192,121,4.0E-5
9,test_20231031_155009,11079715.png,443815,130027,313788,0.7070243231977288,9,10,124136,18094,106042,0.8542405104079397,16.408837333333334,1978.80552,15.166772476828436,121,4.0E-5
10,test_20231031_155009,11551286.png,271883,1502,270381,0.9944755648569421,3,6,40092,221,39871,0.9944876783398184,15.668704,1481.5739733333332,16.423570206721926,121,4.0E-5
1,test_20231031_155011,10404007.png,502730,26112,476618,0.9480595946134108,4,6,61265,3765,57500,0.9385456622867869,25.063852444444443,3263.948144,12.993371105880328,121,5.0E-5
2,test_20231031_155011,1254659.png,342646,82322,260324,0.7597462103745557,5,18,80080,11414,68666,0.8574675324675325,20.146789333333334,2968.9748,13.404738494515186,121,5.0E-5
3,test_20231031_155011,10188041.png,221231,10747,210484,0.9514218170147944,4,7,41731,1508,40223,0.9638637943015983,10.256744888888889,960.6228746666667,18.30527436879325,121,5.0E-5
4,test_20231031_155011,10287332.png,216980,13682,203298,0.9369434970965066,4,6,22337,1863,20474,0.9165957827819313,9.239728,729.57032,19.500132029302378,121,5.0E-5
5,test_20231031_155011,11610969.png,368720,30472,338248,0.9173573443263181,4,7,84111,4439,79672,0.9472245009570687,19.285690666666667,2490.9437173333336,14.167164460683386,121,5.0E-5
6,test_20231031_155011,10350842.png,212614,7329,205285,0.965529080869557,4,7,42529,1075,41454,0.9747231300994615,16.994460444444446,1865.2112533333334,15.423523338592997,121,5.0E-5
7,test_20231031_155011,10863862.png,317432,14797,302635,0.9533852919680436,9,17,66058,2120,63938,0.9679069908262437,23.245306666666668,3112.5087946666667,13.199697736252237,121,5.0E-5
8,test_20231031_155011,11382381.png,312486,1269,311217,0.9959390180680094,6,11,46745,174,46571,0.9962776767568724,19.43068977777778,2153.2964853333333,14.799765293355192,121,5.0E-5
9,test_20231031_155011,11079715.png,443815,130027,313788,0.7070243231977288,8,10,124136,18094,106042,0.8542405104079397,16.408837333333334,1978.80552,15.166772476828436,121,5.0E-5
10,test_20231031_155011,11551286.png,271883,1502,270381,0.9944755648569421,2,6,40092,221,39871,0.9944876783398184,15.668704,1481.5739733333332,16.423570206721926,121,5.0E-5
1,test_20231031_155012,10404007.png,502730,26112,476618,0.9480595946134108,5,7,61265,3765,57500,0.9385456622867869,25.063852444444443,3263.948144,12.993371105880328,121,6.0E-5
2,test_20231031_155012,1254659.png,342646,82322,260324,0.7597462103745557,7,9,80080,11414,68666,0.8574675324675325,20.146789333333334,2968.9748,13.404738494515186,121,6.0E-5
3,test_20231031_155012,10188041.png,221231,10747,210484,0.9514218170147944,4,9,41731,1508,40223,0.9638637943015983,10.256744888888889,960.6228746666667,18.30527436879325,121,6.0E-5
4,test_20231031_155012,10287332.png,216980,13682,203298,0.9369434970965066,4,7,22337,1863,20474,0.9165957827819313,9.239728,729.57032,19.500132029302378,121,6.0E-5
5,test_20231031_155012,11610969.png,368720,30472,338248,0.9173573443263181,5,9,84111,4439,79672,0.9472245009570687,19.285690666666667,2490.9437173333336,14.167164460683386,121,6.0E-5
6,test_20231031_155012,10350842.png,212614,7329,205285,0.965529080869557,3,8,42529,1075,41454,0.9747231300994615,16.994460444444446,1865.2112533333334,15.423523338592997,121,6.0E-5
7,test_20231031_155012,10863862.png,317432,14797,302635,0.9533852919680436,5,7,66058,2120,63938,0.9679069908262437,23.245306666666668,3112.5087946666667,13.199697736252237,121,6.0E-5
8,test_20231031_155012,11382381.png,312486,1269,311217,0.9959390180680094,3,6,46745,174,46571,0.9962776767568724,19.43068977777778,2153.2964853333333,14.799765293355192,121,6.0E-5
9,test_20231031_155012,11079715.png,443815,130027,313788,0.7070243231977288,6,7,124136,18094,106042,0.8542405104079397,16.408837333333334,1978.80552,15.166772476828436,121,6.0E-5
10,test_20231031_155012,11551286.png,271883,1502,270381,0.9944755648569421,3,6,40092,221,39871,0.9944876783398184,15.668704,1481.5739733333332,16.423570206721926,121,6.0E-5
1,test_20231031_155014,10404007.png,502730,26112,476618,0.9480595946134108,4,6,61265,3765,57500,0.9385456622867869,25.063852444444443,3263.948144,12.993371105880328,121,7.000000000000001E-5
2,test_20231031_155014,1254659.png,342646,82322,260324,0.7597462103745557,5,7,80080,11414,68666,0.8574675324675325,20.146789333333334,2968.9748,13.404738494515186,121,7.000000000000001E-5
3,test_20231031_155014,10188041.png,221231,10747,210484,0.9514218170147944,3,7,41731,1508,40223,0.9638637943015983,10.256744888888889,960.6228746666667,18.30527436879325,121,7.000000000000001E-5
4,test_20231031_155014,10287332.png,216980,13682,203298,0.9369434970965066,2,6,22337,1863,20474,0.9165957827819313,9.239728,729.57032,19.500132029302378,121,7.000000000000001E-5
5,test_20231031_155014,11610969.png,368720,30472,338248,0.9173573443263181,4,6,84111,4439,79672,0.9472245009570687,19.285690666666667,2490.9437173333336,14.167164460683386,121,7.000000000000001E-5
6,test_20231031_155014,10350842.png,212614,7329,205285,0.965529080869557,3,6,42529,1075,41454,0.9747231300994615,16.994460444444446,1865.2112533333334,15.423523338592997,121,7.000000000000001E-5
7,test_20231031_155014,10863862.png,317432,14797,302635,0.9533852919680436,3,6,66058,2120,63938,0.9679069908262437,23.245306666666668,3112.5087946666667,13.199697736252237,121,7.000000000000001E-5
8,test_20231031_155014,11382381.png,312486,1199,311287,0.9961630281036591,3,6,46745,164,46581,0.9964916033800406,20.298848,2271.7021546666665,14.56728970917017,121,7.000000000000001E-5
9,test_20231031_155014,11079715.png,443815,130027,313788,0.7070243231977288,6,7,124136,18094,106042,0.8542405104079397,16.408837333333334,1978.80552,15.166772476828436,121,7.000000000000001E-5
10,test_20231031_155014,11551286.png,271883,1362,270521,0.9949904922337918,2,6,40092,200,39892,0.9950114736106954,15.756325333333333,1488.0124746666668,16.404737887600753,121,7.000000000000001E-5
1,test_20231031_155015,10404007.png,502730,26112,476618,0.9480595946134108,4,6,61265,3765,57500,0.9385456622867869,25.063852444444443,3263.948144,12.993371105880328,121,8.0E-5
2,test_20231031_155015,1254659.png,342646,82322,260324,0.7597462103745557,5,6,80080,11414,68666,0.8574675324675325,20.146789333333334,2968.9748,13.404738494515186,121,8.0E-5
3,test_20231031_155015,10188041.png,221231,10747,210484,0.9514218170147944,3,6,41731,1508,40223,0.9638637943015983,10.256744888888889,960.6228746666667,18.30527436879325,121,8.0E-5
4,test_20231031_155015,10287332.png,216980,13682,203298,0.9369434970965066,3,6,22337,1863,20474,0.9165957827819313,9.239728,729.57032,19.500132029302378,121,8.0E-5
5,test_20231031_155015,11610969.png,368720,30472,338248,0.9173573443263181,4,6,84111,4439,79672,0.9472245009570687,19.285690666666667,2490.9437173333336,14.167164460683386,121,8.0E-5
6,test_20231031_155015,10350842.png,212614,7329,205285,0.965529080869557,3,6,42529,1075,41454,0.9747231300994615,16.994460444444446,1865.2112533333334,15.423523338592997,121,8.0E-5
7,test_20231031_155015,10863862.png,317432,14797,302635,0.9533852919680436,4,5,66058,2120,63938,0.9679069908262437,23.245306666666668,3112.5087946666667,13.199697736252237,121,8.0E-5
8,test_20231031_155015,11382381.png,312486,1199,311287,0.9961630281036591,2,5,46745,164,46581,0.9964916033800406,20.298848,2271.7021546666665,14.56728970917017,121,8.0E-5
9,test_20231031_155015,11079715.png,443815,130027,313788,0.7070243231977288,6,7,124136,18094,106042,0.8542405104079397,16.408837333333334,1978.80552,15.166772476828436,121,8.0E-5
10,test_20231031_155015,11551286.png,271883,1362,270521,0.9949904922337918,2,5,40092,200,39892,0.9950114736106954,15.756325333333333,1488.0124746666668,16.404737887600753,121,8.0E-5
1,test_20231031_155016,10404007.png,502730,26112,476618,0.9480595946134108,3,5,61265,3765,57500,0.9385456622867869,25.063852444444443,3263.948144,12.993371105880328,121,9.0E-5
2,test_20231031_155016,1254659.png,342646,82322,260324,0.7597462103745557,5,6,80080,11414,68666,0.8574675324675325,20.146789333333334,2968.9748,13.404738494515186,121,9.0E-5
3,test_20231031_155016,10188041.png,221231,10747,210484,0.9514218170147944,3,6,41731,1508,40223,0.9638637943015983,10.256744888888889,960.6228746666667,18.30527436879325,121,9.0E-5
4,test_20231031_155016,10287332.png,216980,13682,203298,0.9369434970965066,2,5,22337,1863,20474,0.9165957827819313,9.239728,729.57032,19.500132029302378,121,9.0E-5
5,test_20231031_155016,11610969.png,368720,30472,338248,0.9173573443263181,4,5,84111,4439,79672,0.9472245009570687,19.285690666666667,2490.9437173333336,14.167164460683386,121,9.0E-5
6,test_20231031_155016,10350842.png,212614,7329,205285,0.965529080869557,3,6,42529,1075,41454,0.9747231300994615,16.994460444444446,1865.2112533333334,15.423523338592997,121,9.0E-5
7,test_20231031_155016,10863862.png,317432,14797,302635,0.9533852919680436,3,6,66058,2120,63938,0.9679069908262437,23.245306666666668,3112.5087946666667,13.199697736252237,121,9.0E-5
8,test_20231031_155016,11382381.png,312486,1199,311287,0.9961630281036591,3,6,46745,164,46581,0.9964916033800406,20.298848,2271.7021546666665,14.56728970917017,121,9.0E-5
9,test_20231031_155016,11079715.png,443815,130027,313788,0.7070243231977288,5,6,124136,18094,106042,0.8542405104079397,16.408837333333334,1978.80552,15.166772476828436,121,9.0E-5
10,test_20231031_155016,11551286.png,271883,1362,270521,0.9949904922337918,2,6,40092,200,39892,0.9950114736106954,15.756325333333333,1488.0124746666668,16.404737887600753,121,9.0E-5
1,test_20231031_155017,10404007.png,502730,26112,476618,0.9480595946134108,3,5,61265,3765,57500,0.9385456622867869,25.063852444444443,3263.948144,12.993371105880328,121,1.0E-4
2,test_20231031_155017,1254659.png,342646,82322,260324,0.7597462103745557,4,7,80080,11414,68666,0.8574675324675325,20.146789333333334,2968.9748,13.404738494515186,121,1.0E-4
3,test_20231031_155017,10188041.png,221231,10747,210484,0.9514218170147944,3,5,41731,1508,40223,0.9638637943015983,10.256744888888889,960.6228746666667,18.30527436879325,121,1.0E-4
4,test_20231031_155017,10287332.png,216980,13682,203298,0.9369434970965066,3,6,22337,1863,20474,0.9165957827819313,9.239728,729.57032,19.500132029302378,121,1.0E-4
5,test_20231031_155017,11610969.png,368720,30472,338248,0.9173573443263181,3,6,84111,4439,79672,0.9472245009570687,19.285690666666667,2490.9437173333336,14.167164460683386,121,1.0E-4
6,test_20231031_155017,10350842.png,212614,7329,205285,0.965529080869557,3,6,42529,1075,41454,0.9747231300994615,16.994460444444446,1865.2112533333334,15.423523338592997,121,1.0E-4
7,test_20231031_155017,10863862.png,317432,14797,302635,0.9533852919680436,3,5,66058,2120,63938,0.9679069908262437,23.245306666666668,3112.5087946666667,13.199697736252237,121,1.0E-4
8,test_20231031_155017,11382381.png,312486,1199,311287,0.9961630281036591,2,5,46745,164,46581,0.9964916033800406,20.298848,2271.7021546666665,14.56728970917017,121,1.0E-4
9,test_20231031_155017,11079715.png,443815,130027,313788,0.7070243231977288,5,7,124136,18094,106042,0.8542405104079397,16.408837333333334,1978.80552,15.166772476828436,121,1.0E-4
10,test_20231031_155017,11551286.png,271883,1362,270521,0.9949904922337918,2,5,40092,200,39892,0.9950114736106954,15.756325333333333,1488.0124746666668,16.404737887600753,121,1.0E-4
1,test_20231031_155018,10404007.png,502730,26112,476618,0.9480595946134108,3,6,61265,3765,57500,0.9385456622867869,25.063852444444443,3263.948144,12.993371105880328,121,1.1E-4
2,test_20231031_155018,1254659.png,342646,82322,260324,0.7597462103745557,5,7,80080,11414,68666,0.8574675324675325,20.146789333333334,2968.9748,13.404738494515186,121,1.1E-4
3,test_20231031_155018,10188041.png,221231,10747,210484,0.9514218170147944,4,6,41731,1508,40223,0.9638637943015983,10.256744888888889,960.6228746666667,18.30527436879325,121,1.1E-4
4,test_20231031_155018,10287332.png,216980,13682,203298,0.9369434970965066,3,6,22337,1863,20474,0.9165957827819313,9.239728,729.57032,19.500132029302378,121,1.1E-4
5,test_20231031_155018,11610969.png,368720,30472,338248,0.9173573443263181,4,6,84111,4439,79672,0.9472245009570687,19.285690666666667,2490.9437173333336,14.167164460683386,121,1.1E-4
6,test_20231031_155018,10350842.png,212614,7329,205285,0.965529080869557,2,5,42529,1075,41454,0.9747231300994615,16.994460444444446,1865.2112533333334,15.423523338592997,121,1.1E-4
7,test_20231031_155018,10863862.png,317432,14797,302635,0.9533852919680436,3,6,66058,2120,63938,0.9679069908262437,23.245306666666668,3112.5087946666667,13.199697736252237,121,1.1E-4
8,test_20231031_155018,11382381.png,312486,1199,311287,0.9961630281036591,2,6,46745,164,46581,0.9964916033800406,20.298848,2271.7021546666665,14.56728970917017,121,1.1E-4
9,test_20231031_155018,11079715.png,443815,130027,313788,0.7070243231977288,5,7,124136,18094,106042,0.8542405104079397,16.408837333333334,1978.80552,15.166772476828436,121,1.1E-4
10,test_20231031_155018,11551286.png,271883,1362,270521,0.9949904922337918,3,6,40092,200,39892,0.9950114736106954,15.756325333333333,1488.0124746666668,16.404737887600753,121,1.1E-4
1,test_20231031_155019,10404007.png,502730,26112,476618,0.9480595946134108,4,6,61265,3765,57500,0.9385456622867869,25.063852444444443,3263.948144,12.993371105880328,121,1.2E-4
2,test_20231031_155019,1254659.png,342646,82322,260324,0.7597462103745557,5,6,80080,11414,68666,0.8574675324675325,20.146789333333334,2968.9748,13.404738494515186,121,1.2E-4
3,test_20231031_155019,10188041.png,221231,10747,210484,0.9514218170147944,3,5,41731,1508,40223,0.9638637943015983,10.256744888888889,960.6228746666667,18.30527436879325,121,1.2E-4
4,test_20231031_155019,10287332.png,216980,13682,203298,0.9369434970965066,3,5,22337,1863,20474,0.9165957827819313,9.239728,729.57032,19.500132029302378,121,1.2E-4
5,test_20231031_155019,11610969.png,368720,30472,338248,0.9173573443263181,4,6,84111,4439,79672,0.9472245009570687,19.285690666666667,2490.9437173333336,14.167164460683386,121,1.2E-4
6,test_20231031_155019,10350842.png,212614,7329,205285,0.965529080869557,3,6,42529,1075,41454,0.9747231300994615,16.994460444444446,1865.2112533333334,15.423523338592997,121,1.2E-4
7,test_20231031_155019,10863862.png,317432,14797,302635,0.9533852919680436,3,5,66058,2120,63938,0.9679069908262437,23.245306666666668,3112.5087946666667,13.199697736252237,121,1.2E-4
8,test_20231031_155019,11382381.png,312486,1199,311287,0.9961630281036591,2,5,46745,164,46581,0.9964916033800406,20.298848,2271.7021546666665,14.56728970917017,121,1.2E-4
9,test_20231031_155019,11079715.png,443815,130027,313788,0.7070243231977288,5,7,124136,18094,106042,0.8542405104079397,16.408837333333334,1978.80552,15.166772476828436,121,1.2E-4
10,test_20231031_155019,11551286.png,271883,1362,270521,0.9949904922337918,2,5,40092,200,39892,0.9950114736106954,15.756325333333333,1488.0124746666668,16.404737887600753,121,1.2E-4
1,test_20231031_155020,10404007.png,502730,26112,476618,0.9480595946134108,4,6,61265,3765,57500,0.9385456622867869,25.063852444444443,3263.948144,12.993371105880328,121,1.3000000000000002E-4
2,test_20231031_155020,1254659.png,342646,82322,260324,0.7597462103745557,5,7,80080,11414,68666,0.8574675324675325,20.146789333333334,2968.9748,13.404738494515186,121,1.3000000000000002E-4
3,test_20231031_155020,10188041.png,221231,10747,210484,0.9514218170147944,3,6,41731,1508,40223,0.9638637943015983,10.256744888888889,960.6228746666667,18.30527436879325,121,1.3000000000000002E-4
4,test_20231031_155020,10287332.png,216980,13682,203298,0.9369434970965066,3,6,22337,1863,20474,0.9165957827819313,9.239728,729.57032,19.500132029302378,121,1.3000000000000002E-4
5,test_20231031_155020,11610969.png,368720,30472,338248,0.9173573443263181,4,6,84111,4439,79672,0.9472245009570687,19.285690666666667,2490.9437173333336,14.167164460683386,121,1.3000000000000002E-4
6,test_20231031_155020,10350842.png,212614,7329,205285,0.965529080869557,3,6,42529,1075,41454,0.9747231300994615,16.994460444444446,1865.2112533333334,15.423523338592997,121,1.3000000000000002E-4
7,test_20231031_155020,10863862.png,317432,14797,302635,0.9533852919680436,3,6,66058,2120,63938,0.9679069908262437,23.245306666666668,3112.5087946666667,13.199697736252237,121,1.3000000000000002E-4
8,test_20231031_155020,11382381.png,312486,1199,311287,0.9961630281036591,3,6,46745,164,46581,0.9964916033800406,20.298848,2271.7021546666665,14.56728970917017,121,1.3000000000000002E-4
9,test_20231031_155020,11079715.png,443815,130027,313788,0.7070243231977288,6,7,124136,18094,106042,0.8542405104079397,16.408837333333334,1978.80552,15.166772476828436,121,1.3000000000000002E-4
10,test_20231031_155020,11551286.png,271883,1362,270521,0.9949904922337918,2,5,40092,200,39892,0.9950114736106954,15.756325333333333,1488.0124746666668,16.404737887600753,121,1.3000000000000002E-4
1,test_20231031_155021,10404007.png,502730,26112,476618,0.9480595946134108,4,6,61265,3765,57500,0.9385456622867869,25.063852444444443,3263.948144,12.993371105880328,121,1.4000000000000001E-4
2,test_20231031_155021,1254659.png,342646,82322,260324,0.7597462103745557,5,7,80080,11414,68666,0.8574675324675325,20.146789333333334,2968.9748,13.404738494515186,121,1.4000000000000001E-4
3,test_20231031_155021,10188041.png,221231,10747,210484,0.9514218170147944,3,6,41731,1508,40223,0.9638637943015983,10.256744888888889,960.6228746666667,18.30527436879325,121,1.4000000000000001E-4
4,test_20231031_155021,10287332.png,216980,13682,203298,0.9369434970965066,2,6,22337,1863,20474,0.9165957827819313,9.239728,729.57032,19.500132029302378,121,1.4000000000000001E-4
5,test_20231031_155021,11610969.png,368720,30472,338248,0.9173573443263181,4,6,84111,4439,79672,0.9472245009570687,19.285690666666667,2490.9437173333336,14.167164460683386,121,1.4000000000000001E-4
6,test_20231031_155021,10350842.png,212614,7329,205285,0.965529080869557,2,5,42529,1075,41454,0.9747231300994615,16.994460444444446,1865.2112533333334,15.423523338592997,121,1.4000000000000001E-4
7,test_20231031_155021,10863862.png,317432,14797,302635,0.9533852919680436,3,5,66058,2120,63938,0.9679069908262437,23.245306666666668,3112.5087946666667,13.199697736252237,121,1.4000000000000001E-4
8,test_20231031_155021,11382381.png,312486,1199,311287,0.9961630281036591,2,5,46745,164,46581,0.9964916033800406,20.298848,2271.7021546666665,14.56728970917017,121,1.4000000000000001E-4
9,test_20231031_155021,11079715.png,443815,130027,313788,0.7070243231977288,6,7,124136,18094,106042,0.8542405104079397,16.408837333333334,1978.80552,15.166772476828436,121,1.4000000000000001E-4
10,test_20231031_155021,11551286.png,271883,1362,270521,0.9949904922337918,2,6,40092,200,39892,0.9950114736106954,15.756325333333333,1488.0124746666668,16.404737887600753,121,1.4000000000000001E-4
1,test_20231031_155022,10404007.png,502730,26112,476618,0.9480595946134108,4,6,61265,3765,57500,0.9385456622867869,25.063852444444443,3263.948144,12.993371105880328,121,1.5000000000000001E-4
2,test_20231031_155022,1254659.png,342646,82322,260324,0.7597462103745557,5,7,80080,11414,68666,0.8574675324675325,20.146789333333334,2968.9748,13.404738494515186,121,1.5000000000000001E-4
3,test_20231031_155022,10188041.png,221231,10747,210484,0.9514218170147944,3,5,41731,1508,40223,0.9638637943015983,10.256744888888889,960.6228746666667,18.30527436879325,121,1.5000000000000001E-4
4,test_20231031_155022,10287332.png,216980,13682,203298,0.9369434970965066,3,6,22337,1863,20474,0.9165957827819313,9.239728,729.57032,19.500132029302378,121,1.5000000000000001E-4
5,test_20231031_155022,11610969.png,368720,30472,338248,0.9173573443263181,4,6,84111,4439,79672,0.9472245009570687,19.285690666666667,2490.9437173333336,14.167164460683386,121,1.5000000000000001E-4
6,test_20231031_155022,10350842.png,212614,7329,205285,0.965529080869557,3,6,42529,1075,41454,0.9747231300994615,16.994460444444446,1865.2112533333334,15.423523338592997,121,1.5000000000000001E-4
7,test_20231031_155022,10863862.png,317432,14797,302635,0.9533852919680436,3,6,66058,2120,63938,0.9679069908262437,23.245306666666668,3112.5087946666667,13.199697736252237,121,1.5000000000000001E-4
8,test_20231031_155022,11382381.png,312486,1199,311287,0.9961630281036591,3,6,46745,164,46581,0.9964916033800406,20.298848,2271.7021546666665,14.56728970917017,121,1.5000000000000001E-4
9,test_20231031_155022,11079715.png,443815,130027,313788,0.7070243231977288,5,7,124136,18094,106042,0.8542405104079397,16.408837333333334,1978.80552,15.166772476828436,121,1.5000000000000001E-4
10,test_20231031_155022,11551286.png,271883,1362,270521,0.9949904922337918,3,6,40092,200,39892,0.9950114736106954,15.756325333333333,1488.0124746666668,16.404737887600753,121,1.5000000000000001E-4
1,test_20231031_155023,10404007.png,502730,26112,476618,0.9480595946134108,4,6,61265,3765,57500,0.9385456622867869,25.063852444444443,3263.948144,12.993371105880328,121,1.6E-4
2,test_20231031_155023,1254659.png,342646,82322,260324,0.7597462103745557,5,6,80080,11414,68666,0.8574675324675325,20.146789333333334,2968.9748,13.404738494515186,121,1.6E-4
3,test_20231031_155023,10188041.png,221231,10747,210484,0.9514218170147944,3,6,41731,1508,40223,0.9638637943015983,10.256744888888889,960.6228746666667,18.30527436879325,121,1.6E-4
4,test_20231031_155023,10287332.png,216980,13429,203551,0.9381095031800166,3,6,22337,1833,20504,0.9179388458611273,9.370778666666666,756.6213706666666,19.342017571499717,121,1.6E-4
5,test_20231031_155023,11610969.png,368720,30472,338248,0.9173573443263181,4,6,84111,4439,79672,0.9472245009570687,19.285690666666667,2490.9437173333336,14.167164460683386,121,1.6E-4
6,test_20231031_155023,10350842.png,212614,7329,205285,0.965529080869557,2,5,42529,1075,41454,0.9747231300994615,16.994460444444446,1865.2112533333334,15.423523338592997,121,1.6E-4
7,test_20231031_155023,10863862.png,317432,14797,302635,0.9533852919680436,3,6,66058,2120,63938,0.9679069908262437,23.245306666666668,3112.5087946666667,13.199697736252237,121,1.6E-4
8,test_20231031_155023,11382381.png,312486,1199,311287,0.9961630281036591,3,6,46745,164,46581,0.9964916033800406,20.298848,2271.7021546666665,14.56728970917017,121,1.6E-4
9,test_20231031_155023,11079715.png,443815,130027,313788,0.7070243231977288,6,7,124136,18094,106042,0.8542405104079397,16.408837333333334,1978.80552,15.166772476828436,121,1.6E-4
10,test_20231031_155023,11551286.png,271883,1362,270521,0.9949904922337918,3,5,40092,200,39892,0.9950114736106954,15.756325333333333,1488.0124746666668,16.404737887600753,121,1.6E-4
1,test_20231031_155024,10404007.png,502730,26112,476618,0.9480595946134108,4,6,61265,3765,57500,0.9385456622867869,25.063852444444443,3263.948144,12.993371105880328,121,1.7E-4
2,test_20231031_155024,1254659.png,342646,82322,260324,0.7597462103745557,5,6,80080,11414,68666,0.8574675324675325,20.146789333333334,2968.9748,13.404738494515186,121,1.7E-4
3,test_20231031_155024,10188041.png,221231,10747,210484,0.9514218170147944,3,5,41731,1508,40223,0.9638637943015983,10.256744888888889,960.6228746666667,18.30527436879325,121,1.7E-4
4,test_20231031_155024,10287332.png,216980,13429,203551,0.9381095031800166,2,5,22337,1833,20504,0.9179388458611273,9.370778666666666,756.6213706666666,19.342017571499717,121,1.7E-4
5,test_20231031_155024,11610969.png,368720,30472,338248,0.9173573443263181,4,6,84111,4439,79672,0.9472245009570687,19.285690666666667,2490.9437173333336,14.167164460683386,121,1.7E-4
6,test_20231031_155024,10350842.png,212614,7329,205285,0.965529080869557,2,5,42529,1075,41454,0.9747231300994615,16.994460444444446,1865.2112533333334,15.423523338592997,121,1.7E-4
7,test_20231031_155024,10863862.png,317432,14797,302635,0.9533852919680436,3,6,66058,2120,63938,0.9679069908262437,23.245306666666668,3112.5087946666667,13.199697736252237,121,1.7E-4
8,test_20231031_155024,11382381.png,312486,1199,311287,0.9961630281036591,3,6,46745,164,46581,0.9964916033800406,20.298848,2271.7021546666665,14.56728970917017,121,1.7E-4
9,test_20231031_155024,11079715.png,443815,130027,313788,0.7070243231977288,6,7,124136,18094,106042,0.8542405104079397,16.408837333333334,1978.80552,15.166772476828436,121,1.7E-4
10,test_20231031_155024,11551286.png,271883,1362,270521,0.9949904922337918,3,6,40092,200,39892,0.9950114736106954,15.756325333333333,1488.0124746666668,16.404737887600753,121,1.7E-4
1,test_20231031_155025,10404007.png,502730,26112,476618,0.9480595946134108,4,6,61265,3765,57500,0.9385456622867869,25.063852444444443,3263.948144,12.993371105880328,121,1.8E-4
2,test_20231031_155025,1254659.png,342646,82322,260324,0.7597462103745557,7,6,80080,11414,68666,0.8574675324675325,20.146789333333334,2968.9748,13.404738494515186,121,1.8E-4
3,test_20231031_155025,10188041.png,221231,10747,210484,0.9514218170147944,3,6,41731,1508,40223,0.9638637943015983,10.256744888888889,960.6228746666667,18.30527436879325,121,1.8E-4
4,test_20231031_155025,10287332.png,216980,13429,203551,0.9381095031800166,3,6,22337,1833,20504,0.9179388458611273,9.370778666666666,756.6213706666666,19.342017571499717,121,1.8E-4
5,test_20231031_155025,11610969.png,368720,30472,338248,0.9173573443263181,4,7,84111,4439,79672,0.9472245009570687,19.285690666666667,2490.9437173333336,14.167164460683386,121,1.8E-4
6,test_20231031_155025,10350842.png,212614,7329,205285,0.965529080869557,2,7,42529,1075,41454,0.9747231300994615,16.994460444444446,1865.2112533333334,15.423523338592997,121,1.8E-4
7,test_20231031_155025,10863862.png,317432,14797,302635,0.9533852919680436,3,6,66058,2120,63938,0.9679069908262437,23.245306666666668,3112.5087946666667,13.199697736252237,121,1.8E-4
8,test_20231031_155025,11382381.png,312486,1199,311287,0.9961630281036591,3,6,46745,164,46581,0.9964916033800406,20.298848,2271.7021546666665,14.56728970917017,121,1.8E-4
9,test_20231031_155025,11079715.png,443815,130027,313788,0.7070243231977288,5,10,124136,18094,106042,0.8542405104079397,16.408837333333334,1978.80552,15.166772476828436,121,1.8E-4
10,test_20231031_155025,11551286.png,271883,1362,270521,0.9949904922337918,2,5,40092,200,39892,0.9950114736106954,15.756325333333333,1488.0124746666668,16.404737887600753,121,1.8E-4
1,test_20231031_155026,10404007.png,502730,26112,476618,0.9480595946134108,4,6,61265,3765,57500,0.9385456622867869,25.063852444444443,3263.948144,12.993371105880328,121,1.9E-4
2,test_20231031_155026,1254659.png,342646,82322,260324,0.7597462103745557,4,6,80080,11414,68666,0.8574675324675325,20.146789333333334,2968.9748,13.404738494515186,121,1.9E-4
3,test_20231031_155026,10188041.png,221231,10747,210484,0.9514218170147944,3,6,41731,1508,40223,0.9638637943015983,10.256744888888889,960.6228746666667,18.30527436879325,121,1.9E-4
4,test_20231031_155026,10287332.png,216980,13429,203551,0.9381095031800166,3,5,22337,1833,20504,0.9179388458611273,9.370778666666666,756.6213706666666,19.342017571499717,121,1.9E-4
5,test_20231031_155026,11610969.png,368720,30472,338248,0.9173573443263181,5,6,84111,4439,79672,0.9472245009570687,19.285690666666667,2490.9437173333336,14.167164460683386,121,1.9E-4
6,test_20231031_155026,10350842.png,212614,7329,205285,0.965529080869557,2,5,42529,1075,41454,0.9747231300994615,16.994460444444446,1865.2112533333334,15.423523338592997,121,1.9E-4
7,test_20231031_155026,10863862.png,317432,14797,302635,0.9533852919680436,3,5,66058,2120,63938,0.9679069908262437,23.245306666666668,3112.5087946666667,13.199697736252237,121,1.9E-4
8,test_20231031_155026,11382381.png,312486,1199,311287,0.9961630281036591,3,6,46745,164,46581,0.9964916033800406,20.298848,2271.7021546666665,14.56728970917017,121,1.9E-4
9,test_20231031_155026,11079715.png,443815,130027,313788,0.7070243231977288,6,7,124136,18094,106042,0.8542405104079397,16.408837333333334,1978.80552,15.166772476828436,121,1.9E-4
10,test_20231031_155026,11551286.png,271883,1362,270521,0.9949904922337918,3,6,40092,200,39892,0.9950114736106954,15.756325333333333,1488.0124746666668,16.404737887600753,121,1.9E-4
1,test_20231031_155027,10404007.png,502730,26112,476618,0.9480595946134108,4,6,61265,3765,57500,0.9385456622867869,25.063852444444443,3263.948144,12.993371105880328,121,2.0E-4
2,test_20231031_155027,1254659.png,342646,82322,260324,0.7597462103745557,5,6,80080,11414,68666,0.8574675324675325,20.146789333333334,2968.9748,13.404738494515186,121,2.0E-4
3,test_20231031_155027,10188041.png,221231,10747,210484,0.9514218170147944,3,5,41731,1508,40223,0.9638637943015983,10.256744888888889,960.6228746666667,18.30527436879325,121,2.0E-4
4,test_20231031_155027,10287332.png,216980,13429,203551,0.9381095031800166,3,6,22337,1833,20504,0.9179388458611273,9.370778666666666,756.6213706666666,19.342017571499717,121,2.0E-4
5,test_20231031_155027,11610969.png,368720,30472,338248,0.9173573443263181,4,6,84111,4439,79672,0.9472245009570687,19.285690666666667,2490.9437173333336,14.167164460683386,121,2.0E-4
6,test_20231031_155027,10350842.png,212614,7329,205285,0.965529080869557,2,5,42529,1075,41454,0.9747231300994615,16.994460444444446,1865.2112533333334,15.423523338592997,121,2.0E-4
7,test_20231031_155027,10863862.png,317432,14797,302635,0.9533852919680436,3,5,66058,2120,63938,0.9679069908262437,23.245306666666668,3112.5087946666667,13.199697736252237,121,2.0E-4
8,test_20231031_155027,11382381.png,312486,1199,311287,0.9961630281036591,3,5,46745,164,46581,0.9964916033800406,20.298848,2271.7021546666665,14.56728970917017,121,2.0E-4
9,test_20231031_155027,11079715.png,443815,130027,313788,0.7070243231977288,5,6,124136,18094,106042,0.8542405104079397,16.408837333333334,1978.80552,15.166772476828436,121,2.0E-4
10,test_20231031_155027,11551286.png,271883,1362,270521,0.9949904922337918,2,5,40092,200,39892,0.9950114736106954,15.756325333333333,1488.0124746666668,16.404737887600753,121,2.0E-4
1,test_20231031_155028,10404007.png,502730,26112,476618,0.9480595946134108,3,5,61265,3765,57500,0.9385456622867869,25.063852444444443,3263.948144,12.993371105880328,121,2.1E-4
2,test_20231031_155028,1254659.png,342646,82322,260324,0.7597462103745557,5,6,80080,11414,68666,0.8574675324675325,20.146789333333334,2968.9748,13.404738494515186,121,2.1E-4
3,test_20231031_155028,10188041.png,221231,10747,210484,0.9514218170147944,3,6,41731,1508,40223,0.9638637943015983,10.256744888888889,960.6228746666667,18.30527436879325,121,2.1E-4
4,test_20231031_155028,10287332.png,216980,13429,203551,0.9381095031800166,3,6,22337,1833,20504,0.9179388458611273,9.370778666666666,756.6213706666666,19.342017571499717,121,2.1E-4
5,test_20231031_155028,11610969.png,368720,30472,338248,0.9173573443263181,3,5,84111,4439,79672,0.9472245009570687,19.285690666666667,2490.9437173333336,14.167164460683386,121,2.1E-4
6,test_20231031_155028,10350842.png,212614,7329,205285,0.965529080869557,3,6,42529,1075,41454,0.9747231300994615,16.994460444444446,1865.2112533333334,15.423523338592997,121,2.1E-4
7,test_20231031_155028,10863862.png,317432,14797,302635,0.9533852919680436,4,6,66058,2120,63938,0.9679069908262437,23.245306666666668,3112.5087946666667,13.199697736252237,121,2.1E-4
8,test_20231031_155028,11382381.png,312486,1199,311287,0.9961630281036591,3,6,46745,164,46581,0.9964916033800406,20.298848,2271.7021546666665,14.56728970917017,121,2.1E-4
9,test_20231031_155028,11079715.png,443815,130027,313788,0.7070243231977288,7,7,124136,18094,106042,0.8542405104079397,16.408837333333334,1978.80552,15.166772476828436,121,2.1E-4
10,test_20231031_155028,11551286.png,271883,1362,270521,0.9949904922337918,2,5,40092,200,39892,0.9950114736106954,15.756325333333333,1488.0124746666668,16.404737887600753,121,2.1E-4
1,test_20231031_155029,10404007.png,502730,26112,476618,0.9480595946134108,3,5,61265,3765,57500,0.9385456622867869,25.063852444444443,3263.948144,12.993371105880328,121,2.2E-4
2,test_20231031_155029,1254659.png,342646,82322,260324,0.7597462103745557,5,7,80080,11414,68666,0.8574675324675325,20.146789333333334,2968.9748,13.404738494515186,121,2.2E-4
3,test_20231031_155029,10188041.png,221231,10747,210484,0.9514218170147944,3,7,41731,1508,40223,0.9638637943015983,10.256744888888889,960.6228746666667,18.30527436879325,121,2.2E-4
4,test_20231031_155029,10287332.png,216980,13429,203551,0.9381095031800166,2,7,22337,1833,20504,0.9179388458611273,9.370778666666666,756.6213706666666,19.342017571499717,121,2.2E-4
5,test_20231031_155029,11610969.png,368720,30472,338248,0.9173573443263181,3,6,84111,4439,79672,0.9472245009570687,19.285690666666667,2490.9437173333336,14.167164460683386,121,2.2E-4
6,test_20231031_155029,10350842.png,212614,7329,205285,0.965529080869557,3,5,42529,1075,41454,0.9747231300994615,16.994460444444446,1865.2112533333334,15.423523338592997,121,2.2E-4
7,test_20231031_155029,10863862.png,317432,14797,302635,0.9533852919680436,3,5,66058,2120,63938,0.9679069908262437,23.245306666666668,3112.5087946666667,13.199697736252237,121,2.2E-4
8,test_20231031_155029,11382381.png,312486,1199,311287,0.9961630281036591,3,6,46745,164,46581,0.9964916033800406,20.298848,2271.7021546666665,14.56728970917017,121,2.2E-4
9,test_20231031_155029,11079715.png,443815,130027,313788,0.7070243231977288,6,13,124136,18094,106042,0.8542405104079397,16.408837333333334,1978.80552,15.166772476828436,121,2.2E-4
10,test_20231031_155029,11551286.png,271883,1362,270521,0.9949904922337918,2,5,40092,200,39892,0.9950114736106954,15.756325333333333,1488.0124746666668,16.404737887600753,121,2.2E-4
1,test_20231031_155030,10404007.png,502730,26112,476618,0.9480595946134108,4,6,61265,3765,57500,0.9385456622867869,25.063852444444443,3263.948144,12.993371105880328,121,2.3E-4
2,test_20231031_155030,1254659.png,342646,82322,260324,0.7597462103745557,5,6,80080,11414,68666,0.8574675324675325,20.146789333333334,2968.9748,13.404738494515186,121,2.3E-4
3,test_20231031_155030,10188041.png,221231,10747,210484,0.9514218170147944,3,5,41731,1508,40223,0.9638637943015983,10.256744888888889,960.6228746666667,18.30527436879325,121,2.3E-4
4,test_20231031_155030,10287332.png,216980,13429,203551,0.9381095031800166,2,6,22337,1833,20504,0.9179388458611273,9.370778666666666,756.6213706666666,19.342017571499717,121,2.3E-4
5,test_20231031_155030,11610969.png,368720,30472,338248,0.9173573443263181,4,6,84111,4439,79672,0.9472245009570687,19.285690666666667,2490.9437173333336,14.167164460683386,121,2.3E-4
6,test_20231031_155030,10350842.png,212614,7329,205285,0.965529080869557,2,5,42529,1075,41454,0.9747231300994615,16.994460444444446,1865.2112533333334,15.423523338592997,121,2.3E-4
7,test_20231031_155030,10863862.png,317432,14797,302635,0.9533852919680436,3,6,66058,2120,63938,0.9679069908262437,23.245306666666668,3112.5087946666667,13.199697736252237,121,2.3E-4
8,test_20231031_155030,11382381.png,312486,1199,311287,0.9961630281036591,2,5,46745,164,46581,0.9964916033800406,20.298848,2271.7021546666665,14.56728970917017,121,2.3E-4
9,test_20231031_155030,11079715.png,443815,130027,313788,0.7070243231977288,6,8,124136,18094,106042,0.8542405104079397,16.408837333333334,1978.80552,15.166772476828436,121,2.3E-4
10,test_20231031_155030,11551286.png,271883,1362,270521,0.9949904922337918,3,6,40092,200,39892,0.9950114736106954,15.756325333333333,1488.0124746666668,16.404737887600753,121,2.3E-4
1,test_20231031_155031,10404007.png,502730,26112,476618,0.9480595946134108,3,6,61265,3765,57500,0.9385456622867869,25.063852444444443,3263.948144,12.993371105880328,121,2.4E-4
2,test_20231031_155031,1254659.png,342646,82322,260324,0.7597462103745557,4,6,80080,11414,68666,0.8574675324675325,20.146789333333334,2968.9748,13.404738494515186,121,2.4E-4
3,test_20231031_155031,10188041.png,221231,10747,210484,0.9514218170147944,3,6,41731,1508,40223,0.9638637943015983,10.256744888888889,960.6228746666667,18.30527436879325,121,2.4E-4
4,test_20231031_155031,10287332.png,216980,13429,203551,0.9381095031800166,3,6,22337,1833,20504,0.9179388458611273,9.370778666666666,756.6213706666666,19.342017571499717,121,2.4E-4
5,test_20231031_155031,11610969.png,368720,30472,338248,0.9173573443263181,4,6,84111,4439,79672,0.9472245009570687,19.285690666666667,2490.9437173333336,14.167164460683386,121,2.4E-4
6,test_20231031_155031,10350842.png,212614,7329,205285,0.965529080869557,2,6,42529,1075,41454,0.9747231300994615,16.994460444444446,1865.2112533333334,15.423523338592997,121,2.4E-4
7,test_20231031_155031,10863862.png,317432,14797,302635,0.9533852919680436,3,6,66058,2120,63938,0.9679069908262437,23.245306666666668,3112.5087946666667,13.199697736252237,121,2.4E-4
8,test_20231031_155031,11382381.png,312486,1199,311287,0.9961630281036591,2,5,46745,164,46581,0.9964916033800406,20.298848,2271.7021546666665,14.56728970917017,121,2.4E-4
9,test_20231031_155031,11079715.png,443815,130027,313788,0.7070243231977288,5,6,124136,18094,106042,0.8542405104079397,16.408837333333334,1978.80552,15.166772476828436,121,2.4E-4
10,test_20231031_155031,11551286.png,271883,1362,270521,0.9949904922337918,3,5,40092,200,39892,0.9950114736106954,15.756325333333333,1488.0124746666668,16.404737887600753,121,2.4E-4
1,test_20231031_155032,10404007.png,502730,26112,476618,0.9480595946134108,4,6,61265,3765,57500,0.9385456622867869,25.063852444444443,3263.948144,12.993371105880328,121,2.5E-4
2,test_20231031_155032,1254659.png,342646,82322,260324,0.7597462103745557,5,7,80080,11414,68666,0.8574675324675325,20.146789333333334,2968.9748,13.404738494515186,121,2.5E-4
3,test_20231031_155032,10188041.png,221231,10747,210484,0.9514218170147944,3,6,41731,1508,40223,0.9638637943015983,10.256744888888889,960.6228746666667,18.30527436879325,121,2.5E-4
4,test_20231031_155032,10287332.png,216980,13429,203551,0.9381095031800166,3,6,22337,1833,20504,0.9179388458611273,9.370778666666666,756.6213706666666,19.342017571499717,121,2.5E-4
5,test_20231031_155032,11610969.png,368720,30472,338248,0.9173573443263181,4,6,84111,4439,79672,0.9472245009570687,19.285690666666667,2490.9437173333336,14.167164460683386,121,2.5E-4
6,test_20231031_155032,10350842.png,212614,7329,205285,0.965529080869557,3,6,42529,1075,41454,0.9747231300994615,16.994460444444446,1865.2112533333334,15.423523338592997,121,2.5E-4
7,test_20231031_155032,10863862.png,317432,14797,302635,0.9533852919680436,3,6,66058,2120,63938,0.9679069908262437,23.245306666666668,3112.5087946666667,13.199697736252237,121,2.5E-4
8,test_20231031_155032,11382381.png,312486,1199,311287,0.9961630281036591,3,5,46745,164,46581,0.9964916033800406,20.298848,2271.7021546666665,14.56728970917017,121,2.5E-4
9,test_20231031_155032,11079715.png,443815,130027,313788,0.7070243231977288,6,7,124136,18094,106042,0.8542405104079397,16.408837333333334,1978.80552,15.166772476828436,121,2.5E-4
10,test_20231031_155032,11551286.png,271883,1362,270521,0.9949904922337918,2,6,40092,200,39892,0.9950114736106954,15.756325333333333,1488.0124746666668,16.404737887600753,121,2.5E-4
1,test_20231031_155033,10404007.png,502730,25849,476881,0.9485827382491596,4,15,61265,3728,57537,0.9391495960173019,25.087061333333335,3268.065152,12.987896548459542,121,2.6000000000000003E-4
2,test_20231031_155033,1254659.png,342646,82262,260384,0.7599213182117988,4,6,80080,11409,68671,0.85752997002997,20.156343111111113,2970.0569866666665,13.403155786357337,121,2.6000000000000003E-4
3,test_20231031_155033,10188041.png,221231,10667,210564,0.9517834299894681,4,6,41731,1496,40235,0.9641513503151135,10.409946666666666,981.2383306666667,18.21305855911757,121,2.6000000000000003E-4
4,test_20231031_155033,10287332.png,216980,13429,203551,0.9381095031800166,2,5,22337,1833,20504,0.9179388458611273,9.370778666666666,756.6213706666666,19.342017571499717,121,2.6000000000000003E-4
5,test_20231031_155033,11610969.png,368720,30412,338308,0.9175200694293772,4,5,84111,4432,79679,0.9473077243166768,19.617939555555555,2565.311952,14.039401762955164,121,2.6000000000000003E-4
6,test_20231031_155033,10350842.png,212614,7187,205427,0.9661969578673089,3,5,42529,1054,41475,0.9752169108137977,17.523210666666667,1977.5073386666666,15.169622569983105,121,2.6000000000000003E-4
7,test_20231031_155033,10863862.png,317432,14697,302735,0.9537003200685501,3,5,66058,2105,63953,0.9681340640043599,23.275838222222223,3117.6927946666665,13.192470415975402,121,2.6000000000000003E-4
8,test_20231031_155033,11382381.png,312486,967,311519,0.9969054613646692,2,5,46745,130,46615,0.9972189538988127,21.068341333333333,2406.1475626666665,14.317581029153203,121,2.6000000000000003E-4
9,test_20231031_155033,11079715.png,443815,130027,313788,0.7070243231977288,5,6,124136,18094,106042,0.8542405104079397,16.408837333333334,1978.80552,15.166772476828436,121,2.6000000000000003E-4
10,test_20231031_155033,11551286.png,271883,1219,270664,0.9955164537687167,2,5,40092,179,39913,0.9955352688815724,16.076115555555557,1539.5683893333332,16.25681375358216,121,2.6000000000000003E-4
1,test_20231031_155034,10404007.png,502730,25849,476881,0.9485827382491596,4,6,61265,3728,57537,0.9391495960173019,25.087061333333335,3268.065152,12.987896548459542,121,2.7000000000000006E-4
2,test_20231031_155034,1254659.png,342646,82262,260384,0.7599213182117988,5,6,80080,11409,68671,0.85752997002997,20.156343111111113,2970.0569866666665,13.403155786357337,121,2.7000000000000006E-4
3,test_20231031_155034,10188041.png,221231,10667,210564,0.9517834299894681,4,6,41731,1496,40235,0.9641513503151135,10.409946666666666,981.2383306666667,18.21305855911757,121,2.7000000000000006E-4
4,test_20231031_155034,10287332.png,216980,13429,203551,0.9381095031800166,2,5,22337,1833,20504,0.9179388458611273,9.370778666666666,756.6213706666666,19.342017571499717,121,2.7000000000000006E-4
5,test_20231031_155034,11610969.png,368720,30412,338308,0.9175200694293772,4,6,84111,4432,79679,0.9473077243166768,19.617939555555555,2565.311952,14.039401762955164,121,2.7000000000000006E-4
6,test_20231031_155034,10350842.png,212614,7187,205427,0.9661969578673089,2,5,42529,1054,41475,0.9752169108137977,17.523210666666667,1977.5073386666666,15.169622569983105,121,2.7000000000000006E-4
7,test_20231031_155034,10863862.png,317432,14697,302735,0.9537003200685501,3,5,66058,2105,63953,0.9681340640043599,23.275838222222223,3117.6927946666665,13.192470415975402,121,2.7000000000000006E-4
8,test_20231031_155034,11382381.png,312486,967,311519,0.9969054613646692,3,6,46745,130,46615,0.9972189538988127,21.068341333333333,2406.1475626666665,14.317581029153203,121,2.7000000000000006E-4
9,test_20231031_155034,11079715.png,443815,130027,313788,0.7070243231977288,6,6,124136,18094,106042,0.8542405104079397,16.408837333333334,1978.80552,15.166772476828436,121,2.7000000000000006E-4
10,test_20231031_155034,11551286.png,271883,1219,270664,0.9955164537687167,3,6,40092,179,39913,0.9955352688815724,16.076115555555557,1539.5683893333332,16.25681375358216,121,2.7000000000000006E-4
1,test_20231031_155036,10404007.png,502730,25849,476881,0.9485827382491596,4,6,61265,3728,57537,0.9391495960173019,25.087061333333335,3268.065152,12.987896548459542,121,2.800000000000001E-4
2,test_20231031_155036,1254659.png,342646,82262,260384,0.7599213182117988,5,6,80080,11409,68671,0.85752997002997,20.156343111111113,2970.0569866666665,13.403155786357337,121,2.800000000000001E-4
3,test_20231031_155036,10188041.png,221231,10667,210564,0.9517834299894681,3,6,41731,1496,40235,0.9641513503151135,10.409946666666666,981.2383306666667,18.21305855911757,121,2.800000000000001E-4
4,test_20231031_155036,10287332.png,216980,13429,203551,0.9381095031800166,2,5,22337,1833,20504,0.9179388458611273,9.370778666666666,756.6213706666666,19.342017571499717,121,2.800000000000001E-4
5,test_20231031_155036,11610969.png,368720,30412,338308,0.9175200694293772,3,6,84111,4432,79679,0.9473077243166768,19.617939555555555,2565.311952,14.039401762955164,121,2.800000000000001E-4
6,test_20231031_155036,10350842.png,212614,7187,205427,0.9661969578673089,2,6,42529,1054,41475,0.9752169108137977,17.523210666666667,1977.5073386666666,15.169622569983105,121,2.800000000000001E-4
7,test_20231031_155036,10863862.png,317432,14697,302735,0.9537003200685501,3,5,66058,2105,63953,0.9681340640043599,23.275838222222223,3117.6927946666665,13.192470415975402,121,2.800000000000001E-4
8,test_20231031_155036,11382381.png,312486,967,311519,0.9969054613646692,3,6,46745,130,46615,0.9972189538988127,21.068341333333333,2406.1475626666665,14.317581029153203,121,2.800000000000001E-4
9,test_20231031_155036,11079715.png,443815,130027,313788,0.7070243231977288,5,7,124136,18094,106042,0.8542405104079397,16.408837333333334,1978.80552,15.166772476828436,121,2.800000000000001E-4
10,test_20231031_155036,11551286.png,271883,1219,270664,0.9955164537687167,2,5,40092,179,39913,0.9955352688815724,16.076115555555557,1539.5683893333332,16.25681375358216,121,2.800000000000001E-4
1,test_20231031_155037,10404007.png,502730,25849,476881,0.9485827382491596,3,6,61265,3728,57537,0.9391495960173019,25.087061333333335,3268.065152,12.987896548459542,121,2.900000000000001E-4
2,test_20231031_155037,1254659.png,342646,82262,260384,0.7599213182117988,5,7,80080,11409,68671,0.85752997002997,20.156343111111113,2970.0569866666665,13.403155786357337,121,2.900000000000001E-4
3,test_20231031_155037,10188041.png,221231,10667,210564,0.9517834299894681,4,6,41731,1496,40235,0.9641513503151135,10.409946666666666,981.2383306666667,18.21305855911757,121,2.900000000000001E-4
4,test_20231031_155037,10287332.png,216980,13429,203551,0.9381095031800166,3,6,22337,1833,20504,0.9179388458611273,9.370778666666666,756.6213706666666,19.342017571499717,121,2.900000000000001E-4
5,test_20231031_155037,11610969.png,368720,30412,338308,0.9175200694293772,4,6,84111,4432,79679,0.9473077243166768,19.617939555555555,2565.311952,14.039401762955164,121,2.900000000000001E-4
6,test_20231031_155037,10350842.png,212614,7187,205427,0.9661969578673089,3,6,42529,1054,41475,0.9752169108137977,17.523210666666667,1977.5073386666666,15.169622569983105,121,2.900000000000001E-4
7,test_20231031_155037,10863862.png,317432,14697,302735,0.9537003200685501,4,6,66058,2105,63953,0.9681340640043599,23.275838222222223,3117.6927946666665,13.192470415975402,121,2.900000000000001E-4
8,test_20231031_155037,11382381.png,312486,967,311519,0.9969054613646692,2,5,46745,130,46615,0.9972189538988127,21.068341333333333,2406.1475626666665,14.317581029153203,121,2.900000000000001E-4
9,test_20231031_155037,11079715.png,443815,130027,313788,0.7070243231977288,6,7,124136,18094,106042,0.8542405104079397,16.408837333333334,1978.80552,15.166772476828436,121,2.900000000000001E-4
10,test_20231031_155037,11551286.png,271883,1219,270664,0.9955164537687167,3,6,40092,179,39913,0.9955352688815724,16.076115555555557,1539.5683893333332,16.25681375358216,121,2.900000000000001E-4
1,test_20231031_155038,10404007.png,502730,25187,477543,0.949899548465379,4,6,61265,3630,57635,0.9407492042765038,25.12879288888889,3282.03776,12.969367875434926,122,1.0E-5
2,test_20231031_155038,1254659.png,342646,79962,262684,0.7666337853061177,4,6,80080,11106,68974,0.8613136863136863,20.326528,3020.2829653333333,13.330327276703748,122,1.0E-5
3,test_20231031_155038,10188041.png,221231,10484,210747,0.9526106196690337,4,5,41731,1476,40255,0.9646306103376386,10.29104711111111,967.4823253333333,18.274373211101064,122,1.0E-5
4,test_20231031_155038,10287332.png,216980,13317,203663,0.9386256797861554,6,6,22337,1816,20521,0.9186999149393383,9.276503111111111,739.8157706666667,19.43956775926238,122,1.0E-5
5,test_20231031_155038,11610969.png,368720,29517,339203,0.9199473855500109,3,6,84111,4304,79807,0.9488295228923684,19.500469333333335,2542.365472,14.078423791408932,122,1.0E-5
6,test_20231031_155038,10350842.png,212614,7067,205547,0.9667613609640004,2,5,42529,1036,41493,0.9756401514260857,17.272896,1936.234528,15.261224004330279,122,1.0E-5
7,test_20231031_155038,10863862.png,317432,14152,303280,0.955417223216311,3,6,66058,2034,64024,0.9692088770474432,23.416272,3158.1188533333334,13.136518905548746,122,1.0E-5
8,test_20231031_155038,11382381.png,312486,1229,311257,0.9960670238026663,3,6,46745,168,46577,0.9964060327307733,19.73855111111111,2216.4945546666668,14.67413692176443,122,1.0E-5
9,test_20231031_155038,11079715.png,443815,127382,316433,0.7129840136092742,6,7,124136,17736,106400,0.8571244441580202,16.53779911111111,2010.815104,15.097082221479486,122,1.0E-5
10,test_20231031_155038,11551286.png,271883,1442,270441,0.9946962480184491,3,6,40092,212,39880,0.9947121620273371,15.670912,1482.1901333333333,16.421764429459,122,1.0E-5
1,test_20231031_155039,10404007.png,502730,25187,477543,0.949899548465379,3,6,61265,3630,57635,0.9407492042765038,25.12879288888889,3282.03776,12.969367875434926,122,2.0E-5
2,test_20231031_155039,1254659.png,342646,79962,262684,0.7666337853061177,4,6,80080,11106,68974,0.8613136863136863,20.326528,3020.2829653333333,13.330327276703748,122,2.0E-5
3,test_20231031_155039,10188041.png,221231,10484,210747,0.9526106196690337,3,5,41731,1476,40255,0.9646306103376386,10.29104711111111,967.4823253333333,18.274373211101064,122,2.0E-5
4,test_20231031_155039,10287332.png,216980,13317,203663,0.9386256797861554,2,5,22337,1816,20521,0.9186999149393383,9.276503111111111,739.8157706666667,19.43956775926238,122,2.0E-5
5,test_20231031_155039,11610969.png,368720,29517,339203,0.9199473855500109,3,5,84111,4304,79807,0.9488295228923684,19.500469333333335,2542.365472,14.078423791408932,122,2.0E-5
6,test_20231031_155039,10350842.png,212614,7067,205547,0.9667613609640004,3,6,42529,1036,41493,0.9756401514260857,17.272896,1936.234528,15.261224004330279,122,2.0E-5
7,test_20231031_155039,10863862.png,317432,14152,303280,0.955417223216311,3,6,66058,2034,64024,0.9692088770474432,23.416272,3158.1188533333334,13.136518905548746,122,2.0E-5
8,test_20231031_155039,11382381.png,312486,1229,311257,0.9960670238026663,3,6,46745,168,46577,0.9964060327307733,19.73855111111111,2216.4945546666668,14.67413692176443,122,2.0E-5
9,test_20231031_155039,11079715.png,443815,127382,316433,0.7129840136092742,6,7,124136,17736,106400,0.8571244441580202,16.53779911111111,2010.815104,15.097082221479486,122,2.0E-5
10,test_20231031_155039,11551286.png,271883,1442,270441,0.9946962480184491,2,5,40092,212,39880,0.9947121620273371,15.670912,1482.1901333333333,16.421764429459,122,2.0E-5
1,test_20231031_155040,10404007.png,502730,25187,477543,0.949899548465379,4,6,61265,3630,57635,0.9407492042765038,25.12879288888889,3282.03776,12.969367875434926,122,3.0000000000000004E-5
2,test_20231031_155040,1254659.png,342646,79962,262684,0.7666337853061177,5,6,80080,11106,68974,0.8613136863136863,20.326528,3020.2829653333333,13.330327276703748,122,3.0000000000000004E-5
3,test_20231031_155040,10188041.png,221231,10484,210747,0.9526106196690337,3,5,41731,1476,40255,0.9646306103376386,10.29104711111111,967.4823253333333,18.274373211101064,122,3.0000000000000004E-5
4,test_20231031_155040,10287332.png,216980,13317,203663,0.9386256797861554,2,5,22337,1816,20521,0.9186999149393383,9.276503111111111,739.8157706666667,19.43956775926238,122,3.0000000000000004E-5
5,test_20231031_155040,11610969.png,368720,29517,339203,0.9199473855500109,3,5,84111,4304,79807,0.9488295228923684,19.500469333333335,2542.365472,14.078423791408932,122,3.0000000000000004E-5
6,test_20231031_155040,10350842.png,212614,7067,205547,0.9667613609640004,3,6,42529,1036,41493,0.9756401514260857,17.272896,1936.234528,15.261224004330279,122,3.0000000000000004E-5
7,test_20231031_155040,10863862.png,317432,14152,303280,0.955417223216311,3,5,66058,2034,64024,0.9692088770474432,23.416272,3158.1188533333334,13.136518905548746,122,3.0000000000000004E-5
8,test_20231031_155040,11382381.png,312486,1229,311257,0.9960670238026663,3,6,46745,168,46577,0.9964060327307733,19.73855111111111,2216.4945546666668,14.67413692176443,122,3.0000000000000004E-5
9,test_20231031_155040,11079715.png,443815,127382,316433,0.7129840136092742,5,6,124136,17736,106400,0.8571244441580202,16.53779911111111,2010.815104,15.097082221479486,122,3.0000000000000004E-5
10,test_20231031_155040,11551286.png,271883,1442,270441,0.9946962480184491,2,6,40092,212,39880,0.9947121620273371,15.670912,1482.1901333333333,16.421764429459,122,3.0000000000000004E-5
1,test_20231031_155041,10404007.png,502730,25187,477543,0.949899548465379,3,5,61265,3630,57635,0.9407492042765038,25.12879288888889,3282.03776,12.969367875434926,122,4.0E-5
2,test_20231031_155041,1254659.png,342646,79962,262684,0.7666337853061177,4,6,80080,11106,68974,0.8613136863136863,20.326528,3020.2829653333333,13.330327276703748,122,4.0E-5
3,test_20231031_155041,10188041.png,221231,10484,210747,0.9526106196690337,3,6,41731,1476,40255,0.9646306103376386,10.29104711111111,967.4823253333333,18.274373211101064,122,4.0E-5
4,test_20231031_155041,10287332.png,216980,13317,203663,0.9386256797861554,2,5,22337,1816,20521,0.9186999149393383,9.276503111111111,739.8157706666667,19.43956775926238,122,4.0E-5
5,test_20231031_155041,11610969.png,368720,29517,339203,0.9199473855500109,4,5,84111,4304,79807,0.9488295228923684,19.500469333333335,2542.365472,14.078423791408932,122,4.0E-5
6,test_20231031_155041,10350842.png,212614,7067,205547,0.9667613609640004,2,5,42529,1036,41493,0.9756401514260857,17.272896,1936.234528,15.261224004330279,122,4.0E-5
7,test_20231031_155041,10863862.png,317432,14152,303280,0.955417223216311,3,6,66058,2034,64024,0.9692088770474432,23.416272,3158.1188533333334,13.136518905548746,122,4.0E-5
8,test_20231031_155041,11382381.png,312486,1229,311257,0.9960670238026663,3,13,46745,168,46577,0.9964060327307733,19.73855111111111,2216.4945546666668,14.67413692176443,122,4.0E-5
9,test_20231031_155041,11079715.png,443815,127382,316433,0.7129840136092742,6,7,124136,17736,106400,0.8571244441580202,16.53779911111111,2010.815104,15.097082221479486,122,4.0E-5
10,test_20231031_155041,11551286.png,271883,1442,270441,0.9946962480184491,2,5,40092,212,39880,0.9947121620273371,15.670912,1482.1901333333333,16.421764429459,122,4.0E-5
1,test_20231031_155042,10404007.png,502730,25187,477543,0.949899548465379,3,5,61265,3630,57635,0.9407492042765038,25.12879288888889,3282.03776,12.969367875434926,122,5.0E-5
2,test_20231031_155042,1254659.png,342646,79962,262684,0.7666337853061177,5,17,80080,11106,68974,0.8613136863136863,20.326528,3020.2829653333333,13.330327276703748,122,5.0E-5
3,test_20231031_155042,10188041.png,221231,10484,210747,0.9526106196690337,3,6,41731,1476,40255,0.9646306103376386,10.29104711111111,967.4823253333333,18.274373211101064,122,5.0E-5
4,test_20231031_155042,10287332.png,216980,13317,203663,0.9386256797861554,2,6,22337,1816,20521,0.9186999149393383,9.276503111111111,739.8157706666667,19.43956775926238,122,5.0E-5
5,test_20231031_155042,11610969.png,368720,29517,339203,0.9199473855500109,4,6,84111,4304,79807,0.9488295228923684,19.500469333333335,2542.365472,14.078423791408932,122,5.0E-5
6,test_20231031_155042,10350842.png,212614,7067,205547,0.9667613609640004,3,5,42529,1036,41493,0.9756401514260857,17.272896,1936.234528,15.261224004330279,122,5.0E-5
7,test_20231031_155042,10863862.png,317432,14152,303280,0.955417223216311,3,5,66058,2034,64024,0.9692088770474432,23.416272,3158.1188533333334,13.136518905548746,122,5.0E-5
8,test_20231031_155042,11382381.png,312486,1229,311257,0.9960670238026663,3,5,46745,168,46577,0.9964060327307733,19.73855111111111,2216.4945546666668,14.67413692176443,122,5.0E-5
9,test_20231031_155042,11079715.png,443815,127382,316433,0.7129840136092742,6,7,124136,17736,106400,0.8571244441580202,16.53779911111111,2010.815104,15.097082221479486,122,5.0E-5
10,test_20231031_155042,11551286.png,271883,1442,270441,0.9946962480184491,4,6,40092,212,39880,0.9947121620273371,15.670912,1482.1901333333333,16.421764429459,122,5.0E-5
1,test_20231031_155043,10404007.png,502730,25187,477543,0.949899548465379,4,6,61265,3630,57635,0.9407492042765038,25.12879288888889,3282.03776,12.969367875434926,122,6.0E-5
2,test_20231031_155043,1254659.png,342646,79962,262684,0.7666337853061177,4,7,80080,11106,68974,0.8613136863136863,20.326528,3020.2829653333333,13.330327276703748,122,6.0E-5
3,test_20231031_155043,10188041.png,221231,10484,210747,0.9526106196690337,3,6,41731,1476,40255,0.9646306103376386,10.29104711111111,967.4823253333333,18.274373211101064,122,6.0E-5
4,test_20231031_155043,10287332.png,216980,13317,203663,0.9386256797861554,2,6,22337,1816,20521,0.9186999149393383,9.276503111111111,739.8157706666667,19.43956775926238,122,6.0E-5
5,test_20231031_155043,11610969.png,368720,29517,339203,0.9199473855500109,4,5,84111,4304,79807,0.9488295228923684,19.500469333333335,2542.365472,14.078423791408932,122,6.0E-5
6,test_20231031_155043,10350842.png,212614,7067,205547,0.9667613609640004,3,6,42529,1036,41493,0.9756401514260857,17.272896,1936.234528,15.261224004330279,122,6.0E-5
7,test_20231031_155043,10863862.png,317432,14152,303280,0.955417223216311,3,6,66058,2034,64024,0.9692088770474432,23.416272,3158.1188533333334,13.136518905548746,122,6.0E-5
8,test_20231031_155043,11382381.png,312486,1229,311257,0.9960670238026663,3,6,46745,168,46577,0.9964060327307733,19.73855111111111,2216.4945546666668,14.67413692176443,122,6.0E-5
9,test_20231031_155043,11079715.png,443815,127382,316433,0.7129840136092742,7,8,124136,17736,106400,0.8571244441580202,16.53779911111111,2010.815104,15.097082221479486,122,6.0E-5
10,test_20231031_155043,11551286.png,271883,1442,270441,0.9946962480184491,4,10,40092,212,39880,0.9947121620273371,15.670912,1482.1901333333333,16.421764429459,122,6.0E-5
1,test_20231031_155044,10404007.png,502730,25187,477543,0.949899548465379,6,10,61265,3630,57635,0.9407492042765038,25.12879288888889,3282.03776,12.969367875434926,122,7.000000000000001E-5
2,test_20231031_155044,1254659.png,342646,79962,262684,0.7666337853061177,7,8,80080,11106,68974,0.8613136863136863,20.326528,3020.2829653333333,13.330327276703748,122,7.000000000000001E-5
3,test_20231031_155044,10188041.png,221231,10484,210747,0.9526106196690337,3,6,41731,1476,40255,0.9646306103376386,10.29104711111111,967.4823253333333,18.274373211101064,122,7.000000000000001E-5
4,test_20231031_155044,10287332.png,216980,13317,203663,0.9386256797861554,3,6,22337,1816,20521,0.9186999149393383,9.276503111111111,739.8157706666667,19.43956775926238,122,7.000000000000001E-5
5,test_20231031_155044,11610969.png,368720,29517,339203,0.9199473855500109,4,6,84111,4304,79807,0.9488295228923684,19.500469333333335,2542.365472,14.078423791408932,122,7.000000000000001E-5
6,test_20231031_155044,10350842.png,212614,7067,205547,0.9667613609640004,3,6,42529,1036,41493,0.9756401514260857,17.272896,1936.234528,15.261224004330279,122,7.000000000000001E-5
7,test_20231031_155044,10863862.png,317432,14152,303280,0.955417223216311,3,6,66058,2034,64024,0.9692088770474432,23.416272,3158.1188533333334,13.136518905548746,122,7.000000000000001E-5
8,test_20231031_155044,11382381.png,312486,1159,311327,0.996291033838316,3,6,46745,158,46587,0.9966199593539415,20.606709333333335,2334.900224,14.448120340351833,122,7.000000000000001E-5
9,test_20231031_155044,11079715.png,443815,127382,316433,0.7129840136092742,6,7,124136,17736,106400,0.8571244441580202,16.53779911111111,2010.815104,15.097082221479486,122,7.000000000000001E-5
10,test_20231031_155044,11551286.png,271883,1322,270561,0.9951376143414631,2,7,40092,194,39898,0.9951611294023746,15.757246222222221,1488.3021066666668,16.40389264375073,122,7.000000000000001E-5
1,test_20231031_155045,10404007.png,502730,25187,477543,0.949899548465379,5,7,61265,3630,57635,0.9407492042765038,25.12879288888889,3282.03776,12.969367875434926,122,8.0E-5
2,test_20231031_155045,1254659.png,342646,79962,262684,0.7666337853061177,6,9,80080,11106,68974,0.8613136863136863,20.326528,3020.2829653333333,13.330327276703748,122,8.0E-5
3,test_20231031_155045,10188041.png,221231,10484,210747,0.9526106196690337,6,11,41731,1476,40255,0.9646306103376386,10.29104711111111,967.4823253333333,18.274373211101064,122,8.0E-5
4,test_20231031_155045,10287332.png,216980,13317,203663,0.9386256797861554,5,11,22337,1816,20521,0.9186999149393383,9.276503111111111,739.8157706666667,19.43956775926238,122,8.0E-5
5,test_20231031_155045,11610969.png,368720,29517,339203,0.9199473855500109,4,7,84111,4304,79807,0.9488295228923684,19.500469333333335,2542.365472,14.078423791408932,122,8.0E-5
6,test_20231031_155045,10350842.png,212614,7067,205547,0.9667613609640004,3,6,42529,1036,41493,0.9756401514260857,17.272896,1936.234528,15.261224004330279,122,8.0E-5
7,test_20231031_155045,10863862.png,317432,14152,303280,0.955417223216311,4,7,66058,2034,64024,0.9692088770474432,23.416272,3158.1188533333334,13.136518905548746,122,8.0E-5
8,test_20231031_155045,11382381.png,312486,1159,311327,0.996291033838316,4,8,46745,158,46587,0.9966199593539415,20.606709333333335,2334.900224,14.448120340351833,122,8.0E-5
9,test_20231031_155045,11079715.png,443815,127382,316433,0.7129840136092742,10,13,124136,17736,106400,0.8571244441580202,16.53779911111111,2010.815104,15.097082221479486,122,8.0E-5
10,test_20231031_155045,11551286.png,271883,1322,270561,0.9951376143414631,3,9,40092,194,39898,0.9951611294023746,15.757246222222221,1488.3021066666668,16.40389264375073,122,8.0E-5
1,test_20231031_155047,10404007.png,502730,25187,477543,0.949899548465379,5,8,61265,3630,57635,0.9407492042765038,25.12879288888889,3282.03776,12.969367875434926,122,9.0E-5
2,test_20231031_155047,1254659.png,342646,79962,262684,0.7666337853061177,5,7,80080,11106,68974,0.8613136863136863,20.326528,3020.2829653333333,13.330327276703748,122,9.0E-5
3,test_20231031_155047,10188041.png,221231,10484,210747,0.9526106196690337,4,7,41731,1476,40255,0.9646306103376386,10.29104711111111,967.4823253333333,18.274373211101064,122,9.0E-5
4,test_20231031_155047,10287332.png,216980,13317,203663,0.9386256797861554,5,11,22337,1816,20521,0.9186999149393383,9.276503111111111,739.8157706666667,19.43956775926238,122,9.0E-5
5,test_20231031_155047,11610969.png,368720,29517,339203,0.9199473855500109,7,11,84111,4304,79807,0.9488295228923684,19.500469333333335,2542.365472,14.078423791408932,122,9.0E-5
6,test_20231031_155047,10350842.png,212614,7067,205547,0.9667613609640004,5,10,42529,1036,41493,0.9756401514260857,17.272896,1936.234528,15.261224004330279,122,9.0E-5
7,test_20231031_155047,10863862.png,317432,14152,303280,0.955417223216311,5,7,66058,2034,64024,0.9692088770474432,23.416272,3158.1188533333334,13.136518905548746,122,9.0E-5
8,test_20231031_155047,11382381.png,312486,1159,311327,0.996291033838316,3,7,46745,158,46587,0.9966199593539415,20.606709333333335,2334.900224,14.448120340351833,122,9.0E-5
9,test_20231031_155047,11079715.png,443815,127382,316433,0.7129840136092742,8,10,124136,17736,106400,0.8571244441580202,16.53779911111111,2010.815104,15.097082221479486,122,9.0E-5
10,test_20231031_155047,11551286.png,271883,1322,270561,0.9951376143414631,3,6,40092,194,39898,0.9951611294023746,15.757246222222221,1488.3021066666668,16.40389264375073,122,9.0E-5
1,test_20231031_155048,10404007.png,502730,25187,477543,0.949899548465379,4,7,61265,3630,57635,0.9407492042765038,25.12879288888889,3282.03776,12.969367875434926,122,1.0E-4
2,test_20231031_155048,1254659.png,342646,79962,262684,0.7666337853061177,5,7,80080,11106,68974,0.8613136863136863,20.326528,3020.2829653333333,13.330327276703748,122,1.0E-4
3,test_20231031_155048,10188041.png,221231,10484,210747,0.9526106196690337,3,5,41731,1476,40255,0.9646306103376386,10.29104711111111,967.4823253333333,18.274373211101064,122,1.0E-4
4,test_20231031_155048,10287332.png,216980,13317,203663,0.9386256797861554,3,6,22337,1816,20521,0.9186999149393383,9.276503111111111,739.8157706666667,19.43956775926238,122,1.0E-4
5,test_20231031_155048,11610969.png,368720,29517,339203,0.9199473855500109,3,5,84111,4304,79807,0.9488295228923684,19.500469333333335,2542.365472,14.078423791408932,122,1.0E-4
6,test_20231031_155048,10350842.png,212614,7067,205547,0.9667613609640004,3,6,42529,1036,41493,0.9756401514260857,17.272896,1936.234528,15.261224004330279,122,1.0E-4
7,test_20231031_155048,10863862.png,317432,14152,303280,0.955417223216311,3,5,66058,2034,64024,0.9692088770474432,23.416272,3158.1188533333334,13.136518905548746,122,1.0E-4
8,test_20231031_155048,11382381.png,312486,1159,311327,0.996291033838316,2,5,46745,158,46587,0.9966199593539415,20.606709333333335,2334.900224,14.448120340351833,122,1.0E-4
9,test_20231031_155048,11079715.png,443815,127382,316433,0.7129840136092742,6,11,124136,17736,106400,0.8571244441580202,16.53779911111111,2010.815104,15.097082221479486,122,1.0E-4
10,test_20231031_155048,11551286.png,271883,1322,270561,0.9951376143414631,2,6,40092,194,39898,0.9951611294023746,15.757246222222221,1488.3021066666668,16.40389264375073,122,1.0E-4
1,test_20231031_155049,10404007.png,502730,25187,477543,0.949899548465379,4,6,61265,3630,57635,0.9407492042765038,25.12879288888889,3282.03776,12.969367875434926,122,1.1E-4
2,test_20231031_155049,1254659.png,342646,79962,262684,0.7666337853061177,4,7,80080,11106,68974,0.8613136863136863,20.326528,3020.2829653333333,13.330327276703748,122,1.1E-4
3,test_20231031_155049,10188041.png,221231,10484,210747,0.9526106196690337,3,6,41731,1476,40255,0.9646306103376386,10.29104711111111,967.4823253333333,18.274373211101064,122,1.1E-4
4,test_20231031_155049,10287332.png,216980,13317,203663,0.9386256797861554,3,5,22337,1816,20521,0.9186999149393383,9.276503111111111,739.8157706666667,19.43956775926238,122,1.1E-4
5,test_20231031_155049,11610969.png,368720,29517,339203,0.9199473855500109,3,5,84111,4304,79807,0.9488295228923684,19.500469333333335,2542.365472,14.078423791408932,122,1.1E-4
6,test_20231031_155049,10350842.png,212614,7067,205547,0.9667613609640004,2,5,42529,1036,41493,0.9756401514260857,17.272896,1936.234528,15.261224004330279,122,1.1E-4
7,test_20231031_155049,10863862.png,317432,14152,303280,0.955417223216311,4,6,66058,2034,64024,0.9692088770474432,23.416272,3158.1188533333334,13.136518905548746,122,1.1E-4
8,test_20231031_155049,11382381.png,312486,1159,311327,0.996291033838316,3,6,46745,158,46587,0.9966199593539415,20.606709333333335,2334.900224,14.448120340351833,122,1.1E-4
9,test_20231031_155049,11079715.png,443815,127382,316433,0.7129840136092742,5,7,124136,17736,106400,0.8571244441580202,16.53779911111111,2010.815104,15.097082221479486,122,1.1E-4
10,test_20231031_155049,11551286.png,271883,1322,270561,0.9951376143414631,2,5,40092,194,39898,0.9951611294023746,15.757246222222221,1488.3021066666668,16.40389264375073,122,1.1E-4
1,test_20231031_155050,10404007.png,502730,25187,477543,0.949899548465379,4,12,61265,3630,57635,0.9407492042765038,25.12879288888889,3282.03776,12.969367875434926,122,1.2E-4
2,test_20231031_155050,1254659.png,342646,79962,262684,0.7666337853061177,4,6,80080,11106,68974,0.8613136863136863,20.326528,3020.2829653333333,13.330327276703748,122,1.2E-4
3,test_20231031_155050,10188041.png,221231,10484,210747,0.9526106196690337,3,6,41731,1476,40255,0.9646306103376386,10.29104711111111,967.4823253333333,18.274373211101064,122,1.2E-4
4,test_20231031_155050,10287332.png,216980,13317,203663,0.9386256797861554,3,6,22337,1816,20521,0.9186999149393383,9.276503111111111,739.8157706666667,19.43956775926238,122,1.2E-4
5,test_20231031_155050,11610969.png,368720,29517,339203,0.9199473855500109,4,6,84111,4304,79807,0.9488295228923684,19.500469333333335,2542.365472,14.078423791408932,122,1.2E-4
6,test_20231031_155050,10350842.png,212614,7067,205547,0.9667613609640004,2,5,42529,1036,41493,0.9756401514260857,17.272896,1936.234528,15.261224004330279,122,1.2E-4
7,test_20231031_155050,10863862.png,317432,14152,303280,0.955417223216311,3,6,66058,2034,64024,0.9692088770474432,23.416272,3158.1188533333334,13.136518905548746,122,1.2E-4
8,test_20231031_155050,11382381.png,312486,1159,311327,0.996291033838316,2,5,46745,158,46587,0.9966199593539415,20.606709333333335,2334.900224,14.448120340351833,122,1.2E-4
9,test_20231031_155050,11079715.png,443815,127382,316433,0.7129840136092742,5,7,124136,17736,106400,0.8571244441580202,16.53779911111111,2010.815104,15.097082221479486,122,1.2E-4
10,test_20231031_155050,11551286.png,271883,1322,270561,0.9951376143414631,2,5,40092,194,39898,0.9951611294023746,15.757246222222221,1488.3021066666668,16.40389264375073,122,1.2E-4
1,test_20231031_155051,10404007.png,502730,25187,477543,0.949899548465379,4,6,61265,3630,57635,0.9407492042765038,25.12879288888889,3282.03776,12.969367875434926,122,1.3000000000000002E-4
2,test_20231031_155051,1254659.png,342646,79962,262684,0.7666337853061177,11,7,80080,11106,68974,0.8613136863136863,20.326528,3020.2829653333333,13.330327276703748,122,1.3000000000000002E-4
3,test_20231031_155051,10188041.png,221231,10484,210747,0.9526106196690337,3,6,41731,1476,40255,0.9646306103376386,10.29104711111111,967.4823253333333,18.274373211101064,122,1.3000000000000002E-4
4,test_20231031_155051,10287332.png,216980,13317,203663,0.9386256797861554,2,6,22337,1816,20521,0.9186999149393383,9.276503111111111,739.8157706666667,19.43956775926238,122,1.3000000000000002E-4
5,test_20231031_155051,11610969.png,368720,29517,339203,0.9199473855500109,4,6,84111,4304,79807,0.9488295228923684,19.500469333333335,2542.365472,14.078423791408932,122,1.3000000000000002E-4
6,test_20231031_155051,10350842.png,212614,7067,205547,0.9667613609640004,2,5,42529,1036,41493,0.9756401514260857,17.272896,1936.234528,15.261224004330279,122,1.3000000000000002E-4
7,test_20231031_155051,10863862.png,317432,14152,303280,0.955417223216311,3,6,66058,2034,64024,0.9692088770474432,23.416272,3158.1188533333334,13.136518905548746,122,1.3000000000000002E-4
8,test_20231031_155051,11382381.png,312486,1159,311327,0.996291033838316,2,5,46745,158,46587,0.9966199593539415,20.606709333333335,2334.900224,14.448120340351833,122,1.3000000000000002E-4
9,test_20231031_155051,11079715.png,443815,127382,316433,0.7129840136092742,5,6,124136,17736,106400,0.8571244441580202,16.53779911111111,2010.815104,15.097082221479486,122,1.3000000000000002E-4
10,test_20231031_155051,11551286.png,271883,1322,270561,0.9951376143414631,2,5,40092,194,39898,0.9951611294023746,15.757246222222221,1488.3021066666668,16.40389264375073,122,1.3000000000000002E-4
1,test_20231031_155052,10404007.png,502730,25187,477543,0.949899548465379,3,5,61265,3630,57635,0.9407492042765038,25.12879288888889,3282.03776,12.969367875434926,122,1.4000000000000001E-4
2,test_20231031_155052,1254659.png,342646,79962,262684,0.7666337853061177,5,7,80080,11106,68974,0.8613136863136863,20.326528,3020.2829653333333,13.330327276703748,122,1.4000000000000001E-4
3,test_20231031_155052,10188041.png,221231,10484,210747,0.9526106196690337,4,6,41731,1476,40255,0.9646306103376386,10.29104711111111,967.4823253333333,18.274373211101064,122,1.4000000000000001E-4
4,test_20231031_155052,10287332.png,216980,13317,203663,0.9386256797861554,5,6,22337,1816,20521,0.9186999149393383,9.276503111111111,739.8157706666667,19.43956775926238,122,1.4000000000000001E-4
5,test_20231031_155052,11610969.png,368720,29517,339203,0.9199473855500109,4,6,84111,4304,79807,0.9488295228923684,19.500469333333335,2542.365472,14.078423791408932,122,1.4000000000000001E-4
6,test_20231031_155052,10350842.png,212614,7067,205547,0.9667613609640004,3,6,42529,1036,41493,0.9756401514260857,17.272896,1936.234528,15.261224004330279,122,1.4000000000000001E-4
7,test_20231031_155052,10863862.png,317432,14152,303280,0.955417223216311,3,5,66058,2034,64024,0.9692088770474432,23.416272,3158.1188533333334,13.136518905548746,122,1.4000000000000001E-4
8,test_20231031_155052,11382381.png,312486,1159,311327,0.996291033838316,3,6,46745,158,46587,0.9966199593539415,20.606709333333335,2334.900224,14.448120340351833,122,1.4000000000000001E-4
9,test_20231031_155052,11079715.png,443815,127382,316433,0.7129840136092742,5,7,124136,17736,106400,0.8571244441580202,16.53779911111111,2010.815104,15.097082221479486,122,1.4000000000000001E-4
10,test_20231031_155052,11551286.png,271883,1322,270561,0.9951376143414631,3,6,40092,194,39898,0.9951611294023746,15.757246222222221,1488.3021066666668,16.40389264375073,122,1.4000000000000001E-4
1,test_20231031_155054,10404007.png,502730,25187,477543,0.949899548465379,4,6,61265,3630,57635,0.9407492042765038,25.12879288888889,3282.03776,12.969367875434926,122,1.5000000000000001E-4
2,test_20231031_155054,1254659.png,342646,79962,262684,0.7666337853061177,5,12,80080,11106,68974,0.8613136863136863,20.326528,3020.2829653333333,13.330327276703748,122,1.5000000000000001E-4
3,test_20231031_155054,10188041.png,221231,10484,210747,0.9526106196690337,4,6,41731,1476,40255,0.9646306103376386,10.29104711111111,967.4823253333333,18.274373211101064,122,1.5000000000000001E-4
4,test_20231031_155054,10287332.png,216980,13317,203663,0.9386256797861554,3,6,22337,1816,20521,0.9186999149393383,9.276503111111111,739.8157706666667,19.43956775926238,122,1.5000000000000001E-4
5,test_20231031_155054,11610969.png,368720,29517,339203,0.9199473855500109,3,5,84111,4304,79807,0.9488295228923684,19.500469333333335,2542.365472,14.078423791408932,122,1.5000000000000001E-4
6,test_20231031_155054,10350842.png,212614,7067,205547,0.9667613609640004,2,6,42529,1036,41493,0.9756401514260857,17.272896,1936.234528,15.261224004330279,122,1.5000000000000001E-4
7,test_20231031_155054,10863862.png,317432,14152,303280,0.955417223216311,3,5,66058,2034,64024,0.9692088770474432,23.416272,3158.1188533333334,13.136518905548746,122,1.5000000000000001E-4
8,test_20231031_155054,11382381.png,312486,1159,311327,0.996291033838316,2,5,46745,158,46587,0.9966199593539415,20.606709333333335,2334.900224,14.448120340351833,122,1.5000000000000001E-4
9,test_20231031_155054,11079715.png,443815,127382,316433,0.7129840136092742,5,6,124136,17736,106400,0.8571244441580202,16.53779911111111,2010.815104,15.097082221479486,122,1.5000000000000001E-4
10,test_20231031_155054,11551286.png,271883,1322,270561,0.9951376143414631,3,13,40092,194,39898,0.9951611294023746,15.757246222222221,1488.3021066666668,16.40389264375073,122,1.5000000000000001E-4
1,test_20231031_155055,10404007.png,502730,25187,477543,0.949899548465379,4,6,61265,3630,57635,0.9407492042765038,25.12879288888889,3282.03776,12.969367875434926,122,1.6E-4
2,test_20231031_155055,1254659.png,342646,79962,262684,0.7666337853061177,5,6,80080,11106,68974,0.8613136863136863,20.326528,3020.2829653333333,13.330327276703748,122,1.6E-4
3,test_20231031_155055,10188041.png,221231,10484,210747,0.9526106196690337,3,5,41731,1476,40255,0.9646306103376386,10.29104711111111,967.4823253333333,18.274373211101064,122,1.6E-4
4,test_20231031_155055,10287332.png,216980,13087,203893,0.939685685316619,4,6,22337,1789,20548,0.9199086717106146,9.406264888888888,766.5465173333333,19.285418460243026,122,1.6E-4
5,test_20231031_155055,11610969.png,368720,29517,339203,0.9199473855500109,4,6,84111,4304,79807,0.9488295228923684,19.500469333333335,2542.365472,14.078423791408932,122,1.6E-4
6,test_20231031_155055,10350842.png,212614,7067,205547,0.9667613609640004,2,7,42529,1036,41493,0.9756401514260857,17.272896,1936.234528,15.261224004330279,122,1.6E-4
7,test_20231031_155055,10863862.png,317432,14152,303280,0.955417223216311,3,6,66058,2034,64024,0.9692088770474432,23.416272,3158.1188533333334,13.136518905548746,122,1.6E-4
8,test_20231031_155055,11382381.png,312486,1159,311327,0.996291033838316,2,5,46745,158,46587,0.9966199593539415,20.606709333333335,2334.900224,14.448120340351833,122,1.6E-4
9,test_20231031_155055,11079715.png,443815,127382,316433,0.7129840136092742,5,7,124136,17736,106400,0.8571244441580202,16.53779911111111,2010.815104,15.097082221479486,122,1.6E-4
10,test_20231031_155055,11551286.png,271883,1322,270561,0.9951376143414631,2,5,40092,194,39898,0.9951611294023746,15.757246222222221,1488.3021066666668,16.40389264375073,122,1.6E-4
1,test_20231031_155056,10404007.png,502730,25187,477543,0.949899548465379,3,6,61265,3630,57635,0.9407492042765038,25.12879288888889,3282.03776,12.969367875434926,122,1.7E-4
2,test_20231031_155056,1254659.png,342646,79962,262684,0.7666337853061177,5,6,80080,11106,68974,0.8613136863136863,20.326528,3020.2829653333333,13.330327276703748,122,1.7E-4
3,test_20231031_155056,10188041.png,221231,10484,210747,0.9526106196690337,3,6,41731,1476,40255,0.9646306103376386,10.29104711111111,967.4823253333333,18.274373211101064,122,1.7E-4
4,test_20231031_155056,10287332.png,216980,13087,203893,0.939685685316619,3,6,22337,1789,20548,0.9199086717106146,9.406264888888888,766.5465173333333,19.285418460243026,122,1.7E-4
5,test_20231031_155056,11610969.png,368720,29517,339203,0.9199473855500109,3,5,84111,4304,79807,0.9488295228923684,19.500469333333335,2542.365472,14.078423791408932,122,1.7E-4
6,test_20231031_155056,10350842.png,212614,7067,205547,0.9667613609640004,3,6,42529,1036,41493,0.9756401514260857,17.272896,1936.234528,15.261224004330279,122,1.7E-4
7,test_20231031_155056,10863862.png,317432,14152,303280,0.955417223216311,4,6,66058,2034,64024,0.9692088770474432,23.416272,3158.1188533333334,13.136518905548746,122,1.7E-4
8,test_20231031_155056,11382381.png,312486,1159,311327,0.996291033838316,3,6,46745,158,46587,0.9966199593539415,20.606709333333335,2334.900224,14.448120340351833,122,1.7E-4
9,test_20231031_155056,11079715.png,443815,127382,316433,0.7129840136092742,6,7,124136,17736,106400,0.8571244441580202,16.53779911111111,2010.815104,15.097082221479486,122,1.7E-4
10,test_20231031_155056,11551286.png,271883,1322,270561,0.9951376143414631,2,6,40092,194,39898,0.9951611294023746,15.757246222222221,1488.3021066666668,16.40389264375073,122,1.7E-4
1,test_20231031_155057,10404007.png,502730,25187,477543,0.949899548465379,3,5,61265,3630,57635,0.9407492042765038,25.12879288888889,3282.03776,12.969367875434926,122,1.8E-4
2,test_20231031_155057,1254659.png,342646,79962,262684,0.7666337853061177,4,6,80080,11106,68974,0.8613136863136863,20.326528,3020.2829653333333,13.330327276703748,122,1.8E-4
3,test_20231031_155057,10188041.png,221231,10484,210747,0.9526106196690337,4,6,41731,1476,40255,0.9646306103376386,10.29104711111111,967.4823253333333,18.274373211101064,122,1.8E-4
4,test_20231031_155057,10287332.png,216980,13087,203893,0.939685685316619,2,6,22337,1789,20548,0.9199086717106146,9.406264888888888,766.5465173333333,19.285418460243026,122,1.8E-4
5,test_20231031_155057,11610969.png,368720,29517,339203,0.9199473855500109,4,6,84111,4304,79807,0.9488295228923684,19.500469333333335,2542.365472,14.078423791408932,122,1.8E-4
6,test_20231031_155057,10350842.png,212614,7067,205547,0.9667613609640004,2,5,42529,1036,41493,0.9756401514260857,17.272896,1936.234528,15.261224004330279,122,1.8E-4
7,test_20231031_155057,10863862.png,317432,14152,303280,0.955417223216311,3,5,66058,2034,64024,0.9692088770474432,23.416272,3158.1188533333334,13.136518905548746,122,1.8E-4
8,test_20231031_155057,11382381.png,312486,1159,311327,0.996291033838316,3,12,46745,158,46587,0.9966199593539415,20.606709333333335,2334.900224,14.448120340351833,122,1.8E-4
9,test_20231031_155057,11079715.png,443815,127382,316433,0.7129840136092742,5,6,124136,17736,106400,0.8571244441580202,16.53779911111111,2010.815104,15.097082221479486,122,1.8E-4
10,test_20231031_155057,11551286.png,271883,1322,270561,0.9951376143414631,2,6,40092,194,39898,0.9951611294023746,15.757246222222221,1488.3021066666668,16.40389264375073,122,1.8E-4
1,test_20231031_155058,10404007.png,502730,25187,477543,0.949899548465379,3,16,61265,3630,57635,0.9407492042765038,25.12879288888889,3282.03776,12.969367875434926,122,1.9E-4
2,test_20231031_155058,1254659.png,342646,79962,262684,0.7666337853061177,5,6,80080,11106,68974,0.8613136863136863,20.326528,3020.2829653333333,13.330327276703748,122,1.9E-4
3,test_20231031_155058,10188041.png,221231,10484,210747,0.9526106196690337,3,5,41731,1476,40255,0.9646306103376386,10.29104711111111,967.4823253333333,18.274373211101064,122,1.9E-4
4,test_20231031_155058,10287332.png,216980,13087,203893,0.939685685316619,3,11,22337,1789,20548,0.9199086717106146,9.406264888888888,766.5465173333333,19.285418460243026,122,1.9E-4
5,test_20231031_155058,11610969.png,368720,29517,339203,0.9199473855500109,4,7,84111,4304,79807,0.9488295228923684,19.500469333333335,2542.365472,14.078423791408932,122,1.9E-4
6,test_20231031_155058,10350842.png,212614,7067,205547,0.9667613609640004,2,6,42529,1036,41493,0.9756401514260857,17.272896,1936.234528,15.261224004330279,122,1.9E-4
7,test_20231031_155058,10863862.png,317432,14152,303280,0.955417223216311,3,6,66058,2034,64024,0.9692088770474432,23.416272,3158.1188533333334,13.136518905548746,122,1.9E-4
8,test_20231031_155058,11382381.png,312486,1159,311327,0.996291033838316,4,6,46745,158,46587,0.9966199593539415,20.606709333333335,2334.900224,14.448120340351833,122,1.9E-4
9,test_20231031_155058,11079715.png,443815,127382,316433,0.7129840136092742,7,7,124136,17736,106400,0.8571244441580202,16.53779911111111,2010.815104,15.097082221479486,122,1.9E-4
10,test_20231031_155058,11551286.png,271883,1322,270561,0.9951376143414631,3,6,40092,194,39898,0.9951611294023746,15.757246222222221,1488.3021066666668,16.40389264375073,122,1.9E-4
1,test_20231031_155059,10404007.png,502730,25187,477543,0.949899548465379,3,5,61265,3630,57635,0.9407492042765038,25.12879288888889,3282.03776,12.969367875434926,122,2.0E-4
2,test_20231031_155059,1254659.png,342646,79962,262684,0.7666337853061177,5,6,80080,11106,68974,0.8613136863136863,20.326528,3020.2829653333333,13.330327276703748,122,2.0E-4
3,test_20231031_155059,10188041.png,221231,10484,210747,0.9526106196690337,3,5,41731,1476,40255,0.9646306103376386,10.29104711111111,967.4823253333333,18.274373211101064,122,2.0E-4
4,test_20231031_155059,10287332.png,216980,13087,203893,0.939685685316619,3,6,22337,1789,20548,0.9199086717106146,9.406264888888888,766.5465173333333,19.285418460243026,122,2.0E-4
5,test_20231031_155059,11610969.png,368720,29517,339203,0.9199473855500109,3,5,84111,4304,79807,0.9488295228923684,19.500469333333335,2542.365472,14.078423791408932,122,2.0E-4
6,test_20231031_155059,10350842.png,212614,7067,205547,0.9667613609640004,2,5,42529,1036,41493,0.9756401514260857,17.272896,1936.234528,15.261224004330279,122,2.0E-4
7,test_20231031_155059,10863862.png,317432,14152,303280,0.955417223216311,3,5,66058,2034,64024,0.9692088770474432,23.416272,3158.1188533333334,13.136518905548746,122,2.0E-4
8,test_20231031_155059,11382381.png,312486,1159,311327,0.996291033838316,2,5,46745,158,46587,0.9966199593539415,20.606709333333335,2334.900224,14.448120340351833,122,2.0E-4
9,test_20231031_155059,11079715.png,443815,127382,316433,0.7129840136092742,6,7,124136,17736,106400,0.8571244441580202,16.53779911111111,2010.815104,15.097082221479486,122,2.0E-4
10,test_20231031_155059,11551286.png,271883,1322,270561,0.9951376143414631,3,5,40092,194,39898,0.9951611294023746,15.757246222222221,1488.3021066666668,16.40389264375073,122,2.0E-4
1,test_20231031_155100,10404007.png,502730,25187,477543,0.949899548465379,4,6,61265,3630,57635,0.9407492042765038,25.12879288888889,3282.03776,12.969367875434926,122,2.1E-4
2,test_20231031_155100,1254659.png,342646,79962,262684,0.7666337853061177,6,6,80080,11106,68974,0.8613136863136863,20.326528,3020.2829653333333,13.330327276703748,122,2.1E-4
3,test_20231031_155100,10188041.png,221231,10484,210747,0.9526106196690337,4,5,41731,1476,40255,0.9646306103376386,10.29104711111111,967.4823253333333,18.274373211101064,122,2.1E-4
4,test_20231031_155100,10287332.png,216980,13087,203893,0.939685685316619,2,5,22337,1789,20548,0.9199086717106146,9.406264888888888,766.5465173333333,19.285418460243026,122,2.1E-4
5,test_20231031_155100,11610969.png,368720,29517,339203,0.9199473855500109,4,6,84111,4304,79807,0.9488295228923684,19.500469333333335,2542.365472,14.078423791408932,122,2.1E-4
6,test_20231031_155100,10350842.png,212614,7067,205547,0.9667613609640004,3,6,42529,1036,41493,0.9756401514260857,17.272896,1936.234528,15.261224004330279,122,2.1E-4
7,test_20231031_155100,10863862.png,317432,14152,303280,0.955417223216311,3,5,66058,2034,64024,0.9692088770474432,23.416272,3158.1188533333334,13.136518905548746,122,2.1E-4
8,test_20231031_155100,11382381.png,312486,1159,311327,0.996291033838316,2,6,46745,158,46587,0.9966199593539415,20.606709333333335,2334.900224,14.448120340351833,122,2.1E-4
9,test_20231031_155100,11079715.png,443815,127382,316433,0.7129840136092742,5,7,124136,17736,106400,0.8571244441580202,16.53779911111111,2010.815104,15.097082221479486,122,2.1E-4
10,test_20231031_155100,11551286.png,271883,1322,270561,0.9951376143414631,3,6,40092,194,39898,0.9951611294023746,15.757246222222221,1488.3021066666668,16.40389264375073,122,2.1E-4
1,test_20231031_155101,10404007.png,502730,25187,477543,0.949899548465379,4,6,61265,3630,57635,0.9407492042765038,25.12879288888889,3282.03776,12.969367875434926,122,2.2E-4
2,test_20231031_155101,1254659.png,342646,79962,262684,0.7666337853061177,4,6,80080,11106,68974,0.8613136863136863,20.326528,3020.2829653333333,13.330327276703748,122,2.2E-4
3,test_20231031_155101,10188041.png,221231,10484,210747,0.9526106196690337,3,5,41731,1476,40255,0.9646306103376386,10.29104711111111,967.4823253333333,18.274373211101064,122,2.2E-4
4,test_20231031_155101,10287332.png,216980,13087,203893,0.939685685316619,2,5,22337,1789,20548,0.9199086717106146,9.406264888888888,766.5465173333333,19.285418460243026,122,2.2E-4
5,test_20231031_155101,11610969.png,368720,29517,339203,0.9199473855500109,3,5,84111,4304,79807,0.9488295228923684,19.500469333333335,2542.365472,14.078423791408932,122,2.2E-4
6,test_20231031_155101,10350842.png,212614,7067,205547,0.9667613609640004,3,6,42529,1036,41493,0.9756401514260857,17.272896,1936.234528,15.261224004330279,122,2.2E-4
7,test_20231031_155101,10863862.png,317432,14152,303280,0.955417223216311,3,5,66058,2034,64024,0.9692088770474432,23.416272,3158.1188533333334,13.136518905548746,122,2.2E-4
8,test_20231031_155101,11382381.png,312486,1159,311327,0.996291033838316,3,6,46745,158,46587,0.9966199593539415,20.606709333333335,2334.900224,14.448120340351833,122,2.2E-4
9,test_20231031_155101,11079715.png,443815,127382,316433,0.7129840136092742,5,7,124136,17736,106400,0.8571244441580202,16.53779911111111,2010.815104,15.097082221479486,122,2.2E-4
10,test_20231031_155101,11551286.png,271883,1322,270561,0.9951376143414631,2,14,40092,194,39898,0.9951611294023746,15.757246222222221,1488.3021066666668,16.40389264375073,122,2.2E-4
1,test_20231031_155102,10404007.png,502730,25187,477543,0.949899548465379,3,6,61265,3630,57635,0.9407492042765038,25.12879288888889,3282.03776,12.969367875434926,122,2.3E-4
2,test_20231031_155102,1254659.png,342646,79962,262684,0.7666337853061177,5,6,80080,11106,68974,0.8613136863136863,20.326528,3020.2829653333333,13.330327276703748,122,2.3E-4
3,test_20231031_155102,10188041.png,221231,10484,210747,0.9526106196690337,4,6,41731,1476,40255,0.9646306103376386,10.29104711111111,967.4823253333333,18.274373211101064,122,2.3E-4
4,test_20231031_155102,10287332.png,216980,13087,203893,0.939685685316619,3,6,22337,1789,20548,0.9199086717106146,9.406264888888888,766.5465173333333,19.285418460243026,122,2.3E-4
5,test_20231031_155102,11610969.png,368720,29517,339203,0.9199473855500109,4,6,84111,4304,79807,0.9488295228923684,19.500469333333335,2542.365472,14.078423791408932,122,2.3E-4
6,test_20231031_155102,10350842.png,212614,7067,205547,0.9667613609640004,3,6,42529,1036,41493,0.9756401514260857,17.272896,1936.234528,15.261224004330279,122,2.3E-4
7,test_20231031_155102,10863862.png,317432,14152,303280,0.955417223216311,4,6,66058,2034,64024,0.9692088770474432,23.416272,3158.1188533333334,13.136518905548746,122,2.3E-4
8,test_20231031_155102,11382381.png,312486,1159,311327,0.996291033838316,3,6,46745,158,46587,0.9966199593539415,20.606709333333335,2334.900224,14.448120340351833,122,2.3E-4
9,test_20231031_155102,11079715.png,443815,127382,316433,0.7129840136092742,5,7,124136,17736,106400,0.8571244441580202,16.53779911111111,2010.815104,15.097082221479486,122,2.3E-4
10,test_20231031_155102,11551286.png,271883,1322,270561,0.9951376143414631,3,5,40092,194,39898,0.9951611294023746,15.757246222222221,1488.3021066666668,16.40389264375073,122,2.3E-4
1,test_20231031_155103,10404007.png,502730,25187,477543,0.949899548465379,4,6,61265,3630,57635,0.9407492042765038,25.12879288888889,3282.03776,12.969367875434926,122,2.4E-4
2,test_20231031_155103,1254659.png,342646,79962,262684,0.7666337853061177,5,6,80080,11106,68974,0.8613136863136863,20.326528,3020.2829653333333,13.330327276703748,122,2.4E-4
3,test_20231031_155103,10188041.png,221231,10484,210747,0.9526106196690337,3,5,41731,1476,40255,0.9646306103376386,10.29104711111111,967.4823253333333,18.274373211101064,122,2.4E-4
4,test_20231031_155103,10287332.png,216980,13087,203893,0.939685685316619,3,6,22337,1789,20548,0.9199086717106146,9.406264888888888,766.5465173333333,19.285418460243026,122,2.4E-4
5,test_20231031_155103,11610969.png,368720,29517,339203,0.9199473855500109,4,5,84111,4304,79807,0.9488295228923684,19.500469333333335,2542.365472,14.078423791408932,122,2.4E-4
6,test_20231031_155103,10350842.png,212614,7067,205547,0.9667613609640004,2,6,42529,1036,41493,0.9756401514260857,17.272896,1936.234528,15.261224004330279,122,2.4E-4
7,test_20231031_155103,10863862.png,317432,14152,303280,0.955417223216311,4,6,66058,2034,64024,0.9692088770474432,23.416272,3158.1188533333334,13.136518905548746,122,2.4E-4
8,test_20231031_155103,11382381.png,312486,967,311519,0.9969054613646692,3,6,46745,130,46615,0.9972189538988127,21.068341333333333,2406.1475626666665,14.317581029153203,122,2.4E-4
9,test_20231031_155103,11079715.png,443815,127382,316433,0.7129840136092742,6,7,124136,17736,106400,0.8571244441580202,16.53779911111111,2010.815104,15.097082221479486,122,2.4E-4
10,test_20231031_155103,11551286.png,271883,1322,270561,0.9951376143414631,3,6,40092,194,39898,0.9951611294023746,15.757246222222221,1488.3021066666668,16.40389264375073,122,2.4E-4
1,test_20231031_155104,10404007.png,502730,25187,477543,0.949899548465379,4,6,61265,3630,57635,0.9407492042765038,25.12879288888889,3282.03776,12.969367875434926,122,2.5E-4
2,test_20231031_155104,1254659.png,342646,79962,262684,0.7666337853061177,5,6,80080,11106,68974,0.8613136863136863,20.326528,3020.2829653333333,13.330327276703748,122,2.5E-4
3,test_20231031_155104,10188041.png,221231,10484,210747,0.9526106196690337,3,5,41731,1476,40255,0.9646306103376386,10.29104711111111,967.4823253333333,18.274373211101064,122,2.5E-4
4,test_20231031_155104,10287332.png,216980,13087,203893,0.939685685316619,3,5,22337,1789,20548,0.9199086717106146,9.406264888888888,766.5465173333333,19.285418460243026,122,2.5E-4
5,test_20231031_155104,11610969.png,368720,29517,339203,0.9199473855500109,4,6,84111,4304,79807,0.9488295228923684,19.500469333333335,2542.365472,14.078423791408932,122,2.5E-4
6,test_20231031_155104,10350842.png,212614,7067,205547,0.9667613609640004,3,10,42529,1036,41493,0.9756401514260857,17.272896,1936.234528,15.261224004330279,122,2.5E-4
7,test_20231031_155104,10863862.png,317432,14152,303280,0.955417223216311,4,6,66058,2034,64024,0.9692088770474432,23.416272,3158.1188533333334,13.136518905548746,122,2.5E-4
8,test_20231031_155104,11382381.png,312486,967,311519,0.9969054613646692,2,6,46745,130,46615,0.9972189538988127,21.068341333333333,2406.1475626666665,14.317581029153203,122,2.5E-4
9,test_20231031_155104,11079715.png,443815,127382,316433,0.7129840136092742,5,6,124136,17736,106400,0.8571244441580202,16.53779911111111,2010.815104,15.097082221479486,122,2.5E-4
10,test_20231031_155104,11551286.png,271883,1322,270561,0.9951376143414631,3,5,40092,194,39898,0.9951611294023746,15.757246222222221,1488.3021066666668,16.40389264375073,122,2.5E-4
1,test_20231031_155105,10404007.png,502730,24924,477806,0.9504226921011278,4,6,61265,3592,57673,0.9413694605402758,25.162432,3287.893781333333,12.961625820868626,122,2.6000000000000003E-4
2,test_20231031_155105,1254659.png,342646,79902,262744,0.7668088931433608,5,7,80080,11101,68979,0.861376123876124,20.33608177777778,3021.365152,13.328771450566173,122,2.6000000000000003E-4
3,test_20231031_155105,10188041.png,221231,10304,210927,0.9534242488620491,3,6,41731,1450,40281,0.9652536483669215,10.567601777777778,1003.8131733333333,18.114274701111977,122,2.6000000000000003E-4
4,test_20231031_155105,10287332.png,216980,13087,203893,0.939685685316619,3,6,22337,1789,20548,0.9199086717106146,9.406264888888888,766.5465173333333,19.285418460243026,122,2.6000000000000003E-4
5,test_20231031_155105,11610969.png,368720,29457,339263,0.92011011065307,4,6,84111,4297,79814,0.9489127462519765,19.832718222222223,2616.733706666667,13.953208321942551,122,2.6000000000000003E-4
6,test_20231031_155105,10350842.png,212614,6727,205887,0.9683605030712935,3,5,42529,986,41543,0.9768158197935526,18.680309333333334,2252.1961813333332,14.604741430901797,122,2.6000000000000003E-4
7,test_20231031_155105,10863862.png,317432,14072,303360,0.9556692456967162,3,5,66058,2022,64036,0.9693905355899362,23.44550577777778,3163.1715893333335,13.129576095846978,122,2.6000000000000003E-4
8,test_20231031_155105,11382381.png,312486,967,311519,0.9969054613646692,2,5,46745,130,46615,0.9972189538988127,21.068341333333333,2406.1475626666665,14.317581029153203,122,2.6000000000000003E-4
9,test_20231031_155105,11079715.png,443815,127382,316433,0.7129840136092742,6,7,124136,17736,106400,0.8571244441580202,16.53779911111111,2010.815104,15.097082221479486,122,2.6000000000000003E-4
10,test_20231031_155105,11551286.png,271883,1159,270724,0.9957371369302237,2,6,40092,170,39922,0.9957597525690911,16.782250666666666,1659.7933333333333,15.930263449847823,122,2.6000000000000003E-4
1,test_20231031_155106,10404007.png,502730,24924,477806,0.9504226921011278,4,6,61265,3592,57673,0.9413694605402758,25.162432,3287.893781333333,12.961625820868626,122,2.7000000000000006E-4
2,test_20231031_155106,1254659.png,342646,79902,262744,0.7668088931433608,5,6,80080,11101,68979,0.861376123876124,20.33608177777778,3021.365152,13.328771450566173,122,2.7000000000000006E-4
3,test_20231031_155106,10188041.png,221231,10304,210927,0.9534242488620491,3,6,41731,1450,40281,0.9652536483669215,10.567601777777778,1003.8131733333333,18.114274701111977,122,2.7000000000000006E-4
4,test_20231031_155106,10287332.png,216980,13087,203893,0.939685685316619,2,6,22337,1789,20548,0.9199086717106146,9.406264888888888,766.5465173333333,19.285418460243026,122,2.7000000000000006E-4
5,test_20231031_155106,11610969.png,368720,29457,339263,0.92011011065307,4,5,84111,4297,79814,0.9489127462519765,19.832718222222223,2616.733706666667,13.953208321942551,122,2.7000000000000006E-4
6,test_20231031_155106,10350842.png,212614,6727,205887,0.9683605030712935,2,6,42529,986,41543,0.9768158197935526,18.680309333333334,2252.1961813333332,14.604741430901797,122,2.7000000000000006E-4
7,test_20231031_155106,10863862.png,317432,14072,303360,0.9556692456967162,3,5,66058,2022,64036,0.9693905355899362,23.44550577777778,3163.1715893333335,13.129576095846978,122,2.7000000000000006E-4
8,test_20231031_155106,11382381.png,312486,967,311519,0.9969054613646692,3,6,46745,130,46615,0.9972189538988127,21.068341333333333,2406.1475626666665,14.317581029153203,122,2.7000000000000006E-4
9,test_20231031_155106,11079715.png,443815,127382,316433,0.7129840136092742,5,7,124136,17736,106400,0.8571244441580202,16.53779911111111,2010.815104,15.097082221479486,122,2.7000000000000006E-4
10,test_20231031_155106,11551286.png,271883,1159,270724,0.9957371369302237,2,5,40092,170,39922,0.9957597525690911,16.782250666666666,1659.7933333333333,15.930263449847823,122,2.7000000000000006E-4
1,test_20231031_155107,10404007.png,502730,24924,477806,0.9504226921011278,4,6,61265,3592,57673,0.9413694605402758,25.162432,3287.893781333333,12.961625820868626,122,2.800000000000001E-4
2,test_20231031_155107,1254659.png,342646,79902,262744,0.7668088931433608,5,6,80080,11101,68979,0.861376123876124,20.33608177777778,3021.365152,13.328771450566173,122,2.800000000000001E-4
3,test_20231031_155107,10188041.png,221231,10304,210927,0.9534242488620491,3,5,41731,1450,40281,0.9652536483669215,10.567601777777778,1003.8131733333333,18.114274701111977,122,2.800000000000001E-4
4,test_20231031_155107,10287332.png,216980,13087,203893,0.939685685316619,3,6,22337,1789,20548,0.9199086717106146,9.406264888888888,766.5465173333333,19.285418460243026,122,2.800000000000001E-4
5,test_20231031_155107,11610969.png,368720,29457,339263,0.92011011065307,4,6,84111,4297,79814,0.9489127462519765,19.832718222222223,2616.733706666667,13.953208321942551,122,2.800000000000001E-4
6,test_20231031_155107,10350842.png,212614,6727,205887,0.9683605030712935,2,6,42529,986,41543,0.9768158197935526,18.680309333333334,2252.1961813333332,14.604741430901797,122,2.800000000000001E-4
7,test_20231031_155107,10863862.png,317432,14072,303360,0.9556692456967162,3,5,66058,2022,64036,0.9693905355899362,23.44550577777778,3163.1715893333335,13.129576095846978,122,2.800000000000001E-4
8,test_20231031_155107,11382381.png,312486,967,311519,0.9969054613646692,2,5,46745,130,46615,0.9972189538988127,21.068341333333333,2406.1475626666665,14.317581029153203,122,2.800000000000001E-4
9,test_20231031_155107,11079715.png,443815,127382,316433,0.7129840136092742,9,6,124136,17736,106400,0.8571244441580202,16.53779911111111,2010.815104,15.097082221479486,122,2.800000000000001E-4
10,test_20231031_155107,11551286.png,271883,1159,270724,0.9957371369302237,3,7,40092,170,39922,0.9957597525690911,16.782250666666666,1659.7933333333333,15.930263449847823,122,2.800000000000001E-4
1,test_20231031_155108,10404007.png,502730,24924,477806,0.9504226921011278,4,7,61265,3592,57673,0.9413694605402758,25.162432,3287.893781333333,12.961625820868626,122,2.900000000000001E-4
2,test_20231031_155108,1254659.png,342646,79902,262744,0.7668088931433608,5,6,80080,11101,68979,0.861376123876124,20.33608177777778,3021.365152,13.328771450566173,122,2.900000000000001E-4
3,test_20231031_155108,10188041.png,221231,10304,210927,0.9534242488620491,3,5,41731,1450,40281,0.9652536483669215,10.567601777777778,1003.8131733333333,18.114274701111977,122,2.900000000000001E-4
4,test_20231031_155108,10287332.png,216980,13087,203893,0.939685685316619,2,6,22337,1789,20548,0.9199086717106146,9.406264888888888,766.5465173333333,19.285418460243026,122,2.900000000000001E-4
5,test_20231031_155108,11610969.png,368720,29457,339263,0.92011011065307,4,6,84111,4297,79814,0.9489127462519765,19.832718222222223,2616.733706666667,13.953208321942551,122,2.900000000000001E-4
6,test_20231031_155108,10350842.png,212614,6727,205887,0.9683605030712935,2,7,42529,986,41543,0.9768158197935526,18.680309333333334,2252.1961813333332,14.604741430901797,122,2.900000000000001E-4
7,test_20231031_155108,10863862.png,317432,14072,303360,0.9556692456967162,3,5,66058,2022,64036,0.9693905355899362,23.44550577777778,3163.1715893333335,13.129576095846978,122,2.900000000000001E-4
8,test_20231031_155108,11382381.png,312486,967,311519,0.9969054613646692,2,6,46745,130,46615,0.9972189538988127,21.068341333333333,2406.1475626666665,14.317581029153203,122,2.900000000000001E-4
9,test_20231031_155108,11079715.png,443815,127382,316433,0.7129840136092742,5,7,124136,17736,106400,0.8571244441580202,16.53779911111111,2010.815104,15.097082221479486,122,2.900000000000001E-4
10,test_20231031_155108,11551286.png,271883,847,271036,0.9968846893700599,3,6,40092,124,39968,0.9969071136386312,17.065274666666667,1704.2078666666666,15.81557795178707,122,2.900000000000001E-4
1,test_20231031_155109,10404007.png,502730,24182,478548,0.9518986334613013,3,5,61265,3483,57782,0.9431486166653065,25.191109333333333,3298.676826666667,12.947405913275208,123,1.0E-5
2,test_20231031_155109,1254659.png,342646,78072,264574,0.7721496821792754,5,7,80080,10861,69219,0.8643731268731268,20.51848177777778,3069.789525333333,13.259717609997972,123,1.0E-5
3,test_20231031_155109,10188041.png,221231,10202,211029,0.9538853054047579,3,7,41731,1437,40294,0.9655651673815628,10.472250666666667,996.2625973333334,18.147065349528113,123,1.0E-5
4,test_20231031_155109,10287332.png,216980,12977,204003,0.9401926444833625,3,5,22337,1774,20563,0.9205802032502126,9.307064888888888,748.7130986666666,19.387649297314677,123,1.0E-5
5,test_20231031_155109,11610969.png,368720,28492,340228,0.9227272727272727,4,6,84111,4156,79955,0.9505891024955119,19.969996444444444,2649.321978666667,13.899456184782972,123,1.0E-5
6,test_20231031_155109,10350842.png,212614,6887,205727,0.967607965609038,2,5,42529,1009,41520,0.9762750123445179,17.477884444444445,1977.0087253333334,15.170717748340774,123,1.0E-5
7,test_20231031_155109,10863862.png,317432,13337,304095,0.9579847022354394,3,6,66058,1928,64130,0.9708135275061309,23.652634666666668,3218.7282186666666,13.053960533703744,123,1.0E-5
8,test_20231031_155109,11382381.png,312486,1229,311257,0.9960670238026663,3,6,46745,168,46577,0.9964060327307733,19.73855111111111,2216.4945546666668,14.67413692176443,123,1.0E-5
9,test_20231031_155109,11079715.png,443815,125192,318623,0.7179185020785688,5,7,124136,17444,106692,0.8594767029709351,16.64877511111111,2039.7730453333334,15.034985123844537,123,1.0E-5
10,test_20231031_155109,11551286.png,271883,1322,270561,0.9951376143414631,3,6,40092,194,39898,0.9951611294023746,15.753514666666666,1496.8890666666666,16.378907445727467,123,1.0E-5
1,test_20231031_155110,10404007.png,502730,24182,478548,0.9518986334613013,4,6,61265,3483,57782,0.9431486166653065,25.191109333333333,3298.676826666667,12.947405913275208,123,2.0E-5
2,test_20231031_155110,1254659.png,342646,78072,264574,0.7721496821792754,4,6,80080,10861,69219,0.8643731268731268,20.51848177777778,3069.789525333333,13.259717609997972,123,2.0E-5
3,test_20231031_155110,10188041.png,221231,10202,211029,0.9538853054047579,4,5,41731,1437,40294,0.9655651673815628,10.472250666666667,996.2625973333334,18.147065349528113,123,2.0E-5
4,test_20231031_155110,10287332.png,216980,12977,204003,0.9401926444833625,3,5,22337,1774,20563,0.9205802032502126,9.307064888888888,748.7130986666666,19.387649297314677,123,2.0E-5
5,test_20231031_155110,11610969.png,368720,28492,340228,0.9227272727272727,4,5,84111,4156,79955,0.9505891024955119,19.969996444444444,2649.321978666667,13.899456184782972,123,2.0E-5
6,test_20231031_155110,10350842.png,212614,6887,205727,0.967607965609038,2,6,42529,1009,41520,0.9762750123445179,17.477884444444445,1977.0087253333334,15.170717748340774,123,2.0E-5
7,test_20231031_155110,10863862.png,317432,13337,304095,0.9579847022354394,3,6,66058,1928,64130,0.9708135275061309,23.652634666666668,3218.7282186666666,13.053960533703744,123,2.0E-5
8,test_20231031_155110,11382381.png,312486,1229,311257,0.9960670238026663,3,6,46745,168,46577,0.9964060327307733,19.73855111111111,2216.4945546666668,14.67413692176443,123,2.0E-5
9,test_20231031_155110,11079715.png,443815,125192,318623,0.7179185020785688,6,7,124136,17444,106692,0.8594767029709351,16.64877511111111,2039.7730453333334,15.034985123844537,123,2.0E-5
10,test_20231031_155110,11551286.png,271883,1322,270561,0.9951376143414631,2,5,40092,194,39898,0.9951611294023746,15.753514666666666,1496.8890666666666,16.378907445727467,123,2.0E-5
1,test_20231031_155111,10404007.png,502730,24182,478548,0.9518986334613013,3,5,61265,3483,57782,0.9431486166653065,25.191109333333333,3298.676826666667,12.947405913275208,123,3.0000000000000004E-5
2,test_20231031_155111,1254659.png,342646,78072,264574,0.7721496821792754,5,6,80080,10861,69219,0.8643731268731268,20.51848177777778,3069.789525333333,13.259717609997972,123,3.0000000000000004E-5
3,test_20231031_155111,10188041.png,221231,10202,211029,0.9538853054047579,3,5,41731,1437,40294,0.9655651673815628,10.472250666666667,996.2625973333334,18.147065349528113,123,3.0000000000000004E-5
4,test_20231031_155111,10287332.png,216980,12977,204003,0.9401926444833625,5,6,22337,1774,20563,0.9205802032502126,9.307064888888888,748.7130986666666,19.387649297314677,123,3.0000000000000004E-5
5,test_20231031_155111,11610969.png,368720,28492,340228,0.9227272727272727,5,9,84111,4156,79955,0.9505891024955119,19.969996444444444,2649.321978666667,13.899456184782972,123,3.0000000000000004E-5
6,test_20231031_155111,10350842.png,212614,6887,205727,0.967607965609038,2,6,42529,1009,41520,0.9762750123445179,17.477884444444445,1977.0087253333334,15.170717748340774,123,3.0000000000000004E-5
7,test_20231031_155111,10863862.png,317432,13337,304095,0.9579847022354394,3,5,66058,1928,64130,0.9708135275061309,23.652634666666668,3218.7282186666666,13.053960533703744,123,3.0000000000000004E-5
8,test_20231031_155111,11382381.png,312486,1229,311257,0.9960670238026663,3,6,46745,168,46577,0.9964060327307733,19.73855111111111,2216.4945546666668,14.67413692176443,123,3.0000000000000004E-5
9,test_20231031_155111,11079715.png,443815,125192,318623,0.7179185020785688,6,8,124136,17444,106692,0.8594767029709351,16.64877511111111,2039.7730453333334,15.034985123844537,123,3.0000000000000004E-5
10,test_20231031_155111,11551286.png,271883,1322,270561,0.9951376143414631,3,6,40092,194,39898,0.9951611294023746,15.753514666666666,1496.8890666666666,16.378907445727467,123,3.0000000000000004E-5
1,test_20231031_155112,10404007.png,502730,24182,478548,0.9518986334613013,3,6,61265,3483,57782,0.9431486166653065,25.191109333333333,3298.676826666667,12.947405913275208,123,4.0E-5
2,test_20231031_155112,1254659.png,342646,78072,264574,0.7721496821792754,5,6,80080,10861,69219,0.8643731268731268,20.51848177777778,3069.789525333333,13.259717609997972,123,4.0E-5
3,test_20231031_155112,10188041.png,221231,10202,211029,0.9538853054047579,3,15,41731,1437,40294,0.9655651673815628,10.472250666666667,996.2625973333334,18.147065349528113,123,4.0E-5
4,test_20231031_155112,10287332.png,216980,12977,204003,0.9401926444833625,3,6,22337,1774,20563,0.9205802032502126,9.307064888888888,748.7130986666666,19.387649297314677,123,4.0E-5
5,test_20231031_155112,11610969.png,368720,28492,340228,0.9227272727272727,3,6,84111,4156,79955,0.9505891024955119,19.969996444444444,2649.321978666667,13.899456184782972,123,4.0E-5
6,test_20231031_155112,10350842.png,212614,6887,205727,0.967607965609038,3,6,42529,1009,41520,0.9762750123445179,17.477884444444445,1977.0087253333334,15.170717748340774,123,4.0E-5
7,test_20231031_155112,10863862.png,317432,13337,304095,0.9579847022354394,3,5,66058,1928,64130,0.9708135275061309,23.652634666666668,3218.7282186666666,13.053960533703744,123,4.0E-5
8,test_20231031_155112,11382381.png,312486,1229,311257,0.9960670238026663,3,5,46745,168,46577,0.9964060327307733,19.73855111111111,2216.4945546666668,14.67413692176443,123,4.0E-5
9,test_20231031_155112,11079715.png,443815,125192,318623,0.7179185020785688,5,6,124136,17444,106692,0.8594767029709351,16.64877511111111,2039.7730453333334,15.034985123844537,123,4.0E-5
10,test_20231031_155112,11551286.png,271883,1322,270561,0.9951376143414631,3,6,40092,194,39898,0.9951611294023746,15.753514666666666,1496.8890666666666,16.378907445727467,123,4.0E-5
1,test_20231031_155113,10404007.png,502730,24182,478548,0.9518986334613013,4,6,61265,3483,57782,0.9431486166653065,25.191109333333333,3298.676826666667,12.947405913275208,123,5.0E-5
2,test_20231031_155113,1254659.png,342646,78072,264574,0.7721496821792754,5,6,80080,10861,69219,0.8643731268731268,20.51848177777778,3069.789525333333,13.259717609997972,123,5.0E-5
3,test_20231031_155113,10188041.png,221231,10202,211029,0.9538853054047579,3,5,41731,1437,40294,0.9655651673815628,10.472250666666667,996.2625973333334,18.147065349528113,123,5.0E-5
4,test_20231031_155113,10287332.png,216980,12977,204003,0.9401926444833625,2,5,22337,1774,20563,0.9205802032502126,9.307064888888888,748.7130986666666,19.387649297314677,123,5.0E-5
5,test_20231031_155113,11610969.png,368720,28492,340228,0.9227272727272727,3,6,84111,4156,79955,0.9505891024955119,19.969996444444444,2649.321978666667,13.899456184782972,123,5.0E-5
6,test_20231031_155113,10350842.png,212614,6887,205727,0.967607965609038,2,5,42529,1009,41520,0.9762750123445179,17.477884444444445,1977.0087253333334,15.170717748340774,123,5.0E-5
7,test_20231031_155113,10863862.png,317432,13337,304095,0.9579847022354394,3,6,66058,1928,64130,0.9708135275061309,23.652634666666668,3218.7282186666666,13.053960533703744,123,5.0E-5
8,test_20231031_155113,11382381.png,312486,1159,311327,0.996291033838316,2,5,46745,158,46587,0.9966199593539415,20.606709333333335,2334.900224,14.448120340351833,123,5.0E-5
9,test_20231031_155113,11079715.png,443815,125192,318623,0.7179185020785688,6,7,124136,17444,106692,0.8594767029709351,16.64877511111111,2039.7730453333334,15.034985123844537,123,5.0E-5
10,test_20231031_155113,11551286.png,271883,1322,270561,0.9951376143414631,2,5,40092,194,39898,0.9951611294023746,15.753514666666666,1496.8890666666666,16.378907445727467,123,5.0E-5
1,test_20231031_155114,10404007.png,502730,24182,478548,0.9518986334613013,4,6,61265,3483,57782,0.9431486166653065,25.191109333333333,3298.676826666667,12.947405913275208,123,6.0E-5
2,test_20231031_155114,1254659.png,342646,78072,264574,0.7721496821792754,4,7,80080,10861,69219,0.8643731268731268,20.51848177777778,3069.789525333333,13.259717609997972,123,6.0E-5
3,test_20231031_155114,10188041.png,221231,10202,211029,0.9538853054047579,3,5,41731,1437,40294,0.9655651673815628,10.472250666666667,996.2625973333334,18.147065349528113,123,6.0E-5
4,test_20231031_155114,10287332.png,216980,12977,204003,0.9401926444833625,3,6,22337,1774,20563,0.9205802032502126,9.307064888888888,748.7130986666666,19.387649297314677,123,6.0E-5
5,test_20231031_155114,11610969.png,368720,28492,340228,0.9227272727272727,4,5,84111,4156,79955,0.9505891024955119,19.969996444444444,2649.321978666667,13.899456184782972,123,6.0E-5
6,test_20231031_155114,10350842.png,212614,6887,205727,0.967607965609038,2,5,42529,1009,41520,0.9762750123445179,17.477884444444445,1977.0087253333334,15.170717748340774,123,6.0E-5
7,test_20231031_155114,10863862.png,317432,13337,304095,0.9579847022354394,4,6,66058,1928,64130,0.9708135275061309,23.652634666666668,3218.7282186666666,13.053960533703744,123,6.0E-5
8,test_20231031_155114,11382381.png,312486,1159,311327,0.996291033838316,2,5,46745,158,46587,0.9966199593539415,20.606709333333335,2334.900224,14.448120340351833,123,6.0E-5
9,test_20231031_155114,11079715.png,443815,125192,318623,0.7179185020785688,6,7,124136,17444,106692,0.8594767029709351,16.64877511111111,2039.7730453333334,15.034985123844537,123,6.0E-5
10,test_20231031_155114,11551286.png,271883,1322,270561,0.9951376143414631,3,6,40092,194,39898,0.9951611294023746,15.753514666666666,1496.8890666666666,16.378907445727467,123,6.0E-5
1,test_20231031_155115,10404007.png,502730,24182,478548,0.9518986334613013,3,6,61265,3483,57782,0.9431486166653065,25.191109333333333,3298.676826666667,12.947405913275208,123,7.000000000000001E-5
2,test_20231031_155115,1254659.png,342646,78072,264574,0.7721496821792754,5,7,80080,10861,69219,0.8643731268731268,20.51848177777778,3069.789525333333,13.259717609997972,123,7.000000000000001E-5
3,test_20231031_155115,10188041.png,221231,10202,211029,0.9538853054047579,3,6,41731,1437,40294,0.9655651673815628,10.472250666666667,996.2625973333334,18.147065349528113,123,7.000000000000001E-5
4,test_20231031_155115,10287332.png,216980,12977,204003,0.9401926444833625,2,5,22337,1774,20563,0.9205802032502126,9.307064888888888,748.7130986666666,19.387649297314677,123,7.000000000000001E-5
5,test_20231031_155115,11610969.png,368720,28492,340228,0.9227272727272727,4,5,84111,4156,79955,0.9505891024955119,19.969996444444444,2649.321978666667,13.899456184782972,123,7.000000000000001E-5
6,test_20231031_155115,10350842.png,212614,6887,205727,0.967607965609038,2,6,42529,1009,41520,0.9762750123445179,17.477884444444445,1977.0087253333334,15.170717748340774,123,7.000000000000001E-5
7,test_20231031_155115,10863862.png,317432,13337,304095,0.9579847022354394,3,5,66058,1928,64130,0.9708135275061309,23.652634666666668,3218.7282186666666,13.053960533703744,123,7.000000000000001E-5
8,test_20231031_155115,11382381.png,312486,1159,311327,0.996291033838316,3,6,46745,158,46587,0.9966199593539415,20.606709333333335,2334.900224,14.448120340351833,123,7.000000000000001E-5
9,test_20231031_155115,11079715.png,443815,125192,318623,0.7179185020785688,6,7,124136,17444,106692,0.8594767029709351,16.64877511111111,2039.7730453333334,15.034985123844537,123,7.000000000000001E-5
10,test_20231031_155115,11551286.png,271883,1199,270684,0.9955900148225524,2,6,40092,176,39916,0.995610096777412,15.83984888888889,1503.00104,16.36121079771285,123,7.000000000000001E-5
1,test_20231031_155116,10404007.png,502730,24182,478548,0.9518986334613013,4,6,61265,3483,57782,0.9431486166653065,25.191109333333333,3298.676826666667,12.947405913275208,123,8.0E-5
2,test_20231031_155116,1254659.png,342646,78072,264574,0.7721496821792754,5,6,80080,10861,69219,0.8643731268731268,20.51848177777778,3069.789525333333,13.259717609997972,123,8.0E-5
3,test_20231031_155116,10188041.png,221231,10202,211029,0.9538853054047579,3,5,41731,1437,40294,0.9655651673815628,10.472250666666667,996.2625973333334,18.147065349528113,123,8.0E-5
4,test_20231031_155116,10287332.png,216980,12977,204003,0.9401926444833625,3,6,22337,1774,20563,0.9205802032502126,9.307064888888888,748.7130986666666,19.387649297314677,123,8.0E-5
5,test_20231031_155116,11610969.png,368720,28492,340228,0.9227272727272727,4,6,84111,4156,79955,0.9505891024955119,19.969996444444444,2649.321978666667,13.899456184782972,123,8.0E-5
6,test_20231031_155116,10350842.png,212614,6887,205727,0.967607965609038,3,6,42529,1009,41520,0.9762750123445179,17.477884444444445,1977.0087253333334,15.170717748340774,123,8.0E-5
7,test_20231031_155116,10863862.png,317432,13337,304095,0.9579847022354394,3,5,66058,1928,64130,0.9708135275061309,23.652634666666668,3218.7282186666666,13.053960533703744,123,8.0E-5
8,test_20231031_155116,11382381.png,312486,1159,311327,0.996291033838316,4,6,46745,158,46587,0.9966199593539415,20.606709333333335,2334.900224,14.448120340351833,123,8.0E-5
9,test_20231031_155116,11079715.png,443815,125192,318623,0.7179185020785688,5,7,124136,17444,106692,0.8594767029709351,16.64877511111111,2039.7730453333334,15.034985123844537,123,8.0E-5
10,test_20231031_155116,11551286.png,271883,1199,270684,0.9955900148225524,2,6,40092,176,39916,0.995610096777412,15.83984888888889,1503.00104,16.36121079771285,123,8.0E-5
1,test_20231031_155117,10404007.png,502730,24182,478548,0.9518986334613013,4,34,61265,3483,57782,0.9431486166653065,25.191109333333333,3298.676826666667,12.947405913275208,123,9.0E-5
2,test_20231031_155117,1254659.png,342646,78072,264574,0.7721496821792754,4,6,80080,10861,69219,0.8643731268731268,20.51848177777778,3069.789525333333,13.259717609997972,123,9.0E-5
3,test_20231031_155117,10188041.png,221231,10202,211029,0.9538853054047579,3,6,41731,1437,40294,0.9655651673815628,10.472250666666667,996.2625973333334,18.147065349528113,123,9.0E-5
4,test_20231031_155117,10287332.png,216980,12977,204003,0.9401926444833625,3,6,22337,1774,20563,0.9205802032502126,9.307064888888888,748.7130986666666,19.387649297314677,123,9.0E-5
5,test_20231031_155117,11610969.png,368720,28492,340228,0.9227272727272727,3,5,84111,4156,79955,0.9505891024955119,19.969996444444444,2649.321978666667,13.899456184782972,123,9.0E-5
6,test_20231031_155117,10350842.png,212614,6887,205727,0.967607965609038,2,5,42529,1009,41520,0.9762750123445179,17.477884444444445,1977.0087253333334,15.170717748340774,123,9.0E-5
7,test_20231031_155117,10863862.png,317432,13337,304095,0.9579847022354394,3,5,66058,1928,64130,0.9708135275061309,23.652634666666668,3218.7282186666666,13.053960533703744,123,9.0E-5
8,test_20231031_155117,11382381.png,312486,1159,311327,0.996291033838316,3,6,46745,158,46587,0.9966199593539415,20.606709333333335,2334.900224,14.448120340351833,123,9.0E-5
9,test_20231031_155117,11079715.png,443815,125192,318623,0.7179185020785688,5,7,124136,17444,106692,0.8594767029709351,16.64877511111111,2039.7730453333334,15.034985123844537,123,9.0E-5
10,test_20231031_155117,11551286.png,271883,1199,270684,0.9955900148225524,3,6,40092,176,39916,0.995610096777412,15.83984888888889,1503.00104,16.36121079771285,123,9.0E-5
1,test_20231031_155118,10404007.png,502730,24182,478548,0.9518986334613013,4,5,61265,3483,57782,0.9431486166653065,25.191109333333333,3298.676826666667,12.947405913275208,123,1.0E-4
2,test_20231031_155118,1254659.png,342646,78072,264574,0.7721496821792754,5,6,80080,10861,69219,0.8643731268731268,20.51848177777778,3069.789525333333,13.259717609997972,123,1.0E-4
3,test_20231031_155118,10188041.png,221231,10202,211029,0.9538853054047579,4,6,41731,1437,40294,0.9655651673815628,10.472250666666667,996.2625973333334,18.147065349528113,123,1.0E-4
4,test_20231031_155118,10287332.png,216980,12977,204003,0.9401926444833625,3,5,22337,1774,20563,0.9205802032502126,9.307064888888888,748.7130986666666,19.387649297314677,123,1.0E-4
5,test_20231031_155118,11610969.png,368720,28492,340228,0.9227272727272727,4,7,84111,4156,79955,0.9505891024955119,19.969996444444444,2649.321978666667,13.899456184782972,123,1.0E-4
6,test_20231031_155118,10350842.png,212614,6887,205727,0.967607965609038,2,5,42529,1009,41520,0.9762750123445179,17.477884444444445,1977.0087253333334,15.170717748340774,123,1.0E-4
7,test_20231031_155118,10863862.png,317432,13337,304095,0.9579847022354394,3,6,66058,1928,64130,0.9708135275061309,23.652634666666668,3218.7282186666666,13.053960533703744,123,1.0E-4
8,test_20231031_155118,11382381.png,312486,1159,311327,0.996291033838316,3,6,46745,158,46587,0.9966199593539415,20.606709333333335,2334.900224,14.448120340351833,123,1.0E-4
9,test_20231031_155118,11079715.png,443815,125192,318623,0.7179185020785688,5,7,124136,17444,106692,0.8594767029709351,16.64877511111111,2039.7730453333334,15.034985123844537,123,1.0E-4
10,test_20231031_155118,11551286.png,271883,1199,270684,0.9955900148225524,2,6,40092,176,39916,0.995610096777412,15.83984888888889,1503.00104,16.36121079771285,123,1.0E-4
1,test_20231031_155120,10404007.png,502730,24182,478548,0.9518986334613013,4,6,61265,3483,57782,0.9431486166653065,25.191109333333333,3298.676826666667,12.947405913275208,123,1.1E-4
2,test_20231031_155120,1254659.png,342646,78072,264574,0.7721496821792754,5,7,80080,10861,69219,0.8643731268731268,20.51848177777778,3069.789525333333,13.259717609997972,123,1.1E-4
3,test_20231031_155120,10188041.png,221231,10202,211029,0.9538853054047579,3,5,41731,1437,40294,0.9655651673815628,10.472250666666667,996.2625973333334,18.147065349528113,123,1.1E-4
4,test_20231031_155120,10287332.png,216980,12977,204003,0.9401926444833625,3,6,22337,1774,20563,0.9205802032502126,9.307064888888888,748.7130986666666,19.387649297314677,123,1.1E-4
5,test_20231031_155120,11610969.png,368720,28492,340228,0.9227272727272727,4,6,84111,4156,79955,0.9505891024955119,19.969996444444444,2649.321978666667,13.899456184782972,123,1.1E-4
6,test_20231031_155120,10350842.png,212614,6887,205727,0.967607965609038,2,5,42529,1009,41520,0.9762750123445179,17.477884444444445,1977.0087253333334,15.170717748340774,123,1.1E-4
7,test_20231031_155120,10863862.png,317432,13337,304095,0.9579847022354394,3,6,66058,1928,64130,0.9708135275061309,23.652634666666668,3218.7282186666666,13.053960533703744,123,1.1E-4
8,test_20231031_155120,11382381.png,312486,1159,311327,0.996291033838316,2,6,46745,158,46587,0.9966199593539415,20.606709333333335,2334.900224,14.448120340351833,123,1.1E-4
9,test_20231031_155120,11079715.png,443815,125192,318623,0.7179185020785688,5,7,124136,17444,106692,0.8594767029709351,16.64877511111111,2039.7730453333334,15.034985123844537,123,1.1E-4
10,test_20231031_155120,11551286.png,271883,1199,270684,0.9955900148225524,3,5,40092,176,39916,0.995610096777412,15.83984888888889,1503.00104,16.36121079771285,123,1.1E-4
1,test_20231031_155121,10404007.png,502730,24182,478548,0.9518986334613013,4,6,61265,3483,57782,0.9431486166653065,25.191109333333333,3298.676826666667,12.947405913275208,123,1.2E-4
2,test_20231031_155121,1254659.png,342646,78072,264574,0.7721496821792754,5,12,80080,10861,69219,0.8643731268731268,20.51848177777778,3069.789525333333,13.259717609997972,123,1.2E-4
3,test_20231031_155121,10188041.png,221231,10202,211029,0.9538853054047579,3,6,41731,1437,40294,0.9655651673815628,10.472250666666667,996.2625973333334,18.147065349528113,123,1.2E-4
4,test_20231031_155121,10287332.png,216980,12977,204003,0.9401926444833625,3,9,22337,1774,20563,0.9205802032502126,9.307064888888888,748.7130986666666,19.387649297314677,123,1.2E-4
5,test_20231031_155121,11610969.png,368720,28492,340228,0.9227272727272727,4,6,84111,4156,79955,0.9505891024955119,19.969996444444444,2649.321978666667,13.899456184782972,123,1.2E-4
6,test_20231031_155121,10350842.png,212614,6887,205727,0.967607965609038,2,5,42529,1009,41520,0.9762750123445179,17.477884444444445,1977.0087253333334,15.170717748340774,123,1.2E-4
7,test_20231031_155121,10863862.png,317432,13337,304095,0.9579847022354394,3,5,66058,1928,64130,0.9708135275061309,23.652634666666668,3218.7282186666666,13.053960533703744,123,1.2E-4
8,test_20231031_155121,11382381.png,312486,1159,311327,0.996291033838316,2,5,46745,158,46587,0.9966199593539415,20.606709333333335,2334.900224,14.448120340351833,123,1.2E-4
9,test_20231031_155121,11079715.png,443815,125192,318623,0.7179185020785688,5,11,124136,17444,106692,0.8594767029709351,16.64877511111111,2039.7730453333334,15.034985123844537,123,1.2E-4
10,test_20231031_155121,11551286.png,271883,1199,270684,0.9955900148225524,2,6,40092,176,39916,0.995610096777412,15.83984888888889,1503.00104,16.36121079771285,123,1.2E-4
1,test_20231031_155122,10404007.png,502730,24182,478548,0.9518986334613013,4,5,61265,3483,57782,0.9431486166653065,25.191109333333333,3298.676826666667,12.947405913275208,123,1.3000000000000002E-4
2,test_20231031_155122,1254659.png,342646,78072,264574,0.7721496821792754,5,6,80080,10861,69219,0.8643731268731268,20.51848177777778,3069.789525333333,13.259717609997972,123,1.3000000000000002E-4
3,test_20231031_155122,10188041.png,221231,10202,211029,0.9538853054047579,3,6,41731,1437,40294,0.9655651673815628,10.472250666666667,996.2625973333334,18.147065349528113,123,1.3000000000000002E-4
4,test_20231031_155122,10287332.png,216980,12977,204003,0.9401926444833625,3,5,22337,1774,20563,0.9205802032502126,9.307064888888888,748.7130986666666,19.387649297314677,123,1.3000000000000002E-4
5,test_20231031_155122,11610969.png,368720,28492,340228,0.9227272727272727,4,6,84111,4156,79955,0.9505891024955119,19.969996444444444,2649.321978666667,13.899456184782972,123,1.3000000000000002E-4
6,test_20231031_155122,10350842.png,212614,6887,205727,0.967607965609038,2,5,42529,1009,41520,0.9762750123445179,17.477884444444445,1977.0087253333334,15.170717748340774,123,1.3000000000000002E-4
7,test_20231031_155122,10863862.png,317432,13337,304095,0.9579847022354394,3,6,66058,1928,64130,0.9708135275061309,23.652634666666668,3218.7282186666666,13.053960533703744,123,1.3000000000000002E-4
8,test_20231031_155122,11382381.png,312486,1159,311327,0.996291033838316,2,5,46745,158,46587,0.9966199593539415,20.606709333333335,2334.900224,14.448120340351833,123,1.3000000000000002E-4
9,test_20231031_155122,11079715.png,443815,125192,318623,0.7179185020785688,5,7,124136,17444,106692,0.8594767029709351,16.64877511111111,2039.7730453333334,15.034985123844537,123,1.3000000000000002E-4
10,test_20231031_155122,11551286.png,271883,1199,270684,0.9955900148225524,2,6,40092,176,39916,0.995610096777412,15.83984888888889,1503.00104,16.36121079771285,123,1.3000000000000002E-4
1,test_20231031_155123,10404007.png,502730,24182,478548,0.9518986334613013,3,5,61265,3483,57782,0.9431486166653065,25.191109333333333,3298.676826666667,12.947405913275208,123,1.4000000000000001E-4
2,test_20231031_155123,1254659.png,342646,78072,264574,0.7721496821792754,5,6,80080,10861,69219,0.8643731268731268,20.51848177777778,3069.789525333333,13.259717609997972,123,1.4000000000000001E-4
3,test_20231031_155123,10188041.png,221231,10202,211029,0.9538853054047579,3,5,41731,1437,40294,0.9655651673815628,10.472250666666667,996.2625973333334,18.147065349528113,123,1.4000000000000001E-4
4,test_20231031_155123,10287332.png,216980,12977,204003,0.9401926444833625,3,6,22337,1774,20563,0.9205802032502126,9.307064888888888,748.7130986666666,19.387649297314677,123,1.4000000000000001E-4
5,test_20231031_155123,11610969.png,368720,28492,340228,0.9227272727272727,4,6,84111,4156,79955,0.9505891024955119,19.969996444444444,2649.321978666667,13.899456184782972,123,1.4000000000000001E-4
6,test_20231031_155123,10350842.png,212614,6887,205727,0.967607965609038,2,5,42529,1009,41520,0.9762750123445179,17.477884444444445,1977.0087253333334,15.170717748340774,123,1.4000000000000001E-4
7,test_20231031_155123,10863862.png,317432,13337,304095,0.9579847022354394,3,5,66058,1928,64130,0.9708135275061309,23.652634666666668,3218.7282186666666,13.053960533703744,123,1.4000000000000001E-4
8,test_20231031_155123,11382381.png,312486,1159,311327,0.996291033838316,3,6,46745,158,46587,0.9966199593539415,20.606709333333335,2334.900224,14.448120340351833,123,1.4000000000000001E-4
9,test_20231031_155123,11079715.png,443815,125192,318623,0.7179185020785688,5,6,124136,17444,106692,0.8594767029709351,16.64877511111111,2039.7730453333334,15.034985123844537,123,1.4000000000000001E-4
10,test_20231031_155123,11551286.png,271883,1199,270684,0.9955900148225524,2,6,40092,176,39916,0.995610096777412,15.83984888888889,1503.00104,16.36121079771285,123,1.4000000000000001E-4
1,test_20231031_155124,10404007.png,502730,24182,478548,0.9518986334613013,4,6,61265,3483,57782,0.9431486166653065,25.191109333333333,3298.676826666667,12.947405913275208,123,1.5000000000000001E-4
2,test_20231031_155124,1254659.png,342646,78072,264574,0.7721496821792754,5,6,80080,10861,69219,0.8643731268731268,20.51848177777778,3069.789525333333,13.259717609997972,123,1.5000000000000001E-4
3,test_20231031_155124,10188041.png,221231,10202,211029,0.9538853054047579,3,6,41731,1437,40294,0.9655651673815628,10.472250666666667,996.2625973333334,18.147065349528113,123,1.5000000000000001E-4
4,test_20231031_155124,10287332.png,216980,12977,204003,0.9401926444833625,2,6,22337,1774,20563,0.9205802032502126,9.307064888888888,748.7130986666666,19.387649297314677,123,1.5000000000000001E-4
5,test_20231031_155124,11610969.png,368720,28492,340228,0.9227272727272727,4,6,84111,4156,79955,0.9505891024955119,19.969996444444444,2649.321978666667,13.899456184782972,123,1.5000000000000001E-4
6,test_20231031_155124,10350842.png,212614,6887,205727,0.967607965609038,2,5,42529,1009,41520,0.9762750123445179,17.477884444444445,1977.0087253333334,15.170717748340774,123,1.5000000000000001E-4
7,test_20231031_155124,10863862.png,317432,13337,304095,0.9579847022354394,3,11,66058,1928,64130,0.9708135275061309,23.652634666666668,3218.7282186666666,13.053960533703744,123,1.5000000000000001E-4
8,test_20231031_155124,11382381.png,312486,1159,311327,0.996291033838316,2,5,46745,158,46587,0.9966199593539415,20.606709333333335,2334.900224,14.448120340351833,123,1.5000000000000001E-4
9,test_20231031_155124,11079715.png,443815,125192,318623,0.7179185020785688,5,7,124136,17444,106692,0.8594767029709351,16.64877511111111,2039.7730453333334,15.034985123844537,123,1.5000000000000001E-4
10,test_20231031_155124,11551286.png,271883,1199,270684,0.9955900148225524,2,6,40092,176,39916,0.995610096777412,15.83984888888889,1503.00104,16.36121079771285,123,1.5000000000000001E-4
1,test_20231031_155125,10404007.png,502730,24182,478548,0.9518986334613013,4,7,61265,3483,57782,0.9431486166653065,25.191109333333333,3298.676826666667,12.947405913275208,123,1.6E-4
2,test_20231031_155125,1254659.png,342646,78072,264574,0.7721496821792754,5,6,80080,10861,69219,0.8643731268731268,20.51848177777778,3069.789525333333,13.259717609997972,123,1.6E-4
3,test_20231031_155125,10188041.png,221231,10202,211029,0.9538853054047579,3,5,41731,1437,40294,0.9655651673815628,10.472250666666667,996.2625973333334,18.147065349528113,123,1.6E-4
4,test_20231031_155125,10287332.png,216980,12767,204213,0.9411604756198728,2,5,22337,1747,20590,0.921788960021489,9.436826666666667,775.4438453333333,19.235300075188995,123,1.6E-4
5,test_20231031_155125,11610969.png,368720,28492,340228,0.9227272727272727,4,6,84111,4156,79955,0.9505891024955119,19.969996444444444,2649.321978666667,13.899456184782972,123,1.6E-4
6,test_20231031_155125,10350842.png,212614,6887,205727,0.967607965609038,2,6,42529,1009,41520,0.9762750123445179,17.477884444444445,1977.0087253333334,15.170717748340774,123,1.6E-4
7,test_20231031_155125,10863862.png,317432,13337,304095,0.9579847022354394,3,6,66058,1928,64130,0.9708135275061309,23.652634666666668,3218.7282186666666,13.053960533703744,123,1.6E-4
8,test_20231031_155125,11382381.png,312486,1159,311327,0.996291033838316,3,6,46745,158,46587,0.9966199593539415,20.606709333333335,2334.900224,14.448120340351833,123,1.6E-4
9,test_20231031_155125,11079715.png,443815,125192,318623,0.7179185020785688,5,6,124136,17444,106692,0.8594767029709351,16.64877511111111,2039.7730453333334,15.034985123844537,123,1.6E-4
10,test_20231031_155125,11551286.png,271883,1199,270684,0.9955900148225524,3,5,40092,176,39916,0.995610096777412,15.83984888888889,1503.00104,16.36121079771285,123,1.6E-4
1,test_20231031_155126,10404007.png,502730,24182,478548,0.9518986334613013,4,6,61265,3483,57782,0.9431486166653065,25.191109333333333,3298.676826666667,12.947405913275208,123,1.7E-4
2,test_20231031_155126,1254659.png,342646,78072,264574,0.7721496821792754,5,6,80080,10861,69219,0.8643731268731268,20.51848177777778,3069.789525333333,13.259717609997972,123,1.7E-4
3,test_20231031_155126,10188041.png,221231,10202,211029,0.9538853054047579,3,6,41731,1437,40294,0.9655651673815628,10.472250666666667,996.2625973333334,18.147065349528113,123,1.7E-4
4,test_20231031_155126,10287332.png,216980,12767,204213,0.9411604756198728,2,6,22337,1747,20590,0.921788960021489,9.436826666666667,775.4438453333333,19.235300075188995,123,1.7E-4
5,test_20231031_155126,11610969.png,368720,28492,340228,0.9227272727272727,5,9,84111,4156,79955,0.9505891024955119,19.969996444444444,2649.321978666667,13.899456184782972,123,1.7E-4
6,test_20231031_155126,10350842.png,212614,6887,205727,0.967607965609038,4,7,42529,1009,41520,0.9762750123445179,17.477884444444445,1977.0087253333334,15.170717748340774,123,1.7E-4
7,test_20231031_155126,10863862.png,317432,13337,304095,0.9579847022354394,3,6,66058,1928,64130,0.9708135275061309,23.652634666666668,3218.7282186666666,13.053960533703744,123,1.7E-4
8,test_20231031_155126,11382381.png,312486,1159,311327,0.996291033838316,3,6,46745,158,46587,0.9966199593539415,20.606709333333335,2334.900224,14.448120340351833,123,1.7E-4
9,test_20231031_155126,11079715.png,443815,125192,318623,0.7179185020785688,5,7,124136,17444,106692,0.8594767029709351,16.64877511111111,2039.7730453333334,15.034985123844537,123,1.7E-4
10,test_20231031_155126,11551286.png,271883,1199,270684,0.9955900148225524,3,6,40092,176,39916,0.995610096777412,15.83984888888889,1503.00104,16.36121079771285,123,1.7E-4
1,test_20231031_155127,10404007.png,502730,24182,478548,0.9518986334613013,4,5,61265,3483,57782,0.9431486166653065,25.191109333333333,3298.676826666667,12.947405913275208,123,1.8E-4
2,test_20231031_155127,1254659.png,342646,78072,264574,0.7721496821792754,5,6,80080,10861,69219,0.8643731268731268,20.51848177777778,3069.789525333333,13.259717609997972,123,1.8E-4
3,test_20231031_155127,10188041.png,221231,10202,211029,0.9538853054047579,3,6,41731,1437,40294,0.9655651673815628,10.472250666666667,996.2625973333334,18.147065349528113,123,1.8E-4
4,test_20231031_155127,10287332.png,216980,12767,204213,0.9411604756198728,3,6,22337,1747,20590,0.921788960021489,9.436826666666667,775.4438453333333,19.235300075188995,123,1.8E-4
5,test_20231031_155127,11610969.png,368720,28492,340228,0.9227272727272727,3,6,84111,4156,79955,0.9505891024955119,19.969996444444444,2649.321978666667,13.899456184782972,123,1.8E-4
6,test_20231031_155127,10350842.png,212614,6887,205727,0.967607965609038,2,5,42529,1009,41520,0.9762750123445179,17.477884444444445,1977.0087253333334,15.170717748340774,123,1.8E-4
7,test_20231031_155127,10863862.png,317432,13337,304095,0.9579847022354394,3,6,66058,1928,64130,0.9708135275061309,23.652634666666668,3218.7282186666666,13.053960533703744,123,1.8E-4
8,test_20231031_155127,11382381.png,312486,1159,311327,0.996291033838316,2,5,46745,158,46587,0.9966199593539415,20.606709333333335,2334.900224,14.448120340351833,123,1.8E-4
9,test_20231031_155127,11079715.png,443815,125192,318623,0.7179185020785688,5,7,124136,17444,106692,0.8594767029709351,16.64877511111111,2039.7730453333334,15.034985123844537,123,1.8E-4
10,test_20231031_155127,11551286.png,271883,1199,270684,0.9955900148225524,2,6,40092,176,39916,0.995610096777412,15.83984888888889,1503.00104,16.36121079771285,123,1.8E-4
1,test_20231031_155128,10404007.png,502730,24182,478548,0.9518986334613013,3,5,61265,3483,57782,0.9431486166653065,25.191109333333333,3298.676826666667,12.947405913275208,123,1.9E-4
2,test_20231031_155128,1254659.png,342646,78072,264574,0.7721496821792754,5,16,80080,10861,69219,0.8643731268731268,20.51848177777778,3069.789525333333,13.259717609997972,123,1.9E-4
3,test_20231031_155128,10188041.png,221231,10202,211029,0.9538853054047579,3,6,41731,1437,40294,0.9655651673815628,10.472250666666667,996.2625973333334,18.147065349528113,123,1.9E-4
4,test_20231031_155128,10287332.png,216980,12767,204213,0.9411604756198728,3,6,22337,1747,20590,0.921788960021489,9.436826666666667,775.4438453333333,19.235300075188995,123,1.9E-4
5,test_20231031_155128,11610969.png,368720,28492,340228,0.9227272727272727,3,6,84111,4156,79955,0.9505891024955119,19.969996444444444,2649.321978666667,13.899456184782972,123,1.9E-4
6,test_20231031_155128,10350842.png,212614,6887,205727,0.967607965609038,2,7,42529,1009,41520,0.9762750123445179,17.477884444444445,1977.0087253333334,15.170717748340774,123,1.9E-4
7,test_20231031_155128,10863862.png,317432,13337,304095,0.9579847022354394,3,6,66058,1928,64130,0.9708135275061309,23.652634666666668,3218.7282186666666,13.053960533703744,123,1.9E-4
8,test_20231031_155128,11382381.png,312486,1159,311327,0.996291033838316,3,6,46745,158,46587,0.9966199593539415,20.606709333333335,2334.900224,14.448120340351833,123,1.9E-4
9,test_20231031_155128,11079715.png,443815,125192,318623,0.7179185020785688,5,7,124136,17444,106692,0.8594767029709351,16.64877511111111,2039.7730453333334,15.034985123844537,123,1.9E-4
10,test_20231031_155128,11551286.png,271883,1199,270684,0.9955900148225524,3,6,40092,176,39916,0.995610096777412,15.83984888888889,1503.00104,16.36121079771285,123,1.9E-4
1,test_20231031_155129,10404007.png,502730,24182,478548,0.9518986334613013,4,6,61265,3483,57782,0.9431486166653065,25.191109333333333,3298.676826666667,12.947405913275208,123,2.0E-4
2,test_20231031_155129,1254659.png,342646,78072,264574,0.7721496821792754,4,6,80080,10861,69219,0.8643731268731268,20.51848177777778,3069.789525333333,13.259717609997972,123,2.0E-4
3,test_20231031_155129,10188041.png,221231,10202,211029,0.9538853054047579,3,6,41731,1437,40294,0.9655651673815628,10.472250666666667,996.2625973333334,18.147065349528113,123,2.0E-4
4,test_20231031_155129,10287332.png,216980,12767,204213,0.9411604756198728,3,6,22337,1747,20590,0.921788960021489,9.436826666666667,775.4438453333333,19.235300075188995,123,2.0E-4
5,test_20231031_155129,11610969.png,368720,28492,340228,0.9227272727272727,4,6,84111,4156,79955,0.9505891024955119,19.969996444444444,2649.321978666667,13.899456184782972,123,2.0E-4
6,test_20231031_155129,10350842.png,212614,6887,205727,0.967607965609038,3,5,42529,1009,41520,0.9762750123445179,17.477884444444445,1977.0087253333334,15.170717748340774,123,2.0E-4
7,test_20231031_155129,10863862.png,317432,13337,304095,0.9579847022354394,3,6,66058,1928,64130,0.9708135275061309,23.652634666666668,3218.7282186666666,13.053960533703744,123,2.0E-4
8,test_20231031_155129,11382381.png,312486,1159,311327,0.996291033838316,2,5,46745,158,46587,0.9966199593539415,20.606709333333335,2334.900224,14.448120340351833,123,2.0E-4
9,test_20231031_155129,11079715.png,443815,125192,318623,0.7179185020785688,5,7,124136,17444,106692,0.8594767029709351,16.64877511111111,2039.7730453333334,15.034985123844537,123,2.0E-4
10,test_20231031_155129,11551286.png,271883,1179,270704,0.995663575876388,2,6,40092,173,39919,0.9956849246732515,16.545063111111112,1622.936352,16.027788727836416,123,2.0E-4
1,test_20231031_155130,10404007.png,502730,24182,478548,0.9518986334613013,4,6,61265,3483,57782,0.9431486166653065,25.191109333333333,3298.676826666667,12.947405913275208,123,2.1E-4
2,test_20231031_155130,1254659.png,342646,78072,264574,0.7721496821792754,5,6,80080,10861,69219,0.8643731268731268,20.51848177777778,3069.789525333333,13.259717609997972,123,2.1E-4
3,test_20231031_155130,10188041.png,221231,10202,211029,0.9538853054047579,3,5,41731,1437,40294,0.9655651673815628,10.472250666666667,996.2625973333334,18.147065349528113,123,2.1E-4
4,test_20231031_155130,10287332.png,216980,12767,204213,0.9411604756198728,2,5,22337,1747,20590,0.921788960021489,9.436826666666667,775.4438453333333,19.235300075188995,123,2.1E-4
5,test_20231031_155130,11610969.png,368720,28492,340228,0.9227272727272727,4,6,84111,4156,79955,0.9505891024955119,19.969996444444444,2649.321978666667,13.899456184782972,123,2.1E-4
6,test_20231031_155130,10350842.png,212614,6887,205727,0.967607965609038,3,6,42529,1009,41520,0.9762750123445179,17.477884444444445,1977.0087253333334,15.170717748340774,123,2.1E-4
7,test_20231031_155130,10863862.png,317432,13337,304095,0.9579847022354394,3,5,66058,1928,64130,0.9708135275061309,23.652634666666668,3218.7282186666666,13.053960533703744,123,2.1E-4
8,test_20231031_155130,11382381.png,312486,1159,311327,0.996291033838316,3,6,46745,158,46587,0.9966199593539415,20.606709333333335,2334.900224,14.448120340351833,123,2.1E-4
9,test_20231031_155130,11079715.png,443815,125192,318623,0.7179185020785688,5,6,124136,17444,106692,0.8594767029709351,16.64877511111111,2039.7730453333334,15.034985123844537,123,2.1E-4
10,test_20231031_155130,11551286.png,271883,1179,270704,0.995663575876388,2,6,40092,173,39919,0.9956849246732515,16.545063111111112,1622.936352,16.027788727836416,123,2.1E-4
1,test_20231031_155131,10404007.png,502730,24182,478548,0.9518986334613013,4,6,61265,3483,57782,0.9431486166653065,25.191109333333333,3298.676826666667,12.947405913275208,123,2.2E-4
2,test_20231031_155131,1254659.png,342646,78072,264574,0.7721496821792754,5,6,80080,10861,69219,0.8643731268731268,20.51848177777778,3069.789525333333,13.259717609997972,123,2.2E-4
3,test_20231031_155131,10188041.png,221231,10202,211029,0.9538853054047579,3,5,41731,1437,40294,0.9655651673815628,10.472250666666667,996.2625973333334,18.147065349528113,123,2.2E-4
4,test_20231031_155131,10287332.png,216980,12767,204213,0.9411604756198728,2,5,22337,1747,20590,0.921788960021489,9.436826666666667,775.4438453333333,19.235300075188995,123,2.2E-4
5,test_20231031_155131,11610969.png,368720,28492,340228,0.9227272727272727,3,6,84111,4156,79955,0.9505891024955119,19.969996444444444,2649.321978666667,13.899456184782972,123,2.2E-4
6,test_20231031_155131,10350842.png,212614,6887,205727,0.967607965609038,3,6,42529,1009,41520,0.9762750123445179,17.477884444444445,1977.0087253333334,15.170717748340774,123,2.2E-4
7,test_20231031_155131,10863862.png,317432,13337,304095,0.9579847022354394,3,6,66058,1928,64130,0.9708135275061309,23.652634666666668,3218.7282186666666,13.053960533703744,123,2.2E-4
8,test_20231031_155131,11382381.png,312486,1159,311327,0.996291033838316,3,6,46745,158,46587,0.9966199593539415,20.606709333333335,2334.900224,14.448120340351833,123,2.2E-4
9,test_20231031_155131,11079715.png,443815,125192,318623,0.7179185020785688,5,6,124136,17444,106692,0.8594767029709351,16.64877511111111,2039.7730453333334,15.034985123844537,123,2.2E-4
10,test_20231031_155131,11551286.png,271883,1179,270704,0.995663575876388,3,6,40092,173,39919,0.9956849246732515,16.545063111111112,1622.936352,16.027788727836416,123,2.2E-4
1,test_20231031_155132,10404007.png,502730,24182,478548,0.9518986334613013,3,6,61265,3483,57782,0.9431486166653065,25.191109333333333,3298.676826666667,12.947405913275208,123,2.3E-4
2,test_20231031_155132,1254659.png,342646,78072,264574,0.7721496821792754,5,6,80080,10861,69219,0.8643731268731268,20.51848177777778,3069.789525333333,13.259717609997972,123,2.3E-4
3,test_20231031_155132,10188041.png,221231,10202,211029,0.9538853054047579,3,6,41731,1437,40294,0.9655651673815628,10.472250666666667,996.2625973333334,18.147065349528113,123,2.3E-4
4,test_20231031_155132,10287332.png,216980,12767,204213,0.9411604756198728,2,6,22337,1747,20590,0.921788960021489,9.436826666666667,775.4438453333333,19.235300075188995,123,2.3E-4
5,test_20231031_155132,11610969.png,368720,28492,340228,0.9227272727272727,4,6,84111,4156,79955,0.9505891024955119,19.969996444444444,2649.321978666667,13.899456184782972,123,2.3E-4
6,test_20231031_155132,10350842.png,212614,6887,205727,0.967607965609038,2,6,42529,1009,41520,0.9762750123445179,17.477884444444445,1977.0087253333334,15.170717748340774,123,2.3E-4
7,test_20231031_155132,10863862.png,317432,13337,304095,0.9579847022354394,3,5,66058,1928,64130,0.9708135275061309,23.652634666666668,3218.7282186666666,13.053960533703744,123,2.3E-4
8,test_20231031_155132,11382381.png,312486,967,311519,0.9969054613646692,3,6,46745,130,46615,0.9972189538988127,21.068341333333333,2406.1475626666665,14.317581029153203,123,2.3E-4
9,test_20231031_155132,11079715.png,443815,125192,318623,0.7179185020785688,6,7,124136,17444,106692,0.8594767029709351,16.64877511111111,2039.7730453333334,15.034985123844537,123,2.3E-4
10,test_20231031_155132,11551286.png,271883,1179,270704,0.995663575876388,2,5,40092,173,39919,0.9956849246732515,16.545063111111112,1622.936352,16.027788727836416,123,2.3E-4
1,test_20231031_155133,10404007.png,502730,24182,478548,0.9518986334613013,4,6,61265,3483,57782,0.9431486166653065,25.191109333333333,3298.676826666667,12.947405913275208,123,2.4E-4
2,test_20231031_155133,1254659.png,342646,78072,264574,0.7721496821792754,5,6,80080,10861,69219,0.8643731268731268,20.51848177777778,3069.789525333333,13.259717609997972,123,2.4E-4
3,test_20231031_155133,10188041.png,221231,10202,211029,0.9538853054047579,4,5,41731,1437,40294,0.9655651673815628,10.472250666666667,996.2625973333334,18.147065349528113,123,2.4E-4
4,test_20231031_155133,10287332.png,216980,12767,204213,0.9411604756198728,3,6,22337,1747,20590,0.921788960021489,9.436826666666667,775.4438453333333,19.235300075188995,123,2.4E-4
5,test_20231031_155133,11610969.png,368720,28492,340228,0.9227272727272727,4,6,84111,4156,79955,0.9505891024955119,19.969996444444444,2649.321978666667,13.899456184782972,123,2.4E-4
6,test_20231031_155133,10350842.png,212614,6887,205727,0.967607965609038,2,6,42529,1009,41520,0.9762750123445179,17.477884444444445,1977.0087253333334,15.170717748340774,123,2.4E-4
7,test_20231031_155133,10863862.png,317432,13337,304095,0.9579847022354394,3,6,66058,1928,64130,0.9708135275061309,23.652634666666668,3218.7282186666666,13.053960533703744,123,2.4E-4
8,test_20231031_155133,11382381.png,312486,967,311519,0.9969054613646692,2,6,46745,130,46615,0.9972189538988127,21.068341333333333,2406.1475626666665,14.317581029153203,123,2.4E-4
9,test_20231031_155133,11079715.png,443815,125192,318623,0.7179185020785688,5,7,124136,17444,106692,0.8594767029709351,16.64877511111111,2039.7730453333334,15.034985123844537,123,2.4E-4
10,test_20231031_155133,11551286.png,271883,1179,270704,0.995663575876388,3,6,40092,173,39919,0.9956849246732515,16.545063111111112,1622.936352,16.027788727836416,123,2.4E-4
1,test_20231031_155134,10404007.png,502730,24182,478548,0.9518986334613013,4,6,61265,3483,57782,0.9431486166653065,25.191109333333333,3298.676826666667,12.947405913275208,123,2.5E-4
2,test_20231031_155134,1254659.png,342646,78072,264574,0.7721496821792754,5,6,80080,10861,69219,0.8643731268731268,20.51848177777778,3069.789525333333,13.259717609997972,123,2.5E-4
3,test_20231031_155134,10188041.png,221231,10202,211029,0.9538853054047579,3,6,41731,1437,40294,0.9655651673815628,10.472250666666667,996.2625973333334,18.147065349528113,123,2.5E-4
4,test_20231031_155134,10287332.png,216980,12767,204213,0.9411604756198728,2,6,22337,1747,20590,0.921788960021489,9.436826666666667,775.4438453333333,19.235300075188995,123,2.5E-4
5,test_20231031_155134,11610969.png,368720,28492,340228,0.9227272727272727,4,5,84111,4156,79955,0.9505891024955119,19.969996444444444,2649.321978666667,13.899456184782972,123,2.5E-4
6,test_20231031_155134,10350842.png,212614,6887,205727,0.967607965609038,2,6,42529,1009,41520,0.9762750123445179,17.477884444444445,1977.0087253333334,15.170717748340774,123,2.5E-4
7,test_20231031_155134,10863862.png,317432,13337,304095,0.9579847022354394,3,6,66058,1928,64130,0.9708135275061309,23.652634666666668,3218.7282186666666,13.053960533703744,123,2.5E-4
8,test_20231031_155134,11382381.png,312486,967,311519,0.9969054613646692,2,6,46745,130,46615,0.9972189538988127,21.068341333333333,2406.1475626666665,14.317581029153203,123,2.5E-4
9,test_20231031_155134,11079715.png,443815,125192,318623,0.7179185020785688,5,7,124136,17444,106692,0.8594767029709351,16.64877511111111,2039.7730453333334,15.034985123844537,123,2.5E-4
10,test_20231031_155134,11551286.png,271883,1179,270704,0.995663575876388,2,5,40092,173,39919,0.9956849246732515,16.545063111111112,1622.936352,16.027788727836416,123,2.5E-4
1,test_20231031_155135,10404007.png,502730,24062,478668,0.9521373301772323,4,6,61265,3466,57799,0.9434260997306783,25.205253333333335,3301.279184,12.943981073817032,123,2.6000000000000003E-4
2,test_20231031_155135,1254659.png,342646,78012,264634,0.7723247900165185,5,6,80080,10856,69224,0.8644355644355645,20.528035555555554,3070.871712,13.258186870279811,123,2.6000000000000003E-4
3,test_20231031_155135,10188041.png,221231,10102,211129,0.9543373216230998,3,6,41731,1423,40308,0.9659006493973306,10.595603555555556,1011.9779893333333,18.079092942287858,123,2.6000000000000003E-4
4,test_20231031_155135,10287332.png,216980,12767,204213,0.9411604756198728,3,6,22337,1747,20590,0.921788960021489,9.436826666666667,775.4438453333333,19.235300075188995,123,2.6000000000000003E-4
5,test_20231031_155135,11610969.png,368720,28252,340468,0.9233781731395097,4,6,84111,4121,79990,0.9510052192935525,20.351372444444443,2731.876538666667,13.766192924277291,123,2.6000000000000003E-4
6,test_20231031_155135,10350842.png,212614,6467,206147,0.9695833764474587,2,6,42529,947,41582,0.9777328411201768,19.205194666666667,2350.2698026666667,14.419626402627658,123,2.6000000000000003E-4
7,test_20231031_155135,10863862.png,317432,13257,304175,0.9582367247158446,3,5,66058,1916,64142,0.9709951860486239,23.681868444444444,3223.7809546666667,13.047148356167963,123,2.6000000000000003E-4
8,test_20231031_155135,11382381.png,312486,967,311519,0.9969054613646692,2,6,46745,130,46615,0.9972189538988127,21.068341333333333,2406.1475626666665,14.317581029153203,123,2.6000000000000003E-4
9,test_20231031_155135,11079715.png,443815,125192,318623,0.7179185020785688,6,6,124136,17444,106692,0.8594767029709351,16.64877511111111,2039.7730453333334,15.034985123844537,123,2.6000000000000003E-4
10,test_20231031_155135,11551286.png,271883,857,271026,0.9968479088431421,3,5,40092,125,39967,0.9968821710066846,17.555712,1807.787776,15.559329154375803,123,2.6000000000000003E-4
1,test_20231031_155136,10404007.png,502730,24062,478668,0.9521373301772323,4,6,61265,3466,57799,0.9434260997306783,25.205253333333335,3301.279184,12.943981073817032,123,2.7000000000000006E-4
2,test_20231031_155136,1254659.png,342646,78012,264634,0.7723247900165185,5,7,80080,10856,69224,0.8644355644355645,20.528035555555554,3070.871712,13.258186870279811,123,2.7000000000000006E-4
3,test_20231031_155136,10188041.png,221231,10102,211129,0.9543373216230998,3,5,41731,1423,40308,0.9659006493973306,10.595603555555556,1011.9779893333333,18.079092942287858,123,2.7000000000000006E-4
4,test_20231031_155136,10287332.png,216980,12767,204213,0.9411604756198728,3,6,22337,1747,20590,0.921788960021489,9.436826666666667,775.4438453333333,19.235300075188995,123,2.7000000000000006E-4
5,test_20231031_155136,11610969.png,368720,28252,340468,0.9233781731395097,3,6,84111,4121,79990,0.9510052192935525,20.351372444444443,2731.876538666667,13.766192924277291,123,2.7000000000000006E-4
6,test_20231031_155136,10350842.png,212614,6467,206147,0.9695833764474587,2,6,42529,947,41582,0.9777328411201768,19.205194666666667,2350.2698026666667,14.419626402627658,123,2.7000000000000006E-4
7,test_20231031_155136,10863862.png,317432,13257,304175,0.9582367247158446,3,5,66058,1916,64142,0.9709951860486239,23.681868444444444,3223.7809546666667,13.047148356167963,123,2.7000000000000006E-4
8,test_20231031_155136,11382381.png,312486,967,311519,0.9969054613646692,3,6,46745,130,46615,0.9972189538988127,21.068341333333333,2406.1475626666665,14.317581029153203,123,2.7000000000000006E-4
9,test_20231031_155136,11079715.png,443815,125192,318623,0.7179185020785688,5,7,124136,17444,106692,0.8594767029709351,16.64877511111111,2039.7730453333334,15.034985123844537,123,2.7000000000000006E-4
10,test_20231031_155136,11551286.png,271883,857,271026,0.9968479088431421,2,6,40092,125,39967,0.9968821710066846,17.555712,1807.787776,15.559329154375803,123,2.7000000000000006E-4
1,test_20231031_155137,10404007.png,502730,24062,478668,0.9521373301772323,3,5,61265,3466,57799,0.9434260997306783,25.205253333333335,3301.279184,12.943981073817032,123,2.800000000000001E-4
2,test_20231031_155137,1254659.png,342646,78012,264634,0.7723247900165185,5,6,80080,10856,69224,0.8644355644355645,20.528035555555554,3070.871712,13.258186870279811,123,2.800000000000001E-4
3,test_20231031_155137,10188041.png,221231,10102,211129,0.9543373216230998,3,5,41731,1423,40308,0.9659006493973306,10.595603555555556,1011.9779893333333,18.079092942287858,123,2.800000000000001E-4
4,test_20231031_155137,10287332.png,216980,12767,204213,0.9411604756198728,3,6,22337,1747,20590,0.921788960021489,9.436826666666667,775.4438453333333,19.235300075188995,123,2.800000000000001E-4
5,test_20231031_155137,11610969.png,368720,28252,340468,0.9233781731395097,4,6,84111,4121,79990,0.9510052192935525,20.351372444444443,2731.876538666667,13.766192924277291,123,2.800000000000001E-4
6,test_20231031_155137,10350842.png,212614,6467,206147,0.9695833764474587,3,6,42529,947,41582,0.9777328411201768,19.205194666666667,2350.2698026666667,14.419626402627658,123,2.800000000000001E-4
7,test_20231031_155137,10863862.png,317432,13257,304175,0.9582367247158446,3,6,66058,1916,64142,0.9709951860486239,23.681868444444444,3223.7809546666667,13.047148356167963,123,2.800000000000001E-4
8,test_20231031_155137,11382381.png,312486,967,311519,0.9969054613646692,2,6,46745,130,46615,0.9972189538988127,21.068341333333333,2406.1475626666665,14.317581029153203,123,2.800000000000001E-4
9,test_20231031_155137,11079715.png,443815,125192,318623,0.7179185020785688,7,7,124136,17444,106692,0.8594767029709351,16.64877511111111,2039.7730453333334,15.034985123844537,123,2.800000000000001E-4
10,test_20231031_155137,11551286.png,271883,857,271026,0.9968479088431421,3,6,40092,125,39967,0.9968821710066846,17.555712,1807.787776,15.559329154375803,123,2.800000000000001E-4
1,test_20231031_155138,10404007.png,502730,24062,478668,0.9521373301772323,4,6,61265,3466,57799,0.9434260997306783,25.205253333333335,3301.279184,12.943981073817032,123,2.900000000000001E-4
2,test_20231031_155138,1254659.png,342646,78012,264634,0.7723247900165185,5,6,80080,10856,69224,0.8644355644355645,20.528035555555554,3070.871712,13.258186870279811,123,2.900000000000001E-4
3,test_20231031_155138,10188041.png,221231,10102,211129,0.9543373216230998,3,5,41731,1423,40308,0.9659006493973306,10.595603555555556,1011.9779893333333,18.079092942287858,123,2.900000000000001E-4
4,test_20231031_155138,10287332.png,216980,12767,204213,0.9411604756198728,3,6,22337,1747,20590,0.921788960021489,9.436826666666667,775.4438453333333,19.235300075188995,123,2.900000000000001E-4
5,test_20231031_155138,11610969.png,368720,28252,340468,0.9233781731395097,4,6,84111,4121,79990,0.9510052192935525,20.351372444444443,2731.876538666667,13.766192924277291,123,2.900000000000001E-4
6,test_20231031_155138,10350842.png,212614,6467,206147,0.9695833764474587,2,6,42529,947,41582,0.9777328411201768,19.205194666666667,2350.2698026666667,14.419626402627658,123,2.900000000000001E-4
7,test_20231031_155138,10863862.png,317432,13257,304175,0.9582367247158446,3,5,66058,1916,64142,0.9709951860486239,23.681868444444444,3223.7809546666667,13.047148356167963,123,2.900000000000001E-4
8,test_20231031_155138,11382381.png,312486,967,311519,0.9969054613646692,3,6,46745,130,46615,0.9972189538988127,21.068341333333333,2406.1475626666665,14.317581029153203,123,2.900000000000001E-4
9,test_20231031_155138,11079715.png,443815,125192,318623,0.7179185020785688,6,7,124136,17444,106692,0.8594767029709351,16.64877511111111,2039.7730453333334,15.034985123844537,123,2.900000000000001E-4
10,test_20231031_155138,11551286.png,271883,547,271336,0.9979881051775947,1,5,40092,79,40013,0.9980295320762247,17.838736,1852.2023093333332,15.453919395217167,123,2.900000000000001E-4
1,test_20231031_155139,10404007.png,502730,22884,479846,0.9544805362719552,3,6,61265,3295,57970,0.9462172529176528,25.586942222222223,3400.765381333333,12.815036898605106,124,1.0E-5
2,test_20231031_155139,1254659.png,342646,76264,266382,0.7774262650082009,5,6,80080,10638,69442,0.8671578421578422,20.667370666666667,3113.3477866666667,13.198527231942004,124,1.0E-5
3,test_20231031_155139,10188041.png,221231,10142,211089,0.954156515135763,3,6,41731,1428,40303,0.9657808343916993,10.476305777777778,997.11648,18.1433446668218,124,1.0E-5
4,test_20231031_155139,10287332.png,216980,12897,204083,0.940561342059176,3,6,22337,1766,20571,0.9209383534046649,9.311077333333333,749.8733493333333,19.38092441916683,124,1.0E-5
5,test_20231031_155139,11610969.png,368720,27227,341493,0.9261580603167715,4,6,84111,3970,80141,0.9528004660508138,20.228828444444446,2711.644832,13.798475553202607,124,1.0E-5
6,test_20231031_155139,10350842.png,212614,6344,206270,0.9701618896215677,2,6,42529,929,41600,0.9781560817324649,19.196949333333333,2355.988128,14.409072631896374,124,1.0E-5
7,test_20231031_155139,10863862.png,317432,12977,304455,0.9591188033972631,3,6,66058,1885,64173,0.9714644706167308,23.722218666666667,3236.9452053333334,13.029450130942488,124,1.0E-5
8,test_20231031_155139,11382381.png,312486,1169,311317,0.9962590324046517,3,6,46745,159,46586,0.9965985666916247,19.758430222222223,2219.8571466666667,14.667553334490613,124,1.0E-5
9,test_20231031_155139,11079715.png,443815,122782,321033,0.7233486925858748,5,6,124136,17120,107016,0.8620867435715667,16.763402666666668,2067.635402666667,14.97606401189655,124,1.0E-5
10,test_20231031_155139,11551286.png,271883,1322,270561,0.9951376143414631,2,5,40092,194,39898,0.9951611294023746,15.753514666666666,1496.8890666666666,16.378907445727467,124,1.0E-5
1,test_20231031_155140,10404007.png,502730,22884,479846,0.9544805362719552,3,5,61265,3295,57970,0.9462172529176528,25.586942222222223,3400.765381333333,12.815036898605106,124,2.0E-5
2,test_20231031_155140,1254659.png,342646,76264,266382,0.7774262650082009,4,6,80080,10638,69442,0.8671578421578422,20.667370666666667,3113.3477866666667,13.198527231942004,124,2.0E-5
3,test_20231031_155140,10188041.png,221231,10142,211089,0.954156515135763,3,6,41731,1428,40303,0.9657808343916993,10.476305777777778,997.11648,18.1433446668218,124,2.0E-5
4,test_20231031_155140,10287332.png,216980,12897,204083,0.940561342059176,3,6,22337,1766,20571,0.9209383534046649,9.311077333333333,749.8733493333333,19.38092441916683,124,2.0E-5
5,test_20231031_155140,11610969.png,368720,27227,341493,0.9261580603167715,4,6,84111,3970,80141,0.9528004660508138,20.228828444444446,2711.644832,13.798475553202607,124,2.0E-5
6,test_20231031_155140,10350842.png,212614,6344,206270,0.9701618896215677,2,5,42529,929,41600,0.9781560817324649,19.196949333333333,2355.988128,14.409072631896374,124,2.0E-5
7,test_20231031_155140,10863862.png,317432,12977,304455,0.9591188033972631,3,5,66058,1885,64173,0.9714644706167308,23.722218666666667,3236.9452053333334,13.029450130942488,124,2.0E-5
8,test_20231031_155140,11382381.png,312486,1169,311317,0.9962590324046517,3,6,46745,159,46586,0.9965985666916247,19.758430222222223,2219.8571466666667,14.667553334490613,124,2.0E-5
9,test_20231031_155140,11079715.png,443815,122782,321033,0.7233486925858748,5,6,124136,17120,107016,0.8620867435715667,16.763402666666668,2067.635402666667,14.97606401189655,124,2.0E-5
10,test_20231031_155140,11551286.png,271883,1322,270561,0.9951376143414631,2,5,40092,194,39898,0.9951611294023746,15.753514666666666,1496.8890666666666,16.378907445727467,124,2.0E-5
1,test_20231031_155141,10404007.png,502730,22884,479846,0.9544805362719552,3,6,61265,3295,57970,0.9462172529176528,25.586942222222223,3400.765381333333,12.815036898605106,124,3.0000000000000004E-5
2,test_20231031_155141,1254659.png,342646,76264,266382,0.7774262650082009,6,6,80080,10638,69442,0.8671578421578422,20.667370666666667,3113.3477866666667,13.198527231942004,124,3.0000000000000004E-5
3,test_20231031_155141,10188041.png,221231,10142,211089,0.954156515135763,3,7,41731,1428,40303,0.9657808343916993,10.476305777777778,997.11648,18.1433446668218,124,3.0000000000000004E-5
4,test_20231031_155141,10287332.png,216980,12897,204083,0.940561342059176,2,5,22337,1766,20571,0.9209383534046649,9.311077333333333,749.8733493333333,19.38092441916683,124,3.0000000000000004E-5
5,test_20231031_155141,11610969.png,368720,27227,341493,0.9261580603167715,4,6,84111,3970,80141,0.9528004660508138,20.228828444444446,2711.644832,13.798475553202607,124,3.0000000000000004E-5
6,test_20231031_155141,10350842.png,212614,6344,206270,0.9701618896215677,2,6,42529,929,41600,0.9781560817324649,19.196949333333333,2355.988128,14.409072631896374,124,3.0000000000000004E-5
7,test_20231031_155141,10863862.png,317432,12977,304455,0.9591188033972631,2,5,66058,1885,64173,0.9714644706167308,23.722218666666667,3236.9452053333334,13.029450130942488,124,3.0000000000000004E-5
8,test_20231031_155141,11382381.png,312486,1169,311317,0.9962590324046517,3,5,46745,159,46586,0.9965985666916247,19.758430222222223,2219.8571466666667,14.667553334490613,124,3.0000000000000004E-5
9,test_20231031_155141,11079715.png,443815,122782,321033,0.7233486925858748,6,7,124136,17120,107016,0.8620867435715667,16.763402666666668,2067.635402666667,14.97606401189655,124,3.0000000000000004E-5
10,test_20231031_155141,11551286.png,271883,1322,270561,0.9951376143414631,2,6,40092,194,39898,0.9951611294023746,15.753514666666666,1496.8890666666666,16.378907445727467,124,3.0000000000000004E-5
1,test_20231031_155142,10404007.png,502730,22884,479846,0.9544805362719552,3,6,61265,3295,57970,0.9462172529176528,25.586942222222223,3400.765381333333,12.815036898605106,124,4.0E-5
2,test_20231031_155142,1254659.png,342646,76264,266382,0.7774262650082009,5,7,80080,10638,69442,0.8671578421578422,20.667370666666667,3113.3477866666667,13.198527231942004,124,4.0E-5
3,test_20231031_155142,10188041.png,221231,10142,211089,0.954156515135763,4,6,41731,1428,40303,0.9657808343916993,10.476305777777778,997.11648,18.1433446668218,124,4.0E-5
4,test_20231031_155142,10287332.png,216980,12897,204083,0.940561342059176,4,6,22337,1766,20571,0.9209383534046649,9.311077333333333,749.8733493333333,19.38092441916683,124,4.0E-5
5,test_20231031_155142,11610969.png,368720,27227,341493,0.9261580603167715,3,6,84111,3970,80141,0.9528004660508138,20.228828444444446,2711.644832,13.798475553202607,124,4.0E-5
6,test_20231031_155142,10350842.png,212614,6344,206270,0.9701618896215677,2,5,42529,929,41600,0.9781560817324649,19.196949333333333,2355.988128,14.409072631896374,124,4.0E-5
7,test_20231031_155142,10863862.png,317432,12977,304455,0.9591188033972631,3,6,66058,1885,64173,0.9714644706167308,23.722218666666667,3236.9452053333334,13.029450130942488,124,4.0E-5
8,test_20231031_155142,11382381.png,312486,1169,311317,0.9962590324046517,3,5,46745,159,46586,0.9965985666916247,19.758430222222223,2219.8571466666667,14.667553334490613,124,4.0E-5
9,test_20231031_155142,11079715.png,443815,122782,321033,0.7233486925858748,7,6,124136,17120,107016,0.8620867435715667,16.763402666666668,2067.635402666667,14.97606401189655,124,4.0E-5
10,test_20231031_155142,11551286.png,271883,1322,270561,0.9951376143414631,2,5,40092,194,39898,0.9951611294023746,15.753514666666666,1496.8890666666666,16.378907445727467,124,4.0E-5
1,test_20231031_155144,10404007.png,502730,22884,479846,0.9544805362719552,4,6,61265,3295,57970,0.9462172529176528,25.586942222222223,3400.765381333333,12.815036898605106,124,5.0E-5
2,test_20231031_155144,1254659.png,342646,76264,266382,0.7774262650082009,4,7,80080,10638,69442,0.8671578421578422,20.667370666666667,3113.3477866666667,13.198527231942004,124,5.0E-5
3,test_20231031_155144,10188041.png,221231,10142,211089,0.954156515135763,3,5,41731,1428,40303,0.9657808343916993,10.476305777777778,997.11648,18.1433446668218,124,5.0E-5
4,test_20231031_155144,10287332.png,216980,12897,204083,0.940561342059176,3,6,22337,1766,20571,0.9209383534046649,9.311077333333333,749.8733493333333,19.38092441916683,124,5.0E-5
5,test_20231031_155144,11610969.png,368720,27227,341493,0.9261580603167715,4,6,84111,3970,80141,0.9528004660508138,20.228828444444446,2711.644832,13.798475553202607,124,5.0E-5
6,test_20231031_155144,10350842.png,212614,6344,206270,0.9701618896215677,2,5,42529,929,41600,0.9781560817324649,19.196949333333333,2355.988128,14.409072631896374,124,5.0E-5
7,test_20231031_155144,10863862.png,317432,12977,304455,0.9591188033972631,3,6,66058,1885,64173,0.9714644706167308,23.722218666666667,3236.9452053333334,13.029450130942488,124,5.0E-5
8,test_20231031_155144,11382381.png,312486,1099,311387,0.9964830424403013,2,5,46745,149,46596,0.996812493314793,20.626588444444444,2338.262816,14.441870374793048,124,5.0E-5
9,test_20231031_155144,11079715.png,443815,122782,321033,0.7233486925858748,5,6,124136,17120,107016,0.8620867435715667,16.763402666666668,2067.635402666667,14.97606401189655,124,5.0E-5
10,test_20231031_155144,11551286.png,271883,1322,270561,0.9951376143414631,2,5,40092,194,39898,0.9951611294023746,15.753514666666666,1496.8890666666666,16.378907445727467,124,5.0E-5
1,test_20231031_155145,10404007.png,502730,22884,479846,0.9544805362719552,4,6,61265,3295,57970,0.9462172529176528,25.586942222222223,3400.765381333333,12.815036898605106,124,6.0E-5
2,test_20231031_155145,1254659.png,342646,76264,266382,0.7774262650082009,4,6,80080,10638,69442,0.8671578421578422,20.667370666666667,3113.3477866666667,13.198527231942004,124,6.0E-5
3,test_20231031_155145,10188041.png,221231,10142,211089,0.954156515135763,3,12,41731,1428,40303,0.9657808343916993,10.476305777777778,997.11648,18.1433446668218,124,6.0E-5
4,test_20231031_155145,10287332.png,216980,12897,204083,0.940561342059176,3,6,22337,1766,20571,0.9209383534046649,9.311077333333333,749.8733493333333,19.38092441916683,124,6.0E-5
5,test_20231031_155145,11610969.png,368720,27227,341493,0.9261580603167715,4,5,84111,3970,80141,0.9528004660508138,20.228828444444446,2711.644832,13.798475553202607,124,6.0E-5
6,test_20231031_155145,10350842.png,212614,6344,206270,0.9701618896215677,3,6,42529,929,41600,0.9781560817324649,19.196949333333333,2355.988128,14.409072631896374,124,6.0E-5
7,test_20231031_155145,10863862.png,317432,12977,304455,0.9591188033972631,3,6,66058,1885,64173,0.9714644706167308,23.722218666666667,3236.9452053333334,13.029450130942488,124,6.0E-5
8,test_20231031_155145,11382381.png,312486,1099,311387,0.9964830424403013,2,5,46745,149,46596,0.996812493314793,20.626588444444444,2338.262816,14.441870374793048,124,6.0E-5
9,test_20231031_155145,11079715.png,443815,122782,321033,0.7233486925858748,6,7,124136,17120,107016,0.8620867435715667,16.763402666666668,2067.635402666667,14.97606401189655,124,6.0E-5
10,test_20231031_155145,11551286.png,271883,1322,270561,0.9951376143414631,2,6,40092,194,39898,0.9951611294023746,15.753514666666666,1496.8890666666666,16.378907445727467,124,6.0E-5
1,test_20231031_155146,10404007.png,502730,22884,479846,0.9544805362719552,4,6,61265,3295,57970,0.9462172529176528,25.586942222222223,3400.765381333333,12.815036898605106,124,7.000000000000001E-5
2,test_20231031_155146,1254659.png,342646,76264,266382,0.7774262650082009,5,6,80080,10638,69442,0.8671578421578422,20.667370666666667,3113.3477866666667,13.198527231942004,124,7.000000000000001E-5
3,test_20231031_155146,10188041.png,221231,10142,211089,0.954156515135763,3,6,41731,1428,40303,0.9657808343916993,10.476305777777778,997.11648,18.1433446668218,124,7.000000000000001E-5
4,test_20231031_155146,10287332.png,216980,12897,204083,0.940561342059176,3,5,22337,1766,20571,0.9209383534046649,9.311077333333333,749.8733493333333,19.38092441916683,124,7.000000000000001E-5
5,test_20231031_155146,11610969.png,368720,27227,341493,0.9261580603167715,4,7,84111,3970,80141,0.9528004660508138,20.228828444444446,2711.644832,13.798475553202607,124,7.000000000000001E-5
6,test_20231031_155146,10350842.png,212614,6344,206270,0.9701618896215677,2,5,42529,929,41600,0.9781560817324649,19.196949333333333,2355.988128,14.409072631896374,124,7.000000000000001E-5
7,test_20231031_155146,10863862.png,317432,12977,304455,0.9591188033972631,3,5,66058,1885,64173,0.9714644706167308,23.722218666666667,3236.9452053333334,13.029450130942488,124,7.000000000000001E-5
8,test_20231031_155146,11382381.png,312486,1099,311387,0.9964830424403013,3,6,46745,149,46596,0.996812493314793,20.626588444444444,2338.262816,14.441870374793048,124,7.000000000000001E-5
9,test_20231031_155146,11079715.png,443815,122782,321033,0.7233486925858748,5,7,124136,17120,107016,0.8620867435715667,16.763402666666668,2067.635402666667,14.97606401189655,124,7.000000000000001E-5
10,test_20231031_155146,11551286.png,271883,1199,270684,0.9955900148225524,3,6,40092,176,39916,0.995610096777412,15.83984888888889,1503.00104,16.36121079771285,124,7.000000000000001E-5
1,test_20231031_155147,10404007.png,502730,22884,479846,0.9544805362719552,3,6,61265,3295,57970,0.9462172529176528,25.586942222222223,3400.765381333333,12.815036898605106,124,8.0E-5
2,test_20231031_155147,1254659.png,342646,76264,266382,0.7774262650082009,5,6,80080,10638,69442,0.8671578421578422,20.667370666666667,3113.3477866666667,13.198527231942004,124,8.0E-5
3,test_20231031_155147,10188041.png,221231,10142,211089,0.954156515135763,4,6,41731,1428,40303,0.9657808343916993,10.476305777777778,997.11648,18.1433446668218,124,8.0E-5
4,test_20231031_155147,10287332.png,216980,12897,204083,0.940561342059176,3,6,22337,1766,20571,0.9209383534046649,9.311077333333333,749.8733493333333,19.38092441916683,124,8.0E-5
5,test_20231031_155147,11610969.png,368720,27227,341493,0.9261580603167715,4,6,84111,3970,80141,0.9528004660508138,20.228828444444446,2711.644832,13.798475553202607,124,8.0E-5
6,test_20231031_155147,10350842.png,212614,6344,206270,0.9701618896215677,2,6,42529,929,41600,0.9781560817324649,19.196949333333333,2355.988128,14.409072631896374,124,8.0E-5
7,test_20231031_155147,10863862.png,317432,12977,304455,0.9591188033972631,3,5,66058,1885,64173,0.9714644706167308,23.722218666666667,3236.9452053333334,13.029450130942488,124,8.0E-5
8,test_20231031_155147,11382381.png,312486,1099,311387,0.9964830424403013,3,6,46745,149,46596,0.996812493314793,20.626588444444444,2338.262816,14.441870374793048,124,8.0E-5
9,test_20231031_155147,11079715.png,443815,122782,321033,0.7233486925858748,6,7,124136,17120,107016,0.8620867435715667,16.763402666666668,2067.635402666667,14.97606401189655,124,8.0E-5
10,test_20231031_155147,11551286.png,271883,1199,270684,0.9955900148225524,2,5,40092,176,39916,0.995610096777412,15.83984888888889,1503.00104,16.36121079771285,124,8.0E-5
1,test_20231031_155148,10404007.png,502730,22884,479846,0.9544805362719552,3,5,61265,3295,57970,0.9462172529176528,25.586942222222223,3400.765381333333,12.815036898605106,124,9.0E-5
2,test_20231031_155148,1254659.png,342646,76264,266382,0.7774262650082009,4,7,80080,10638,69442,0.8671578421578422,20.667370666666667,3113.3477866666667,13.198527231942004,124,9.0E-5
3,test_20231031_155148,10188041.png,221231,10142,211089,0.954156515135763,3,6,41731,1428,40303,0.9657808343916993,10.476305777777778,997.11648,18.1433446668218,124,9.0E-5
4,test_20231031_155148,10287332.png,216980,12897,204083,0.940561342059176,3,6,22337,1766,20571,0.9209383534046649,9.311077333333333,749.8733493333333,19.38092441916683,124,9.0E-5
5,test_20231031_155148,11610969.png,368720,27227,341493,0.9261580603167715,4,6,84111,3970,80141,0.9528004660508138,20.228828444444446,2711.644832,13.798475553202607,124,9.0E-5
6,test_20231031_155148,10350842.png,212614,6344,206270,0.9701618896215677,2,6,42529,929,41600,0.9781560817324649,19.196949333333333,2355.988128,14.409072631896374,124,9.0E-5
7,test_20231031_155148,10863862.png,317432,12977,304455,0.9591188033972631,4,6,66058,1885,64173,0.9714644706167308,23.722218666666667,3236.9452053333334,13.029450130942488,124,9.0E-5
8,test_20231031_155148,11382381.png,312486,1099,311387,0.9964830424403013,3,6,46745,149,46596,0.996812493314793,20.626588444444444,2338.262816,14.441870374793048,124,9.0E-5
9,test_20231031_155148,11079715.png,443815,122782,321033,0.7233486925858748,5,6,124136,17120,107016,0.8620867435715667,16.763402666666668,2067.635402666667,14.97606401189655,124,9.0E-5
10,test_20231031_155148,11551286.png,271883,1199,270684,0.9955900148225524,2,6,40092,176,39916,0.995610096777412,15.83984888888889,1503.00104,16.36121079771285,124,9.0E-5
1,test_20231031_155149,10404007.png,502730,22884,479846,0.9544805362719552,3,6,61265,3295,57970,0.9462172529176528,25.586942222222223,3400.765381333333,12.815036898605106,124,1.0E-4
2,test_20231031_155149,1254659.png,342646,76264,266382,0.7774262650082009,5,6,80080,10638,69442,0.8671578421578422,20.667370666666667,3113.3477866666667,13.198527231942004,124,1.0E-4
3,test_20231031_155149,10188041.png,221231,10142,211089,0.954156515135763,3,5,41731,1428,40303,0.9657808343916993,10.476305777777778,997.11648,18.1433446668218,124,1.0E-4
4,test_20231031_155149,10287332.png,216980,12897,204083,0.940561342059176,2,5,22337,1766,20571,0.9209383534046649,9.311077333333333,749.8733493333333,19.38092441916683,124,1.0E-4
5,test_20231031_155149,11610969.png,368720,27227,341493,0.9261580603167715,3,5,84111,3970,80141,0.9528004660508138,20.228828444444446,2711.644832,13.798475553202607,124,1.0E-4
6,test_20231031_155149,10350842.png,212614,6344,206270,0.9701618896215677,2,5,42529,929,41600,0.9781560817324649,19.196949333333333,2355.988128,14.409072631896374,124,1.0E-4
7,test_20231031_155149,10863862.png,317432,12977,304455,0.9591188033972631,3,6,66058,1885,64173,0.9714644706167308,23.722218666666667,3236.9452053333334,13.029450130942488,124,1.0E-4
8,test_20231031_155149,11382381.png,312486,1099,311387,0.9964830424403013,3,6,46745,149,46596,0.996812493314793,20.626588444444444,2338.262816,14.441870374793048,124,1.0E-4
9,test_20231031_155149,11079715.png,443815,122782,321033,0.7233486925858748,5,6,124136,17120,107016,0.8620867435715667,16.763402666666668,2067.635402666667,14.97606401189655,124,1.0E-4
10,test_20231031_155149,11551286.png,271883,1199,270684,0.9955900148225524,2,5,40092,176,39916,0.995610096777412,15.83984888888889,1503.00104,16.36121079771285,124,1.0E-4
1,test_20231031_155150,10404007.png,502730,22884,479846,0.9544805362719552,4,6,61265,3295,57970,0.9462172529176528,25.586942222222223,3400.765381333333,12.815036898605106,124,1.1E-4
2,test_20231031_155150,1254659.png,342646,76264,266382,0.7774262650082009,5,6,80080,10638,69442,0.8671578421578422,20.667370666666667,3113.3477866666667,13.198527231942004,124,1.1E-4
3,test_20231031_155150,10188041.png,221231,10142,211089,0.954156515135763,3,6,41731,1428,40303,0.9657808343916993,10.476305777777778,997.11648,18.1433446668218,124,1.1E-4
4,test_20231031_155150,10287332.png,216980,12897,204083,0.940561342059176,3,6,22337,1766,20571,0.9209383534046649,9.311077333333333,749.8733493333333,19.38092441916683,124,1.1E-4
5,test_20231031_155150,11610969.png,368720,27227,341493,0.9261580603167715,4,6,84111,3970,80141,0.9528004660508138,20.228828444444446,2711.644832,13.798475553202607,124,1.1E-4
6,test_20231031_155150,10350842.png,212614,6344,206270,0.9701618896215677,2,5,42529,929,41600,0.9781560817324649,19.196949333333333,2355.988128,14.409072631896374,124,1.1E-4
7,test_20231031_155150,10863862.png,317432,12977,304455,0.9591188033972631,3,6,66058,1885,64173,0.9714644706167308,23.722218666666667,3236.9452053333334,13.029450130942488,124,1.1E-4
8,test_20231031_155150,11382381.png,312486,1099,311387,0.9964830424403013,3,12,46745,149,46596,0.996812493314793,20.626588444444444,2338.262816,14.441870374793048,124,1.1E-4
9,test_20231031_155150,11079715.png,443815,122782,321033,0.7233486925858748,5,7,124136,17120,107016,0.8620867435715667,16.763402666666668,2067.635402666667,14.97606401189655,124,1.1E-4
10,test_20231031_155150,11551286.png,271883,1199,270684,0.9955900148225524,4,6,40092,176,39916,0.995610096777412,15.83984888888889,1503.00104,16.36121079771285,124,1.1E-4
1,test_20231031_155151,10404007.png,502730,22884,479846,0.9544805362719552,3,5,61265,3295,57970,0.9462172529176528,25.586942222222223,3400.765381333333,12.815036898605106,124,1.2E-4
2,test_20231031_155151,1254659.png,342646,76264,266382,0.7774262650082009,4,6,80080,10638,69442,0.8671578421578422,20.667370666666667,3113.3477866666667,13.198527231942004,124,1.2E-4
3,test_20231031_155151,10188041.png,221231,10142,211089,0.954156515135763,3,6,41731,1428,40303,0.9657808343916993,10.476305777777778,997.11648,18.1433446668218,124,1.2E-4
4,test_20231031_155151,10287332.png,216980,12897,204083,0.940561342059176,2,11,22337,1766,20571,0.9209383534046649,9.311077333333333,749.8733493333333,19.38092441916683,124,1.2E-4
5,test_20231031_155151,11610969.png,368720,27227,341493,0.9261580603167715,5,6,84111,3970,80141,0.9528004660508138,20.228828444444446,2711.644832,13.798475553202607,124,1.2E-4
6,test_20231031_155151,10350842.png,212614,6344,206270,0.9701618896215677,3,6,42529,929,41600,0.9781560817324649,19.196949333333333,2355.988128,14.409072631896374,124,1.2E-4
7,test_20231031_155151,10863862.png,317432,12977,304455,0.9591188033972631,3,6,66058,1885,64173,0.9714644706167308,23.722218666666667,3236.9452053333334,13.029450130942488,124,1.2E-4
8,test_20231031_155151,11382381.png,312486,1099,311387,0.9964830424403013,3,6,46745,149,46596,0.996812493314793,20.626588444444444,2338.262816,14.441870374793048,124,1.2E-4
9,test_20231031_155151,11079715.png,443815,122782,321033,0.7233486925858748,5,7,124136,17120,107016,0.8620867435715667,16.763402666666668,2067.635402666667,14.97606401189655,124,1.2E-4
10,test_20231031_155151,11551286.png,271883,1199,270684,0.9955900148225524,9,6,40092,176,39916,0.995610096777412,15.83984888888889,1503.00104,16.36121079771285,124,1.2E-4
1,test_20231031_155152,10404007.png,502730,22884,479846,0.9544805362719552,4,6,61265,3295,57970,0.9462172529176528,25.586942222222223,3400.765381333333,12.815036898605106,124,1.3000000000000002E-4
2,test_20231031_155152,1254659.png,342646,76264,266382,0.7774262650082009,10,7,80080,10638,69442,0.8671578421578422,20.667370666666667,3113.3477866666667,13.198527231942004,124,1.3000000000000002E-4
3,test_20231031_155152,10188041.png,221231,10142,211089,0.954156515135763,3,6,41731,1428,40303,0.9657808343916993,10.476305777777778,997.11648,18.1433446668218,124,1.3000000000000002E-4
4,test_20231031_155152,10287332.png,216980,12897,204083,0.940561342059176,3,6,22337,1766,20571,0.9209383534046649,9.311077333333333,749.8733493333333,19.38092441916683,124,1.3000000000000002E-4
5,test_20231031_155152,11610969.png,368720,27227,341493,0.9261580603167715,3,5,84111,3970,80141,0.9528004660508138,20.228828444444446,2711.644832,13.798475553202607,124,1.3000000000000002E-4
6,test_20231031_155152,10350842.png,212614,6344,206270,0.9701618896215677,2,6,42529,929,41600,0.9781560817324649,19.196949333333333,2355.988128,14.409072631896374,124,1.3000000000000002E-4
7,test_20231031_155152,10863862.png,317432,12977,304455,0.9591188033972631,4,6,66058,1885,64173,0.9714644706167308,23.722218666666667,3236.9452053333334,13.029450130942488,124,1.3000000000000002E-4
8,test_20231031_155152,11382381.png,312486,1099,311387,0.9964830424403013,3,5,46745,149,46596,0.996812493314793,20.626588444444444,2338.262816,14.441870374793048,124,1.3000000000000002E-4
9,test_20231031_155152,11079715.png,443815,122782,321033,0.7233486925858748,5,7,124136,17120,107016,0.8620867435715667,16.763402666666668,2067.635402666667,14.97606401189655,124,1.3000000000000002E-4
10,test_20231031_155152,11551286.png,271883,997,270886,0.9963329814662925,2,5,40092,146,39946,0.9963583757358077,16.30040888888889,1591.9994026666666,16.11137460417654,124,1.3000000000000002E-4
1,test_20231031_155153,10404007.png,502730,22884,479846,0.9544805362719552,3,6,61265,3295,57970,0.9462172529176528,25.586942222222223,3400.765381333333,12.815036898605106,124,1.4000000000000001E-4
2,test_20231031_155153,1254659.png,342646,76264,266382,0.7774262650082009,5,6,80080,10638,69442,0.8671578421578422,20.667370666666667,3113.3477866666667,13.198527231942004,124,1.4000000000000001E-4
3,test_20231031_155153,10188041.png,221231,10142,211089,0.954156515135763,3,5,41731,1428,40303,0.9657808343916993,10.476305777777778,997.11648,18.1433446668218,124,1.4000000000000001E-4
4,test_20231031_155153,10287332.png,216980,12897,204083,0.940561342059176,3,7,22337,1766,20571,0.9209383534046649,9.311077333333333,749.8733493333333,19.38092441916683,124,1.4000000000000001E-4
5,test_20231031_155153,11610969.png,368720,27227,341493,0.9261580603167715,4,6,84111,3970,80141,0.9528004660508138,20.228828444444446,2711.644832,13.798475553202607,124,1.4000000000000001E-4
6,test_20231031_155153,10350842.png,212614,6344,206270,0.9701618896215677,3,6,42529,929,41600,0.9781560817324649,19.196949333333333,2355.988128,14.409072631896374,124,1.4000000000000001E-4
7,test_20231031_155153,10863862.png,317432,12977,304455,0.9591188033972631,3,6,66058,1885,64173,0.9714644706167308,23.722218666666667,3236.9452053333334,13.029450130942488,124,1.4000000000000001E-4
8,test_20231031_155153,11382381.png,312486,1099,311387,0.9964830424403013,3,6,46745,149,46596,0.996812493314793,20.626588444444444,2338.262816,14.441870374793048,124,1.4000000000000001E-4
9,test_20231031_155153,11079715.png,443815,122782,321033,0.7233486925858748,6,7,124136,17120,107016,0.8620867435715667,16.763402666666668,2067.635402666667,14.97606401189655,124,1.4000000000000001E-4
10,test_20231031_155153,11551286.png,271883,997,270886,0.9963329814662925,2,6,40092,146,39946,0.9963583757358077,16.30040888888889,1591.9994026666666,16.11137460417654,124,1.4000000000000001E-4
1,test_20231031_155154,10404007.png,502730,22884,479846,0.9544805362719552,4,6,61265,3295,57970,0.9462172529176528,25.586942222222223,3400.765381333333,12.815036898605106,124,1.5000000000000001E-4
2,test_20231031_155154,1254659.png,342646,76264,266382,0.7774262650082009,4,6,80080,10638,69442,0.8671578421578422,20.667370666666667,3113.3477866666667,13.198527231942004,124,1.5000000000000001E-4
3,test_20231031_155154,10188041.png,221231,10142,211089,0.954156515135763,4,6,41731,1428,40303,0.9657808343916993,10.476305777777778,997.11648,18.1433446668218,124,1.5000000000000001E-4
4,test_20231031_155154,10287332.png,216980,12897,204083,0.940561342059176,3,6,22337,1766,20571,0.9209383534046649,9.311077333333333,749.8733493333333,19.38092441916683,124,1.5000000000000001E-4
5,test_20231031_155154,11610969.png,368720,27227,341493,0.9261580603167715,4,5,84111,3970,80141,0.9528004660508138,20.228828444444446,2711.644832,13.798475553202607,124,1.5000000000000001E-4
6,test_20231031_155154,10350842.png,212614,6344,206270,0.9701618896215677,3,6,42529,929,41600,0.9781560817324649,19.196949333333333,2355.988128,14.409072631896374,124,1.5000000000000001E-4
7,test_20231031_155154,10863862.png,317432,12977,304455,0.9591188033972631,3,9,66058,1885,64173,0.9714644706167308,23.722218666666667,3236.9452053333334,13.029450130942488,124,1.5000000000000001E-4
8,test_20231031_155154,11382381.png,312486,1099,311387,0.9964830424403013,3,5,46745,149,46596,0.996812493314793,20.626588444444444,2338.262816,14.441870374793048,124,1.5000000000000001E-4
9,test_20231031_155154,11079715.png,443815,122782,321033,0.7233486925858748,5,7,124136,17120,107016,0.8620867435715667,16.763402666666668,2067.635402666667,14.97606401189655,124,1.5000000000000001E-4
10,test_20231031_155154,11551286.png,271883,997,270886,0.9963329814662925,2,5,40092,146,39946,0.9963583757358077,16.30040888888889,1591.9994026666666,16.11137460417654,124,1.5000000000000001E-4
1,test_20231031_155155,10404007.png,502730,22884,479846,0.9544805362719552,4,6,61265,3295,57970,0.9462172529176528,25.586942222222223,3400.765381333333,12.815036898605106,124,1.6E-4
2,test_20231031_155155,1254659.png,342646,76264,266382,0.7774262650082009,5,6,80080,10638,69442,0.8671578421578422,20.667370666666667,3113.3477866666667,13.198527231942004,124,1.6E-4
3,test_20231031_155155,10188041.png,221231,10142,211089,0.954156515135763,4,5,41731,1428,40303,0.9657808343916993,10.476305777777778,997.11648,18.1433446668218,124,1.6E-4
4,test_20231031_155155,10287332.png,216980,12687,204293,0.9415291731956862,2,6,22337,1739,20598,0.9221471101759413,9.440839111111112,776.604096,19.22880684076492,124,1.6E-4
5,test_20231031_155155,11610969.png,368720,27227,341493,0.9261580603167715,4,6,84111,3970,80141,0.9528004660508138,20.228828444444446,2711.644832,13.798475553202607,124,1.6E-4
6,test_20231031_155155,10350842.png,212614,6344,206270,0.9701618896215677,2,5,42529,929,41600,0.9781560817324649,19.196949333333333,2355.988128,14.409072631896374,124,1.6E-4
7,test_20231031_155155,10863862.png,317432,12977,304455,0.9591188033972631,3,5,66058,1885,64173,0.9714644706167308,23.722218666666667,3236.9452053333334,13.029450130942488,124,1.6E-4
8,test_20231031_155155,11382381.png,312486,1099,311387,0.9964830424403013,2,6,46745,149,46596,0.996812493314793,20.626588444444444,2338.262816,14.441870374793048,124,1.6E-4
9,test_20231031_155155,11079715.png,443815,122782,321033,0.7233486925858748,6,7,124136,17120,107016,0.8620867435715667,16.763402666666668,2067.635402666667,14.97606401189655,124,1.6E-4
10,test_20231031_155155,11551286.png,271883,997,270886,0.9963329814662925,2,6,40092,146,39946,0.9963583757358077,16.30040888888889,1591.9994026666666,16.11137460417654,124,1.6E-4
1,test_20231031_155156,10404007.png,502730,22884,479846,0.9544805362719552,3,5,61265,3295,57970,0.9462172529176528,25.586942222222223,3400.765381333333,12.815036898605106,124,1.7E-4
2,test_20231031_155156,1254659.png,342646,76264,266382,0.7774262650082009,5,7,80080,10638,69442,0.8671578421578422,20.667370666666667,3113.3477866666667,13.198527231942004,124,1.7E-4
3,test_20231031_155156,10188041.png,221231,10142,211089,0.954156515135763,3,5,41731,1428,40303,0.9657808343916993,10.476305777777778,997.11648,18.1433446668218,124,1.7E-4
4,test_20231031_155156,10287332.png,216980,12687,204293,0.9415291731956862,2,5,22337,1739,20598,0.9221471101759413,9.440839111111112,776.604096,19.22880684076492,124,1.7E-4
5,test_20231031_155156,11610969.png,368720,27227,341493,0.9261580603167715,4,6,84111,3970,80141,0.9528004660508138,20.228828444444446,2711.644832,13.798475553202607,124,1.7E-4
6,test_20231031_155156,10350842.png,212614,6344,206270,0.9701618896215677,2,5,42529,929,41600,0.9781560817324649,19.196949333333333,2355.988128,14.409072631896374,124,1.7E-4
7,test_20231031_155156,10863862.png,317432,12977,304455,0.9591188033972631,3,5,66058,1885,64173,0.9714644706167308,23.722218666666667,3236.9452053333334,13.029450130942488,124,1.7E-4
8,test_20231031_155156,11382381.png,312486,1099,311387,0.9964830424403013,3,6,46745,149,46596,0.996812493314793,20.626588444444444,2338.262816,14.441870374793048,124,1.7E-4
9,test_20231031_155156,11079715.png,443815,122782,321033,0.7233486925858748,5,6,124136,17120,107016,0.8620867435715667,16.763402666666668,2067.635402666667,14.97606401189655,124,1.7E-4
10,test_20231031_155156,11551286.png,271883,997,270886,0.9963329814662925,2,5,40092,146,39946,0.9963583757358077,16.30040888888889,1591.9994026666666,16.11137460417654,124,1.7E-4
1,test_20231031_155157,10404007.png,502730,22884,479846,0.9544805362719552,3,5,61265,3295,57970,0.9462172529176528,25.586942222222223,3400.765381333333,12.815036898605106,124,1.8E-4
2,test_20231031_155157,1254659.png,342646,76264,266382,0.7774262650082009,5,6,80080,10638,69442,0.8671578421578422,20.667370666666667,3113.3477866666667,13.198527231942004,124,1.8E-4
3,test_20231031_155157,10188041.png,221231,10142,211089,0.954156515135763,3,6,41731,1428,40303,0.9657808343916993,10.476305777777778,997.11648,18.1433446668218,124,1.8E-4
4,test_20231031_155157,10287332.png,216980,12687,204293,0.9415291731956862,3,6,22337,1739,20598,0.9221471101759413,9.440839111111112,776.604096,19.22880684076492,124,1.8E-4
5,test_20231031_155157,11610969.png,368720,27227,341493,0.9261580603167715,3,6,84111,3970,80141,0.9528004660508138,20.228828444444446,2711.644832,13.798475553202607,124,1.8E-4
6,test_20231031_155157,10350842.png,212614,6344,206270,0.9701618896215677,3,6,42529,929,41600,0.9781560817324649,19.196949333333333,2355.988128,14.409072631896374,124,1.8E-4
7,test_20231031_155157,10863862.png,317432,12977,304455,0.9591188033972631,3,6,66058,1885,64173,0.9714644706167308,23.722218666666667,3236.9452053333334,13.029450130942488,124,1.8E-4
8,test_20231031_155157,11382381.png,312486,1099,311387,0.9964830424403013,3,6,46745,149,46596,0.996812493314793,20.626588444444444,2338.262816,14.441870374793048,124,1.8E-4
9,test_20231031_155157,11079715.png,443815,122782,321033,0.7233486925858748,7,7,124136,17120,107016,0.8620867435715667,16.763402666666668,2067.635402666667,14.97606401189655,124,1.8E-4
10,test_20231031_155157,11551286.png,271883,997,270886,0.9963329814662925,2,6,40092,146,39946,0.9963583757358077,16.30040888888889,1591.9994026666666,16.11137460417654,124,1.8E-4
1,test_20231031_155158,10404007.png,502730,22884,479846,0.9544805362719552,4,6,61265,3295,57970,0.9462172529176528,25.586942222222223,3400.765381333333,12.815036898605106,124,1.9E-4
2,test_20231031_155158,1254659.png,342646,76264,266382,0.7774262650082009,5,6,80080,10638,69442,0.8671578421578422,20.667370666666667,3113.3477866666667,13.198527231942004,124,1.9E-4
3,test_20231031_155158,10188041.png,221231,10142,211089,0.954156515135763,3,5,41731,1428,40303,0.9657808343916993,10.476305777777778,997.11648,18.1433446668218,124,1.9E-4
4,test_20231031_155158,10287332.png,216980,12687,204293,0.9415291731956862,3,6,22337,1739,20598,0.9221471101759413,9.440839111111112,776.604096,19.22880684076492,124,1.9E-4
5,test_20231031_155158,11610969.png,368720,27227,341493,0.9261580603167715,4,6,84111,3970,80141,0.9528004660508138,20.228828444444446,2711.644832,13.798475553202607,124,1.9E-4
6,test_20231031_155158,10350842.png,212614,6344,206270,0.9701618896215677,2,6,42529,929,41600,0.9781560817324649,19.196949333333333,2355.988128,14.409072631896374,124,1.9E-4
7,test_20231031_155158,10863862.png,317432,12977,304455,0.9591188033972631,4,6,66058,1885,64173,0.9714644706167308,23.722218666666667,3236.9452053333334,13.029450130942488,124,1.9E-4
8,test_20231031_155158,11382381.png,312486,1099,311387,0.9964830424403013,3,5,46745,149,46596,0.996812493314793,20.626588444444444,2338.262816,14.441870374793048,124,1.9E-4
9,test_20231031_155158,11079715.png,443815,122782,321033,0.7233486925858748,5,7,124136,17120,107016,0.8620867435715667,16.763402666666668,2067.635402666667,14.97606401189655,124,1.9E-4
10,test_20231031_155158,11551286.png,271883,997,270886,0.9963329814662925,2,6,40092,146,39946,0.9963583757358077,16.30040888888889,1591.9994026666666,16.11137460417654,124,1.9E-4
1,test_20231031_155159,10404007.png,502730,22884,479846,0.9544805362719552,4,6,61265,3295,57970,0.9462172529176528,25.586942222222223,3400.765381333333,12.815036898605106,124,2.0E-4
2,test_20231031_155159,1254659.png,342646,76264,266382,0.7774262650082009,4,6,80080,10638,69442,0.8671578421578422,20.667370666666667,3113.3477866666667,13.198527231942004,124,2.0E-4
3,test_20231031_155159,10188041.png,221231,10142,211089,0.954156515135763,3,6,41731,1428,40303,0.9657808343916993,10.476305777777778,997.11648,18.1433446668218,124,2.0E-4
4,test_20231031_155159,10287332.png,216980,12687,204293,0.9415291731956862,2,5,22337,1739,20598,0.9221471101759413,9.440839111111112,776.604096,19.22880684076492,124,2.0E-4
5,test_20231031_155159,11610969.png,368720,27227,341493,0.9261580603167715,4,6,84111,3970,80141,0.9528004660508138,20.228828444444446,2711.644832,13.798475553202607,124,2.0E-4
6,test_20231031_155159,10350842.png,212614,6344,206270,0.9701618896215677,2,6,42529,929,41600,0.9781560817324649,19.196949333333333,2355.988128,14.409072631896374,124,2.0E-4
7,test_20231031_155159,10863862.png,317432,12977,304455,0.9591188033972631,4,5,66058,1885,64173,0.9714644706167308,23.722218666666667,3236.9452053333334,13.029450130942488,124,2.0E-4
8,test_20231031_155159,11382381.png,312486,907,311579,0.9970974699666545,3,6,46745,121,46624,0.9974114878596642,21.088220444444445,2409.5101546666665,14.311515999312824,124,2.0E-4
9,test_20231031_155159,11079715.png,443815,122782,321033,0.7233486925858748,5,7,124136,17120,107016,0.8620867435715667,16.763402666666668,2067.635402666667,14.97606401189655,124,2.0E-4
10,test_20231031_155159,11551286.png,271883,977,270906,0.9964065425201282,3,5,40092,143,39949,0.9964332036316472,17.00562311111111,1711.9347146666667,15.795931622093908,124,2.0E-4
1,test_20231031_155200,10404007.png,502730,22884,479846,0.9544805362719552,4,6,61265,3295,57970,0.9462172529176528,25.586942222222223,3400.765381333333,12.815036898605106,124,2.1E-4
2,test_20231031_155200,1254659.png,342646,76264,266382,0.7774262650082009,5,6,80080,10638,69442,0.8671578421578422,20.667370666666667,3113.3477866666667,13.198527231942004,124,2.1E-4
3,test_20231031_155200,10188041.png,221231,10142,211089,0.954156515135763,3,7,41731,1428,40303,0.9657808343916993,10.476305777777778,997.11648,18.1433446668218,124,2.1E-4
4,test_20231031_155200,10287332.png,216980,12687,204293,0.9415291731956862,2,6,22337,1739,20598,0.9221471101759413,9.440839111111112,776.604096,19.22880684076492,124,2.1E-4
5,test_20231031_155200,11610969.png,368720,27227,341493,0.9261580603167715,4,6,84111,3970,80141,0.9528004660508138,20.228828444444446,2711.644832,13.798475553202607,124,2.1E-4
6,test_20231031_155200,10350842.png,212614,6344,206270,0.9701618896215677,2,5,42529,929,41600,0.9781560817324649,19.196949333333333,2355.988128,14.409072631896374,124,2.1E-4
7,test_20231031_155200,10863862.png,317432,12977,304455,0.9591188033972631,3,6,66058,1885,64173,0.9714644706167308,23.722218666666667,3236.9452053333334,13.029450130942488,124,2.1E-4
8,test_20231031_155200,11382381.png,312486,907,311579,0.9970974699666545,2,6,46745,121,46624,0.9974114878596642,21.088220444444445,2409.5101546666665,14.311515999312824,124,2.1E-4
9,test_20231031_155200,11079715.png,443815,122782,321033,0.7233486925858748,5,7,124136,17120,107016,0.8620867435715667,16.763402666666668,2067.635402666667,14.97606401189655,124,2.1E-4
10,test_20231031_155200,11551286.png,271883,977,270906,0.9964065425201282,2,5,40092,143,39949,0.9964332036316472,17.00562311111111,1711.9347146666667,15.795931622093908,124,2.1E-4
1,test_20231031_155201,10404007.png,502730,22884,479846,0.9544805362719552,4,6,61265,3295,57970,0.9462172529176528,25.586942222222223,3400.765381333333,12.815036898605106,124,2.2E-4
2,test_20231031_155201,1254659.png,342646,76264,266382,0.7774262650082009,5,6,80080,10638,69442,0.8671578421578422,20.667370666666667,3113.3477866666667,13.198527231942004,124,2.2E-4
3,test_20231031_155201,10188041.png,221231,10142,211089,0.954156515135763,3,5,41731,1428,40303,0.9657808343916993,10.476305777777778,997.11648,18.1433446668218,124,2.2E-4
4,test_20231031_155201,10287332.png,216980,12687,204293,0.9415291731956862,2,5,22337,1739,20598,0.9221471101759413,9.440839111111112,776.604096,19.22880684076492,124,2.2E-4
5,test_20231031_155201,11610969.png,368720,27227,341493,0.9261580603167715,3,6,84111,3970,80141,0.9528004660508138,20.228828444444446,2711.644832,13.798475553202607,124,2.2E-4
6,test_20231031_155201,10350842.png,212614,6344,206270,0.9701618896215677,2,5,42529,929,41600,0.9781560817324649,19.196949333333333,2355.988128,14.409072631896374,124,2.2E-4
7,test_20231031_155201,10863862.png,317432,12977,304455,0.9591188033972631,3,6,66058,1885,64173,0.9714644706167308,23.722218666666667,3236.9452053333334,13.029450130942488,124,2.2E-4
8,test_20231031_155201,11382381.png,312486,907,311579,0.9970974699666545,2,6,46745,121,46624,0.9974114878596642,21.088220444444445,2409.5101546666665,14.311515999312824,124,2.2E-4
9,test_20231031_155201,11079715.png,443815,122782,321033,0.7233486925858748,5,6,124136,17120,107016,0.8620867435715667,16.763402666666668,2067.635402666667,14.97606401189655,124,2.2E-4
10,test_20231031_155201,11551286.png,271883,977,270906,0.9964065425201282,3,6,40092,143,39949,0.9964332036316472,17.00562311111111,1711.9347146666667,15.795931622093908,124,2.2E-4
1,test_20231031_155202,10404007.png,502730,22884,479846,0.9544805362719552,3,5,61265,3295,57970,0.9462172529176528,25.586942222222223,3400.765381333333,12.815036898605106,124,2.3E-4
2,test_20231031_155202,1254659.png,342646,76264,266382,0.7774262650082009,5,6,80080,10638,69442,0.8671578421578422,20.667370666666667,3113.3477866666667,13.198527231942004,124,2.3E-4
3,test_20231031_155202,10188041.png,221231,10142,211089,0.954156515135763,3,5,41731,1428,40303,0.9657808343916993,10.476305777777778,997.11648,18.1433446668218,124,2.3E-4
4,test_20231031_155202,10287332.png,216980,12687,204293,0.9415291731956862,2,5,22337,1739,20598,0.9221471101759413,9.440839111111112,776.604096,19.22880684076492,124,2.3E-4
5,test_20231031_155202,11610969.png,368720,27227,341493,0.9261580603167715,4,6,84111,3970,80141,0.9528004660508138,20.228828444444446,2711.644832,13.798475553202607,124,2.3E-4
6,test_20231031_155202,10350842.png,212614,6344,206270,0.9701618896215677,2,5,42529,929,41600,0.9781560817324649,19.196949333333333,2355.988128,14.409072631896374,124,2.3E-4
7,test_20231031_155202,10863862.png,317432,12977,304455,0.9591188033972631,3,6,66058,1885,64173,0.9714644706167308,23.722218666666667,3236.9452053333334,13.029450130942488,124,2.3E-4
8,test_20231031_155202,11382381.png,312486,907,311579,0.9970974699666545,3,5,46745,121,46624,0.9974114878596642,21.088220444444445,2409.5101546666665,14.311515999312824,124,2.3E-4
9,test_20231031_155202,11079715.png,443815,122782,321033,0.7233486925858748,6,6,124136,17120,107016,0.8620867435715667,16.763402666666668,2067.635402666667,14.97606401189655,124,2.3E-4
10,test_20231031_155202,11551286.png,271883,977,270906,0.9964065425201282,3,5,40092,143,39949,0.9964332036316472,17.00562311111111,1711.9347146666667,15.795931622093908,124,2.3E-4
1,test_20231031_155203,10404007.png,502730,22884,479846,0.9544805362719552,3,5,61265,3295,57970,0.9462172529176528,25.586942222222223,3400.765381333333,12.815036898605106,124,2.4E-4
2,test_20231031_155203,1254659.png,342646,76264,266382,0.7774262650082009,5,6,80080,10638,69442,0.8671578421578422,20.667370666666667,3113.3477866666667,13.198527231942004,124,2.4E-4
3,test_20231031_155203,10188041.png,221231,10142,211089,0.954156515135763,3,6,41731,1428,40303,0.9657808343916993,10.476305777777778,997.11648,18.1433446668218,124,2.4E-4
4,test_20231031_155203,10287332.png,216980,12687,204293,0.9415291731956862,3,6,22337,1739,20598,0.9221471101759413,9.440839111111112,776.604096,19.22880684076492,124,2.4E-4
5,test_20231031_155203,11610969.png,368720,27227,341493,0.9261580603167715,3,6,84111,3970,80141,0.9528004660508138,20.228828444444446,2711.644832,13.798475553202607,124,2.4E-4
6,test_20231031_155203,10350842.png,212614,6344,206270,0.9701618896215677,2,5,42529,929,41600,0.9781560817324649,19.196949333333333,2355.988128,14.409072631896374,124,2.4E-4
7,test_20231031_155203,10863862.png,317432,12977,304455,0.9591188033972631,3,6,66058,1885,64173,0.9714644706167308,23.722218666666667,3236.9452053333334,13.029450130942488,124,2.4E-4
8,test_20231031_155203,11382381.png,312486,907,311579,0.9970974699666545,2,6,46745,121,46624,0.9974114878596642,21.088220444444445,2409.5101546666665,14.311515999312824,124,2.4E-4
9,test_20231031_155203,11079715.png,443815,122782,321033,0.7233486925858748,5,6,124136,17120,107016,0.8620867435715667,16.763402666666668,2067.635402666667,14.97606401189655,124,2.4E-4
10,test_20231031_155203,11551286.png,271883,977,270906,0.9964065425201282,2,15,40092,143,39949,0.9964332036316472,17.00562311111111,1711.9347146666667,15.795931622093908,124,2.4E-4
1,test_20231031_155204,10404007.png,502730,22884,479846,0.9544805362719552,3,6,61265,3295,57970,0.9462172529176528,25.586942222222223,3400.765381333333,12.815036898605106,124,2.5E-4
2,test_20231031_155204,1254659.png,342646,76264,266382,0.7774262650082009,5,6,80080,10638,69442,0.8671578421578422,20.667370666666667,3113.3477866666667,13.198527231942004,124,2.5E-4
3,test_20231031_155204,10188041.png,221231,10142,211089,0.954156515135763,3,6,41731,1428,40303,0.9657808343916993,10.476305777777778,997.11648,18.1433446668218,124,2.5E-4
4,test_20231031_155204,10287332.png,216980,12687,204293,0.9415291731956862,2,5,22337,1739,20598,0.9221471101759413,9.440839111111112,776.604096,19.22880684076492,124,2.5E-4
5,test_20231031_155204,11610969.png,368720,27227,341493,0.9261580603167715,4,6,84111,3970,80141,0.9528004660508138,20.228828444444446,2711.644832,13.798475553202607,124,2.5E-4
6,test_20231031_155204,10350842.png,212614,6344,206270,0.9701618896215677,2,5,42529,929,41600,0.9781560817324649,19.196949333333333,2355.988128,14.409072631896374,124,2.5E-4
7,test_20231031_155204,10863862.png,317432,12977,304455,0.9591188033972631,4,6,66058,1885,64173,0.9714644706167308,23.722218666666667,3236.9452053333334,13.029450130942488,124,2.5E-4
8,test_20231031_155204,11382381.png,312486,907,311579,0.9970974699666545,2,9,46745,121,46624,0.9974114878596642,21.088220444444445,2409.5101546666665,14.311515999312824,124,2.5E-4
9,test_20231031_155204,11079715.png,443815,122782,321033,0.7233486925858748,5,6,124136,17120,107016,0.8620867435715667,16.763402666666668,2067.635402666667,14.97606401189655,124,2.5E-4
10,test_20231031_155204,11551286.png,271883,977,270906,0.9964065425201282,2,6,40092,143,39949,0.9964332036316472,17.00562311111111,1711.9347146666667,15.795931622093908,124,2.5E-4
1,test_20231031_155205,10404007.png,502730,22704,480026,0.9548385813458516,4,6,61265,3271,57994,0.9466089937158247,25.603198222222222,3403.693370666667,12.811299320833328,124,2.6000000000000003E-4
2,test_20231031_155205,1254659.png,342646,76204,266442,0.777601372845444,13,6,80080,10632,69448,0.8672327672327672,20.676924444444445,3114.4299733333332,13.197017904793334,124,2.6000000000000003E-4
3,test_20231031_155205,10188041.png,221231,10042,211189,0.954608531354105,3,6,41731,1414,40317,0.9661163164074669,10.599658666666667,1012.831872,18.07543001512229,124,2.6000000000000003E-4
4,test_20231031_155205,10287332.png,216980,12687,204293,0.9415291731956862,2,6,22337,1739,20598,0.9221471101759413,9.440839111111112,776.604096,19.22880684076492,124,2.6000000000000003E-4
5,test_20231031_155205,11610969.png,368720,26582,342138,0.9279073551746583,4,6,84111,3877,80234,0.9539061478284647,21.465290666666668,2964.25984,13.411640906658562,124,2.6000000000000003E-4
6,test_20231031_155205,10350842.png,212614,6264,206350,0.9705381583526955,3,6,42529,917,41612,0.978438242140657,19.265742222222222,2361.7458346666667,14.398472027898631,124,2.6000000000000003E-4
7,test_20231031_155205,10863862.png,317432,12917,304515,0.959307820257567,3,6,66058,1876,64182,0.9716007145236005,23.73152711111111,3238.389536,13.027512733498073,124,2.6000000000000003E-4
8,test_20231031_155205,11382381.png,312486,767,311719,0.9975454900379537,2,6,46745,100,46645,0.9978607337683175,21.58402311111111,2479.723024,14.186771864393144,124,2.6000000000000003E-4
9,test_20231031_155205,11079715.png,443815,122782,321033,0.7233486925858748,6,7,124136,17120,107016,0.8620867435715667,16.763402666666668,2067.635402666667,14.97606401189655,124,2.6000000000000003E-4
10,test_20231031_155205,11551286.png,271883,857,271026,0.9968479088431421,2,5,40092,125,39967,0.9968821710066846,17.555712,1807.787776,15.559329154375803,124,2.6000000000000003E-4
1,test_20231031_155206,10404007.png,502730,22704,480026,0.9548385813458516,4,6,61265,3271,57994,0.9466089937158247,25.603198222222222,3403.693370666667,12.811299320833328,124,2.7000000000000006E-4
2,test_20231031_155206,1254659.png,342646,76204,266442,0.777601372845444,4,6,80080,10632,69448,0.8672327672327672,20.676924444444445,3114.4299733333332,13.197017904793334,124,2.7000000000000006E-4
3,test_20231031_155206,10188041.png,221231,10042,211189,0.954608531354105,3,5,41731,1414,40317,0.9661163164074669,10.599658666666667,1012.831872,18.07543001512229,124,2.7000000000000006E-4
4,test_20231031_155206,10287332.png,216980,12687,204293,0.9415291731956862,2,5,22337,1739,20598,0.9221471101759413,9.440839111111112,776.604096,19.22880684076492,124,2.7000000000000006E-4
5,test_20231031_155206,11610969.png,368720,26582,342138,0.9279073551746583,3,5,84111,3877,80234,0.9539061478284647,21.465290666666668,2964.25984,13.411640906658562,124,2.7000000000000006E-4
6,test_20231031_155206,10350842.png,212614,6264,206350,0.9705381583526955,3,5,42529,917,41612,0.978438242140657,19.265742222222222,2361.7458346666667,14.398472027898631,124,2.7000000000000006E-4
7,test_20231031_155206,10863862.png,317432,12917,304515,0.959307820257567,3,6,66058,1876,64182,0.9716007145236005,23.73152711111111,3238.389536,13.027512733498073,124,2.7000000000000006E-4
8,test_20231031_155206,11382381.png,312486,767,311719,0.9975454900379537,3,6,46745,100,46645,0.9978607337683175,21.58402311111111,2479.723024,14.186771864393144,124,2.7000000000000006E-4
9,test_20231031_155206,11079715.png,443815,122782,321033,0.7233486925858748,6,7,124136,17120,107016,0.8620867435715667,16.763402666666668,2067.635402666667,14.97606401189655,124,2.7000000000000006E-4
10,test_20231031_155206,11551286.png,271883,857,271026,0.9968479088431421,2,6,40092,125,39967,0.9968821710066846,17.555712,1807.787776,15.559329154375803,124,2.7000000000000006E-4
1,test_20231031_155207,10404007.png,502730,22704,480026,0.9548385813458516,4,6,61265,3271,57994,0.9466089937158247,25.603198222222222,3403.693370666667,12.811299320833328,124,2.800000000000001E-4
2,test_20231031_155207,1254659.png,342646,76204,266442,0.777601372845444,5,6,80080,10632,69448,0.8672327672327672,20.676924444444445,3114.4299733333332,13.197017904793334,124,2.800000000000001E-4
3,test_20231031_155207,10188041.png,221231,10042,211189,0.954608531354105,3,5,41731,1414,40317,0.9661163164074669,10.599658666666667,1012.831872,18.07543001512229,124,2.800000000000001E-4
4,test_20231031_155207,10287332.png,216980,12687,204293,0.9415291731956862,2,10,22337,1739,20598,0.9221471101759413,9.440839111111112,776.604096,19.22880684076492,124,2.800000000000001E-4
5,test_20231031_155207,11610969.png,368720,26582,342138,0.9279073551746583,4,6,84111,3877,80234,0.9539061478284647,21.465290666666668,2964.25984,13.411640906658562,124,2.800000000000001E-4
6,test_20231031_155207,10350842.png,212614,6264,206350,0.9705381583526955,3,6,42529,917,41612,0.978438242140657,19.265742222222222,2361.7458346666667,14.398472027898631,124,2.800000000000001E-4
7,test_20231031_155207,10863862.png,317432,12917,304515,0.959307820257567,3,6,66058,1876,64182,0.9716007145236005,23.73152711111111,3238.389536,13.027512733498073,124,2.800000000000001E-4
8,test_20231031_155207,11382381.png,312486,767,311719,0.9975454900379537,2,6,46745,100,46645,0.9978607337683175,21.58402311111111,2479.723024,14.186771864393144,124,2.800000000000001E-4
9,test_20231031_155207,11079715.png,443815,122782,321033,0.7233486925858748,5,7,124136,17120,107016,0.8620867435715667,16.763402666666668,2067.635402666667,14.97606401189655,124,2.800000000000001E-4
10,test_20231031_155207,11551286.png,271883,857,271026,0.9968479088431421,2,6,40092,125,39967,0.9968821710066846,17.555712,1807.787776,15.559329154375803,124,2.800000000000001E-4
1,test_20231031_155208,10404007.png,502730,22704,480026,0.9548385813458516,4,6,61265,3271,57994,0.9466089937158247,25.603198222222222,3403.693370666667,12.811299320833328,124,2.900000000000001E-4
2,test_20231031_155208,1254659.png,342646,76204,266442,0.777601372845444,5,7,80080,10632,69448,0.8672327672327672,20.676924444444445,3114.4299733333332,13.197017904793334,124,2.900000000000001E-4
3,test_20231031_155208,10188041.png,221231,10042,211189,0.954608531354105,3,5,41731,1414,40317,0.9661163164074669,10.599658666666667,1012.831872,18.07543001512229,124,2.900000000000001E-4
4,test_20231031_155208,10287332.png,216980,12687,204293,0.9415291731956862,3,5,22337,1739,20598,0.9221471101759413,9.440839111111112,776.604096,19.22880684076492,124,2.900000000000001E-4
5,test_20231031_155208,11610969.png,368720,26582,342138,0.9279073551746583,4,6,84111,3877,80234,0.9539061478284647,21.465290666666668,2964.25984,13.411640906658562,124,2.900000000000001E-4
6,test_20231031_155208,10350842.png,212614,6264,206350,0.9705381583526955,3,6,42529,917,41612,0.978438242140657,19.265742222222222,2361.7458346666667,14.398472027898631,124,2.900000000000001E-4
7,test_20231031_155208,10863862.png,317432,12917,304515,0.959307820257567,3,6,66058,1876,64182,0.9716007145236005,23.73152711111111,3238.389536,13.027512733498073,124,2.900000000000001E-4
8,test_20231031_155208,11382381.png,312486,767,311719,0.9975454900379537,3,5,46745,100,46645,0.9978607337683175,21.58402311111111,2479.723024,14.186771864393144,124,2.900000000000001E-4
9,test_20231031_155208,11079715.png,443815,122782,321033,0.7233486925858748,5,7,124136,17120,107016,0.8620867435715667,16.763402666666668,2067.635402666667,14.97606401189655,124,2.900000000000001E-4
10,test_20231031_155208,11551286.png,271883,547,271336,0.9979881051775947,2,5,40092,79,40013,0.9980295320762247,17.838736,1852.2023093333332,15.453919395217167,124,2.900000000000001E-4
1,test_20231031_155209,10404007.png,502730,21859,480871,0.9565194040538659,3,6,61265,3161,58104,0.9484044723741125,25.648606222222224,3418.377488,12.792603411306079,125,1.0E-5
2,test_20231031_155209,1254659.png,342646,74757,267889,0.7818243901869568,5,6,80080,10445,69635,0.869567932067932,20.832983111111112,3162.755813333333,13.130146982015201,125,1.0E-5
3,test_20231031_155209,10188041.png,221231,9952,211279,0.9550153459506127,3,7,41731,1403,40328,0.9663799094198557,10.516405333333333,1008.327776,18.094786301784424,125,1.0E-5
4,test_20231031_155209,10287332.png,216980,12797,204183,0.9410222140289428,3,6,22337,1754,20583,0.9214755786363433,9.318817777777777,752.2076,19.367426438243534,125,1.0E-5
5,test_20231031_155209,11610969.png,368720,26082,342638,0.9292633977001519,4,6,84111,3804,80307,0.9547740485786639,21.12351288888889,2899.7180693333335,13.507245860327119,125,1.0E-5
6,test_20231031_155209,10350842.png,212614,6184,206430,0.9709144270838233,3,6,42529,906,41623,0.9786968891814997,19.249219555555555,2368.0866986666665,14.386827624524777,125,1.0E-5
7,test_20231031_155209,10863862.png,317432,12282,305150,0.9613082486957837,3,6,66058,1783,64275,0.9730085682279209,23.971452444444445,3305.626730666667,12.938265491291542,125,1.0E-5
8,test_20231031_155209,11382381.png,312486,1049,311437,0.9966430496086225,2,5,46745,141,46604,0.9969836346133276,20.099987555555554,2270.406096,14.569768166799841,125,1.0E-5
9,test_20231031_155209,11079715.png,443815,120387,323428,0.7287450852269527,5,6,124136,16809,107327,0.8645920603209383,16.86984177777778,2095.0260693333335,14.918909294142013,125,1.0E-5
10,test_20231031_155209,11551286.png,271883,1179,270704,0.995663575876388,2,6,40092,173,39919,0.9956849246732515,15.771648,1500.8809066666668,16.367341280713223,125,1.0E-5
1,test_20231031_155210,10404007.png,502730,21859,480871,0.9565194040538659,3,6,61265,3161,58104,0.9484044723741125,25.648606222222224,3418.377488,12.792603411306079,125,2.0E-5
2,test_20231031_155210,1254659.png,342646,74757,267889,0.7818243901869568,5,6,80080,10445,69635,0.869567932067932,20.832983111111112,3162.755813333333,13.130146982015201,125,2.0E-5
3,test_20231031_155210,10188041.png,221231,9952,211279,0.9550153459506127,3,6,41731,1403,40328,0.9663799094198557,10.516405333333333,1008.327776,18.094786301784424,125,2.0E-5
4,test_20231031_155210,10287332.png,216980,12797,204183,0.9410222140289428,2,5,22337,1754,20583,0.9214755786363433,9.318817777777777,752.2076,19.367426438243534,125,2.0E-5
5,test_20231031_155210,11610969.png,368720,26082,342638,0.9292633977001519,4,6,84111,3804,80307,0.9547740485786639,21.12351288888889,2899.7180693333335,13.507245860327119,125,2.0E-5
6,test_20231031_155210,10350842.png,212614,6184,206430,0.9709144270838233,2,5,42529,906,41623,0.9786968891814997,19.249219555555555,2368.0866986666665,14.386827624524777,125,2.0E-5
7,test_20231031_155210,10863862.png,317432,12282,305150,0.9613082486957837,3,6,66058,1783,64275,0.9730085682279209,23.971452444444445,3305.626730666667,12.938265491291542,125,2.0E-5
8,test_20231031_155210,11382381.png,312486,1049,311437,0.9966430496086225,2,5,46745,141,46604,0.9969836346133276,20.099987555555554,2270.406096,14.569768166799841,125,2.0E-5
9,test_20231031_155210,11079715.png,443815,120387,323428,0.7287450852269527,6,7,124136,16809,107327,0.8645920603209383,16.86984177777778,2095.0260693333335,14.918909294142013,125,2.0E-5
10,test_20231031_155210,11551286.png,271883,1179,270704,0.995663575876388,3,5,40092,173,39919,0.9956849246732515,15.771648,1500.8809066666668,16.367341280713223,125,2.0E-5
1,test_20231031_155211,10404007.png,502730,21859,480871,0.9565194040538659,3,6,61265,3161,58104,0.9484044723741125,25.648606222222224,3418.377488,12.792603411306079,125,3.0000000000000004E-5
2,test_20231031_155211,1254659.png,342646,74757,267889,0.7818243901869568,4,7,80080,10445,69635,0.869567932067932,20.832983111111112,3162.755813333333,13.130146982015201,125,3.0000000000000004E-5
3,test_20231031_155211,10188041.png,221231,9952,211279,0.9550153459506127,3,5,41731,1403,40328,0.9663799094198557,10.516405333333333,1008.327776,18.094786301784424,125,3.0000000000000004E-5
4,test_20231031_155211,10287332.png,216980,12797,204183,0.9410222140289428,2,5,22337,1754,20583,0.9214755786363433,9.318817777777777,752.2076,19.367426438243534,125,3.0000000000000004E-5
5,test_20231031_155211,11610969.png,368720,26082,342638,0.9292633977001519,4,6,84111,3804,80307,0.9547740485786639,21.12351288888889,2899.7180693333335,13.507245860327119,125,3.0000000000000004E-5
6,test_20231031_155211,10350842.png,212614,6184,206430,0.9709144270838233,2,6,42529,906,41623,0.9786968891814997,19.249219555555555,2368.0866986666665,14.386827624524777,125,3.0000000000000004E-5
7,test_20231031_155211,10863862.png,317432,12282,305150,0.9613082486957837,3,5,66058,1783,64275,0.9730085682279209,23.971452444444445,3305.626730666667,12.938265491291542,125,3.0000000000000004E-5
8,test_20231031_155211,11382381.png,312486,1049,311437,0.9966430496086225,2,5,46745,141,46604,0.9969836346133276,20.099987555555554,2270.406096,14.569768166799841,125,3.0000000000000004E-5
9,test_20231031_155211,11079715.png,443815,120387,323428,0.7287450852269527,5,6,124136,16809,107327,0.8645920603209383,16.86984177777778,2095.0260693333335,14.918909294142013,125,3.0000000000000004E-5
10,test_20231031_155211,11551286.png,271883,1179,270704,0.995663575876388,3,6,40092,173,39919,0.9956849246732515,15.771648,1500.8809066666668,16.367341280713223,125,3.0000000000000004E-5
1,test_20231031_155213,10404007.png,502730,21859,480871,0.9565194040538659,3,6,61265,3161,58104,0.9484044723741125,25.648606222222224,3418.377488,12.792603411306079,125,4.0E-5
2,test_20231031_155213,1254659.png,342646,74757,267889,0.7818243901869568,4,7,80080,10445,69635,0.869567932067932,20.832983111111112,3162.755813333333,13.130146982015201,125,4.0E-5
3,test_20231031_155213,10188041.png,221231,9952,211279,0.9550153459506127,3,5,41731,1403,40328,0.9663799094198557,10.516405333333333,1008.327776,18.094786301784424,125,4.0E-5
4,test_20231031_155213,10287332.png,216980,12797,204183,0.9410222140289428,4,6,22337,1754,20583,0.9214755786363433,9.318817777777777,752.2076,19.367426438243534,125,4.0E-5
5,test_20231031_155213,11610969.png,368720,26082,342638,0.9292633977001519,3,6,84111,3804,80307,0.9547740485786639,21.12351288888889,2899.7180693333335,13.507245860327119,125,4.0E-5
6,test_20231031_155213,10350842.png,212614,6184,206430,0.9709144270838233,3,6,42529,906,41623,0.9786968891814997,19.249219555555555,2368.0866986666665,14.386827624524777,125,4.0E-5
7,test_20231031_155213,10863862.png,317432,12282,305150,0.9613082486957837,3,6,66058,1783,64275,0.9730085682279209,23.971452444444445,3305.626730666667,12.938265491291542,125,4.0E-5
8,test_20231031_155213,11382381.png,312486,1049,311437,0.9966430496086225,2,6,46745,141,46604,0.9969836346133276,20.099987555555554,2270.406096,14.569768166799841,125,4.0E-5
9,test_20231031_155213,11079715.png,443815,120387,323428,0.7287450852269527,5,7,124136,16809,107327,0.8645920603209383,16.86984177777778,2095.0260693333335,14.918909294142013,125,4.0E-5
10,test_20231031_155213,11551286.png,271883,1179,270704,0.995663575876388,3,5,40092,173,39919,0.9956849246732515,15.771648,1500.8809066666668,16.367341280713223,125,4.0E-5
1,test_20231031_155214,10404007.png,502730,21859,480871,0.9565194040538659,4,6,61265,3161,58104,0.9484044723741125,25.648606222222224,3418.377488,12.792603411306079,125,5.0E-5
2,test_20231031_155214,1254659.png,342646,74757,267889,0.7818243901869568,5,6,80080,10445,69635,0.869567932067932,20.832983111111112,3162.755813333333,13.130146982015201,125,5.0E-5
3,test_20231031_155214,10188041.png,221231,9952,211279,0.9550153459506127,3,6,41731,1403,40328,0.9663799094198557,10.516405333333333,1008.327776,18.094786301784424,125,5.0E-5
4,test_20231031_155214,10287332.png,216980,12797,204183,0.9410222140289428,3,6,22337,1754,20583,0.9214755786363433,9.318817777777777,752.2076,19.367426438243534,125,5.0E-5
5,test_20231031_155214,11610969.png,368720,26082,342638,0.9292633977001519,4,7,84111,3804,80307,0.9547740485786639,21.12351288888889,2899.7180693333335,13.507245860327119,125,5.0E-5
6,test_20231031_155214,10350842.png,212614,6184,206430,0.9709144270838233,3,5,42529,906,41623,0.9786968891814997,19.249219555555555,2368.0866986666665,14.386827624524777,125,5.0E-5
7,test_20231031_155214,10863862.png,317432,12282,305150,0.9613082486957837,3,6,66058,1783,64275,0.9730085682279209,23.971452444444445,3305.626730666667,12.938265491291542,125,5.0E-5
8,test_20231031_155214,11382381.png,312486,1039,311447,0.9966750510422867,3,6,46745,140,46605,0.9970050272756444,20.829804444444445,2368.9669066666665,14.385213669887252,125,5.0E-5
9,test_20231031_155214,11079715.png,443815,120387,323428,0.7287450852269527,5,7,124136,16809,107327,0.8645920603209383,16.86984177777778,2095.0260693333335,14.918909294142013,125,5.0E-5
10,test_20231031_155214,11551286.png,271883,1179,270704,0.995663575876388,2,5,40092,173,39919,0.9956849246732515,15.771648,1500.8809066666668,16.367341280713223,125,5.0E-5
1,test_20231031_155215,10404007.png,502730,21859,480871,0.9565194040538659,4,6,61265,3161,58104,0.9484044723741125,25.648606222222224,3418.377488,12.792603411306079,125,6.0E-5
2,test_20231031_155215,1254659.png,342646,74757,267889,0.7818243901869568,5,6,80080,10445,69635,0.869567932067932,20.832983111111112,3162.755813333333,13.130146982015201,125,6.0E-5
3,test_20231031_155215,10188041.png,221231,9952,211279,0.9550153459506127,3,5,41731,1403,40328,0.9663799094198557,10.516405333333333,1008.327776,18.094786301784424,125,6.0E-5
4,test_20231031_155215,10287332.png,216980,12797,204183,0.9410222140289428,3,6,22337,1754,20583,0.9214755786363433,9.318817777777777,752.2076,19.367426438243534,125,6.0E-5
5,test_20231031_155215,11610969.png,368720,26082,342638,0.9292633977001519,3,6,84111,3804,80307,0.9547740485786639,21.12351288888889,2899.7180693333335,13.507245860327119,125,6.0E-5
6,test_20231031_155215,10350842.png,212614,6184,206430,0.9709144270838233,2,5,42529,906,41623,0.9786968891814997,19.249219555555555,2368.0866986666665,14.386827624524777,125,6.0E-5
7,test_20231031_155215,10863862.png,317432,12282,305150,0.9613082486957837,3,5,66058,1783,64275,0.9730085682279209,23.971452444444445,3305.626730666667,12.938265491291542,125,6.0E-5
8,test_20231031_155215,11382381.png,312486,1039,311447,0.9966750510422867,2,5,46745,140,46605,0.9970050272756444,20.829804444444445,2368.9669066666665,14.385213669887252,125,6.0E-5
9,test_20231031_155215,11079715.png,443815,120387,323428,0.7287450852269527,6,7,124136,16809,107327,0.8645920603209383,16.86984177777778,2095.0260693333335,14.918909294142013,125,6.0E-5
10,test_20231031_155215,11551286.png,271883,1179,270704,0.995663575876388,3,6,40092,173,39919,0.9956849246732515,15.771648,1500.8809066666668,16.367341280713223,125,6.0E-5
1,test_20231031_155216,10404007.png,502730,21859,480871,0.9565194040538659,4,6,61265,3161,58104,0.9484044723741125,25.648606222222224,3418.377488,12.792603411306079,125,7.000000000000001E-5
2,test_20231031_155216,1254659.png,342646,74757,267889,0.7818243901869568,5,6,80080,10445,69635,0.869567932067932,20.832983111111112,3162.755813333333,13.130146982015201,125,7.000000000000001E-5
3,test_20231031_155216,10188041.png,221231,9952,211279,0.9550153459506127,3,6,41731,1403,40328,0.9663799094198557,10.516405333333333,1008.327776,18.094786301784424,125,7.000000000000001E-5
4,test_20231031_155216,10287332.png,216980,12797,204183,0.9410222140289428,2,5,22337,1754,20583,0.9214755786363433,9.318817777777777,752.2076,19.367426438243534,125,7.000000000000001E-5
5,test_20231031_155216,11610969.png,368720,26082,342638,0.9292633977001519,3,6,84111,3804,80307,0.9547740485786639,21.12351288888889,2899.7180693333335,13.507245860327119,125,7.000000000000001E-5
6,test_20231031_155216,10350842.png,212614,6184,206430,0.9709144270838233,2,6,42529,906,41623,0.9786968891814997,19.249219555555555,2368.0866986666665,14.386827624524777,125,7.000000000000001E-5
7,test_20231031_155216,10863862.png,317432,12282,305150,0.9613082486957837,3,5,66058,1783,64275,0.9730085682279209,23.971452444444445,3305.626730666667,12.938265491291542,125,7.000000000000001E-5
8,test_20231031_155216,11382381.png,312486,1039,311447,0.9966750510422867,2,5,46745,140,46605,0.9970050272756444,20.829804444444445,2368.9669066666665,14.385213669887252,125,7.000000000000001E-5
9,test_20231031_155216,11079715.png,443815,120387,323428,0.7287450852269527,5,6,124136,16809,107327,0.8645920603209383,16.86984177777778,2095.0260693333335,14.918909294142013,125,7.000000000000001E-5
10,test_20231031_155216,11551286.png,271883,1059,270824,0.9961049421994019,2,5,40092,155,39937,0.996133892048289,15.857982222222223,1506.99288,16.349691604338467,125,7.000000000000001E-5
1,test_20231031_155217,10404007.png,502730,21859,480871,0.9565194040538659,4,5,61265,3161,58104,0.9484044723741125,25.648606222222224,3418.377488,12.792603411306079,125,8.0E-5
2,test_20231031_155217,1254659.png,342646,74757,267889,0.7818243901869568,5,6,80080,10445,69635,0.869567932067932,20.832983111111112,3162.755813333333,13.130146982015201,125,8.0E-5
3,test_20231031_155217,10188041.png,221231,9952,211279,0.9550153459506127,3,5,41731,1403,40328,0.9663799094198557,10.516405333333333,1008.327776,18.094786301784424,125,8.0E-5
4,test_20231031_155217,10287332.png,216980,12797,204183,0.9410222140289428,3,6,22337,1754,20583,0.9214755786363433,9.318817777777777,752.2076,19.367426438243534,125,8.0E-5
5,test_20231031_155217,11610969.png,368720,26082,342638,0.9292633977001519,4,6,84111,3804,80307,0.9547740485786639,21.12351288888889,2899.7180693333335,13.507245860327119,125,8.0E-5
6,test_20231031_155217,10350842.png,212614,6184,206430,0.9709144270838233,3,6,42529,906,41623,0.9786968891814997,19.249219555555555,2368.0866986666665,14.386827624524777,125,8.0E-5
7,test_20231031_155217,10863862.png,317432,12282,305150,0.9613082486957837,3,6,66058,1783,64275,0.9730085682279209,23.971452444444445,3305.626730666667,12.938265491291542,125,8.0E-5
8,test_20231031_155217,11382381.png,312486,1039,311447,0.9966750510422867,3,6,46745,140,46605,0.9970050272756444,20.829804444444445,2368.9669066666665,14.385213669887252,125,8.0E-5
9,test_20231031_155217,11079715.png,443815,120387,323428,0.7287450852269527,6,7,124136,16809,107327,0.8645920603209383,16.86984177777778,2095.0260693333335,14.918909294142013,125,8.0E-5
10,test_20231031_155217,11551286.png,271883,1059,270824,0.9961049421994019,3,6,40092,155,39937,0.996133892048289,15.857982222222223,1506.99288,16.349691604338467,125,8.0E-5
1,test_20231031_155218,10404007.png,502730,21859,480871,0.9565194040538659,3,6,61265,3161,58104,0.9484044723741125,25.648606222222224,3418.377488,12.792603411306079,125,9.0E-5
2,test_20231031_155218,1254659.png,342646,74757,267889,0.7818243901869568,4,6,80080,10445,69635,0.869567932067932,20.832983111111112,3162.755813333333,13.130146982015201,125,9.0E-5
3,test_20231031_155218,10188041.png,221231,9952,211279,0.9550153459506127,3,6,41731,1403,40328,0.9663799094198557,10.516405333333333,1008.327776,18.094786301784424,125,9.0E-5
4,test_20231031_155218,10287332.png,216980,12797,204183,0.9410222140289428,3,6,22337,1754,20583,0.9214755786363433,9.318817777777777,752.2076,19.367426438243534,125,9.0E-5
5,test_20231031_155218,11610969.png,368720,26082,342638,0.9292633977001519,4,6,84111,3804,80307,0.9547740485786639,21.12351288888889,2899.7180693333335,13.507245860327119,125,9.0E-5
6,test_20231031_155218,10350842.png,212614,6184,206430,0.9709144270838233,2,5,42529,906,41623,0.9786968891814997,19.249219555555555,2368.0866986666665,14.386827624524777,125,9.0E-5
7,test_20231031_155218,10863862.png,317432,12282,305150,0.9613082486957837,3,5,66058,1783,64275,0.9730085682279209,23.971452444444445,3305.626730666667,12.938265491291542,125,9.0E-5
8,test_20231031_155218,11382381.png,312486,1039,311447,0.9966750510422867,3,6,46745,140,46605,0.9970050272756444,20.829804444444445,2368.9669066666665,14.385213669887252,125,9.0E-5
9,test_20231031_155218,11079715.png,443815,120387,323428,0.7287450852269527,5,7,124136,16809,107327,0.8645920603209383,16.86984177777778,2095.0260693333335,14.918909294142013,125,9.0E-5
10,test_20231031_155218,11551286.png,271883,1059,270824,0.9961049421994019,2,5,40092,155,39937,0.996133892048289,15.857982222222223,1506.99288,16.349691604338467,125,9.0E-5
1,test_20231031_155219,10404007.png,502730,21859,480871,0.9565194040538659,3,5,61265,3161,58104,0.9484044723741125,25.648606222222224,3418.377488,12.792603411306079,125,1.0E-4
2,test_20231031_155219,1254659.png,342646,74757,267889,0.7818243901869568,5,7,80080,10445,69635,0.869567932067932,20.832983111111112,3162.755813333333,13.130146982015201,125,1.0E-4
3,test_20231031_155219,10188041.png,221231,9952,211279,0.9550153459506127,3,6,41731,1403,40328,0.9663799094198557,10.516405333333333,1008.327776,18.094786301784424,125,1.0E-4
4,test_20231031_155219,10287332.png,216980,12797,204183,0.9410222140289428,3,5,22337,1754,20583,0.9214755786363433,9.318817777777777,752.2076,19.367426438243534,125,1.0E-4
5,test_20231031_155219,11610969.png,368720,26082,342638,0.9292633977001519,4,5,84111,3804,80307,0.9547740485786639,21.12351288888889,2899.7180693333335,13.507245860327119,125,1.0E-4
6,test_20231031_155219,10350842.png,212614,6184,206430,0.9709144270838233,2,5,42529,906,41623,0.9786968891814997,19.249219555555555,2368.0866986666665,14.386827624524777,125,1.0E-4
7,test_20231031_155219,10863862.png,317432,12282,305150,0.9613082486957837,4,6,66058,1783,64275,0.9730085682279209,23.971452444444445,3305.626730666667,12.938265491291542,125,1.0E-4
8,test_20231031_155219,11382381.png,312486,1039,311447,0.9966750510422867,2,5,46745,140,46605,0.9970050272756444,20.829804444444445,2368.9669066666665,14.385213669887252,125,1.0E-4
9,test_20231031_155219,11079715.png,443815,120387,323428,0.7287450852269527,10,7,124136,16809,107327,0.8645920603209383,16.86984177777778,2095.0260693333335,14.918909294142013,125,1.0E-4
10,test_20231031_155219,11551286.png,271883,1059,270824,0.9961049421994019,3,6,40092,155,39937,0.996133892048289,15.857982222222223,1506.99288,16.349691604338467,125,1.0E-4
1,test_20231031_155220,10404007.png,502730,21859,480871,0.9565194040538659,4,6,61265,3161,58104,0.9484044723741125,25.648606222222224,3418.377488,12.792603411306079,125,1.1E-4
2,test_20231031_155220,1254659.png,342646,74757,267889,0.7818243901869568,5,7,80080,10445,69635,0.869567932067932,20.832983111111112,3162.755813333333,13.130146982015201,125,1.1E-4
3,test_20231031_155220,10188041.png,221231,9952,211279,0.9550153459506127,3,7,41731,1403,40328,0.9663799094198557,10.516405333333333,1008.327776,18.094786301784424,125,1.1E-4
4,test_20231031_155220,10287332.png,216980,12797,204183,0.9410222140289428,2,5,22337,1754,20583,0.9214755786363433,9.318817777777777,752.2076,19.367426438243534,125,1.1E-4
5,test_20231031_155220,11610969.png,368720,26082,342638,0.9292633977001519,4,6,84111,3804,80307,0.9547740485786639,21.12351288888889,2899.7180693333335,13.507245860327119,125,1.1E-4
6,test_20231031_155220,10350842.png,212614,6184,206430,0.9709144270838233,2,6,42529,906,41623,0.9786968891814997,19.249219555555555,2368.0866986666665,14.386827624524777,125,1.1E-4
7,test_20231031_155220,10863862.png,317432,12282,305150,0.9613082486957837,3,6,66058,1783,64275,0.9730085682279209,23.971452444444445,3305.626730666667,12.938265491291542,125,1.1E-4
8,test_20231031_155220,11382381.png,312486,1039,311447,0.9966750510422867,3,5,46745,140,46605,0.9970050272756444,20.829804444444445,2368.9669066666665,14.385213669887252,125,1.1E-4
9,test_20231031_155220,11079715.png,443815,120387,323428,0.7287450852269527,6,7,124136,16809,107327,0.8645920603209383,16.86984177777778,2095.0260693333335,14.918909294142013,125,1.1E-4
10,test_20231031_155220,11551286.png,271883,1059,270824,0.9961049421994019,2,5,40092,155,39937,0.996133892048289,15.857982222222223,1506.99288,16.349691604338467,125,1.1E-4
1,test_20231031_155221,10404007.png,502730,21859,480871,0.9565194040538659,3,5,61265,3161,58104,0.9484044723741125,25.648606222222224,3418.377488,12.792603411306079,125,1.2E-4
2,test_20231031_155221,1254659.png,342646,74757,267889,0.7818243901869568,4,6,80080,10445,69635,0.869567932067932,20.832983111111112,3162.755813333333,13.130146982015201,125,1.2E-4
3,test_20231031_155221,10188041.png,221231,9952,211279,0.9550153459506127,3,6,41731,1403,40328,0.9663799094198557,10.516405333333333,1008.327776,18.094786301784424,125,1.2E-4
4,test_20231031_155221,10287332.png,216980,12797,204183,0.9410222140289428,3,6,22337,1754,20583,0.9214755786363433,9.318817777777777,752.2076,19.367426438243534,125,1.2E-4
5,test_20231031_155221,11610969.png,368720,26082,342638,0.9292633977001519,4,6,84111,3804,80307,0.9547740485786639,21.12351288888889,2899.7180693333335,13.507245860327119,125,1.2E-4
6,test_20231031_155221,10350842.png,212614,6184,206430,0.9709144270838233,2,5,42529,906,41623,0.9786968891814997,19.249219555555555,2368.0866986666665,14.386827624524777,125,1.2E-4
7,test_20231031_155221,10863862.png,317432,12282,305150,0.9613082486957837,3,5,66058,1783,64275,0.9730085682279209,23.971452444444445,3305.626730666667,12.938265491291542,125,1.2E-4
8,test_20231031_155221,11382381.png,312486,1039,311447,0.9966750510422867,2,5,46745,140,46605,0.9970050272756444,20.829804444444445,2368.9669066666665,14.385213669887252,125,1.2E-4
9,test_20231031_155221,11079715.png,443815,120387,323428,0.7287450852269527,6,7,124136,16809,107327,0.8645920603209383,16.86984177777778,2095.0260693333335,14.918909294142013,125,1.2E-4
10,test_20231031_155221,11551286.png,271883,1059,270824,0.9961049421994019,2,5,40092,155,39937,0.996133892048289,15.857982222222223,1506.99288,16.349691604338467,125,1.2E-4
1,test_20231031_155222,10404007.png,502730,21859,480871,0.9565194040538659,4,6,61265,3161,58104,0.9484044723741125,25.648606222222224,3418.377488,12.792603411306079,125,1.3000000000000002E-4
2,test_20231031_155222,1254659.png,342646,74757,267889,0.7818243901869568,5,6,80080,10445,69635,0.869567932067932,20.832983111111112,3162.755813333333,13.130146982015201,125,1.3000000000000002E-4
3,test_20231031_155222,10188041.png,221231,9952,211279,0.9550153459506127,3,5,41731,1403,40328,0.9663799094198557,10.516405333333333,1008.327776,18.094786301784424,125,1.3000000000000002E-4
4,test_20231031_155222,10287332.png,216980,12797,204183,0.9410222140289428,3,5,22337,1754,20583,0.9214755786363433,9.318817777777777,752.2076,19.367426438243534,125,1.3000000000000002E-4
5,test_20231031_155222,11610969.png,368720,26082,342638,0.9292633977001519,4,6,84111,3804,80307,0.9547740485786639,21.12351288888889,2899.7180693333335,13.507245860327119,125,1.3000000000000002E-4
6,test_20231031_155222,10350842.png,212614,6184,206430,0.9709144270838233,2,5,42529,906,41623,0.9786968891814997,19.249219555555555,2368.0866986666665,14.386827624524777,125,1.3000000000000002E-4
7,test_20231031_155222,10863862.png,317432,12282,305150,0.9613082486957837,3,5,66058,1783,64275,0.9730085682279209,23.971452444444445,3305.626730666667,12.938265491291542,125,1.3000000000000002E-4
8,test_20231031_155222,11382381.png,312486,1039,311447,0.9966750510422867,3,6,46745,140,46605,0.9970050272756444,20.829804444444445,2368.9669066666665,14.385213669887252,125,1.3000000000000002E-4
9,test_20231031_155222,11079715.png,443815,120387,323428,0.7287450852269527,8,7,124136,16809,107327,0.8645920603209383,16.86984177777778,2095.0260693333335,14.918909294142013,125,1.3000000000000002E-4
10,test_20231031_155222,11551286.png,271883,877,271006,0.9967743477893064,3,5,40092,128,39964,0.9968073431108451,17.018796444444444,1715.096528,15.787917931083486,125,1.3000000000000002E-4
1,test_20231031_155223,10404007.png,502730,21859,480871,0.9565194040538659,3,6,61265,3161,58104,0.9484044723741125,25.648606222222224,3418.377488,12.792603411306079,125,1.4000000000000001E-4
2,test_20231031_155223,1254659.png,342646,74757,267889,0.7818243901869568,5,6,80080,10445,69635,0.869567932067932,20.832983111111112,3162.755813333333,13.130146982015201,125,1.4000000000000001E-4
3,test_20231031_155223,10188041.png,221231,9952,211279,0.9550153459506127,4,6,41731,1403,40328,0.9663799094198557,10.516405333333333,1008.327776,18.094786301784424,125,1.4000000000000001E-4
4,test_20231031_155223,10287332.png,216980,12797,204183,0.9410222140289428,3,6,22337,1754,20583,0.9214755786363433,9.318817777777777,752.2076,19.367426438243534,125,1.4000000000000001E-4
5,test_20231031_155223,11610969.png,368720,26082,342638,0.9292633977001519,3,5,84111,3804,80307,0.9547740485786639,21.12351288888889,2899.7180693333335,13.507245860327119,125,1.4000000000000001E-4
6,test_20231031_155223,10350842.png,212614,6184,206430,0.9709144270838233,3,6,42529,906,41623,0.9786968891814997,19.249219555555555,2368.0866986666665,14.386827624524777,125,1.4000000000000001E-4
7,test_20231031_155223,10863862.png,317432,12282,305150,0.9613082486957837,3,5,66058,1783,64275,0.9730085682279209,23.971452444444445,3305.626730666667,12.938265491291542,125,1.4000000000000001E-4
8,test_20231031_155223,11382381.png,312486,1039,311447,0.9966750510422867,2,7,46745,140,46605,0.9970050272756444,20.829804444444445,2368.9669066666665,14.385213669887252,125,1.4000000000000001E-4
9,test_20231031_155223,11079715.png,443815,120387,323428,0.7287450852269527,5,6,124136,16809,107327,0.8645920603209383,16.86984177777778,2095.0260693333335,14.918909294142013,125,1.4000000000000001E-4
10,test_20231031_155223,11551286.png,271883,877,271006,0.9967743477893064,3,6,40092,128,39964,0.9968073431108451,17.018796444444444,1715.096528,15.787917931083486,125,1.4000000000000001E-4
1,test_20231031_155224,10404007.png,502730,21859,480871,0.9565194040538659,4,12,61265,3161,58104,0.9484044723741125,25.648606222222224,3418.377488,12.792603411306079,125,1.5000000000000001E-4
2,test_20231031_155224,1254659.png,342646,74757,267889,0.7818243901869568,5,7,80080,10445,69635,0.869567932067932,20.832983111111112,3162.755813333333,13.130146982015201,125,1.5000000000000001E-4
3,test_20231031_155224,10188041.png,221231,9952,211279,0.9550153459506127,3,7,41731,1403,40328,0.9663799094198557,10.516405333333333,1008.327776,18.094786301784424,125,1.5000000000000001E-4
4,test_20231031_155224,10287332.png,216980,12797,204183,0.9410222140289428,3,6,22337,1754,20583,0.9214755786363433,9.318817777777777,752.2076,19.367426438243534,125,1.5000000000000001E-4
5,test_20231031_155224,11610969.png,368720,26082,342638,0.9292633977001519,3,6,84111,3804,80307,0.9547740485786639,21.12351288888889,2899.7180693333335,13.507245860327119,125,1.5000000000000001E-4
6,test_20231031_155224,10350842.png,212614,6184,206430,0.9709144270838233,2,5,42529,906,41623,0.9786968891814997,19.249219555555555,2368.0866986666665,14.386827624524777,125,1.5000000000000001E-4
7,test_20231031_155224,10863862.png,317432,12282,305150,0.9613082486957837,3,5,66058,1783,64275,0.9730085682279209,23.971452444444445,3305.626730666667,12.938265491291542,125,1.5000000000000001E-4
8,test_20231031_155224,11382381.png,312486,1039,311447,0.9966750510422867,3,6,46745,140,46605,0.9970050272756444,20.829804444444445,2368.9669066666665,14.385213669887252,125,1.5000000000000001E-4
9,test_20231031_155224,11079715.png,443815,120387,323428,0.7287450852269527,6,7,124136,16809,107327,0.8645920603209383,16.86984177777778,2095.0260693333335,14.918909294142013,125,1.5000000000000001E-4
10,test_20231031_155224,11551286.png,271883,877,271006,0.9967743477893064,2,5,40092,128,39964,0.9968073431108451,17.018796444444444,1715.096528,15.787917931083486,125,1.5000000000000001E-4
1,test_20231031_155225,10404007.png,502730,21859,480871,0.9565194040538659,4,6,61265,3161,58104,0.9484044723741125,25.648606222222224,3418.377488,12.792603411306079,125,1.6E-4
2,test_20231031_155225,1254659.png,342646,74757,267889,0.7818243901869568,4,7,80080,10445,69635,0.869567932067932,20.832983111111112,3162.755813333333,13.130146982015201,125,1.6E-4
3,test_20231031_155225,10188041.png,221231,9952,211279,0.9550153459506127,3,6,41731,1403,40328,0.9663799094198557,10.516405333333333,1008.327776,18.094786301784424,125,1.6E-4
4,test_20231031_155225,10287332.png,216980,12584,204396,0.942003871324546,2,5,22337,1727,20610,0.9226843354076196,9.448579555555556,778.9383466666667,19.21577276445775,125,1.6E-4
5,test_20231031_155225,11610969.png,368720,26082,342638,0.9292633977001519,3,6,84111,3804,80307,0.9547740485786639,21.12351288888889,2899.7180693333335,13.507245860327119,125,1.6E-4
6,test_20231031_155225,10350842.png,212614,6184,206430,0.9709144270838233,2,9,42529,906,41623,0.9786968891814997,19.249219555555555,2368.0866986666665,14.386827624524777,125,1.6E-4
7,test_20231031_155225,10863862.png,317432,12282,305150,0.9613082486957837,3,6,66058,1783,64275,0.9730085682279209,23.971452444444445,3305.626730666667,12.938265491291542,125,1.6E-4
8,test_20231031_155225,11382381.png,312486,907,311579,0.9970974699666545,2,6,46745,121,46624,0.9974114878596642,21.088220444444445,2409.5101546666665,14.311515999312824,125,1.6E-4
9,test_20231031_155225,11079715.png,443815,120387,323428,0.7287450852269527,5,7,124136,16809,107327,0.8645920603209383,16.86984177777778,2095.0260693333335,14.918909294142013,125,1.6E-4
10,test_20231031_155225,11551286.png,271883,877,271006,0.9967743477893064,2,5,40092,128,39964,0.9968073431108451,17.018796444444444,1715.096528,15.787917931083486,125,1.6E-4
1,test_20231031_155226,10404007.png,502730,21859,480871,0.9565194040538659,4,11,61265,3161,58104,0.9484044723741125,25.648606222222224,3418.377488,12.792603411306079,125,1.7E-4
2,test_20231031_155226,1254659.png,342646,74757,267889,0.7818243901869568,5,6,80080,10445,69635,0.869567932067932,20.832983111111112,3162.755813333333,13.130146982015201,125,1.7E-4
3,test_20231031_155226,10188041.png,221231,9952,211279,0.9550153459506127,3,5,41731,1403,40328,0.9663799094198557,10.516405333333333,1008.327776,18.094786301784424,125,1.7E-4
4,test_20231031_155226,10287332.png,216980,12584,204396,0.942003871324546,2,5,22337,1727,20610,0.9226843354076196,9.448579555555556,778.9383466666667,19.21577276445775,125,1.7E-4
5,test_20231031_155226,11610969.png,368720,26082,342638,0.9292633977001519,3,5,84111,3804,80307,0.9547740485786639,21.12351288888889,2899.7180693333335,13.507245860327119,125,1.7E-4
6,test_20231031_155226,10350842.png,212614,6184,206430,0.9709144270838233,2,6,42529,906,41623,0.9786968891814997,19.249219555555555,2368.0866986666665,14.386827624524777,125,1.7E-4
7,test_20231031_155226,10863862.png,317432,12282,305150,0.9613082486957837,3,6,66058,1783,64275,0.9730085682279209,23.971452444444445,3305.626730666667,12.938265491291542,125,1.7E-4
8,test_20231031_155226,11382381.png,312486,907,311579,0.9970974699666545,3,6,46745,121,46624,0.9974114878596642,21.088220444444445,2409.5101546666665,14.311515999312824,125,1.7E-4
9,test_20231031_155226,11079715.png,443815,120387,323428,0.7287450852269527,6,7,124136,16809,107327,0.8645920603209383,16.86984177777778,2095.0260693333335,14.918909294142013,125,1.7E-4
10,test_20231031_155226,11551286.png,271883,877,271006,0.9967743477893064,2,5,40092,128,39964,0.9968073431108451,17.018796444444444,1715.096528,15.787917931083486,125,1.7E-4
1,test_20231031_155227,10404007.png,502730,21859,480871,0.9565194040538659,4,6,61265,3161,58104,0.9484044723741125,25.648606222222224,3418.377488,12.792603411306079,125,1.8E-4
2,test_20231031_155227,1254659.png,342646,74757,267889,0.7818243901869568,4,6,80080,10445,69635,0.869567932067932,20.832983111111112,3162.755813333333,13.130146982015201,125,1.8E-4
3,test_20231031_155227,10188041.png,221231,9952,211279,0.9550153459506127,3,5,41731,1403,40328,0.9663799094198557,10.516405333333333,1008.327776,18.094786301784424,125,1.8E-4
4,test_20231031_155227,10287332.png,216980,12584,204396,0.942003871324546,6,6,22337,1727,20610,0.9226843354076196,9.448579555555556,778.9383466666667,19.21577276445775,125,1.8E-4
5,test_20231031_155227,11610969.png,368720,26082,342638,0.9292633977001519,4,6,84111,3804,80307,0.9547740485786639,21.12351288888889,2899.7180693333335,13.507245860327119,125,1.8E-4
6,test_20231031_155227,10350842.png,212614,6184,206430,0.9709144270838233,3,6,42529,906,41623,0.9786968891814997,19.249219555555555,2368.0866986666665,14.386827624524777,125,1.8E-4
7,test_20231031_155227,10863862.png,317432,12282,305150,0.9613082486957837,3,6,66058,1783,64275,0.9730085682279209,23.971452444444445,3305.626730666667,12.938265491291542,125,1.8E-4
8,test_20231031_155227,11382381.png,312486,907,311579,0.9970974699666545,3,6,46745,121,46624,0.9974114878596642,21.088220444444445,2409.5101546666665,14.311515999312824,125,1.8E-4
9,test_20231031_155227,11079715.png,443815,120387,323428,0.7287450852269527,5,7,124136,16809,107327,0.8645920603209383,16.86984177777778,2095.0260693333335,14.918909294142013,125,1.8E-4
10,test_20231031_155227,11551286.png,271883,877,271006,0.9967743477893064,2,6,40092,128,39964,0.9968073431108451,17.018796444444444,1715.096528,15.787917931083486,125,1.8E-4
1,test_20231031_155228,10404007.png,502730,21859,480871,0.9565194040538659,4,6,61265,3161,58104,0.9484044723741125,25.648606222222224,3418.377488,12.792603411306079,125,1.9E-4
2,test_20231031_155228,1254659.png,342646,74757,267889,0.7818243901869568,4,6,80080,10445,69635,0.869567932067932,20.832983111111112,3162.755813333333,13.130146982015201,125,1.9E-4
3,test_20231031_155228,10188041.png,221231,9952,211279,0.9550153459506127,3,5,41731,1403,40328,0.9663799094198557,10.516405333333333,1008.327776,18.094786301784424,125,1.9E-4
4,test_20231031_155228,10287332.png,216980,12584,204396,0.942003871324546,3,6,22337,1727,20610,0.9226843354076196,9.448579555555556,778.9383466666667,19.21577276445775,125,1.9E-4
5,test_20231031_155228,11610969.png,368720,26082,342638,0.9292633977001519,4,6,84111,3804,80307,0.9547740485786639,21.12351288888889,2899.7180693333335,13.507245860327119,125,1.9E-4
6,test_20231031_155228,10350842.png,212614,6184,206430,0.9709144270838233,2,6,42529,906,41623,0.9786968891814997,19.249219555555555,2368.0866986666665,14.386827624524777,125,1.9E-4
7,test_20231031_155228,10863862.png,317432,12282,305150,0.9613082486957837,4,6,66058,1783,64275,0.9730085682279209,23.971452444444445,3305.626730666667,12.938265491291542,125,1.9E-4
8,test_20231031_155228,11382381.png,312486,907,311579,0.9970974699666545,2,5,46745,121,46624,0.9974114878596642,21.088220444444445,2409.5101546666665,14.311515999312824,125,1.9E-4
9,test_20231031_155228,11079715.png,443815,120387,323428,0.7287450852269527,5,7,124136,16809,107327,0.8645920603209383,16.86984177777778,2095.0260693333335,14.918909294142013,125,1.9E-4
10,test_20231031_155228,11551286.png,271883,877,271006,0.9967743477893064,2,5,40092,128,39964,0.9968073431108451,17.018796444444444,1715.096528,15.787917931083486,125,1.9E-4
1,test_20231031_155229,10404007.png,502730,21859,480871,0.9565194040538659,3,6,61265,3161,58104,0.9484044723741125,25.648606222222224,3418.377488,12.792603411306079,125,2.0E-4
2,test_20231031_155229,1254659.png,342646,74757,267889,0.7818243901869568,5,6,80080,10445,69635,0.869567932067932,20.832983111111112,3162.755813333333,13.130146982015201,125,2.0E-4
3,test_20231031_155229,10188041.png,221231,9952,211279,0.9550153459506127,3,7,41731,1403,40328,0.9663799094198557,10.516405333333333,1008.327776,18.094786301784424,125,2.0E-4
4,test_20231031_155229,10287332.png,216980,12584,204396,0.942003871324546,2,5,22337,1727,20610,0.9226843354076196,9.448579555555556,778.9383466666667,19.21577276445775,125,2.0E-4
5,test_20231031_155229,11610969.png,368720,26082,342638,0.9292633977001519,4,6,84111,3804,80307,0.9547740485786639,21.12351288888889,2899.7180693333335,13.507245860327119,125,2.0E-4
6,test_20231031_155229,10350842.png,212614,6184,206430,0.9709144270838233,2,5,42529,906,41623,0.9786968891814997,19.249219555555555,2368.0866986666665,14.386827624524777,125,2.0E-4
7,test_20231031_155229,10863862.png,317432,12282,305150,0.9613082486957837,3,5,66058,1783,64275,0.9730085682279209,23.971452444444445,3305.626730666667,12.938265491291542,125,2.0E-4
8,test_20231031_155229,11382381.png,312486,907,311579,0.9970974699666545,2,6,46745,121,46624,0.9974114878596642,21.088220444444445,2409.5101546666665,14.311515999312824,125,2.0E-4
9,test_20231031_155229,11079715.png,443815,120387,323428,0.7287450852269527,6,6,124136,16809,107327,0.8645920603209383,16.86984177777778,2095.0260693333335,14.918909294142013,125,2.0E-4
10,test_20231031_155229,11551286.png,271883,877,271006,0.9967743477893064,3,6,40092,128,39964,0.9968073431108451,17.018796444444444,1715.096528,15.787917931083486,125,2.0E-4
1,test_20231031_155230,10404007.png,502730,21859,480871,0.9565194040538659,4,6,61265,3161,58104,0.9484044723741125,25.648606222222224,3418.377488,12.792603411306079,125,2.1E-4
2,test_20231031_155230,1254659.png,342646,74757,267889,0.7818243901869568,5,6,80080,10445,69635,0.869567932067932,20.832983111111112,3162.755813333333,13.130146982015201,125,2.1E-4
3,test_20231031_155230,10188041.png,221231,9952,211279,0.9550153459506127,3,6,41731,1403,40328,0.9663799094198557,10.516405333333333,1008.327776,18.094786301784424,125,2.1E-4
4,test_20231031_155230,10287332.png,216980,12584,204396,0.942003871324546,3,6,22337,1727,20610,0.9226843354076196,9.448579555555556,778.9383466666667,19.21577276445775,125,2.1E-4
5,test_20231031_155230,11610969.png,368720,26082,342638,0.9292633977001519,4,6,84111,3804,80307,0.9547740485786639,21.12351288888889,2899.7180693333335,13.507245860327119,125,2.1E-4
6,test_20231031_155230,10350842.png,212614,6184,206430,0.9709144270838233,3,6,42529,906,41623,0.9786968891814997,19.249219555555555,2368.0866986666665,14.386827624524777,125,2.1E-4
7,test_20231031_155230,10863862.png,317432,12282,305150,0.9613082486957837,3,6,66058,1783,64275,0.9730085682279209,23.971452444444445,3305.626730666667,12.938265491291542,125,2.1E-4
8,test_20231031_155230,11382381.png,312486,907,311579,0.9970974699666545,3,5,46745,121,46624,0.9974114878596642,21.088220444444445,2409.5101546666665,14.311515999312824,125,2.1E-4
9,test_20231031_155230,11079715.png,443815,120387,323428,0.7287450852269527,5,6,124136,16809,107327,0.8645920603209383,16.86984177777778,2095.0260693333335,14.918909294142013,125,2.1E-4
10,test_20231031_155230,11551286.png,271883,877,271006,0.9967743477893064,2,5,40092,128,39964,0.9968073431108451,17.018796444444444,1715.096528,15.787917931083486,125,2.1E-4
1,test_20231031_155231,10404007.png,502730,21859,480871,0.9565194040538659,3,5,61265,3161,58104,0.9484044723741125,25.648606222222224,3418.377488,12.792603411306079,125,2.2E-4
2,test_20231031_155231,1254659.png,342646,74757,267889,0.7818243901869568,5,6,80080,10445,69635,0.869567932067932,20.832983111111112,3162.755813333333,13.130146982015201,125,2.2E-4
3,test_20231031_155231,10188041.png,221231,9952,211279,0.9550153459506127,3,6,41731,1403,40328,0.9663799094198557,10.516405333333333,1008.327776,18.094786301784424,125,2.2E-4
4,test_20231031_155231,10287332.png,216980,12584,204396,0.942003871324546,2,5,22337,1727,20610,0.9226843354076196,9.448579555555556,778.9383466666667,19.21577276445775,125,2.2E-4
5,test_20231031_155231,11610969.png,368720,26082,342638,0.9292633977001519,4,6,84111,3804,80307,0.9547740485786639,21.12351288888889,2899.7180693333335,13.507245860327119,125,2.2E-4
6,test_20231031_155231,10350842.png,212614,6184,206430,0.9709144270838233,3,6,42529,906,41623,0.9786968891814997,19.249219555555555,2368.0866986666665,14.386827624524777,125,2.2E-4
7,test_20231031_155231,10863862.png,317432,12282,305150,0.9613082486957837,3,6,66058,1783,64275,0.9730085682279209,23.971452444444445,3305.626730666667,12.938265491291542,125,2.2E-4
8,test_20231031_155231,11382381.png,312486,907,311579,0.9970974699666545,2,6,46745,121,46624,0.9974114878596642,21.088220444444445,2409.5101546666665,14.311515999312824,125,2.2E-4
9,test_20231031_155231,11079715.png,443815,120387,323428,0.7287450852269527,5,6,124136,16809,107327,0.8645920603209383,16.86984177777778,2095.0260693333335,14.918909294142013,125,2.2E-4
10,test_20231031_155231,11551286.png,271883,877,271006,0.9967743477893064,2,6,40092,128,39964,0.9968073431108451,17.018796444444444,1715.096528,15.787917931083486,125,2.2E-4
1,test_20231031_155232,10404007.png,502730,21859,480871,0.9565194040538659,3,6,61265,3161,58104,0.9484044723741125,25.648606222222224,3418.377488,12.792603411306079,125,2.3E-4
2,test_20231031_155232,1254659.png,342646,74757,267889,0.7818243901869568,4,6,80080,10445,69635,0.869567932067932,20.832983111111112,3162.755813333333,13.130146982015201,125,2.3E-4
3,test_20231031_155232,10188041.png,221231,9952,211279,0.9550153459506127,3,6,41731,1403,40328,0.9663799094198557,10.516405333333333,1008.327776,18.094786301784424,125,2.3E-4
4,test_20231031_155232,10287332.png,216980,12584,204396,0.942003871324546,2,5,22337,1727,20610,0.9226843354076196,9.448579555555556,778.9383466666667,19.21577276445775,125,2.3E-4
5,test_20231031_155232,11610969.png,368720,26082,342638,0.9292633977001519,4,6,84111,3804,80307,0.9547740485786639,21.12351288888889,2899.7180693333335,13.507245860327119,125,2.3E-4
6,test_20231031_155232,10350842.png,212614,6184,206430,0.9709144270838233,3,6,42529,906,41623,0.9786968891814997,19.249219555555555,2368.0866986666665,14.386827624524777,125,2.3E-4
7,test_20231031_155232,10863862.png,317432,12282,305150,0.9613082486957837,4,6,66058,1783,64275,0.9730085682279209,23.971452444444445,3305.626730666667,12.938265491291542,125,2.3E-4
8,test_20231031_155232,11382381.png,312486,907,311579,0.9970974699666545,2,5,46745,121,46624,0.9974114878596642,21.088220444444445,2409.5101546666665,14.311515999312824,125,2.3E-4
9,test_20231031_155232,11079715.png,443815,120387,323428,0.7287450852269527,5,6,124136,16809,107327,0.8645920603209383,16.86984177777778,2095.0260693333335,14.918909294142013,125,2.3E-4
10,test_20231031_155232,11551286.png,271883,877,271006,0.9967743477893064,2,17,40092,128,39964,0.9968073431108451,17.018796444444444,1715.096528,15.787917931083486,125,2.3E-4
1,test_20231031_155233,10404007.png,502730,21859,480871,0.9565194040538659,4,6,61265,3161,58104,0.9484044723741125,25.648606222222224,3418.377488,12.792603411306079,125,2.4E-4
2,test_20231031_155233,1254659.png,342646,74757,267889,0.7818243901869568,5,6,80080,10445,69635,0.869567932067932,20.832983111111112,3162.755813333333,13.130146982015201,125,2.4E-4
3,test_20231031_155233,10188041.png,221231,9952,211279,0.9550153459506127,3,6,41731,1403,40328,0.9663799094198557,10.516405333333333,1008.327776,18.094786301784424,125,2.4E-4
4,test_20231031_155233,10287332.png,216980,12584,204396,0.942003871324546,2,6,22337,1727,20610,0.9226843354076196,9.448579555555556,778.9383466666667,19.21577276445775,125,2.4E-4
5,test_20231031_155233,11610969.png,368720,26082,342638,0.9292633977001519,4,6,84111,3804,80307,0.9547740485786639,21.12351288888889,2899.7180693333335,13.507245860327119,125,2.4E-4
6,test_20231031_155233,10350842.png,212614,6184,206430,0.9709144270838233,2,5,42529,906,41623,0.9786968891814997,19.249219555555555,2368.0866986666665,14.386827624524777,125,2.4E-4
7,test_20231031_155233,10863862.png,317432,12282,305150,0.9613082486957837,3,6,66058,1783,64275,0.9730085682279209,23.971452444444445,3305.626730666667,12.938265491291542,125,2.4E-4
8,test_20231031_155233,11382381.png,312486,907,311579,0.9970974699666545,2,6,46745,121,46624,0.9974114878596642,21.088220444444445,2409.5101546666665,14.311515999312824,125,2.4E-4
9,test_20231031_155233,11079715.png,443815,120387,323428,0.7287450852269527,6,7,124136,16809,107327,0.8645920603209383,16.86984177777778,2095.0260693333335,14.918909294142013,125,2.4E-4
10,test_20231031_155233,11551286.png,271883,877,271006,0.9967743477893064,2,5,40092,128,39964,0.9968073431108451,17.018796444444444,1715.096528,15.787917931083486,125,2.4E-4
1,test_20231031_155234,10404007.png,502730,21859,480871,0.9565194040538659,4,6,61265,3161,58104,0.9484044723741125,25.648606222222224,3418.377488,12.792603411306079,125,2.5E-4
2,test_20231031_155234,1254659.png,342646,74757,267889,0.7818243901869568,5,6,80080,10445,69635,0.869567932067932,20.832983111111112,3162.755813333333,13.130146982015201,125,2.5E-4
3,test_20231031_155234,10188041.png,221231,9952,211279,0.9550153459506127,3,6,41731,1403,40328,0.9663799094198557,10.516405333333333,1008.327776,18.094786301784424,125,2.5E-4
4,test_20231031_155234,10287332.png,216980,12584,204396,0.942003871324546,2,5,22337,1727,20610,0.9226843354076196,9.448579555555556,778.9383466666667,19.21577276445775,125,2.5E-4
5,test_20231031_155234,11610969.png,368720,26082,342638,0.9292633977001519,4,6,84111,3804,80307,0.9547740485786639,21.12351288888889,2899.7180693333335,13.507245860327119,125,2.5E-4
6,test_20231031_155234,10350842.png,212614,6184,206430,0.9709144270838233,3,6,42529,906,41623,0.9786968891814997,19.249219555555555,2368.0866986666665,14.386827624524777,125,2.5E-4
7,test_20231031_155234,10863862.png,317432,12282,305150,0.9613082486957837,6,7,66058,1783,64275,0.9730085682279209,23.971452444444445,3305.626730666667,12.938265491291542,125,2.5E-4
8,test_20231031_155234,11382381.png,312486,907,311579,0.9970974699666545,2,5,46745,121,46624,0.9974114878596642,21.088220444444445,2409.5101546666665,14.311515999312824,125,2.5E-4
9,test_20231031_155234,11079715.png,443815,120387,323428,0.7287450852269527,7,7,124136,16809,107327,0.8645920603209383,16.86984177777778,2095.0260693333335,14.918909294142013,125,2.5E-4
10,test_20231031_155234,11551286.png,271883,877,271006,0.9967743477893064,2,6,40092,128,39964,0.9968073431108451,17.018796444444444,1715.096528,15.787917931083486,125,2.5E-4
1,test_20231031_155235,10404007.png,502730,21619,481111,0.956996797485728,4,18,61265,3126,58139,0.9489757610381131,25.66681422222222,3421.940368,12.788079237733479,125,2.6000000000000003E-4
2,test_20231031_155235,1254659.png,342646,74697,267949,0.7819994980241999,5,6,80080,10439,69641,0.8696428571428572,20.84253688888889,3163.838,13.12866122928261,125,2.6000000000000003E-4
3,test_20231031_155235,10188041.png,221231,9852,211379,0.9554673621689547,3,6,41731,1388,40343,0.9667393544367496,10.639758222222222,1024.043168,18.02762096387238,125,2.6000000000000003E-4
4,test_20231031_155235,10287332.png,216980,12584,204396,0.942003871324546,2,6,22337,1727,20610,0.9226843354076196,9.448579555555556,778.9383466666667,19.21577276445775,125,2.6000000000000003E-4
5,test_20231031_155235,11610969.png,368720,25759,342961,0.9301394011716207,5,6,84111,3758,80353,0.9553209449418031,21.541429333333333,2985.787157333333,13.380215151782494,125,2.6000000000000003E-4
6,test_20231031_155235,10350842.png,212614,6102,206512,0.9713001025332292,3,5,42529,894,41635,0.9789790495896917,19.318012444444445,2373.8444053333333,14.37628111337661,125,2.6000000000000003E-4
7,test_20231031_155235,10863862.png,317432,12162,305270,0.9616862824163915,3,6,66058,1765,64293,0.9732810560416604,24.022609777777777,3308.937994666667,12.933917317637896,125,2.6000000000000003E-4
8,test_20231031_155235,11382381.png,312486,767,311719,0.9975454900379537,3,6,46745,100,46645,0.9978607337683175,21.58402311111111,2479.723024,14.186771864393144,125,2.6000000000000003E-4
9,test_20231031_155235,11079715.png,443815,120387,323428,0.7287450852269527,5,6,124136,16809,107327,0.8645920603209383,16.86984177777778,2095.0260693333335,14.918909294142013,125,2.6000000000000003E-4
10,test_20231031_155235,11551286.png,271883,757,271126,0.9972157141123204,2,5,40092,110,39982,0.9972563104858825,17.568885333333334,1810.9495893333333,15.55173999664329,125,2.6000000000000003E-4
1,test_20231031_155236,10404007.png,502730,21619,481111,0.956996797485728,3,5,61265,3126,58139,0.9489757610381131,25.66681422222222,3421.940368,12.788079237733479,125,2.7000000000000006E-4
2,test_20231031_155236,1254659.png,342646,74697,267949,0.7819994980241999,5,6,80080,10439,69641,0.8696428571428572,20.84253688888889,3163.838,13.12866122928261,125,2.7000000000000006E-4
3,test_20231031_155236,10188041.png,221231,9852,211379,0.9554673621689547,3,5,41731,1388,40343,0.9667393544367496,10.639758222222222,1024.043168,18.02762096387238,125,2.7000000000000006E-4
4,test_20231031_155236,10287332.png,216980,12584,204396,0.942003871324546,3,6,22337,1727,20610,0.9226843354076196,9.448579555555556,778.9383466666667,19.21577276445775,125,2.7000000000000006E-4
5,test_20231031_155236,11610969.png,368720,25759,342961,0.9301394011716207,3,6,84111,3758,80353,0.9553209449418031,21.541429333333333,2985.787157333333,13.380215151782494,125,2.7000000000000006E-4
6,test_20231031_155236,10350842.png,212614,6102,206512,0.9713001025332292,2,5,42529,894,41635,0.9789790495896917,19.318012444444445,2373.8444053333333,14.37628111337661,125,2.7000000000000006E-4
7,test_20231031_155236,10863862.png,317432,12162,305270,0.9616862824163915,4,5,66058,1765,64293,0.9732810560416604,24.022609777777777,3308.937994666667,12.933917317637896,125,2.7000000000000006E-4
8,test_20231031_155236,11382381.png,312486,767,311719,0.9975454900379537,3,5,46745,100,46645,0.9978607337683175,21.58402311111111,2479.723024,14.186771864393144,125,2.7000000000000006E-4
9,test_20231031_155236,11079715.png,443815,120387,323428,0.7287450852269527,5,6,124136,16809,107327,0.8645920603209383,16.86984177777778,2095.0260693333335,14.918909294142013,125,2.7000000000000006E-4
10,test_20231031_155236,11551286.png,271883,757,271126,0.9972157141123204,2,5,40092,110,39982,0.9972563104858825,17.568885333333334,1810.9495893333333,15.55173999664329,125,2.7000000000000006E-4
1,test_20231031_155237,10404007.png,502730,21619,481111,0.956996797485728,3,5,61265,3126,58139,0.9489757610381131,25.66681422222222,3421.940368,12.788079237733479,125,2.800000000000001E-4
2,test_20231031_155237,1254659.png,342646,74697,267949,0.7819994980241999,4,6,80080,10439,69641,0.8696428571428572,20.84253688888889,3163.838,13.12866122928261,125,2.800000000000001E-4
3,test_20231031_155237,10188041.png,221231,9852,211379,0.9554673621689547,3,6,41731,1388,40343,0.9667393544367496,10.639758222222222,1024.043168,18.02762096387238,125,2.800000000000001E-4
4,test_20231031_155237,10287332.png,216980,12584,204396,0.942003871324546,2,5,22337,1727,20610,0.9226843354076196,9.448579555555556,778.9383466666667,19.21577276445775,125,2.800000000000001E-4
5,test_20231031_155237,11610969.png,368720,25759,342961,0.9301394011716207,4,6,84111,3758,80353,0.9553209449418031,21.541429333333333,2985.787157333333,13.380215151782494,125,2.800000000000001E-4
6,test_20231031_155237,10350842.png,212614,6102,206512,0.9713001025332292,2,16,42529,894,41635,0.9789790495896917,19.318012444444445,2373.8444053333333,14.37628111337661,125,2.800000000000001E-4
7,test_20231031_155237,10863862.png,317432,12162,305270,0.9616862824163915,4,5,66058,1765,64293,0.9732810560416604,24.022609777777777,3308.937994666667,12.933917317637896,125,2.800000000000001E-4
8,test_20231031_155237,11382381.png,312486,767,311719,0.9975454900379537,2,5,46745,100,46645,0.9978607337683175,21.58402311111111,2479.723024,14.186771864393144,125,2.800000000000001E-4
9,test_20231031_155237,11079715.png,443815,120387,323428,0.7287450852269527,5,7,124136,16809,107327,0.8645920603209383,16.86984177777778,2095.0260693333335,14.918909294142013,125,2.800000000000001E-4
10,test_20231031_155237,11551286.png,271883,757,271126,0.9972157141123204,2,14,40092,110,39982,0.9972563104858825,17.568885333333334,1810.9495893333333,15.55173999664329,125,2.800000000000001E-4
1,test_20231031_155238,10404007.png,502730,21619,481111,0.956996797485728,3,5,61265,3126,58139,0.9489757610381131,25.66681422222222,3421.940368,12.788079237733479,125,2.900000000000001E-4
2,test_20231031_155238,1254659.png,342646,74697,267949,0.7819994980241999,4,6,80080,10439,69641,0.8696428571428572,20.84253688888889,3163.838,13.12866122928261,125,2.900000000000001E-4
3,test_20231031_155238,10188041.png,221231,9852,211379,0.9554673621689547,3,5,41731,1388,40343,0.9667393544367496,10.639758222222222,1024.043168,18.02762096387238,125,2.900000000000001E-4
4,test_20231031_155238,10287332.png,216980,12584,204396,0.942003871324546,2,5,22337,1727,20610,0.9226843354076196,9.448579555555556,778.9383466666667,19.21577276445775,125,2.900000000000001E-4
5,test_20231031_155238,11610969.png,368720,25759,342961,0.9301394011716207,4,6,84111,3758,80353,0.9553209449418031,21.541429333333333,2985.787157333333,13.380215151782494,125,2.900000000000001E-4
6,test_20231031_155238,10350842.png,212614,6102,206512,0.9713001025332292,2,6,42529,894,41635,0.9789790495896917,19.318012444444445,2373.8444053333333,14.37628111337661,125,2.900000000000001E-4
7,test_20231031_155238,10863862.png,317432,12162,305270,0.9616862824163915,3,5,66058,1765,64293,0.9732810560416604,24.022609777777777,3308.937994666667,12.933917317637896,125,2.900000000000001E-4
8,test_20231031_155238,11382381.png,312486,767,311719,0.9975454900379537,3,5,46745,100,46645,0.9978607337683175,21.58402311111111,2479.723024,14.186771864393144,125,2.900000000000001E-4
9,test_20231031_155238,11079715.png,443815,120387,323428,0.7287450852269527,5,6,124136,16809,107327,0.8645920603209383,16.86984177777778,2095.0260693333335,14.918909294142013,125,2.900000000000001E-4
10,test_20231031_155238,11551286.png,271883,447,271436,0.9983559104467731,2,5,40092,64,40028,0.9984036715554225,17.85190933333333,1855.3641226666666,15.446512065144763,125,2.900000000000001E-4
1,test_20231031_155240,10404007.png,502730,20834,481896,0.9585582718357767,4,6,61265,3016,58249,0.9507712396964009,25.686528,3429.773024,12.778149806752824,126,1.0E-5
2,test_20231031_155240,1254659.png,342646,73249,269397,0.7862254338296668,5,7,80080,10244,69836,0.8720779220779221,20.98264711111111,3208.4044853333335,13.067912460579436,126,1.0E-5
3,test_20231031_155240,10188041.png,221231,9692,211539,0.9561905881183017,3,6,41731,1366,40365,0.9672665404615274,10.568042666666667,1021.7253333333333,18.037461991689202,126,1.0E-5
4,test_20231031_155240,10287332.png,216980,12574,204406,0.9420499585215227,2,5,22337,1723,20614,0.9228634104848458,9.367333333333333,764.1768586666667,19.29886478922929,126,1.0E-5
5,test_20231031_155240,11610969.png,368720,25357,343363,0.9312296593621177,4,6,84111,3701,80410,0.9559986208700408,21.3076,2937.504816,13.451017735675183,126,1.0E-5
6,test_20231031_155240,10350842.png,212614,6082,206532,0.9713941697160112,3,6,42529,891,41638,0.9790495896917397,19.26112,2371.9918826666667,14.379671623979055,126,1.0E-5
7,test_20231031_155240,10863862.png,317432,11479,305953,0.9638379243428514,3,5,66058,1667,64391,0.9747646008053529,24.188906666666668,3362.179488,12.864594665868092,126,1.0E-5
8,test_20231031_155240,11382381.png,312486,1007,311479,0.9967774556300122,3,6,46745,136,46609,0.9970905979249117,20.14226311111111,2274.987984,14.561012537192962,126,1.0E-5
9,test_20231031_155240,11079715.png,443815,118057,325758,0.733995020447709,5,7,124136,16497,107639,0.8671054327511761,17.022149333333335,2131.304528,14.84434853255526,126,1.0E-5
10,test_20231031_155240,11551286.png,271883,1159,270724,0.9957371369302237,3,6,40092,170,39922,0.9957597525690911,15.773507555555556,1501.2797866666667,16.36618723599906,126,1.0E-5
1,test_20231031_155241,10404007.png,502730,20834,481896,0.9585582718357767,3,7,61265,3016,58249,0.9507712396964009,25.686528,3429.773024,12.778149806752824,126,2.0E-5
2,test_20231031_155241,1254659.png,342646,73249,269397,0.7862254338296668,5,12,80080,10244,69836,0.8720779220779221,20.98264711111111,3208.4044853333335,13.067912460579436,126,2.0E-5
3,test_20231031_155241,10188041.png,221231,9692,211539,0.9561905881183017,3,6,41731,1366,40365,0.9672665404615274,10.568042666666667,1021.7253333333333,18.037461991689202,126,2.0E-5
4,test_20231031_155241,10287332.png,216980,12574,204406,0.9420499585215227,3,6,22337,1723,20614,0.9228634104848458,9.367333333333333,764.1768586666667,19.29886478922929,126,2.0E-5
5,test_20231031_155241,11610969.png,368720,25357,343363,0.9312296593621177,4,5,84111,3701,80410,0.9559986208700408,21.3076,2937.504816,13.451017735675183,126,2.0E-5
6,test_20231031_155241,10350842.png,212614,6082,206532,0.9713941697160112,3,6,42529,891,41638,0.9790495896917397,19.26112,2371.9918826666667,14.379671623979055,126,2.0E-5
7,test_20231031_155241,10863862.png,317432,11479,305953,0.9638379243428514,3,6,66058,1667,64391,0.9747646008053529,24.188906666666668,3362.179488,12.864594665868092,126,2.0E-5
8,test_20231031_155241,11382381.png,312486,1007,311479,0.9967774556300122,2,5,46745,136,46609,0.9970905979249117,20.14226311111111,2274.987984,14.561012537192962,126,2.0E-5
9,test_20231031_155241,11079715.png,443815,118057,325758,0.733995020447709,6,7,124136,16497,107639,0.8671054327511761,17.022149333333335,2131.304528,14.84434853255526,126,2.0E-5
10,test_20231031_155241,11551286.png,271883,1159,270724,0.9957371369302237,2,5,40092,170,39922,0.9957597525690911,15.773507555555556,1501.2797866666667,16.36618723599906,126,2.0E-5
1,test_20231031_155242,10404007.png,502730,20834,481896,0.9585582718357767,3,6,61265,3016,58249,0.9507712396964009,25.686528,3429.773024,12.778149806752824,126,3.0000000000000004E-5
2,test_20231031_155242,1254659.png,342646,73249,269397,0.7862254338296668,4,6,80080,10244,69836,0.8720779220779221,20.98264711111111,3208.4044853333335,13.067912460579436,126,3.0000000000000004E-5
3,test_20231031_155242,10188041.png,221231,9692,211539,0.9561905881183017,4,6,41731,1366,40365,0.9672665404615274,10.568042666666667,1021.7253333333333,18.037461991689202,126,3.0000000000000004E-5
4,test_20231031_155242,10287332.png,216980,12574,204406,0.9420499585215227,3,5,22337,1723,20614,0.9228634104848458,9.367333333333333,764.1768586666667,19.29886478922929,126,3.0000000000000004E-5
5,test_20231031_155242,11610969.png,368720,25357,343363,0.9312296593621177,4,6,84111,3701,80410,0.9559986208700408,21.3076,2937.504816,13.451017735675183,126,3.0000000000000004E-5
6,test_20231031_155242,10350842.png,212614,6082,206532,0.9713941697160112,2,5,42529,891,41638,0.9790495896917397,19.26112,2371.9918826666667,14.379671623979055,126,3.0000000000000004E-5
7,test_20231031_155242,10863862.png,317432,11479,305953,0.9638379243428514,3,6,66058,1667,64391,0.9747646008053529,24.188906666666668,3362.179488,12.864594665868092,126,3.0000000000000004E-5
8,test_20231031_155242,11382381.png,312486,1007,311479,0.9967774556300122,2,5,46745,136,46609,0.9970905979249117,20.14226311111111,2274.987984,14.561012537192962,126,3.0000000000000004E-5
9,test_20231031_155242,11079715.png,443815,118057,325758,0.733995020447709,5,7,124136,16497,107639,0.8671054327511761,17.022149333333335,2131.304528,14.84434853255526,126,3.0000000000000004E-5
10,test_20231031_155242,11551286.png,271883,1159,270724,0.9957371369302237,3,5,40092,170,39922,0.9957597525690911,15.773507555555556,1501.2797866666667,16.36618723599906,126,3.0000000000000004E-5
1,test_20231031_155243,10404007.png,502730,20834,481896,0.9585582718357767,7,6,61265,3016,58249,0.9507712396964009,25.686528,3429.773024,12.778149806752824,126,4.0E-5
2,test_20231031_155243,1254659.png,342646,73249,269397,0.7862254338296668,5,12,80080,10244,69836,0.8720779220779221,20.98264711111111,3208.4044853333335,13.067912460579436,126,4.0E-5
3,test_20231031_155243,10188041.png,221231,9692,211539,0.9561905881183017,3,6,41731,1366,40365,0.9672665404615274,10.568042666666667,1021.7253333333333,18.037461991689202,126,4.0E-5
4,test_20231031_155243,10287332.png,216980,12574,204406,0.9420499585215227,3,5,22337,1723,20614,0.9228634104848458,9.367333333333333,764.1768586666667,19.29886478922929,126,4.0E-5
5,test_20231031_155243,11610969.png,368720,25357,343363,0.9312296593621177,3,5,84111,3701,80410,0.9559986208700408,21.3076,2937.504816,13.451017735675183,126,4.0E-5
6,test_20231031_155243,10350842.png,212614,6082,206532,0.9713941697160112,2,5,42529,891,41638,0.9790495896917397,19.26112,2371.9918826666667,14.379671623979055,126,4.0E-5
7,test_20231031_155243,10863862.png,317432,11479,305953,0.9638379243428514,3,6,66058,1667,64391,0.9747646008053529,24.188906666666668,3362.179488,12.864594665868092,126,4.0E-5
8,test_20231031_155243,11382381.png,312486,1007,311479,0.9967774556300122,2,5,46745,136,46609,0.9970905979249117,20.14226311111111,2274.987984,14.561012537192962,126,4.0E-5
9,test_20231031_155243,11079715.png,443815,118057,325758,0.733995020447709,5,7,124136,16497,107639,0.8671054327511761,17.022149333333335,2131.304528,14.84434853255526,126,4.0E-5
10,test_20231031_155243,11551286.png,271883,1159,270724,0.9957371369302237,2,6,40092,170,39922,0.9957597525690911,15.773507555555556,1501.2797866666667,16.36618723599906,126,4.0E-5
1,test_20231031_155244,10404007.png,502730,20834,481896,0.9585582718357767,4,6,61265,3016,58249,0.9507712396964009,25.686528,3429.773024,12.778149806752824,126,5.0E-5
2,test_20231031_155244,1254659.png,342646,73249,269397,0.7862254338296668,5,7,80080,10244,69836,0.8720779220779221,20.98264711111111,3208.4044853333335,13.067912460579436,126,5.0E-5
3,test_20231031_155244,10188041.png,221231,9692,211539,0.9561905881183017,3,6,41731,1366,40365,0.9672665404615274,10.568042666666667,1021.7253333333333,18.037461991689202,126,5.0E-5
4,test_20231031_155244,10287332.png,216980,12574,204406,0.9420499585215227,3,6,22337,1723,20614,0.9228634104848458,9.367333333333333,764.1768586666667,19.29886478922929,126,5.0E-5
5,test_20231031_155244,11610969.png,368720,25357,343363,0.9312296593621177,4,6,84111,3701,80410,0.9559986208700408,21.3076,2937.504816,13.451017735675183,126,5.0E-5
6,test_20231031_155244,10350842.png,212614,6082,206532,0.9713941697160112,3,6,42529,891,41638,0.9790495896917397,19.26112,2371.9918826666667,14.379671623979055,126,5.0E-5
7,test_20231031_155244,10863862.png,317432,11479,305953,0.9638379243428514,3,6,66058,1667,64391,0.9747646008053529,24.188906666666668,3362.179488,12.864594665868092,126,5.0E-5
8,test_20231031_155244,11382381.png,312486,997,311489,0.9968094570636764,3,6,46745,135,46610,0.9971119905872285,20.87208,2373.5487946666667,14.376821966329306,126,5.0E-5
9,test_20231031_155244,11079715.png,443815,118057,325758,0.733995020447709,6,7,124136,16497,107639,0.8671054327511761,17.022149333333335,2131.304528,14.84434853255526,126,5.0E-5
10,test_20231031_155244,11551286.png,271883,1159,270724,0.9957371369302237,2,5,40092,170,39922,0.9957597525690911,15.773507555555556,1501.2797866666667,16.36618723599906,126,5.0E-5
1,test_20231031_155245,10404007.png,502730,20834,481896,0.9585582718357767,4,6,61265,3016,58249,0.9507712396964009,25.686528,3429.773024,12.778149806752824,126,6.0E-5
2,test_20231031_155245,1254659.png,342646,73249,269397,0.7862254338296668,5,6,80080,10244,69836,0.8720779220779221,20.98264711111111,3208.4044853333335,13.067912460579436,126,6.0E-5
3,test_20231031_155245,10188041.png,221231,9692,211539,0.9561905881183017,3,5,41731,1366,40365,0.9672665404615274,10.568042666666667,1021.7253333333333,18.037461991689202,126,6.0E-5
4,test_20231031_155245,10287332.png,216980,12574,204406,0.9420499585215227,2,5,22337,1723,20614,0.9228634104848458,9.367333333333333,764.1768586666667,19.29886478922929,126,6.0E-5
5,test_20231031_155245,11610969.png,368720,25357,343363,0.9312296593621177,3,5,84111,3701,80410,0.9559986208700408,21.3076,2937.504816,13.451017735675183,126,6.0E-5
6,test_20231031_155245,10350842.png,212614,6082,206532,0.9713941697160112,2,5,42529,891,41638,0.9790495896917397,19.26112,2371.9918826666667,14.379671623979055,126,6.0E-5
7,test_20231031_155245,10863862.png,317432,11479,305953,0.9638379243428514,3,6,66058,1667,64391,0.9747646008053529,24.188906666666668,3362.179488,12.864594665868092,126,6.0E-5
8,test_20231031_155245,11382381.png,312486,997,311489,0.9968094570636764,2,5,46745,135,46610,0.9971119905872285,20.87208,2373.5487946666667,14.376821966329306,126,6.0E-5
9,test_20231031_155245,11079715.png,443815,118057,325758,0.733995020447709,5,12,124136,16497,107639,0.8671054327511761,17.022149333333335,2131.304528,14.84434853255526,126,6.0E-5
10,test_20231031_155245,11551286.png,271883,1159,270724,0.9957371369302237,3,6,40092,170,39922,0.9957597525690911,15.773507555555556,1501.2797866666667,16.36618723599906,126,6.0E-5
1,test_20231031_155246,10404007.png,502730,20834,481896,0.9585582718357767,4,6,61265,3016,58249,0.9507712396964009,25.686528,3429.773024,12.778149806752824,126,7.000000000000001E-5
2,test_20231031_155246,1254659.png,342646,73249,269397,0.7862254338296668,4,7,80080,10244,69836,0.8720779220779221,20.98264711111111,3208.4044853333335,13.067912460579436,126,7.000000000000001E-5
3,test_20231031_155246,10188041.png,221231,9692,211539,0.9561905881183017,3,5,41731,1366,40365,0.9672665404615274,10.568042666666667,1021.7253333333333,18.037461991689202,126,7.000000000000001E-5
4,test_20231031_155246,10287332.png,216980,12574,204406,0.9420499585215227,2,5,22337,1723,20614,0.9228634104848458,9.367333333333333,764.1768586666667,19.29886478922929,126,7.000000000000001E-5
5,test_20231031_155246,11610969.png,368720,25357,343363,0.9312296593621177,3,12,84111,3701,80410,0.9559986208700408,21.3076,2937.504816,13.451017735675183,126,7.000000000000001E-5
6,test_20231031_155246,10350842.png,212614,6082,206532,0.9713941697160112,2,6,42529,891,41638,0.9790495896917397,19.26112,2371.9918826666667,14.379671623979055,126,7.000000000000001E-5
7,test_20231031_155246,10863862.png,317432,11479,305953,0.9638379243428514,3,5,66058,1667,64391,0.9747646008053529,24.188906666666668,3362.179488,12.864594665868092,126,7.000000000000001E-5
8,test_20231031_155246,11382381.png,312486,997,311489,0.9968094570636764,3,5,46745,135,46610,0.9971119905872285,20.87208,2373.5487946666667,14.376821966329306,126,7.000000000000001E-5
9,test_20231031_155246,11079715.png,443815,118057,325758,0.733995020447709,5,6,124136,16497,107639,0.8671054327511761,17.022149333333335,2131.304528,14.84434853255526,126,7.000000000000001E-5
10,test_20231031_155246,11551286.png,271883,1039,270844,0.9961785032532376,2,5,40092,152,39940,0.9962087199441285,15.859841777777778,1507.39176,16.348542239511865,126,7.000000000000001E-5
1,test_20231031_155247,10404007.png,502730,20834,481896,0.9585582718357767,4,6,61265,3016,58249,0.9507712396964009,25.686528,3429.773024,12.778149806752824,126,8.0E-5
2,test_20231031_155247,1254659.png,342646,73249,269397,0.7862254338296668,5,6,80080,10244,69836,0.8720779220779221,20.98264711111111,3208.4044853333335,13.067912460579436,126,8.0E-5
3,test_20231031_155247,10188041.png,221231,9692,211539,0.9561905881183017,3,6,41731,1366,40365,0.9672665404615274,10.568042666666667,1021.7253333333333,18.037461991689202,126,8.0E-5
4,test_20231031_155247,10287332.png,216980,12574,204406,0.9420499585215227,3,6,22337,1723,20614,0.9228634104848458,9.367333333333333,764.1768586666667,19.29886478922929,126,8.0E-5
5,test_20231031_155247,11610969.png,368720,25357,343363,0.9312296593621177,4,6,84111,3701,80410,0.9559986208700408,21.3076,2937.504816,13.451017735675183,126,8.0E-5
6,test_20231031_155247,10350842.png,212614,6082,206532,0.9713941697160112,2,5,42529,891,41638,0.9790495896917397,19.26112,2371.9918826666667,14.379671623979055,126,8.0E-5
7,test_20231031_155247,10863862.png,317432,11479,305953,0.9638379243428514,3,5,66058,1667,64391,0.9747646008053529,24.188906666666668,3362.179488,12.864594665868092,126,8.0E-5
8,test_20231031_155247,11382381.png,312486,997,311489,0.9968094570636764,3,6,46745,135,46610,0.9971119905872285,20.87208,2373.5487946666667,14.376821966329306,126,8.0E-5
9,test_20231031_155247,11079715.png,443815,118057,325758,0.733995020447709,6,7,124136,16497,107639,0.8671054327511761,17.022149333333335,2131.304528,14.84434853255526,126,8.0E-5
10,test_20231031_155247,11551286.png,271883,1039,270844,0.9961785032532376,2,6,40092,152,39940,0.9962087199441285,15.859841777777778,1507.39176,16.348542239511865,126,8.0E-5
1,test_20231031_155248,10404007.png,502730,20834,481896,0.9585582718357767,4,6,61265,3016,58249,0.9507712396964009,25.686528,3429.773024,12.778149806752824,126,9.0E-5
2,test_20231031_155248,1254659.png,342646,73249,269397,0.7862254338296668,4,6,80080,10244,69836,0.8720779220779221,20.98264711111111,3208.4044853333335,13.067912460579436,126,9.0E-5
3,test_20231031_155248,10188041.png,221231,9692,211539,0.9561905881183017,3,5,41731,1366,40365,0.9672665404615274,10.568042666666667,1021.7253333333333,18.037461991689202,126,9.0E-5
4,test_20231031_155248,10287332.png,216980,12574,204406,0.9420499585215227,3,6,22337,1723,20614,0.9228634104848458,9.367333333333333,764.1768586666667,19.29886478922929,126,9.0E-5
5,test_20231031_155248,11610969.png,368720,25357,343363,0.9312296593621177,3,5,84111,3701,80410,0.9559986208700408,21.3076,2937.504816,13.451017735675183,126,9.0E-5
6,test_20231031_155248,10350842.png,212614,6082,206532,0.9713941697160112,2,6,42529,891,41638,0.9790495896917397,19.26112,2371.9918826666667,14.379671623979055,126,9.0E-5
7,test_20231031_155248,10863862.png,317432,11479,305953,0.9638379243428514,3,6,66058,1667,64391,0.9747646008053529,24.188906666666668,3362.179488,12.864594665868092,126,9.0E-5
8,test_20231031_155248,11382381.png,312486,997,311489,0.9968094570636764,3,6,46745,135,46610,0.9971119905872285,20.87208,2373.5487946666667,14.376821966329306,126,9.0E-5
9,test_20231031_155248,11079715.png,443815,118057,325758,0.733995020447709,5,7,124136,16497,107639,0.8671054327511761,17.022149333333335,2131.304528,14.84434853255526,126,9.0E-5
10,test_20231031_155248,11551286.png,271883,1039,270844,0.9961785032532376,2,5,40092,152,39940,0.9962087199441285,15.859841777777778,1507.39176,16.348542239511865,126,9.0E-5
1,test_20231031_155249,10404007.png,502730,20834,481896,0.9585582718357767,4,6,61265,3016,58249,0.9507712396964009,25.686528,3429.773024,12.778149806752824,126,1.0E-4
2,test_20231031_155249,1254659.png,342646,73249,269397,0.7862254338296668,4,15,80080,10244,69836,0.8720779220779221,20.98264711111111,3208.4044853333335,13.067912460579436,126,1.0E-4
3,test_20231031_155249,10188041.png,221231,9692,211539,0.9561905881183017,3,5,41731,1366,40365,0.9672665404615274,10.568042666666667,1021.7253333333333,18.037461991689202,126,1.0E-4
4,test_20231031_155249,10287332.png,216980,12574,204406,0.9420499585215227,2,5,22337,1723,20614,0.9228634104848458,9.367333333333333,764.1768586666667,19.29886478922929,126,1.0E-4
5,test_20231031_155249,11610969.png,368720,25357,343363,0.9312296593621177,3,5,84111,3701,80410,0.9559986208700408,21.3076,2937.504816,13.451017735675183,126,1.0E-4
6,test_20231031_155249,10350842.png,212614,6082,206532,0.9713941697160112,2,5,42529,891,41638,0.9790495896917397,19.26112,2371.9918826666667,14.379671623979055,126,1.0E-4
7,test_20231031_155249,10863862.png,317432,11479,305953,0.9638379243428514,3,6,66058,1667,64391,0.9747646008053529,24.188906666666668,3362.179488,12.864594665868092,126,1.0E-4
8,test_20231031_155249,11382381.png,312486,997,311489,0.9968094570636764,2,6,46745,135,46610,0.9971119905872285,20.87208,2373.5487946666667,14.376821966329306,126,1.0E-4
9,test_20231031_155249,11079715.png,443815,118057,325758,0.733995020447709,6,7,124136,16497,107639,0.8671054327511761,17.022149333333335,2131.304528,14.84434853255526,126,1.0E-4
10,test_20231031_155249,11551286.png,271883,1039,270844,0.9961785032532376,2,6,40092,152,39940,0.9962087199441285,15.859841777777778,1507.39176,16.348542239511865,126,1.0E-4
1,test_20231031_155250,10404007.png,502730,20834,481896,0.9585582718357767,3,6,61265,3016,58249,0.9507712396964009,25.686528,3429.773024,12.778149806752824,126,1.1E-4
2,test_20231031_155250,1254659.png,342646,73249,269397,0.7862254338296668,5,7,80080,10244,69836,0.8720779220779221,20.98264711111111,3208.4044853333335,13.067912460579436,126,1.1E-4
3,test_20231031_155250,10188041.png,221231,9692,211539,0.9561905881183017,3,6,41731,1366,40365,0.9672665404615274,10.568042666666667,1021.7253333333333,18.037461991689202,126,1.1E-4
4,test_20231031_155250,10287332.png,216980,12574,204406,0.9420499585215227,2,6,22337,1723,20614,0.9228634104848458,9.367333333333333,764.1768586666667,19.29886478922929,126,1.1E-4
5,test_20231031_155250,11610969.png,368720,25357,343363,0.9312296593621177,4,6,84111,3701,80410,0.9559986208700408,21.3076,2937.504816,13.451017735675183,126,1.1E-4
6,test_20231031_155250,10350842.png,212614,6082,206532,0.9713941697160112,2,5,42529,891,41638,0.9790495896917397,19.26112,2371.9918826666667,14.379671623979055,126,1.1E-4
7,test_20231031_155250,10863862.png,317432,11479,305953,0.9638379243428514,3,5,66058,1667,64391,0.9747646008053529,24.188906666666668,3362.179488,12.864594665868092,126,1.1E-4
8,test_20231031_155250,11382381.png,312486,997,311489,0.9968094570636764,2,5,46745,135,46610,0.9971119905872285,20.87208,2373.5487946666667,14.376821966329306,126,1.1E-4
9,test_20231031_155250,11079715.png,443815,118057,325758,0.733995020447709,5,7,124136,16497,107639,0.8671054327511761,17.022149333333335,2131.304528,14.84434853255526,126,1.1E-4
10,test_20231031_155250,11551286.png,271883,1039,270844,0.9961785032532376,2,5,40092,152,39940,0.9962087199441285,15.859841777777778,1507.39176,16.348542239511865,126,1.1E-4
1,test_20231031_155251,10404007.png,502730,20834,481896,0.9585582718357767,4,6,61265,3016,58249,0.9507712396964009,25.686528,3429.773024,12.778149806752824,126,1.2E-4
2,test_20231031_155251,1254659.png,342646,73249,269397,0.7862254338296668,5,6,80080,10244,69836,0.8720779220779221,20.98264711111111,3208.4044853333335,13.067912460579436,126,1.2E-4
3,test_20231031_155251,10188041.png,221231,9692,211539,0.9561905881183017,3,6,41731,1366,40365,0.9672665404615274,10.568042666666667,1021.7253333333333,18.037461991689202,126,1.2E-4
4,test_20231031_155251,10287332.png,216980,12574,204406,0.9420499585215227,3,6,22337,1723,20614,0.9228634104848458,9.367333333333333,764.1768586666667,19.29886478922929,126,1.2E-4
5,test_20231031_155251,11610969.png,368720,25357,343363,0.9312296593621177,4,6,84111,3701,80410,0.9559986208700408,21.3076,2937.504816,13.451017735675183,126,1.2E-4
6,test_20231031_155251,10350842.png,212614,6082,206532,0.9713941697160112,2,5,42529,891,41638,0.9790495896917397,19.26112,2371.9918826666667,14.379671623979055,126,1.2E-4
7,test_20231031_155251,10863862.png,317432,11479,305953,0.9638379243428514,3,6,66058,1667,64391,0.9747646008053529,24.188906666666668,3362.179488,12.864594665868092,126,1.2E-4
8,test_20231031_155251,11382381.png,312486,997,311489,0.9968094570636764,3,6,46745,135,46610,0.9971119905872285,20.87208,2373.5487946666667,14.376821966329306,126,1.2E-4
9,test_20231031_155251,11079715.png,443815,118057,325758,0.733995020447709,11,6,124136,16497,107639,0.8671054327511761,17.022149333333335,2131.304528,14.84434853255526,126,1.2E-4
10,test_20231031_155251,11551286.png,271883,1039,270844,0.9961785032532376,2,5,40092,152,39940,0.9962087199441285,15.859841777777778,1507.39176,16.348542239511865,126,1.2E-4
1,test_20231031_155252,10404007.png,502730,20834,481896,0.9585582718357767,3,5,61265,3016,58249,0.9507712396964009,25.686528,3429.773024,12.778149806752824,126,1.3000000000000002E-4
2,test_20231031_155252,1254659.png,342646,73249,269397,0.7862254338296668,4,6,80080,10244,69836,0.8720779220779221,20.98264711111111,3208.4044853333335,13.067912460579436,126,1.3000000000000002E-4
3,test_20231031_155252,10188041.png,221231,9692,211539,0.9561905881183017,4,5,41731,1366,40365,0.9672665404615274,10.568042666666667,1021.7253333333333,18.037461991689202,126,1.3000000000000002E-4
4,test_20231031_155252,10287332.png,216980,12574,204406,0.9420499585215227,3,6,22337,1723,20614,0.9228634104848458,9.367333333333333,764.1768586666667,19.29886478922929,126,1.3000000000000002E-4
5,test_20231031_155252,11610969.png,368720,25357,343363,0.9312296593621177,3,6,84111,3701,80410,0.9559986208700408,21.3076,2937.504816,13.451017735675183,126,1.3000000000000002E-4
6,test_20231031_155252,10350842.png,212614,6082,206532,0.9713941697160112,2,5,42529,891,41638,0.9790495896917397,19.26112,2371.9918826666667,14.379671623979055,126,1.3000000000000002E-4
7,test_20231031_155252,10863862.png,317432,11479,305953,0.9638379243428514,3,6,66058,1667,64391,0.9747646008053529,24.188906666666668,3362.179488,12.864594665868092,126,1.3000000000000002E-4
8,test_20231031_155252,11382381.png,312486,997,311489,0.9968094570636764,2,5,46745,135,46610,0.9971119905872285,20.87208,2373.5487946666667,14.376821966329306,126,1.3000000000000002E-4
9,test_20231031_155252,11079715.png,443815,118057,325758,0.733995020447709,5,7,124136,16497,107639,0.8671054327511761,17.022149333333335,2131.304528,14.84434853255526,126,1.3000000000000002E-4
10,test_20231031_155252,11551286.png,271883,857,271026,0.9968479088431421,3,5,40092,125,39967,0.9968821710066846,17.020656,1715.495408,15.78690800983984,126,1.3000000000000002E-4
1,test_20231031_155253,10404007.png,502730,20834,481896,0.9585582718357767,4,6,61265,3016,58249,0.9507712396964009,25.686528,3429.773024,12.778149806752824,126,1.4000000000000001E-4
2,test_20231031_155253,1254659.png,342646,73249,269397,0.7862254338296668,4,6,80080,10244,69836,0.8720779220779221,20.98264711111111,3208.4044853333335,13.067912460579436,126,1.4000000000000001E-4
3,test_20231031_155253,10188041.png,221231,9692,211539,0.9561905881183017,3,6,41731,1366,40365,0.9672665404615274,10.568042666666667,1021.7253333333333,18.037461991689202,126,1.4000000000000001E-4
4,test_20231031_155253,10287332.png,216980,12574,204406,0.9420499585215227,2,5,22337,1723,20614,0.9228634104848458,9.367333333333333,764.1768586666667,19.29886478922929,126,1.4000000000000001E-4
5,test_20231031_155253,11610969.png,368720,25357,343363,0.9312296593621177,3,6,84111,3701,80410,0.9559986208700408,21.3076,2937.504816,13.451017735675183,126,1.4000000000000001E-4
6,test_20231031_155253,10350842.png,212614,6082,206532,0.9713941697160112,2,6,42529,891,41638,0.9790495896917397,19.26112,2371.9918826666667,14.379671623979055,126,1.4000000000000001E-4
7,test_20231031_155253,10863862.png,317432,11479,305953,0.9638379243428514,3,5,66058,1667,64391,0.9747646008053529,24.188906666666668,3362.179488,12.864594665868092,126,1.4000000000000001E-4
8,test_20231031_155253,11382381.png,312486,997,311489,0.9968094570636764,3,6,46745,135,46610,0.9971119905872285,20.87208,2373.5487946666667,14.376821966329306,126,1.4000000000000001E-4
9,test_20231031_155253,11079715.png,443815,118057,325758,0.733995020447709,5,6,124136,16497,107639,0.8671054327511761,17.022149333333335,2131.304528,14.84434853255526,126,1.4000000000000001E-4
10,test_20231031_155253,11551286.png,271883,857,271026,0.9968479088431421,2,6,40092,125,39967,0.9968821710066846,17.020656,1715.495408,15.78690800983984,126,1.4000000000000001E-4
1,test_20231031_155254,10404007.png,502730,20834,481896,0.9585582718357767,4,6,61265,3016,58249,0.9507712396964009,25.686528,3429.773024,12.778149806752824,126,1.5000000000000001E-4
2,test_20231031_155254,1254659.png,342646,73249,269397,0.7862254338296668,5,6,80080,10244,69836,0.8720779220779221,20.98264711111111,3208.4044853333335,13.067912460579436,126,1.5000000000000001E-4
3,test_20231031_155254,10188041.png,221231,9692,211539,0.9561905881183017,3,6,41731,1366,40365,0.9672665404615274,10.568042666666667,1021.7253333333333,18.037461991689202,126,1.5000000000000001E-4
4,test_20231031_155254,10287332.png,216980,12574,204406,0.9420499585215227,3,6,22337,1723,20614,0.9228634104848458,9.367333333333333,764.1768586666667,19.29886478922929,126,1.5000000000000001E-4
5,test_20231031_155254,11610969.png,368720,25357,343363,0.9312296593621177,3,5,84111,3701,80410,0.9559986208700408,21.3076,2937.504816,13.451017735675183,126,1.5000000000000001E-4
6,test_20231031_155254,10350842.png,212614,6082,206532,0.9713941697160112,3,6,42529,891,41638,0.9790495896917397,19.26112,2371.9918826666667,14.379671623979055,126,1.5000000000000001E-4
7,test_20231031_155254,10863862.png,317432,11479,305953,0.9638379243428514,3,5,66058,1667,64391,0.9747646008053529,24.188906666666668,3362.179488,12.864594665868092,126,1.5000000000000001E-4
8,test_20231031_155254,11382381.png,312486,867,311619,0.9972254757013114,3,6,46745,116,46629,0.9975184511712483,21.130496,2414.0920426666667,14.303265363409706,126,1.5000000000000001E-4
9,test_20231031_155254,11079715.png,443815,118057,325758,0.733995020447709,5,6,124136,16497,107639,0.8671054327511761,17.022149333333335,2131.304528,14.84434853255526,126,1.5000000000000001E-4
10,test_20231031_155254,11551286.png,271883,857,271026,0.9968479088431421,2,6,40092,125,39967,0.9968821710066846,17.020656,1715.495408,15.78690800983984,126,1.5000000000000001E-4
1,test_20231031_155255,10404007.png,502730,20834,481896,0.9585582718357767,3,5,61265,3016,58249,0.9507712396964009,25.686528,3429.773024,12.778149806752824,126,1.6E-4
2,test_20231031_155255,1254659.png,342646,73249,269397,0.7862254338296668,5,6,80080,10244,69836,0.8720779220779221,20.98264711111111,3208.4044853333335,13.067912460579436,126,1.6E-4
3,test_20231031_155255,10188041.png,221231,9692,211539,0.9561905881183017,4,6,41731,1366,40365,0.9672665404615274,10.568042666666667,1021.7253333333333,18.037461991689202,126,1.6E-4
4,test_20231031_155255,10287332.png,216980,12364,204616,0.943017789658033,2,5,22337,1696,20641,0.9240721672561221,9.497095111111111,790.9076053333333,19.149546091497648,126,1.6E-4
5,test_20231031_155255,11610969.png,368720,25357,343363,0.9312296593621177,4,6,84111,3701,80410,0.9559986208700408,21.3076,2937.504816,13.451017735675183,126,1.6E-4
6,test_20231031_155255,10350842.png,212614,6082,206532,0.9713941697160112,2,7,42529,891,41638,0.9790495896917397,19.26112,2371.9918826666667,14.379671623979055,126,1.6E-4
7,test_20231031_155255,10863862.png,317432,11479,305953,0.9638379243428514,3,6,66058,1667,64391,0.9747646008053529,24.188906666666668,3362.179488,12.864594665868092,126,1.6E-4
8,test_20231031_155255,11382381.png,312486,867,311619,0.9972254757013114,3,6,46745,116,46629,0.9975184511712483,21.130496,2414.0920426666667,14.303265363409706,126,1.6E-4
9,test_20231031_155255,11079715.png,443815,118057,325758,0.733995020447709,5,6,124136,16497,107639,0.8671054327511761,17.022149333333335,2131.304528,14.84434853255526,126,1.6E-4
10,test_20231031_155255,11551286.png,271883,857,271026,0.9968479088431421,2,6,40092,125,39967,0.9968821710066846,17.020656,1715.495408,15.78690800983984,126,1.6E-4
1,test_20231031_155256,10404007.png,502730,20834,481896,0.9585582718357767,3,5,61265,3016,58249,0.9507712396964009,25.686528,3429.773024,12.778149806752824,126,1.7E-4
2,test_20231031_155256,1254659.png,342646,73249,269397,0.7862254338296668,4,6,80080,10244,69836,0.8720779220779221,20.98264711111111,3208.4044853333335,13.067912460579436,126,1.7E-4
3,test_20231031_155256,10188041.png,221231,9692,211539,0.9561905881183017,3,6,41731,1366,40365,0.9672665404615274,10.568042666666667,1021.7253333333333,18.037461991689202,126,1.7E-4
4,test_20231031_155256,10287332.png,216980,12364,204616,0.943017789658033,2,5,22337,1696,20641,0.9240721672561221,9.497095111111111,790.9076053333333,19.149546091497648,126,1.7E-4
5,test_20231031_155256,11610969.png,368720,25357,343363,0.9312296593621177,4,6,84111,3701,80410,0.9559986208700408,21.3076,2937.504816,13.451017735675183,126,1.7E-4
6,test_20231031_155256,10350842.png,212614,6082,206532,0.9713941697160112,2,5,42529,891,41638,0.9790495896917397,19.26112,2371.9918826666667,14.379671623979055,126,1.7E-4
7,test_20231031_155256,10863862.png,317432,11479,305953,0.9638379243428514,4,5,66058,1667,64391,0.9747646008053529,24.188906666666668,3362.179488,12.864594665868092,126,1.7E-4
8,test_20231031_155256,11382381.png,312486,867,311619,0.9972254757013114,2,5,46745,116,46629,0.9975184511712483,21.130496,2414.0920426666667,14.303265363409706,126,1.7E-4
9,test_20231031_155256,11079715.png,443815,118057,325758,0.733995020447709,5,6,124136,16497,107639,0.8671054327511761,17.022149333333335,2131.304528,14.84434853255526,126,1.7E-4
10,test_20231031_155256,11551286.png,271883,857,271026,0.9968479088431421,2,6,40092,125,39967,0.9968821710066846,17.020656,1715.495408,15.78690800983984,126,1.7E-4
1,test_20231031_155257,10404007.png,502730,20834,481896,0.9585582718357767,3,6,61265,3016,58249,0.9507712396964009,25.686528,3429.773024,12.778149806752824,126,1.8E-4
2,test_20231031_155257,1254659.png,342646,73249,269397,0.7862254338296668,4,6,80080,10244,69836,0.8720779220779221,20.98264711111111,3208.4044853333335,13.067912460579436,126,1.8E-4
3,test_20231031_155257,10188041.png,221231,9692,211539,0.9561905881183017,3,5,41731,1366,40365,0.9672665404615274,10.568042666666667,1021.7253333333333,18.037461991689202,126,1.8E-4
4,test_20231031_155257,10287332.png,216980,12364,204616,0.943017789658033,3,6,22337,1696,20641,0.9240721672561221,9.497095111111111,790.9076053333333,19.149546091497648,126,1.8E-4
5,test_20231031_155257,11610969.png,368720,25357,343363,0.9312296593621177,4,7,84111,3701,80410,0.9559986208700408,21.3076,2937.504816,13.451017735675183,126,1.8E-4
6,test_20231031_155257,10350842.png,212614,6082,206532,0.9713941697160112,2,5,42529,891,41638,0.9790495896917397,19.26112,2371.9918826666667,14.379671623979055,126,1.8E-4
7,test_20231031_155257,10863862.png,317432,11479,305953,0.9638379243428514,3,6,66058,1667,64391,0.9747646008053529,24.188906666666668,3362.179488,12.864594665868092,126,1.8E-4
8,test_20231031_155257,11382381.png,312486,867,311619,0.9972254757013114,2,6,46745,116,46629,0.9975184511712483,21.130496,2414.0920426666667,14.303265363409706,126,1.8E-4
9,test_20231031_155257,11079715.png,443815,118057,325758,0.733995020447709,5,6,124136,16497,107639,0.8671054327511761,17.022149333333335,2131.304528,14.84434853255526,126,1.8E-4
10,test_20231031_155257,11551286.png,271883,857,271026,0.9968479088431421,2,6,40092,125,39967,0.9968821710066846,17.020656,1715.495408,15.78690800983984,126,1.8E-4
1,test_20231031_155258,10404007.png,502730,20834,481896,0.9585582718357767,4,7,61265,3016,58249,0.9507712396964009,25.686528,3429.773024,12.778149806752824,126,1.9E-4
2,test_20231031_155258,1254659.png,342646,73249,269397,0.7862254338296668,5,8,80080,10244,69836,0.8720779220779221,20.98264711111111,3208.4044853333335,13.067912460579436,126,1.9E-4
3,test_20231031_155258,10188041.png,221231,9692,211539,0.9561905881183017,3,6,41731,1366,40365,0.9672665404615274,10.568042666666667,1021.7253333333333,18.037461991689202,126,1.9E-4
4,test_20231031_155258,10287332.png,216980,12364,204616,0.943017789658033,3,6,22337,1696,20641,0.9240721672561221,9.497095111111111,790.9076053333333,19.149546091497648,126,1.9E-4
5,test_20231031_155258,11610969.png,368720,25357,343363,0.9312296593621177,4,6,84111,3701,80410,0.9559986208700408,21.3076,2937.504816,13.451017735675183,126,1.9E-4
6,test_20231031_155258,10350842.png,212614,6082,206532,0.9713941697160112,3,6,42529,891,41638,0.9790495896917397,19.26112,2371.9918826666667,14.379671623979055,126,1.9E-4
7,test_20231031_155258,10863862.png,317432,11479,305953,0.9638379243428514,3,6,66058,1667,64391,0.9747646008053529,24.188906666666668,3362.179488,12.864594665868092,126,1.9E-4
8,test_20231031_155258,11382381.png,312486,867,311619,0.9972254757013114,4,5,46745,116,46629,0.9975184511712483,21.130496,2414.0920426666667,14.303265363409706,126,1.9E-4
9,test_20231031_155258,11079715.png,443815,118057,325758,0.733995020447709,5,6,124136,16497,107639,0.8671054327511761,17.022149333333335,2131.304528,14.84434853255526,126,1.9E-4
10,test_20231031_155258,11551286.png,271883,857,271026,0.9968479088431421,3,5,40092,125,39967,0.9968821710066846,17.020656,1715.495408,15.78690800983984,126,1.9E-4
1,test_20231031_155259,10404007.png,502730,20834,481896,0.9585582718357767,3,7,61265,3016,58249,0.9507712396964009,25.686528,3429.773024,12.778149806752824,126,2.0E-4
2,test_20231031_155259,1254659.png,342646,73249,269397,0.7862254338296668,4,7,80080,10244,69836,0.8720779220779221,20.98264711111111,3208.4044853333335,13.067912460579436,126,2.0E-4
3,test_20231031_155259,10188041.png,221231,9692,211539,0.9561905881183017,3,5,41731,1366,40365,0.9672665404615274,10.568042666666667,1021.7253333333333,18.037461991689202,126,2.0E-4
4,test_20231031_155259,10287332.png,216980,12364,204616,0.943017789658033,2,5,22337,1696,20641,0.9240721672561221,9.497095111111111,790.9076053333333,19.149546091497648,126,2.0E-4
5,test_20231031_155259,11610969.png,368720,25357,343363,0.9312296593621177,4,6,84111,3701,80410,0.9559986208700408,21.3076,2937.504816,13.451017735675183,126,2.0E-4
6,test_20231031_155259,10350842.png,212614,6082,206532,0.9713941697160112,2,5,42529,891,41638,0.9790495896917397,19.26112,2371.9918826666667,14.379671623979055,126,2.0E-4
7,test_20231031_155259,10863862.png,317432,11479,305953,0.9638379243428514,3,6,66058,1667,64391,0.9747646008053529,24.188906666666668,3362.179488,12.864594665868092,126,2.0E-4
8,test_20231031_155259,11382381.png,312486,867,311619,0.9972254757013114,2,5,46745,116,46629,0.9975184511712483,21.130496,2414.0920426666667,14.303265363409706,126,2.0E-4
9,test_20231031_155259,11079715.png,443815,118057,325758,0.733995020447709,5,6,124136,16497,107639,0.8671054327511761,17.022149333333335,2131.304528,14.84434853255526,126,2.0E-4
10,test_20231031_155259,11551286.png,271883,737,271146,0.9972892751661561,2,6,40092,107,39985,0.997331138381722,17.57074488888889,1811.3484693333332,15.5507835243661,126,2.0E-4
1,test_20231031_155300,10404007.png,502730,20834,481896,0.9585582718357767,4,6,61265,3016,58249,0.9507712396964009,25.686528,3429.773024,12.778149806752824,126,2.1E-4
2,test_20231031_155300,1254659.png,342646,73249,269397,0.7862254338296668,5,6,80080,10244,69836,0.8720779220779221,20.98264711111111,3208.4044853333335,13.067912460579436,126,2.1E-4
3,test_20231031_155300,10188041.png,221231,9692,211539,0.9561905881183017,3,6,41731,1366,40365,0.9672665404615274,10.568042666666667,1021.7253333333333,18.037461991689202,126,2.1E-4
4,test_20231031_155300,10287332.png,216980,12364,204616,0.943017789658033,2,6,22337,1696,20641,0.9240721672561221,9.497095111111111,790.9076053333333,19.149546091497648,126,2.1E-4
5,test_20231031_155300,11610969.png,368720,25357,343363,0.9312296593621177,4,7,84111,3701,80410,0.9559986208700408,21.3076,2937.504816,13.451017735675183,126,2.1E-4
6,test_20231031_155300,10350842.png,212614,6082,206532,0.9713941697160112,3,6,42529,891,41638,0.9790495896917397,19.26112,2371.9918826666667,14.379671623979055,126,2.1E-4
7,test_20231031_155300,10863862.png,317432,11479,305953,0.9638379243428514,3,5,66058,1667,64391,0.9747646008053529,24.188906666666668,3362.179488,12.864594665868092,126,2.1E-4
8,test_20231031_155300,11382381.png,312486,867,311619,0.9972254757013114,3,5,46745,116,46629,0.9975184511712483,21.130496,2414.0920426666667,14.303265363409706,126,2.1E-4
9,test_20231031_155300,11079715.png,443815,118057,325758,0.733995020447709,5,6,124136,16497,107639,0.8671054327511761,17.022149333333335,2131.304528,14.84434853255526,126,2.1E-4
10,test_20231031_155300,11551286.png,271883,737,271146,0.9972892751661561,3,5,40092,107,39985,0.997331138381722,17.57074488888889,1811.3484693333332,15.5507835243661,126,2.1E-4
1,test_20231031_155301,10404007.png,502730,20834,481896,0.9585582718357767,4,6,61265,3016,58249,0.9507712396964009,25.686528,3429.773024,12.778149806752824,126,2.2E-4
2,test_20231031_155301,1254659.png,342646,73249,269397,0.7862254338296668,5,7,80080,10244,69836,0.8720779220779221,20.98264711111111,3208.4044853333335,13.067912460579436,126,2.2E-4
3,test_20231031_155301,10188041.png,221231,9692,211539,0.9561905881183017,3,5,41731,1366,40365,0.9672665404615274,10.568042666666667,1021.7253333333333,18.037461991689202,126,2.2E-4
4,test_20231031_155301,10287332.png,216980,12364,204616,0.943017789658033,3,6,22337,1696,20641,0.9240721672561221,9.497095111111111,790.9076053333333,19.149546091497648,126,2.2E-4
5,test_20231031_155301,11610969.png,368720,25357,343363,0.9312296593621177,3,6,84111,3701,80410,0.9559986208700408,21.3076,2937.504816,13.451017735675183,126,2.2E-4
6,test_20231031_155301,10350842.png,212614,6082,206532,0.9713941697160112,2,6,42529,891,41638,0.9790495896917397,19.26112,2371.9918826666667,14.379671623979055,126,2.2E-4
7,test_20231031_155301,10863862.png,317432,11479,305953,0.9638379243428514,3,6,66058,1667,64391,0.9747646008053529,24.188906666666668,3362.179488,12.864594665868092,126,2.2E-4
8,test_20231031_155301,11382381.png,312486,867,311619,0.9972254757013114,2,5,46745,116,46629,0.9975184511712483,21.130496,2414.0920426666667,14.303265363409706,126,2.2E-4
9,test_20231031_155301,11079715.png,443815,118057,325758,0.733995020447709,6,7,124136,16497,107639,0.8671054327511761,17.022149333333335,2131.304528,14.84434853255526,126,2.2E-4
10,test_20231031_155301,11551286.png,271883,737,271146,0.9972892751661561,2,5,40092,107,39985,0.997331138381722,17.57074488888889,1811.3484693333332,15.5507835243661,126,2.2E-4
1,test_20231031_155302,10404007.png,502730,20834,481896,0.9585582718357767,3,5,61265,3016,58249,0.9507712396964009,25.686528,3429.773024,12.778149806752824,126,2.3E-4
2,test_20231031_155302,1254659.png,342646,73249,269397,0.7862254338296668,5,6,80080,10244,69836,0.8720779220779221,20.98264711111111,3208.4044853333335,13.067912460579436,126,2.3E-4
3,test_20231031_155302,10188041.png,221231,9692,211539,0.9561905881183017,3,5,41731,1366,40365,0.9672665404615274,10.568042666666667,1021.7253333333333,18.037461991689202,126,2.3E-4
4,test_20231031_155302,10287332.png,216980,12364,204616,0.943017789658033,2,5,22337,1696,20641,0.9240721672561221,9.497095111111111,790.9076053333333,19.149546091497648,126,2.3E-4
5,test_20231031_155302,11610969.png,368720,25357,343363,0.9312296593621177,4,6,84111,3701,80410,0.9559986208700408,21.3076,2937.504816,13.451017735675183,126,2.3E-4
6,test_20231031_155302,10350842.png,212614,6082,206532,0.9713941697160112,2,6,42529,891,41638,0.9790495896917397,19.26112,2371.9918826666667,14.379671623979055,126,2.3E-4
7,test_20231031_155302,10863862.png,317432,11479,305953,0.9638379243428514,3,6,66058,1667,64391,0.9747646008053529,24.188906666666668,3362.179488,12.864594665868092,126,2.3E-4
8,test_20231031_155302,11382381.png,312486,867,311619,0.9972254757013114,3,6,46745,116,46629,0.9975184511712483,21.130496,2414.0920426666667,14.303265363409706,126,2.3E-4
9,test_20231031_155302,11079715.png,443815,118057,325758,0.733995020447709,5,7,124136,16497,107639,0.8671054327511761,17.022149333333335,2131.304528,14.84434853255526,126,2.3E-4
10,test_20231031_155302,11551286.png,271883,737,271146,0.9972892751661561,2,6,40092,107,39985,0.997331138381722,17.57074488888889,1811.3484693333332,15.5507835243661,126,2.3E-4
1,test_20231031_155303,10404007.png,502730,20834,481896,0.9585582718357767,3,5,61265,3016,58249,0.9507712396964009,25.686528,3429.773024,12.778149806752824,126,2.4E-4
2,test_20231031_155303,1254659.png,342646,73249,269397,0.7862254338296668,4,6,80080,10244,69836,0.8720779220779221,20.98264711111111,3208.4044853333335,13.067912460579436,126,2.4E-4
3,test_20231031_155303,10188041.png,221231,9692,211539,0.9561905881183017,3,6,41731,1366,40365,0.9672665404615274,10.568042666666667,1021.7253333333333,18.037461991689202,126,2.4E-4
4,test_20231031_155303,10287332.png,216980,12364,204616,0.943017789658033,2,6,22337,1696,20641,0.9240721672561221,9.497095111111111,790.9076053333333,19.149546091497648,126,2.4E-4
5,test_20231031_155303,11610969.png,368720,25357,343363,0.9312296593621177,4,6,84111,3701,80410,0.9559986208700408,21.3076,2937.504816,13.451017735675183,126,2.4E-4
6,test_20231031_155303,10350842.png,212614,6082,206532,0.9713941697160112,2,6,42529,891,41638,0.9790495896917397,19.26112,2371.9918826666667,14.379671623979055,126,2.4E-4
7,test_20231031_155303,10863862.png,317432,11479,305953,0.9638379243428514,3,6,66058,1667,64391,0.9747646008053529,24.188906666666668,3362.179488,12.864594665868092,126,2.4E-4
8,test_20231031_155303,11382381.png,312486,867,311619,0.9972254757013114,2,6,46745,116,46629,0.9975184511712483,21.130496,2414.0920426666667,14.303265363409706,126,2.4E-4
9,test_20231031_155303,11079715.png,443815,118057,325758,0.733995020447709,6,7,124136,16497,107639,0.8671054327511761,17.022149333333335,2131.304528,14.84434853255526,126,2.4E-4
10,test_20231031_155303,11551286.png,271883,737,271146,0.9972892751661561,2,6,40092,107,39985,0.997331138381722,17.57074488888889,1811.3484693333332,15.5507835243661,126,2.4E-4
1,test_20231031_155304,10404007.png,502730,20834,481896,0.9585582718357767,4,6,61265,3016,58249,0.9507712396964009,25.686528,3429.773024,12.778149806752824,126,2.5E-4
2,test_20231031_155304,1254659.png,342646,73249,269397,0.7862254338296668,5,6,80080,10244,69836,0.8720779220779221,20.98264711111111,3208.4044853333335,13.067912460579436,126,2.5E-4
3,test_20231031_155304,10188041.png,221231,9692,211539,0.9561905881183017,3,6,41731,1366,40365,0.9672665404615274,10.568042666666667,1021.7253333333333,18.037461991689202,126,2.5E-4
4,test_20231031_155304,10287332.png,216980,12364,204616,0.943017789658033,2,6,22337,1696,20641,0.9240721672561221,9.497095111111111,790.9076053333333,19.149546091497648,126,2.5E-4
5,test_20231031_155304,11610969.png,368720,25357,343363,0.9312296593621177,4,6,84111,3701,80410,0.9559986208700408,21.3076,2937.504816,13.451017735675183,126,2.5E-4
6,test_20231031_155304,10350842.png,212614,6082,206532,0.9713941697160112,2,6,42529,891,41638,0.9790495896917397,19.26112,2371.9918826666667,14.379671623979055,126,2.5E-4
7,test_20231031_155304,10863862.png,317432,11479,305953,0.9638379243428514,13,5,66058,1667,64391,0.9747646008053529,24.188906666666668,3362.179488,12.864594665868092,126,2.5E-4
8,test_20231031_155304,11382381.png,312486,867,311619,0.9972254757013114,2,6,46745,116,46629,0.9975184511712483,21.130496,2414.0920426666667,14.303265363409706,126,2.5E-4
9,test_20231031_155304,11079715.png,443815,118057,325758,0.733995020447709,5,6,124136,16497,107639,0.8671054327511761,17.022149333333335,2131.304528,14.84434853255526,126,2.5E-4
10,test_20231031_155304,11551286.png,271883,737,271146,0.9972892751661561,2,5,40092,107,39985,0.997331138381722,17.57074488888889,1811.3484693333332,15.5507835243661,126,2.5E-4
1,test_20231031_155306,10404007.png,502730,20754,481976,0.9587174029797306,4,6,61265,3004,58261,0.9509671100954868,25.695610666666667,3431.257168,12.776270918184878,126,2.6000000000000003E-4
2,test_20231031_155306,1254659.png,342646,73189,269457,0.7864005416669099,5,6,80080,10238,69842,0.8721528471528471,20.99220088888889,3209.486672,13.066447843337867,126,2.6000000000000003E-4
3,test_20231031_155306,10188041.png,221231,9592,211639,0.9566426043366436,3,6,41731,1351,40380,0.9676259854784213,10.691395555555555,1037.4407253333334,17.971170683956313,126,2.6000000000000003E-4
4,test_20231031_155306,10287332.png,216980,12364,204616,0.943017789658033,2,5,22337,1696,20641,0.9240721672561221,9.497095111111111,790.9076053333333,19.149546091497648,126,2.6000000000000003E-4
5,test_20231031_155306,11610969.png,368720,25037,343683,0.9320975265784335,3,5,84111,3655,80456,0.9565455172331799,21.725516444444445,3023.573904,13.3255977251099,126,2.6000000000000003E-4
6,test_20231031_155306,10350842.png,212614,6002,206612,0.971770438447139,3,5,42529,879,41650,0.9793317500999318,19.329912888888888,2377.7495893333335,14.369142455293513,126,2.6000000000000003E-4
7,test_20231031_155306,10863862.png,317432,11359,306073,0.9642159580634593,3,6,66058,1649,64409,0.9750370886190923,24.240064,3365.490752,12.860319593671788,126,2.6000000000000003E-4
8,test_20231031_155306,11382381.png,312486,747,311739,0.9976094929052821,3,5,46745,98,46647,0.9979035190929512,21.62502222222222,2484.034352,14.179227634129312,126,2.6000000000000003E-4
9,test_20231031_155306,11079715.png,443815,118057,325758,0.733995020447709,6,6,124136,16497,107639,0.8671054327511761,17.022149333333335,2131.304528,14.84434853255526,126,2.6000000000000003E-4
10,test_20231031_155306,11551286.png,271883,737,271146,0.9972892751661561,2,5,40092,107,39985,0.997331138381722,17.57074488888889,1811.3484693333332,15.5507835243661,126,2.6000000000000003E-4
1,test_20231031_155307,10404007.png,502730,20754,481976,0.9587174029797306,4,6,61265,3004,58261,0.9509671100954868,25.695610666666667,3431.257168,12.776270918184878,126,2.7000000000000006E-4
2,test_20231031_155307,1254659.png,342646,73189,269457,0.7864005416669099,5,6,80080,10238,69842,0.8721528471528471,20.99220088888889,3209.486672,13.066447843337867,126,2.7000000000000006E-4
3,test_20231031_155307,10188041.png,221231,9592,211639,0.9566426043366436,3,6,41731,1351,40380,0.9676259854784213,10.691395555555555,1037.4407253333334,17.971170683956313,126,2.7000000000000006E-4
4,test_20231031_155307,10287332.png,216980,12364,204616,0.943017789658033,3,6,22337,1696,20641,0.9240721672561221,9.497095111111111,790.9076053333333,19.149546091497648,126,2.7000000000000006E-4
5,test_20231031_155307,11610969.png,368720,25037,343683,0.9320975265784335,4,6,84111,3655,80456,0.9565455172331799,21.725516444444445,3023.573904,13.3255977251099,126,2.7000000000000006E-4
6,test_20231031_155307,10350842.png,212614,6002,206612,0.971770438447139,2,6,42529,879,41650,0.9793317500999318,19.329912888888888,2377.7495893333335,14.369142455293513,126,2.7000000000000006E-4
7,test_20231031_155307,10863862.png,317432,11359,306073,0.9642159580634593,3,5,66058,1649,64409,0.9750370886190923,24.240064,3365.490752,12.860319593671788,126,2.7000000000000006E-4
8,test_20231031_155307,11382381.png,312486,747,311739,0.9976094929052821,2,6,46745,98,46647,0.9979035190929512,21.62502222222222,2484.034352,14.179227634129312,126,2.7000000000000006E-4
9,test_20231031_155307,11079715.png,443815,118057,325758,0.733995020447709,6,8,124136,16497,107639,0.8671054327511761,17.022149333333335,2131.304528,14.84434853255526,126,2.7000000000000006E-4
10,test_20231031_155307,11551286.png,271883,737,271146,0.9972892751661561,2,5,40092,107,39985,0.997331138381722,17.57074488888889,1811.3484693333332,15.5507835243661,126,2.7000000000000006E-4
1,test_20231031_155308,10404007.png,502730,20754,481976,0.9587174029797306,4,6,61265,3004,58261,0.9509671100954868,25.695610666666667,3431.257168,12.776270918184878,126,2.800000000000001E-4
2,test_20231031_155308,1254659.png,342646,73189,269457,0.7864005416669099,4,6,80080,10238,69842,0.8721528471528471,20.99220088888889,3209.486672,13.066447843337867,126,2.800000000000001E-4
3,test_20231031_155308,10188041.png,221231,9592,211639,0.9566426043366436,3,6,41731,1351,40380,0.9676259854784213,10.691395555555555,1037.4407253333334,17.971170683956313,126,2.800000000000001E-4
4,test_20231031_155308,10287332.png,216980,12364,204616,0.943017789658033,3,6,22337,1696,20641,0.9240721672561221,9.497095111111111,790.9076053333333,19.149546091497648,126,2.800000000000001E-4
5,test_20231031_155308,11610969.png,368720,25037,343683,0.9320975265784335,4,6,84111,3655,80456,0.9565455172331799,21.725516444444445,3023.573904,13.3255977251099,126,2.800000000000001E-4
6,test_20231031_155308,10350842.png,212614,6002,206612,0.971770438447139,2,6,42529,879,41650,0.9793317500999318,19.329912888888888,2377.7495893333335,14.369142455293513,126,2.800000000000001E-4
7,test_20231031_155308,10863862.png,317432,11359,306073,0.9642159580634593,4,5,66058,1649,64409,0.9750370886190923,24.240064,3365.490752,12.860319593671788,126,2.800000000000001E-4
8,test_20231031_155308,11382381.png,312486,747,311739,0.9976094929052821,3,5,46745,98,46647,0.9979035190929512,21.62502222222222,2484.034352,14.179227634129312,126,2.800000000000001E-4
9,test_20231031_155308,11079715.png,443815,118057,325758,0.733995020447709,5,7,124136,16497,107639,0.8671054327511761,17.022149333333335,2131.304528,14.84434853255526,126,2.800000000000001E-4
10,test_20231031_155308,11551286.png,271883,427,271456,0.9984294715006087,2,6,40092,61,40031,0.9984784994512621,17.85376888888889,1855.7630026666666,15.445578486866474,126,2.800000000000001E-4
1,test_20231031_155309,10404007.png,502730,20754,481976,0.9587174029797306,3,5,61265,3004,58261,0.9509671100954868,25.695610666666667,3431.257168,12.776270918184878,126,2.900000000000001E-4
2,test_20231031_155309,1254659.png,342646,73189,269457,0.7864005416669099,5,6,80080,10238,69842,0.8721528471528471,20.99220088888889,3209.486672,13.066447843337867,126,2.900000000000001E-4
3,test_20231031_155309,10188041.png,221231,9592,211639,0.9566426043366436,3,5,41731,1351,40380,0.9676259854784213,10.691395555555555,1037.4407253333334,17.971170683956313,126,2.900000000000001E-4
4,test_20231031_155309,10287332.png,216980,12364,204616,0.943017789658033,3,6,22337,1696,20641,0.9240721672561221,9.497095111111111,790.9076053333333,19.149546091497648,126,2.900000000000001E-4
5,test_20231031_155309,11610969.png,368720,25037,343683,0.9320975265784335,4,6,84111,3655,80456,0.9565455172331799,21.725516444444445,3023.573904,13.3255977251099,126,2.900000000000001E-4
6,test_20231031_155309,10350842.png,212614,6002,206612,0.971770438447139,2,5,42529,879,41650,0.9793317500999318,19.329912888888888,2377.7495893333335,14.369142455293513,126,2.900000000000001E-4
7,test_20231031_155309,10863862.png,317432,11359,306073,0.9642159580634593,3,6,66058,1649,64409,0.9750370886190923,24.240064,3365.490752,12.860319593671788,126,2.900000000000001E-4
8,test_20231031_155309,11382381.png,312486,747,311739,0.9976094929052821,2,8,46745,98,46647,0.9979035190929512,21.62502222222222,2484.034352,14.179227634129312,126,2.900000000000001E-4
9,test_20231031_155309,11079715.png,443815,118057,325758,0.733995020447709,6,7,124136,16497,107639,0.8671054327511761,17.022149333333335,2131.304528,14.84434853255526,126,2.900000000000001E-4
10,test_20231031_155309,11551286.png,271883,427,271456,0.9984294715006087,2,6,40092,61,40031,0.9984784994512621,17.85376888888889,1855.7630026666666,15.445578486866474,126,2.900000000000001E-4
1,test_20231031_155310,10404007.png,502730,19649,483081,0.9609154019055954,4,6,61265,2845,58420,0.9535623928833755,25.79059377777778,3461.428794666667,12.738249587356849,127,1.0E-5
2,test_20231031_155310,1254659.png,342646,71682,270964,0.7907986668456658,5,6,80080,10037,70043,0.8746628371628371,21.233608888888888,3282.5188533333335,12.968731317042248,127,1.0E-5
3,test_20231031_155310,10188041.png,221231,9489,211742,0.9571081810415357,3,6,41731,1337,40394,0.967961467494189,10.60381511111111,1029.055584,18.006415272400552,127,1.0E-5
4,test_20231031_155310,10287332.png,216980,12312,204668,0.9432574430823117,2,5,22337,1688,20649,0.9244303174105744,9.401898666666666,774.2090986666667,19.242220899357278,127,1.0E-5
5,test_20231031_155310,11610969.png,368720,24512,344208,0.9335213712302017,4,6,84111,3579,80532,0.9574490851374968,21.428912,2970.4620213333333,13.402563567661467,127,1.0E-5
6,test_20231031_155310,10350842.png,212614,5842,206772,0.9725229759093945,2,6,42529,859,41670,0.9798020174469185,19.341116444444445,2392.76384,14.341805239536118,127,1.0E-5
7,test_20231031_155310,10863862.png,317432,11017,306415,0.9652933541671918,3,6,66058,1602,64456,0.9757485845771897,24.437365333333332,3426.7552746666665,12.781972709279499,127,1.0E-5
8,test_20231031_155310,11382381.png,312486,967,311519,0.9969054613646692,3,6,46745,132,46613,0.997176168574179,20.34548088888889,2312.227088,14.490498761790324,127,1.0E-5
9,test_20231031_155310,11079715.png,443815,115577,328238,0.7395829343307458,5,7,124136,16143,107993,0.8699571437777921,17.25776711111111,2193.2968,14.719829558750817,127,1.0E-5
10,test_20231031_155310,11551286.png,271883,1039,270844,0.9961785032532376,2,5,40092,152,39940,0.9962087199441285,15.89976888888889,1521.9435626666666,16.30681812820273,127,1.0E-5
1,test_20231031_155311,10404007.png,502730,19649,483081,0.9609154019055954,4,6,61265,2845,58420,0.9535623928833755,25.79059377777778,3461.428794666667,12.738249587356849,127,2.0E-5
2,test_20231031_155311,1254659.png,342646,71682,270964,0.7907986668456658,4,7,80080,10037,70043,0.8746628371628371,21.233608888888888,3282.5188533333335,12.968731317042248,127,2.0E-5
3,test_20231031_155311,10188041.png,221231,9489,211742,0.9571081810415357,3,6,41731,1337,40394,0.967961467494189,10.60381511111111,1029.055584,18.006415272400552,127,2.0E-5
4,test_20231031_155311,10287332.png,216980,12312,204668,0.9432574430823117,3,6,22337,1688,20649,0.9244303174105744,9.401898666666666,774.2090986666667,19.242220899357278,127,2.0E-5
5,test_20231031_155311,11610969.png,368720,24512,344208,0.9335213712302017,4,6,84111,3579,80532,0.9574490851374968,21.428912,2970.4620213333333,13.402563567661467,127,2.0E-5
6,test_20231031_155311,10350842.png,212614,5842,206772,0.9725229759093945,3,6,42529,859,41670,0.9798020174469185,19.341116444444445,2392.76384,14.341805239536118,127,2.0E-5
7,test_20231031_155311,10863862.png,317432,11017,306415,0.9652933541671918,3,6,66058,1602,64456,0.9757485845771897,24.437365333333332,3426.7552746666665,12.781972709279499,127,2.0E-5
8,test_20231031_155311,11382381.png,312486,967,311519,0.9969054613646692,2,6,46745,132,46613,0.997176168574179,20.34548088888889,2312.227088,14.490498761790324,127,2.0E-5
9,test_20231031_155311,11079715.png,443815,115577,328238,0.7395829343307458,5,7,124136,16143,107993,0.8699571437777921,17.25776711111111,2193.2968,14.719829558750817,127,2.0E-5
10,test_20231031_155311,11551286.png,271883,1039,270844,0.9961785032532376,3,6,40092,152,39940,0.9962087199441285,15.89976888888889,1521.9435626666666,16.30681812820273,127,2.0E-5
1,test_20231031_155312,10404007.png,502730,19649,483081,0.9609154019055954,4,6,61265,2845,58420,0.9535623928833755,25.79059377777778,3461.428794666667,12.738249587356849,127,3.0000000000000004E-5
2,test_20231031_155312,1254659.png,342646,71682,270964,0.7907986668456658,5,6,80080,10037,70043,0.8746628371628371,21.233608888888888,3282.5188533333335,12.968731317042248,127,3.0000000000000004E-5
3,test_20231031_155312,10188041.png,221231,9489,211742,0.9571081810415357,3,6,41731,1337,40394,0.967961467494189,10.60381511111111,1029.055584,18.006415272400552,127,3.0000000000000004E-5
4,test_20231031_155312,10287332.png,216980,12312,204668,0.9432574430823117,3,6,22337,1688,20649,0.9244303174105744,9.401898666666666,774.2090986666667,19.242220899357278,127,3.0000000000000004E-5
5,test_20231031_155312,11610969.png,368720,24512,344208,0.9335213712302017,3,5,84111,3579,80532,0.9574490851374968,21.428912,2970.4620213333333,13.402563567661467,127,3.0000000000000004E-5
6,test_20231031_155312,10350842.png,212614,5842,206772,0.9725229759093945,2,6,42529,859,41670,0.9798020174469185,19.341116444444445,2392.76384,14.341805239536118,127,3.0000000000000004E-5
7,test_20231031_155312,10863862.png,317432,11017,306415,0.9652933541671918,4,6,66058,1602,64456,0.9757485845771897,24.437365333333332,3426.7552746666665,12.781972709279499,127,3.0000000000000004E-5
8,test_20231031_155312,11382381.png,312486,967,311519,0.9969054613646692,3,6,46745,132,46613,0.997176168574179,20.34548088888889,2312.227088,14.490498761790324,127,3.0000000000000004E-5
9,test_20231031_155312,11079715.png,443815,115577,328238,0.7395829343307458,5,6,124136,16143,107993,0.8699571437777921,17.25776711111111,2193.2968,14.719829558750817,127,3.0000000000000004E-5
10,test_20231031_155312,11551286.png,271883,1039,270844,0.9961785032532376,3,6,40092,152,39940,0.9962087199441285,15.89976888888889,1521.9435626666666,16.30681812820273,127,3.0000000000000004E-5
1,test_20231031_155313,10404007.png,502730,19649,483081,0.9609154019055954,3,6,61265,2845,58420,0.9535623928833755,25.79059377777778,3461.428794666667,12.738249587356849,127,4.0E-5
2,test_20231031_155313,1254659.png,342646,71682,270964,0.7907986668456658,5,6,80080,10037,70043,0.8746628371628371,21.233608888888888,3282.5188533333335,12.968731317042248,127,4.0E-5
3,test_20231031_155313,10188041.png,221231,9489,211742,0.9571081810415357,3,6,41731,1337,40394,0.967961467494189,10.60381511111111,1029.055584,18.006415272400552,127,4.0E-5
4,test_20231031_155313,10287332.png,216980,12312,204668,0.9432574430823117,2,5,22337,1688,20649,0.9244303174105744,9.401898666666666,774.2090986666667,19.242220899357278,127,4.0E-5
5,test_20231031_155313,11610969.png,368720,24512,344208,0.9335213712302017,4,6,84111,3579,80532,0.9574490851374968,21.428912,2970.4620213333333,13.402563567661467,127,4.0E-5
6,test_20231031_155313,10350842.png,212614,5842,206772,0.9725229759093945,2,6,42529,859,41670,0.9798020174469185,19.341116444444445,2392.76384,14.341805239536118,127,4.0E-5
7,test_20231031_155313,10863862.png,317432,11017,306415,0.9652933541671918,3,5,66058,1602,64456,0.9757485845771897,24.437365333333332,3426.7552746666665,12.781972709279499,127,4.0E-5
8,test_20231031_155313,11382381.png,312486,967,311519,0.9969054613646692,2,5,46745,132,46613,0.997176168574179,20.34548088888889,2312.227088,14.490498761790324,127,4.0E-5
9,test_20231031_155313,11079715.png,443815,115577,328238,0.7395829343307458,5,7,124136,16143,107993,0.8699571437777921,17.25776711111111,2193.2968,14.719829558750817,127,4.0E-5
10,test_20231031_155313,11551286.png,271883,1039,270844,0.9961785032532376,2,5,40092,152,39940,0.9962087199441285,15.89976888888889,1521.9435626666666,16.30681812820273,127,4.0E-5
1,test_20231031_155314,10404007.png,502730,19649,483081,0.9609154019055954,3,5,61265,2845,58420,0.9535623928833755,25.79059377777778,3461.428794666667,12.738249587356849,127,5.0E-5
2,test_20231031_155314,1254659.png,342646,71682,270964,0.7907986668456658,5,6,80080,10037,70043,0.8746628371628371,21.233608888888888,3282.5188533333335,12.968731317042248,127,5.0E-5
3,test_20231031_155314,10188041.png,221231,9489,211742,0.9571081810415357,7,6,41731,1337,40394,0.967961467494189,10.60381511111111,1029.055584,18.006415272400552,127,5.0E-5
4,test_20231031_155314,10287332.png,216980,12312,204668,0.9432574430823117,3,5,22337,1688,20649,0.9244303174105744,9.401898666666666,774.2090986666667,19.242220899357278,127,5.0E-5
5,test_20231031_155314,11610969.png,368720,24512,344208,0.9335213712302017,4,11,84111,3579,80532,0.9574490851374968,21.428912,2970.4620213333333,13.402563567661467,127,5.0E-5
6,test_20231031_155314,10350842.png,212614,5842,206772,0.9725229759093945,2,6,42529,859,41670,0.9798020174469185,19.341116444444445,2392.76384,14.341805239536118,127,5.0E-5
7,test_20231031_155314,10863862.png,317432,11017,306415,0.9652933541671918,3,6,66058,1602,64456,0.9757485845771897,24.437365333333332,3426.7552746666665,12.781972709279499,127,5.0E-5
8,test_20231031_155314,11382381.png,312486,957,311529,0.9969374627983334,2,5,46745,131,46614,0.9971975612364958,21.075297777777777,2410.7878986666665,14.309213580767988,127,5.0E-5
9,test_20231031_155314,11079715.png,443815,115577,328238,0.7395829343307458,5,6,124136,16143,107993,0.8699571437777921,17.25776711111111,2193.2968,14.719829558750817,127,5.0E-5
10,test_20231031_155314,11551286.png,271883,1039,270844,0.9961785032532376,3,6,40092,152,39940,0.9962087199441285,15.89976888888889,1521.9435626666666,16.30681812820273,127,5.0E-5
1,test_20231031_155315,10404007.png,502730,19649,483081,0.9609154019055954,4,6,61265,2845,58420,0.9535623928833755,25.79059377777778,3461.428794666667,12.738249587356849,127,6.0E-5
2,test_20231031_155315,1254659.png,342646,71682,270964,0.7907986668456658,4,7,80080,10037,70043,0.8746628371628371,21.233608888888888,3282.5188533333335,12.968731317042248,127,6.0E-5
3,test_20231031_155315,10188041.png,221231,9489,211742,0.9571081810415357,4,6,41731,1337,40394,0.967961467494189,10.60381511111111,1029.055584,18.006415272400552,127,6.0E-5
4,test_20231031_155315,10287332.png,216980,12312,204668,0.9432574430823117,3,6,22337,1688,20649,0.9244303174105744,9.401898666666666,774.2090986666667,19.242220899357278,127,6.0E-5
5,test_20231031_155315,11610969.png,368720,24512,344208,0.9335213712302017,3,5,84111,3579,80532,0.9574490851374968,21.428912,2970.4620213333333,13.402563567661467,127,6.0E-5
6,test_20231031_155315,10350842.png,212614,5842,206772,0.9725229759093945,2,5,42529,859,41670,0.9798020174469185,19.341116444444445,2392.76384,14.341805239536118,127,6.0E-5
7,test_20231031_155315,10863862.png,317432,11017,306415,0.9652933541671918,3,5,66058,1602,64456,0.9757485845771897,24.437365333333332,3426.7552746666665,12.781972709279499,127,6.0E-5
8,test_20231031_155315,11382381.png,312486,957,311529,0.9969374627983334,3,6,46745,131,46614,0.9971975612364958,21.075297777777777,2410.7878986666665,14.309213580767988,127,6.0E-5
9,test_20231031_155315,11079715.png,443815,115577,328238,0.7395829343307458,5,7,124136,16143,107993,0.8699571437777921,17.25776711111111,2193.2968,14.719829558750817,127,6.0E-5
10,test_20231031_155315,11551286.png,271883,1039,270844,0.9961785032532376,2,5,40092,152,39940,0.9962087199441285,15.89976888888889,1521.9435626666666,16.30681812820273,127,6.0E-5
1,test_20231031_155316,10404007.png,502730,19649,483081,0.9609154019055954,4,6,61265,2845,58420,0.9535623928833755,25.79059377777778,3461.428794666667,12.738249587356849,127,7.000000000000001E-5
2,test_20231031_155316,1254659.png,342646,71682,270964,0.7907986668456658,4,6,80080,10037,70043,0.8746628371628371,21.233608888888888,3282.5188533333335,12.968731317042248,127,7.000000000000001E-5
3,test_20231031_155316,10188041.png,221231,9489,211742,0.9571081810415357,3,6,41731,1337,40394,0.967961467494189,10.60381511111111,1029.055584,18.006415272400552,127,7.000000000000001E-5
4,test_20231031_155316,10287332.png,216980,12312,204668,0.9432574430823117,3,6,22337,1688,20649,0.9244303174105744,9.401898666666666,774.2090986666667,19.242220899357278,127,7.000000000000001E-5
5,test_20231031_155316,11610969.png,368720,24512,344208,0.9335213712302017,4,6,84111,3579,80532,0.9574490851374968,21.428912,2970.4620213333333,13.402563567661467,127,7.000000000000001E-5
6,test_20231031_155316,10350842.png,212614,5842,206772,0.9725229759093945,2,5,42529,859,41670,0.9798020174469185,19.341116444444445,2392.76384,14.341805239536118,127,7.000000000000001E-5
7,test_20231031_155316,10863862.png,317432,11017,306415,0.9652933541671918,3,6,66058,1602,64456,0.9757485845771897,24.437365333333332,3426.7552746666665,12.781972709279499,127,7.000000000000001E-5
8,test_20231031_155316,11382381.png,312486,957,311529,0.9969374627983334,3,6,46745,131,46614,0.9971975612364958,21.075297777777777,2410.7878986666665,14.309213580767988,127,7.000000000000001E-5
9,test_20231031_155316,11079715.png,443815,115577,328238,0.7395829343307458,6,7,124136,16143,107993,0.8699571437777921,17.25776711111111,2193.2968,14.719829558750817,127,7.000000000000001E-5
10,test_20231031_155316,11551286.png,271883,917,270966,0.9966272256816351,2,6,40092,134,39958,0.9966576873191659,15.986103111111111,1528.055536,16.289412222433906,127,7.000000000000001E-5
1,test_20231031_155317,10404007.png,502730,19649,483081,0.9609154019055954,4,6,61265,2845,58420,0.9535623928833755,25.79059377777778,3461.428794666667,12.738249587356849,127,8.0E-5
2,test_20231031_155317,1254659.png,342646,71682,270964,0.7907986668456658,5,6,80080,10037,70043,0.8746628371628371,21.233608888888888,3282.5188533333335,12.968731317042248,127,8.0E-5
3,test_20231031_155317,10188041.png,221231,9489,211742,0.9571081810415357,3,5,41731,1337,40394,0.967961467494189,10.60381511111111,1029.055584,18.006415272400552,127,8.0E-5
4,test_20231031_155317,10287332.png,216980,12312,204668,0.9432574430823117,2,5,22337,1688,20649,0.9244303174105744,9.401898666666666,774.2090986666667,19.242220899357278,127,8.0E-5
5,test_20231031_155317,11610969.png,368720,24512,344208,0.9335213712302017,4,6,84111,3579,80532,0.9574490851374968,21.428912,2970.4620213333333,13.402563567661467,127,8.0E-5
6,test_20231031_155317,10350842.png,212614,5842,206772,0.9725229759093945,2,6,42529,859,41670,0.9798020174469185,19.341116444444445,2392.76384,14.341805239536118,127,8.0E-5
7,test_20231031_155317,10863862.png,317432,11017,306415,0.9652933541671918,3,11,66058,1602,64456,0.9757485845771897,24.437365333333332,3426.7552746666665,12.781972709279499,127,8.0E-5
8,test_20231031_155317,11382381.png,312486,957,311529,0.9969374627983334,2,5,46745,131,46614,0.9971975612364958,21.075297777777777,2410.7878986666665,14.309213580767988,127,8.0E-5
9,test_20231031_155317,11079715.png,443815,115577,328238,0.7395829343307458,6,7,124136,16143,107993,0.8699571437777921,17.25776711111111,2193.2968,14.719829558750817,127,8.0E-5
10,test_20231031_155317,11551286.png,271883,917,270966,0.9966272256816351,2,14,40092,134,39958,0.9966576873191659,15.986103111111111,1528.055536,16.289412222433906,127,8.0E-5
1,test_20231031_155318,10404007.png,502730,19649,483081,0.9609154019055954,4,6,61265,2845,58420,0.9535623928833755,25.79059377777778,3461.428794666667,12.738249587356849,127,9.0E-5
2,test_20231031_155318,1254659.png,342646,71682,270964,0.7907986668456658,5,6,80080,10037,70043,0.8746628371628371,21.233608888888888,3282.5188533333335,12.968731317042248,127,9.0E-5
3,test_20231031_155318,10188041.png,221231,9489,211742,0.9571081810415357,3,5,41731,1337,40394,0.967961467494189,10.60381511111111,1029.055584,18.006415272400552,127,9.0E-5
4,test_20231031_155318,10287332.png,216980,12312,204668,0.9432574430823117,3,6,22337,1688,20649,0.9244303174105744,9.401898666666666,774.2090986666667,19.242220899357278,127,9.0E-5
5,test_20231031_155318,11610969.png,368720,24512,344208,0.9335213712302017,4,6,84111,3579,80532,0.9574490851374968,21.428912,2970.4620213333333,13.402563567661467,127,9.0E-5
6,test_20231031_155318,10350842.png,212614,5842,206772,0.9725229759093945,2,5,42529,859,41670,0.9798020174469185,19.341116444444445,2392.76384,14.341805239536118,127,9.0E-5
7,test_20231031_155318,10863862.png,317432,11017,306415,0.9652933541671918,4,6,66058,1602,64456,0.9757485845771897,24.437365333333332,3426.7552746666665,12.781972709279499,127,9.0E-5
8,test_20231031_155318,11382381.png,312486,957,311529,0.9969374627983334,3,5,46745,131,46614,0.9971975612364958,21.075297777777777,2410.7878986666665,14.309213580767988,127,9.0E-5
9,test_20231031_155318,11079715.png,443815,115577,328238,0.7395829343307458,5,7,124136,16143,107993,0.8699571437777921,17.25776711111111,2193.2968,14.719829558750817,127,9.0E-5
10,test_20231031_155318,11551286.png,271883,917,270966,0.9966272256816351,2,5,40092,134,39958,0.9966576873191659,15.986103111111111,1528.055536,16.289412222433906,127,9.0E-5
1,test_20231031_155319,10404007.png,502730,19649,483081,0.9609154019055954,4,6,61265,2845,58420,0.9535623928833755,25.79059377777778,3461.428794666667,12.738249587356849,127,1.0E-4
2,test_20231031_155319,1254659.png,342646,71682,270964,0.7907986668456658,4,7,80080,10037,70043,0.8746628371628371,21.233608888888888,3282.5188533333335,12.968731317042248,127,1.0E-4
3,test_20231031_155319,10188041.png,221231,9489,211742,0.9571081810415357,3,5,41731,1337,40394,0.967961467494189,10.60381511111111,1029.055584,18.006415272400552,127,1.0E-4
4,test_20231031_155319,10287332.png,216980,12312,204668,0.9432574430823117,2,5,22337,1688,20649,0.9244303174105744,9.401898666666666,774.2090986666667,19.242220899357278,127,1.0E-4
5,test_20231031_155319,11610969.png,368720,24512,344208,0.9335213712302017,4,6,84111,3579,80532,0.9574490851374968,21.428912,2970.4620213333333,13.402563567661467,127,1.0E-4
6,test_20231031_155319,10350842.png,212614,5842,206772,0.9725229759093945,2,5,42529,859,41670,0.9798020174469185,19.341116444444445,2392.76384,14.341805239536118,127,1.0E-4
7,test_20231031_155319,10863862.png,317432,11017,306415,0.9652933541671918,3,5,66058,1602,64456,0.9757485845771897,24.437365333333332,3426.7552746666665,12.781972709279499,127,1.0E-4
8,test_20231031_155319,11382381.png,312486,957,311529,0.9969374627983334,2,5,46745,131,46614,0.9971975612364958,21.075297777777777,2410.7878986666665,14.309213580767988,127,1.0E-4
9,test_20231031_155319,11079715.png,443815,115577,328238,0.7395829343307458,10,6,124136,16143,107993,0.8699571437777921,17.25776711111111,2193.2968,14.719829558750817,127,1.0E-4
10,test_20231031_155319,11551286.png,271883,917,270966,0.9966272256816351,2,6,40092,134,39958,0.9966576873191659,15.986103111111111,1528.055536,16.289412222433906,127,1.0E-4
1,test_20231031_155320,10404007.png,502730,19649,483081,0.9609154019055954,4,6,61265,2845,58420,0.9535623928833755,25.79059377777778,3461.428794666667,12.738249587356849,127,1.1E-4
2,test_20231031_155320,1254659.png,342646,71682,270964,0.7907986668456658,4,6,80080,10037,70043,0.8746628371628371,21.233608888888888,3282.5188533333335,12.968731317042248,127,1.1E-4
3,test_20231031_155320,10188041.png,221231,9489,211742,0.9571081810415357,4,6,41731,1337,40394,0.967961467494189,10.60381511111111,1029.055584,18.006415272400552,127,1.1E-4
4,test_20231031_155320,10287332.png,216980,12312,204668,0.9432574430823117,3,5,22337,1688,20649,0.9244303174105744,9.401898666666666,774.2090986666667,19.242220899357278,127,1.1E-4
5,test_20231031_155320,11610969.png,368720,24512,344208,0.9335213712302017,3,5,84111,3579,80532,0.9574490851374968,21.428912,2970.4620213333333,13.402563567661467,127,1.1E-4
6,test_20231031_155320,10350842.png,212614,5842,206772,0.9725229759093945,3,6,42529,859,41670,0.9798020174469185,19.341116444444445,2392.76384,14.341805239536118,127,1.1E-4
7,test_20231031_155320,10863862.png,317432,11017,306415,0.9652933541671918,4,6,66058,1602,64456,0.9757485845771897,24.437365333333332,3426.7552746666665,12.781972709279499,127,1.1E-4
8,test_20231031_155320,11382381.png,312486,957,311529,0.9969374627983334,3,5,46745,131,46614,0.9971975612364958,21.075297777777777,2410.7878986666665,14.309213580767988,127,1.1E-4
9,test_20231031_155320,11079715.png,443815,115577,328238,0.7395829343307458,5,7,124136,16143,107993,0.8699571437777921,17.25776711111111,2193.2968,14.719829558750817,127,1.1E-4
10,test_20231031_155320,11551286.png,271883,917,270966,0.9966272256816351,2,6,40092,134,39958,0.9966576873191659,15.986103111111111,1528.055536,16.289412222433906,127,1.1E-4
1,test_20231031_155321,10404007.png,502730,19649,483081,0.9609154019055954,4,6,61265,2845,58420,0.9535623928833755,25.79059377777778,3461.428794666667,12.738249587356849,127,1.2E-4
2,test_20231031_155321,1254659.png,342646,71682,270964,0.7907986668456658,4,6,80080,10037,70043,0.8746628371628371,21.233608888888888,3282.5188533333335,12.968731317042248,127,1.2E-4
3,test_20231031_155321,10188041.png,221231,9489,211742,0.9571081810415357,3,6,41731,1337,40394,0.967961467494189,10.60381511111111,1029.055584,18.006415272400552,127,1.2E-4
4,test_20231031_155321,10287332.png,216980,12312,204668,0.9432574430823117,3,6,22337,1688,20649,0.9244303174105744,9.401898666666666,774.2090986666667,19.242220899357278,127,1.2E-4
5,test_20231031_155321,11610969.png,368720,24512,344208,0.9335213712302017,3,5,84111,3579,80532,0.9574490851374968,21.428912,2970.4620213333333,13.402563567661467,127,1.2E-4
6,test_20231031_155321,10350842.png,212614,5842,206772,0.9725229759093945,2,5,42529,859,41670,0.9798020174469185,19.341116444444445,2392.76384,14.341805239536118,127,1.2E-4
7,test_20231031_155321,10863862.png,317432,11017,306415,0.9652933541671918,3,5,66058,1602,64456,0.9757485845771897,24.437365333333332,3426.7552746666665,12.781972709279499,127,1.2E-4
8,test_20231031_155321,11382381.png,312486,957,311529,0.9969374627983334,3,5,46745,131,46614,0.9971975612364958,21.075297777777777,2410.7878986666665,14.309213580767988,127,1.2E-4
9,test_20231031_155321,11079715.png,443815,115577,328238,0.7395829343307458,5,6,124136,16143,107993,0.8699571437777921,17.25776711111111,2193.2968,14.719829558750817,127,1.2E-4
10,test_20231031_155321,11551286.png,271883,917,270966,0.9966272256816351,2,5,40092,134,39958,0.9966576873191659,15.986103111111111,1528.055536,16.289412222433906,127,1.2E-4
1,test_20231031_155322,10404007.png,502730,19649,483081,0.9609154019055954,4,6,61265,2845,58420,0.9535623928833755,25.79059377777778,3461.428794666667,12.738249587356849,127,1.3000000000000002E-4
2,test_20231031_155322,1254659.png,342646,71682,270964,0.7907986668456658,5,18,80080,10037,70043,0.8746628371628371,21.233608888888888,3282.5188533333335,12.968731317042248,127,1.3000000000000002E-4
3,test_20231031_155322,10188041.png,221231,9489,211742,0.9571081810415357,3,6,41731,1337,40394,0.967961467494189,10.60381511111111,1029.055584,18.006415272400552,127,1.3000000000000002E-4
4,test_20231031_155322,10287332.png,216980,12312,204668,0.9432574430823117,3,6,22337,1688,20649,0.9244303174105744,9.401898666666666,774.2090986666667,19.242220899357278,127,1.3000000000000002E-4
5,test_20231031_155322,11610969.png,368720,24512,344208,0.9335213712302017,3,5,84111,3579,80532,0.9574490851374968,21.428912,2970.4620213333333,13.402563567661467,127,1.3000000000000002E-4
6,test_20231031_155322,10350842.png,212614,5842,206772,0.9725229759093945,2,6,42529,859,41670,0.9798020174469185,19.341116444444445,2392.76384,14.341805239536118,127,1.3000000000000002E-4
7,test_20231031_155322,10863862.png,317432,11017,306415,0.9652933541671918,4,5,66058,1602,64456,0.9757485845771897,24.437365333333332,3426.7552746666665,12.781972709279499,127,1.3000000000000002E-4
8,test_20231031_155322,11382381.png,312486,957,311529,0.9969374627983334,3,6,46745,131,46614,0.9971975612364958,21.075297777777777,2410.7878986666665,14.309213580767988,127,1.3000000000000002E-4
9,test_20231031_155322,11079715.png,443815,115577,328238,0.7395829343307458,5,6,124136,16143,107993,0.8699571437777921,17.25776711111111,2193.2968,14.719829558750817,127,1.3000000000000002E-4
10,test_20231031_155322,11551286.png,271883,817,271066,0.9969950309508134,2,6,40092,119,39973,0.9970318267983638,17.022202666666665,1715.7899786666667,15.786162339334698,127,1.3000000000000002E-4
1,test_20231031_155323,10404007.png,502730,19649,483081,0.9609154019055954,4,6,61265,2845,58420,0.9535623928833755,25.79059377777778,3461.428794666667,12.738249587356849,127,1.4000000000000001E-4
2,test_20231031_155323,1254659.png,342646,71682,270964,0.7907986668456658,4,6,80080,10037,70043,0.8746628371628371,21.233608888888888,3282.5188533333335,12.968731317042248,127,1.4000000000000001E-4
3,test_20231031_155323,10188041.png,221231,9489,211742,0.9571081810415357,3,5,41731,1337,40394,0.967961467494189,10.60381511111111,1029.055584,18.006415272400552,127,1.4000000000000001E-4
4,test_20231031_155323,10287332.png,216980,12312,204668,0.9432574430823117,3,6,22337,1688,20649,0.9244303174105744,9.401898666666666,774.2090986666667,19.242220899357278,127,1.4000000000000001E-4
5,test_20231031_155323,11610969.png,368720,24512,344208,0.9335213712302017,3,6,84111,3579,80532,0.9574490851374968,21.428912,2970.4620213333333,13.402563567661467,127,1.4000000000000001E-4
6,test_20231031_155323,10350842.png,212614,5842,206772,0.9725229759093945,2,5,42529,859,41670,0.9798020174469185,19.341116444444445,2392.76384,14.341805239536118,127,1.4000000000000001E-4
7,test_20231031_155323,10863862.png,317432,11017,306415,0.9652933541671918,3,5,66058,1602,64456,0.9757485845771897,24.437365333333332,3426.7552746666665,12.781972709279499,127,1.4000000000000001E-4
8,test_20231031_155323,11382381.png,312486,957,311529,0.9969374627983334,2,5,46745,131,46614,0.9971975612364958,21.075297777777777,2410.7878986666665,14.309213580767988,127,1.4000000000000001E-4
9,test_20231031_155323,11079715.png,443815,115577,328238,0.7395829343307458,5,7,124136,16143,107993,0.8699571437777921,17.25776711111111,2193.2968,14.719829558750817,127,1.4000000000000001E-4
10,test_20231031_155323,11551286.png,271883,817,271066,0.9969950309508134,2,13,40092,119,39973,0.9970318267983638,17.022202666666665,1715.7899786666667,15.786162339334698,127,1.4000000000000001E-4
1,test_20231031_155324,10404007.png,502730,19649,483081,0.9609154019055954,4,6,61265,2845,58420,0.9535623928833755,25.79059377777778,3461.428794666667,12.738249587356849,127,1.5000000000000001E-4
2,test_20231031_155324,1254659.png,342646,71682,270964,0.7907986668456658,4,7,80080,10037,70043,0.8746628371628371,21.233608888888888,3282.5188533333335,12.968731317042248,127,1.5000000000000001E-4
3,test_20231031_155324,10188041.png,221231,9489,211742,0.9571081810415357,3,10,41731,1337,40394,0.967961467494189,10.60381511111111,1029.055584,18.006415272400552,127,1.5000000000000001E-4
4,test_20231031_155324,10287332.png,216980,12312,204668,0.9432574430823117,2,6,22337,1688,20649,0.9244303174105744,9.401898666666666,774.2090986666667,19.242220899357278,127,1.5000000000000001E-4
5,test_20231031_155324,11610969.png,368720,24512,344208,0.9335213712302017,3,6,84111,3579,80532,0.9574490851374968,21.428912,2970.4620213333333,13.402563567661467,127,1.5000000000000001E-4
6,test_20231031_155324,10350842.png,212614,5842,206772,0.9725229759093945,3,5,42529,859,41670,0.9798020174469185,19.341116444444445,2392.76384,14.341805239536118,127,1.5000000000000001E-4
7,test_20231031_155324,10863862.png,317432,11017,306415,0.9652933541671918,4,6,66058,1602,64456,0.9757485845771897,24.437365333333332,3426.7552746666665,12.781972709279499,127,1.5000000000000001E-4
8,test_20231031_155324,11382381.png,312486,827,311659,0.9973534814359684,2,6,46745,112,46633,0.9976040218205156,21.333713777777778,2451.331146666667,14.236783774592807,127,1.5000000000000001E-4
9,test_20231031_155324,11079715.png,443815,115577,328238,0.7395829343307458,5,7,124136,16143,107993,0.8699571437777921,17.25776711111111,2193.2968,14.719829558750817,127,1.5000000000000001E-4
10,test_20231031_155324,11551286.png,271883,817,271066,0.9969950309508134,2,5,40092,119,39973,0.9970318267983638,17.022202666666665,1715.7899786666667,15.786162339334698,127,1.5000000000000001E-4
1,test_20231031_155325,10404007.png,502730,19649,483081,0.9609154019055954,4,6,61265,2845,58420,0.9535623928833755,25.79059377777778,3461.428794666667,12.738249587356849,127,1.6E-4
2,test_20231031_155325,1254659.png,342646,71682,270964,0.7907986668456658,4,7,80080,10037,70043,0.8746628371628371,21.233608888888888,3282.5188533333335,12.968731317042248,127,1.6E-4
3,test_20231031_155325,10188041.png,221231,9489,211742,0.9571081810415357,3,7,41731,1337,40394,0.967961467494189,10.60381511111111,1029.055584,18.006415272400552,127,1.6E-4
4,test_20231031_155325,10287332.png,216980,12102,204878,0.944225274218822,3,6,22337,1661,20676,0.9256390741818508,9.531660444444444,800.9398453333333,19.09480461289071,127,1.6E-4
5,test_20231031_155325,11610969.png,368720,24512,344208,0.9335213712302017,4,6,84111,3579,80532,0.9574490851374968,21.428912,2970.4620213333333,13.402563567661467,127,1.6E-4
6,test_20231031_155325,10350842.png,212614,5842,206772,0.9725229759093945,2,5,42529,859,41670,0.9798020174469185,19.341116444444445,2392.76384,14.341805239536118,127,1.6E-4
7,test_20231031_155325,10863862.png,317432,11017,306415,0.9652933541671918,3,5,66058,1602,64456,0.9757485845771897,24.437365333333332,3426.7552746666665,12.781972709279499,127,1.6E-4
8,test_20231031_155325,11382381.png,312486,827,311659,0.9973534814359684,2,5,46745,112,46633,0.9976040218205156,21.333713777777778,2451.331146666667,14.236783774592807,127,1.6E-4
9,test_20231031_155325,11079715.png,443815,115577,328238,0.7395829343307458,5,7,124136,16143,107993,0.8699571437777921,17.25776711111111,2193.2968,14.719829558750817,127,1.6E-4
10,test_20231031_155325,11551286.png,271883,817,271066,0.9969950309508134,4,5,40092,119,39973,0.9970318267983638,17.022202666666665,1715.7899786666667,15.786162339334698,127,1.6E-4
1,test_20231031_155326,10404007.png,502730,19649,483081,0.9609154019055954,4,5,61265,2845,58420,0.9535623928833755,25.79059377777778,3461.428794666667,12.738249587356849,127,1.7E-4
2,test_20231031_155326,1254659.png,342646,71682,270964,0.7907986668456658,4,7,80080,10037,70043,0.8746628371628371,21.233608888888888,3282.5188533333335,12.968731317042248,127,1.7E-4
3,test_20231031_155326,10188041.png,221231,9489,211742,0.9571081810415357,3,6,41731,1337,40394,0.967961467494189,10.60381511111111,1029.055584,18.006415272400552,127,1.7E-4
4,test_20231031_155326,10287332.png,216980,12102,204878,0.944225274218822,3,6,22337,1661,20676,0.9256390741818508,9.531660444444444,800.9398453333333,19.09480461289071,127,1.7E-4
5,test_20231031_155326,11610969.png,368720,24512,344208,0.9335213712302017,4,6,84111,3579,80532,0.9574490851374968,21.428912,2970.4620213333333,13.402563567661467,127,1.7E-4
6,test_20231031_155326,10350842.png,212614,5842,206772,0.9725229759093945,2,5,42529,859,41670,0.9798020174469185,19.341116444444445,2392.76384,14.341805239536118,127,1.7E-4
7,test_20231031_155326,10863862.png,317432,11017,306415,0.9652933541671918,3,6,66058,1602,64456,0.9757485845771897,24.437365333333332,3426.7552746666665,12.781972709279499,127,1.7E-4
8,test_20231031_155326,11382381.png,312486,827,311659,0.9973534814359684,2,6,46745,112,46633,0.9976040218205156,21.333713777777778,2451.331146666667,14.236783774592807,127,1.7E-4
9,test_20231031_155326,11079715.png,443815,115577,328238,0.7395829343307458,5,6,124136,16143,107993,0.8699571437777921,17.25776711111111,2193.2968,14.719829558750817,127,1.7E-4
10,test_20231031_155326,11551286.png,271883,817,271066,0.9969950309508134,3,5,40092,119,39973,0.9970318267983638,17.022202666666665,1715.7899786666667,15.786162339334698,127,1.7E-4
1,test_20231031_155327,10404007.png,502730,19649,483081,0.9609154019055954,4,6,61265,2845,58420,0.9535623928833755,25.79059377777778,3461.428794666667,12.738249587356849,127,1.8E-4
2,test_20231031_155327,1254659.png,342646,71682,270964,0.7907986668456658,4,7,80080,10037,70043,0.8746628371628371,21.233608888888888,3282.5188533333335,12.968731317042248,127,1.8E-4
3,test_20231031_155327,10188041.png,221231,9489,211742,0.9571081810415357,3,6,41731,1337,40394,0.967961467494189,10.60381511111111,1029.055584,18.006415272400552,127,1.8E-4
4,test_20231031_155327,10287332.png,216980,12102,204878,0.944225274218822,3,6,22337,1661,20676,0.9256390741818508,9.531660444444444,800.9398453333333,19.09480461289071,127,1.8E-4
5,test_20231031_155327,11610969.png,368720,24512,344208,0.9335213712302017,3,5,84111,3579,80532,0.9574490851374968,21.428912,2970.4620213333333,13.402563567661467,127,1.8E-4
6,test_20231031_155327,10350842.png,212614,5842,206772,0.9725229759093945,3,6,42529,859,41670,0.9798020174469185,19.341116444444445,2392.76384,14.341805239536118,127,1.8E-4
7,test_20231031_155327,10863862.png,317432,11017,306415,0.9652933541671918,4,6,66058,1602,64456,0.9757485845771897,24.437365333333332,3426.7552746666665,12.781972709279499,127,1.8E-4
8,test_20231031_155327,11382381.png,312486,827,311659,0.9973534814359684,3,5,46745,112,46633,0.9976040218205156,21.333713777777778,2451.331146666667,14.236783774592807,127,1.8E-4
9,test_20231031_155327,11079715.png,443815,115577,328238,0.7395829343307458,5,7,124136,16143,107993,0.8699571437777921,17.25776711111111,2193.2968,14.719829558750817,127,1.8E-4
10,test_20231031_155327,11551286.png,271883,817,271066,0.9969950309508134,2,5,40092,119,39973,0.9970318267983638,17.022202666666665,1715.7899786666667,15.786162339334698,127,1.8E-4
1,test_20231031_155328,10404007.png,502730,19649,483081,0.9609154019055954,4,6,61265,2845,58420,0.9535623928833755,25.79059377777778,3461.428794666667,12.738249587356849,127,1.9E-4
2,test_20231031_155328,1254659.png,342646,71682,270964,0.7907986668456658,5,7,80080,10037,70043,0.8746628371628371,21.233608888888888,3282.5188533333335,12.968731317042248,127,1.9E-4
3,test_20231031_155328,10188041.png,221231,9489,211742,0.9571081810415357,3,13,41731,1337,40394,0.967961467494189,10.60381511111111,1029.055584,18.006415272400552,127,1.9E-4
4,test_20231031_155328,10287332.png,216980,12102,204878,0.944225274218822,2,6,22337,1661,20676,0.9256390741818508,9.531660444444444,800.9398453333333,19.09480461289071,127,1.9E-4
5,test_20231031_155328,11610969.png,368720,24512,344208,0.9335213712302017,3,5,84111,3579,80532,0.9574490851374968,21.428912,2970.4620213333333,13.402563567661467,127,1.9E-4
6,test_20231031_155328,10350842.png,212614,5842,206772,0.9725229759093945,2,5,42529,859,41670,0.9798020174469185,19.341116444444445,2392.76384,14.341805239536118,127,1.9E-4
7,test_20231031_155328,10863862.png,317432,11017,306415,0.9652933541671918,3,6,66058,1602,64456,0.9757485845771897,24.437365333333332,3426.7552746666665,12.781972709279499,127,1.9E-4
8,test_20231031_155328,11382381.png,312486,827,311659,0.9973534814359684,3,6,46745,112,46633,0.9976040218205156,21.333713777777778,2451.331146666667,14.236783774592807,127,1.9E-4
9,test_20231031_155328,11079715.png,443815,115577,328238,0.7395829343307458,5,7,124136,16143,107993,0.8699571437777921,17.25776711111111,2193.2968,14.719829558750817,127,1.9E-4
10,test_20231031_155328,11551286.png,271883,817,271066,0.9969950309508134,2,11,40092,119,39973,0.9970318267983638,17.022202666666665,1715.7899786666667,15.786162339334698,127,1.9E-4
1,test_20231031_155329,10404007.png,502730,19649,483081,0.9609154019055954,4,6,61265,2845,58420,0.9535623928833755,25.79059377777778,3461.428794666667,12.738249587356849,127,2.0E-4
2,test_20231031_155329,1254659.png,342646,71682,270964,0.7907986668456658,4,6,80080,10037,70043,0.8746628371628371,21.233608888888888,3282.5188533333335,12.968731317042248,127,2.0E-4
3,test_20231031_155329,10188041.png,221231,9489,211742,0.9571081810415357,3,6,41731,1337,40394,0.967961467494189,10.60381511111111,1029.055584,18.006415272400552,127,2.0E-4
4,test_20231031_155329,10287332.png,216980,12102,204878,0.944225274218822,3,6,22337,1661,20676,0.9256390741818508,9.531660444444444,800.9398453333333,19.09480461289071,127,2.0E-4
5,test_20231031_155329,11610969.png,368720,24512,344208,0.9335213712302017,4,6,84111,3579,80532,0.9574490851374968,21.428912,2970.4620213333333,13.402563567661467,127,2.0E-4
6,test_20231031_155329,10350842.png,212614,5842,206772,0.9725229759093945,3,6,42529,859,41670,0.9798020174469185,19.341116444444445,2392.76384,14.341805239536118,127,2.0E-4
7,test_20231031_155329,10863862.png,317432,11017,306415,0.9652933541671918,3,6,66058,1602,64456,0.9757485845771897,24.437365333333332,3426.7552746666665,12.781972709279499,127,2.0E-4
8,test_20231031_155329,11382381.png,312486,827,311659,0.9973534814359684,2,5,46745,112,46633,0.9976040218205156,21.333713777777778,2451.331146666667,14.236783774592807,127,2.0E-4
9,test_20231031_155329,11079715.png,443815,115577,328238,0.7395829343307458,6,7,124136,16143,107993,0.8699571437777921,17.25776711111111,2193.2968,14.719829558750817,127,2.0E-4
10,test_20231031_155329,11551286.png,271883,697,271186,0.9974363972738274,3,6,40092,101,39991,0.9974807941734012,17.572291555555555,1811.64304,15.55007731009529,127,2.0E-4
1,test_20231031_155330,10404007.png,502730,19649,483081,0.9609154019055954,4,6,61265,2845,58420,0.9535623928833755,25.79059377777778,3461.428794666667,12.738249587356849,127,2.1E-4
2,test_20231031_155330,1254659.png,342646,71682,270964,0.7907986668456658,4,6,80080,10037,70043,0.8746628371628371,21.233608888888888,3282.5188533333335,12.968731317042248,127,2.1E-4
3,test_20231031_155330,10188041.png,221231,9489,211742,0.9571081810415357,3,6,41731,1337,40394,0.967961467494189,10.60381511111111,1029.055584,18.006415272400552,127,2.1E-4
4,test_20231031_155330,10287332.png,216980,12102,204878,0.944225274218822,2,5,22337,1661,20676,0.9256390741818508,9.531660444444444,800.9398453333333,19.09480461289071,127,2.1E-4
5,test_20231031_155330,11610969.png,368720,24512,344208,0.9335213712302017,3,6,84111,3579,80532,0.9574490851374968,21.428912,2970.4620213333333,13.402563567661467,127,2.1E-4
6,test_20231031_155330,10350842.png,212614,5842,206772,0.9725229759093945,2,11,42529,859,41670,0.9798020174469185,19.341116444444445,2392.76384,14.341805239536118,127,2.1E-4
7,test_20231031_155330,10863862.png,317432,11017,306415,0.9652933541671918,3,6,66058,1602,64456,0.9757485845771897,24.437365333333332,3426.7552746666665,12.781972709279499,127,2.1E-4
8,test_20231031_155330,11382381.png,312486,827,311659,0.9973534814359684,3,6,46745,112,46633,0.9976040218205156,21.333713777777778,2451.331146666667,14.236783774592807,127,2.1E-4
9,test_20231031_155330,11079715.png,443815,115577,328238,0.7395829343307458,5,8,124136,16143,107993,0.8699571437777921,17.25776711111111,2193.2968,14.719829558750817,127,2.1E-4
10,test_20231031_155330,11551286.png,271883,697,271186,0.9974363972738274,2,6,40092,101,39991,0.9974807941734012,17.572291555555555,1811.64304,15.55007731009529,127,2.1E-4
1,test_20231031_155331,10404007.png,502730,19649,483081,0.9609154019055954,4,6,61265,2845,58420,0.9535623928833755,25.79059377777778,3461.428794666667,12.738249587356849,127,2.2E-4
2,test_20231031_155331,1254659.png,342646,71682,270964,0.7907986668456658,4,13,80080,10037,70043,0.8746628371628371,21.233608888888888,3282.5188533333335,12.968731317042248,127,2.2E-4
3,test_20231031_155331,10188041.png,221231,9489,211742,0.9571081810415357,3,6,41731,1337,40394,0.967961467494189,10.60381511111111,1029.055584,18.006415272400552,127,2.2E-4
4,test_20231031_155331,10287332.png,216980,12102,204878,0.944225274218822,3,6,22337,1661,20676,0.9256390741818508,9.531660444444444,800.9398453333333,19.09480461289071,127,2.2E-4
5,test_20231031_155331,11610969.png,368720,24512,344208,0.9335213712302017,3,5,84111,3579,80532,0.9574490851374968,21.428912,2970.4620213333333,13.402563567661467,127,2.2E-4
6,test_20231031_155331,10350842.png,212614,5842,206772,0.9725229759093945,3,6,42529,859,41670,0.9798020174469185,19.341116444444445,2392.76384,14.341805239536118,127,2.2E-4
7,test_20231031_155331,10863862.png,317432,11017,306415,0.9652933541671918,3,6,66058,1602,64456,0.9757485845771897,24.437365333333332,3426.7552746666665,12.781972709279499,127,2.2E-4
8,test_20231031_155331,11382381.png,312486,827,311659,0.9973534814359684,3,6,46745,112,46633,0.9976040218205156,21.333713777777778,2451.331146666667,14.236783774592807,127,2.2E-4
9,test_20231031_155331,11079715.png,443815,115577,328238,0.7395829343307458,6,8,124136,16143,107993,0.8699571437777921,17.25776711111111,2193.2968,14.719829558750817,127,2.2E-4
10,test_20231031_155331,11551286.png,271883,697,271186,0.9974363972738274,3,6,40092,101,39991,0.9974807941734012,17.572291555555555,1811.64304,15.55007731009529,127,2.2E-4
1,test_20231031_155332,10404007.png,502730,19649,483081,0.9609154019055954,4,6,61265,2845,58420,0.9535623928833755,25.79059377777778,3461.428794666667,12.738249587356849,127,2.3E-4
2,test_20231031_155332,1254659.png,342646,71682,270964,0.7907986668456658,5,12,80080,10037,70043,0.8746628371628371,21.233608888888888,3282.5188533333335,12.968731317042248,127,2.3E-4
3,test_20231031_155332,10188041.png,221231,9489,211742,0.9571081810415357,3,6,41731,1337,40394,0.967961467494189,10.60381511111111,1029.055584,18.006415272400552,127,2.3E-4
4,test_20231031_155332,10287332.png,216980,12102,204878,0.944225274218822,3,6,22337,1661,20676,0.9256390741818508,9.531660444444444,800.9398453333333,19.09480461289071,127,2.3E-4
5,test_20231031_155332,11610969.png,368720,24512,344208,0.9335213712302017,4,6,84111,3579,80532,0.9574490851374968,21.428912,2970.4620213333333,13.402563567661467,127,2.3E-4
6,test_20231031_155332,10350842.png,212614,5842,206772,0.9725229759093945,3,6,42529,859,41670,0.9798020174469185,19.341116444444445,2392.76384,14.341805239536118,127,2.3E-4
7,test_20231031_155332,10863862.png,317432,11017,306415,0.9652933541671918,4,6,66058,1602,64456,0.9757485845771897,24.437365333333332,3426.7552746666665,12.781972709279499,127,2.3E-4
8,test_20231031_155332,11382381.png,312486,827,311659,0.9973534814359684,3,5,46745,112,46633,0.9976040218205156,21.333713777777778,2451.331146666667,14.236783774592807,127,2.3E-4
9,test_20231031_155332,11079715.png,443815,115577,328238,0.7395829343307458,6,8,124136,16143,107993,0.8699571437777921,17.25776711111111,2193.2968,14.719829558750817,127,2.3E-4
10,test_20231031_155332,11551286.png,271883,697,271186,0.9974363972738274,2,7,40092,101,39991,0.9974807941734012,17.572291555555555,1811.64304,15.55007731009529,127,2.3E-4
1,test_20231031_155334,10404007.png,502730,19649,483081,0.9609154019055954,7,11,61265,2845,58420,0.9535623928833755,25.79059377777778,3461.428794666667,12.738249587356849,127,2.4E-4
2,test_20231031_155334,1254659.png,342646,71682,270964,0.7907986668456658,6,8,80080,10037,70043,0.8746628371628371,21.233608888888888,3282.5188533333335,12.968731317042248,127,2.4E-4
3,test_20231031_155334,10188041.png,221231,9489,211742,0.9571081810415357,4,6,41731,1337,40394,0.967961467494189,10.60381511111111,1029.055584,18.006415272400552,127,2.4E-4
4,test_20231031_155334,10287332.png,216980,12102,204878,0.944225274218822,3,6,22337,1661,20676,0.9256390741818508,9.531660444444444,800.9398453333333,19.09480461289071,127,2.4E-4
5,test_20231031_155334,11610969.png,368720,24512,344208,0.9335213712302017,4,6,84111,3579,80532,0.9574490851374968,21.428912,2970.4620213333333,13.402563567661467,127,2.4E-4
6,test_20231031_155334,10350842.png,212614,5842,206772,0.9725229759093945,3,6,42529,859,41670,0.9798020174469185,19.341116444444445,2392.76384,14.341805239536118,127,2.4E-4
7,test_20231031_155334,10863862.png,317432,11017,306415,0.9652933541671918,3,6,66058,1602,64456,0.9757485845771897,24.437365333333332,3426.7552746666665,12.781972709279499,127,2.4E-4
8,test_20231031_155334,11382381.png,312486,827,311659,0.9973534814359684,2,6,46745,112,46633,0.9976040218205156,21.333713777777778,2451.331146666667,14.236783774592807,127,2.4E-4
9,test_20231031_155334,11079715.png,443815,115577,328238,0.7395829343307458,5,7,124136,16143,107993,0.8699571437777921,17.25776711111111,2193.2968,14.719829558750817,127,2.4E-4
10,test_20231031_155334,11551286.png,271883,697,271186,0.9974363972738274,3,5,40092,101,39991,0.9974807941734012,17.572291555555555,1811.64304,15.55007731009529,127,2.4E-4
1,test_20231031_155335,10404007.png,502730,19649,483081,0.9609154019055954,4,6,61265,2845,58420,0.9535623928833755,25.79059377777778,3461.428794666667,12.738249587356849,127,2.5E-4
2,test_20231031_155335,1254659.png,342646,71682,270964,0.7907986668456658,5,7,80080,10037,70043,0.8746628371628371,21.233608888888888,3282.5188533333335,12.968731317042248,127,2.5E-4
3,test_20231031_155335,10188041.png,221231,9489,211742,0.9571081810415357,4,6,41731,1337,40394,0.967961467494189,10.60381511111111,1029.055584,18.006415272400552,127,2.5E-4
4,test_20231031_155335,10287332.png,216980,12102,204878,0.944225274218822,3,7,22337,1661,20676,0.9256390741818508,9.531660444444444,800.9398453333333,19.09480461289071,127,2.5E-4
5,test_20231031_155335,11610969.png,368720,24512,344208,0.9335213712302017,6,9,84111,3579,80532,0.9574490851374968,21.428912,2970.4620213333333,13.402563567661467,127,2.5E-4
6,test_20231031_155335,10350842.png,212614,5842,206772,0.9725229759093945,4,10,42529,859,41670,0.9798020174469185,19.341116444444445,2392.76384,14.341805239536118,127,2.5E-4
7,test_20231031_155335,10863862.png,317432,11017,306415,0.9652933541671918,4,7,66058,1602,64456,0.9757485845771897,24.437365333333332,3426.7552746666665,12.781972709279499,127,2.5E-4
8,test_20231031_155335,11382381.png,312486,827,311659,0.9973534814359684,3,7,46745,112,46633,0.9976040218205156,21.333713777777778,2451.331146666667,14.236783774592807,127,2.5E-4
9,test_20231031_155335,11079715.png,443815,115577,328238,0.7395829343307458,5,6,124136,16143,107993,0.8699571437777921,17.25776711111111,2193.2968,14.719829558750817,127,2.5E-4
10,test_20231031_155335,11551286.png,271883,697,271186,0.9974363972738274,2,5,40092,101,39991,0.9974807941734012,17.572291555555555,1811.64304,15.55007731009529,127,2.5E-4
1,test_20231031_155336,10404007.png,502730,19467,483263,0.9612774252580908,3,6,61265,2821,58444,0.9539541336815474,25.804821333333333,3464.2128746666667,12.734757894589483,127,2.6000000000000003E-4
2,test_20231031_155336,1254659.png,342646,71622,271024,0.7909737746829089,5,6,80080,10031,70049,0.8747377622377622,21.243162666666667,3283.60104,12.96729976321864,127,2.6000000000000003E-4
3,test_20231031_155336,10188041.png,221231,9449,211782,0.9572889875288726,3,6,41731,1331,40400,0.9681052455009466,10.71383111111111,1042.626304,17.949516834977533,127,2.6000000000000003E-4
4,test_20231031_155336,10287332.png,216980,12102,204878,0.944225274218822,3,5,22337,1661,20676,0.9256390741818508,9.531660444444444,800.9398453333333,19.09480461289071,127,2.6000000000000003E-4
5,test_20231031_155336,11610969.png,368720,24192,344528,0.9343892384465177,3,5,84111,3533,80578,0.957995981500636,21.846828444444444,3056.5311093333335,13.278515404761055,127,2.6000000000000003E-4
6,test_20231031_155336,10350842.png,212614,5762,206852,0.9728992446405222,2,5,42529,847,41682,0.9800841778551106,19.409909333333335,2398.521546666667,14.33136736645771,127,2.6000000000000003E-4
7,test_20231031_155336,10863862.png,317432,10897,306535,0.9656713878877996,3,5,66058,1584,64474,0.9760210723909292,24.488522666666668,3430.0665386666665,12.77777816015962,127,2.6000000000000003E-4
8,test_20231031_155336,11382381.png,312486,707,311779,0.9977374986399391,2,6,46745,94,46651,0.9979890897422184,21.82824,2521.273456,14.11460409284577,127,2.6000000000000003E-4
9,test_20231031_155336,11079715.png,443815,115577,328238,0.7395829343307458,5,7,124136,16143,107993,0.8699571437777921,17.25776711111111,2193.2968,14.719829558750817,127,2.6000000000000003E-4
10,test_20231031_155336,11551286.png,271883,697,271186,0.9974363972738274,2,6,40092,101,39991,0.9974807941734012,17.572291555555555,1811.64304,15.55007731009529,127,2.6000000000000003E-4
1,test_20231031_155337,10404007.png,502730,19467,483263,0.9612774252580908,4,6,61265,2821,58444,0.9539541336815474,25.804821333333333,3464.2128746666667,12.734757894589483,127,2.7000000000000006E-4
2,test_20231031_155337,1254659.png,342646,71622,271024,0.7909737746829089,4,6,80080,10031,70049,0.8747377622377622,21.243162666666667,3283.60104,12.96729976321864,127,2.7000000000000006E-4
3,test_20231031_155337,10188041.png,221231,9449,211782,0.9572889875288726,3,6,41731,1331,40400,0.9681052455009466,10.71383111111111,1042.626304,17.949516834977533,127,2.7000000000000006E-4
4,test_20231031_155337,10287332.png,216980,12102,204878,0.944225274218822,2,5,22337,1661,20676,0.9256390741818508,9.531660444444444,800.9398453333333,19.09480461289071,127,2.7000000000000006E-4
5,test_20231031_155337,11610969.png,368720,24192,344528,0.9343892384465177,4,5,84111,3533,80578,0.957995981500636,21.846828444444444,3056.5311093333335,13.278515404761055,127,2.7000000000000006E-4
6,test_20231031_155337,10350842.png,212614,5762,206852,0.9728992446405222,2,5,42529,847,41682,0.9800841778551106,19.409909333333335,2398.521546666667,14.33136736645771,127,2.7000000000000006E-4
7,test_20231031_155337,10863862.png,317432,10897,306535,0.9656713878877996,3,5,66058,1584,64474,0.9760210723909292,24.488522666666668,3430.0665386666665,12.77777816015962,127,2.7000000000000006E-4
8,test_20231031_155337,11382381.png,312486,707,311779,0.9977374986399391,2,6,46745,94,46651,0.9979890897422184,21.82824,2521.273456,14.11460409284577,127,2.7000000000000006E-4
9,test_20231031_155337,11079715.png,443815,115577,328238,0.7395829343307458,5,6,124136,16143,107993,0.8699571437777921,17.25776711111111,2193.2968,14.719829558750817,127,2.7000000000000006E-4
10,test_20231031_155337,11551286.png,271883,697,271186,0.9974363972738274,2,7,40092,101,39991,0.9974807941734012,17.572291555555555,1811.64304,15.55007731009529,127,2.7000000000000006E-4
1,test_20231031_155338,10404007.png,502730,19467,483263,0.9612774252580908,4,6,61265,2821,58444,0.9539541336815474,25.804821333333333,3464.2128746666667,12.734757894589483,127,2.800000000000001E-4
2,test_20231031_155338,1254659.png,342646,71622,271024,0.7909737746829089,6,7,80080,10031,70049,0.8747377622377622,21.243162666666667,3283.60104,12.96729976321864,127,2.800000000000001E-4
3,test_20231031_155338,10188041.png,221231,9449,211782,0.9572889875288726,3,6,41731,1331,40400,0.9681052455009466,10.71383111111111,1042.626304,17.949516834977533,127,2.800000000000001E-4
4,test_20231031_155338,10287332.png,216980,12102,204878,0.944225274218822,3,6,22337,1661,20676,0.9256390741818508,9.531660444444444,800.9398453333333,19.09480461289071,127,2.800000000000001E-4
5,test_20231031_155338,11610969.png,368720,24192,344528,0.9343892384465177,4,6,84111,3533,80578,0.957995981500636,21.846828444444444,3056.5311093333335,13.278515404761055,127,2.800000000000001E-4
6,test_20231031_155338,10350842.png,212614,5762,206852,0.9728992446405222,3,5,42529,847,41682,0.9800841778551106,19.409909333333335,2398.521546666667,14.33136736645771,127,2.800000000000001E-4
7,test_20231031_155338,10863862.png,317432,10897,306535,0.9656713878877996,3,6,66058,1584,64474,0.9760210723909292,24.488522666666668,3430.0665386666665,12.77777816015962,127,2.800000000000001E-4
8,test_20231031_155338,11382381.png,312486,707,311779,0.9977374986399391,3,6,46745,94,46651,0.9979890897422184,21.82824,2521.273456,14.11460409284577,127,2.800000000000001E-4
9,test_20231031_155338,11079715.png,443815,115577,328238,0.7395829343307458,5,6,124136,16143,107993,0.8699571437777921,17.25776711111111,2193.2968,14.719829558750817,127,2.800000000000001E-4
10,test_20231031_155338,11551286.png,271883,407,271476,0.9985030325544444,2,6,40092,58,40034,0.9985533273471017,17.855009777777777,1855.9584906666666,15.44512102064812,127,2.800000000000001E-4
1,test_20231031_155339,10404007.png,502730,19467,483263,0.9612774252580908,4,6,61265,2821,58444,0.9539541336815474,25.804821333333333,3464.2128746666667,12.734757894589483,127,2.900000000000001E-4
2,test_20231031_155339,1254659.png,342646,71622,271024,0.7909737746829089,5,6,80080,10031,70049,0.8747377622377622,21.243162666666667,3283.60104,12.96729976321864,127,2.900000000000001E-4
3,test_20231031_155339,10188041.png,221231,9449,211782,0.9572889875288726,3,6,41731,1331,40400,0.9681052455009466,10.71383111111111,1042.626304,17.949516834977533,127,2.900000000000001E-4
4,test_20231031_155339,10287332.png,216980,12102,204878,0.944225274218822,2,6,22337,1661,20676,0.9256390741818508,9.531660444444444,800.9398453333333,19.09480461289071,127,2.900000000000001E-4
5,test_20231031_155339,11610969.png,368720,24192,344528,0.9343892384465177,3,6,84111,3533,80578,0.957995981500636,21.846828444444444,3056.5311093333335,13.278515404761055,127,2.900000000000001E-4
6,test_20231031_155339,10350842.png,212614,5762,206852,0.9728992446405222,3,6,42529,847,41682,0.9800841778551106,19.409909333333335,2398.521546666667,14.33136736645771,127,2.900000000000001E-4
7,test_20231031_155339,10863862.png,317432,10897,306535,0.9656713878877996,3,6,66058,1584,64474,0.9760210723909292,24.488522666666668,3430.0665386666665,12.77777816015962,127,2.900000000000001E-4
8,test_20231031_155339,11382381.png,312486,707,311779,0.9977374986399391,2,6,46745,94,46651,0.9979890897422184,21.82824,2521.273456,14.11460409284577,127,2.900000000000001E-4
9,test_20231031_155339,11079715.png,443815,115577,328238,0.7395829343307458,5,6,124136,16143,107993,0.8699571437777921,17.25776711111111,2193.2968,14.719829558750817,127,2.900000000000001E-4
10,test_20231031_155339,11551286.png,271883,407,271476,0.9985030325544444,2,6,40092,58,40034,0.9985533273471017,17.855009777777777,1855.9584906666666,15.44512102064812,127,2.900000000000001E-4
1,test_20231031_155340,10404007.png,502730,18534,484196,0.9631332922244544,3,6,61265,2687,58578,0.956141353138007,25.885536,3487.714848,12.705393906287338,128,1.0E-5
2,test_20231031_155340,1254659.png,342646,69592,273054,0.7968982565096339,5,6,80080,9768,70312,0.878021978021978,21.430725333333335,3345.388144,12.88633847428336,128,1.0E-5
3,test_20231031_155340,10188041.png,221231,9309,211922,0.9579218102345513,3,6,41731,1311,40420,0.9685845055234718,10.629137777777778,1035.1340373333333,17.980837715530228,128,1.0E-5
4,test_20231031_155340,10287332.png,216980,12152,204828,0.9439948382339386,3,6,22337,1664,20673,0.9255047678739311,9.449086222222222,786.1254666666666,19.175884953215455,128,1.0E-5
5,test_20231031_155340,11610969.png,368720,24032,344688,0.9348231720546756,4,6,84111,3509,80602,0.9582813187335782,21.529770666666668,2995.306272,13.366391249809656,128,1.0E-5
6,test_20231031_155340,10350842.png,212614,5642,206972,0.9734636477372139,3,6,42529,830,41699,0.9804839051000493,19.393774222222223,2404.812736,14.319990975752292,128,1.0E-5
7,test_20231031_155340,10863862.png,317432,10677,306755,0.966364449708914,3,6,66058,1554,64504,0.9764752187471616,24.58188977777778,3464.000261333333,12.735024447582767,128,1.0E-5
8,test_20231031_155340,11382381.png,312486,927,311559,0.997033467099326,2,6,46745,127,46618,0.9972831318857632,20.359315555555554,2313.8482506666664,14.487454876951972,128,1.0E-5
9,test_20231031_155340,11079715.png,443815,113162,330653,0.7450243907934613,5,6,124136,15824,108312,0.872526905974093,17.42231111111111,2238.1416106666666,14.631927993255129,128,1.0E-5
10,test_20231031_155340,11551286.png,271883,917,270966,0.9966272256816351,2,5,40092,134,39958,0.9966576873191659,15.950851555555555,1533.329888,16.274447597479135,128,1.0E-5
1,test_20231031_155341,10404007.png,502730,18534,484196,0.9631332922244544,3,6,61265,2687,58578,0.956141353138007,25.885536,3487.714848,12.705393906287338,128,2.0E-5
2,test_20231031_155341,1254659.png,342646,69592,273054,0.7968982565096339,4,6,80080,9768,70312,0.878021978021978,21.430725333333335,3345.388144,12.88633847428336,128,2.0E-5
3,test_20231031_155341,10188041.png,221231,9309,211922,0.9579218102345513,3,6,41731,1311,40420,0.9685845055234718,10.629137777777778,1035.1340373333333,17.980837715530228,128,2.0E-5
4,test_20231031_155341,10287332.png,216980,12152,204828,0.9439948382339386,2,5,22337,1664,20673,0.9255047678739311,9.449086222222222,786.1254666666666,19.175884953215455,128,2.0E-5
5,test_20231031_155341,11610969.png,368720,24032,344688,0.9348231720546756,4,6,84111,3509,80602,0.9582813187335782,21.529770666666668,2995.306272,13.366391249809656,128,2.0E-5
6,test_20231031_155341,10350842.png,212614,5642,206972,0.9734636477372139,3,5,42529,830,41699,0.9804839051000493,19.393774222222223,2404.812736,14.319990975752292,128,2.0E-5
7,test_20231031_155341,10863862.png,317432,10677,306755,0.966364449708914,3,5,66058,1554,64504,0.9764752187471616,24.58188977777778,3464.000261333333,12.735024447582767,128,2.0E-5
8,test_20231031_155341,11382381.png,312486,927,311559,0.997033467099326,2,5,46745,127,46618,0.9972831318857632,20.359315555555554,2313.8482506666664,14.487454876951972,128,2.0E-5
9,test_20231031_155341,11079715.png,443815,113162,330653,0.7450243907934613,5,6,124136,15824,108312,0.872526905974093,17.42231111111111,2238.1416106666666,14.631927993255129,128,2.0E-5
10,test_20231031_155341,11551286.png,271883,917,270966,0.9966272256816351,3,6,40092,134,39958,0.9966576873191659,15.950851555555555,1533.329888,16.274447597479135,128,2.0E-5
1,test_20231031_155342,10404007.png,502730,18534,484196,0.9631332922244544,3,6,61265,2687,58578,0.956141353138007,25.885536,3487.714848,12.705393906287338,128,3.0000000000000004E-5
2,test_20231031_155342,1254659.png,342646,69592,273054,0.7968982565096339,4,6,80080,9768,70312,0.878021978021978,21.430725333333335,3345.388144,12.88633847428336,128,3.0000000000000004E-5
3,test_20231031_155342,10188041.png,221231,9309,211922,0.9579218102345513,3,6,41731,1311,40420,0.9685845055234718,10.629137777777778,1035.1340373333333,17.980837715530228,128,3.0000000000000004E-5
4,test_20231031_155342,10287332.png,216980,12152,204828,0.9439948382339386,3,5,22337,1664,20673,0.9255047678739311,9.449086222222222,786.1254666666666,19.175884953215455,128,3.0000000000000004E-5
5,test_20231031_155342,11610969.png,368720,24032,344688,0.9348231720546756,3,5,84111,3509,80602,0.9582813187335782,21.529770666666668,2995.306272,13.366391249809656,128,3.0000000000000004E-5
6,test_20231031_155342,10350842.png,212614,5642,206972,0.9734636477372139,2,5,42529,830,41699,0.9804839051000493,19.393774222222223,2404.812736,14.319990975752292,128,3.0000000000000004E-5
7,test_20231031_155342,10863862.png,317432,10677,306755,0.966364449708914,3,5,66058,1554,64504,0.9764752187471616,24.58188977777778,3464.000261333333,12.735024447582767,128,3.0000000000000004E-5
8,test_20231031_155342,11382381.png,312486,927,311559,0.997033467099326,2,5,46745,127,46618,0.9972831318857632,20.359315555555554,2313.8482506666664,14.487454876951972,128,3.0000000000000004E-5
9,test_20231031_155342,11079715.png,443815,113162,330653,0.7450243907934613,5,8,124136,15824,108312,0.872526905974093,17.42231111111111,2238.1416106666666,14.631927993255129,128,3.0000000000000004E-5
10,test_20231031_155342,11551286.png,271883,917,270966,0.9966272256816351,2,5,40092,134,39958,0.9966576873191659,15.950851555555555,1533.329888,16.274447597479135,128,3.0000000000000004E-5
1,test_20231031_155343,10404007.png,502730,18534,484196,0.9631332922244544,3,5,61265,2687,58578,0.956141353138007,25.885536,3487.714848,12.705393906287338,128,4.0E-5
2,test_20231031_155343,1254659.png,342646,69592,273054,0.7968982565096339,4,6,80080,9768,70312,0.878021978021978,21.430725333333335,3345.388144,12.88633847428336,128,4.0E-5
3,test_20231031_155343,10188041.png,221231,9309,211922,0.9579218102345513,3,6,41731,1311,40420,0.9685845055234718,10.629137777777778,1035.1340373333333,17.980837715530228,128,4.0E-5
4,test_20231031_155343,10287332.png,216980,12152,204828,0.9439948382339386,3,6,22337,1664,20673,0.9255047678739311,9.449086222222222,786.1254666666666,19.175884953215455,128,4.0E-5
5,test_20231031_155343,11610969.png,368720,24032,344688,0.9348231720546756,4,6,84111,3509,80602,0.9582813187335782,21.529770666666668,2995.306272,13.366391249809656,128,4.0E-5
6,test_20231031_155343,10350842.png,212614,5642,206972,0.9734636477372139,2,6,42529,830,41699,0.9804839051000493,19.393774222222223,2404.812736,14.319990975752292,128,4.0E-5
7,test_20231031_155343,10863862.png,317432,10677,306755,0.966364449708914,3,5,66058,1554,64504,0.9764752187471616,24.58188977777778,3464.000261333333,12.735024447582767,128,4.0E-5
8,test_20231031_155343,11382381.png,312486,927,311559,0.997033467099326,2,5,46745,127,46618,0.9972831318857632,20.359315555555554,2313.8482506666664,14.487454876951972,128,4.0E-5
9,test_20231031_155343,11079715.png,443815,113162,330653,0.7450243907934613,5,6,124136,15824,108312,0.872526905974093,17.42231111111111,2238.1416106666666,14.631927993255129,128,4.0E-5
10,test_20231031_155343,11551286.png,271883,917,270966,0.9966272256816351,2,6,40092,134,39958,0.9966576873191659,15.950851555555555,1533.329888,16.274447597479135,128,4.0E-5
1,test_20231031_155344,10404007.png,502730,18534,484196,0.9631332922244544,3,5,61265,2687,58578,0.956141353138007,25.885536,3487.714848,12.705393906287338,128,5.0E-5
2,test_20231031_155344,1254659.png,342646,69592,273054,0.7968982565096339,4,7,80080,9768,70312,0.878021978021978,21.430725333333335,3345.388144,12.88633847428336,128,5.0E-5
3,test_20231031_155344,10188041.png,221231,9309,211922,0.9579218102345513,3,6,41731,1311,40420,0.9685845055234718,10.629137777777778,1035.1340373333333,17.980837715530228,128,5.0E-5
4,test_20231031_155344,10287332.png,216980,12152,204828,0.9439948382339386,3,6,22337,1664,20673,0.9255047678739311,9.449086222222222,786.1254666666666,19.175884953215455,128,5.0E-5
5,test_20231031_155344,11610969.png,368720,24032,344688,0.9348231720546756,4,6,84111,3509,80602,0.9582813187335782,21.529770666666668,2995.306272,13.366391249809656,128,5.0E-5
6,test_20231031_155344,10350842.png,212614,5642,206972,0.9734636477372139,2,6,42529,830,41699,0.9804839051000493,19.393774222222223,2404.812736,14.319990975752292,128,5.0E-5
7,test_20231031_155344,10863862.png,317432,10677,306755,0.966364449708914,3,5,66058,1554,64504,0.9764752187471616,24.58188977777778,3464.000261333333,12.735024447582767,128,5.0E-5
8,test_20231031_155344,11382381.png,312486,917,311569,0.9970654685329903,3,5,46745,126,46619,0.99730452454808,21.089132444444445,2412.4090613333333,14.306294097973675,128,5.0E-5
9,test_20231031_155344,11079715.png,443815,113162,330653,0.7450243907934613,5,6,124136,15824,108312,0.872526905974093,17.42231111111111,2238.1416106666666,14.631927993255129,128,5.0E-5
10,test_20231031_155344,11551286.png,271883,917,270966,0.9966272256816351,2,6,40092,134,39958,0.9966576873191659,15.950851555555555,1533.329888,16.274447597479135,128,5.0E-5
1,test_20231031_155345,10404007.png,502730,18534,484196,0.9631332922244544,4,6,61265,2687,58578,0.956141353138007,25.885536,3487.714848,12.705393906287338,128,6.0E-5
2,test_20231031_155345,1254659.png,342646,69592,273054,0.7968982565096339,5,6,80080,9768,70312,0.878021978021978,21.430725333333335,3345.388144,12.88633847428336,128,6.0E-5
3,test_20231031_155345,10188041.png,221231,9309,211922,0.9579218102345513,3,6,41731,1311,40420,0.9685845055234718,10.629137777777778,1035.1340373333333,17.980837715530228,128,6.0E-5
4,test_20231031_155345,10287332.png,216980,12152,204828,0.9439948382339386,3,6,22337,1664,20673,0.9255047678739311,9.449086222222222,786.1254666666666,19.175884953215455,128,6.0E-5
5,test_20231031_155345,11610969.png,368720,24032,344688,0.9348231720546756,4,6,84111,3509,80602,0.9582813187335782,21.529770666666668,2995.306272,13.366391249809656,128,6.0E-5
6,test_20231031_155345,10350842.png,212614,5642,206972,0.9734636477372139,2,6,42529,830,41699,0.9804839051000493,19.393774222222223,2404.812736,14.319990975752292,128,6.0E-5
7,test_20231031_155345,10863862.png,317432,10677,306755,0.966364449708914,3,6,66058,1554,64504,0.9764752187471616,24.58188977777778,3464.000261333333,12.735024447582767,128,6.0E-5
8,test_20231031_155345,11382381.png,312486,917,311569,0.9970654685329903,3,6,46745,126,46619,0.99730452454808,21.089132444444445,2412.4090613333333,14.306294097973675,128,6.0E-5
9,test_20231031_155345,11079715.png,443815,113162,330653,0.7450243907934613,5,6,124136,15824,108312,0.872526905974093,17.42231111111111,2238.1416106666666,14.631927993255129,128,6.0E-5
10,test_20231031_155345,11551286.png,271883,917,270966,0.9966272256816351,2,5,40092,134,39958,0.9966576873191659,15.950851555555555,1533.329888,16.274447597479135,128,6.0E-5
1,test_20231031_155346,10404007.png,502730,18534,484196,0.9631332922244544,4,6,61265,2687,58578,0.956141353138007,25.885536,3487.714848,12.705393906287338,128,7.000000000000001E-5
2,test_20231031_155346,1254659.png,342646,69592,273054,0.7968982565096339,4,6,80080,9768,70312,0.878021978021978,21.430725333333335,3345.388144,12.88633847428336,128,7.000000000000001E-5
3,test_20231031_155346,10188041.png,221231,9309,211922,0.9579218102345513,3,7,41731,1311,40420,0.9685845055234718,10.629137777777778,1035.1340373333333,17.980837715530228,128,7.000000000000001E-5
4,test_20231031_155346,10287332.png,216980,12152,204828,0.9439948382339386,3,6,22337,1664,20673,0.9255047678739311,9.449086222222222,786.1254666666666,19.175884953215455,128,7.000000000000001E-5
5,test_20231031_155346,11610969.png,368720,24032,344688,0.9348231720546756,3,6,84111,3509,80602,0.9582813187335782,21.529770666666668,2995.306272,13.366391249809656,128,7.000000000000001E-5
6,test_20231031_155346,10350842.png,212614,5642,206972,0.9734636477372139,2,5,42529,830,41699,0.9804839051000493,19.393774222222223,2404.812736,14.319990975752292,128,7.000000000000001E-5
7,test_20231031_155346,10863862.png,317432,10677,306755,0.966364449708914,4,6,66058,1554,64504,0.9764752187471616,24.58188977777778,3464.000261333333,12.735024447582767,128,7.000000000000001E-5
8,test_20231031_155346,11382381.png,312486,917,311569,0.9970654685329903,2,6,46745,126,46619,0.99730452454808,21.089132444444445,2412.4090613333333,14.306294097973675,128,7.000000000000001E-5
9,test_20231031_155346,11079715.png,443815,113162,330653,0.7450243907934613,5,6,124136,15824,108312,0.872526905974093,17.42231111111111,2238.1416106666666,14.631927993255129,128,7.000000000000001E-5
10,test_20231031_155346,11551286.png,271883,797,271086,0.997068592004649,2,5,40092,116,39976,0.9971066546942033,16.03718577777778,1539.4418613333332,16.257170689141084,128,7.000000000000001E-5
1,test_20231031_155347,10404007.png,502730,18534,484196,0.9631332922244544,3,5,61265,2687,58578,0.956141353138007,25.885536,3487.714848,12.705393906287338,128,8.0E-5
2,test_20231031_155347,1254659.png,342646,69592,273054,0.7968982565096339,5,6,80080,9768,70312,0.878021978021978,21.430725333333335,3345.388144,12.88633847428336,128,8.0E-5
3,test_20231031_155347,10188041.png,221231,9309,211922,0.9579218102345513,3,5,41731,1311,40420,0.9685845055234718,10.629137777777778,1035.1340373333333,17.980837715530228,128,8.0E-5
4,test_20231031_155347,10287332.png,216980,12152,204828,0.9439948382339386,3,6,22337,1664,20673,0.9255047678739311,9.449086222222222,786.1254666666666,19.175884953215455,128,8.0E-5
5,test_20231031_155347,11610969.png,368720,24032,344688,0.9348231720546756,4,6,84111,3509,80602,0.9582813187335782,21.529770666666668,2995.306272,13.366391249809656,128,8.0E-5
6,test_20231031_155347,10350842.png,212614,5642,206972,0.9734636477372139,2,5,42529,830,41699,0.9804839051000493,19.393774222222223,2404.812736,14.319990975752292,128,8.0E-5
7,test_20231031_155347,10863862.png,317432,10677,306755,0.966364449708914,4,6,66058,1554,64504,0.9764752187471616,24.58188977777778,3464.000261333333,12.735024447582767,128,8.0E-5
8,test_20231031_155347,11382381.png,312486,917,311569,0.9970654685329903,3,6,46745,126,46619,0.99730452454808,21.089132444444445,2412.4090613333333,14.306294097973675,128,8.0E-5
9,test_20231031_155347,11079715.png,443815,113162,330653,0.7450243907934613,5,7,124136,15824,108312,0.872526905974093,17.42231111111111,2238.1416106666666,14.631927993255129,128,8.0E-5
10,test_20231031_155347,11551286.png,271883,797,271086,0.997068592004649,3,6,40092,116,39976,0.9971066546942033,16.03718577777778,1539.4418613333332,16.257170689141084,128,8.0E-5
1,test_20231031_155348,10404007.png,502730,18534,484196,0.9631332922244544,3,5,61265,2687,58578,0.956141353138007,25.885536,3487.714848,12.705393906287338,128,9.0E-5
2,test_20231031_155348,1254659.png,342646,69592,273054,0.7968982565096339,4,6,80080,9768,70312,0.878021978021978,21.430725333333335,3345.388144,12.88633847428336,128,9.0E-5
3,test_20231031_155348,10188041.png,221231,9309,211922,0.9579218102345513,3,5,41731,1311,40420,0.9685845055234718,10.629137777777778,1035.1340373333333,17.980837715530228,128,9.0E-5
4,test_20231031_155348,10287332.png,216980,12152,204828,0.9439948382339386,3,6,22337,1664,20673,0.9255047678739311,9.449086222222222,786.1254666666666,19.175884953215455,128,9.0E-5
5,test_20231031_155348,11610969.png,368720,24032,344688,0.9348231720546756,4,6,84111,3509,80602,0.9582813187335782,21.529770666666668,2995.306272,13.366391249809656,128,9.0E-5
6,test_20231031_155348,10350842.png,212614,5642,206972,0.9734636477372139,2,5,42529,830,41699,0.9804839051000493,19.393774222222223,2404.812736,14.319990975752292,128,9.0E-5
7,test_20231031_155348,10863862.png,317432,10677,306755,0.966364449708914,3,6,66058,1554,64504,0.9764752187471616,24.58188977777778,3464.000261333333,12.735024447582767,128,9.0E-5
8,test_20231031_155348,11382381.png,312486,917,311569,0.9970654685329903,2,5,46745,126,46619,0.99730452454808,21.089132444444445,2412.4090613333333,14.306294097973675,128,9.0E-5
9,test_20231031_155348,11079715.png,443815,113162,330653,0.7450243907934613,5,7,124136,15824,108312,0.872526905974093,17.42231111111111,2238.1416106666666,14.631927993255129,128,9.0E-5
10,test_20231031_155348,11551286.png,271883,797,271086,0.997068592004649,3,6,40092,116,39976,0.9971066546942033,16.03718577777778,1539.4418613333332,16.257170689141084,128,9.0E-5
1,test_20231031_155349,10404007.png,502730,18534,484196,0.9631332922244544,4,6,61265,2687,58578,0.956141353138007,25.885536,3487.714848,12.705393906287338,128,1.0E-4
2,test_20231031_155349,1254659.png,342646,69592,273054,0.7968982565096339,5,6,80080,9768,70312,0.878021978021978,21.430725333333335,3345.388144,12.88633847428336,128,1.0E-4
3,test_20231031_155349,10188041.png,221231,9309,211922,0.9579218102345513,3,6,41731,1311,40420,0.9685845055234718,10.629137777777778,1035.1340373333333,17.980837715530228,128,1.0E-4
4,test_20231031_155349,10287332.png,216980,12152,204828,0.9439948382339386,3,6,22337,1664,20673,0.9255047678739311,9.449086222222222,786.1254666666666,19.175884953215455,128,1.0E-4
5,test_20231031_155349,11610969.png,368720,24032,344688,0.9348231720546756,5,6,84111,3509,80602,0.9582813187335782,21.529770666666668,2995.306272,13.366391249809656,128,1.0E-4
6,test_20231031_155349,10350842.png,212614,5642,206972,0.9734636477372139,3,6,42529,830,41699,0.9804839051000493,19.393774222222223,2404.812736,14.319990975752292,128,1.0E-4
7,test_20231031_155349,10863862.png,317432,10677,306755,0.966364449708914,3,5,66058,1554,64504,0.9764752187471616,24.58188977777778,3464.000261333333,12.735024447582767,128,1.0E-4
8,test_20231031_155349,11382381.png,312486,917,311569,0.9970654685329903,2,5,46745,126,46619,0.99730452454808,21.089132444444445,2412.4090613333333,14.306294097973675,128,1.0E-4
9,test_20231031_155349,11079715.png,443815,113162,330653,0.7450243907934613,5,6,124136,15824,108312,0.872526905974093,17.42231111111111,2238.1416106666666,14.631927993255129,128,1.0E-4
10,test_20231031_155349,11551286.png,271883,797,271086,0.997068592004649,2,6,40092,116,39976,0.9971066546942033,16.03718577777778,1539.4418613333332,16.257170689141084,128,1.0E-4
1,test_20231031_155350,10404007.png,502730,18534,484196,0.9631332922244544,4,6,61265,2687,58578,0.956141353138007,25.885536,3487.714848,12.705393906287338,128,1.1E-4
2,test_20231031_155350,1254659.png,342646,69592,273054,0.7968982565096339,5,6,80080,9768,70312,0.878021978021978,21.430725333333335,3345.388144,12.88633847428336,128,1.1E-4
3,test_20231031_155350,10188041.png,221231,9309,211922,0.9579218102345513,3,6,41731,1311,40420,0.9685845055234718,10.629137777777778,1035.1340373333333,17.980837715530228,128,1.1E-4
4,test_20231031_155350,10287332.png,216980,12152,204828,0.9439948382339386,3,6,22337,1664,20673,0.9255047678739311,9.449086222222222,786.1254666666666,19.175884953215455,128,1.1E-4
5,test_20231031_155350,11610969.png,368720,24032,344688,0.9348231720546756,3,6,84111,3509,80602,0.9582813187335782,21.529770666666668,2995.306272,13.366391249809656,128,1.1E-4
6,test_20231031_155350,10350842.png,212614,5642,206972,0.9734636477372139,2,5,42529,830,41699,0.9804839051000493,19.393774222222223,2404.812736,14.319990975752292,128,1.1E-4
7,test_20231031_155350,10863862.png,317432,10677,306755,0.966364449708914,3,6,66058,1554,64504,0.9764752187471616,24.58188977777778,3464.000261333333,12.735024447582767,128,1.1E-4
8,test_20231031_155350,11382381.png,312486,917,311569,0.9970654685329903,5,9,46745,126,46619,0.99730452454808,21.089132444444445,2412.4090613333333,14.306294097973675,128,1.1E-4
9,test_20231031_155350,11079715.png,443815,113162,330653,0.7450243907934613,5,7,124136,15824,108312,0.872526905974093,17.42231111111111,2238.1416106666666,14.631927993255129,128,1.1E-4
10,test_20231031_155350,11551286.png,271883,797,271086,0.997068592004649,3,6,40092,116,39976,0.9971066546942033,16.03718577777778,1539.4418613333332,16.257170689141084,128,1.1E-4
1,test_20231031_155351,10404007.png,502730,18534,484196,0.9631332922244544,4,5,61265,2687,58578,0.956141353138007,25.885536,3487.714848,12.705393906287338,128,1.2E-4
2,test_20231031_155351,1254659.png,342646,69592,273054,0.7968982565096339,4,6,80080,9768,70312,0.878021978021978,21.430725333333335,3345.388144,12.88633847428336,128,1.2E-4
3,test_20231031_155351,10188041.png,221231,9309,211922,0.9579218102345513,3,6,41731,1311,40420,0.9685845055234718,10.629137777777778,1035.1340373333333,17.980837715530228,128,1.2E-4
4,test_20231031_155351,10287332.png,216980,12152,204828,0.9439948382339386,3,6,22337,1664,20673,0.9255047678739311,9.449086222222222,786.1254666666666,19.175884953215455,128,1.2E-4
5,test_20231031_155351,11610969.png,368720,24032,344688,0.9348231720546756,3,5,84111,3509,80602,0.9582813187335782,21.529770666666668,2995.306272,13.366391249809656,128,1.2E-4
6,test_20231031_155351,10350842.png,212614,5642,206972,0.9734636477372139,2,5,42529,830,41699,0.9804839051000493,19.393774222222223,2404.812736,14.319990975752292,128,1.2E-4
7,test_20231031_155351,10863862.png,317432,10677,306755,0.966364449708914,4,6,66058,1554,64504,0.9764752187471616,24.58188977777778,3464.000261333333,12.735024447582767,128,1.2E-4
8,test_20231031_155351,11382381.png,312486,917,311569,0.9970654685329903,3,5,46745,126,46619,0.99730452454808,21.089132444444445,2412.4090613333333,14.306294097973675,128,1.2E-4
9,test_20231031_155351,11079715.png,443815,113162,330653,0.7450243907934613,5,11,124136,15824,108312,0.872526905974093,17.42231111111111,2238.1416106666666,14.631927993255129,128,1.2E-4
10,test_20231031_155351,11551286.png,271883,797,271086,0.997068592004649,3,6,40092,116,39976,0.9971066546942033,16.03718577777778,1539.4418613333332,16.257170689141084,128,1.2E-4
1,test_20231031_155353,10404007.png,502730,18534,484196,0.9631332922244544,3,6,61265,2687,58578,0.956141353138007,25.885536,3487.714848,12.705393906287338,128,1.3000000000000002E-4
2,test_20231031_155353,1254659.png,342646,69592,273054,0.7968982565096339,5,7,80080,9768,70312,0.878021978021978,21.430725333333335,3345.388144,12.88633847428336,128,1.3000000000000002E-4
3,test_20231031_155353,10188041.png,221231,9309,211922,0.9579218102345513,3,6,41731,1311,40420,0.9685845055234718,10.629137777777778,1035.1340373333333,17.980837715530228,128,1.3000000000000002E-4
4,test_20231031_155353,10287332.png,216980,12152,204828,0.9439948382339386,3,6,22337,1664,20673,0.9255047678739311,9.449086222222222,786.1254666666666,19.175884953215455,128,1.3000000000000002E-4
5,test_20231031_155353,11610969.png,368720,24032,344688,0.9348231720546756,4,6,84111,3509,80602,0.9582813187335782,21.529770666666668,2995.306272,13.366391249809656,128,1.3000000000000002E-4
6,test_20231031_155353,10350842.png,212614,5642,206972,0.9734636477372139,2,5,42529,830,41699,0.9804839051000493,19.393774222222223,2404.812736,14.319990975752292,128,1.3000000000000002E-4
7,test_20231031_155353,10863862.png,317432,10677,306755,0.966364449708914,3,6,66058,1554,64504,0.9764752187471616,24.58188977777778,3464.000261333333,12.735024447582767,128,1.3000000000000002E-4
8,test_20231031_155353,11382381.png,312486,917,311569,0.9970654685329903,2,5,46745,126,46619,0.99730452454808,21.089132444444445,2412.4090613333333,14.306294097973675,128,1.3000000000000002E-4
9,test_20231031_155353,11079715.png,443815,113162,330653,0.7450243907934613,5,6,124136,15824,108312,0.872526905974093,17.42231111111111,2238.1416106666666,14.631927993255129,128,1.3000000000000002E-4
10,test_20231031_155353,11551286.png,271883,717,271166,0.9973628362199917,2,6,40092,104,39988,0.9974059662775616,17.035560888888888,1719.2356853333333,15.777449438530502,128,1.3000000000000002E-4
1,test_20231031_155354,10404007.png,502730,18534,484196,0.9631332922244544,4,6,61265,2687,58578,0.956141353138007,25.885536,3487.714848,12.705393906287338,128,1.4000000000000001E-4
2,test_20231031_155354,1254659.png,342646,69592,273054,0.7968982565096339,4,6,80080,9768,70312,0.878021978021978,21.430725333333335,3345.388144,12.88633847428336,128,1.4000000000000001E-4
3,test_20231031_155354,10188041.png,221231,9309,211922,0.9579218102345513,3,7,41731,1311,40420,0.9685845055234718,10.629137777777778,1035.1340373333333,17.980837715530228,128,1.4000000000000001E-4
4,test_20231031_155354,10287332.png,216980,12152,204828,0.9439948382339386,3,6,22337,1664,20673,0.9255047678739311,9.449086222222222,786.1254666666666,19.175884953215455,128,1.4000000000000001E-4
5,test_20231031_155354,11610969.png,368720,24032,344688,0.9348231720546756,3,6,84111,3509,80602,0.9582813187335782,21.529770666666668,2995.306272,13.366391249809656,128,1.4000000000000001E-4
6,test_20231031_155354,10350842.png,212614,5642,206972,0.9734636477372139,2,5,42529,830,41699,0.9804839051000493,19.393774222222223,2404.812736,14.319990975752292,128,1.4000000000000001E-4
7,test_20231031_155354,10863862.png,317432,10677,306755,0.966364449708914,3,5,66058,1554,64504,0.9764752187471616,24.58188977777778,3464.000261333333,12.735024447582767,128,1.4000000000000001E-4
8,test_20231031_155354,11382381.png,312486,917,311569,0.9970654685329903,3,6,46745,126,46619,0.99730452454808,21.089132444444445,2412.4090613333333,14.306294097973675,128,1.4000000000000001E-4
9,test_20231031_155354,11079715.png,443815,113162,330653,0.7450243907934613,5,6,124136,15824,108312,0.872526905974093,17.42231111111111,2238.1416106666666,14.631927993255129,128,1.4000000000000001E-4
10,test_20231031_155354,11551286.png,271883,717,271166,0.9973628362199917,3,6,40092,104,39988,0.9974059662775616,17.035560888888888,1719.2356853333333,15.777449438530502,128,1.4000000000000001E-4
1,test_20231031_155355,10404007.png,502730,18534,484196,0.9631332922244544,4,6,61265,2687,58578,0.956141353138007,25.885536,3487.714848,12.705393906287338,128,1.5000000000000001E-4
2,test_20231031_155355,1254659.png,342646,69592,273054,0.7968982565096339,4,7,80080,9768,70312,0.878021978021978,21.430725333333335,3345.388144,12.88633847428336,128,1.5000000000000001E-4
3,test_20231031_155355,10188041.png,221231,9309,211922,0.9579218102345513,3,6,41731,1311,40420,0.9685845055234718,10.629137777777778,1035.1340373333333,17.980837715530228,128,1.5000000000000001E-4
4,test_20231031_155355,10287332.png,216980,12152,204828,0.9439948382339386,2,5,22337,1664,20673,0.9255047678739311,9.449086222222222,786.1254666666666,19.175884953215455,128,1.5000000000000001E-4
5,test_20231031_155355,11610969.png,368720,24032,344688,0.9348231720546756,4,6,84111,3509,80602,0.9582813187335782,21.529770666666668,2995.306272,13.366391249809656,128,1.5000000000000001E-4
6,test_20231031_155355,10350842.png,212614,5642,206972,0.9734636477372139,2,5,42529,830,41699,0.9804839051000493,19.393774222222223,2404.812736,14.319990975752292,128,1.5000000000000001E-4
7,test_20231031_155355,10863862.png,317432,10677,306755,0.966364449708914,4,6,66058,1554,64504,0.9764752187471616,24.58188977777778,3464.000261333333,12.735024447582767,128,1.5000000000000001E-4
8,test_20231031_155355,11382381.png,312486,787,311699,0.9974814871706252,2,5,46745,107,46638,0.9977109851320997,21.347548444444445,2452.9523093333332,14.233912561978928,128,1.5000000000000001E-4
9,test_20231031_155355,11079715.png,443815,113162,330653,0.7450243907934613,5,7,124136,15824,108312,0.872526905974093,17.42231111111111,2238.1416106666666,14.631927993255129,128,1.5000000000000001E-4
10,test_20231031_155355,11551286.png,271883,717,271166,0.9973628362199917,2,5,40092,104,39988,0.9974059662775616,17.035560888888888,1719.2356853333333,15.777449438530502,128,1.5000000000000001E-4
1,test_20231031_155356,10404007.png,502730,18534,484196,0.9631332922244544,4,6,61265,2687,58578,0.956141353138007,25.885536,3487.714848,12.705393906287338,128,1.6E-4
2,test_20231031_155356,1254659.png,342646,69592,273054,0.7968982565096339,4,6,80080,9768,70312,0.878021978021978,21.430725333333335,3345.388144,12.88633847428336,128,1.6E-4
3,test_20231031_155356,10188041.png,221231,9309,211922,0.9579218102345513,3,6,41731,1311,40420,0.9685845055234718,10.629137777777778,1035.1340373333333,17.980837715530228,128,1.6E-4
4,test_20231031_155356,10287332.png,216980,11942,205038,0.9449626693704489,2,5,22337,1637,20700,0.9267135246452075,9.578848,812.8562133333334,19.03066631114696,128,1.6E-4
5,test_20231031_155356,11610969.png,368720,24032,344688,0.9348231720546756,3,6,84111,3509,80602,0.9582813187335782,21.529770666666668,2995.306272,13.366391249809656,128,1.6E-4
6,test_20231031_155356,10350842.png,212614,5642,206972,0.9734636477372139,2,5,42529,830,41699,0.9804839051000493,19.393774222222223,2404.812736,14.319990975752292,128,1.6E-4
7,test_20231031_155356,10863862.png,317432,10677,306755,0.966364449708914,4,8,66058,1554,64504,0.9764752187471616,24.58188977777778,3464.000261333333,12.735024447582767,128,1.6E-4
8,test_20231031_155356,11382381.png,312486,787,311699,0.9974814871706252,2,5,46745,107,46638,0.9977109851320997,21.347548444444445,2452.9523093333332,14.233912561978928,128,1.6E-4
9,test_20231031_155356,11079715.png,443815,113162,330653,0.7450243907934613,6,7,124136,15824,108312,0.872526905974093,17.42231111111111,2238.1416106666666,14.631927993255129,128,1.6E-4
10,test_20231031_155356,11551286.png,271883,717,271166,0.9973628362199917,2,5,40092,104,39988,0.9974059662775616,17.035560888888888,1719.2356853333333,15.777449438530502,128,1.6E-4
1,test_20231031_155357,10404007.png,502730,18534,484196,0.9631332922244544,3,5,61265,2687,58578,0.956141353138007,25.885536,3487.714848,12.705393906287338,128,1.7E-4
2,test_20231031_155357,1254659.png,342646,69592,273054,0.7968982565096339,4,7,80080,9768,70312,0.878021978021978,21.430725333333335,3345.388144,12.88633847428336,128,1.7E-4
3,test_20231031_155357,10188041.png,221231,9309,211922,0.9579218102345513,3,5,41731,1311,40420,0.9685845055234718,10.629137777777778,1035.1340373333333,17.980837715530228,128,1.7E-4
4,test_20231031_155357,10287332.png,216980,11942,205038,0.9449626693704489,3,6,22337,1637,20700,0.9267135246452075,9.578848,812.8562133333334,19.03066631114696,128,1.7E-4
5,test_20231031_155357,11610969.png,368720,24032,344688,0.9348231720546756,3,5,84111,3509,80602,0.9582813187335782,21.529770666666668,2995.306272,13.366391249809656,128,1.7E-4
6,test_20231031_155357,10350842.png,212614,5642,206972,0.9734636477372139,3,6,42529,830,41699,0.9804839051000493,19.393774222222223,2404.812736,14.319990975752292,128,1.7E-4
7,test_20231031_155357,10863862.png,317432,10677,306755,0.966364449708914,3,6,66058,1554,64504,0.9764752187471616,24.58188977777778,3464.000261333333,12.735024447582767,128,1.7E-4
8,test_20231031_155357,11382381.png,312486,787,311699,0.9974814871706252,3,6,46745,107,46638,0.9977109851320997,21.347548444444445,2452.9523093333332,14.233912561978928,128,1.7E-4
9,test_20231031_155357,11079715.png,443815,113162,330653,0.7450243907934613,8,7,124136,15824,108312,0.872526905974093,17.42231111111111,2238.1416106666666,14.631927993255129,128,1.7E-4
10,test_20231031_155357,11551286.png,271883,717,271166,0.9973628362199917,2,6,40092,104,39988,0.9974059662775616,17.035560888888888,1719.2356853333333,15.777449438530502,128,1.7E-4
1,test_20231031_155358,10404007.png,502730,18534,484196,0.9631332922244544,3,5,61265,2687,58578,0.956141353138007,25.885536,3487.714848,12.705393906287338,128,1.8E-4
2,test_20231031_155358,1254659.png,342646,69592,273054,0.7968982565096339,4,6,80080,9768,70312,0.878021978021978,21.430725333333335,3345.388144,12.88633847428336,128,1.8E-4
3,test_20231031_155358,10188041.png,221231,9309,211922,0.9579218102345513,3,6,41731,1311,40420,0.9685845055234718,10.629137777777778,1035.1340373333333,17.980837715530228,128,1.8E-4
4,test_20231031_155358,10287332.png,216980,11942,205038,0.9449626693704489,2,6,22337,1637,20700,0.9267135246452075,9.578848,812.8562133333334,19.03066631114696,128,1.8E-4
5,test_20231031_155358,11610969.png,368720,24032,344688,0.9348231720546756,3,5,84111,3509,80602,0.9582813187335782,21.529770666666668,2995.306272,13.366391249809656,128,1.8E-4
6,test_20231031_155358,10350842.png,212614,5642,206972,0.9734636477372139,2,12,42529,830,41699,0.9804839051000493,19.393774222222223,2404.812736,14.319990975752292,128,1.8E-4
7,test_20231031_155358,10863862.png,317432,10677,306755,0.966364449708914,3,5,66058,1554,64504,0.9764752187471616,24.58188977777778,3464.000261333333,12.735024447582767,128,1.8E-4
8,test_20231031_155358,11382381.png,312486,787,311699,0.9974814871706252,2,6,46745,107,46638,0.9977109851320997,21.347548444444445,2452.9523093333332,14.233912561978928,128,1.8E-4
9,test_20231031_155358,11079715.png,443815,113162,330653,0.7450243907934613,5,6,124136,15824,108312,0.872526905974093,17.42231111111111,2238.1416106666666,14.631927993255129,128,1.8E-4
10,test_20231031_155358,11551286.png,271883,717,271166,0.9973628362199917,2,5,40092,104,39988,0.9974059662775616,17.035560888888888,1719.2356853333333,15.777449438530502,128,1.8E-4
1,test_20231031_155359,10404007.png,502730,18534,484196,0.9631332922244544,4,6,61265,2687,58578,0.956141353138007,25.885536,3487.714848,12.705393906287338,128,1.9E-4
2,test_20231031_155359,1254659.png,342646,69592,273054,0.7968982565096339,4,6,80080,9768,70312,0.878021978021978,21.430725333333335,3345.388144,12.88633847428336,128,1.9E-4
3,test_20231031_155359,10188041.png,221231,9309,211922,0.9579218102345513,3,5,41731,1311,40420,0.9685845055234718,10.629137777777778,1035.1340373333333,17.980837715530228,128,1.9E-4
4,test_20231031_155359,10287332.png,216980,11942,205038,0.9449626693704489,2,6,22337,1637,20700,0.9267135246452075,9.578848,812.8562133333334,19.03066631114696,128,1.9E-4
5,test_20231031_155359,11610969.png,368720,24032,344688,0.9348231720546756,4,6,84111,3509,80602,0.9582813187335782,21.529770666666668,2995.306272,13.366391249809656,128,1.9E-4
6,test_20231031_155359,10350842.png,212614,5642,206972,0.9734636477372139,2,6,42529,830,41699,0.9804839051000493,19.393774222222223,2404.812736,14.319990975752292,128,1.9E-4
7,test_20231031_155359,10863862.png,317432,10677,306755,0.966364449708914,3,6,66058,1554,64504,0.9764752187471616,24.58188977777778,3464.000261333333,12.735024447582767,128,1.9E-4
8,test_20231031_155359,11382381.png,312486,787,311699,0.9974814871706252,2,6,46745,107,46638,0.9977109851320997,21.347548444444445,2452.9523093333332,14.233912561978928,128,1.9E-4
9,test_20231031_155359,11079715.png,443815,113162,330653,0.7450243907934613,5,7,124136,15824,108312,0.872526905974093,17.42231111111111,2238.1416106666666,14.631927993255129,128,1.9E-4
10,test_20231031_155359,11551286.png,271883,717,271166,0.9973628362199917,2,6,40092,104,39988,0.9974059662775616,17.035560888888888,1719.2356853333333,15.777449438530502,128,1.9E-4
1,test_20231031_155400,10404007.png,502730,18534,484196,0.9631332922244544,4,6,61265,2687,58578,0.956141353138007,25.885536,3487.714848,12.705393906287338,128,2.0E-4
2,test_20231031_155400,1254659.png,342646,69592,273054,0.7968982565096339,4,6,80080,9768,70312,0.878021978021978,21.430725333333335,3345.388144,12.88633847428336,128,2.0E-4
3,test_20231031_155400,10188041.png,221231,9309,211922,0.9579218102345513,3,6,41731,1311,40420,0.9685845055234718,10.629137777777778,1035.1340373333333,17.980837715530228,128,2.0E-4
4,test_20231031_155400,10287332.png,216980,11942,205038,0.9449626693704489,2,6,22337,1637,20700,0.9267135246452075,9.578848,812.8562133333334,19.03066631114696,128,2.0E-4
5,test_20231031_155400,11610969.png,368720,24032,344688,0.9348231720546756,4,6,84111,3509,80602,0.9582813187335782,21.529770666666668,2995.306272,13.366391249809656,128,2.0E-4
6,test_20231031_155400,10350842.png,212614,5642,206972,0.9734636477372139,3,6,42529,830,41699,0.9804839051000493,19.393774222222223,2404.812736,14.319990975752292,128,2.0E-4
7,test_20231031_155400,10863862.png,317432,10677,306755,0.966364449708914,3,7,66058,1554,64504,0.9764752187471616,24.58188977777778,3464.000261333333,12.735024447582767,128,2.0E-4
8,test_20231031_155400,11382381.png,312486,787,311699,0.9974814871706252,3,7,46745,107,46638,0.9977109851320997,21.347548444444445,2452.9523093333332,14.233912561978928,128,2.0E-4
9,test_20231031_155400,11079715.png,443815,113162,330653,0.7450243907934613,6,8,124136,15824,108312,0.872526905974093,17.42231111111111,2238.1416106666666,14.631927993255129,128,2.0E-4
10,test_20231031_155400,11551286.png,271883,597,271286,0.9978042025430056,3,6,40092,86,40006,0.997854933652599,17.58564977777778,1815.0887466666666,15.541824966498465,128,2.0E-4
1,test_20231031_155401,10404007.png,502730,18534,484196,0.9631332922244544,4,6,61265,2687,58578,0.956141353138007,25.885536,3487.714848,12.705393906287338,128,2.1E-4
2,test_20231031_155401,1254659.png,342646,69592,273054,0.7968982565096339,5,7,80080,9768,70312,0.878021978021978,21.430725333333335,3345.388144,12.88633847428336,128,2.1E-4
3,test_20231031_155401,10188041.png,221231,9309,211922,0.9579218102345513,3,6,41731,1311,40420,0.9685845055234718,10.629137777777778,1035.1340373333333,17.980837715530228,128,2.1E-4
4,test_20231031_155401,10287332.png,216980,11942,205038,0.9449626693704489,3,6,22337,1637,20700,0.9267135246452075,9.578848,812.8562133333334,19.03066631114696,128,2.1E-4
5,test_20231031_155401,11610969.png,368720,24032,344688,0.9348231720546756,6,8,84111,3509,80602,0.9582813187335782,21.529770666666668,2995.306272,13.366391249809656,128,2.1E-4
6,test_20231031_155401,10350842.png,212614,5642,206972,0.9734636477372139,3,8,42529,830,41699,0.9804839051000493,19.393774222222223,2404.812736,14.319990975752292,128,2.1E-4
7,test_20231031_155401,10863862.png,317432,10677,306755,0.966364449708914,4,7,66058,1554,64504,0.9764752187471616,24.58188977777778,3464.000261333333,12.735024447582767,128,2.1E-4
8,test_20231031_155401,11382381.png,312486,787,311699,0.9974814871706252,3,6,46745,107,46638,0.9977109851320997,21.347548444444445,2452.9523093333332,14.233912561978928,128,2.1E-4
9,test_20231031_155401,11079715.png,443815,113162,330653,0.7450243907934613,5,6,124136,15824,108312,0.872526905974093,17.42231111111111,2238.1416106666666,14.631927993255129,128,2.1E-4
10,test_20231031_155401,11551286.png,271883,597,271286,0.9978042025430056,2,6,40092,86,40006,0.997854933652599,17.58564977777778,1815.0887466666666,15.541824966498465,128,2.1E-4
1,test_20231031_155402,10404007.png,502730,18534,484196,0.9631332922244544,3,5,61265,2687,58578,0.956141353138007,25.885536,3487.714848,12.705393906287338,128,2.2E-4
2,test_20231031_155402,1254659.png,342646,69592,273054,0.7968982565096339,4,6,80080,9768,70312,0.878021978021978,21.430725333333335,3345.388144,12.88633847428336,128,2.2E-4
3,test_20231031_155402,10188041.png,221231,9309,211922,0.9579218102345513,3,6,41731,1311,40420,0.9685845055234718,10.629137777777778,1035.1340373333333,17.980837715530228,128,2.2E-4
4,test_20231031_155402,10287332.png,216980,11942,205038,0.9449626693704489,2,5,22337,1637,20700,0.9267135246452075,9.578848,812.8562133333334,19.03066631114696,128,2.2E-4
5,test_20231031_155402,11610969.png,368720,24032,344688,0.9348231720546756,4,6,84111,3509,80602,0.9582813187335782,21.529770666666668,2995.306272,13.366391249809656,128,2.2E-4
6,test_20231031_155402,10350842.png,212614,5642,206972,0.9734636477372139,3,6,42529,830,41699,0.9804839051000493,19.393774222222223,2404.812736,14.319990975752292,128,2.2E-4
7,test_20231031_155402,10863862.png,317432,10677,306755,0.966364449708914,4,5,66058,1554,64504,0.9764752187471616,24.58188977777778,3464.000261333333,12.735024447582767,128,2.2E-4
8,test_20231031_155402,11382381.png,312486,787,311699,0.9974814871706252,3,7,46745,107,46638,0.9977109851320997,21.347548444444445,2452.9523093333332,14.233912561978928,128,2.2E-4
9,test_20231031_155402,11079715.png,443815,113162,330653,0.7450243907934613,10,12,124136,15824,108312,0.872526905974093,17.42231111111111,2238.1416106666666,14.631927993255129,128,2.2E-4
10,test_20231031_155402,11551286.png,271883,597,271286,0.9978042025430056,3,6,40092,86,40006,0.997854933652599,17.58564977777778,1815.0887466666666,15.541824966498465,128,2.2E-4
1,test_20231031_155403,10404007.png,502730,18534,484196,0.9631332922244544,4,7,61265,2687,58578,0.956141353138007,25.885536,3487.714848,12.705393906287338,128,2.3E-4
2,test_20231031_155403,1254659.png,342646,69592,273054,0.7968982565096339,4,6,80080,9768,70312,0.878021978021978,21.430725333333335,3345.388144,12.88633847428336,128,2.3E-4
3,test_20231031_155403,10188041.png,221231,9309,211922,0.9579218102345513,3,5,41731,1311,40420,0.9685845055234718,10.629137777777778,1035.1340373333333,17.980837715530228,128,2.3E-4
4,test_20231031_155403,10287332.png,216980,11942,205038,0.9449626693704489,3,6,22337,1637,20700,0.9267135246452075,9.578848,812.8562133333334,19.03066631114696,128,2.3E-4
5,test_20231031_155403,11610969.png,368720,24032,344688,0.9348231720546756,4,7,84111,3509,80602,0.9582813187335782,21.529770666666668,2995.306272,13.366391249809656,128,2.3E-4
6,test_20231031_155403,10350842.png,212614,5642,206972,0.9734636477372139,3,7,42529,830,41699,0.9804839051000493,19.393774222222223,2404.812736,14.319990975752292,128,2.3E-4
7,test_20231031_155403,10863862.png,317432,10677,306755,0.966364449708914,3,6,66058,1554,64504,0.9764752187471616,24.58188977777778,3464.000261333333,12.735024447582767,128,2.3E-4
8,test_20231031_155403,11382381.png,312486,787,311699,0.9974814871706252,2,6,46745,107,46638,0.9977109851320997,21.347548444444445,2452.9523093333332,14.233912561978928,128,2.3E-4
9,test_20231031_155403,11079715.png,443815,113162,330653,0.7450243907934613,7,9,124136,15824,108312,0.872526905974093,17.42231111111111,2238.1416106666666,14.631927993255129,128,2.3E-4
10,test_20231031_155403,11551286.png,271883,327,271556,0.998797276769787,3,7,40092,46,40046,0.99885263893046,17.867866666666668,1859.2518453333332,15.437421396648572,128,2.3E-4
1,test_20231031_155405,10404007.png,502730,18534,484196,0.9631332922244544,4,7,61265,2687,58578,0.956141353138007,25.885536,3487.714848,12.705393906287338,128,2.4E-4
2,test_20231031_155405,1254659.png,342646,69592,273054,0.7968982565096339,4,7,80080,9768,70312,0.878021978021978,21.430725333333335,3345.388144,12.88633847428336,128,2.4E-4
3,test_20231031_155405,10188041.png,221231,9309,211922,0.9579218102345513,3,5,41731,1311,40420,0.9685845055234718,10.629137777777778,1035.1340373333333,17.980837715530228,128,2.4E-4
4,test_20231031_155405,10287332.png,216980,11942,205038,0.9449626693704489,2,6,22337,1637,20700,0.9267135246452075,9.578848,812.8562133333334,19.03066631114696,128,2.4E-4
5,test_20231031_155405,11610969.png,368720,24032,344688,0.9348231720546756,4,6,84111,3509,80602,0.9582813187335782,21.529770666666668,2995.306272,13.366391249809656,128,2.4E-4
6,test_20231031_155405,10350842.png,212614,5642,206972,0.9734636477372139,2,5,42529,830,41699,0.9804839051000493,19.393774222222223,2404.812736,14.319990975752292,128,2.4E-4
7,test_20231031_155405,10863862.png,317432,10677,306755,0.966364449708914,4,6,66058,1554,64504,0.9764752187471616,24.58188977777778,3464.000261333333,12.735024447582767,128,2.4E-4
8,test_20231031_155405,11382381.png,312486,787,311699,0.9974814871706252,3,6,46745,107,46638,0.9977109851320997,21.347548444444445,2452.9523093333332,14.233912561978928,128,2.4E-4
9,test_20231031_155405,11079715.png,443815,113162,330653,0.7450243907934613,8,10,124136,15824,108312,0.872526905974093,17.42231111111111,2238.1416106666666,14.631927993255129,128,2.4E-4
10,test_20231031_155405,11551286.png,271883,327,271556,0.998797276769787,3,8,40092,46,40046,0.99885263893046,17.867866666666668,1859.2518453333332,15.437421396648572,128,2.4E-4
1,test_20231031_155406,10404007.png,502730,18534,484196,0.9631332922244544,5,24,61265,2687,58578,0.956141353138007,25.885536,3487.714848,12.705393906287338,128,2.5E-4
2,test_20231031_155406,1254659.png,342646,69592,273054,0.7968982565096339,8,11,80080,9768,70312,0.878021978021978,21.430725333333335,3345.388144,12.88633847428336,128,2.5E-4
3,test_20231031_155406,10188041.png,221231,9309,211922,0.9579218102345513,3,7,41731,1311,40420,0.9685845055234718,10.629137777777778,1035.1340373333333,17.980837715530228,128,2.5E-4
4,test_20231031_155406,10287332.png,216980,11942,205038,0.9449626693704489,2,5,22337,1637,20700,0.9267135246452075,9.578848,812.8562133333334,19.03066631114696,128,2.5E-4
5,test_20231031_155406,11610969.png,368720,24032,344688,0.9348231720546756,4,6,84111,3509,80602,0.9582813187335782,21.529770666666668,2995.306272,13.366391249809656,128,2.5E-4
6,test_20231031_155406,10350842.png,212614,5642,206972,0.9734636477372139,2,5,42529,830,41699,0.9804839051000493,19.393774222222223,2404.812736,14.319990975752292,128,2.5E-4
7,test_20231031_155406,10863862.png,317432,10677,306755,0.966364449708914,4,6,66058,1554,64504,0.9764752187471616,24.58188977777778,3464.000261333333,12.735024447582767,128,2.5E-4
8,test_20231031_155406,11382381.png,312486,787,311699,0.9974814871706252,3,6,46745,107,46638,0.9977109851320997,21.347548444444445,2452.9523093333332,14.233912561978928,128,2.5E-4
9,test_20231031_155406,11079715.png,443815,113162,330653,0.7450243907934613,5,14,124136,15824,108312,0.872526905974093,17.42231111111111,2238.1416106666666,14.631927993255129,128,2.5E-4
10,test_20231031_155406,11551286.png,271883,327,271556,0.998797276769787,2,6,40092,46,40046,0.99885263893046,17.867866666666668,1859.2518453333332,15.437421396648572,128,2.5E-4
1,test_20231031_155407,10404007.png,502730,18032,484698,0.9641318401527659,3,6,61265,2618,58647,0.9572676079327511,25.992037333333332,3511.230128,12.676210665648235,128,2.6000000000000003E-4
2,test_20231031_155407,1254659.png,342646,69532,273114,0.7970733643468769,4,6,80080,9762,70318,0.8780969030969031,21.44027911111111,3346.4703306666665,12.884933819048644,128,2.6000000000000003E-4
3,test_20231031_155407,10188041.png,221231,9269,211962,0.958102616721888,3,6,41731,1305,40426,0.9687282835302293,10.994965333333333,1087.4147413333333,17.76685144730885,128,2.6000000000000003E-4
4,test_20231031_155407,10287332.png,216980,11942,205038,0.9449626693704489,3,7,22337,1637,20700,0.9267135246452075,9.578848,812.8562133333334,19.03066631114696,128,2.6000000000000003E-4
5,test_20231031_155407,11610969.png,368720,23467,345253,0.9363555001084833,8,14,84111,3427,80684,0.9592562209461307,22.418577777777777,3189.8884373333335,13.093048664934157,128,2.6000000000000003E-4
6,test_20231031_155407,10350842.png,212614,5562,207052,0.9738399164683417,4,7,42529,818,41711,0.9807660655082414,19.46256711111111,2410.5704426666666,14.30960533734045,128,2.6000000000000003E-4
7,test_20231031_155407,10863862.png,317432,10557,306875,0.966742483429522,4,7,66058,1536,64522,0.976747706560901,24.63304711111111,3467.3115253333335,12.730874976784207,128,2.6000000000000003E-4
8,test_20231031_155407,11382381.png,312486,667,311819,0.997865504374596,2,5,46745,89,46656,0.9980960530538026,21.842074666666665,2522.8946186666667,14.11181250456314,128,2.6000000000000003E-4
9,test_20231031_155407,11079715.png,443815,113162,330653,0.7450243907934613,7,7,124136,15824,108312,0.872526905974093,17.42231111111111,2238.1416106666666,14.631927993255129,128,2.6000000000000003E-4
10,test_20231031_155407,11551286.png,271883,267,271616,0.9990179599312939,2,5,40092,37,40055,0.9990771226179787,18.016108444444445,1877.54488,15.394900338849709,128,2.6000000000000003E-4
1,test_20231031_155408,10404007.png,502730,18032,484698,0.9641318401527659,3,5,61265,2618,58647,0.9572676079327511,25.992037333333332,3511.230128,12.676210665648235,128,2.7000000000000006E-4
2,test_20231031_155408,1254659.png,342646,69532,273114,0.7970733643468769,5,6,80080,9762,70318,0.8780969030969031,21.44027911111111,3346.4703306666665,12.884933819048644,128,2.7000000000000006E-4
3,test_20231031_155408,10188041.png,221231,9269,211962,0.958102616721888,3,6,41731,1305,40426,0.9687282835302293,10.994965333333333,1087.4147413333333,17.76685144730885,128,2.7000000000000006E-4
4,test_20231031_155408,10287332.png,216980,11942,205038,0.9449626693704489,2,5,22337,1637,20700,0.9267135246452075,9.578848,812.8562133333334,19.03066631114696,128,2.7000000000000006E-4
5,test_20231031_155408,11610969.png,368720,23467,345253,0.9363555001084833,4,6,84111,3427,80684,0.9592562209461307,22.418577777777777,3189.8884373333335,13.093048664934157,128,2.7000000000000006E-4
6,test_20231031_155408,10350842.png,212614,5562,207052,0.9738399164683417,2,6,42529,818,41711,0.9807660655082414,19.46256711111111,2410.5704426666666,14.30960533734045,128,2.7000000000000006E-4
7,test_20231031_155408,10863862.png,317432,10557,306875,0.966742483429522,4,6,66058,1536,64522,0.976747706560901,24.63304711111111,3467.3115253333335,12.730874976784207,128,2.7000000000000006E-4
8,test_20231031_155408,11382381.png,312486,667,311819,0.997865504374596,3,6,46745,89,46656,0.9980960530538026,21.842074666666665,2522.8946186666667,14.11181250456314,128,2.7000000000000006E-4
9,test_20231031_155408,11079715.png,443815,113162,330653,0.7450243907934613,5,7,124136,15824,108312,0.872526905974093,17.42231111111111,2238.1416106666666,14.631927993255129,128,2.7000000000000006E-4
10,test_20231031_155408,11551286.png,271883,267,271616,0.9990179599312939,2,13,40092,37,40055,0.9990771226179787,18.016108444444445,1877.54488,15.394900338849709,128,2.7000000000000006E-4
1,test_20231031_155409,10404007.png,502730,18032,484698,0.9641318401527659,3,6,61265,2618,58647,0.9572676079327511,25.992037333333332,3511.230128,12.676210665648235,128,2.800000000000001E-4
2,test_20231031_155409,1254659.png,342646,69532,273114,0.7970733643468769,5,8,80080,9762,70318,0.8780969030969031,21.44027911111111,3346.4703306666665,12.884933819048644,128,2.800000000000001E-4
3,test_20231031_155409,10188041.png,221231,9269,211962,0.958102616721888,5,10,41731,1305,40426,0.9687282835302293,10.994965333333333,1087.4147413333333,17.76685144730885,128,2.800000000000001E-4
4,test_20231031_155409,10287332.png,216980,11942,205038,0.9449626693704489,6,13,22337,1637,20700,0.9267135246452075,9.578848,812.8562133333334,19.03066631114696,128,2.800000000000001E-4
5,test_20231031_155409,11610969.png,368720,23467,345253,0.9363555001084833,6,8,84111,3427,80684,0.9592562209461307,22.418577777777777,3189.8884373333335,13.093048664934157,128,2.800000000000001E-4
6,test_20231031_155409,10350842.png,212614,5562,207052,0.9738399164683417,3,7,42529,818,41711,0.9807660655082414,19.46256711111111,2410.5704426666666,14.30960533734045,128,2.800000000000001E-4
7,test_20231031_155409,10863862.png,317432,10557,306875,0.966742483429522,3,6,66058,1536,64522,0.976747706560901,24.63304711111111,3467.3115253333335,12.730874976784207,128,2.800000000000001E-4
8,test_20231031_155409,11382381.png,312486,667,311819,0.997865504374596,3,7,46745,89,46656,0.9980960530538026,21.842074666666665,2522.8946186666667,14.11181250456314,128,2.800000000000001E-4
9,test_20231031_155409,11079715.png,443815,113162,330653,0.7450243907934613,6,7,124136,15824,108312,0.872526905974093,17.42231111111111,2238.1416106666666,14.631927993255129,128,2.800000000000001E-4
10,test_20231031_155409,11551286.png,271883,267,271616,0.9990179599312939,4,10,40092,37,40055,0.9990771226179787,18.016108444444445,1877.54488,15.394900338849709,128,2.800000000000001E-4
1,test_20231031_155411,10404007.png,502730,18032,484698,0.9641318401527659,9,28,61265,2618,58647,0.9572676079327511,25.992037333333332,3511.230128,12.676210665648235,128,2.900000000000001E-4
2,test_20231031_155411,1254659.png,342646,69532,273114,0.7970733643468769,6,8,80080,9762,70318,0.8780969030969031,21.44027911111111,3346.4703306666665,12.884933819048644,128,2.900000000000001E-4
3,test_20231031_155411,10188041.png,221231,9269,211962,0.958102616721888,4,8,41731,1305,40426,0.9687282835302293,10.994965333333333,1087.4147413333333,17.76685144730885,128,2.900000000000001E-4
4,test_20231031_155411,10287332.png,216980,11942,205038,0.9449626693704489,3,7,22337,1637,20700,0.9267135246452075,9.578848,812.8562133333334,19.03066631114696,128,2.900000000000001E-4
5,test_20231031_155411,11610969.png,368720,23467,345253,0.9363555001084833,5,8,84111,3427,80684,0.9592562209461307,22.418577777777777,3189.8884373333335,13.093048664934157,128,2.900000000000001E-4
6,test_20231031_155411,10350842.png,212614,5562,207052,0.9738399164683417,3,8,42529,818,41711,0.9807660655082414,19.46256711111111,2410.5704426666666,14.30960533734045,128,2.900000000000001E-4
7,test_20231031_155411,10863862.png,317432,10557,306875,0.966742483429522,4,7,66058,1536,64522,0.976747706560901,24.63304711111111,3467.3115253333335,12.730874976784207,128,2.900000000000001E-4
8,test_20231031_155411,11382381.png,312486,667,311819,0.997865504374596,3,6,46745,89,46656,0.9980960530538026,21.842074666666665,2522.8946186666667,14.11181250456314,128,2.900000000000001E-4
9,test_20231031_155411,11079715.png,443815,113162,330653,0.7450243907934613,5,7,124136,15824,108312,0.872526905974093,17.42231111111111,2238.1416106666666,14.631927993255129,128,2.900000000000001E-4
10,test_20231031_155411,11551286.png,271883,267,271616,0.9990179599312939,2,6,40092,37,40055,0.9990771226179787,18.016108444444445,1877.54488,15.394900338849709,128,2.900000000000001E-4
1,test_20231031_155412,10404007.png,502730,17447,485283,0.9652954866429296,4,6,61265,2534,58731,0.9586387007263527,26.03058311111111,3527.0062986666667,12.656741256195492,129,1.0E-5
2,test_20231031_155412,1254659.png,342646,67202,275444,0.8038733853598174,4,6,80080,9440,70640,0.8821178821178821,21.685260444444445,3425.6872266666664,12.78332652540119,129,1.0E-5
3,test_20231031_155412,10188041.png,221231,8907,212324,0.9597389154322857,3,5,41731,1262,40469,0.9697586925786585,10.89088711111111,1117.198944,17.64949844343051,129,1.0E-5
4,test_20231031_155412,10287332.png,216980,11792,205188,0.945653977325099,3,6,22337,1617,20720,0.9276089000313381,9.499649777777778,803.2418826666667,19.082340154783257,129,1.0E-5
5,test_20231031_155412,11610969.png,368720,22372,346348,0.9393252332393144,4,6,84111,3270,80841,0.9611228020116275,22.074186666666666,3125.7853333333333,13.18121211800863,129,1.0E-5
6,test_20231031_155412,10350842.png,212614,5359,207255,0.9747946983735785,2,5,42529,788,41741,0.9814714665287215,19.497994666666667,2427.775552,14.27871827160568,129,1.0E-5
7,test_20231031_155412,10863862.png,317432,9932,307500,0.9687114090576879,3,6,66058,1452,64606,0.9780193163583517,25.005619555555555,3556.4882826666667,12.620589786737968,129,1.0E-5
8,test_20231031_155412,11382381.png,312486,827,311659,0.9973534814359684,2,5,46745,113,46632,0.9975826291581987,20.486714666666668,2360.4332106666666,14.400886444502593,129,1.0E-5
9,test_20231031_155412,11079715.png,443815,110349,333466,0.7513626173067607,5,7,124136,15456,108680,0.8754913965328349,17.57312,2279.878944,14.551685732308561,129,1.0E-5
10,test_20231031_155412,11551286.png,271883,917,270966,0.9966272256816351,5,5,40092,134,39958,0.9966576873191659,15.950851555555555,1533.329888,16.274447597479135,129,1.0E-5
1,test_20231031_155413,10404007.png,502730,17447,485283,0.9652954866429296,3,5,61265,2534,58731,0.9586387007263527,26.03058311111111,3527.0062986666667,12.656741256195492,129,2.0E-5
2,test_20231031_155413,1254659.png,342646,67202,275444,0.8038733853598174,4,6,80080,9440,70640,0.8821178821178821,21.685260444444445,3425.6872266666664,12.78332652540119,129,2.0E-5
3,test_20231031_155413,10188041.png,221231,8907,212324,0.9597389154322857,3,6,41731,1262,40469,0.9697586925786585,10.89088711111111,1117.198944,17.64949844343051,129,2.0E-5
4,test_20231031_155413,10287332.png,216980,11792,205188,0.945653977325099,3,6,22337,1617,20720,0.9276089000313381,9.499649777777778,803.2418826666667,19.082340154783257,129,2.0E-5
5,test_20231031_155413,11610969.png,368720,22372,346348,0.9393252332393144,3,6,84111,3270,80841,0.9611228020116275,22.074186666666666,3125.7853333333333,13.18121211800863,129,2.0E-5
6,test_20231031_155413,10350842.png,212614,5359,207255,0.9747946983735785,2,6,42529,788,41741,0.9814714665287215,19.497994666666667,2427.775552,14.27871827160568,129,2.0E-5
7,test_20231031_155413,10863862.png,317432,7622,309810,0.9759885581793896,2,6,66058,1113,64945,0.9831511701837778,35.65140977777778,6505.424832,9.998046977614175,129,2.0E-5
8,test_20231031_155413,11382381.png,312486,827,311659,0.9973534814359684,3,6,46745,113,46632,0.9975826291581987,20.486714666666668,2360.4332106666666,14.400886444502593,129,2.0E-5
9,test_20231031_155413,11079715.png,443815,110349,333466,0.7513626173067607,5,6,124136,15456,108680,0.8754913965328349,17.57312,2279.878944,14.551685732308561,129,2.0E-5
10,test_20231031_155413,11551286.png,271883,917,270966,0.9966272256816351,3,6,40092,134,39958,0.9966576873191659,15.950851555555555,1533.329888,16.274447597479135,129,2.0E-5
1,test_20231031_155414,10404007.png,502730,17447,485283,0.9652954866429296,3,5,61265,2534,58731,0.9586387007263527,26.03058311111111,3527.0062986666667,12.656741256195492,129,3.0000000000000004E-5
2,test_20231031_155414,1254659.png,342646,67202,275444,0.8038733853598174,5,6,80080,9440,70640,0.8821178821178821,21.685260444444445,3425.6872266666664,12.78332652540119,129,3.0000000000000004E-5
3,test_20231031_155414,10188041.png,221231,8907,212324,0.9597389154322857,3,6,41731,1262,40469,0.9697586925786585,10.89088711111111,1117.198944,17.64949844343051,129,3.0000000000000004E-5
4,test_20231031_155414,10287332.png,216980,11792,205188,0.945653977325099,3,5,22337,1617,20720,0.9276089000313381,9.499649777777778,803.2418826666667,19.082340154783257,129,3.0000000000000004E-5
5,test_20231031_155414,11610969.png,368720,22372,346348,0.9393252332393144,3,6,84111,3270,80841,0.9611228020116275,22.074186666666666,3125.7853333333333,13.18121211800863,129,3.0000000000000004E-5
6,test_20231031_155414,10350842.png,212614,5359,207255,0.9747946983735785,10,6,42529,788,41741,0.9814714665287215,19.497994666666667,2427.775552,14.27871827160568,129,3.0000000000000004E-5
7,test_20231031_155414,10863862.png,317432,7622,309810,0.9759885581793896,3,7,66058,1113,64945,0.9831511701837778,35.65140977777778,6505.424832,9.998046977614175,129,3.0000000000000004E-5
8,test_20231031_155414,11382381.png,312486,827,311659,0.9973534814359684,2,5,46745,113,46632,0.9975826291581987,20.486714666666668,2360.4332106666666,14.400886444502593,129,3.0000000000000004E-5
9,test_20231031_155414,11079715.png,443815,110349,333466,0.7513626173067607,5,7,124136,15456,108680,0.8754913965328349,17.57312,2279.878944,14.551685732308561,129,3.0000000000000004E-5
10,test_20231031_155414,11551286.png,271883,917,270966,0.9966272256816351,2,6,40092,134,39958,0.9966576873191659,15.950851555555555,1533.329888,16.274447597479135,129,3.0000000000000004E-5
1,test_20231031_155415,10404007.png,502730,17447,485283,0.9652954866429296,3,6,61265,2534,58731,0.9586387007263527,26.03058311111111,3527.0062986666667,12.656741256195492,129,4.0E-5
2,test_20231031_155415,1254659.png,342646,67202,275444,0.8038733853598174,5,6,80080,9440,70640,0.8821178821178821,21.685260444444445,3425.6872266666664,12.78332652540119,129,4.0E-5
3,test_20231031_155415,10188041.png,221231,8907,212324,0.9597389154322857,2,5,41731,1262,40469,0.9697586925786585,10.89088711111111,1117.198944,17.64949844343051,129,4.0E-5
4,test_20231031_155415,10287332.png,216980,11792,205188,0.945653977325099,2,5,22337,1617,20720,0.9276089000313381,9.499649777777778,803.2418826666667,19.082340154783257,129,4.0E-5
5,test_20231031_155415,11610969.png,368720,22372,346348,0.9393252332393144,3,6,84111,3270,80841,0.9611228020116275,22.074186666666666,3125.7853333333333,13.18121211800863,129,4.0E-5
6,test_20231031_155415,10350842.png,212614,5359,207255,0.9747946983735785,2,5,42529,788,41741,0.9814714665287215,19.497994666666667,2427.775552,14.27871827160568,129,4.0E-5
7,test_20231031_155415,10863862.png,317432,7622,309810,0.9759885581793896,3,6,66058,1113,64945,0.9831511701837778,35.65140977777778,6505.424832,9.998046977614175,129,4.0E-5
8,test_20231031_155415,11382381.png,312486,827,311659,0.9973534814359684,3,6,46745,113,46632,0.9975826291581987,20.486714666666668,2360.4332106666666,14.400886444502593,129,4.0E-5
9,test_20231031_155415,11079715.png,443815,110349,333466,0.7513626173067607,6,7,124136,15456,108680,0.8754913965328349,17.57312,2279.878944,14.551685732308561,129,4.0E-5
10,test_20231031_155415,11551286.png,271883,917,270966,0.9966272256816351,2,5,40092,134,39958,0.9966576873191659,15.950851555555555,1533.329888,16.274447597479135,129,4.0E-5
1,test_20231031_155416,10404007.png,502730,17447,485283,0.9652954866429296,3,5,61265,2534,58731,0.9586387007263527,26.03058311111111,3527.0062986666667,12.656741256195492,129,5.0E-5
2,test_20231031_155416,1254659.png,342646,67202,275444,0.8038733853598174,7,6,80080,9440,70640,0.8821178821178821,21.685260444444445,3425.6872266666664,12.78332652540119,129,5.0E-5
3,test_20231031_155416,10188041.png,221231,8907,212324,0.9597389154322857,3,6,41731,1262,40469,0.9697586925786585,10.89088711111111,1117.198944,17.64949844343051,129,5.0E-5
4,test_20231031_155416,10287332.png,216980,11792,205188,0.945653977325099,2,5,22337,1617,20720,0.9276089000313381,9.499649777777778,803.2418826666667,19.082340154783257,129,5.0E-5
5,test_20231031_155416,11610969.png,368720,22372,346348,0.9393252332393144,4,6,84111,3270,80841,0.9611228020116275,22.074186666666666,3125.7853333333333,13.18121211800863,129,5.0E-5
6,test_20231031_155416,10350842.png,212614,5359,207255,0.9747946983735785,2,5,42529,788,41741,0.9814714665287215,19.497994666666667,2427.775552,14.27871827160568,129,5.0E-5
7,test_20231031_155416,10863862.png,317432,7622,309810,0.9759885581793896,3,6,66058,1113,64945,0.9831511701837778,35.65140977777778,6505.424832,9.998046977614175,129,5.0E-5
8,test_20231031_155416,11382381.png,312486,817,311669,0.9973854828696326,2,5,46745,112,46633,0.9976040218205156,21.216531555555555,2458.9940213333334,14.223228880483061,129,5.0E-5
9,test_20231031_155416,11079715.png,443815,110349,333466,0.7513626173067607,5,6,124136,15456,108680,0.8754913965328349,17.57312,2279.878944,14.551685732308561,129,5.0E-5
10,test_20231031_155416,11551286.png,271883,917,270966,0.9966272256816351,3,5,40092,134,39958,0.9966576873191659,15.950851555555555,1533.329888,16.274447597479135,129,5.0E-5
1,test_20231031_155417,10404007.png,502730,17447,485283,0.9652954866429296,3,5,61265,2534,58731,0.9586387007263527,26.03058311111111,3527.0062986666667,12.656741256195492,129,6.0E-5
2,test_20231031_155417,1254659.png,342646,67202,275444,0.8038733853598174,4,6,80080,9440,70640,0.8821178821178821,21.685260444444445,3425.6872266666664,12.78332652540119,129,6.0E-5
3,test_20231031_155417,10188041.png,221231,8907,212324,0.9597389154322857,4,5,41731,1262,40469,0.9697586925786585,10.89088711111111,1117.198944,17.64949844343051,129,6.0E-5
4,test_20231031_155417,10287332.png,216980,11792,205188,0.945653977325099,3,5,22337,1617,20720,0.9276089000313381,9.499649777777778,803.2418826666667,19.082340154783257,129,6.0E-5
5,test_20231031_155417,11610969.png,368720,22372,346348,0.9393252332393144,4,6,84111,3270,80841,0.9611228020116275,22.074186666666666,3125.7853333333333,13.18121211800863,129,6.0E-5
6,test_20231031_155417,10350842.png,212614,5359,207255,0.9747946983735785,2,5,42529,788,41741,0.9814714665287215,19.497994666666667,2427.775552,14.27871827160568,129,6.0E-5
7,test_20231031_155417,10863862.png,317432,7622,309810,0.9759885581793896,3,6,66058,1113,64945,0.9831511701837778,35.65140977777778,6505.424832,9.998046977614175,129,6.0E-5
8,test_20231031_155417,11382381.png,312486,817,311669,0.9973854828696326,3,6,46745,112,46633,0.9976040218205156,21.216531555555555,2458.9940213333334,14.223228880483061,129,6.0E-5
9,test_20231031_155417,11079715.png,443815,110349,333466,0.7513626173067607,5,6,124136,15456,108680,0.8754913965328349,17.57312,2279.878944,14.551685732308561,129,6.0E-5
10,test_20231031_155417,11551286.png,271883,917,270966,0.9966272256816351,2,5,40092,134,39958,0.9966576873191659,15.950851555555555,1533.329888,16.274447597479135,129,6.0E-5
1,test_20231031_155418,10404007.png,502730,17207,485523,0.9657728800747917,3,6,61265,2499,58766,0.9592099893903534,26.117214222222223,3546.187088,12.633187167032132,129,7.000000000000001E-5
2,test_20231031_155418,1254659.png,342646,67202,275444,0.8038733853598174,5,6,80080,9440,70640,0.8821178821178821,21.685260444444445,3425.6872266666664,12.78332652540119,129,7.000000000000001E-5
3,test_20231031_155418,10188041.png,221231,8907,212324,0.9597389154322857,3,6,41731,1262,40469,0.9697586925786585,10.89088711111111,1117.198944,17.64949844343051,129,7.000000000000001E-5
4,test_20231031_155418,10287332.png,216980,11792,205188,0.945653977325099,3,6,22337,1617,20720,0.9276089000313381,9.499649777777778,803.2418826666667,19.082340154783257,129,7.000000000000001E-5
5,test_20231031_155418,11610969.png,368720,22372,346348,0.9393252332393144,3,6,84111,3270,80841,0.9611228020116275,22.074186666666666,3125.7853333333333,13.18121211800863,129,7.000000000000001E-5
6,test_20231031_155418,10350842.png,212614,5359,207255,0.9747946983735785,3,6,42529,788,41741,0.9814714665287215,19.497994666666667,2427.775552,14.27871827160568,129,7.000000000000001E-5
7,test_20231031_155418,10863862.png,317432,7622,309810,0.9759885581793896,3,6,66058,1113,64945,0.9831511701837778,35.65140977777778,6505.424832,9.998046977614175,129,7.000000000000001E-5
8,test_20231031_155418,11382381.png,312486,817,311669,0.9973854828696326,3,6,46745,112,46633,0.9976040218205156,21.216531555555555,2458.9940213333334,14.223228880483061,129,7.000000000000001E-5
9,test_20231031_155418,11079715.png,443815,110349,333466,0.7513626173067607,5,7,124136,15456,108680,0.8754913965328349,17.57312,2279.878944,14.551685732308561,129,7.000000000000001E-5
10,test_20231031_155418,11551286.png,271883,737,271146,0.9972892751661561,3,6,40092,107,39985,0.997331138381722,16.330346666666667,1599.3003733333333,16.09150322243563,129,7.000000000000001E-5
1,test_20231031_155419,10404007.png,502730,17207,485523,0.9657728800747917,5,7,61265,2499,58766,0.9592099893903534,26.117214222222223,3546.187088,12.633187167032132,129,8.0E-5
2,test_20231031_155419,1254659.png,342646,67202,275444,0.8038733853598174,6,7,80080,9440,70640,0.8821178821178821,21.685260444444445,3425.6872266666664,12.78332652540119,129,8.0E-5
3,test_20231031_155419,10188041.png,221231,8907,212324,0.9597389154322857,3,6,41731,1262,40469,0.9697586925786585,10.89088711111111,1117.198944,17.64949844343051,129,8.0E-5
4,test_20231031_155419,10287332.png,216980,11792,205188,0.945653977325099,3,7,22337,1617,20720,0.9276089000313381,9.499649777777778,803.2418826666667,19.082340154783257,129,8.0E-5
5,test_20231031_155419,11610969.png,368720,22372,346348,0.9393252332393144,6,9,84111,3270,80841,0.9611228020116275,22.074186666666666,3125.7853333333333,13.18121211800863,129,8.0E-5
6,test_20231031_155419,10350842.png,212614,5359,207255,0.9747946983735785,3,7,42529,788,41741,0.9814714665287215,19.497994666666667,2427.775552,14.27871827160568,129,8.0E-5
7,test_20231031_155419,10863862.png,317432,7622,309810,0.9759885581793896,2,6,66058,1113,64945,0.9831511701837778,35.65140977777778,6505.424832,9.998046977614175,129,8.0E-5
8,test_20231031_155419,11382381.png,312486,817,311669,0.9973854828696326,3,6,46745,112,46633,0.9976040218205156,21.216531555555555,2458.9940213333334,14.223228880483061,129,8.0E-5
9,test_20231031_155419,11079715.png,443815,110349,333466,0.7513626173067607,6,8,124136,15456,108680,0.8754913965328349,17.57312,2279.878944,14.551685732308561,129,8.0E-5
10,test_20231031_155419,11551286.png,271883,737,271146,0.9972892751661561,2,6,40092,107,39985,0.997331138381722,16.330346666666667,1599.3003733333333,16.09150322243563,129,8.0E-5
1,test_20231031_155421,10404007.png,502730,17207,485523,0.9657728800747917,4,6,61265,2499,58766,0.9592099893903534,26.117214222222223,3546.187088,12.633187167032132,129,9.0E-5
2,test_20231031_155421,1254659.png,342646,67202,275444,0.8038733853598174,5,7,80080,9440,70640,0.8821178821178821,21.685260444444445,3425.6872266666664,12.78332652540119,129,9.0E-5
3,test_20231031_155421,10188041.png,221231,8907,212324,0.9597389154322857,5,8,41731,1262,40469,0.9697586925786585,10.89088711111111,1117.198944,17.64949844343051,129,9.0E-5
4,test_20231031_155421,10287332.png,216980,11792,205188,0.945653977325099,5,10,22337,1617,20720,0.9276089000313381,9.499649777777778,803.2418826666667,19.082340154783257,129,9.0E-5
5,test_20231031_155421,11610969.png,368720,22372,346348,0.9393252332393144,8,10,84111,3270,80841,0.9611228020116275,22.074186666666666,3125.7853333333333,13.18121211800863,129,9.0E-5
6,test_20231031_155421,10350842.png,212614,5359,207255,0.9747946983735785,4,11,42529,788,41741,0.9814714665287215,19.497994666666667,2427.775552,14.27871827160568,129,9.0E-5
7,test_20231031_155421,10863862.png,317432,7622,309810,0.9759885581793896,4,8,66058,1113,64945,0.9831511701837778,35.65140977777778,6505.424832,9.998046977614175,129,9.0E-5
8,test_20231031_155421,11382381.png,312486,817,311669,0.9973854828696326,6,8,46745,112,46633,0.9976040218205156,21.216531555555555,2458.9940213333334,14.223228880483061,129,9.0E-5
9,test_20231031_155421,11079715.png,443815,110349,333466,0.7513626173067607,9,12,124136,15456,108680,0.8754913965328349,17.57312,2279.878944,14.551685732308561,129,9.0E-5
10,test_20231031_155421,11551286.png,271883,737,271146,0.9972892751661561,4,8,40092,107,39985,0.997331138381722,16.330346666666667,1599.3003733333333,16.09150322243563,129,9.0E-5
1,test_20231031_155422,10404007.png,502730,17207,485523,0.9657728800747917,5,9,61265,2499,58766,0.9592099893903534,26.117214222222223,3546.187088,12.633187167032132,129,1.0E-4
2,test_20231031_155422,1254659.png,342646,67202,275444,0.8038733853598174,5,7,80080,9440,70640,0.8821178821178821,21.685260444444445,3425.6872266666664,12.78332652540119,129,1.0E-4
3,test_20231031_155422,10188041.png,221231,8907,212324,0.9597389154322857,4,6,41731,1262,40469,0.9697586925786585,10.89088711111111,1117.198944,17.64949844343051,129,1.0E-4
4,test_20231031_155422,10287332.png,216980,11792,205188,0.945653977325099,2,5,22337,1617,20720,0.9276089000313381,9.499649777777778,803.2418826666667,19.082340154783257,129,1.0E-4
5,test_20231031_155422,11610969.png,368720,22372,346348,0.9393252332393144,3,5,84111,3270,80841,0.9611228020116275,22.074186666666666,3125.7853333333333,13.18121211800863,129,1.0E-4
6,test_20231031_155422,10350842.png,212614,5359,207255,0.9747946983735785,2,5,42529,788,41741,0.9814714665287215,19.497994666666667,2427.775552,14.27871827160568,129,1.0E-4
7,test_20231031_155422,10863862.png,317432,7622,309810,0.9759885581793896,2,5,66058,1113,64945,0.9831511701837778,35.65140977777778,6505.424832,9.998046977614175,129,1.0E-4
8,test_20231031_155422,11382381.png,312486,817,311669,0.9973854828696326,3,6,46745,112,46633,0.9976040218205156,21.216531555555555,2458.9940213333334,14.223228880483061,129,1.0E-4
9,test_20231031_155422,11079715.png,443815,110349,333466,0.7513626173067607,5,12,124136,15456,108680,0.8754913965328349,17.57312,2279.878944,14.551685732308561,129,1.0E-4
10,test_20231031_155422,11551286.png,271883,737,271146,0.9972892751661561,3,6,40092,107,39985,0.997331138381722,16.330346666666667,1599.3003733333333,16.09150322243563,129,1.0E-4
1,test_20231031_155423,10404007.png,502730,17207,485523,0.9657728800747917,4,6,61265,2499,58766,0.9592099893903534,26.117214222222223,3546.187088,12.633187167032132,129,1.1E-4
2,test_20231031_155423,1254659.png,342646,67202,275444,0.8038733853598174,5,6,80080,9440,70640,0.8821178821178821,21.685260444444445,3425.6872266666664,12.78332652540119,129,1.1E-4
3,test_20231031_155423,10188041.png,221231,8907,212324,0.9597389154322857,3,14,41731,1262,40469,0.9697586925786585,10.89088711111111,1117.198944,17.64949844343051,129,1.1E-4
4,test_20231031_155423,10287332.png,216980,11792,205188,0.945653977325099,3,6,22337,1617,20720,0.9276089000313381,9.499649777777778,803.2418826666667,19.082340154783257,129,1.1E-4
5,test_20231031_155423,11610969.png,368720,22372,346348,0.9393252332393144,3,6,84111,3270,80841,0.9611228020116275,22.074186666666666,3125.7853333333333,13.18121211800863,129,1.1E-4
6,test_20231031_155423,10350842.png,212614,5359,207255,0.9747946983735785,2,5,42529,788,41741,0.9814714665287215,19.497994666666667,2427.775552,14.27871827160568,129,1.1E-4
7,test_20231031_155423,10863862.png,317432,7622,309810,0.9759885581793896,2,5,66058,1113,64945,0.9831511701837778,35.65140977777778,6505.424832,9.998046977614175,129,1.1E-4
8,test_20231031_155423,11382381.png,312486,817,311669,0.9973854828696326,2,6,46745,112,46633,0.9976040218205156,21.216531555555555,2458.9940213333334,14.223228880483061,129,1.1E-4
9,test_20231031_155423,11079715.png,443815,110349,333466,0.7513626173067607,5,7,124136,15456,108680,0.8754913965328349,17.57312,2279.878944,14.551685732308561,129,1.1E-4
10,test_20231031_155423,11551286.png,271883,737,271146,0.9972892751661561,2,5,40092,107,39985,0.997331138381722,16.330346666666667,1599.3003733333333,16.09150322243563,129,1.1E-4
1,test_20231031_155424,10404007.png,502730,17207,485523,0.9657728800747917,4,6,61265,2499,58766,0.9592099893903534,26.117214222222223,3546.187088,12.633187167032132,129,1.2E-4
2,test_20231031_155424,1254659.png,342646,67202,275444,0.8038733853598174,7,6,80080,9440,70640,0.8821178821178821,21.685260444444445,3425.6872266666664,12.78332652540119,129,1.2E-4
3,test_20231031_155424,10188041.png,221231,8907,212324,0.9597389154322857,3,6,41731,1262,40469,0.9697586925786585,10.89088711111111,1117.198944,17.64949844343051,129,1.2E-4
4,test_20231031_155424,10287332.png,216980,11792,205188,0.945653977325099,3,6,22337,1617,20720,0.9276089000313381,9.499649777777778,803.2418826666667,19.082340154783257,129,1.2E-4
5,test_20231031_155424,11610969.png,368720,22372,346348,0.9393252332393144,4,6,84111,3270,80841,0.9611228020116275,22.074186666666666,3125.7853333333333,13.18121211800863,129,1.2E-4
6,test_20231031_155424,10350842.png,212614,5359,207255,0.9747946983735785,3,5,42529,788,41741,0.9814714665287215,19.497994666666667,2427.775552,14.27871827160568,129,1.2E-4
7,test_20231031_155424,10863862.png,317432,7622,309810,0.9759885581793896,3,6,66058,1113,64945,0.9831511701837778,35.65140977777778,6505.424832,9.998046977614175,129,1.2E-4
8,test_20231031_155424,11382381.png,312486,817,311669,0.9973854828696326,2,5,46745,112,46633,0.9976040218205156,21.216531555555555,2458.9940213333334,14.223228880483061,129,1.2E-4
9,test_20231031_155424,11079715.png,443815,110349,333466,0.7513626173067607,6,7,124136,15456,108680,0.8754913965328349,17.57312,2279.878944,14.551685732308561,129,1.2E-4
10,test_20231031_155424,11551286.png,271883,737,271146,0.9972892751661561,2,5,40092,107,39985,0.997331138381722,16.330346666666667,1599.3003733333333,16.09150322243563,129,1.2E-4
1,test_20231031_155425,10404007.png,502730,17207,485523,0.9657728800747917,4,6,61265,2499,58766,0.9592099893903534,26.117214222222223,3546.187088,12.633187167032132,129,1.3000000000000002E-4
2,test_20231031_155425,1254659.png,342646,67202,275444,0.8038733853598174,5,6,80080,9440,70640,0.8821178821178821,21.685260444444445,3425.6872266666664,12.78332652540119,129,1.3000000000000002E-4
3,test_20231031_155425,10188041.png,221231,8907,212324,0.9597389154322857,4,16,41731,1262,40469,0.9697586925786585,10.89088711111111,1117.198944,17.64949844343051,129,1.3000000000000002E-4
4,test_20231031_155425,10287332.png,216980,11792,205188,0.945653977325099,4,7,22337,1617,20720,0.9276089000313381,9.499649777777778,803.2418826666667,19.082340154783257,129,1.3000000000000002E-4
5,test_20231031_155425,11610969.png,368720,22372,346348,0.9393252332393144,4,7,84111,3270,80841,0.9611228020116275,22.074186666666666,3125.7853333333333,13.18121211800863,129,1.3000000000000002E-4
6,test_20231031_155425,10350842.png,212614,5359,207255,0.9747946983735785,3,5,42529,788,41741,0.9814714665287215,19.497994666666667,2427.775552,14.27871827160568,129,1.3000000000000002E-4
7,test_20231031_155425,10863862.png,317432,7622,309810,0.9759885581793896,2,5,66058,1113,64945,0.9831511701837778,35.65140977777778,6505.424832,9.998046977614175,129,1.3000000000000002E-4
8,test_20231031_155425,11382381.png,312486,817,311669,0.9973854828696326,3,7,46745,112,46633,0.9976040218205156,21.216531555555555,2458.9940213333334,14.223228880483061,129,1.3000000000000002E-4
9,test_20231031_155425,11079715.png,443815,110349,333466,0.7513626173067607,8,10,124136,15456,108680,0.8754913965328349,17.57312,2279.878944,14.551685732308561,129,1.3000000000000002E-4
10,test_20231031_155425,11551286.png,271883,717,271166,0.9973628362199917,4,8,40092,104,39988,0.9974059662775616,17.035560888888888,1719.2356853333333,15.777449438530502,129,1.3000000000000002E-4
1,test_20231031_155427,10404007.png,502730,17207,485523,0.9657728800747917,3,6,61265,2499,58766,0.9592099893903534,26.117214222222223,3546.187088,12.633187167032132,129,1.4000000000000001E-4
2,test_20231031_155427,1254659.png,342646,67202,275444,0.8038733853598174,6,7,80080,9440,70640,0.8821178821178821,21.685260444444445,3425.6872266666664,12.78332652540119,129,1.4000000000000001E-4
3,test_20231031_155427,10188041.png,221231,8907,212324,0.9597389154322857,4,6,41731,1262,40469,0.9697586925786585,10.89088711111111,1117.198944,17.64949844343051,129,1.4000000000000001E-4
4,test_20231031_155427,10287332.png,216980,11792,205188,0.945653977325099,2,6,22337,1617,20720,0.9276089000313381,9.499649777777778,803.2418826666667,19.082340154783257,129,1.4000000000000001E-4
5,test_20231031_155427,11610969.png,368720,22372,346348,0.9393252332393144,4,6,84111,3270,80841,0.9611228020116275,22.074186666666666,3125.7853333333333,13.18121211800863,129,1.4000000000000001E-4
6,test_20231031_155427,10350842.png,212614,5359,207255,0.9747946983735785,3,7,42529,788,41741,0.9814714665287215,19.497994666666667,2427.775552,14.27871827160568,129,1.4000000000000001E-4
7,test_20231031_155427,10863862.png,317432,7622,309810,0.9759885581793896,4,8,66058,1113,64945,0.9831511701837778,35.65140977777778,6505.424832,9.998046977614175,129,1.4000000000000001E-4
8,test_20231031_155427,11382381.png,312486,817,311669,0.9973854828696326,3,8,46745,112,46633,0.9976040218205156,21.216531555555555,2458.9940213333334,14.223228880483061,129,1.4000000000000001E-4
9,test_20231031_155427,11079715.png,443815,110349,333466,0.7513626173067607,7,9,124136,15456,108680,0.8754913965328349,17.57312,2279.878944,14.551685732308561,129,1.4000000000000001E-4
10,test_20231031_155427,11551286.png,271883,717,271166,0.9973628362199917,3,8,40092,104,39988,0.9974059662775616,17.035560888888888,1719.2356853333333,15.777449438530502,129,1.4000000000000001E-4
1,test_20231031_155428,10404007.png,502730,17207,485523,0.9657728800747917,5,7,61265,2499,58766,0.9592099893903534,26.117214222222223,3546.187088,12.633187167032132,129,1.5000000000000001E-4
2,test_20231031_155428,1254659.png,342646,67202,275444,0.8038733853598174,5,8,80080,9440,70640,0.8821178821178821,21.685260444444445,3425.6872266666664,12.78332652540119,129,1.5000000000000001E-4
3,test_20231031_155428,10188041.png,221231,8907,212324,0.9597389154322857,3,7,41731,1262,40469,0.9697586925786585,10.89088711111111,1117.198944,17.64949844343051,129,1.5000000000000001E-4
4,test_20231031_155428,10287332.png,216980,11792,205188,0.945653977325099,4,7,22337,1617,20720,0.9276089000313381,9.499649777777778,803.2418826666667,19.082340154783257,129,1.5000000000000001E-4
5,test_20231031_155428,11610969.png,368720,22372,346348,0.9393252332393144,4,7,84111,3270,80841,0.9611228020116275,22.074186666666666,3125.7853333333333,13.18121211800863,129,1.5000000000000001E-4
6,test_20231031_155428,10350842.png,212614,5359,207255,0.9747946983735785,3,7,42529,788,41741,0.9814714665287215,19.497994666666667,2427.775552,14.27871827160568,129,1.5000000000000001E-4
7,test_20231031_155428,10863862.png,317432,7622,309810,0.9759885581793896,3,6,66058,1113,64945,0.9831511701837778,35.65140977777778,6505.424832,9.998046977614175,129,1.5000000000000001E-4
8,test_20231031_155428,11382381.png,312486,707,311779,0.9977374986399391,4,7,46745,96,46649,0.9979463044175848,21.47300977777778,2499.126186666667,14.152921756540431,129,1.5000000000000001E-4
9,test_20231031_155428,11079715.png,443815,110349,333466,0.7513626173067607,9,10,124136,15456,108680,0.8754913965328349,17.57312,2279.878944,14.551685732308561,129,1.5000000000000001E-4
10,test_20231031_155428,11551286.png,271883,717,271166,0.9973628362199917,2,14,40092,104,39988,0.9974059662775616,17.035560888888888,1719.2356853333333,15.777449438530502,129,1.5000000000000001E-4
1,test_20231031_155429,10404007.png,502730,17207,485523,0.9657728800747917,4,7,61265,2499,58766,0.9592099893903534,26.117214222222223,3546.187088,12.633187167032132,129,1.6E-4
2,test_20231031_155429,1254659.png,342646,67202,275444,0.8038733853598174,5,7,80080,9440,70640,0.8821178821178821,21.685260444444445,3425.6872266666664,12.78332652540119,129,1.6E-4
3,test_20231031_155429,10188041.png,221231,8907,212324,0.9597389154322857,4,7,41731,1262,40469,0.9697586925786585,10.89088711111111,1117.198944,17.64949844343051,129,1.6E-4
4,test_20231031_155429,10287332.png,216980,11579,205401,0.9466356346207023,2,6,22337,1590,20747,0.9288176568026145,9.629411555555556,829.9726293333333,18.940165903297878,129,1.6E-4
5,test_20231031_155429,11610969.png,368720,22372,346348,0.9393252332393144,5,7,84111,3270,80841,0.9611228020116275,22.074186666666666,3125.7853333333333,13.18121211800863,129,1.6E-4
6,test_20231031_155429,10350842.png,212614,5359,207255,0.9747946983735785,4,8,42529,788,41741,0.9814714665287215,19.497994666666667,2427.775552,14.27871827160568,129,1.6E-4
7,test_20231031_155429,10863862.png,317432,7622,309810,0.9759885581793896,5,10,66058,1113,64945,0.9831511701837778,35.65140977777778,6505.424832,9.998046977614175,129,1.6E-4
8,test_20231031_155429,11382381.png,312486,707,311779,0.9977374986399391,3,9,46745,96,46649,0.9979463044175848,21.47300977777778,2499.126186666667,14.152921756540431,129,1.6E-4
9,test_20231031_155429,11079715.png,443815,110349,333466,0.7513626173067607,7,10,124136,15456,108680,0.8754913965328349,17.57312,2279.878944,14.551685732308561,129,1.6E-4
10,test_20231031_155429,11551286.png,271883,717,271166,0.9973628362199917,2,6,40092,104,39988,0.9974059662775616,17.035560888888888,1719.2356853333333,15.777449438530502,129,1.6E-4
1,test_20231031_155431,10404007.png,502730,17207,485523,0.9657728800747917,4,6,61265,2499,58766,0.9592099893903534,26.117214222222223,3546.187088,12.633187167032132,129,1.7E-4
2,test_20231031_155431,1254659.png,342646,67202,275444,0.8038733853598174,5,7,80080,9440,70640,0.8821178821178821,21.685260444444445,3425.6872266666664,12.78332652540119,129,1.7E-4
3,test_20231031_155431,10188041.png,221231,8907,212324,0.9597389154322857,4,7,41731,1262,40469,0.9697586925786585,10.89088711111111,1117.198944,17.64949844343051,129,1.7E-4
4,test_20231031_155431,10287332.png,216980,11579,205401,0.9466356346207023,3,6,22337,1590,20747,0.9288176568026145,9.629411555555556,829.9726293333333,18.940165903297878,129,1.7E-4
5,test_20231031_155431,11610969.png,368720,22372,346348,0.9393252332393144,4,5,84111,3270,80841,0.9611228020116275,22.074186666666666,3125.7853333333333,13.18121211800863,129,1.7E-4
6,test_20231031_155431,10350842.png,212614,5359,207255,0.9747946983735785,3,5,42529,788,41741,0.9814714665287215,19.497994666666667,2427.775552,14.27871827160568,129,1.7E-4
7,test_20231031_155431,10863862.png,317432,7622,309810,0.9759885581793896,3,7,66058,1113,64945,0.9831511701837778,35.65140977777778,6505.424832,9.998046977614175,129,1.7E-4
8,test_20231031_155431,11382381.png,312486,707,311779,0.9977374986399391,3,7,46745,96,46649,0.9979463044175848,21.47300977777778,2499.126186666667,14.152921756540431,129,1.7E-4
9,test_20231031_155431,11079715.png,443815,110349,333466,0.7513626173067607,8,11,124136,15456,108680,0.8754913965328349,17.57312,2279.878944,14.551685732308561,129,1.7E-4
10,test_20231031_155431,11551286.png,271883,717,271166,0.9973628362199917,3,9,40092,104,39988,0.9974059662775616,17.035560888888888,1719.2356853333333,15.777449438530502,129,1.7E-4
1,test_20231031_155432,10404007.png,502730,17207,485523,0.9657728800747917,16,10,61265,2499,58766,0.9592099893903534,26.117214222222223,3546.187088,12.633187167032132,129,1.8E-4
2,test_20231031_155432,1254659.png,342646,67202,275444,0.8038733853598174,5,7,80080,9440,70640,0.8821178821178821,21.685260444444445,3425.6872266666664,12.78332652540119,129,1.8E-4
3,test_20231031_155432,10188041.png,221231,8907,212324,0.9597389154322857,4,7,41731,1262,40469,0.9697586925786585,10.89088711111111,1117.198944,17.64949844343051,129,1.8E-4
4,test_20231031_155432,10287332.png,216980,11579,205401,0.9466356346207023,3,7,22337,1590,20747,0.9288176568026145,9.629411555555556,829.9726293333333,18.940165903297878,129,1.8E-4
5,test_20231031_155432,11610969.png,368720,22372,346348,0.9393252332393144,4,9,84111,3270,80841,0.9611228020116275,22.074186666666666,3125.7853333333333,13.18121211800863,129,1.8E-4
6,test_20231031_155432,10350842.png,212614,5359,207255,0.9747946983735785,3,7,42529,788,41741,0.9814714665287215,19.497994666666667,2427.775552,14.27871827160568,129,1.8E-4
7,test_20231031_155432,10863862.png,317432,7622,309810,0.9759885581793896,3,6,66058,1113,64945,0.9831511701837778,35.65140977777778,6505.424832,9.998046977614175,129,1.8E-4
8,test_20231031_155432,11382381.png,312486,707,311779,0.9977374986399391,3,8,46745,96,46649,0.9979463044175848,21.47300977777778,2499.126186666667,14.152921756540431,129,1.8E-4
9,test_20231031_155432,11079715.png,443815,110349,333466,0.7513626173067607,9,10,124136,15456,108680,0.8754913965328349,17.57312,2279.878944,14.551685732308561,129,1.8E-4
10,test_20231031_155432,11551286.png,271883,717,271166,0.9973628362199917,3,7,40092,104,39988,0.9974059662775616,17.035560888888888,1719.2356853333333,15.777449438530502,129,1.8E-4
1,test_20231031_155433,10404007.png,502730,17207,485523,0.9657728800747917,4,8,61265,2499,58766,0.9592099893903534,26.117214222222223,3546.187088,12.633187167032132,129,1.9E-4
2,test_20231031_155433,1254659.png,342646,67202,275444,0.8038733853598174,6,9,80080,9440,70640,0.8821178821178821,21.685260444444445,3425.6872266666664,12.78332652540119,129,1.9E-4
3,test_20231031_155433,10188041.png,221231,8907,212324,0.9597389154322857,5,8,41731,1262,40469,0.9697586925786585,10.89088711111111,1117.198944,17.64949844343051,129,1.9E-4
4,test_20231031_155433,10287332.png,216980,11579,205401,0.9466356346207023,3,6,22337,1590,20747,0.9288176568026145,9.629411555555556,829.9726293333333,18.940165903297878,129,1.9E-4
5,test_20231031_155433,11610969.png,368720,22372,346348,0.9393252332393144,4,6,84111,3270,80841,0.9611228020116275,22.074186666666666,3125.7853333333333,13.18121211800863,129,1.9E-4
6,test_20231031_155433,10350842.png,212614,5359,207255,0.9747946983735785,2,6,42529,788,41741,0.9814714665287215,19.497994666666667,2427.775552,14.27871827160568,129,1.9E-4
7,test_20231031_155433,10863862.png,317432,7622,309810,0.9759885581793896,2,5,66058,1113,64945,0.9831511701837778,35.65140977777778,6505.424832,9.998046977614175,129,1.9E-4
8,test_20231031_155433,11382381.png,312486,707,311779,0.9977374986399391,3,6,46745,96,46649,0.9979463044175848,21.47300977777778,2499.126186666667,14.152921756540431,129,1.9E-4
9,test_20231031_155433,11079715.png,443815,110349,333466,0.7513626173067607,5,6,124136,15456,108680,0.8754913965328349,17.57312,2279.878944,14.551685732308561,129,1.9E-4
10,test_20231031_155433,11551286.png,271883,717,271166,0.9973628362199917,2,6,40092,104,39988,0.9974059662775616,17.035560888888888,1719.2356853333333,15.777449438530502,129,1.9E-4
1,test_20231031_155434,10404007.png,502730,17207,485523,0.9657728800747917,4,7,61265,2499,58766,0.9592099893903534,26.117214222222223,3546.187088,12.633187167032132,129,2.0E-4
2,test_20231031_155434,1254659.png,342646,67202,275444,0.8038733853598174,8,11,80080,9440,70640,0.8821178821178821,21.685260444444445,3425.6872266666664,12.78332652540119,129,2.0E-4
3,test_20231031_155434,10188041.png,221231,8907,212324,0.9597389154322857,5,9,41731,1262,40469,0.9697586925786585,10.89088711111111,1117.198944,17.64949844343051,129,2.0E-4
4,test_20231031_155434,10287332.png,216980,11579,205401,0.9466356346207023,3,7,22337,1590,20747,0.9288176568026145,9.629411555555556,829.9726293333333,18.940165903297878,129,2.0E-4
5,test_20231031_155434,11610969.png,368720,22372,346348,0.9393252332393144,4,8,84111,3270,80841,0.9611228020116275,22.074186666666666,3125.7853333333333,13.18121211800863,129,2.0E-4
6,test_20231031_155434,10350842.png,212614,5359,207255,0.9747946983735785,3,7,42529,788,41741,0.9814714665287215,19.497994666666667,2427.775552,14.27871827160568,129,2.0E-4
7,test_20231031_155434,10863862.png,317432,7622,309810,0.9759885581793896,2,6,66058,1113,64945,0.9831511701837778,35.65140977777778,6505.424832,9.998046977614175,129,2.0E-4
8,test_20231031_155434,11382381.png,312486,707,311779,0.9977374986399391,3,6,46745,96,46649,0.9979463044175848,21.47300977777778,2499.126186666667,14.152921756540431,129,2.0E-4
9,test_20231031_155434,11079715.png,443815,110349,333466,0.7513626173067607,6,7,124136,15456,108680,0.8754913965328349,17.57312,2279.878944,14.551685732308561,129,2.0E-4
10,test_20231031_155434,11551286.png,271883,597,271286,0.9978042025430056,2,6,40092,86,40006,0.997854933652599,17.58564977777778,1815.0887466666666,15.541824966498465,129,2.0E-4
1,test_20231031_155436,10404007.png,502730,17207,485523,0.9657728800747917,5,10,61265,2499,58766,0.9592099893903534,26.117214222222223,3546.187088,12.633187167032132,129,2.1E-4
2,test_20231031_155436,1254659.png,342646,67202,275444,0.8038733853598174,10,15,80080,9440,70640,0.8821178821178821,21.685260444444445,3425.6872266666664,12.78332652540119,129,2.1E-4
3,test_20231031_155436,10188041.png,221231,8907,212324,0.9597389154322857,3,6,41731,1262,40469,0.9697586925786585,10.89088711111111,1117.198944,17.64949844343051,129,2.1E-4
4,test_20231031_155436,10287332.png,216980,11579,205401,0.9466356346207023,3,6,22337,1590,20747,0.9288176568026145,9.629411555555556,829.9726293333333,18.940165903297878,129,2.1E-4
5,test_20231031_155436,11610969.png,368720,22372,346348,0.9393252332393144,4,6,84111,3270,80841,0.9611228020116275,22.074186666666666,3125.7853333333333,13.18121211800863,129,2.1E-4
6,test_20231031_155436,10350842.png,212614,5359,207255,0.9747946983735785,2,6,42529,788,41741,0.9814714665287215,19.497994666666667,2427.775552,14.27871827160568,129,2.1E-4
7,test_20231031_155436,10863862.png,317432,7622,309810,0.9759885581793896,3,7,66058,1113,64945,0.9831511701837778,35.65140977777778,6505.424832,9.998046977614175,129,2.1E-4
8,test_20231031_155436,11382381.png,312486,707,311779,0.9977374986399391,3,6,46745,96,46649,0.9979463044175848,21.47300977777778,2499.126186666667,14.152921756540431,129,2.1E-4
9,test_20231031_155436,11079715.png,443815,110349,333466,0.7513626173067607,6,7,124136,15456,108680,0.8754913965328349,17.57312,2279.878944,14.551685732308561,129,2.1E-4
10,test_20231031_155436,11551286.png,271883,597,271286,0.9978042025430056,4,13,40092,86,40006,0.997854933652599,17.58564977777778,1815.0887466666666,15.541824966498465,129,2.1E-4
1,test_20231031_155437,10404007.png,502730,17207,485523,0.9657728800747917,7,14,61265,2499,58766,0.9592099893903534,26.117214222222223,3546.187088,12.633187167032132,129,2.2E-4
2,test_20231031_155437,1254659.png,342646,67202,275444,0.8038733853598174,7,8,80080,9440,70640,0.8821178821178821,21.685260444444445,3425.6872266666664,12.78332652540119,129,2.2E-4
3,test_20231031_155437,10188041.png,221231,8907,212324,0.9597389154322857,3,7,41731,1262,40469,0.9697586925786585,10.89088711111111,1117.198944,17.64949844343051,129,2.2E-4
4,test_20231031_155437,10287332.png,216980,11579,205401,0.9466356346207023,3,6,22337,1590,20747,0.9288176568026145,9.629411555555556,829.9726293333333,18.940165903297878,129,2.2E-4
5,test_20231031_155437,11610969.png,368720,22372,346348,0.9393252332393144,4,7,84111,3270,80841,0.9611228020116275,22.074186666666666,3125.7853333333333,13.18121211800863,129,2.2E-4
6,test_20231031_155437,10350842.png,212614,5359,207255,0.9747946983735785,2,5,42529,788,41741,0.9814714665287215,19.497994666666667,2427.775552,14.27871827160568,129,2.2E-4
7,test_20231031_155437,10863862.png,317432,7622,309810,0.9759885581793896,3,7,66058,1113,64945,0.9831511701837778,35.65140977777778,6505.424832,9.998046977614175,129,2.2E-4
8,test_20231031_155437,11382381.png,312486,707,311779,0.9977374986399391,3,6,46745,96,46649,0.9979463044175848,21.47300977777778,2499.126186666667,14.152921756540431,129,2.2E-4
9,test_20231031_155437,11079715.png,443815,110349,333466,0.7513626173067607,9,11,124136,15456,108680,0.8754913965328349,17.57312,2279.878944,14.551685732308561,129,2.2E-4
10,test_20231031_155437,11551286.png,271883,597,271286,0.9978042025430056,3,8,40092,86,40006,0.997854933652599,17.58564977777778,1815.0887466666666,15.541824966498465,129,2.2E-4
1,test_20231031_155438,10404007.png,502730,17207,485523,0.9657728800747917,4,7,61265,2499,58766,0.9592099893903534,26.117214222222223,3546.187088,12.633187167032132,129,2.3E-4
2,test_20231031_155438,1254659.png,342646,67202,275444,0.8038733853598174,5,7,80080,9440,70640,0.8821178821178821,21.685260444444445,3425.6872266666664,12.78332652540119,129,2.3E-4
3,test_20231031_155438,10188041.png,221231,8907,212324,0.9597389154322857,4,7,41731,1262,40469,0.9697586925786585,10.89088711111111,1117.198944,17.64949844343051,129,2.3E-4
4,test_20231031_155438,10287332.png,216980,11579,205401,0.9466356346207023,4,7,22337,1590,20747,0.9288176568026145,9.629411555555556,829.9726293333333,18.940165903297878,129,2.3E-4
5,test_20231031_155438,11610969.png,368720,22372,346348,0.9393252332393144,4,7,84111,3270,80841,0.9611228020116275,22.074186666666666,3125.7853333333333,13.18121211800863,129,2.3E-4
6,test_20231031_155438,10350842.png,212614,5359,207255,0.9747946983735785,3,7,42529,788,41741,0.9814714665287215,19.497994666666667,2427.775552,14.27871827160568,129,2.3E-4
7,test_20231031_155438,10863862.png,317432,7622,309810,0.9759885581793896,4,9,66058,1113,64945,0.9831511701837778,35.65140977777778,6505.424832,9.998046977614175,129,2.3E-4
8,test_20231031_155438,11382381.png,312486,707,311779,0.9977374986399391,3,8,46745,96,46649,0.9979463044175848,21.47300977777778,2499.126186666667,14.152921756540431,129,2.3E-4
9,test_20231031_155438,11079715.png,443815,110349,333466,0.7513626173067607,7,9,124136,15456,108680,0.8754913965328349,17.57312,2279.878944,14.551685732308561,129,2.3E-4
10,test_20231031_155438,11551286.png,271883,327,271556,0.998797276769787,3,10,40092,46,40046,0.99885263893046,17.867866666666668,1859.2518453333332,15.437421396648572,129,2.3E-4
1,test_20231031_155440,10404007.png,502730,17207,485523,0.9657728800747917,4,7,61265,2499,58766,0.9592099893903534,26.117214222222223,3546.187088,12.633187167032132,129,2.4E-4
2,test_20231031_155440,1254659.png,342646,67202,275444,0.8038733853598174,5,7,80080,9440,70640,0.8821178821178821,21.685260444444445,3425.6872266666664,12.78332652540119,129,2.4E-4
3,test_20231031_155440,10188041.png,221231,8907,212324,0.9597389154322857,4,8,41731,1262,40469,0.9697586925786585,10.89088711111111,1117.198944,17.64949844343051,129,2.4E-4
4,test_20231031_155440,10287332.png,216980,11579,205401,0.9466356346207023,4,9,22337,1590,20747,0.9288176568026145,9.629411555555556,829.9726293333333,18.940165903297878,129,2.4E-4
5,test_20231031_155440,11610969.png,368720,22372,346348,0.9393252332393144,5,8,84111,3270,80841,0.9611228020116275,22.074186666666666,3125.7853333333333,13.18121211800863,129,2.4E-4
6,test_20231031_155440,10350842.png,212614,5359,207255,0.9747946983735785,3,7,42529,788,41741,0.9814714665287215,19.497994666666667,2427.775552,14.27871827160568,129,2.4E-4
7,test_20231031_155440,10863862.png,317432,7622,309810,0.9759885581793896,4,7,66058,1113,64945,0.9831511701837778,35.65140977777778,6505.424832,9.998046977614175,129,2.4E-4
8,test_20231031_155440,11382381.png,312486,707,311779,0.9977374986399391,3,7,46745,96,46649,0.9979463044175848,21.47300977777778,2499.126186666667,14.152921756540431,129,2.4E-4
9,test_20231031_155440,11079715.png,443815,110349,333466,0.7513626173067607,6,8,124136,15456,108680,0.8754913965328349,17.57312,2279.878944,14.551685732308561,129,2.4E-4
10,test_20231031_155440,11551286.png,271883,327,271556,0.998797276769787,3,6,40092,46,40046,0.99885263893046,17.867866666666668,1859.2518453333332,15.437421396648572,129,2.4E-4
1,test_20231031_155441,10404007.png,502730,17207,485523,0.9657728800747917,4,7,61265,2499,58766,0.9592099893903534,26.117214222222223,3546.187088,12.633187167032132,129,2.5E-4
2,test_20231031_155441,1254659.png,342646,67202,275444,0.8038733853598174,4,6,80080,9440,70640,0.8821178821178821,21.685260444444445,3425.6872266666664,12.78332652540119,129,2.5E-4
3,test_20231031_155441,10188041.png,221231,8907,212324,0.9597389154322857,3,6,41731,1262,40469,0.9697586925786585,10.89088711111111,1117.198944,17.64949844343051,129,2.5E-4
4,test_20231031_155441,10287332.png,216980,11579,205401,0.9466356346207023,3,6,22337,1590,20747,0.9288176568026145,9.629411555555556,829.9726293333333,18.940165903297878,129,2.5E-4
5,test_20231031_155441,11610969.png,368720,22372,346348,0.9393252332393144,4,6,84111,3270,80841,0.9611228020116275,22.074186666666666,3125.7853333333333,13.18121211800863,129,2.5E-4
6,test_20231031_155441,10350842.png,212614,5359,207255,0.9747946983735785,2,5,42529,788,41741,0.9814714665287215,19.497994666666667,2427.775552,14.27871827160568,129,2.5E-4
7,test_20231031_155441,10863862.png,317432,7622,309810,0.9759885581793896,2,6,66058,1113,64945,0.9831511701837778,35.65140977777778,6505.424832,9.998046977614175,129,2.5E-4
8,test_20231031_155441,11382381.png,312486,707,311779,0.9977374986399391,2,6,46745,96,46649,0.9979463044175848,21.47300977777778,2499.126186666667,14.152921756540431,129,2.5E-4
9,test_20231031_155441,11079715.png,443815,110349,333466,0.7513626173067607,5,7,124136,15456,108680,0.8754913965328349,17.57312,2279.878944,14.551685732308561,129,2.5E-4
10,test_20231031_155441,11551286.png,271883,327,271556,0.998797276769787,2,6,40092,46,40046,0.99885263893046,17.867866666666668,1859.2518453333332,15.437421396648572,129,2.5E-4
1,test_20231031_155442,10404007.png,502730,17007,485723,0.9661707079346766,4,6,61265,2473,58792,0.9596343752550396,26.13115911111111,3549.4145653333335,12.629236337316815,129,2.6000000000000003E-4
2,test_20231031_155442,1254659.png,342646,67139,275507,0.8040572485889227,5,7,80080,9434,70646,0.8821928071928072,21.694814222222224,3426.7694133333334,12.781954790485319,129,2.6000000000000003E-4
3,test_20231031_155442,10188041.png,221231,8867,212364,0.9599197219196225,3,5,41731,1256,40475,0.9699024705854161,11.256714666666667,1169.479648,17.450876925151316,129,2.6000000000000003E-4
4,test_20231031_155442,10287332.png,216980,11579,205401,0.9466356346207023,2,5,22337,1590,20747,0.9288176568026145,9.629411555555556,829.9726293333333,18.940165903297878,129,2.6000000000000003E-4
5,test_20231031_155442,11610969.png,368720,21849,346871,0.9407436537209807,4,6,84111,3194,80917,0.9620263699159444,22.960643555555556,3319.495392,12.920082907559944,129,2.6000000000000003E-4
6,test_20231031_155442,10350842.png,212614,5279,207335,0.9751709671047062,3,6,42529,776,41753,0.9817536269369136,19.566787555555557,2433.533258666667,14.268430748223048,129,2.6000000000000003E-4
7,test_20231031_155442,10863862.png,317432,7562,309870,0.9761775750396935,3,6,66058,1104,64954,0.9832874140906476,35.66071822222222,6506.869162666667,9.99708286653367,129,2.6000000000000003E-4
8,test_20231031_155442,11382381.png,312486,587,311899,0.9981215158439098,2,5,46745,78,46667,0.9983313723392876,21.967536,2569.068496,14.03304677372966,129,2.6000000000000003E-4
9,test_20231031_155442,11079715.png,443815,110349,333466,0.7513626173067607,6,7,124136,15456,108680,0.8754913965328349,17.57312,2279.878944,14.551685732308561,129,2.6000000000000003E-4
10,test_20231031_155442,11551286.png,271883,267,271616,0.9990179599312939,2,5,40092,37,40055,0.9990771226179787,18.016108444444445,1877.54488,15.394900338849709,129,2.6000000000000003E-4
1,test_20231031_155443,10404007.png,502730,17007,485723,0.9661707079346766,3,6,61265,2473,58792,0.9596343752550396,26.13115911111111,3549.4145653333335,12.629236337316815,129,2.7000000000000006E-4
2,test_20231031_155443,1254659.png,342646,67139,275507,0.8040572485889227,5,6,80080,9434,70646,0.8821928071928072,21.694814222222224,3426.7694133333334,12.781954790485319,129,2.7000000000000006E-4
3,test_20231031_155443,10188041.png,221231,8867,212364,0.9599197219196225,3,6,41731,1256,40475,0.9699024705854161,11.256714666666667,1169.479648,17.450876925151316,129,2.7000000000000006E-4
4,test_20231031_155443,10287332.png,216980,11579,205401,0.9466356346207023,3,6,22337,1590,20747,0.9288176568026145,9.629411555555556,829.9726293333333,18.940165903297878,129,2.7000000000000006E-4
5,test_20231031_155443,11610969.png,368720,21849,346871,0.9407436537209807,3,5,84111,3194,80917,0.9620263699159444,22.960643555555556,3319.495392,12.920082907559944,129,2.7000000000000006E-4
6,test_20231031_155443,10350842.png,212614,5279,207335,0.9751709671047062,2,6,42529,776,41753,0.9817536269369136,19.566787555555557,2433.533258666667,14.268430748223048,129,2.7000000000000006E-4
7,test_20231031_155443,10863862.png,317432,7562,309870,0.9761775750396935,2,5,66058,1104,64954,0.9832874140906476,35.66071822222222,6506.869162666667,9.99708286653367,129,2.7000000000000006E-4
8,test_20231031_155443,11382381.png,312486,587,311899,0.9981215158439098,3,5,46745,78,46667,0.9983313723392876,21.967536,2569.068496,14.03304677372966,129,2.7000000000000006E-4
9,test_20231031_155443,11079715.png,443815,110349,333466,0.7513626173067607,5,7,124136,15456,108680,0.8754913965328349,17.57312,2279.878944,14.551685732308561,129,2.7000000000000006E-4
10,test_20231031_155443,11551286.png,271883,267,271616,0.9990179599312939,2,5,40092,37,40055,0.9990771226179787,18.016108444444445,1877.54488,15.394900338849709,129,2.7000000000000006E-4
1,test_20231031_155444,10404007.png,502730,17007,485723,0.9661707079346766,3,6,61265,2473,58792,0.9596343752550396,26.13115911111111,3549.4145653333335,12.629236337316815,129,2.800000000000001E-4
2,test_20231031_155444,1254659.png,342646,67139,275507,0.8040572485889227,5,15,80080,9434,70646,0.8821928071928072,21.694814222222224,3426.7694133333334,12.781954790485319,129,2.800000000000001E-4
3,test_20231031_155444,10188041.png,221231,8867,212364,0.9599197219196225,3,6,41731,1256,40475,0.9699024705854161,11.256714666666667,1169.479648,17.450876925151316,129,2.800000000000001E-4
4,test_20231031_155444,10287332.png,216980,11579,205401,0.9466356346207023,3,6,22337,1590,20747,0.9288176568026145,9.629411555555556,829.9726293333333,18.940165903297878,129,2.800000000000001E-4
5,test_20231031_155444,11610969.png,368720,21849,346871,0.9407436537209807,3,6,84111,3194,80917,0.9620263699159444,22.960643555555556,3319.495392,12.920082907559944,129,2.800000000000001E-4
6,test_20231031_155444,10350842.png,212614,5279,207335,0.9751709671047062,2,13,42529,776,41753,0.9817536269369136,19.566787555555557,2433.533258666667,14.268430748223048,129,2.800000000000001E-4
7,test_20231031_155444,10863862.png,317432,7562,309870,0.9761775750396935,3,6,66058,1104,64954,0.9832874140906476,35.66071822222222,6506.869162666667,9.99708286653367,129,2.800000000000001E-4
8,test_20231031_155444,11382381.png,312486,587,311899,0.9981215158439098,3,6,46745,78,46667,0.9983313723392876,21.967536,2569.068496,14.03304677372966,129,2.800000000000001E-4
9,test_20231031_155444,11079715.png,443815,110349,333466,0.7513626173067607,5,6,124136,15456,108680,0.8754913965328349,17.57312,2279.878944,14.551685732308561,129,2.800000000000001E-4
10,test_20231031_155444,11551286.png,271883,267,271616,0.9990179599312939,2,14,40092,37,40055,0.9990771226179787,18.016108444444445,1877.54488,15.394900338849709,129,2.800000000000001E-4
1,test_20231031_155445,10404007.png,502730,17007,485723,0.9661707079346766,4,6,61265,2473,58792,0.9596343752550396,26.13115911111111,3549.4145653333335,12.629236337316815,129,2.900000000000001E-4
2,test_20231031_155445,1254659.png,342646,67139,275507,0.8040572485889227,4,7,80080,9434,70646,0.8821928071928072,21.694814222222224,3426.7694133333334,12.781954790485319,129,2.900000000000001E-4
3,test_20231031_155445,10188041.png,221231,8867,212364,0.9599197219196225,3,6,41731,1256,40475,0.9699024705854161,11.256714666666667,1169.479648,17.450876925151316,129,2.900000000000001E-4
4,test_20231031_155445,10287332.png,216980,11579,205401,0.9466356346207023,3,6,22337,1590,20747,0.9288176568026145,9.629411555555556,829.9726293333333,18.940165903297878,129,2.900000000000001E-4
5,test_20231031_155445,11610969.png,368720,21849,346871,0.9407436537209807,3,5,84111,3194,80917,0.9620263699159444,22.960643555555556,3319.495392,12.920082907559944,129,2.900000000000001E-4
6,test_20231031_155445,10350842.png,212614,5279,207335,0.9751709671047062,3,6,42529,776,41753,0.9817536269369136,19.566787555555557,2433.533258666667,14.268430748223048,129,2.900000000000001E-4
7,test_20231031_155445,10863862.png,317432,7562,309870,0.9761775750396935,2,6,66058,1104,64954,0.9832874140906476,35.66071822222222,6506.869162666667,9.99708286653367,129,2.900000000000001E-4
8,test_20231031_155445,11382381.png,312486,587,311899,0.9981215158439098,3,6,46745,78,46667,0.9983313723392876,21.967536,2569.068496,14.03304677372966,129,2.900000000000001E-4
9,test_20231031_155445,11079715.png,443815,110349,333466,0.7513626173067607,5,7,124136,15456,108680,0.8754913965328349,17.57312,2279.878944,14.551685732308561,129,2.900000000000001E-4
10,test_20231031_155445,11551286.png,271883,267,271616,0.9990179599312939,2,18,40092,37,40055,0.9990771226179787,18.016108444444445,1877.54488,15.394900338849709,129,2.900000000000001E-4
1,test_20231031_155446,10404007.png,502730,16624,486106,0.9669325482863564,3,11,61265,2416,58849,0.9605647596506978,26.07669511111111,3540.964474666667,12.639587912218095,130,1.0E-5
2,test_20231031_155446,1254659.png,342646,65252,277394,0.8095643900702183,4,7,80080,9171,70909,0.885477022977023,21.881578666666666,3492.428917333333,12.699527853441253,130,1.0E-5
3,test_20231031_155446,10188041.png,221231,8404,212827,0.9620125570105456,2,5,41731,1193,40538,0.9714121396563705,11.447850666666668,1280.5076586666667,17.056981805572335,130,1.0E-5
4,test_20231031_155446,10287332.png,216980,11449,205531,0.9472347681813992,3,6,22337,1574,20763,0.929533957111519,9.561258666666667,823.894464,18.97208776158452,130,1.0E-5
5,test_20231031_155446,11610969.png,368720,21407,347313,0.9419423953135171,4,6,84111,3130,80981,0.9627872692037902,22.610574222222223,3255.403008,13.004756004317752,130,1.0E-5
6,test_20231031_155446,10350842.png,212614,4817,207797,0.977343919026969,3,5,42529,707,41822,0.983376049284018,19.67007111111111,2460.5717813333335,14.22044321803745,130,1.0E-5
7,test_20231031_155446,10863862.png,317432,7439,309993,0.9765650596033166,2,5,66058,1092,64966,0.9834690726331405,35.67820088888889,6511.628522666667,9.993907440417022,130,1.0E-5
8,test_20231031_155446,11382381.png,312486,827,311659,0.9973534814359684,3,6,46745,113,46632,0.9975826291581987,20.486714666666668,2360.4332106666666,14.400886444502593,130,1.0E-5
9,test_20231031_155446,11079715.png,443815,107837,335978,0.7570226333044174,7,7,124136,15131,109005,0.8781094928143327,17.708771555555554,2317.625856,14.480370335498858,130,1.0E-5
10,test_20231031_155446,11551286.png,271883,837,271046,0.9969214698969777,3,5,40092,122,39970,0.9969569989025242,16.70746488888889,1661.188816,15.926613623199302,130,1.0E-5
1,test_20231031_155447,10404007.png,502730,16624,486106,0.9669325482863564,4,6,61265,2416,58849,0.9605647596506978,26.07669511111111,3540.964474666667,12.639587912218095,130,2.0E-5
2,test_20231031_155447,1254659.png,342646,65252,277394,0.8095643900702183,5,7,80080,9171,70909,0.885477022977023,21.881578666666666,3492.428917333333,12.699527853441253,130,2.0E-5
3,test_20231031_155447,10188041.png,221231,8404,212827,0.9620125570105456,3,5,41731,1193,40538,0.9714121396563705,11.447850666666668,1280.5076586666667,17.056981805572335,130,2.0E-5
4,test_20231031_155447,10287332.png,216980,11449,205531,0.9472347681813992,2,6,22337,1574,20763,0.929533957111519,9.561258666666667,823.894464,18.97208776158452,130,2.0E-5
5,test_20231031_155447,11610969.png,368720,21407,347313,0.9419423953135171,3,5,84111,3130,80981,0.9627872692037902,22.610574222222223,3255.403008,13.004756004317752,130,2.0E-5
6,test_20231031_155447,10350842.png,212614,4817,207797,0.977343919026969,2,6,42529,707,41822,0.983376049284018,19.67007111111111,2460.5717813333335,14.22044321803745,130,2.0E-5
7,test_20231031_155447,10863862.png,317432,7439,309993,0.9765650596033166,3,6,66058,1092,64966,0.9834690726331405,35.67820088888889,6511.628522666667,9.993907440417022,130,2.0E-5
8,test_20231031_155447,11382381.png,312486,827,311659,0.9973534814359684,2,5,46745,113,46632,0.9975826291581987,20.486714666666668,2360.4332106666666,14.400886444502593,130,2.0E-5
9,test_20231031_155447,11079715.png,443815,107837,335978,0.7570226333044174,5,6,124136,15131,109005,0.8781094928143327,17.708771555555554,2317.625856,14.480370335498858,130,2.0E-5
10,test_20231031_155447,11551286.png,271883,837,271046,0.9969214698969777,2,5,40092,122,39970,0.9969569989025242,16.70746488888889,1661.188816,15.926613623199302,130,2.0E-5
1,test_20231031_155448,10404007.png,502730,16624,486106,0.9669325482863564,4,6,61265,2416,58849,0.9605647596506978,26.07669511111111,3540.964474666667,12.639587912218095,130,3.0000000000000004E-5
2,test_20231031_155448,1254659.png,342646,65252,277394,0.8095643900702183,5,6,80080,9171,70909,0.885477022977023,21.881578666666666,3492.428917333333,12.699527853441253,130,3.0000000000000004E-5
3,test_20231031_155448,10188041.png,221231,8404,212827,0.9620125570105456,5,6,41731,1193,40538,0.9714121396563705,11.447850666666668,1280.5076586666667,17.056981805572335,130,3.0000000000000004E-5
4,test_20231031_155448,10287332.png,216980,11449,205531,0.9472347681813992,4,6,22337,1574,20763,0.929533957111519,9.561258666666667,823.894464,18.97208776158452,130,3.0000000000000004E-5
5,test_20231031_155448,11610969.png,368720,21407,347313,0.9419423953135171,4,7,84111,3130,80981,0.9627872692037902,22.610574222222223,3255.403008,13.004756004317752,130,3.0000000000000004E-5
6,test_20231031_155448,10350842.png,212614,4817,207797,0.977343919026969,3,6,42529,707,41822,0.983376049284018,19.67007111111111,2460.5717813333335,14.22044321803745,130,3.0000000000000004E-5
7,test_20231031_155448,10863862.png,317432,7439,309993,0.9765650596033166,3,6,66058,1092,64966,0.9834690726331405,35.67820088888889,6511.628522666667,9.993907440417022,130,3.0000000000000004E-5
8,test_20231031_155448,11382381.png,312486,827,311659,0.9973534814359684,3,6,46745,113,46632,0.9975826291581987,20.486714666666668,2360.4332106666666,14.400886444502593,130,3.0000000000000004E-5
9,test_20231031_155448,11079715.png,443815,107837,335978,0.7570226333044174,6,7,124136,15131,109005,0.8781094928143327,17.708771555555554,2317.625856,14.480370335498858,130,3.0000000000000004E-5
10,test_20231031_155448,11551286.png,271883,837,271046,0.9969214698969777,3,6,40092,122,39970,0.9969569989025242,16.70746488888889,1661.188816,15.926613623199302,130,3.0000000000000004E-5
1,test_20231031_155449,10404007.png,502730,16624,486106,0.9669325482863564,3,6,61265,2416,58849,0.9605647596506978,26.07669511111111,3540.964474666667,12.639587912218095,130,4.0E-5
2,test_20231031_155449,1254659.png,342646,65252,277394,0.8095643900702183,5,6,80080,9171,70909,0.885477022977023,21.881578666666666,3492.428917333333,12.699527853441253,130,4.0E-5
3,test_20231031_155449,10188041.png,221231,8404,212827,0.9620125570105456,4,6,41731,1193,40538,0.9714121396563705,11.447850666666668,1280.5076586666667,17.056981805572335,130,4.0E-5
4,test_20231031_155449,10287332.png,216980,11449,205531,0.9472347681813992,3,5,22337,1574,20763,0.929533957111519,9.561258666666667,823.894464,18.97208776158452,130,4.0E-5
5,test_20231031_155449,11610969.png,368720,21407,347313,0.9419423953135171,4,5,84111,3130,80981,0.9627872692037902,22.610574222222223,3255.403008,13.004756004317752,130,4.0E-5
6,test_20231031_155449,10350842.png,212614,4817,207797,0.977343919026969,3,8,42529,707,41822,0.983376049284018,19.67007111111111,2460.5717813333335,14.22044321803745,130,4.0E-5
7,test_20231031_155449,10863862.png,317432,7439,309993,0.9765650596033166,4,6,66058,1092,64966,0.9834690726331405,35.67820088888889,6511.628522666667,9.993907440417022,130,4.0E-5
8,test_20231031_155449,11382381.png,312486,827,311659,0.9973534814359684,3,5,46745,113,46632,0.9975826291581987,20.486714666666668,2360.4332106666666,14.400886444502593,130,4.0E-5
9,test_20231031_155449,11079715.png,443815,107837,335978,0.7570226333044174,5,7,124136,15131,109005,0.8781094928143327,17.708771555555554,2317.625856,14.480370335498858,130,4.0E-5
10,test_20231031_155449,11551286.png,271883,837,271046,0.9969214698969777,2,6,40092,122,39970,0.9969569989025242,16.70746488888889,1661.188816,15.926613623199302,130,4.0E-5
1,test_20231031_155451,10404007.png,502730,16624,486106,0.9669325482863564,3,5,61265,2416,58849,0.9605647596506978,26.07669511111111,3540.964474666667,12.639587912218095,130,5.0E-5
2,test_20231031_155451,1254659.png,342646,65252,277394,0.8095643900702183,6,7,80080,9171,70909,0.885477022977023,21.881578666666666,3492.428917333333,12.699527853441253,130,5.0E-5
3,test_20231031_155451,10188041.png,221231,8404,212827,0.9620125570105456,4,8,41731,1193,40538,0.9714121396563705,11.447850666666668,1280.5076586666667,17.056981805572335,130,5.0E-5
4,test_20231031_155451,10287332.png,216980,11449,205531,0.9472347681813992,4,7,22337,1574,20763,0.929533957111519,9.561258666666667,823.894464,18.97208776158452,130,5.0E-5
5,test_20231031_155451,11610969.png,368720,21407,347313,0.9419423953135171,6,9,84111,3130,80981,0.9627872692037902,22.610574222222223,3255.403008,13.004756004317752,130,5.0E-5
6,test_20231031_155451,10350842.png,212614,4817,207797,0.977343919026969,3,7,42529,707,41822,0.983376049284018,19.67007111111111,2460.5717813333335,14.22044321803745,130,5.0E-5
7,test_20231031_155451,10863862.png,317432,7439,309993,0.9765650596033166,3,6,66058,1092,64966,0.9834690726331405,35.67820088888889,6511.628522666667,9.993907440417022,130,5.0E-5
8,test_20231031_155451,11382381.png,312486,817,311669,0.9973854828696326,3,6,46745,112,46633,0.9976040218205156,21.216531555555555,2458.9940213333334,14.223228880483061,130,5.0E-5
9,test_20231031_155451,11079715.png,443815,107837,335978,0.7570226333044174,5,6,124136,15131,109005,0.8781094928143327,17.708771555555554,2317.625856,14.480370335498858,130,5.0E-5
10,test_20231031_155451,11551286.png,271883,837,271046,0.9969214698969777,2,6,40092,122,39970,0.9969569989025242,16.70746488888889,1661.188816,15.926613623199302,130,5.0E-5
1,test_20231031_155452,10404007.png,502730,16624,486106,0.9669325482863564,3,6,61265,2416,58849,0.9605647596506978,26.07669511111111,3540.964474666667,12.639587912218095,130,6.0E-5
2,test_20231031_155452,1254659.png,342646,65252,277394,0.8095643900702183,4,7,80080,9171,70909,0.885477022977023,21.881578666666666,3492.428917333333,12.699527853441253,130,6.0E-5
3,test_20231031_155452,10188041.png,221231,8404,212827,0.9620125570105456,3,6,41731,1193,40538,0.9714121396563705,11.447850666666668,1280.5076586666667,17.056981805572335,130,6.0E-5
4,test_20231031_155452,10287332.png,216980,11449,205531,0.9472347681813992,3,6,22337,1574,20763,0.929533957111519,9.561258666666667,823.894464,18.97208776158452,130,6.0E-5
5,test_20231031_155452,11610969.png,368720,21407,347313,0.9419423953135171,3,6,84111,3130,80981,0.9627872692037902,22.610574222222223,3255.403008,13.004756004317752,130,6.0E-5
6,test_20231031_155452,10350842.png,212614,4817,207797,0.977343919026969,2,5,42529,707,41822,0.983376049284018,19.67007111111111,2460.5717813333335,14.22044321803745,130,6.0E-5
7,test_20231031_155452,10863862.png,317432,7439,309993,0.9765650596033166,2,5,66058,1092,64966,0.9834690726331405,35.67820088888889,6511.628522666667,9.993907440417022,130,6.0E-5
8,test_20231031_155452,11382381.png,312486,817,311669,0.9973854828696326,3,6,46745,112,46633,0.9976040218205156,21.216531555555555,2458.9940213333334,14.223228880483061,130,6.0E-5
9,test_20231031_155452,11079715.png,443815,107837,335978,0.7570226333044174,5,6,124136,15131,109005,0.8781094928143327,17.708771555555554,2317.625856,14.480370335498858,130,6.0E-5
10,test_20231031_155452,11551286.png,271883,837,271046,0.9969214698969777,2,5,40092,122,39970,0.9969569989025242,16.70746488888889,1661.188816,15.926613623199302,130,6.0E-5
1,test_20231031_155453,10404007.png,502730,16402,486328,0.9673741372108289,4,6,61265,2384,58881,0.961087080714927,26.161904,3559.777616,12.61657492996368,130,7.000000000000001E-5
2,test_20231031_155453,1254659.png,342646,65252,277394,0.8095643900702183,4,7,80080,9171,70909,0.885477022977023,21.881578666666666,3492.428917333333,12.699527853441253,130,7.000000000000001E-5
3,test_20231031_155453,10188041.png,221231,8404,212827,0.9620125570105456,3,5,41731,1193,40538,0.9714121396563705,11.447850666666668,1280.5076586666667,17.056981805572335,130,7.000000000000001E-5
4,test_20231031_155453,10287332.png,216980,11449,205531,0.9472347681813992,2,5,22337,1574,20763,0.929533957111519,9.561258666666667,823.894464,18.97208776158452,130,7.000000000000001E-5
5,test_20231031_155453,11610969.png,368720,21407,347313,0.9419423953135171,4,6,84111,3130,80981,0.9627872692037902,22.610574222222223,3255.403008,13.004756004317752,130,7.000000000000001E-5
6,test_20231031_155453,10350842.png,212614,4817,207797,0.977343919026969,2,6,42529,707,41822,0.983376049284018,19.67007111111111,2460.5717813333335,14.22044321803745,130,7.000000000000001E-5
7,test_20231031_155453,10863862.png,317432,7439,309993,0.9765650596033166,2,5,66058,1092,64966,0.9834690726331405,35.67820088888889,6511.628522666667,9.993907440417022,130,7.000000000000001E-5
8,test_20231031_155453,11382381.png,312486,817,311669,0.9973854828696326,2,5,46745,112,46633,0.9976040218205156,21.216531555555555,2458.9940213333334,14.223228880483061,130,7.000000000000001E-5
9,test_20231031_155453,11079715.png,443815,107837,335978,0.7570226333044174,5,7,124136,15131,109005,0.8781094928143327,17.708771555555554,2317.625856,14.480370335498858,130,7.000000000000001E-5
10,test_20231031_155453,11551286.png,271883,657,271226,0.9975835193814987,2,5,40092,95,39997,0.9976304499650803,17.08696,1727.1593013333334,15.75747965107392,130,7.000000000000001E-5
1,test_20231031_155454,10404007.png,502730,16402,486328,0.9673741372108289,3,6,61265,2384,58881,0.961087080714927,26.161904,3559.777616,12.61657492996368,130,8.0E-5
2,test_20231031_155454,1254659.png,342646,65252,277394,0.8095643900702183,4,6,80080,9171,70909,0.885477022977023,21.881578666666666,3492.428917333333,12.699527853441253,130,8.0E-5
3,test_20231031_155454,10188041.png,221231,8404,212827,0.9620125570105456,3,6,41731,1193,40538,0.9714121396563705,11.447850666666668,1280.5076586666667,17.056981805572335,130,8.0E-5
4,test_20231031_155454,10287332.png,216980,11449,205531,0.9472347681813992,2,5,22337,1574,20763,0.929533957111519,9.561258666666667,823.894464,18.97208776158452,130,8.0E-5
5,test_20231031_155454,11610969.png,368720,21407,347313,0.9419423953135171,9,6,84111,3130,80981,0.9627872692037902,22.610574222222223,3255.403008,13.004756004317752,130,8.0E-5
6,test_20231031_155454,10350842.png,212614,4817,207797,0.977343919026969,2,5,42529,707,41822,0.983376049284018,19.67007111111111,2460.5717813333335,14.22044321803745,130,8.0E-5
7,test_20231031_155454,10863862.png,317432,7439,309993,0.9765650596033166,2,6,66058,1092,64966,0.9834690726331405,35.67820088888889,6511.628522666667,9.993907440417022,130,8.0E-5
8,test_20231031_155454,11382381.png,312486,817,311669,0.9973854828696326,3,6,46745,112,46633,0.9976040218205156,21.216531555555555,2458.9940213333334,14.223228880483061,130,8.0E-5
9,test_20231031_155454,11079715.png,443815,107837,335978,0.7570226333044174,5,7,124136,15131,109005,0.8781094928143327,17.708771555555554,2317.625856,14.480370335498858,130,8.0E-5
10,test_20231031_155454,11551286.png,271883,657,271226,0.9975835193814987,3,5,40092,95,39997,0.9976304499650803,17.08696,1727.1593013333334,15.75747965107392,130,8.0E-5
1,test_20231031_155455,10404007.png,502730,16402,486328,0.9673741372108289,3,5,61265,2384,58881,0.961087080714927,26.161904,3559.777616,12.61657492996368,130,9.0E-5
2,test_20231031_155455,1254659.png,342646,65252,277394,0.8095643900702183,4,6,80080,9171,70909,0.885477022977023,21.881578666666666,3492.428917333333,12.699527853441253,130,9.0E-5
3,test_20231031_155455,10188041.png,221231,8404,212827,0.9620125570105456,3,6,41731,1193,40538,0.9714121396563705,11.447850666666668,1280.5076586666667,17.056981805572335,130,9.0E-5
4,test_20231031_155455,10287332.png,216980,11449,205531,0.9472347681813992,3,6,22337,1574,20763,0.929533957111519,9.561258666666667,823.894464,18.97208776158452,130,9.0E-5
5,test_20231031_155455,11610969.png,368720,21407,347313,0.9419423953135171,3,6,84111,3130,80981,0.9627872692037902,22.610574222222223,3255.403008,13.004756004317752,130,9.0E-5
6,test_20231031_155455,10350842.png,212614,4817,207797,0.977343919026969,2,5,42529,707,41822,0.983376049284018,19.67007111111111,2460.5717813333335,14.22044321803745,130,9.0E-5
7,test_20231031_155455,10863862.png,317432,7439,309993,0.9765650596033166,3,6,66058,1092,64966,0.9834690726331405,35.67820088888889,6511.628522666667,9.993907440417022,130,9.0E-5
8,test_20231031_155455,11382381.png,312486,817,311669,0.9973854828696326,3,5,46745,112,46633,0.9976040218205156,21.216531555555555,2458.9940213333334,14.223228880483061,130,9.0E-5
9,test_20231031_155455,11079715.png,443815,107837,335978,0.7570226333044174,5,7,124136,15131,109005,0.8781094928143327,17.708771555555554,2317.625856,14.480370335498858,130,9.0E-5
10,test_20231031_155455,11551286.png,271883,657,271226,0.9975835193814987,2,5,40092,95,39997,0.9976304499650803,17.08696,1727.1593013333334,15.75747965107392,130,9.0E-5
1,test_20231031_155456,10404007.png,502730,16402,486328,0.9673741372108289,3,6,61265,2384,58881,0.961087080714927,26.161904,3559.777616,12.61657492996368,130,1.0E-4
2,test_20231031_155456,1254659.png,342646,65252,277394,0.8095643900702183,4,6,80080,9171,70909,0.885477022977023,21.881578666666666,3492.428917333333,12.699527853441253,130,1.0E-4
3,test_20231031_155456,10188041.png,221231,8404,212827,0.9620125570105456,3,5,41731,1193,40538,0.9714121396563705,11.447850666666668,1280.5076586666667,17.056981805572335,130,1.0E-4
4,test_20231031_155456,10287332.png,216980,11449,205531,0.9472347681813992,2,5,22337,1574,20763,0.929533957111519,9.561258666666667,823.894464,18.97208776158452,130,1.0E-4
5,test_20231031_155456,11610969.png,368720,21407,347313,0.9419423953135171,4,6,84111,3130,80981,0.9627872692037902,22.610574222222223,3255.403008,13.004756004317752,130,1.0E-4
6,test_20231031_155456,10350842.png,212614,4817,207797,0.977343919026969,2,6,42529,707,41822,0.983376049284018,19.67007111111111,2460.5717813333335,14.22044321803745,130,1.0E-4
7,test_20231031_155456,10863862.png,317432,7439,309993,0.9765650596033166,3,6,66058,1092,64966,0.9834690726331405,35.67820088888889,6511.628522666667,9.993907440417022,130,1.0E-4
8,test_20231031_155456,11382381.png,312486,817,311669,0.9973854828696326,3,6,46745,112,46633,0.9976040218205156,21.216531555555555,2458.9940213333334,14.223228880483061,130,1.0E-4
9,test_20231031_155456,11079715.png,443815,107837,335978,0.7570226333044174,5,7,124136,15131,109005,0.8781094928143327,17.708771555555554,2317.625856,14.480370335498858,130,1.0E-4
10,test_20231031_155456,11551286.png,271883,657,271226,0.9975835193814987,2,6,40092,95,39997,0.9976304499650803,17.08696,1727.1593013333334,15.75747965107392,130,1.0E-4
1,test_20231031_155457,10404007.png,502730,16402,486328,0.9673741372108289,3,5,61265,2384,58881,0.961087080714927,26.161904,3559.777616,12.61657492996368,130,1.1E-4
2,test_20231031_155457,1254659.png,342646,65252,277394,0.8095643900702183,5,6,80080,9171,70909,0.885477022977023,21.881578666666666,3492.428917333333,12.699527853441253,130,1.1E-4
3,test_20231031_155457,10188041.png,221231,8404,212827,0.9620125570105456,3,6,41731,1193,40538,0.9714121396563705,11.447850666666668,1280.5076586666667,17.056981805572335,130,1.1E-4
4,test_20231031_155457,10287332.png,216980,11449,205531,0.9472347681813992,2,5,22337,1574,20763,0.929533957111519,9.561258666666667,823.894464,18.97208776158452,130,1.1E-4
5,test_20231031_155457,11610969.png,368720,21407,347313,0.9419423953135171,3,5,84111,3130,80981,0.9627872692037902,22.610574222222223,3255.403008,13.004756004317752,130,1.1E-4
6,test_20231031_155457,10350842.png,212614,4817,207797,0.977343919026969,2,6,42529,707,41822,0.983376049284018,19.67007111111111,2460.5717813333335,14.22044321803745,130,1.1E-4
7,test_20231031_155457,10863862.png,317432,7439,309993,0.9765650596033166,2,5,66058,1092,64966,0.9834690726331405,35.67820088888889,6511.628522666667,9.993907440417022,130,1.1E-4
8,test_20231031_155457,11382381.png,312486,817,311669,0.9973854828696326,2,11,46745,112,46633,0.9976040218205156,21.216531555555555,2458.9940213333334,14.223228880483061,130,1.1E-4
9,test_20231031_155457,11079715.png,443815,107837,335978,0.7570226333044174,6,6,124136,15131,109005,0.8781094928143327,17.708771555555554,2317.625856,14.480370335498858,130,1.1E-4
10,test_20231031_155457,11551286.png,271883,657,271226,0.9975835193814987,2,5,40092,95,39997,0.9976304499650803,17.08696,1727.1593013333334,15.75747965107392,130,1.1E-4
1,test_20231031_155458,10404007.png,502730,16402,486328,0.9673741372108289,3,6,61265,2384,58881,0.961087080714927,26.161904,3559.777616,12.61657492996368,130,1.2E-4
2,test_20231031_155458,1254659.png,342646,65252,277394,0.8095643900702183,4,6,80080,9171,70909,0.885477022977023,21.881578666666666,3492.428917333333,12.699527853441253,130,1.2E-4
3,test_20231031_155458,10188041.png,221231,8404,212827,0.9620125570105456,3,6,41731,1193,40538,0.9714121396563705,11.447850666666668,1280.5076586666667,17.056981805572335,130,1.2E-4
4,test_20231031_155458,10287332.png,216980,11449,205531,0.9472347681813992,2,5,22337,1574,20763,0.929533957111519,9.561258666666667,823.894464,18.97208776158452,130,1.2E-4
5,test_20231031_155458,11610969.png,368720,21407,347313,0.9419423953135171,4,6,84111,3130,80981,0.9627872692037902,22.610574222222223,3255.403008,13.004756004317752,130,1.2E-4
6,test_20231031_155458,10350842.png,212614,4817,207797,0.977343919026969,2,5,42529,707,41822,0.983376049284018,19.67007111111111,2460.5717813333335,14.22044321803745,130,1.2E-4
7,test_20231031_155458,10863862.png,317432,7439,309993,0.9765650596033166,3,6,66058,1092,64966,0.9834690726331405,35.67820088888889,6511.628522666667,9.993907440417022,130,1.2E-4
8,test_20231031_155458,11382381.png,312486,817,311669,0.9973854828696326,2,5,46745,112,46633,0.9976040218205156,21.216531555555555,2458.9940213333334,14.223228880483061,130,1.2E-4
9,test_20231031_155458,11079715.png,443815,107837,335978,0.7570226333044174,5,6,124136,15131,109005,0.8781094928143327,17.708771555555554,2317.625856,14.480370335498858,130,1.2E-4
10,test_20231031_155458,11551286.png,271883,657,271226,0.9975835193814987,2,6,40092,95,39997,0.9976304499650803,17.08696,1727.1593013333334,15.75747965107392,130,1.2E-4
1,test_20231031_155459,10404007.png,502730,16402,486328,0.9673741372108289,3,5,61265,2384,58881,0.961087080714927,26.161904,3559.777616,12.61657492996368,130,1.3000000000000002E-4
2,test_20231031_155459,1254659.png,342646,65252,277394,0.8095643900702183,4,6,80080,9171,70909,0.885477022977023,21.881578666666666,3492.428917333333,12.699527853441253,130,1.3000000000000002E-4
3,test_20231031_155459,10188041.png,221231,8404,212827,0.9620125570105456,3,5,41731,1193,40538,0.9714121396563705,11.447850666666668,1280.5076586666667,17.056981805572335,130,1.3000000000000002E-4
4,test_20231031_155459,10287332.png,216980,11449,205531,0.9472347681813992,3,6,22337,1574,20763,0.929533957111519,9.561258666666667,823.894464,18.97208776158452,130,1.3000000000000002E-4
5,test_20231031_155459,11610969.png,368720,21407,347313,0.9419423953135171,4,6,84111,3130,80981,0.9627872692037902,22.610574222222223,3255.403008,13.004756004317752,130,1.3000000000000002E-4
6,test_20231031_155459,10350842.png,212614,4817,207797,0.977343919026969,2,6,42529,707,41822,0.983376049284018,19.67007111111111,2460.5717813333335,14.22044321803745,130,1.3000000000000002E-4
7,test_20231031_155459,10863862.png,317432,7439,309993,0.9765650596033166,3,6,66058,1092,64966,0.9834690726331405,35.67820088888889,6511.628522666667,9.993907440417022,130,1.3000000000000002E-4
8,test_20231031_155459,11382381.png,312486,817,311669,0.9973854828696326,2,5,46745,112,46633,0.9976040218205156,21.216531555555555,2458.9940213333334,14.223228880483061,130,1.3000000000000002E-4
9,test_20231031_155459,11079715.png,443815,107837,335978,0.7570226333044174,5,7,124136,15131,109005,0.8781094928143327,17.708771555555554,2317.625856,14.480370335498858,130,1.3000000000000002E-4
10,test_20231031_155459,11551286.png,271883,537,271346,0.9980248857045126,2,18,40092,77,40015,0.9980794173401177,17.637048888888888,1823.0123626666666,15.522907470567574,130,1.3000000000000002E-4
1,test_20231031_155500,10404007.png,502730,16402,486328,0.9673741372108289,4,6,61265,2384,58881,0.961087080714927,26.161904,3559.777616,12.61657492996368,130,1.4000000000000001E-4
2,test_20231031_155500,1254659.png,342646,65252,277394,0.8095643900702183,4,7,80080,9171,70909,0.885477022977023,21.881578666666666,3492.428917333333,12.699527853441253,130,1.4000000000000001E-4
3,test_20231031_155500,10188041.png,221231,8404,212827,0.9620125570105456,4,5,41731,1193,40538,0.9714121396563705,11.447850666666668,1280.5076586666667,17.056981805572335,130,1.4000000000000001E-4
4,test_20231031_155500,10287332.png,216980,11449,205531,0.9472347681813992,3,6,22337,1574,20763,0.929533957111519,9.561258666666667,823.894464,18.97208776158452,130,1.4000000000000001E-4
5,test_20231031_155500,11610969.png,368720,21407,347313,0.9419423953135171,4,6,84111,3130,80981,0.9627872692037902,22.610574222222223,3255.403008,13.004756004317752,130,1.4000000000000001E-4
6,test_20231031_155500,10350842.png,212614,4817,207797,0.977343919026969,2,5,42529,707,41822,0.983376049284018,19.67007111111111,2460.5717813333335,14.22044321803745,130,1.4000000000000001E-4
7,test_20231031_155500,10863862.png,317432,7439,309993,0.9765650596033166,3,7,66058,1092,64966,0.9834690726331405,35.67820088888889,6511.628522666667,9.993907440417022,130,1.4000000000000001E-4
8,test_20231031_155500,11382381.png,312486,817,311669,0.9973854828696326,2,5,46745,112,46633,0.9976040218205156,21.216531555555555,2458.9940213333334,14.223228880483061,130,1.4000000000000001E-4
9,test_20231031_155500,11079715.png,443815,107837,335978,0.7570226333044174,5,7,124136,15131,109005,0.8781094928143327,17.708771555555554,2317.625856,14.480370335498858,130,1.4000000000000001E-4
10,test_20231031_155500,11551286.png,271883,537,271346,0.9980248857045126,3,5,40092,77,40015,0.9980794173401177,17.637048888888888,1823.0123626666666,15.522907470567574,130,1.4000000000000001E-4
1,test_20231031_155501,10404007.png,502730,16402,486328,0.9673741372108289,4,6,61265,2384,58881,0.961087080714927,26.161904,3559.777616,12.61657492996368,130,1.5000000000000001E-4
2,test_20231031_155501,1254659.png,342646,65252,277394,0.8095643900702183,4,6,80080,9171,70909,0.885477022977023,21.881578666666666,3492.428917333333,12.699527853441253,130,1.5000000000000001E-4
3,test_20231031_155501,10188041.png,221231,8404,212827,0.9620125570105456,3,6,41731,1193,40538,0.9714121396563705,11.447850666666668,1280.5076586666667,17.056981805572335,130,1.5000000000000001E-4
4,test_20231031_155501,10287332.png,216980,11449,205531,0.9472347681813992,2,6,22337,1574,20763,0.929533957111519,9.561258666666667,823.894464,18.97208776158452,130,1.5000000000000001E-4
5,test_20231031_155501,11610969.png,368720,21407,347313,0.9419423953135171,3,6,84111,3130,80981,0.9627872692037902,22.610574222222223,3255.403008,13.004756004317752,130,1.5000000000000001E-4
6,test_20231031_155501,10350842.png,212614,4817,207797,0.977343919026969,2,9,42529,707,41822,0.983376049284018,19.67007111111111,2460.5717813333335,14.22044321803745,130,1.5000000000000001E-4
7,test_20231031_155501,10863862.png,317432,7439,309993,0.9765650596033166,2,6,66058,1092,64966,0.9834690726331405,35.67820088888889,6511.628522666667,9.993907440417022,130,1.5000000000000001E-4
8,test_20231031_155501,11382381.png,312486,707,311779,0.9977374986399391,2,6,46745,96,46649,0.9979463044175848,21.47300977777778,2499.126186666667,14.152921756540431,130,1.5000000000000001E-4
9,test_20231031_155501,11079715.png,443815,107837,335978,0.7570226333044174,5,7,124136,15131,109005,0.8781094928143327,17.708771555555554,2317.625856,14.480370335498858,130,1.5000000000000001E-4
10,test_20231031_155501,11551286.png,271883,537,271346,0.9980248857045126,2,5,40092,77,40015,0.9980794173401177,17.637048888888888,1823.0123626666666,15.522907470567574,130,1.5000000000000001E-4
1,test_20231031_155502,10404007.png,502730,16402,486328,0.9673741372108289,3,6,61265,2384,58881,0.961087080714927,26.161904,3559.777616,12.61657492996368,130,1.6E-4
2,test_20231031_155502,1254659.png,342646,65252,277394,0.8095643900702183,4,7,80080,9171,70909,0.885477022977023,21.881578666666666,3492.428917333333,12.699527853441253,130,1.6E-4
3,test_20231031_155502,10188041.png,221231,8404,212827,0.9620125570105456,5,12,41731,1193,40538,0.9714121396563705,11.447850666666668,1280.5076586666667,17.056981805572335,130,1.6E-4
4,test_20231031_155502,10287332.png,216980,11257,205723,0.9481196423633514,2,5,22337,1550,20787,0.9306084075748757,9.689633777777777,850.2091146666667,18.835546043579313,130,1.6E-4
5,test_20231031_155502,11610969.png,368720,21407,347313,0.9419423953135171,3,5,84111,3130,80981,0.9627872692037902,22.610574222222223,3255.403008,13.004756004317752,130,1.6E-4
6,test_20231031_155502,10350842.png,212614,4817,207797,0.977343919026969,2,5,42529,707,41822,0.983376049284018,19.67007111111111,2460.5717813333335,14.22044321803745,130,1.6E-4
7,test_20231031_155502,10863862.png,317432,7439,309993,0.9765650596033166,2,5,66058,1092,64966,0.9834690726331405,35.67820088888889,6511.628522666667,9.993907440417022,130,1.6E-4
8,test_20231031_155502,11382381.png,312486,707,311779,0.9977374986399391,2,6,46745,96,46649,0.9979463044175848,21.47300977777778,2499.126186666667,14.152921756540431,130,1.6E-4
9,test_20231031_155502,11079715.png,443815,107837,335978,0.7570226333044174,5,7,124136,15131,109005,0.8781094928143327,17.708771555555554,2317.625856,14.480370335498858,130,1.6E-4
10,test_20231031_155502,11551286.png,271883,537,271346,0.9980248857045126,2,6,40092,77,40015,0.9980794173401177,17.637048888888888,1823.0123626666666,15.522907470567574,130,1.6E-4
1,test_20231031_155503,10404007.png,502730,16402,486328,0.9673741372108289,3,5,61265,2384,58881,0.961087080714927,26.161904,3559.777616,12.61657492996368,130,1.7E-4
2,test_20231031_155503,1254659.png,342646,65252,277394,0.8095643900702183,10,6,80080,9171,70909,0.885477022977023,21.881578666666666,3492.428917333333,12.699527853441253,130,1.7E-4
3,test_20231031_155503,10188041.png,221231,8404,212827,0.9620125570105456,3,6,41731,1193,40538,0.9714121396563705,11.447850666666668,1280.5076586666667,17.056981805572335,130,1.7E-4
4,test_20231031_155503,10287332.png,216980,11257,205723,0.9481196423633514,3,6,22337,1550,20787,0.9306084075748757,9.689633777777777,850.2091146666667,18.835546043579313,130,1.7E-4
5,test_20231031_155503,11610969.png,368720,21407,347313,0.9419423953135171,4,6,84111,3130,80981,0.9627872692037902,22.610574222222223,3255.403008,13.004756004317752,130,1.7E-4
6,test_20231031_155503,10350842.png,212614,4817,207797,0.977343919026969,3,6,42529,707,41822,0.983376049284018,19.67007111111111,2460.5717813333335,14.22044321803745,130,1.7E-4
7,test_20231031_155503,10863862.png,317432,7439,309993,0.9765650596033166,3,6,66058,1092,64966,0.9834690726331405,35.67820088888889,6511.628522666667,9.993907440417022,130,1.7E-4
8,test_20231031_155503,11382381.png,312486,707,311779,0.9977374986399391,2,6,46745,96,46649,0.9979463044175848,21.47300977777778,2499.126186666667,14.152921756540431,130,1.7E-4
9,test_20231031_155503,11079715.png,443815,107837,335978,0.7570226333044174,5,6,124136,15131,109005,0.8781094928143327,17.708771555555554,2317.625856,14.480370335498858,130,1.7E-4
10,test_20231031_155503,11551286.png,271883,537,271346,0.9980248857045126,2,6,40092,77,40015,0.9980794173401177,17.637048888888888,1823.0123626666666,15.522907470567574,130,1.7E-4
1,test_20231031_155504,10404007.png,502730,16402,486328,0.9673741372108289,4,5,61265,2384,58881,0.961087080714927,26.161904,3559.777616,12.61657492996368,130,1.8E-4
2,test_20231031_155504,1254659.png,342646,65252,277394,0.8095643900702183,4,7,80080,9171,70909,0.885477022977023,21.881578666666666,3492.428917333333,12.699527853441253,130,1.8E-4
3,test_20231031_155504,10188041.png,221231,8404,212827,0.9620125570105456,3,5,41731,1193,40538,0.9714121396563705,11.447850666666668,1280.5076586666667,17.056981805572335,130,1.8E-4
4,test_20231031_155504,10287332.png,216980,11257,205723,0.9481196423633514,3,6,22337,1550,20787,0.9306084075748757,9.689633777777777,850.2091146666667,18.835546043579313,130,1.8E-4
5,test_20231031_155504,11610969.png,368720,21407,347313,0.9419423953135171,4,6,84111,3130,80981,0.9627872692037902,22.610574222222223,3255.403008,13.004756004317752,130,1.8E-4
6,test_20231031_155504,10350842.png,212614,4817,207797,0.977343919026969,2,6,42529,707,41822,0.983376049284018,19.67007111111111,2460.5717813333335,14.22044321803745,130,1.8E-4
7,test_20231031_155504,10863862.png,317432,7439,309993,0.9765650596033166,2,6,66058,1092,64966,0.9834690726331405,35.67820088888889,6511.628522666667,9.993907440417022,130,1.8E-4
8,test_20231031_155504,11382381.png,312486,707,311779,0.9977374986399391,2,5,46745,96,46649,0.9979463044175848,21.47300977777778,2499.126186666667,14.152921756540431,130,1.8E-4
9,test_20231031_155504,11079715.png,443815,107837,335978,0.7570226333044174,5,7,124136,15131,109005,0.8781094928143327,17.708771555555554,2317.625856,14.480370335498858,130,1.8E-4
10,test_20231031_155504,11551286.png,271883,537,271346,0.9980248857045126,4,6,40092,77,40015,0.9980794173401177,17.637048888888888,1823.0123626666666,15.522907470567574,130,1.8E-4
1,test_20231031_155505,10404007.png,502730,16402,486328,0.9673741372108289,3,6,61265,2384,58881,0.961087080714927,26.161904,3559.777616,12.61657492996368,130,1.9E-4
2,test_20231031_155505,1254659.png,342646,65252,277394,0.8095643900702183,4,6,80080,9171,70909,0.885477022977023,21.881578666666666,3492.428917333333,12.699527853441253,130,1.9E-4
3,test_20231031_155505,10188041.png,221231,8404,212827,0.9620125570105456,3,6,41731,1193,40538,0.9714121396563705,11.447850666666668,1280.5076586666667,17.056981805572335,130,1.9E-4
4,test_20231031_155505,10287332.png,216980,11257,205723,0.9481196423633514,3,6,22337,1550,20787,0.9306084075748757,9.689633777777777,850.2091146666667,18.835546043579313,130,1.9E-4
5,test_20231031_155505,11610969.png,368720,21407,347313,0.9419423953135171,4,6,84111,3130,80981,0.9627872692037902,22.610574222222223,3255.403008,13.004756004317752,130,1.9E-4
6,test_20231031_155505,10350842.png,212614,4817,207797,0.977343919026969,2,7,42529,707,41822,0.983376049284018,19.67007111111111,2460.5717813333335,14.22044321803745,130,1.9E-4
7,test_20231031_155505,10863862.png,317432,7439,309993,0.9765650596033166,3,6,66058,1092,64966,0.9834690726331405,35.67820088888889,6511.628522666667,9.993907440417022,130,1.9E-4
8,test_20231031_155505,11382381.png,312486,707,311779,0.9977374986399391,2,6,46745,96,46649,0.9979463044175848,21.47300977777778,2499.126186666667,14.152921756540431,130,1.9E-4
9,test_20231031_155505,11079715.png,443815,107837,335978,0.7570226333044174,6,7,124136,15131,109005,0.8781094928143327,17.708771555555554,2317.625856,14.480370335498858,130,1.9E-4
10,test_20231031_155505,11551286.png,271883,537,271346,0.9980248857045126,2,5,40092,77,40015,0.9980794173401177,17.637048888888888,1823.0123626666666,15.522907470567574,130,1.9E-4
1,test_20231031_155506,10404007.png,502730,16402,486328,0.9673741372108289,3,5,61265,2384,58881,0.961087080714927,26.161904,3559.777616,12.61657492996368,130,2.0E-4
2,test_20231031_155506,1254659.png,342646,65252,277394,0.8095643900702183,4,6,80080,9171,70909,0.885477022977023,21.881578666666666,3492.428917333333,12.699527853441253,130,2.0E-4
3,test_20231031_155506,10188041.png,221231,8404,212827,0.9620125570105456,3,6,41731,1193,40538,0.9714121396563705,11.447850666666668,1280.5076586666667,17.056981805572335,130,2.0E-4
4,test_20231031_155506,10287332.png,216980,11257,205723,0.9481196423633514,2,5,22337,1550,20787,0.9306084075748757,9.689633777777777,850.2091146666667,18.835546043579313,130,2.0E-4
5,test_20231031_155506,11610969.png,368720,21407,347313,0.9419423953135171,3,5,84111,3130,80981,0.9627872692037902,22.610574222222223,3255.403008,13.004756004317752,130,2.0E-4
6,test_20231031_155506,10350842.png,212614,4817,207797,0.977343919026969,2,6,42529,707,41822,0.983376049284018,19.67007111111111,2460.5717813333335,14.22044321803745,130,2.0E-4
7,test_20231031_155506,10863862.png,317432,7439,309993,0.9765650596033166,2,5,66058,1092,64966,0.9834690726331405,35.67820088888889,6511.628522666667,9.993907440417022,130,2.0E-4
8,test_20231031_155506,11382381.png,312486,707,311779,0.9977374986399391,2,6,46745,96,46649,0.9979463044175848,21.47300977777778,2499.126186666667,14.152921756540431,130,2.0E-4
9,test_20231031_155506,11079715.png,443815,107837,335978,0.7570226333044174,5,7,124136,15131,109005,0.8781094928143327,17.708771555555554,2317.625856,14.480370335498858,130,2.0E-4
10,test_20231031_155506,11551286.png,271883,267,271616,0.9990179599312939,2,5,40092,37,40055,0.9990771226179787,17.919265777777778,1867.1754613333333,15.418952296845859,130,2.0E-4
1,test_20231031_155507,10404007.png,502730,16402,486328,0.9673741372108289,4,6,61265,2384,58881,0.961087080714927,26.161904,3559.777616,12.61657492996368,130,2.1E-4
2,test_20231031_155507,1254659.png,342646,65252,277394,0.8095643900702183,4,6,80080,9171,70909,0.885477022977023,21.881578666666666,3492.428917333333,12.699527853441253,130,2.1E-4
3,test_20231031_155507,10188041.png,221231,8404,212827,0.9620125570105456,3,6,41731,1193,40538,0.9714121396563705,11.447850666666668,1280.5076586666667,17.056981805572335,130,2.1E-4
4,test_20231031_155507,10287332.png,216980,11257,205723,0.9481196423633514,2,5,22337,1550,20787,0.9306084075748757,9.689633777777777,850.2091146666667,18.835546043579313,130,2.1E-4
5,test_20231031_155507,11610969.png,368720,21407,347313,0.9419423953135171,3,5,84111,3130,80981,0.9627872692037902,22.610574222222223,3255.403008,13.004756004317752,130,2.1E-4
6,test_20231031_155507,10350842.png,212614,4817,207797,0.977343919026969,2,5,42529,707,41822,0.983376049284018,19.67007111111111,2460.5717813333335,14.22044321803745,130,2.1E-4
7,test_20231031_155507,10863862.png,317432,7439,309993,0.9765650596033166,2,6,66058,1092,64966,0.9834690726331405,35.67820088888889,6511.628522666667,9.993907440417022,130,2.1E-4
8,test_20231031_155507,11382381.png,312486,707,311779,0.9977374986399391,2,5,46745,96,46649,0.9979463044175848,21.47300977777778,2499.126186666667,14.152921756540431,130,2.1E-4
9,test_20231031_155507,11079715.png,443815,107837,335978,0.7570226333044174,5,6,124136,15131,109005,0.8781094928143327,17.708771555555554,2317.625856,14.480370335498858,130,2.1E-4
10,test_20231031_155507,11551286.png,271883,267,271616,0.9990179599312939,2,7,40092,37,40055,0.9990771226179787,17.919265777777778,1867.1754613333333,15.418952296845859,130,2.1E-4
1,test_20231031_155508,10404007.png,502730,16402,486328,0.9673741372108289,4,6,61265,2384,58881,0.961087080714927,26.161904,3559.777616,12.61657492996368,130,2.2E-4
2,test_20231031_155508,1254659.png,342646,65252,277394,0.8095643900702183,4,7,80080,9171,70909,0.885477022977023,21.881578666666666,3492.428917333333,12.699527853441253,130,2.2E-4
3,test_20231031_155508,10188041.png,221231,8404,212827,0.9620125570105456,3,6,41731,1193,40538,0.9714121396563705,11.447850666666668,1280.5076586666667,17.056981805572335,130,2.2E-4
4,test_20231031_155508,10287332.png,216980,11257,205723,0.9481196423633514,3,6,22337,1550,20787,0.9306084075748757,9.689633777777777,850.2091146666667,18.835546043579313,130,2.2E-4
5,test_20231031_155508,11610969.png,368720,21407,347313,0.9419423953135171,4,6,84111,3130,80981,0.9627872692037902,22.610574222222223,3255.403008,13.004756004317752,130,2.2E-4
6,test_20231031_155508,10350842.png,212614,4817,207797,0.977343919026969,3,6,42529,707,41822,0.983376049284018,19.67007111111111,2460.5717813333335,14.22044321803745,130,2.2E-4
7,test_20231031_155508,10863862.png,317432,7439,309993,0.9765650596033166,2,5,66058,1092,64966,0.9834690726331405,35.67820088888889,6511.628522666667,9.993907440417022,130,2.2E-4
8,test_20231031_155508,11382381.png,312486,707,311779,0.9977374986399391,2,5,46745,96,46649,0.9979463044175848,21.47300977777778,2499.126186666667,14.152921756540431,130,2.2E-4
9,test_20231031_155508,11079715.png,443815,107837,335978,0.7570226333044174,5,7,124136,15131,109005,0.8781094928143327,17.708771555555554,2317.625856,14.480370335498858,130,2.2E-4
10,test_20231031_155508,11551286.png,271883,267,271616,0.9990179599312939,2,5,40092,37,40055,0.9990771226179787,17.919265777777778,1867.1754613333333,15.418952296845859,130,2.2E-4
1,test_20231031_155509,10404007.png,502730,16402,486328,0.9673741372108289,3,6,61265,2384,58881,0.961087080714927,26.161904,3559.777616,12.61657492996368,130,2.3E-4
2,test_20231031_155509,1254659.png,342646,65252,277394,0.8095643900702183,5,6,80080,9171,70909,0.885477022977023,21.881578666666666,3492.428917333333,12.699527853441253,130,2.3E-4
3,test_20231031_155509,10188041.png,221231,8404,212827,0.9620125570105456,3,5,41731,1193,40538,0.9714121396563705,11.447850666666668,1280.5076586666667,17.056981805572335,130,2.3E-4
4,test_20231031_155509,10287332.png,216980,11257,205723,0.9481196423633514,3,6,22337,1550,20787,0.9306084075748757,9.689633777777777,850.2091146666667,18.835546043579313,130,2.3E-4
5,test_20231031_155509,11610969.png,368720,21407,347313,0.9419423953135171,4,6,84111,3130,80981,0.9627872692037902,22.610574222222223,3255.403008,13.004756004317752,130,2.3E-4
6,test_20231031_155509,10350842.png,212614,4817,207797,0.977343919026969,2,5,42529,707,41822,0.983376049284018,19.67007111111111,2460.5717813333335,14.22044321803745,130,2.3E-4
7,test_20231031_155509,10863862.png,317432,7439,309993,0.9765650596033166,2,6,66058,1092,64966,0.9834690726331405,35.67820088888889,6511.628522666667,9.993907440417022,130,2.3E-4
8,test_20231031_155509,11382381.png,312486,707,311779,0.9977374986399391,2,6,46745,96,46649,0.9979463044175848,21.47300977777778,2499.126186666667,14.152921756540431,130,2.3E-4
9,test_20231031_155509,11079715.png,443815,107837,335978,0.7570226333044174,5,7,124136,15131,109005,0.8781094928143327,17.708771555555554,2317.625856,14.480370335498858,130,2.3E-4
10,test_20231031_155509,11551286.png,271883,267,271616,0.9990179599312939,3,6,40092,37,40055,0.9990771226179787,17.919265777777778,1867.1754613333333,15.418952296845859,130,2.3E-4
1,test_20231031_155510,10404007.png,502730,16402,486328,0.9673741372108289,3,6,61265,2384,58881,0.961087080714927,26.161904,3559.777616,12.61657492996368,130,2.4E-4
2,test_20231031_155510,1254659.png,342646,65252,277394,0.8095643900702183,5,6,80080,9171,70909,0.885477022977023,21.881578666666666,3492.428917333333,12.699527853441253,130,2.4E-4
3,test_20231031_155510,10188041.png,221231,8404,212827,0.9620125570105456,3,6,41731,1193,40538,0.9714121396563705,11.447850666666668,1280.5076586666667,17.056981805572335,130,2.4E-4
4,test_20231031_155510,10287332.png,216980,11257,205723,0.9481196423633514,3,6,22337,1550,20787,0.9306084075748757,9.689633777777777,850.2091146666667,18.835546043579313,130,2.4E-4
5,test_20231031_155510,11610969.png,368720,21407,347313,0.9419423953135171,3,6,84111,3130,80981,0.9627872692037902,22.610574222222223,3255.403008,13.004756004317752,130,2.4E-4
6,test_20231031_155510,10350842.png,212614,4817,207797,0.977343919026969,2,5,42529,707,41822,0.983376049284018,19.67007111111111,2460.5717813333335,14.22044321803745,130,2.4E-4
7,test_20231031_155510,10863862.png,317432,7439,309993,0.9765650596033166,3,6,66058,1092,64966,0.9834690726331405,35.67820088888889,6511.628522666667,9.993907440417022,130,2.4E-4
8,test_20231031_155510,11382381.png,312486,707,311779,0.9977374986399391,2,12,46745,96,46649,0.9979463044175848,21.47300977777778,2499.126186666667,14.152921756540431,130,2.4E-4
9,test_20231031_155510,11079715.png,443815,107837,335978,0.7570226333044174,5,6,124136,15131,109005,0.8781094928143327,17.708771555555554,2317.625856,14.480370335498858,130,2.4E-4
10,test_20231031_155510,11551286.png,271883,267,271616,0.9990179599312939,1,5,40092,37,40055,0.9990771226179787,17.919265777777778,1867.1754613333333,15.418952296845859,130,2.4E-4
1,test_20231031_155511,10404007.png,502730,16402,486328,0.9673741372108289,4,6,61265,2384,58881,0.961087080714927,26.161904,3559.777616,12.61657492996368,130,2.5E-4
2,test_20231031_155511,1254659.png,342646,65252,277394,0.8095643900702183,4,15,80080,9171,70909,0.885477022977023,21.881578666666666,3492.428917333333,12.699527853441253,130,2.5E-4
3,test_20231031_155511,10188041.png,221231,8404,212827,0.9620125570105456,3,6,41731,1193,40538,0.9714121396563705,11.447850666666668,1280.5076586666667,17.056981805572335,130,2.5E-4
4,test_20231031_155511,10287332.png,216980,11257,205723,0.9481196423633514,3,6,22337,1550,20787,0.9306084075748757,9.689633777777777,850.2091146666667,18.835546043579313,130,2.5E-4
5,test_20231031_155511,11610969.png,368720,21407,347313,0.9419423953135171,4,6,84111,3130,80981,0.9627872692037902,22.610574222222223,3255.403008,13.004756004317752,130,2.5E-4
6,test_20231031_155511,10350842.png,212614,4817,207797,0.977343919026969,2,5,42529,707,41822,0.983376049284018,19.67007111111111,2460.5717813333335,14.22044321803745,130,2.5E-4
7,test_20231031_155511,10863862.png,317432,7439,309993,0.9765650596033166,8,5,66058,1092,64966,0.9834690726331405,35.67820088888889,6511.628522666667,9.993907440417022,130,2.5E-4
8,test_20231031_155511,11382381.png,312486,707,311779,0.9977374986399391,2,6,46745,96,46649,0.9979463044175848,21.47300977777778,2499.126186666667,14.152921756540431,130,2.5E-4
9,test_20231031_155511,11079715.png,443815,107837,335978,0.7570226333044174,5,7,124136,15131,109005,0.8781094928143327,17.708771555555554,2317.625856,14.480370335498858,130,2.5E-4
10,test_20231031_155511,11551286.png,271883,267,271616,0.9990179599312939,2,6,40092,37,40055,0.9990771226179787,17.919265777777778,1867.1754613333333,15.418952296845859,130,2.5E-4
1,test_20231031_155512,10404007.png,502730,16282,486448,0.9676128339267599,3,6,61265,2367,58898,0.9613645637802987,26.166622222222223,3560.861381333333,12.615252932576213,130,2.6000000000000003E-4
2,test_20231031_155512,1254659.png,342646,65192,277454,0.8097394979074614,4,6,80080,9165,70915,0.885551948051948,21.891132444444445,3493.511104,12.698182328858888,130,2.6000000000000003E-4
3,test_20231031_155512,10188041.png,221231,8364,212867,0.9621933634978823,3,6,41731,1187,40544,0.9715559176631281,11.813678222222222,1332.7883626666667,16.88319168860807,130,2.6000000000000003E-4
4,test_20231031_155512,10287332.png,216980,11257,205723,0.9481196423633514,2,5,22337,1550,20787,0.9306084075748757,9.689633777777777,850.2091146666667,18.835546043579313,130,2.6000000000000003E-4
5,test_20231031_155512,11610969.png,368720,21127,347593,0.9427017791277934,4,6,84111,3090,81021,0.9632628312586938,23.026140444444444,3340.5999893333333,12.892558854769415,130,2.6000000000000003E-4
6,test_20231031_155512,10350842.png,212614,4817,207797,0.977343919026969,2,6,42529,707,41822,0.983376049284018,19.67007111111111,2460.5717813333335,14.22044321803745,130,2.6000000000000003E-4
7,test_20231031_155512,10863862.png,317432,7399,310033,0.9766910708435192,3,6,66058,1086,64972,0.983559901904387,35.68389688888889,6512.697578666666,9.993194489713737,130,2.6000000000000003E-4
8,test_20231031_155512,11382381.png,312486,587,311899,0.9981215158439098,2,6,46745,78,46667,0.9983313723392876,21.967536,2569.068496,14.03304677372966,130,2.6000000000000003E-4
9,test_20231031_155512,11079715.png,443815,107837,335978,0.7570226333044174,5,7,124136,15131,109005,0.8781094928143327,17.708771555555554,2317.625856,14.480370335498858,130,2.6000000000000003E-4
10,test_20231031_155512,11551286.png,271883,204,271679,0.9992496772508763,2,5,40092,28,40064,0.9993016063054974,18.067507555555554,1885.468496,15.37661080624634,130,2.6000000000000003E-4
1,test_20231031_155513,10404007.png,502730,16282,486448,0.9676128339267599,3,5,61265,2367,58898,0.9613645637802987,26.166622222222223,3560.861381333333,12.615252932576213,130,2.7000000000000006E-4
2,test_20231031_155513,1254659.png,342646,65192,277454,0.8097394979074614,6,6,80080,9165,70915,0.885551948051948,21.891132444444445,3493.511104,12.698182328858888,130,2.7000000000000006E-4
3,test_20231031_155513,10188041.png,221231,8364,212867,0.9621933634978823,3,6,41731,1187,40544,0.9715559176631281,11.813678222222222,1332.7883626666667,16.88319168860807,130,2.7000000000000006E-4
4,test_20231031_155513,10287332.png,216980,11257,205723,0.9481196423633514,3,6,22337,1550,20787,0.9306084075748757,9.689633777777777,850.2091146666667,18.835546043579313,130,2.7000000000000006E-4
5,test_20231031_155513,11610969.png,368720,21127,347593,0.9427017791277934,3,5,84111,3090,81021,0.9632628312586938,23.026140444444444,3340.5999893333333,12.892558854769415,130,2.7000000000000006E-4
6,test_20231031_155513,10350842.png,212614,4817,207797,0.977343919026969,2,5,42529,707,41822,0.983376049284018,19.67007111111111,2460.5717813333335,14.22044321803745,130,2.7000000000000006E-4
7,test_20231031_155513,10863862.png,317432,7399,310033,0.9766910708435192,2,5,66058,1086,64972,0.983559901904387,35.68389688888889,6512.697578666666,9.993194489713737,130,2.7000000000000006E-4
8,test_20231031_155513,11382381.png,312486,587,311899,0.9981215158439098,3,5,46745,78,46667,0.9983313723392876,21.967536,2569.068496,14.03304677372966,130,2.7000000000000006E-4
9,test_20231031_155513,11079715.png,443815,107837,335978,0.7570226333044174,5,7,124136,15131,109005,0.8781094928143327,17.708771555555554,2317.625856,14.480370335498858,130,2.7000000000000006E-4
10,test_20231031_155513,11551286.png,271883,204,271679,0.9992496772508763,2,6,40092,28,40064,0.9993016063054974,18.067507555555554,1885.468496,15.37661080624634,130,2.7000000000000006E-4
1,test_20231031_155514,10404007.png,502730,16282,486448,0.9676128339267599,3,5,61265,2367,58898,0.9613645637802987,26.166622222222223,3560.861381333333,12.615252932576213,130,2.800000000000001E-4
2,test_20231031_155514,1254659.png,342646,65192,277454,0.8097394979074614,6,6,80080,9165,70915,0.885551948051948,21.891132444444445,3493.511104,12.698182328858888,130,2.800000000000001E-4
3,test_20231031_155514,10188041.png,221231,8364,212867,0.9621933634978823,4,6,41731,1187,40544,0.9715559176631281,11.813678222222222,1332.7883626666667,16.88319168860807,130,2.800000000000001E-4
4,test_20231031_155514,10287332.png,216980,11257,205723,0.9481196423633514,3,6,22337,1550,20787,0.9306084075748757,9.689633777777777,850.2091146666667,18.835546043579313,130,2.800000000000001E-4
5,test_20231031_155514,11610969.png,368720,21127,347593,0.9427017791277934,3,5,84111,3090,81021,0.9632628312586938,23.026140444444444,3340.5999893333333,12.892558854769415,130,2.800000000000001E-4
6,test_20231031_155514,10350842.png,212614,4817,207797,0.977343919026969,2,7,42529,707,41822,0.983376049284018,19.67007111111111,2460.5717813333335,14.22044321803745,130,2.800000000000001E-4
7,test_20231031_155514,10863862.png,317432,7399,310033,0.9766910708435192,2,6,66058,1086,64972,0.983559901904387,35.68389688888889,6512.697578666666,9.993194489713737,130,2.800000000000001E-4
8,test_20231031_155514,11382381.png,312486,587,311899,0.9981215158439098,3,6,46745,78,46667,0.9983313723392876,21.967536,2569.068496,14.03304677372966,130,2.800000000000001E-4
9,test_20231031_155514,11079715.png,443815,107837,335978,0.7570226333044174,5,9,124136,15131,109005,0.8781094928143327,17.708771555555554,2317.625856,14.480370335498858,130,2.800000000000001E-4
10,test_20231031_155514,11551286.png,271883,204,271679,0.9992496772508763,2,5,40092,28,40064,0.9993016063054974,18.067507555555554,1885.468496,15.37661080624634,130,2.800000000000001E-4
1,test_20231031_155516,10404007.png,502730,16282,486448,0.9676128339267599,3,6,61265,2367,58898,0.9613645637802987,26.166622222222223,3560.861381333333,12.615252932576213,130,2.900000000000001E-4
2,test_20231031_155516,1254659.png,342646,65192,277454,0.8097394979074614,4,6,80080,9165,70915,0.885551948051948,21.891132444444445,3493.511104,12.698182328858888,130,2.900000000000001E-4
3,test_20231031_155516,10188041.png,221231,8364,212867,0.9621933634978823,3,6,41731,1187,40544,0.9715559176631281,11.813678222222222,1332.7883626666667,16.88319168860807,130,2.900000000000001E-4
4,test_20231031_155516,10287332.png,216980,11257,205723,0.9481196423633514,2,5,22337,1550,20787,0.9306084075748757,9.689633777777777,850.2091146666667,18.835546043579313,130,2.900000000000001E-4
5,test_20231031_155516,11610969.png,368720,21127,347593,0.9427017791277934,4,6,84111,3090,81021,0.9632628312586938,23.026140444444444,3340.5999893333333,12.892558854769415,130,2.900000000000001E-4
6,test_20231031_155516,10350842.png,212614,4817,207797,0.977343919026969,2,6,42529,707,41822,0.983376049284018,19.67007111111111,2460.5717813333335,14.22044321803745,130,2.900000000000001E-4
7,test_20231031_155516,10863862.png,317432,7399,310033,0.9766910708435192,2,5,66058,1086,64972,0.983559901904387,35.68389688888889,6512.697578666666,9.993194489713737,130,2.900000000000001E-4
8,test_20231031_155516,11382381.png,312486,587,311899,0.9981215158439098,2,6,46745,78,46667,0.9983313723392876,21.967536,2569.068496,14.03304677372966,130,2.900000000000001E-4
9,test_20231031_155516,11079715.png,443815,107837,335978,0.7570226333044174,5,6,124136,15131,109005,0.8781094928143327,17.708771555555554,2317.625856,14.480370335498858,130,2.900000000000001E-4
10,test_20231031_155516,11551286.png,271883,204,271679,0.9992496772508763,2,6,40092,28,40064,0.9993016063054974,18.067507555555554,1885.468496,15.37661080624634,130,2.900000000000001E-4
1,test_20231031_155517,10404007.png,502730,15902,486828,0.9683687068605414,4,6,61265,2311,58954,0.9622786256426997,26.12632177777778,3556.940384,12.620037746016699,131,1.0E-5
2,test_20231031_155517,1254659.png,342646,63482,279164,0.8147300712688897,4,7,80080,8932,71148,0.8884615384615384,22.097859555555555,3563.7523413333333,12.611728452251572,131,1.0E-5
3,test_20231031_155517,10188041.png,221231,8142,213089,0.9631968395026014,8,6,41731,1155,40576,0.9723227336991684,11.613923555555555,1328.2626453333332,16.897964016937422,131,1.0E-5
4,test_20231031_155517,10287332.png,216980,11107,205873,0.9488109503180017,3,6,22337,1526,20811,0.9316828580382326,9.696193777777777,868.9342453333334,18.740934474449688,131,1.0E-5
5,test_20231031_155517,11610969.png,368720,20412,348308,0.9446409199392493,3,7,84111,2992,81119,0.9644279582932078,23.11974222222222,3369.6077386666666,12.855010139573743,131,1.0E-5
6,test_20231031_155517,10350842.png,212614,4777,207837,0.9775320533925329,2,6,42529,701,41828,0.983517129488114,19.68519288888889,2463.000773333333,14.216158126689425,131,1.0E-5
7,test_20231031_155517,10863862.png,317432,7117,310315,0.9775794500869478,3,5,66058,1047,65011,0.9841502921674892,35.75787733333333,6533.859029333334,9.979106007075385,131,1.0E-5
8,test_20231031_155517,11382381.png,312486,827,311659,0.9973534814359684,3,5,46745,113,46632,0.9975826291581987,20.486714666666668,2360.4332106666666,14.400886444502593,131,1.0E-5
9,test_20231031_155517,11079715.png,443815,104602,339213,0.7643117064542658,6,7,124136,14684,109452,0.8817103821615003,17.949937777777777,2382.459072,14.360549121901718,131,1.0E-5
10,test_20231031_155517,11551286.png,271883,657,271226,0.9975835193814987,2,6,40092,95,39997,0.9976304499650803,17.313984,1772.7602773333333,15.64430349051646,131,1.0E-5
1,test_20231031_155518,10404007.png,502730,15902,486828,0.9683687068605414,4,6,61265,2311,58954,0.9622786256426997,26.12632177777778,3556.940384,12.620037746016699,131,2.0E-5
2,test_20231031_155518,1254659.png,342646,63482,279164,0.8147300712688897,4,6,80080,8932,71148,0.8884615384615384,22.097859555555555,3563.7523413333333,12.611728452251572,131,2.0E-5
3,test_20231031_155518,10188041.png,221231,8142,213089,0.9631968395026014,3,7,41731,1155,40576,0.9723227336991684,11.613923555555555,1328.2626453333332,16.897964016937422,131,2.0E-5
4,test_20231031_155518,10287332.png,216980,11107,205873,0.9488109503180017,3,6,22337,1526,20811,0.9316828580382326,9.696193777777777,868.9342453333334,18.740934474449688,131,2.0E-5
5,test_20231031_155518,11610969.png,368720,20412,348308,0.9446409199392493,4,6,84111,2992,81119,0.9644279582932078,23.11974222222222,3369.6077386666666,12.855010139573743,131,2.0E-5
6,test_20231031_155518,10350842.png,212614,4777,207837,0.9775320533925329,3,6,42529,701,41828,0.983517129488114,19.68519288888889,2463.000773333333,14.216158126689425,131,2.0E-5
7,test_20231031_155518,10863862.png,317432,7117,310315,0.9775794500869478,3,6,66058,1047,65011,0.9841502921674892,35.75787733333333,6533.859029333334,9.979106007075385,131,2.0E-5
8,test_20231031_155518,11382381.png,312486,827,311659,0.9973534814359684,2,5,46745,113,46632,0.9975826291581987,20.486714666666668,2360.4332106666666,14.400886444502593,131,2.0E-5
9,test_20231031_155518,11079715.png,443815,104602,339213,0.7643117064542658,6,7,124136,14684,109452,0.8817103821615003,17.949937777777777,2382.459072,14.360549121901718,131,2.0E-5
10,test_20231031_155518,11551286.png,271883,657,271226,0.9975835193814987,3,6,40092,95,39997,0.9976304499650803,17.313984,1772.7602773333333,15.64430349051646,131,2.0E-5
1,test_20231031_155519,10404007.png,502730,15902,486828,0.9683687068605414,3,6,61265,2311,58954,0.9622786256426997,26.12632177777778,3556.940384,12.620037746016699,131,3.0000000000000004E-5
2,test_20231031_155519,1254659.png,342646,63482,279164,0.8147300712688897,5,6,80080,8932,71148,0.8884615384615384,22.097859555555555,3563.7523413333333,12.611728452251572,131,3.0000000000000004E-5
3,test_20231031_155519,10188041.png,221231,8142,213089,0.9631968395026014,3,6,41731,1155,40576,0.9723227336991684,11.613923555555555,1328.2626453333332,16.897964016937422,131,3.0000000000000004E-5
4,test_20231031_155519,10287332.png,216980,11107,205873,0.9488109503180017,2,5,22337,1526,20811,0.9316828580382326,9.696193777777777,868.9342453333334,18.740934474449688,131,3.0000000000000004E-5
5,test_20231031_155519,11610969.png,368720,20412,348308,0.9446409199392493,3,5,84111,2992,81119,0.9644279582932078,23.11974222222222,3369.6077386666666,12.855010139573743,131,3.0000000000000004E-5
6,test_20231031_155519,10350842.png,212614,4777,207837,0.9775320533925329,2,5,42529,701,41828,0.983517129488114,19.68519288888889,2463.000773333333,14.216158126689425,131,3.0000000000000004E-5
7,test_20231031_155519,10863862.png,317432,7117,310315,0.9775794500869478,3,6,66058,1047,65011,0.9841502921674892,35.75787733333333,6533.859029333334,9.979106007075385,131,3.0000000000000004E-5
8,test_20231031_155519,11382381.png,312486,827,311659,0.9973534814359684,2,5,46745,113,46632,0.9975826291581987,20.486714666666668,2360.4332106666666,14.400886444502593,131,3.0000000000000004E-5
9,test_20231031_155519,11079715.png,443815,104602,339213,0.7643117064542658,5,7,124136,14684,109452,0.8817103821615003,17.949937777777777,2382.459072,14.360549121901718,131,3.0000000000000004E-5
10,test_20231031_155519,11551286.png,271883,657,271226,0.9975835193814987,2,5,40092,95,39997,0.9976304499650803,17.313984,1772.7602773333333,15.64430349051646,131,3.0000000000000004E-5
1,test_20231031_155520,10404007.png,502730,15902,486828,0.9683687068605414,3,6,61265,2311,58954,0.9622786256426997,26.12632177777778,3556.940384,12.620037746016699,131,4.0E-5
2,test_20231031_155520,1254659.png,342646,63482,279164,0.8147300712688897,4,11,80080,8932,71148,0.8884615384615384,22.097859555555555,3563.7523413333333,12.611728452251572,131,4.0E-5
3,test_20231031_155520,10188041.png,221231,8142,213089,0.9631968395026014,3,5,41731,1155,40576,0.9723227336991684,11.613923555555555,1328.2626453333332,16.897964016937422,131,4.0E-5
4,test_20231031_155520,10287332.png,216980,11107,205873,0.9488109503180017,2,5,22337,1526,20811,0.9316828580382326,9.696193777777777,868.9342453333334,18.740934474449688,131,4.0E-5
5,test_20231031_155520,11610969.png,368720,20412,348308,0.9446409199392493,3,6,84111,2992,81119,0.9644279582932078,23.11974222222222,3369.6077386666666,12.855010139573743,131,4.0E-5
6,test_20231031_155520,10350842.png,212614,4777,207837,0.9775320533925329,3,6,42529,701,41828,0.983517129488114,19.68519288888889,2463.000773333333,14.216158126689425,131,4.0E-5
7,test_20231031_155520,10863862.png,317432,7117,310315,0.9775794500869478,2,6,66058,1047,65011,0.9841502921674892,35.75787733333333,6533.859029333334,9.979106007075385,131,4.0E-5
8,test_20231031_155520,11382381.png,312486,817,311669,0.9973854828696326,3,6,46745,112,46633,0.9976040218205156,21.216531555555555,2458.9940213333334,14.223228880483061,131,4.0E-5
9,test_20231031_155520,11079715.png,443815,104602,339213,0.7643117064542658,6,7,124136,14684,109452,0.8817103821615003,17.949937777777777,2382.459072,14.360549121901718,131,4.0E-5
10,test_20231031_155520,11551286.png,271883,657,271226,0.9975835193814987,2,5,40092,95,39997,0.9976304499650803,17.313984,1772.7602773333333,15.64430349051646,131,4.0E-5
1,test_20231031_155521,10404007.png,502730,15902,486828,0.9683687068605414,3,5,61265,2311,58954,0.9622786256426997,26.12632177777778,3556.940384,12.620037746016699,131,5.0E-5
2,test_20231031_155521,1254659.png,342646,63482,279164,0.8147300712688897,5,6,80080,8932,71148,0.8884615384615384,22.097859555555555,3563.7523413333333,12.611728452251572,131,5.0E-5
3,test_20231031_155521,10188041.png,221231,8142,213089,0.9631968395026014,3,12,41731,1155,40576,0.9723227336991684,11.613923555555555,1328.2626453333332,16.897964016937422,131,5.0E-5
4,test_20231031_155521,10287332.png,216980,11107,205873,0.9488109503180017,3,6,22337,1526,20811,0.9316828580382326,9.696193777777777,868.9342453333334,18.740934474449688,131,5.0E-5
5,test_20231031_155521,11610969.png,368720,20412,348308,0.9446409199392493,5,6,84111,2992,81119,0.9644279582932078,23.11974222222222,3369.6077386666666,12.855010139573743,131,5.0E-5
6,test_20231031_155521,10350842.png,212614,4777,207837,0.9775320533925329,3,7,42529,701,41828,0.983517129488114,19.68519288888889,2463.000773333333,14.216158126689425,131,5.0E-5
7,test_20231031_155521,10863862.png,317432,7117,310315,0.9775794500869478,2,6,66058,1047,65011,0.9841502921674892,35.75787733333333,6533.859029333334,9.979106007075385,131,5.0E-5
8,test_20231031_155521,11382381.png,312486,817,311669,0.9973854828696326,4,7,46745,112,46633,0.9976040218205156,21.216531555555555,2458.9940213333334,14.223228880483061,131,5.0E-5
9,test_20231031_155521,11079715.png,443815,104602,339213,0.7643117064542658,8,11,124136,14684,109452,0.8817103821615003,17.949937777777777,2382.459072,14.360549121901718,131,5.0E-5
10,test_20231031_155521,11551286.png,271883,657,271226,0.9975835193814987,2,7,40092,95,39997,0.9976304499650803,17.313984,1772.7602773333333,15.64430349051646,131,5.0E-5
1,test_20231031_155522,10404007.png,502730,15902,486828,0.9683687068605414,5,8,61265,2311,58954,0.9622786256426997,26.12632177777778,3556.940384,12.620037746016699,131,6.0E-5
2,test_20231031_155522,1254659.png,342646,63482,279164,0.8147300712688897,10,15,80080,8932,71148,0.8884615384615384,22.097859555555555,3563.7523413333333,12.611728452251572,131,6.0E-5
3,test_20231031_155522,10188041.png,221231,8142,213089,0.9631968395026014,7,14,41731,1155,40576,0.9723227336991684,11.613923555555555,1328.2626453333332,16.897964016937422,131,6.0E-5
4,test_20231031_155522,10287332.png,216980,11107,205873,0.9488109503180017,4,8,22337,1526,20811,0.9316828580382326,9.696193777777777,868.9342453333334,18.740934474449688,131,6.0E-5
5,test_20231031_155522,11610969.png,368720,20412,348308,0.9446409199392493,5,8,84111,2992,81119,0.9644279582932078,23.11974222222222,3369.6077386666666,12.855010139573743,131,6.0E-5
6,test_20231031_155522,10350842.png,212614,4777,207837,0.9775320533925329,3,7,42529,701,41828,0.983517129488114,19.68519288888889,2463.000773333333,14.216158126689425,131,6.0E-5
7,test_20231031_155522,10863862.png,317432,7117,310315,0.9775794500869478,4,7,66058,1047,65011,0.9841502921674892,35.75787733333333,6533.859029333334,9.979106007075385,131,6.0E-5
8,test_20231031_155522,11382381.png,312486,817,311669,0.9973854828696326,3,9,46745,112,46633,0.9976040218205156,21.216531555555555,2458.9940213333334,14.223228880483061,131,6.0E-5
9,test_20231031_155522,11079715.png,443815,104602,339213,0.7643117064542658,9,12,124136,14684,109452,0.8817103821615003,17.949937777777777,2382.459072,14.360549121901718,131,6.0E-5
10,test_20231031_155522,11551286.png,271883,657,271226,0.9975835193814987,3,7,40092,95,39997,0.9976304499650803,17.313984,1772.7602773333333,15.64430349051646,131,6.0E-5
1,test_20231031_155524,10404007.png,502730,15702,487028,0.9687665347204265,4,7,61265,2282,58983,0.9627519791071575,26.210798222222223,3575.592384,12.597323573071064,131,7.000000000000001E-5
2,test_20231031_155524,1254659.png,342646,63482,279164,0.8147300712688897,5,7,80080,8932,71148,0.8884615384615384,22.097859555555555,3563.7523413333333,12.611728452251572,131,7.000000000000001E-5
3,test_20231031_155524,10188041.png,221231,8142,213089,0.9631968395026014,4,6,41731,1155,40576,0.9723227336991684,11.613923555555555,1328.2626453333332,16.897964016937422,131,7.000000000000001E-5
4,test_20231031_155524,10287332.png,216980,11107,205873,0.9488109503180017,4,8,22337,1526,20811,0.9316828580382326,9.696193777777777,868.9342453333334,18.740934474449688,131,7.000000000000001E-5
5,test_20231031_155524,11610969.png,368720,20412,348308,0.9446409199392493,5,17,84111,2992,81119,0.9644279582932078,23.11974222222222,3369.6077386666666,12.855010139573743,131,7.000000000000001E-5
6,test_20231031_155524,10350842.png,212614,4777,207837,0.9775320533925329,4,9,42529,701,41828,0.983517129488114,19.68519288888889,2463.000773333333,14.216158126689425,131,7.000000000000001E-5
7,test_20231031_155524,10863862.png,317432,7117,310315,0.9775794500869478,5,8,66058,1047,65011,0.9841502921674892,35.75787733333333,6533.859029333334,9.979106007075385,131,7.000000000000001E-5
8,test_20231031_155524,11382381.png,312486,817,311669,0.9973854828696326,4,8,46745,112,46633,0.9976040218205156,21.216531555555555,2458.9940213333334,14.223228880483061,131,7.000000000000001E-5
9,test_20231031_155524,11079715.png,443815,104602,339213,0.7643117064542658,7,10,124136,14684,109452,0.8817103821615003,17.949937777777777,2382.459072,14.360549121901718,131,7.000000000000001E-5
10,test_20231031_155524,11551286.png,271883,537,271346,0.9980248857045126,3,9,40092,77,40015,0.9980794173401177,17.40031822222222,1778.8722506666666,15.629356004302238,131,7.000000000000001E-5
1,test_20231031_155525,10404007.png,502730,15702,487028,0.9687665347204265,4,7,61265,2282,58983,0.9627519791071575,26.210798222222223,3575.592384,12.597323573071064,131,8.0E-5
2,test_20231031_155525,1254659.png,342646,63482,279164,0.8147300712688897,6,10,80080,8932,71148,0.8884615384615384,22.097859555555555,3563.7523413333333,12.611728452251572,131,8.0E-5
3,test_20231031_155525,10188041.png,221231,8142,213089,0.9631968395026014,4,8,41731,1155,40576,0.9723227336991684,11.613923555555555,1328.2626453333332,16.897964016937422,131,8.0E-5
4,test_20231031_155525,10287332.png,216980,11107,205873,0.9488109503180017,4,6,22337,1526,20811,0.9316828580382326,9.696193777777777,868.9342453333334,18.740934474449688,131,8.0E-5
5,test_20231031_155525,11610969.png,368720,20412,348308,0.9446409199392493,4,7,84111,2992,81119,0.9644279582932078,23.11974222222222,3369.6077386666666,12.855010139573743,131,8.0E-5
6,test_20231031_155525,10350842.png,212614,4777,207837,0.9775320533925329,3,8,42529,701,41828,0.983517129488114,19.68519288888889,2463.000773333333,14.216158126689425,131,8.0E-5
7,test_20231031_155525,10863862.png,317432,7117,310315,0.9775794500869478,4,11,66058,1047,65011,0.9841502921674892,35.75787733333333,6533.859029333334,9.979106007075385,131,8.0E-5
8,test_20231031_155525,11382381.png,312486,817,311669,0.9973854828696326,4,9,46745,112,46633,0.9976040218205156,21.216531555555555,2458.9940213333334,14.223228880483061,131,8.0E-5
9,test_20231031_155525,11079715.png,443815,104602,339213,0.7643117064542658,6,8,124136,14684,109452,0.8817103821615003,17.949937777777777,2382.459072,14.360549121901718,131,8.0E-5
10,test_20231031_155525,11551286.png,271883,537,271346,0.9980248857045126,3,6,40092,77,40015,0.9980794173401177,17.40031822222222,1778.8722506666666,15.629356004302238,131,8.0E-5
1,test_20231031_155526,10404007.png,502730,15702,487028,0.9687665347204265,4,6,61265,2282,58983,0.9627519791071575,26.210798222222223,3575.592384,12.597323573071064,131,9.0E-5
2,test_20231031_155526,1254659.png,342646,63482,279164,0.8147300712688897,6,9,80080,8932,71148,0.8884615384615384,22.097859555555555,3563.7523413333333,12.611728452251572,131,9.0E-5
3,test_20231031_155526,10188041.png,221231,8142,213089,0.9631968395026014,4,7,41731,1155,40576,0.9723227336991684,11.613923555555555,1328.2626453333332,16.897964016937422,131,9.0E-5
4,test_20231031_155526,10287332.png,216980,11107,205873,0.9488109503180017,4,8,22337,1526,20811,0.9316828580382326,9.696193777777777,868.9342453333334,18.740934474449688,131,9.0E-5
5,test_20231031_155526,11610969.png,368720,20412,348308,0.9446409199392493,6,10,84111,2992,81119,0.9644279582932078,23.11974222222222,3369.6077386666666,12.855010139573743,131,9.0E-5
6,test_20231031_155526,10350842.png,212614,4777,207837,0.9775320533925329,4,9,42529,701,41828,0.983517129488114,19.68519288888889,2463.000773333333,14.216158126689425,131,9.0E-5
7,test_20231031_155526,10863862.png,317432,7117,310315,0.9775794500869478,3,7,66058,1047,65011,0.9841502921674892,35.75787733333333,6533.859029333334,9.979106007075385,131,9.0E-5
8,test_20231031_155526,11382381.png,312486,817,311669,0.9973854828696326,3,7,46745,112,46633,0.9976040218205156,21.216531555555555,2458.9940213333334,14.223228880483061,131,9.0E-5
9,test_20231031_155526,11079715.png,443815,104602,339213,0.7643117064542658,5,7,124136,14684,109452,0.8817103821615003,17.949937777777777,2382.459072,14.360549121901718,131,9.0E-5
10,test_20231031_155526,11551286.png,271883,537,271346,0.9980248857045126,2,6,40092,77,40015,0.9980794173401177,17.40031822222222,1778.8722506666666,15.629356004302238,131,9.0E-5
1,test_20231031_155528,10404007.png,502730,15702,487028,0.9687665347204265,4,7,61265,2282,58983,0.9627519791071575,26.210798222222223,3575.592384,12.597323573071064,131,1.0E-4
2,test_20231031_155528,1254659.png,342646,63482,279164,0.8147300712688897,5,8,80080,8932,71148,0.8884615384615384,22.097859555555555,3563.7523413333333,12.611728452251572,131,1.0E-4
3,test_20231031_155528,10188041.png,221231,8142,213089,0.9631968395026014,4,6,41731,1155,40576,0.9723227336991684,11.613923555555555,1328.2626453333332,16.897964016937422,131,1.0E-4
4,test_20231031_155528,10287332.png,216980,11107,205873,0.9488109503180017,3,6,22337,1526,20811,0.9316828580382326,9.696193777777777,868.9342453333334,18.740934474449688,131,1.0E-4
5,test_20231031_155528,11610969.png,368720,20412,348308,0.9446409199392493,4,7,84111,2992,81119,0.9644279582932078,23.11974222222222,3369.6077386666666,12.855010139573743,131,1.0E-4
6,test_20231031_155528,10350842.png,212614,4777,207837,0.9775320533925329,4,10,42529,701,41828,0.983517129488114,19.68519288888889,2463.000773333333,14.216158126689425,131,1.0E-4
7,test_20231031_155528,10863862.png,317432,7117,310315,0.9775794500869478,6,22,66058,1047,65011,0.9841502921674892,35.75787733333333,6533.859029333334,9.979106007075385,131,1.0E-4
8,test_20231031_155528,11382381.png,312486,817,311669,0.9973854828696326,4,9,46745,112,46633,0.9976040218205156,21.216531555555555,2458.9940213333334,14.223228880483061,131,1.0E-4
9,test_20231031_155528,11079715.png,443815,104602,339213,0.7643117064542658,7,9,124136,14684,109452,0.8817103821615003,17.949937777777777,2382.459072,14.360549121901718,131,1.0E-4
10,test_20231031_155528,11551286.png,271883,537,271346,0.9980248857045126,3,6,40092,77,40015,0.9980794173401177,17.40031822222222,1778.8722506666666,15.629356004302238,131,1.0E-4
1,test_20231031_155529,10404007.png,502730,15702,487028,0.9687665347204265,5,8,61265,2282,58983,0.9627519791071575,26.210798222222223,3575.592384,12.597323573071064,131,1.1E-4
2,test_20231031_155529,1254659.png,342646,63482,279164,0.8147300712688897,6,7,80080,8932,71148,0.8884615384615384,22.097859555555555,3563.7523413333333,12.611728452251572,131,1.1E-4
3,test_20231031_155529,10188041.png,221231,8142,213089,0.9631968395026014,4,7,41731,1155,40576,0.9723227336991684,11.613923555555555,1328.2626453333332,16.897964016937422,131,1.1E-4
4,test_20231031_155529,10287332.png,216980,11107,205873,0.9488109503180017,3,6,22337,1526,20811,0.9316828580382326,9.696193777777777,868.9342453333334,18.740934474449688,131,1.1E-4
5,test_20231031_155529,11610969.png,368720,20412,348308,0.9446409199392493,4,7,84111,2992,81119,0.9644279582932078,23.11974222222222,3369.6077386666666,12.855010139573743,131,1.1E-4
6,test_20231031_155529,10350842.png,212614,4777,207837,0.9775320533925329,3,6,42529,701,41828,0.983517129488114,19.68519288888889,2463.000773333333,14.216158126689425,131,1.1E-4
7,test_20231031_155529,10863862.png,317432,7117,310315,0.9775794500869478,3,6,66058,1047,65011,0.9841502921674892,35.75787733333333,6533.859029333334,9.979106007075385,131,1.1E-4
8,test_20231031_155529,11382381.png,312486,817,311669,0.9973854828696326,3,6,46745,112,46633,0.9976040218205156,21.216531555555555,2458.9940213333334,14.223228880483061,131,1.1E-4
9,test_20231031_155529,11079715.png,443815,104602,339213,0.7643117064542658,6,8,124136,14684,109452,0.8817103821615003,17.949937777777777,2382.459072,14.360549121901718,131,1.1E-4
10,test_20231031_155529,11551286.png,271883,537,271346,0.9980248857045126,3,6,40092,77,40015,0.9980794173401177,17.40031822222222,1778.8722506666666,15.629356004302238,131,1.1E-4
1,test_20231031_155530,10404007.png,502730,15702,487028,0.9687665347204265,4,7,61265,2282,58983,0.9627519791071575,26.210798222222223,3575.592384,12.597323573071064,131,1.2E-4
2,test_20231031_155530,1254659.png,342646,63482,279164,0.8147300712688897,5,7,80080,8932,71148,0.8884615384615384,22.097859555555555,3563.7523413333333,12.611728452251572,131,1.2E-4
3,test_20231031_155530,10188041.png,221231,8142,213089,0.9631968395026014,3,6,41731,1155,40576,0.9723227336991684,11.613923555555555,1328.2626453333332,16.897964016937422,131,1.2E-4
4,test_20231031_155530,10287332.png,216980,11107,205873,0.9488109503180017,3,6,22337,1526,20811,0.9316828580382326,9.696193777777777,868.9342453333334,18.740934474449688,131,1.2E-4
5,test_20231031_155530,11610969.png,368720,20412,348308,0.9446409199392493,5,7,84111,2992,81119,0.9644279582932078,23.11974222222222,3369.6077386666666,12.855010139573743,131,1.2E-4
6,test_20231031_155530,10350842.png,212614,4777,207837,0.9775320533925329,3,8,42529,701,41828,0.983517129488114,19.68519288888889,2463.000773333333,14.216158126689425,131,1.2E-4
7,test_20231031_155530,10863862.png,317432,7117,310315,0.9775794500869478,3,13,66058,1047,65011,0.9841502921674892,35.75787733333333,6533.859029333334,9.979106007075385,131,1.2E-4
8,test_20231031_155530,11382381.png,312486,817,311669,0.9973854828696326,3,6,46745,112,46633,0.9976040218205156,21.216531555555555,2458.9940213333334,14.223228880483061,131,1.2E-4
9,test_20231031_155530,11079715.png,443815,104602,339213,0.7643117064542658,5,7,124136,14684,109452,0.8817103821615003,17.949937777777777,2382.459072,14.360549121901718,131,1.2E-4
10,test_20231031_155530,11551286.png,271883,537,271346,0.9980248857045126,3,6,40092,77,40015,0.9980794173401177,17.40031822222222,1778.8722506666666,15.629356004302238,131,1.2E-4
1,test_20231031_155532,10404007.png,502730,15702,487028,0.9687665347204265,4,5,61265,2282,58983,0.9627519791071575,26.210798222222223,3575.592384,12.597323573071064,131,1.3000000000000002E-4
2,test_20231031_155532,1254659.png,342646,63482,279164,0.8147300712688897,5,6,80080,8932,71148,0.8884615384615384,22.097859555555555,3563.7523413333333,12.611728452251572,131,1.3000000000000002E-4
3,test_20231031_155532,10188041.png,221231,8142,213089,0.9631968395026014,4,5,41731,1155,40576,0.9723227336991684,11.613923555555555,1328.2626453333332,16.897964016937422,131,1.3000000000000002E-4
4,test_20231031_155532,10287332.png,216980,11107,205873,0.9488109503180017,2,6,22337,1526,20811,0.9316828580382326,9.696193777777777,868.9342453333334,18.740934474449688,131,1.3000000000000002E-4
5,test_20231031_155532,11610969.png,368720,20412,348308,0.9446409199392493,3,6,84111,2992,81119,0.9644279582932078,23.11974222222222,3369.6077386666666,12.855010139573743,131,1.3000000000000002E-4
6,test_20231031_155532,10350842.png,212614,4777,207837,0.9775320533925329,2,6,42529,701,41828,0.983517129488114,19.68519288888889,2463.000773333333,14.216158126689425,131,1.3000000000000002E-4
7,test_20231031_155532,10863862.png,317432,7117,310315,0.9775794500869478,3,6,66058,1047,65011,0.9841502921674892,35.75787733333333,6533.859029333334,9.979106007075385,131,1.3000000000000002E-4
8,test_20231031_155532,11382381.png,312486,817,311669,0.9973854828696326,2,5,46745,112,46633,0.9976040218205156,21.216531555555555,2458.9940213333334,14.223228880483061,131,1.3000000000000002E-4
9,test_20231031_155532,11079715.png,443815,104602,339213,0.7643117064542658,6,9,124136,14684,109452,0.8817103821615003,17.949937777777777,2382.459072,14.360549121901718,131,1.3000000000000002E-4
10,test_20231031_155532,11551286.png,271883,517,271366,0.9980984467583482,2,6,40092,74,40018,0.9981542452359573,17.640316444444444,1823.8651306666666,15.520876404571137,131,1.3000000000000002E-4
1,test_20231031_155533,10404007.png,502730,15702,487028,0.9687665347204265,4,7,61265,2282,58983,0.9627519791071575,26.210798222222223,3575.592384,12.597323573071064,131,1.4000000000000001E-4
2,test_20231031_155533,1254659.png,342646,63482,279164,0.8147300712688897,4,7,80080,8932,71148,0.8884615384615384,22.097859555555555,3563.7523413333333,12.611728452251572,131,1.4000000000000001E-4
3,test_20231031_155533,10188041.png,221231,8142,213089,0.9631968395026014,5,8,41731,1155,40576,0.9723227336991684,11.613923555555555,1328.2626453333332,16.897964016937422,131,1.4000000000000001E-4
4,test_20231031_155533,10287332.png,216980,11107,205873,0.9488109503180017,4,11,22337,1526,20811,0.9316828580382326,9.696193777777777,868.9342453333334,18.740934474449688,131,1.4000000000000001E-4
5,test_20231031_155533,11610969.png,368720,20412,348308,0.9446409199392493,4,7,84111,2992,81119,0.9644279582932078,23.11974222222222,3369.6077386666666,12.855010139573743,131,1.4000000000000001E-4
6,test_20231031_155533,10350842.png,212614,4777,207837,0.9775320533925329,3,6,42529,701,41828,0.983517129488114,19.68519288888889,2463.000773333333,14.216158126689425,131,1.4000000000000001E-4
7,test_20231031_155533,10863862.png,317432,7117,310315,0.9775794500869478,2,6,66058,1047,65011,0.9841502921674892,35.75787733333333,6533.859029333334,9.979106007075385,131,1.4000000000000001E-4
8,test_20231031_155533,11382381.png,312486,817,311669,0.9973854828696326,3,5,46745,112,46633,0.9976040218205156,21.216531555555555,2458.9940213333334,14.223228880483061,131,1.4000000000000001E-4
9,test_20231031_155533,11079715.png,443815,104602,339213,0.7643117064542658,5,6,124136,14684,109452,0.8817103821615003,17.949937777777777,2382.459072,14.360549121901718,131,1.4000000000000001E-4
10,test_20231031_155533,11551286.png,271883,517,271366,0.9980984467583482,2,6,40092,74,40018,0.9981542452359573,17.640316444444444,1823.8651306666666,15.520876404571137,131,1.4000000000000001E-4
1,test_20231031_155534,10404007.png,502730,15702,487028,0.9687665347204265,3,5,61265,2282,58983,0.9627519791071575,26.210798222222223,3575.592384,12.597323573071064,131,1.5000000000000001E-4
2,test_20231031_155534,1254659.png,342646,63482,279164,0.8147300712688897,4,7,80080,8932,71148,0.8884615384615384,22.097859555555555,3563.7523413333333,12.611728452251572,131,1.5000000000000001E-4
3,test_20231031_155534,10188041.png,221231,8142,213089,0.9631968395026014,3,6,41731,1155,40576,0.9723227336991684,11.613923555555555,1328.2626453333332,16.897964016937422,131,1.5000000000000001E-4
4,test_20231031_155534,10287332.png,216980,11107,205873,0.9488109503180017,3,6,22337,1526,20811,0.9316828580382326,9.696193777777777,868.9342453333334,18.740934474449688,131,1.5000000000000001E-4
5,test_20231031_155534,11610969.png,368720,20412,348308,0.9446409199392493,3,6,84111,2992,81119,0.9644279582932078,23.11974222222222,3369.6077386666666,12.855010139573743,131,1.5000000000000001E-4
6,test_20231031_155534,10350842.png,212614,4777,207837,0.9775320533925329,2,11,42529,701,41828,0.983517129488114,19.68519288888889,2463.000773333333,14.216158126689425,131,1.5000000000000001E-4
7,test_20231031_155534,10863862.png,317432,7117,310315,0.9775794500869478,2,5,66058,1047,65011,0.9841502921674892,35.75787733333333,6533.859029333334,9.979106007075385,131,1.5000000000000001E-4
8,test_20231031_155534,11382381.png,312486,707,311779,0.9977374986399391,2,5,46745,96,46649,0.9979463044175848,21.47300977777778,2499.126186666667,14.152921756540431,131,1.5000000000000001E-4
9,test_20231031_155534,11079715.png,443815,104602,339213,0.7643117064542658,5,12,124136,14684,109452,0.8817103821615003,17.949937777777777,2382.459072,14.360549121901718,131,1.5000000000000001E-4
10,test_20231031_155534,11551286.png,271883,517,271366,0.9980984467583482,2,6,40092,74,40018,0.9981542452359573,17.640316444444444,1823.8651306666666,15.520876404571137,131,1.5000000000000001E-4
1,test_20231031_155535,10404007.png,502730,15702,487028,0.9687665347204265,4,6,61265,2282,58983,0.9627519791071575,26.210798222222223,3575.592384,12.597323573071064,131,1.6E-4
2,test_20231031_155535,1254659.png,342646,63482,279164,0.8147300712688897,4,6,80080,8932,71148,0.8884615384615384,22.097859555555555,3563.7523413333333,12.611728452251572,131,1.6E-4
3,test_20231031_155535,10188041.png,221231,8142,213089,0.9631968395026014,3,5,41731,1155,40576,0.9723227336991684,11.613923555555555,1328.2626453333332,16.897964016937422,131,1.6E-4
4,test_20231031_155535,10287332.png,216980,10917,206063,0.9496866070605585,2,5,22337,1502,20835,0.9327573085015893,9.824568888888889,895.248896,18.611365667454372,131,1.6E-4
5,test_20231031_155535,11610969.png,368720,20412,348308,0.9446409199392493,3,6,84111,2992,81119,0.9644279582932078,23.11974222222222,3369.6077386666666,12.855010139573743,131,1.6E-4
6,test_20231031_155535,10350842.png,212614,4777,207837,0.9775320533925329,2,5,42529,701,41828,0.983517129488114,19.68519288888889,2463.000773333333,14.216158126689425,131,1.6E-4
7,test_20231031_155535,10863862.png,317432,7117,310315,0.9775794500869478,2,5,66058,1047,65011,0.9841502921674892,35.75787733333333,6533.859029333334,9.979106007075385,131,1.6E-4
8,test_20231031_155535,11382381.png,312486,707,311779,0.9977374986399391,2,5,46745,96,46649,0.9979463044175848,21.47300977777778,2499.126186666667,14.152921756540431,131,1.6E-4
9,test_20231031_155535,11079715.png,443815,104602,339213,0.7643117064542658,5,7,124136,14684,109452,0.8817103821615003,17.949937777777777,2382.459072,14.360549121901718,131,1.6E-4
10,test_20231031_155535,11551286.png,271883,517,271366,0.9980984467583482,2,6,40092,74,40018,0.9981542452359573,17.640316444444444,1823.8651306666666,15.520876404571137,131,1.6E-4
1,test_20231031_155536,10404007.png,502730,15702,487028,0.9687665347204265,3,6,61265,2282,58983,0.9627519791071575,26.210798222222223,3575.592384,12.597323573071064,131,1.7E-4
2,test_20231031_155536,1254659.png,342646,63482,279164,0.8147300712688897,4,6,80080,8932,71148,0.8884615384615384,22.097859555555555,3563.7523413333333,12.611728452251572,131,1.7E-4
3,test_20231031_155536,10188041.png,221231,8142,213089,0.9631968395026014,3,6,41731,1155,40576,0.9723227336991684,11.613923555555555,1328.2626453333332,16.897964016937422,131,1.7E-4
4,test_20231031_155536,10287332.png,216980,10917,206063,0.9496866070605585,2,5,22337,1502,20835,0.9327573085015893,9.824568888888889,895.248896,18.611365667454372,131,1.7E-4
5,test_20231031_155536,11610969.png,368720,20412,348308,0.9446409199392493,4,7,84111,2992,81119,0.9644279582932078,23.11974222222222,3369.6077386666666,12.855010139573743,131,1.7E-4
6,test_20231031_155536,10350842.png,212614,4777,207837,0.9775320533925329,2,6,42529,701,41828,0.983517129488114,19.68519288888889,2463.000773333333,14.216158126689425,131,1.7E-4
7,test_20231031_155536,10863862.png,317432,7117,310315,0.9775794500869478,3,9,66058,1047,65011,0.9841502921674892,35.75787733333333,6533.859029333334,9.979106007075385,131,1.7E-4
8,test_20231031_155536,11382381.png,312486,707,311779,0.9977374986399391,5,10,46745,96,46649,0.9979463044175848,21.47300977777778,2499.126186666667,14.152921756540431,131,1.7E-4
9,test_20231031_155536,11079715.png,443815,104602,339213,0.7643117064542658,7,11,124136,14684,109452,0.8817103821615003,17.949937777777777,2382.459072,14.360549121901718,131,1.7E-4
10,test_20231031_155536,11551286.png,271883,517,271366,0.9980984467583482,5,13,40092,74,40018,0.9981542452359573,17.640316444444444,1823.8651306666666,15.520876404571137,131,1.7E-4
1,test_20231031_155538,10404007.png,502730,15702,487028,0.9687665347204265,9,14,61265,2282,58983,0.9627519791071575,26.210798222222223,3575.592384,12.597323573071064,131,1.8E-4
2,test_20231031_155538,1254659.png,342646,63482,279164,0.8147300712688897,7,9,80080,8932,71148,0.8884615384615384,22.097859555555555,3563.7523413333333,12.611728452251572,131,1.8E-4
3,test_20231031_155538,10188041.png,221231,8142,213089,0.9631968395026014,4,7,41731,1155,40576,0.9723227336991684,11.613923555555555,1328.2626453333332,16.897964016937422,131,1.8E-4
4,test_20231031_155538,10287332.png,216980,10917,206063,0.9496866070605585,3,12,22337,1502,20835,0.9327573085015893,9.824568888888889,895.248896,18.611365667454372,131,1.8E-4
5,test_20231031_155538,11610969.png,368720,20412,348308,0.9446409199392493,15,14,84111,2992,81119,0.9644279582932078,23.11974222222222,3369.6077386666666,12.855010139573743,131,1.8E-4
6,test_20231031_155538,10350842.png,212614,4777,207837,0.9775320533925329,6,14,42529,701,41828,0.983517129488114,19.68519288888889,2463.000773333333,14.216158126689425,131,1.8E-4
7,test_20231031_155538,10863862.png,317432,7117,310315,0.9775794500869478,6,14,66058,1047,65011,0.9841502921674892,35.75787733333333,6533.859029333334,9.979106007075385,131,1.8E-4
8,test_20231031_155538,11382381.png,312486,707,311779,0.9977374986399391,6,13,46745,96,46649,0.9979463044175848,21.47300977777778,2499.126186666667,14.152921756540431,131,1.8E-4
9,test_20231031_155538,11079715.png,443815,104602,339213,0.7643117064542658,10,12,124136,14684,109452,0.8817103821615003,17.949937777777777,2382.459072,14.360549121901718,131,1.8E-4
10,test_20231031_155538,11551286.png,271883,517,271366,0.9980984467583482,3,8,40092,74,40018,0.9981542452359573,17.640316444444444,1823.8651306666666,15.520876404571137,131,1.8E-4
1,test_20231031_155540,10404007.png,502730,15702,487028,0.9687665347204265,5,19,61265,2282,58983,0.9627519791071575,26.210798222222223,3575.592384,12.597323573071064,131,1.9E-4
2,test_20231031_155540,1254659.png,342646,63482,279164,0.8147300712688897,6,10,80080,8932,71148,0.8884615384615384,22.097859555555555,3563.7523413333333,12.611728452251572,131,1.9E-4
3,test_20231031_155540,10188041.png,221231,8142,213089,0.9631968395026014,6,8,41731,1155,40576,0.9723227336991684,11.613923555555555,1328.2626453333332,16.897964016937422,131,1.9E-4
4,test_20231031_155540,10287332.png,216980,10917,206063,0.9496866070605585,4,8,22337,1502,20835,0.9327573085015893,9.824568888888889,895.248896,18.611365667454372,131,1.9E-4
5,test_20231031_155540,11610969.png,368720,20412,348308,0.9446409199392493,6,8,84111,2992,81119,0.9644279582932078,23.11974222222222,3369.6077386666666,12.855010139573743,131,1.9E-4
6,test_20231031_155540,10350842.png,212614,4777,207837,0.9775320533925329,3,8,42529,701,41828,0.983517129488114,19.68519288888889,2463.000773333333,14.216158126689425,131,1.9E-4
7,test_20231031_155540,10863862.png,317432,7117,310315,0.9775794500869478,3,6,66058,1047,65011,0.9841502921674892,35.75787733333333,6533.859029333334,9.979106007075385,131,1.9E-4
8,test_20231031_155540,11382381.png,312486,707,311779,0.9977374986399391,3,5,46745,96,46649,0.9979463044175848,21.47300977777778,2499.126186666667,14.152921756540431,131,1.9E-4
9,test_20231031_155540,11079715.png,443815,104602,339213,0.7643117064542658,5,7,124136,14684,109452,0.8817103821615003,17.949937777777777,2382.459072,14.360549121901718,131,1.9E-4
10,test_20231031_155540,11551286.png,271883,517,271366,0.9980984467583482,2,5,40092,74,40018,0.9981542452359573,17.640316444444444,1823.8651306666666,15.520876404571137,131,1.9E-4
1,test_20231031_155541,10404007.png,502730,15702,487028,0.9687665347204265,3,5,61265,2282,58983,0.9627519791071575,26.210798222222223,3575.592384,12.597323573071064,131,2.0E-4
2,test_20231031_155541,1254659.png,342646,63482,279164,0.8147300712688897,4,15,80080,8932,71148,0.8884615384615384,22.097859555555555,3563.7523413333333,12.611728452251572,131,2.0E-4
3,test_20231031_155541,10188041.png,221231,8142,213089,0.9631968395026014,3,6,41731,1155,40576,0.9723227336991684,11.613923555555555,1328.2626453333332,16.897964016937422,131,2.0E-4
4,test_20231031_155541,10287332.png,216980,10917,206063,0.9496866070605585,3,6,22337,1502,20835,0.9327573085015893,9.824568888888889,895.248896,18.611365667454372,131,2.0E-4
5,test_20231031_155541,11610969.png,368720,20412,348308,0.9446409199392493,3,5,84111,2992,81119,0.9644279582932078,23.11974222222222,3369.6077386666666,12.855010139573743,131,2.0E-4
6,test_20231031_155541,10350842.png,212614,4777,207837,0.9775320533925329,2,6,42529,701,41828,0.983517129488114,19.68519288888889,2463.000773333333,14.216158126689425,131,2.0E-4
7,test_20231031_155541,10863862.png,317432,7117,310315,0.9775794500869478,2,6,66058,1047,65011,0.9841502921674892,35.75787733333333,6533.859029333334,9.979106007075385,131,2.0E-4
8,test_20231031_155541,11382381.png,312486,707,311779,0.9977374986399391,2,5,46745,96,46649,0.9979463044175848,21.47300977777778,2499.126186666667,14.152921756540431,131,2.0E-4
9,test_20231031_155541,11079715.png,443815,104602,339213,0.7643117064542658,5,6,124136,14684,109452,0.8817103821615003,17.949937777777777,2382.459072,14.360549121901718,131,2.0E-4
10,test_20231031_155541,11551286.png,271883,267,271616,0.9990179599312939,2,5,40092,37,40055,0.9990771226179787,17.919265777777778,1867.1754613333333,15.418952296845859,131,2.0E-4
1,test_20231031_155542,10404007.png,502730,15702,487028,0.9687665347204265,4,6,61265,2282,58983,0.9627519791071575,26.210798222222223,3575.592384,12.597323573071064,131,2.1E-4
2,test_20231031_155542,1254659.png,342646,63482,279164,0.8147300712688897,4,6,80080,8932,71148,0.8884615384615384,22.097859555555555,3563.7523413333333,12.611728452251572,131,2.1E-4
3,test_20231031_155542,10188041.png,221231,8142,213089,0.9631968395026014,3,6,41731,1155,40576,0.9723227336991684,11.613923555555555,1328.2626453333332,16.897964016937422,131,2.1E-4
4,test_20231031_155542,10287332.png,216980,10917,206063,0.9496866070605585,3,6,22337,1502,20835,0.9327573085015893,9.824568888888889,895.248896,18.611365667454372,131,2.1E-4
5,test_20231031_155542,11610969.png,368720,20412,348308,0.9446409199392493,4,6,84111,2992,81119,0.9644279582932078,23.11974222222222,3369.6077386666666,12.855010139573743,131,2.1E-4
6,test_20231031_155542,10350842.png,212614,4777,207837,0.9775320533925329,2,5,42529,701,41828,0.983517129488114,19.68519288888889,2463.000773333333,14.216158126689425,131,2.1E-4
7,test_20231031_155542,10863862.png,317432,7117,310315,0.9775794500869478,3,6,66058,1047,65011,0.9841502921674892,35.75787733333333,6533.859029333334,9.979106007075385,131,2.1E-4
8,test_20231031_155542,11382381.png,312486,707,311779,0.9977374986399391,3,6,46745,96,46649,0.9979463044175848,21.47300977777778,2499.126186666667,14.152921756540431,131,2.1E-4
9,test_20231031_155542,11079715.png,443815,104602,339213,0.7643117064542658,5,7,124136,14684,109452,0.8817103821615003,17.949937777777777,2382.459072,14.360549121901718,131,2.1E-4
10,test_20231031_155542,11551286.png,271883,267,271616,0.9990179599312939,2,5,40092,37,40055,0.9990771226179787,17.919265777777778,1867.1754613333333,15.418952296845859,131,2.1E-4
1,test_20231031_155543,10404007.png,502730,15702,487028,0.9687665347204265,4,6,61265,2282,58983,0.9627519791071575,26.210798222222223,3575.592384,12.597323573071064,131,2.2E-4
2,test_20231031_155543,1254659.png,342646,63482,279164,0.8147300712688897,4,6,80080,8932,71148,0.8884615384615384,22.097859555555555,3563.7523413333333,12.611728452251572,131,2.2E-4
3,test_20231031_155543,10188041.png,221231,8142,213089,0.9631968395026014,3,6,41731,1155,40576,0.9723227336991684,11.613923555555555,1328.2626453333332,16.897964016937422,131,2.2E-4
4,test_20231031_155543,10287332.png,216980,10917,206063,0.9496866070605585,3,6,22337,1502,20835,0.9327573085015893,9.824568888888889,895.248896,18.611365667454372,131,2.2E-4
5,test_20231031_155543,11610969.png,368720,20412,348308,0.9446409199392493,3,6,84111,2992,81119,0.9644279582932078,23.11974222222222,3369.6077386666666,12.855010139573743,131,2.2E-4
6,test_20231031_155543,10350842.png,212614,4777,207837,0.9775320533925329,3,6,42529,701,41828,0.983517129488114,19.68519288888889,2463.000773333333,14.216158126689425,131,2.2E-4
7,test_20231031_155543,10863862.png,317432,7117,310315,0.9775794500869478,3,6,66058,1047,65011,0.9841502921674892,35.75787733333333,6533.859029333334,9.979106007075385,131,2.2E-4
8,test_20231031_155543,11382381.png,312486,707,311779,0.9977374986399391,2,5,46745,96,46649,0.9979463044175848,21.47300977777778,2499.126186666667,14.152921756540431,131,2.2E-4
9,test_20231031_155543,11079715.png,443815,104602,339213,0.7643117064542658,7,7,124136,14684,109452,0.8817103821615003,17.949937777777777,2382.459072,14.360549121901718,131,2.2E-4
10,test_20231031_155543,11551286.png,271883,267,271616,0.9990179599312939,2,6,40092,37,40055,0.9990771226179787,17.919265777777778,1867.1754613333333,15.418952296845859,131,2.2E-4
1,test_20231031_155544,10404007.png,502730,15702,487028,0.9687665347204265,4,6,61265,2282,58983,0.9627519791071575,26.210798222222223,3575.592384,12.597323573071064,131,2.3E-4
2,test_20231031_155544,1254659.png,342646,63482,279164,0.8147300712688897,6,8,80080,8932,71148,0.8884615384615384,22.097859555555555,3563.7523413333333,12.611728452251572,131,2.3E-4
3,test_20231031_155544,10188041.png,221231,8142,213089,0.9631968395026014,7,13,41731,1155,40576,0.9723227336991684,11.613923555555555,1328.2626453333332,16.897964016937422,131,2.3E-4
4,test_20231031_155544,10287332.png,216980,10917,206063,0.9496866070605585,6,14,22337,1502,20835,0.9327573085015893,9.824568888888889,895.248896,18.611365667454372,131,2.3E-4
5,test_20231031_155544,11610969.png,368720,20412,348308,0.9446409199392493,6,8,84111,2992,81119,0.9644279582932078,23.11974222222222,3369.6077386666666,12.855010139573743,131,2.3E-4
6,test_20231031_155544,10350842.png,212614,4777,207837,0.9775320533925329,3,7,42529,701,41828,0.983517129488114,19.68519288888889,2463.000773333333,14.216158126689425,131,2.3E-4
7,test_20231031_155544,10863862.png,317432,7117,310315,0.9775794500869478,2,6,66058,1047,65011,0.9841502921674892,35.75787733333333,6533.859029333334,9.979106007075385,131,2.3E-4
8,test_20231031_155544,11382381.png,312486,707,311779,0.9977374986399391,2,6,46745,96,46649,0.9979463044175848,21.47300977777778,2499.126186666667,14.152921756540431,131,2.3E-4
9,test_20231031_155544,11079715.png,443815,104602,339213,0.7643117064542658,6,13,124136,14684,109452,0.8817103821615003,17.949937777777777,2382.459072,14.360549121901718,131,2.3E-4
10,test_20231031_155544,11551286.png,271883,267,271616,0.9990179599312939,3,7,40092,37,40055,0.9990771226179787,17.919265777777778,1867.1754613333333,15.418952296845859,131,2.3E-4
1,test_20231031_155545,10404007.png,502730,15702,487028,0.9687665347204265,4,7,61265,2282,58983,0.9627519791071575,26.210798222222223,3575.592384,12.597323573071064,131,2.4E-4
2,test_20231031_155545,1254659.png,342646,63482,279164,0.8147300712688897,6,6,80080,8932,71148,0.8884615384615384,22.097859555555555,3563.7523413333333,12.611728452251572,131,2.4E-4
3,test_20231031_155545,10188041.png,221231,8142,213089,0.9631968395026014,4,6,41731,1155,40576,0.9723227336991684,11.613923555555555,1328.2626453333332,16.897964016937422,131,2.4E-4
4,test_20231031_155545,10287332.png,216980,10917,206063,0.9496866070605585,4,9,22337,1502,20835,0.9327573085015893,9.824568888888889,895.248896,18.611365667454372,131,2.4E-4
5,test_20231031_155545,11610969.png,368720,20412,348308,0.9446409199392493,7,11,84111,2992,81119,0.9644279582932078,23.11974222222222,3369.6077386666666,12.855010139573743,131,2.4E-4
6,test_20231031_155545,10350842.png,212614,4777,207837,0.9775320533925329,3,7,42529,701,41828,0.983517129488114,19.68519288888889,2463.000773333333,14.216158126689425,131,2.4E-4
7,test_20231031_155545,10863862.png,317432,7117,310315,0.9775794500869478,4,7,66058,1047,65011,0.9841502921674892,35.75787733333333,6533.859029333334,9.979106007075385,131,2.4E-4
8,test_20231031_155545,11382381.png,312486,707,311779,0.9977374986399391,3,6,46745,96,46649,0.9979463044175848,21.47300977777778,2499.126186666667,14.152921756540431,131,2.4E-4
9,test_20231031_155545,11079715.png,443815,104602,339213,0.7643117064542658,6,8,124136,14684,109452,0.8817103821615003,17.949937777777777,2382.459072,14.360549121901718,131,2.4E-4
10,test_20231031_155545,11551286.png,271883,267,271616,0.9990179599312939,3,6,40092,37,40055,0.9990771226179787,17.919265777777778,1867.1754613333333,15.418952296845859,131,2.4E-4
1,test_20231031_155547,10404007.png,502730,15702,487028,0.9687665347204265,4,8,61265,2282,58983,0.9627519791071575,26.210798222222223,3575.592384,12.597323573071064,131,2.5E-4
2,test_20231031_155547,1254659.png,342646,63482,279164,0.8147300712688897,6,7,80080,8932,71148,0.8884615384615384,22.097859555555555,3563.7523413333333,12.611728452251572,131,2.5E-4
3,test_20231031_155547,10188041.png,221231,8142,213089,0.9631968395026014,3,7,41731,1155,40576,0.9723227336991684,11.613923555555555,1328.2626453333332,16.897964016937422,131,2.5E-4
4,test_20231031_155547,10287332.png,216980,10917,206063,0.9496866070605585,3,6,22337,1502,20835,0.9327573085015893,9.824568888888889,895.248896,18.611365667454372,131,2.5E-4
5,test_20231031_155547,11610969.png,368720,20412,348308,0.9446409199392493,3,5,84111,2992,81119,0.9644279582932078,23.11974222222222,3369.6077386666666,12.855010139573743,131,2.5E-4
6,test_20231031_155547,10350842.png,212614,4777,207837,0.9775320533925329,2,5,42529,701,41828,0.983517129488114,19.68519288888889,2463.000773333333,14.216158126689425,131,2.5E-4
7,test_20231031_155547,10863862.png,317432,7117,310315,0.9775794500869478,3,6,66058,1047,65011,0.9841502921674892,35.75787733333333,6533.859029333334,9.979106007075385,131,2.5E-4
8,test_20231031_155547,11382381.png,312486,707,311779,0.9977374986399391,3,6,46745,96,46649,0.9979463044175848,21.47300977777778,2499.126186666667,14.152921756540431,131,2.5E-4
9,test_20231031_155547,11079715.png,443815,104602,339213,0.7643117064542658,5,8,124136,14684,109452,0.8817103821615003,17.949937777777777,2382.459072,14.360549121901718,131,2.5E-4
10,test_20231031_155547,11551286.png,271883,267,271616,0.9990179599312939,2,8,40092,37,40055,0.9990771226179787,17.919265777777778,1867.1754613333333,15.418952296845859,131,2.5E-4
1,test_20231031_155548,10404007.png,502730,15579,487151,0.9690111988542558,5,8,61265,2265,59000,0.9630294621725292,26.215516444444443,3576.6761493333333,12.596007421963613,131,2.6000000000000003E-4
2,test_20231031_155548,1254659.png,342646,63422,279224,0.8149051791061328,8,9,80080,8926,71154,0.8885364635364635,22.107413333333334,3564.834528,12.610409852338439,131,2.6000000000000003E-4
3,test_20231031_155548,10188041.png,221231,8102,213129,0.9633776459899381,4,8,41731,1149,40582,0.972466511705926,11.979751111111112,1380.5433493333333,16.73030312746173,131,2.6000000000000003E-4
4,test_20231031_155548,10287332.png,216980,10917,206063,0.9496866070605585,4,9,22337,1502,20835,0.9327573085015893,9.824568888888889,895.248896,18.611365667454372,131,2.6000000000000003E-4
5,test_20231031_155548,11610969.png,368720,20332,348388,0.9448578867433283,6,11,84111,2981,81130,0.9645587378583063,23.157488,3373.484581333333,12.850016313349945,131,2.6000000000000003E-4
6,test_20231031_155548,10350842.png,212614,4777,207837,0.9775320533925329,4,9,42529,701,41828,0.983517129488114,19.68519288888889,2463.000773333333,14.216158126689425,131,2.6000000000000003E-4
7,test_20231031_155548,10863862.png,317432,7077,310355,0.9777054613271504,3,7,66058,1041,65017,0.9842411214387357,35.76357333333333,6534.928085333333,9.978395481884935,131,2.6000000000000003E-4
8,test_20231031_155548,11382381.png,312486,587,311899,0.9981215158439098,3,7,46745,78,46667,0.9983313723392876,21.967536,2569.068496,14.03304677372966,131,2.6000000000000003E-4
9,test_20231031_155548,11079715.png,443815,104602,339213,0.7643117064542658,7,8,124136,14684,109452,0.8817103821615003,17.949937777777777,2382.459072,14.360549121901718,131,2.6000000000000003E-4
10,test_20231031_155548,11551286.png,271883,164,271719,0.9993967993585476,3,7,40092,22,40070,0.9994512620971765,18.120286222222223,1899.5769013333334,15.344234809036362,131,2.6000000000000003E-4
1,test_20231031_155549,10404007.png,502730,15579,487151,0.9690111988542558,4,6,61265,2265,59000,0.9630294621725292,26.215516444444443,3576.6761493333333,12.596007421963613,131,2.7000000000000006E-4
2,test_20231031_155549,1254659.png,342646,63422,279224,0.8149051791061328,6,8,80080,8926,71154,0.8885364635364635,22.107413333333334,3564.834528,12.610409852338439,131,2.7000000000000006E-4
3,test_20231031_155549,10188041.png,221231,8102,213129,0.9633776459899381,4,6,41731,1149,40582,0.972466511705926,11.979751111111112,1380.5433493333333,16.73030312746173,131,2.7000000000000006E-4
4,test_20231031_155549,10287332.png,216980,10917,206063,0.9496866070605585,3,10,22337,1502,20835,0.9327573085015893,9.824568888888889,895.248896,18.611365667454372,131,2.7000000000000006E-4
5,test_20231031_155549,11610969.png,368720,20332,348388,0.9448578867433283,4,6,84111,2981,81130,0.9645587378583063,23.157488,3373.484581333333,12.850016313349945,131,2.7000000000000006E-4
6,test_20231031_155549,10350842.png,212614,4777,207837,0.9775320533925329,3,6,42529,701,41828,0.983517129488114,19.68519288888889,2463.000773333333,14.216158126689425,131,2.7000000000000006E-4
7,test_20231031_155549,10863862.png,317432,7077,310355,0.9777054613271504,3,6,66058,1041,65017,0.9842411214387357,35.76357333333333,6534.928085333333,9.978395481884935,131,2.7000000000000006E-4
8,test_20231031_155549,11382381.png,312486,587,311899,0.9981215158439098,3,6,46745,78,46667,0.9983313723392876,21.967536,2569.068496,14.03304677372966,131,2.7000000000000006E-4
9,test_20231031_155549,11079715.png,443815,104602,339213,0.7643117064542658,5,7,124136,14684,109452,0.8817103821615003,17.949937777777777,2382.459072,14.360549121901718,131,2.7000000000000006E-4
10,test_20231031_155549,11551286.png,271883,164,271719,0.9993967993585476,2,6,40092,22,40070,0.9994512620971765,18.120286222222223,1899.5769013333334,15.344234809036362,131,2.7000000000000006E-4
1,test_20231031_155550,10404007.png,502730,15579,487151,0.9690111988542558,5,7,61265,2265,59000,0.9630294621725292,26.215516444444443,3576.6761493333333,12.596007421963613,131,2.800000000000001E-4
2,test_20231031_155550,1254659.png,342646,63422,279224,0.8149051791061328,7,10,80080,8926,71154,0.8885364635364635,22.107413333333334,3564.834528,12.610409852338439,131,2.800000000000001E-4
3,test_20231031_155550,10188041.png,221231,8102,213129,0.9633776459899381,4,7,41731,1149,40582,0.972466511705926,11.979751111111112,1380.5433493333333,16.73030312746173,131,2.800000000000001E-4
4,test_20231031_155550,10287332.png,216980,10917,206063,0.9496866070605585,3,7,22337,1502,20835,0.9327573085015893,9.824568888888889,895.248896,18.611365667454372,131,2.800000000000001E-4
5,test_20231031_155550,11610969.png,368720,20332,348388,0.9448578867433283,4,7,84111,2981,81130,0.9645587378583063,23.157488,3373.484581333333,12.850016313349945,131,2.800000000000001E-4
6,test_20231031_155550,10350842.png,212614,4777,207837,0.9775320533925329,3,7,42529,701,41828,0.983517129488114,19.68519288888889,2463.000773333333,14.216158126689425,131,2.800000000000001E-4
7,test_20231031_155550,10863862.png,317432,7077,310355,0.9777054613271504,3,6,66058,1041,65017,0.9842411214387357,35.76357333333333,6534.928085333333,9.978395481884935,131,2.800000000000001E-4
8,test_20231031_155550,11382381.png,312486,587,311899,0.9981215158439098,3,6,46745,78,46667,0.9983313723392876,21.967536,2569.068496,14.03304677372966,131,2.800000000000001E-4
9,test_20231031_155550,11079715.png,443815,104602,339213,0.7643117064542658,6,9,124136,14684,109452,0.8817103821615003,17.949937777777777,2382.459072,14.360549121901718,131,2.800000000000001E-4
10,test_20231031_155550,11551286.png,271883,164,271719,0.9993967993585476,3,6,40092,22,40070,0.9994512620971765,18.120286222222223,1899.5769013333334,15.344234809036362,131,2.800000000000001E-4
1,test_20231031_155552,10404007.png,502730,15579,487151,0.9690111988542558,4,15,61265,2265,59000,0.9630294621725292,26.215516444444443,3576.6761493333333,12.596007421963613,131,2.900000000000001E-4
2,test_20231031_155552,1254659.png,342646,63422,279224,0.8149051791061328,6,8,80080,8926,71154,0.8885364635364635,22.107413333333334,3564.834528,12.610409852338439,131,2.900000000000001E-4
3,test_20231031_155552,10188041.png,221231,8102,213129,0.9633776459899381,4,8,41731,1149,40582,0.972466511705926,11.979751111111112,1380.5433493333333,16.73030312746173,131,2.900000000000001E-4
4,test_20231031_155552,10287332.png,216980,10917,206063,0.9496866070605585,3,7,22337,1502,20835,0.9327573085015893,9.824568888888889,895.248896,18.611365667454372,131,2.900000000000001E-4
5,test_20231031_155552,11610969.png,368720,20332,348388,0.9448578867433283,4,7,84111,2981,81130,0.9645587378583063,23.157488,3373.484581333333,12.850016313349945,131,2.900000000000001E-4
6,test_20231031_155552,10350842.png,212614,4777,207837,0.9775320533925329,4,8,42529,701,41828,0.983517129488114,19.68519288888889,2463.000773333333,14.216158126689425,131,2.900000000000001E-4
7,test_20231031_155552,10863862.png,317432,7077,310355,0.9777054613271504,4,7,66058,1041,65017,0.9842411214387357,35.76357333333333,6534.928085333333,9.978395481884935,131,2.900000000000001E-4
8,test_20231031_155552,11382381.png,312486,587,311899,0.9981215158439098,4,9,46745,78,46667,0.9983313723392876,21.967536,2569.068496,14.03304677372966,131,2.900000000000001E-4
9,test_20231031_155552,11079715.png,443815,104602,339213,0.7643117064542658,7,10,124136,14684,109452,0.8817103821615003,17.949937777777777,2382.459072,14.360549121901718,131,2.900000000000001E-4
10,test_20231031_155552,11551286.png,271883,164,271719,0.9993967993585476,3,8,40092,22,40070,0.9994512620971765,18.120286222222223,1899.5769013333334,15.344234809036362,131,2.900000000000001E-4
1,test_20231031_155553,10404007.png,502730,14997,487733,0.9701688779265212,4,7,61265,2183,59082,0.9643679098996164,26.26188088888889,3595.4905386666665,12.573222105988407,132,1.0E-5
2,test_20231031_155553,1254659.png,342646,61492,281154,0.8205378145374527,6,8,80080,8660,71420,0.8918581418581418,22.37580088888889,3655.8830826666667,12.500880625819997,132,1.0E-5
3,test_20231031_155553,10188041.png,221231,7962,213269,0.9640104686956168,6,10,41731,1128,40603,0.9729697347295775,11.738563555555556,1370.24816,16.76281133303664,132,1.0E-5
4,test_20231031_155553,10287332.png,216980,10607,206373,0.9511153101668357,4,8,22337,1456,20881,0.9348166718896898,9.912922666666667,943.6587786666666,18.382653764547456,132,1.0E-5
5,test_20231031_155553,11610969.png,368720,19779,348941,0.9463576697765241,5,8,84111,2902,81209,0.965497972916741,23.214288,3392.272112,12.825896788397955,132,1.0E-5
6,test_20231031_155553,10350842.png,212614,4557,208057,0.9785667924031343,4,8,42529,670,41859,0.9842460438759435,19.768544,2479.744469333333,14.18673430556272,132,1.0E-5
7,test_20231031_155553,10863862.png,317432,6857,310575,0.9783985231482648,4,9,66058,1009,65049,0.9847255442187168,35.86164977777778,6559.87024,9.96185112133917,132,1.0E-5
8,test_20231031_155553,11382381.png,312486,807,311679,0.9974174843032968,5,10,46745,110,46635,0.9976468071451492,20.579290666666665,2386.569818666667,14.353062167735953,132,1.0E-5
9,test_20231031_155553,11079715.png,443815,101847,341968,0.7705192478848168,8,10,124136,14305,109831,0.8847634852097699,18.156124444444444,2439.9212586666667,14.25704549889165,132,1.0E-5
10,test_20231031_155553,11551286.png,271883,637,271246,0.9976570804353343,3,6,40092,92,40000,0.9977052778609199,17.315537777777777,1773.2081386666666,15.643206449122175,132,1.0E-5
1,test_20231031_155555,10404007.png,502730,14997,487733,0.9701688779265212,4,6,61265,2183,59082,0.9643679098996164,26.26188088888889,3595.4905386666665,12.573222105988407,132,2.0E-5
2,test_20231031_155555,1254659.png,342646,61492,281154,0.8205378145374527,5,6,80080,8660,71420,0.8918581418581418,22.37580088888889,3655.8830826666667,12.500880625819997,132,2.0E-5
3,test_20231031_155555,10188041.png,221231,7962,213269,0.9640104686956168,3,5,41731,1128,40603,0.9729697347295775,11.738563555555556,1370.24816,16.76281133303664,132,2.0E-5
4,test_20231031_155555,10287332.png,216980,10607,206373,0.9511153101668357,3,6,22337,1456,20881,0.9348166718896898,9.912922666666667,943.6587786666666,18.382653764547456,132,2.0E-5
5,test_20231031_155555,11610969.png,368720,19779,348941,0.9463576697765241,3,13,84111,2902,81209,0.965497972916741,23.214288,3392.272112,12.825896788397955,132,2.0E-5
6,test_20231031_155555,10350842.png,212614,4557,208057,0.9785667924031343,2,6,42529,670,41859,0.9842460438759435,19.768544,2479.744469333333,14.18673430556272,132,2.0E-5
7,test_20231031_155555,10863862.png,317432,6857,310575,0.9783985231482648,2,5,66058,1009,65049,0.9847255442187168,35.86164977777778,6559.87024,9.96185112133917,132,2.0E-5
8,test_20231031_155555,11382381.png,312486,797,311689,0.997449485736961,3,5,46745,109,46636,0.997668199807466,21.309107555555556,2485.130629333333,14.177311387814227,132,2.0E-5
9,test_20231031_155555,11079715.png,443815,101847,341968,0.7705192478848168,5,6,124136,14305,109831,0.8847634852097699,18.156124444444444,2439.9212586666667,14.25704549889165,132,2.0E-5
10,test_20231031_155555,11551286.png,271883,637,271246,0.9976570804353343,2,6,40092,92,40000,0.9977052778609199,17.315537777777777,1773.2081386666666,15.643206449122175,132,2.0E-5
1,test_20231031_155556,10404007.png,502730,14997,487733,0.9701688779265212,4,5,61265,2183,59082,0.9643679098996164,26.26188088888889,3595.4905386666665,12.573222105988407,132,3.0000000000000004E-5
2,test_20231031_155556,1254659.png,342646,61492,281154,0.8205378145374527,5,6,80080,8660,71420,0.8918581418581418,22.37580088888889,3655.8830826666667,12.500880625819997,132,3.0000000000000004E-5
3,test_20231031_155556,10188041.png,221231,7962,213269,0.9640104686956168,3,6,41731,1128,40603,0.9729697347295775,11.738563555555556,1370.24816,16.76281133303664,132,3.0000000000000004E-5
4,test_20231031_155556,10287332.png,216980,10607,206373,0.9511153101668357,3,6,22337,1456,20881,0.9348166718896898,9.912922666666667,943.6587786666666,18.382653764547456,132,3.0000000000000004E-5
5,test_20231031_155556,11610969.png,368720,19779,348941,0.9463576697765241,4,6,84111,2902,81209,0.965497972916741,23.214288,3392.272112,12.825896788397955,132,3.0000000000000004E-5
6,test_20231031_155556,10350842.png,212614,4557,208057,0.9785667924031343,2,6,42529,670,41859,0.9842460438759435,19.768544,2479.744469333333,14.18673430556272,132,3.0000000000000004E-5
7,test_20231031_155556,10863862.png,317432,6857,310575,0.9783985231482648,3,6,66058,1009,65049,0.9847255442187168,35.86164977777778,6559.87024,9.96185112133917,132,3.0000000000000004E-5
8,test_20231031_155556,11382381.png,312486,797,311689,0.997449485736961,2,5,46745,109,46636,0.997668199807466,21.309107555555556,2485.130629333333,14.177311387814227,132,3.0000000000000004E-5
9,test_20231031_155556,11079715.png,443815,101847,341968,0.7705192478848168,5,7,124136,14305,109831,0.8847634852097699,18.156124444444444,2439.9212586666667,14.25704549889165,132,3.0000000000000004E-5
10,test_20231031_155556,11551286.png,271883,637,271246,0.9976570804353343,2,6,40092,92,40000,0.9977052778609199,17.315537777777777,1773.2081386666666,15.643206449122175,132,3.0000000000000004E-5
1,test_20231031_155557,10404007.png,502730,14997,487733,0.9701688779265212,4,5,61265,2183,59082,0.9643679098996164,26.26188088888889,3595.4905386666665,12.573222105988407,132,4.0E-5
2,test_20231031_155557,1254659.png,342646,61492,281154,0.8205378145374527,5,7,80080,8660,71420,0.8918581418581418,22.37580088888889,3655.8830826666667,12.500880625819997,132,4.0E-5
3,test_20231031_155557,10188041.png,221231,7962,213269,0.9640104686956168,3,5,41731,1128,40603,0.9729697347295775,11.738563555555556,1370.24816,16.76281133303664,132,4.0E-5
4,test_20231031_155557,10287332.png,216980,10607,206373,0.9511153101668357,2,5,22337,1456,20881,0.9348166718896898,9.912922666666667,943.6587786666666,18.382653764547456,132,4.0E-5
5,test_20231031_155557,11610969.png,368720,19779,348941,0.9463576697765241,3,5,84111,2902,81209,0.965497972916741,23.214288,3392.272112,12.825896788397955,132,4.0E-5
6,test_20231031_155557,10350842.png,212614,4557,208057,0.9785667924031343,3,6,42529,670,41859,0.9842460438759435,19.768544,2479.744469333333,14.18673430556272,132,4.0E-5
7,test_20231031_155557,10863862.png,317432,6857,310575,0.9783985231482648,2,5,66058,1009,65049,0.9847255442187168,35.86164977777778,6559.87024,9.96185112133917,132,4.0E-5
8,test_20231031_155557,11382381.png,312486,797,311689,0.997449485736961,2,5,46745,109,46636,0.997668199807466,21.309107555555556,2485.130629333333,14.177311387814227,132,4.0E-5
9,test_20231031_155557,11079715.png,443815,101847,341968,0.7705192478848168,7,7,124136,14305,109831,0.8847634852097699,18.156124444444444,2439.9212586666667,14.25704549889165,132,4.0E-5
10,test_20231031_155557,11551286.png,271883,637,271246,0.9976570804353343,2,5,40092,92,40000,0.9977052778609199,17.315537777777777,1773.2081386666666,15.643206449122175,132,4.0E-5
1,test_20231031_155558,10404007.png,502730,14997,487733,0.9701688779265212,3,6,61265,2183,59082,0.9643679098996164,26.26188088888889,3595.4905386666665,12.573222105988407,132,5.0E-5
2,test_20231031_155558,1254659.png,342646,61492,281154,0.8205378145374527,4,6,80080,8660,71420,0.8918581418581418,22.37580088888889,3655.8830826666667,12.500880625819997,132,5.0E-5
3,test_20231031_155558,10188041.png,221231,7962,213269,0.9640104686956168,3,5,41731,1128,40603,0.9729697347295775,11.738563555555556,1370.24816,16.76281133303664,132,5.0E-5
4,test_20231031_155558,10287332.png,216980,10607,206373,0.9511153101668357,2,5,22337,1456,20881,0.9348166718896898,9.912922666666667,943.6587786666666,18.382653764547456,132,5.0E-5
5,test_20231031_155558,11610969.png,368720,19779,348941,0.9463576697765241,4,6,84111,2902,81209,0.965497972916741,23.214288,3392.272112,12.825896788397955,132,5.0E-5
6,test_20231031_155558,10350842.png,212614,4557,208057,0.9785667924031343,3,7,42529,670,41859,0.9842460438759435,19.768544,2479.744469333333,14.18673430556272,132,5.0E-5
7,test_20231031_155558,10863862.png,317432,6857,310575,0.9783985231482648,3,6,66058,1009,65049,0.9847255442187168,35.86164977777778,6559.87024,9.96185112133917,132,5.0E-5
8,test_20231031_155558,11382381.png,312486,797,311689,0.997449485736961,3,5,46745,109,46636,0.997668199807466,21.309107555555556,2485.130629333333,14.177311387814227,132,5.0E-5
9,test_20231031_155558,11079715.png,443815,101847,341968,0.7705192478848168,6,6,124136,14305,109831,0.8847634852097699,18.156124444444444,2439.9212586666667,14.25704549889165,132,5.0E-5
10,test_20231031_155558,11551286.png,271883,637,271246,0.9976570804353343,2,15,40092,92,40000,0.9977052778609199,17.315537777777777,1773.2081386666666,15.643206449122175,132,5.0E-5
1,test_20231031_155559,10404007.png,502730,14997,487733,0.9701688779265212,4,6,61265,2183,59082,0.9643679098996164,26.26188088888889,3595.4905386666665,12.573222105988407,132,6.0E-5
2,test_20231031_155559,1254659.png,342646,61492,281154,0.8205378145374527,4,6,80080,8660,71420,0.8918581418581418,22.37580088888889,3655.8830826666667,12.500880625819997,132,6.0E-5
3,test_20231031_155559,10188041.png,221231,7962,213269,0.9640104686956168,3,6,41731,1128,40603,0.9729697347295775,11.738563555555556,1370.24816,16.76281133303664,132,6.0E-5
4,test_20231031_155559,10287332.png,216980,10607,206373,0.9511153101668357,3,6,22337,1456,20881,0.9348166718896898,9.912922666666667,943.6587786666666,18.382653764547456,132,6.0E-5
5,test_20231031_155559,11610969.png,368720,19779,348941,0.9463576697765241,3,6,84111,2902,81209,0.965497972916741,23.214288,3392.272112,12.825896788397955,132,6.0E-5
6,test_20231031_155559,10350842.png,212614,4557,208057,0.9785667924031343,2,6,42529,670,41859,0.9842460438759435,19.768544,2479.744469333333,14.18673430556272,132,6.0E-5
7,test_20231031_155559,10863862.png,317432,6857,310575,0.9783985231482648,3,6,66058,1009,65049,0.9847255442187168,35.86164977777778,6559.87024,9.96185112133917,132,6.0E-5
8,test_20231031_155559,11382381.png,312486,797,311689,0.997449485736961,3,6,46745,109,46636,0.997668199807466,21.309107555555556,2485.130629333333,14.177311387814227,132,6.0E-5
9,test_20231031_155559,11079715.png,443815,101847,341968,0.7705192478848168,5,7,124136,14305,109831,0.8847634852097699,18.156124444444444,2439.9212586666667,14.25704549889165,132,6.0E-5
10,test_20231031_155559,11551286.png,271883,637,271246,0.9976570804353343,2,5,40092,92,40000,0.9977052778609199,17.315537777777777,1773.2081386666666,15.643206449122175,132,6.0E-5
1,test_20231031_155600,10404007.png,502730,14797,487933,0.9705667057864062,3,5,61265,2154,59111,0.964841263364074,26.346357333333334,3614.1425386666665,12.550750841051833,132,7.000000000000001E-5
2,test_20231031_155600,1254659.png,342646,61492,281154,0.8205378145374527,4,7,80080,8660,71420,0.8918581418581418,22.37580088888889,3655.8830826666667,12.500880625819997,132,7.000000000000001E-5
3,test_20231031_155600,10188041.png,221231,7962,213269,0.9640104686956168,3,5,41731,1128,40603,0.9729697347295775,11.738563555555556,1370.24816,16.76281133303664,132,7.000000000000001E-5
4,test_20231031_155600,10287332.png,216980,10607,206373,0.9511153101668357,2,5,22337,1456,20881,0.9348166718896898,9.912922666666667,943.6587786666666,18.382653764547456,132,7.000000000000001E-5
5,test_20231031_155600,11610969.png,368720,19779,348941,0.9463576697765241,4,6,84111,2902,81209,0.965497972916741,23.214288,3392.272112,12.825896788397955,132,7.000000000000001E-5
6,test_20231031_155600,10350842.png,212614,4194,208420,0.9802741117706266,2,5,42529,617,41912,0.9854922523454583,21.679027555555557,2995.340346666667,13.366341844659766,132,7.000000000000001E-5
7,test_20231031_155600,10863862.png,317432,6857,310575,0.9783985231482648,2,6,66058,1009,65049,0.9847255442187168,35.86164977777778,6559.87024,9.96185112133917,132,7.000000000000001E-5
8,test_20231031_155600,11382381.png,312486,797,311689,0.997449485736961,2,5,46745,109,46636,0.997668199807466,21.309107555555556,2485.130629333333,14.177311387814227,132,7.000000000000001E-5
9,test_20231031_155600,11079715.png,443815,101847,341968,0.7705192478848168,5,7,124136,14305,109831,0.8847634852097699,18.156124444444444,2439.9212586666667,14.25704549889165,132,7.000000000000001E-5
10,test_20231031_155600,11551286.png,271883,497,271386,0.998172007812184,2,6,40092,71,40021,0.9982290731317969,17.641870222222224,1824.312992,15.519810098595052,132,7.000000000000001E-5
1,test_20231031_155601,10404007.png,502730,14797,487933,0.9705667057864062,3,6,61265,2154,59111,0.964841263364074,26.346357333333334,3614.1425386666665,12.550750841051833,132,8.0E-5
2,test_20231031_155601,1254659.png,342646,61492,281154,0.8205378145374527,5,6,80080,8660,71420,0.8918581418581418,22.37580088888889,3655.8830826666667,12.500880625819997,132,8.0E-5
3,test_20231031_155601,10188041.png,221231,7962,213269,0.9640104686956168,3,6,41731,1128,40603,0.9729697347295775,11.738563555555556,1370.24816,16.76281133303664,132,8.0E-5
4,test_20231031_155601,10287332.png,216980,10607,206373,0.9511153101668357,3,6,22337,1456,20881,0.9348166718896898,9.912922666666667,943.6587786666666,18.382653764547456,132,8.0E-5
5,test_20231031_155601,11610969.png,368720,19779,348941,0.9463576697765241,4,6,84111,2902,81209,0.965497972916741,23.214288,3392.272112,12.825896788397955,132,8.0E-5
6,test_20231031_155601,10350842.png,212614,4194,208420,0.9802741117706266,2,5,42529,617,41912,0.9854922523454583,21.679027555555557,2995.340346666667,13.366341844659766,132,8.0E-5
7,test_20231031_155601,10863862.png,317432,6857,310575,0.9783985231482648,2,5,66058,1009,65049,0.9847255442187168,35.86164977777778,6559.87024,9.96185112133917,132,8.0E-5
8,test_20231031_155601,11382381.png,312486,797,311689,0.997449485736961,3,6,46745,109,46636,0.997668199807466,21.309107555555556,2485.130629333333,14.177311387814227,132,8.0E-5
9,test_20231031_155601,11079715.png,443815,101847,341968,0.7705192478848168,5,7,124136,14305,109831,0.8847634852097699,18.156124444444444,2439.9212586666667,14.25704549889165,132,8.0E-5
10,test_20231031_155601,11551286.png,271883,497,271386,0.998172007812184,2,6,40092,71,40021,0.9982290731317969,17.641870222222224,1824.312992,15.519810098595052,132,8.0E-5
1,test_20231031_155602,10404007.png,502730,14797,487933,0.9705667057864062,4,6,61265,2154,59111,0.964841263364074,26.346357333333334,3614.1425386666665,12.550750841051833,132,9.0E-5
2,test_20231031_155602,1254659.png,342646,61492,281154,0.8205378145374527,4,6,80080,8660,71420,0.8918581418581418,22.37580088888889,3655.8830826666667,12.500880625819997,132,9.0E-5
3,test_20231031_155602,10188041.png,221231,7962,213269,0.9640104686956168,3,6,41731,1128,40603,0.9729697347295775,11.738563555555556,1370.24816,16.76281133303664,132,9.0E-5
4,test_20231031_155602,10287332.png,216980,10607,206373,0.9511153101668357,3,6,22337,1456,20881,0.9348166718896898,9.912922666666667,943.6587786666666,18.382653764547456,132,9.0E-5
5,test_20231031_155602,11610969.png,368720,19779,348941,0.9463576697765241,3,6,84111,2902,81209,0.965497972916741,23.214288,3392.272112,12.825896788397955,132,9.0E-5
6,test_20231031_155602,10350842.png,212614,4194,208420,0.9802741117706266,3,6,42529,617,41912,0.9854922523454583,21.679027555555557,2995.340346666667,13.366341844659766,132,9.0E-5
7,test_20231031_155602,10863862.png,317432,6857,310575,0.9783985231482648,3,7,66058,1009,65049,0.9847255442187168,35.86164977777778,6559.87024,9.96185112133917,132,9.0E-5
8,test_20231031_155602,11382381.png,312486,797,311689,0.997449485736961,2,5,46745,109,46636,0.997668199807466,21.309107555555556,2485.130629333333,14.177311387814227,132,9.0E-5
9,test_20231031_155602,11079715.png,443815,101847,341968,0.7705192478848168,5,6,124136,14305,109831,0.8847634852097699,18.156124444444444,2439.9212586666667,14.25704549889165,132,9.0E-5
10,test_20231031_155602,11551286.png,271883,497,271386,0.998172007812184,2,6,40092,71,40021,0.9982290731317969,17.641870222222224,1824.312992,15.519810098595052,132,9.0E-5
1,test_20231031_155603,10404007.png,502730,14797,487933,0.9705667057864062,3,13,61265,2154,59111,0.964841263364074,26.346357333333334,3614.1425386666665,12.550750841051833,132,1.0E-4
2,test_20231031_155603,1254659.png,342646,61492,281154,0.8205378145374527,4,7,80080,8660,71420,0.8918581418581418,22.37580088888889,3655.8830826666667,12.500880625819997,132,1.0E-4
3,test_20231031_155603,10188041.png,221231,7962,213269,0.9640104686956168,3,6,41731,1128,40603,0.9729697347295775,11.738563555555556,1370.24816,16.76281133303664,132,1.0E-4
4,test_20231031_155603,10287332.png,216980,10607,206373,0.9511153101668357,3,6,22337,1456,20881,0.9348166718896898,9.912922666666667,943.6587786666666,18.382653764547456,132,1.0E-4
5,test_20231031_155603,11610969.png,368720,19779,348941,0.9463576697765241,3,6,84111,2902,81209,0.965497972916741,23.214288,3392.272112,12.825896788397955,132,1.0E-4
6,test_20231031_155603,10350842.png,212614,4194,208420,0.9802741117706266,2,11,42529,617,41912,0.9854922523454583,21.679027555555557,2995.340346666667,13.366341844659766,132,1.0E-4
7,test_20231031_155603,10863862.png,317432,6857,310575,0.9783985231482648,3,6,66058,1009,65049,0.9847255442187168,35.86164977777778,6559.87024,9.96185112133917,132,1.0E-4
8,test_20231031_155603,11382381.png,312486,797,311689,0.997449485736961,2,5,46745,109,46636,0.997668199807466,21.309107555555556,2485.130629333333,14.177311387814227,132,1.0E-4
9,test_20231031_155603,11079715.png,443815,101847,341968,0.7705192478848168,5,7,124136,14305,109831,0.8847634852097699,18.156124444444444,2439.9212586666667,14.25704549889165,132,1.0E-4
10,test_20231031_155603,11551286.png,271883,497,271386,0.998172007812184,2,5,40092,71,40021,0.9982290731317969,17.641870222222224,1824.312992,15.519810098595052,132,1.0E-4
1,test_20231031_155604,10404007.png,502730,14797,487933,0.9705667057864062,4,14,61265,2154,59111,0.964841263364074,26.346357333333334,3614.1425386666665,12.550750841051833,132,1.1E-4
2,test_20231031_155604,1254659.png,342646,61492,281154,0.8205378145374527,4,6,80080,8660,71420,0.8918581418581418,22.37580088888889,3655.8830826666667,12.500880625819997,132,1.1E-4
3,test_20231031_155604,10188041.png,221231,7962,213269,0.9640104686956168,3,5,41731,1128,40603,0.9729697347295775,11.738563555555556,1370.24816,16.76281133303664,132,1.1E-4
4,test_20231031_155604,10287332.png,216980,10607,206373,0.9511153101668357,3,6,22337,1456,20881,0.9348166718896898,9.912922666666667,943.6587786666666,18.382653764547456,132,1.1E-4
5,test_20231031_155604,11610969.png,368720,19779,348941,0.9463576697765241,4,6,84111,2902,81209,0.965497972916741,23.214288,3392.272112,12.825896788397955,132,1.1E-4
6,test_20231031_155604,10350842.png,212614,4194,208420,0.9802741117706266,2,5,42529,617,41912,0.9854922523454583,21.679027555555557,2995.340346666667,13.366341844659766,132,1.1E-4
7,test_20231031_155604,10863862.png,317432,6857,310575,0.9783985231482648,2,6,66058,1009,65049,0.9847255442187168,35.86164977777778,6559.87024,9.96185112133917,132,1.1E-4
8,test_20231031_155604,11382381.png,312486,797,311689,0.997449485736961,2,5,46745,109,46636,0.997668199807466,21.309107555555556,2485.130629333333,14.177311387814227,132,1.1E-4
9,test_20231031_155604,11079715.png,443815,101847,341968,0.7705192478848168,5,6,124136,14305,109831,0.8847634852097699,18.156124444444444,2439.9212586666667,14.25704549889165,132,1.1E-4
10,test_20231031_155604,11551286.png,271883,497,271386,0.998172007812184,2,5,40092,71,40021,0.9982290731317969,17.641870222222224,1824.312992,15.519810098595052,132,1.1E-4
1,test_20231031_155605,10404007.png,502730,14797,487933,0.9705667057864062,4,6,61265,2154,59111,0.964841263364074,26.346357333333334,3614.1425386666665,12.550750841051833,132,1.2E-4
2,test_20231031_155605,1254659.png,342646,61492,281154,0.8205378145374527,4,6,80080,8660,71420,0.8918581418581418,22.37580088888889,3655.8830826666667,12.500880625819997,132,1.2E-4
3,test_20231031_155605,10188041.png,221231,7962,213269,0.9640104686956168,3,6,41731,1128,40603,0.9729697347295775,11.738563555555556,1370.24816,16.76281133303664,132,1.2E-4
4,test_20231031_155605,10287332.png,216980,10607,206373,0.9511153101668357,3,6,22337,1456,20881,0.9348166718896898,9.912922666666667,943.6587786666666,18.382653764547456,132,1.2E-4
5,test_20231031_155605,11610969.png,368720,19779,348941,0.9463576697765241,4,6,84111,2902,81209,0.965497972916741,23.214288,3392.272112,12.825896788397955,132,1.2E-4
6,test_20231031_155605,10350842.png,212614,4194,208420,0.9802741117706266,2,6,42529,617,41912,0.9854922523454583,21.679027555555557,2995.340346666667,13.366341844659766,132,1.2E-4
7,test_20231031_155605,10863862.png,317432,6857,310575,0.9783985231482648,2,5,66058,1009,65049,0.9847255442187168,35.86164977777778,6559.87024,9.96185112133917,132,1.2E-4
8,test_20231031_155605,11382381.png,312486,797,311689,0.997449485736961,3,6,46745,109,46636,0.997668199807466,21.309107555555556,2485.130629333333,14.177311387814227,132,1.2E-4
9,test_20231031_155605,11079715.png,443815,101847,341968,0.7705192478848168,5,6,124136,14305,109831,0.8847634852097699,18.156124444444444,2439.9212586666667,14.25704549889165,132,1.2E-4
10,test_20231031_155605,11551286.png,271883,497,271386,0.998172007812184,2,5,40092,71,40021,0.9982290731317969,17.641870222222224,1824.312992,15.519810098595052,132,1.2E-4
1,test_20231031_155606,10404007.png,502730,14797,487933,0.9705667057864062,3,6,61265,2154,59111,0.964841263364074,26.346357333333334,3614.1425386666665,12.550750841051833,132,1.3000000000000002E-4
2,test_20231031_155606,1254659.png,342646,61492,281154,0.8205378145374527,4,6,80080,8660,71420,0.8918581418581418,22.37580088888889,3655.8830826666667,12.500880625819997,132,1.3000000000000002E-4
3,test_20231031_155606,10188041.png,221231,7962,213269,0.9640104686956168,4,5,41731,1128,40603,0.9729697347295775,11.738563555555556,1370.24816,16.76281133303664,132,1.3000000000000002E-4
4,test_20231031_155606,10287332.png,216980,10607,206373,0.9511153101668357,3,5,22337,1456,20881,0.9348166718896898,9.912922666666667,943.6587786666666,18.382653764547456,132,1.3000000000000002E-4
5,test_20231031_155606,11610969.png,368720,19779,348941,0.9463576697765241,3,5,84111,2902,81209,0.965497972916741,23.214288,3392.272112,12.825896788397955,132,1.3000000000000002E-4
6,test_20231031_155606,10350842.png,212614,4194,208420,0.9802741117706266,2,6,42529,617,41912,0.9854922523454583,21.679027555555557,2995.340346666667,13.366341844659766,132,1.3000000000000002E-4
7,test_20231031_155606,10863862.png,317432,6857,310575,0.9783985231482648,3,6,66058,1009,65049,0.9847255442187168,35.86164977777778,6559.87024,9.96185112133917,132,1.3000000000000002E-4
8,test_20231031_155606,11382381.png,312486,797,311689,0.997449485736961,2,5,46745,109,46636,0.997668199807466,21.309107555555556,2485.130629333333,14.177311387814227,132,1.3000000000000002E-4
9,test_20231031_155606,11079715.png,443815,101847,341968,0.7705192478848168,5,6,124136,14305,109831,0.8847634852097699,18.156124444444444,2439.9212586666667,14.25704549889165,132,1.3000000000000002E-4
10,test_20231031_155606,11551286.png,271883,497,271386,0.998172007812184,2,6,40092,71,40021,0.9982290731317969,17.641870222222224,1824.312992,15.519810098595052,132,1.3000000000000002E-4
1,test_20231031_155607,10404007.png,502730,14797,487933,0.9705667057864062,3,6,61265,2154,59111,0.964841263364074,26.346357333333334,3614.1425386666665,12.550750841051833,132,1.4000000000000001E-4
2,test_20231031_155607,1254659.png,342646,61492,281154,0.8205378145374527,4,6,80080,8660,71420,0.8918581418581418,22.37580088888889,3655.8830826666667,12.500880625819997,132,1.4000000000000001E-4
3,test_20231031_155607,10188041.png,221231,7962,213269,0.9640104686956168,3,6,41731,1128,40603,0.9729697347295775,11.738563555555556,1370.24816,16.76281133303664,132,1.4000000000000001E-4
4,test_20231031_155607,10287332.png,216980,10607,206373,0.9511153101668357,3,6,22337,1456,20881,0.9348166718896898,9.912922666666667,943.6587786666666,18.382653764547456,132,1.4000000000000001E-4
5,test_20231031_155607,11610969.png,368720,19779,348941,0.9463576697765241,3,6,84111,2902,81209,0.965497972916741,23.214288,3392.272112,12.825896788397955,132,1.4000000000000001E-4
6,test_20231031_155607,10350842.png,212614,4194,208420,0.9802741117706266,2,6,42529,617,41912,0.9854922523454583,21.679027555555557,2995.340346666667,13.366341844659766,132,1.4000000000000001E-4
7,test_20231031_155607,10863862.png,317432,6857,310575,0.9783985231482648,3,6,66058,1009,65049,0.9847255442187168,35.86164977777778,6559.87024,9.96185112133917,132,1.4000000000000001E-4
8,test_20231031_155607,11382381.png,312486,797,311689,0.997449485736961,2,5,46745,109,46636,0.997668199807466,21.309107555555556,2485.130629333333,14.177311387814227,132,1.4000000000000001E-4
9,test_20231031_155607,11079715.png,443815,101847,341968,0.7705192478848168,5,6,124136,14305,109831,0.8847634852097699,18.156124444444444,2439.9212586666667,14.25704549889165,132,1.4000000000000001E-4
10,test_20231031_155607,11551286.png,271883,497,271386,0.998172007812184,2,6,40092,71,40021,0.9982290731317969,17.641870222222224,1824.312992,15.519810098595052,132,1.4000000000000001E-4
1,test_20231031_155608,10404007.png,502730,14797,487933,0.9705667057864062,4,6,61265,2154,59111,0.964841263364074,26.346357333333334,3614.1425386666665,12.550750841051833,132,1.5000000000000001E-4
2,test_20231031_155608,1254659.png,342646,61492,281154,0.8205378145374527,4,6,80080,8660,71420,0.8918581418581418,22.37580088888889,3655.8830826666667,12.500880625819997,132,1.5000000000000001E-4
3,test_20231031_155608,10188041.png,221231,7962,213269,0.9640104686956168,3,5,41731,1128,40603,0.9729697347295775,11.738563555555556,1370.24816,16.76281133303664,132,1.5000000000000001E-4
4,test_20231031_155608,10287332.png,216980,10607,206373,0.9511153101668357,3,6,22337,1456,20881,0.9348166718896898,9.912922666666667,943.6587786666666,18.382653764547456,132,1.5000000000000001E-4
5,test_20231031_155608,11610969.png,368720,19779,348941,0.9463576697765241,3,6,84111,2902,81209,0.965497972916741,23.214288,3392.272112,12.825896788397955,132,1.5000000000000001E-4
6,test_20231031_155608,10350842.png,212614,4194,208420,0.9802741117706266,2,5,42529,617,41912,0.9854922523454583,21.679027555555557,2995.340346666667,13.366341844659766,132,1.5000000000000001E-4
7,test_20231031_155608,10863862.png,317432,6857,310575,0.9783985231482648,2,5,66058,1009,65049,0.9847255442187168,35.86164977777778,6559.87024,9.96185112133917,132,1.5000000000000001E-4
8,test_20231031_155608,11382381.png,312486,687,311799,0.9978015015072675,2,6,46745,93,46652,0.9980104824045353,21.565585777777777,2525.2627946666667,14.107737806568558,132,1.5000000000000001E-4
9,test_20231031_155608,11079715.png,443815,101847,341968,0.7705192478848168,4,6,124136,14305,109831,0.8847634852097699,18.156124444444444,2439.9212586666667,14.25704549889165,132,1.5000000000000001E-4
10,test_20231031_155608,11551286.png,271883,497,271386,0.998172007812184,3,5,40092,71,40021,0.9982290731317969,17.641870222222224,1824.312992,15.519810098595052,132,1.5000000000000001E-4
1,test_20231031_155609,10404007.png,502730,14797,487933,0.9705667057864062,4,6,61265,2154,59111,0.964841263364074,26.346357333333334,3614.1425386666665,12.550750841051833,132,1.6E-4
2,test_20231031_155609,1254659.png,342646,61492,281154,0.8205378145374527,4,6,80080,8660,71420,0.8918581418581418,22.37580088888889,3655.8830826666667,12.500880625819997,132,1.6E-4
3,test_20231031_155609,10188041.png,221231,7962,213269,0.9640104686956168,3,6,41731,1128,40603,0.9729697347295775,11.738563555555556,1370.24816,16.76281133303664,132,1.6E-4
4,test_20231031_155609,10287332.png,216980,10414,206566,0.9520047930684856,3,5,22337,1432,20905,0.9358911223530465,10.041297777777778,969.9734293333333,18.26320523150082,132,1.6E-4
5,test_20231031_155609,11610969.png,368720,19779,348941,0.9463576697765241,4,6,84111,2902,81209,0.965497972916741,23.214288,3392.272112,12.825896788397955,132,1.6E-4
6,test_20231031_155609,10350842.png,212614,4194,208420,0.9802741117706266,3,6,42529,617,41912,0.9854922523454583,21.679027555555557,2995.340346666667,13.366341844659766,132,1.6E-4
7,test_20231031_155609,10863862.png,317432,6857,310575,0.9783985231482648,2,5,66058,1009,65049,0.9847255442187168,35.86164977777778,6559.87024,9.96185112133917,132,1.6E-4
8,test_20231031_155609,11382381.png,312486,687,311799,0.9978015015072675,3,6,46745,93,46652,0.9980104824045353,21.565585777777777,2525.2627946666667,14.107737806568558,132,1.6E-4
9,test_20231031_155609,11079715.png,443815,101847,341968,0.7705192478848168,5,6,124136,14305,109831,0.8847634852097699,18.156124444444444,2439.9212586666667,14.25704549889165,132,1.6E-4
10,test_20231031_155609,11551286.png,271883,497,271386,0.998172007812184,2,6,40092,71,40021,0.9982290731317969,17.641870222222224,1824.312992,15.519810098595052,132,1.6E-4
1,test_20231031_155610,10404007.png,502730,14797,487933,0.9705667057864062,4,5,61265,2154,59111,0.964841263364074,26.346357333333334,3614.1425386666665,12.550750841051833,132,1.7E-4
2,test_20231031_155610,1254659.png,342646,61492,281154,0.8205378145374527,4,6,80080,8660,71420,0.8918581418581418,22.37580088888889,3655.8830826666667,12.500880625819997,132,1.7E-4
3,test_20231031_155610,10188041.png,221231,7962,213269,0.9640104686956168,3,6,41731,1128,40603,0.9729697347295775,11.738563555555556,1370.24816,16.76281133303664,132,1.7E-4
4,test_20231031_155610,10287332.png,216980,10414,206566,0.9520047930684856,2,6,22337,1432,20905,0.9358911223530465,10.041297777777778,969.9734293333333,18.26320523150082,132,1.7E-4
5,test_20231031_155610,11610969.png,368720,19779,348941,0.9463576697765241,4,6,84111,2902,81209,0.965497972916741,23.214288,3392.272112,12.825896788397955,132,1.7E-4
6,test_20231031_155610,10350842.png,212614,4194,208420,0.9802741117706266,2,6,42529,617,41912,0.9854922523454583,21.679027555555557,2995.340346666667,13.366341844659766,132,1.7E-4
7,test_20231031_155610,10863862.png,317432,6857,310575,0.9783985231482648,3,6,66058,1009,65049,0.9847255442187168,35.86164977777778,6559.87024,9.96185112133917,132,1.7E-4
8,test_20231031_155610,11382381.png,312486,687,311799,0.9978015015072675,2,5,46745,93,46652,0.9980104824045353,21.565585777777777,2525.2627946666667,14.107737806568558,132,1.7E-4
9,test_20231031_155610,11079715.png,443815,101847,341968,0.7705192478848168,5,7,124136,14305,109831,0.8847634852097699,18.156124444444444,2439.9212586666667,14.25704549889165,132,1.7E-4
10,test_20231031_155610,11551286.png,271883,497,271386,0.998172007812184,2,5,40092,71,40021,0.9982290731317969,17.641870222222224,1824.312992,15.519810098595052,132,1.7E-4
1,test_20231031_155611,10404007.png,502730,14797,487933,0.9705667057864062,3,6,61265,2154,59111,0.964841263364074,26.346357333333334,3614.1425386666665,12.550750841051833,132,1.8E-4
2,test_20231031_155611,1254659.png,342646,61492,281154,0.8205378145374527,4,11,80080,8660,71420,0.8918581418581418,22.37580088888889,3655.8830826666667,12.500880625819997,132,1.8E-4
3,test_20231031_155611,10188041.png,221231,7962,213269,0.9640104686956168,3,5,41731,1128,40603,0.9729697347295775,11.738563555555556,1370.24816,16.76281133303664,132,1.8E-4
4,test_20231031_155611,10287332.png,216980,10414,206566,0.9520047930684856,2,5,22337,1432,20905,0.9358911223530465,10.041297777777778,969.9734293333333,18.26320523150082,132,1.8E-4
5,test_20231031_155611,11610969.png,368720,19779,348941,0.9463576697765241,3,6,84111,2902,81209,0.965497972916741,23.214288,3392.272112,12.825896788397955,132,1.8E-4
6,test_20231031_155611,10350842.png,212614,4194,208420,0.9802741117706266,2,6,42529,617,41912,0.9854922523454583,21.679027555555557,2995.340346666667,13.366341844659766,132,1.8E-4
7,test_20231031_155611,10863862.png,317432,6857,310575,0.9783985231482648,2,5,66058,1009,65049,0.9847255442187168,35.86164977777778,6559.87024,9.96185112133917,132,1.8E-4
8,test_20231031_155611,11382381.png,312486,667,311819,0.997865504374596,2,6,46745,90,46655,0.9980746603914857,22.322282666666666,2670.9360426666667,13.864168721911659,132,1.8E-4
9,test_20231031_155611,11079715.png,443815,101847,341968,0.7705192478848168,5,7,124136,14305,109831,0.8847634852097699,18.156124444444444,2439.9212586666667,14.25704549889165,132,1.8E-4
10,test_20231031_155611,11551286.png,271883,497,271386,0.998172007812184,3,5,40092,71,40021,0.9982290731317969,17.641870222222224,1824.312992,15.519810098595052,132,1.8E-4
1,test_20231031_155612,10404007.png,502730,14797,487933,0.9705667057864062,4,6,61265,2154,59111,0.964841263364074,26.346357333333334,3614.1425386666665,12.550750841051833,132,1.9E-4
2,test_20231031_155612,1254659.png,342646,61492,281154,0.8205378145374527,4,6,80080,8660,71420,0.8918581418581418,22.37580088888889,3655.8830826666667,12.500880625819997,132,1.9E-4
3,test_20231031_155612,10188041.png,221231,7962,213269,0.9640104686956168,3,6,41731,1128,40603,0.9729697347295775,11.738563555555556,1370.24816,16.76281133303664,132,1.9E-4
4,test_20231031_155612,10287332.png,216980,10414,206566,0.9520047930684856,2,6,22337,1432,20905,0.9358911223530465,10.041297777777778,969.9734293333333,18.26320523150082,132,1.9E-4
5,test_20231031_155612,11610969.png,368720,19779,348941,0.9463576697765241,3,5,84111,2902,81209,0.965497972916741,23.214288,3392.272112,12.825896788397955,132,1.9E-4
6,test_20231031_155612,10350842.png,212614,4194,208420,0.9802741117706266,2,6,42529,617,41912,0.9854922523454583,21.679027555555557,2995.340346666667,13.366341844659766,132,1.9E-4
7,test_20231031_155612,10863862.png,317432,6857,310575,0.9783985231482648,2,6,66058,1009,65049,0.9847255442187168,35.86164977777778,6559.87024,9.96185112133917,132,1.9E-4
8,test_20231031_155612,11382381.png,312486,667,311819,0.997865504374596,2,5,46745,90,46655,0.9980746603914857,22.322282666666666,2670.9360426666667,13.864168721911659,132,1.9E-4
9,test_20231031_155612,11079715.png,443815,101847,341968,0.7705192478848168,5,6,124136,14305,109831,0.8847634852097699,18.156124444444444,2439.9212586666667,14.25704549889165,132,1.9E-4
10,test_20231031_155612,11551286.png,271883,497,271386,0.998172007812184,3,5,40092,71,40021,0.9982290731317969,17.641870222222224,1824.312992,15.519810098595052,132,1.9E-4
1,test_20231031_155613,10404007.png,502730,14797,487933,0.9705667057864062,4,6,61265,2154,59111,0.964841263364074,26.346357333333334,3614.1425386666665,12.550750841051833,132,2.0E-4
2,test_20231031_155613,1254659.png,342646,61492,281154,0.8205378145374527,4,6,80080,8660,71420,0.8918581418581418,22.37580088888889,3655.8830826666667,12.500880625819997,132,2.0E-4
3,test_20231031_155613,10188041.png,221231,7962,213269,0.9640104686956168,3,5,41731,1128,40603,0.9729697347295775,11.738563555555556,1370.24816,16.76281133303664,132,2.0E-4
4,test_20231031_155613,10287332.png,216980,10414,206566,0.9520047930684856,3,6,22337,1432,20905,0.9358911223530465,10.041297777777778,969.9734293333333,18.26320523150082,132,2.0E-4
5,test_20231031_155613,11610969.png,368720,19779,348941,0.9463576697765241,3,5,84111,2902,81209,0.965497972916741,23.214288,3392.272112,12.825896788397955,132,2.0E-4
6,test_20231031_155613,10350842.png,212614,4194,208420,0.9802741117706266,2,5,42529,617,41912,0.9854922523454583,21.679027555555557,2995.340346666667,13.366341844659766,132,2.0E-4
7,test_20231031_155613,10863862.png,317432,6857,310575,0.9783985231482648,3,6,66058,1009,65049,0.9847255442187168,35.86164977777778,6559.87024,9.96185112133917,132,2.0E-4
8,test_20231031_155613,11382381.png,312486,667,311819,0.997865504374596,2,5,46745,90,46655,0.9980746603914857,22.322282666666666,2670.9360426666667,13.864168721911659,132,2.0E-4
9,test_20231031_155613,11079715.png,443815,101847,341968,0.7705192478848168,5,7,124136,14305,109831,0.8847634852097699,18.156124444444444,2439.9212586666667,14.25704549889165,132,2.0E-4
10,test_20231031_155613,11551286.png,271883,267,271616,0.9990179599312939,2,6,40092,37,40055,0.9990771226179787,17.919265777777778,1867.1754613333333,15.418952296845859,132,2.0E-4
1,test_20231031_155614,10404007.png,502730,14797,487933,0.9705667057864062,3,6,61265,2154,59111,0.964841263364074,26.346357333333334,3614.1425386666665,12.550750841051833,132,2.1E-4
2,test_20231031_155614,1254659.png,342646,61492,281154,0.8205378145374527,4,6,80080,8660,71420,0.8918581418581418,22.37580088888889,3655.8830826666667,12.500880625819997,132,2.1E-4
3,test_20231031_155614,10188041.png,221231,7962,213269,0.9640104686956168,3,6,41731,1128,40603,0.9729697347295775,11.738563555555556,1370.24816,16.76281133303664,132,2.1E-4
4,test_20231031_155614,10287332.png,216980,10414,206566,0.9520047930684856,2,6,22337,1432,20905,0.9358911223530465,10.041297777777778,969.9734293333333,18.26320523150082,132,2.1E-4
5,test_20231031_155614,11610969.png,368720,19779,348941,0.9463576697765241,3,6,84111,2902,81209,0.965497972916741,23.214288,3392.272112,12.825896788397955,132,2.1E-4
6,test_20231031_155614,10350842.png,212614,4194,208420,0.9802741117706266,3,5,42529,617,41912,0.9854922523454583,21.679027555555557,2995.340346666667,13.366341844659766,132,2.1E-4
7,test_20231031_155614,10863862.png,317432,6857,310575,0.9783985231482648,3,6,66058,1009,65049,0.9847255442187168,35.86164977777778,6559.87024,9.96185112133917,132,2.1E-4
8,test_20231031_155614,11382381.png,312486,667,311819,0.997865504374596,2,6,46745,90,46655,0.9980746603914857,22.322282666666666,2670.9360426666667,13.864168721911659,132,2.1E-4
9,test_20231031_155614,11079715.png,443815,101847,341968,0.7705192478848168,6,7,124136,14305,109831,0.8847634852097699,18.156124444444444,2439.9212586666667,14.25704549889165,132,2.1E-4
10,test_20231031_155614,11551286.png,271883,267,271616,0.9990179599312939,2,6,40092,37,40055,0.9990771226179787,17.919265777777778,1867.1754613333333,15.418952296845859,132,2.1E-4
1,test_20231031_155615,10404007.png,502730,14797,487933,0.9705667057864062,4,6,61265,2154,59111,0.964841263364074,26.346357333333334,3614.1425386666665,12.550750841051833,132,2.2E-4
2,test_20231031_155615,1254659.png,342646,61492,281154,0.8205378145374527,5,6,80080,8660,71420,0.8918581418581418,22.37580088888889,3655.8830826666667,12.500880625819997,132,2.2E-4
3,test_20231031_155615,10188041.png,221231,7962,213269,0.9640104686956168,4,5,41731,1128,40603,0.9729697347295775,11.738563555555556,1370.24816,16.76281133303664,132,2.2E-4
4,test_20231031_155615,10287332.png,216980,10414,206566,0.9520047930684856,2,6,22337,1432,20905,0.9358911223530465,10.041297777777778,969.9734293333333,18.26320523150082,132,2.2E-4
5,test_20231031_155615,11610969.png,368720,19779,348941,0.9463576697765241,4,6,84111,2902,81209,0.965497972916741,23.214288,3392.272112,12.825896788397955,132,2.2E-4
6,test_20231031_155615,10350842.png,212614,4194,208420,0.9802741117706266,2,5,42529,617,41912,0.9854922523454583,21.679027555555557,2995.340346666667,13.366341844659766,132,2.2E-4
7,test_20231031_155615,10863862.png,317432,6857,310575,0.9783985231482648,2,5,66058,1009,65049,0.9847255442187168,35.86164977777778,6559.87024,9.96185112133917,132,2.2E-4
8,test_20231031_155615,11382381.png,312486,667,311819,0.997865504374596,3,5,46745,90,46655,0.9980746603914857,22.322282666666666,2670.9360426666667,13.864168721911659,132,2.2E-4
9,test_20231031_155615,11079715.png,443815,101847,341968,0.7705192478848168,5,7,124136,14305,109831,0.8847634852097699,18.156124444444444,2439.9212586666667,14.25704549889165,132,2.2E-4
10,test_20231031_155615,11551286.png,271883,267,271616,0.9990179599312939,2,5,40092,37,40055,0.9990771226179787,17.919265777777778,1867.1754613333333,15.418952296845859,132,2.2E-4
1,test_20231031_155616,10404007.png,502730,14797,487933,0.9705667057864062,4,6,61265,2154,59111,0.964841263364074,26.346357333333334,3614.1425386666665,12.550750841051833,132,2.3E-4
2,test_20231031_155616,1254659.png,342646,61492,281154,0.8205378145374527,4,6,80080,8660,71420,0.8918581418581418,22.37580088888889,3655.8830826666667,12.500880625819997,132,2.3E-4
3,test_20231031_155616,10188041.png,221231,7962,213269,0.9640104686956168,3,5,41731,1128,40603,0.9729697347295775,11.738563555555556,1370.24816,16.76281133303664,132,2.3E-4
4,test_20231031_155616,10287332.png,216980,10414,206566,0.9520047930684856,2,6,22337,1432,20905,0.9358911223530465,10.041297777777778,969.9734293333333,18.26320523150082,132,2.3E-4
5,test_20231031_155616,11610969.png,368720,19779,348941,0.9463576697765241,3,6,84111,2902,81209,0.965497972916741,23.214288,3392.272112,12.825896788397955,132,2.3E-4
6,test_20231031_155616,10350842.png,212614,4194,208420,0.9802741117706266,2,6,42529,617,41912,0.9854922523454583,21.679027555555557,2995.340346666667,13.366341844659766,132,2.3E-4
7,test_20231031_155616,10863862.png,317432,6857,310575,0.9783985231482648,3,6,66058,1009,65049,0.9847255442187168,35.86164977777778,6559.87024,9.96185112133917,132,2.3E-4
8,test_20231031_155616,11382381.png,312486,667,311819,0.997865504374596,2,5,46745,90,46655,0.9980746603914857,22.322282666666666,2670.9360426666667,13.864168721911659,132,2.3E-4
9,test_20231031_155616,11079715.png,443815,101847,341968,0.7705192478848168,5,7,124136,14305,109831,0.8847634852097699,18.156124444444444,2439.9212586666667,14.25704549889165,132,2.3E-4
10,test_20231031_155616,11551286.png,271883,267,271616,0.9990179599312939,2,6,40092,37,40055,0.9990771226179787,17.919265777777778,1867.1754613333333,15.418952296845859,132,2.3E-4
1,test_20231031_155617,10404007.png,502730,14797,487933,0.9705667057864062,3,5,61265,2154,59111,0.964841263364074,26.346357333333334,3614.1425386666665,12.550750841051833,132,2.4E-4
2,test_20231031_155617,1254659.png,342646,61492,281154,0.8205378145374527,4,16,80080,8660,71420,0.8918581418581418,22.37580088888889,3655.8830826666667,12.500880625819997,132,2.4E-4
3,test_20231031_155617,10188041.png,221231,7962,213269,0.9640104686956168,3,6,41731,1128,40603,0.9729697347295775,11.738563555555556,1370.24816,16.76281133303664,132,2.4E-4
4,test_20231031_155617,10287332.png,216980,10414,206566,0.9520047930684856,3,6,22337,1432,20905,0.9358911223530465,10.041297777777778,969.9734293333333,18.26320523150082,132,2.4E-4
5,test_20231031_155617,11610969.png,368720,19779,348941,0.9463576697765241,3,5,84111,2902,81209,0.965497972916741,23.214288,3392.272112,12.825896788397955,132,2.4E-4
6,test_20231031_155617,10350842.png,212614,4194,208420,0.9802741117706266,3,6,42529,617,41912,0.9854922523454583,21.679027555555557,2995.340346666667,13.366341844659766,132,2.4E-4
7,test_20231031_155617,10863862.png,317432,6857,310575,0.9783985231482648,2,5,66058,1009,65049,0.9847255442187168,35.86164977777778,6559.87024,9.96185112133917,132,2.4E-4
8,test_20231031_155617,11382381.png,312486,667,311819,0.997865504374596,2,5,46745,90,46655,0.9980746603914857,22.322282666666666,2670.9360426666667,13.864168721911659,132,2.4E-4
9,test_20231031_155617,11079715.png,443815,101847,341968,0.7705192478848168,5,10,124136,14305,109831,0.8847634852097699,18.156124444444444,2439.9212586666667,14.25704549889165,132,2.4E-4
10,test_20231031_155617,11551286.png,271883,267,271616,0.9990179599312939,2,6,40092,37,40055,0.9990771226179787,17.919265777777778,1867.1754613333333,15.418952296845859,132,2.4E-4
1,test_20231031_155618,10404007.png,502730,14797,487933,0.9705667057864062,3,6,61265,2154,59111,0.964841263364074,26.346357333333334,3614.1425386666665,12.550750841051833,132,2.5E-4
2,test_20231031_155618,1254659.png,342646,61492,281154,0.8205378145374527,4,6,80080,8660,71420,0.8918581418581418,22.37580088888889,3655.8830826666667,12.500880625819997,132,2.5E-4
3,test_20231031_155618,10188041.png,221231,7962,213269,0.9640104686956168,3,7,41731,1128,40603,0.9729697347295775,11.738563555555556,1370.24816,16.76281133303664,132,2.5E-4
4,test_20231031_155618,10287332.png,216980,10414,206566,0.9520047930684856,3,6,22337,1432,20905,0.9358911223530465,10.041297777777778,969.9734293333333,18.26320523150082,132,2.5E-4
5,test_20231031_155618,11610969.png,368720,19779,348941,0.9463576697765241,4,6,84111,2902,81209,0.965497972916741,23.214288,3392.272112,12.825896788397955,132,2.5E-4
6,test_20231031_155618,10350842.png,212614,4194,208420,0.9802741117706266,3,6,42529,617,41912,0.9854922523454583,21.679027555555557,2995.340346666667,13.366341844659766,132,2.5E-4
7,test_20231031_155618,10863862.png,317432,6857,310575,0.9783985231482648,3,6,66058,1009,65049,0.9847255442187168,35.86164977777778,6559.87024,9.96185112133917,132,2.5E-4
8,test_20231031_155618,11382381.png,312486,667,311819,0.997865504374596,2,6,46745,90,46655,0.9980746603914857,22.322282666666666,2670.9360426666667,13.864168721911659,132,2.5E-4
9,test_20231031_155618,11079715.png,443815,101847,341968,0.7705192478848168,5,7,124136,14305,109831,0.8847634852097699,18.156124444444444,2439.9212586666667,14.25704549889165,132,2.5E-4
10,test_20231031_155618,11551286.png,271883,267,271616,0.9990179599312939,2,5,40092,37,40055,0.9990771226179787,17.919265777777778,1867.1754613333333,15.418952296845859,132,2.5E-4
1,test_20231031_155619,10404007.png,502730,14677,488053,0.9708054025023373,3,6,61265,2138,59127,0.9651024238961887,26.351075555555557,3615.226304,12.549448726530596,132,2.6000000000000003E-4
2,test_20231031_155619,1254659.png,342646,61432,281214,0.8207129223746957,5,6,80080,8654,71426,0.891933066933067,22.385354666666668,3656.9652693333333,12.49959525060495,132,2.6000000000000003E-4
3,test_20231031_155619,10188041.png,221231,7922,213309,0.9641912751829536,3,6,41731,1122,40609,0.9731135127363351,12.104391111111111,1422.528864,16.60019273604845,132,2.6000000000000003E-4
4,test_20231031_155619,10287332.png,216980,10414,206566,0.9520047930684856,3,5,22337,1432,20905,0.9358911223530465,10.041297777777778,969.9734293333333,18.26320523150082,132,2.6000000000000003E-4
5,test_20231031_155619,11610969.png,368720,19659,349061,0.9466831199826427,3,5,84111,2887,81224,0.9656763086873298,23.630064,3459.2615946666665,12.740969555969798,132,2.6000000000000003E-4
6,test_20231031_155619,10350842.png,212614,4194,208420,0.9802741117706266,2,5,42529,617,41912,0.9854922523454583,21.679027555555557,2995.340346666667,13.366341844659766,132,2.6000000000000003E-4
7,test_20231031_155619,10863862.png,317432,6817,310615,0.9785245343884674,2,6,66058,1003,65055,0.9848163734899633,35.86734577777778,6560.939296,9.96114341329509,132,2.6000000000000003E-4
8,test_20231031_155619,11382381.png,312486,547,311939,0.9982495215785667,2,6,46745,72,46673,0.9984597283131885,22.81680888888889,2740.878352,13.751906001286724,132,2.6000000000000003E-4
9,test_20231031_155619,11079715.png,443815,101847,341968,0.7705192478848168,5,7,124136,14305,109831,0.8847634852097699,18.156124444444444,2439.9212586666667,14.25704549889165,132,2.6000000000000003E-4
10,test_20231031_155619,11551286.png,271883,164,271719,0.9993967993585476,2,6,40092,22,40070,0.9994512620971765,18.120286222222223,1899.5769013333334,15.344234809036362,132,2.6000000000000003E-4
1,test_20231031_155620,10404007.png,502730,14677,488053,0.9708054025023373,3,6,61265,2138,59127,0.9651024238961887,26.351075555555557,3615.226304,12.549448726530596,132,2.7000000000000006E-4
2,test_20231031_155620,1254659.png,342646,61432,281214,0.8207129223746957,4,6,80080,8654,71426,0.891933066933067,22.385354666666668,3656.9652693333333,12.49959525060495,132,2.7000000000000006E-4
3,test_20231031_155620,10188041.png,221231,7922,213309,0.9641912751829536,4,6,41731,1122,40609,0.9731135127363351,12.104391111111111,1422.528864,16.60019273604845,132,2.7000000000000006E-4
4,test_20231031_155620,10287332.png,216980,10414,206566,0.9520047930684856,3,6,22337,1432,20905,0.9358911223530465,10.041297777777778,969.9734293333333,18.26320523150082,132,2.7000000000000006E-4
5,test_20231031_155620,11610969.png,368720,19659,349061,0.9466831199826427,3,5,84111,2887,81224,0.9656763086873298,23.630064,3459.2615946666665,12.740969555969798,132,2.7000000000000006E-4
6,test_20231031_155620,10350842.png,212614,4194,208420,0.9802741117706266,3,6,42529,617,41912,0.9854922523454583,21.679027555555557,2995.340346666667,13.366341844659766,132,2.7000000000000006E-4
7,test_20231031_155620,10863862.png,317432,6817,310615,0.9785245343884674,2,5,66058,1003,65055,0.9848163734899633,35.86734577777778,6560.939296,9.96114341329509,132,2.7000000000000006E-4
8,test_20231031_155620,11382381.png,312486,547,311939,0.9982495215785667,2,6,46745,72,46673,0.9984597283131885,22.81680888888889,2740.878352,13.751906001286724,132,2.7000000000000006E-4
9,test_20231031_155620,11079715.png,443815,101847,341968,0.7705192478848168,5,6,124136,14305,109831,0.8847634852097699,18.156124444444444,2439.9212586666667,14.25704549889165,132,2.7000000000000006E-4
10,test_20231031_155620,11551286.png,271883,164,271719,0.9993967993585476,2,6,40092,22,40070,0.9994512620971765,18.120286222222223,1899.5769013333334,15.344234809036362,132,2.7000000000000006E-4
1,test_20231031_155621,10404007.png,502730,14677,488053,0.9708054025023373,4,6,61265,2138,59127,0.9651024238961887,26.351075555555557,3615.226304,12.549448726530596,132,2.800000000000001E-4
2,test_20231031_155621,1254659.png,342646,61432,281214,0.8207129223746957,5,6,80080,8654,71426,0.891933066933067,22.385354666666668,3656.9652693333333,12.49959525060495,132,2.800000000000001E-4
3,test_20231031_155621,10188041.png,221231,7922,213309,0.9641912751829536,3,11,41731,1122,40609,0.9731135127363351,12.104391111111111,1422.528864,16.60019273604845,132,2.800000000000001E-4
4,test_20231031_155621,10287332.png,216980,10414,206566,0.9520047930684856,2,6,22337,1432,20905,0.9358911223530465,10.041297777777778,969.9734293333333,18.26320523150082,132,2.800000000000001E-4
5,test_20231031_155621,11610969.png,368720,19659,349061,0.9466831199826427,4,6,84111,2887,81224,0.9656763086873298,23.630064,3459.2615946666665,12.740969555969798,132,2.800000000000001E-4
6,test_20231031_155621,10350842.png,212614,4194,208420,0.9802741117706266,2,5,42529,617,41912,0.9854922523454583,21.679027555555557,2995.340346666667,13.366341844659766,132,2.800000000000001E-4
7,test_20231031_155621,10863862.png,317432,6817,310615,0.9785245343884674,2,6,66058,1003,65055,0.9848163734899633,35.86734577777778,6560.939296,9.96114341329509,132,2.800000000000001E-4
8,test_20231031_155621,11382381.png,312486,547,311939,0.9982495215785667,2,5,46745,72,46673,0.9984597283131885,22.81680888888889,2740.878352,13.751906001286724,132,2.800000000000001E-4
9,test_20231031_155621,11079715.png,443815,101847,341968,0.7705192478848168,5,6,124136,14305,109831,0.8847634852097699,18.156124444444444,2439.9212586666667,14.25704549889165,132,2.800000000000001E-4
10,test_20231031_155621,11551286.png,271883,164,271719,0.9993967993585476,2,6,40092,22,40070,0.9994512620971765,18.120286222222223,1899.5769013333334,15.344234809036362,132,2.800000000000001E-4
1,test_20231031_155622,10404007.png,502730,14677,488053,0.9708054025023373,3,6,61265,2138,59127,0.9651024238961887,26.351075555555557,3615.226304,12.549448726530596,132,2.900000000000001E-4
2,test_20231031_155622,1254659.png,342646,61432,281214,0.8207129223746957,4,7,80080,8654,71426,0.891933066933067,22.385354666666668,3656.9652693333333,12.49959525060495,132,2.900000000000001E-4
3,test_20231031_155622,10188041.png,221231,7922,213309,0.9641912751829536,3,6,41731,1122,40609,0.9731135127363351,12.104391111111111,1422.528864,16.60019273604845,132,2.900000000000001E-4
4,test_20231031_155622,10287332.png,216980,10414,206566,0.9520047930684856,2,5,22337,1432,20905,0.9358911223530465,10.041297777777778,969.9734293333333,18.26320523150082,132,2.900000000000001E-4
5,test_20231031_155622,11610969.png,368720,19659,349061,0.9466831199826427,4,6,84111,2887,81224,0.9656763086873298,23.630064,3459.2615946666665,12.740969555969798,132,2.900000000000001E-4
6,test_20231031_155622,10350842.png,212614,4194,208420,0.9802741117706266,3,6,42529,617,41912,0.9854922523454583,21.679027555555557,2995.340346666667,13.366341844659766,132,2.900000000000001E-4
7,test_20231031_155622,10863862.png,317432,6817,310615,0.9785245343884674,2,5,66058,1003,65055,0.9848163734899633,35.86734577777778,6560.939296,9.96114341329509,132,2.900000000000001E-4
8,test_20231031_155622,11382381.png,312486,547,311939,0.9982495215785667,2,6,46745,72,46673,0.9984597283131885,22.81680888888889,2740.878352,13.751906001286724,132,2.900000000000001E-4
9,test_20231031_155622,11079715.png,443815,101847,341968,0.7705192478848168,5,6,124136,14305,109831,0.8847634852097699,18.156124444444444,2439.9212586666667,14.25704549889165,132,2.900000000000001E-4
10,test_20231031_155622,11551286.png,271883,164,271719,0.9993967993585476,2,5,40092,22,40070,0.9994512620971765,18.120286222222223,1899.5769013333334,15.344234809036362,132,2.900000000000001E-4
1,test_20231031_155624,10404007.png,502730,14152,488578,0.9718497006345355,3,5,61265,2060,59205,0.9663755814902473,26.344917333333335,3614.72256,12.55005391266389,133,1.0E-5
2,test_20231031_155624,1254659.png,342646,59502,283144,0.8263455578060155,4,7,80080,8383,71697,0.8953171828171829,22.628085333333335,3743.293184,12.398265174011183,133,1.0E-5
3,test_20231031_155624,10188041.png,221231,7742,213489,0.965004904375969,3,8,41731,1099,40632,0.9736646617622391,12.021692444444444,1415.9182933333334,16.620421680920458,133,1.0E-5
4,test_20231031_155624,10287332.png,216980,10444,206536,0.9518665314775555,3,7,22337,1436,20901,0.9357120472758204,9.952625777777778,956.3146133333333,18.32479568637085,133,1.0E-5
5,test_20231031_155624,11610969.png,368720,19097,349623,0.9482073117812975,4,6,84111,2803,81308,0.9666749890026275,23.451530666666667,3450.915978666667,12.751459754522989,133,1.0E-5
6,test_20231031_155624,10350842.png,212614,4072,208542,0.9808479215855964,2,6,42529,599,41930,0.9859154929577465,20.203443555555555,2580.173893333333,14.014313842185771,133,1.0E-5
7,test_20231031_155624,10863862.png,317432,6657,310775,0.979028579349278,3,6,66058,979,65079,0.9851796905749493,35.89375288888889,6568.835178666666,9.955919959241273,133,1.0E-5
8,test_20231031_155624,11382381.png,312486,807,311679,0.9974174843032968,3,5,46745,110,46635,0.9976468071451492,20.579290666666665,2386.569818666667,14.353062167735953,133,1.0E-5
9,test_20231031_155624,11079715.png,443815,98874,344941,0.7772179849712155,5,11,124136,13895,110241,0.8880663143648901,18.42161422222222,2518.297664,14.119732982444997,133,1.0E-5
10,test_20231031_155624,11551286.png,271883,617,271266,0.99773064148917,2,5,40092,89,40003,0.9977801057567595,17.32512711111111,1775.1936,15.638346373772247,133,1.0E-5
1,test_20231031_155625,10404007.png,502730,14152,488578,0.9718497006345355,3,5,61265,2060,59205,0.9663755814902473,26.344917333333335,3614.72256,12.55005391266389,133,2.0E-5
2,test_20231031_155625,1254659.png,342646,59502,283144,0.8263455578060155,4,6,80080,8383,71697,0.8953171828171829,22.628085333333335,3743.293184,12.398265174011183,133,2.0E-5
3,test_20231031_155625,10188041.png,221231,7742,213489,0.965004904375969,3,6,41731,1099,40632,0.9736646617622391,12.021692444444444,1415.9182933333334,16.620421680920458,133,2.0E-5
4,test_20231031_155625,10287332.png,216980,10444,206536,0.9518665314775555,3,6,22337,1436,20901,0.9357120472758204,9.952625777777778,956.3146133333333,18.32479568637085,133,2.0E-5
5,test_20231031_155625,11610969.png,368720,19097,349623,0.9482073117812975,3,5,84111,2803,81308,0.9666749890026275,23.451530666666667,3450.915978666667,12.751459754522989,133,2.0E-5
6,test_20231031_155625,10350842.png,212614,4072,208542,0.9808479215855964,3,6,42529,599,41930,0.9859154929577465,20.203443555555555,2580.173893333333,14.014313842185771,133,2.0E-5
7,test_20231031_155625,10863862.png,317432,6657,310775,0.979028579349278,2,5,66058,979,65079,0.9851796905749493,35.89375288888889,6568.835178666666,9.955919959241273,133,2.0E-5
8,test_20231031_155625,11382381.png,312486,797,311689,0.997449485736961,3,6,46745,109,46636,0.997668199807466,21.309107555555556,2485.130629333333,14.177311387814227,133,2.0E-5
9,test_20231031_155625,11079715.png,443815,98874,344941,0.7772179849712155,5,7,124136,13895,110241,0.8880663143648901,18.42161422222222,2518.297664,14.119732982444997,133,2.0E-5
10,test_20231031_155625,11551286.png,271883,617,271266,0.99773064148917,2,5,40092,89,40003,0.9977801057567595,17.32512711111111,1775.1936,15.638346373772247,133,2.0E-5
1,test_20231031_155626,10404007.png,502730,14152,488578,0.9718497006345355,4,6,61265,2060,59205,0.9663755814902473,26.344917333333335,3614.72256,12.55005391266389,133,3.0000000000000004E-5
2,test_20231031_155626,1254659.png,342646,59502,283144,0.8263455578060155,4,6,80080,8383,71697,0.8953171828171829,22.628085333333335,3743.293184,12.398265174011183,133,3.0000000000000004E-5
3,test_20231031_155626,10188041.png,221231,7742,213489,0.965004904375969,3,6,41731,1099,40632,0.9736646617622391,12.021692444444444,1415.9182933333334,16.620421680920458,133,3.0000000000000004E-5
4,test_20231031_155626,10287332.png,216980,10444,206536,0.9518665314775555,3,5,22337,1436,20901,0.9357120472758204,9.952625777777778,956.3146133333333,18.32479568637085,133,3.0000000000000004E-5
5,test_20231031_155626,11610969.png,368720,19097,349623,0.9482073117812975,3,5,84111,2803,81308,0.9666749890026275,23.451530666666667,3450.915978666667,12.751459754522989,133,3.0000000000000004E-5
6,test_20231031_155626,10350842.png,212614,4072,208542,0.9808479215855964,2,6,42529,599,41930,0.9859154929577465,20.203443555555555,2580.173893333333,14.014313842185771,133,3.0000000000000004E-5
7,test_20231031_155626,10863862.png,317432,6657,310775,0.979028579349278,2,5,66058,979,65079,0.9851796905749493,35.89375288888889,6568.835178666666,9.955919959241273,133,3.0000000000000004E-5
8,test_20231031_155626,11382381.png,312486,797,311689,0.997449485736961,3,6,46745,109,46636,0.997668199807466,21.309107555555556,2485.130629333333,14.177311387814227,133,3.0000000000000004E-5
9,test_20231031_155626,11079715.png,443815,98874,344941,0.7772179849712155,5,6,124136,13895,110241,0.8880663143648901,18.42161422222222,2518.297664,14.119732982444997,133,3.0000000000000004E-5
10,test_20231031_155626,11551286.png,271883,617,271266,0.99773064148917,2,5,40092,89,40003,0.9977801057567595,17.32512711111111,1775.1936,15.638346373772247,133,3.0000000000000004E-5
1,test_20231031_155627,10404007.png,502730,14152,488578,0.9718497006345355,3,5,61265,2060,59205,0.9663755814902473,26.344917333333335,3614.72256,12.55005391266389,133,4.0E-5
2,test_20231031_155627,1254659.png,342646,59502,283144,0.8263455578060155,5,6,80080,8383,71697,0.8953171828171829,22.628085333333335,3743.293184,12.398265174011183,133,4.0E-5
3,test_20231031_155627,10188041.png,221231,7742,213489,0.965004904375969,3,5,41731,1099,40632,0.9736646617622391,12.021692444444444,1415.9182933333334,16.620421680920458,133,4.0E-5
4,test_20231031_155627,10287332.png,216980,10444,206536,0.9518665314775555,3,6,22337,1436,20901,0.9357120472758204,9.952625777777778,956.3146133333333,18.32479568637085,133,4.0E-5
5,test_20231031_155627,11610969.png,368720,19097,349623,0.9482073117812975,3,5,84111,2803,81308,0.9666749890026275,23.451530666666667,3450.915978666667,12.751459754522989,133,4.0E-5
6,test_20231031_155627,10350842.png,212614,4072,208542,0.9808479215855964,2,6,42529,599,41930,0.9859154929577465,20.203443555555555,2580.173893333333,14.014313842185771,133,4.0E-5
7,test_20231031_155627,10863862.png,317432,6657,310775,0.979028579349278,2,6,66058,979,65079,0.9851796905749493,35.89375288888889,6568.835178666666,9.955919959241273,133,4.0E-5
8,test_20231031_155627,11382381.png,312486,797,311689,0.997449485736961,2,5,46745,109,46636,0.997668199807466,21.309107555555556,2485.130629333333,14.177311387814227,133,4.0E-5
9,test_20231031_155627,11079715.png,443815,98874,344941,0.7772179849712155,5,6,124136,13895,110241,0.8880663143648901,18.42161422222222,2518.297664,14.119732982444997,133,4.0E-5
10,test_20231031_155627,11551286.png,271883,617,271266,0.99773064148917,2,5,40092,89,40003,0.9977801057567595,17.32512711111111,1775.1936,15.638346373772247,133,4.0E-5
1,test_20231031_155628,10404007.png,502730,14152,488578,0.9718497006345355,3,5,61265,2060,59205,0.9663755814902473,26.344917333333335,3614.72256,12.55005391266389,133,5.0E-5
2,test_20231031_155628,1254659.png,342646,59502,283144,0.8263455578060155,4,6,80080,8383,71697,0.8953171828171829,22.628085333333335,3743.293184,12.398265174011183,133,5.0E-5
3,test_20231031_155628,10188041.png,221231,7742,213489,0.965004904375969,3,6,41731,1099,40632,0.9736646617622391,12.021692444444444,1415.9182933333334,16.620421680920458,133,5.0E-5
4,test_20231031_155628,10287332.png,216980,10444,206536,0.9518665314775555,3,5,22337,1436,20901,0.9357120472758204,9.952625777777778,956.3146133333333,18.32479568637085,133,5.0E-5
5,test_20231031_155628,11610969.png,368720,19097,349623,0.9482073117812975,3,10,84111,2803,81308,0.9666749890026275,23.451530666666667,3450.915978666667,12.751459754522989,133,5.0E-5
6,test_20231031_155628,10350842.png,212614,4072,208542,0.9808479215855964,2,6,42529,599,41930,0.9859154929577465,20.203443555555555,2580.173893333333,14.014313842185771,133,5.0E-5
7,test_20231031_155628,10863862.png,317432,6657,310775,0.979028579349278,2,5,66058,979,65079,0.9851796905749493,35.89375288888889,6568.835178666666,9.955919959241273,133,5.0E-5
8,test_20231031_155628,11382381.png,312486,797,311689,0.997449485736961,3,6,46745,109,46636,0.997668199807466,21.309107555555556,2485.130629333333,14.177311387814227,133,5.0E-5
9,test_20231031_155628,11079715.png,443815,98874,344941,0.7772179849712155,5,7,124136,13895,110241,0.8880663143648901,18.42161422222222,2518.297664,14.119732982444997,133,5.0E-5
10,test_20231031_155628,11551286.png,271883,617,271266,0.99773064148917,4,5,40092,89,40003,0.9977801057567595,17.32512711111111,1775.1936,15.638346373772247,133,5.0E-5
1,test_20231031_155629,10404007.png,502730,14152,488578,0.9718497006345355,3,6,61265,2060,59205,0.9663755814902473,26.344917333333335,3614.72256,12.55005391266389,133,6.0E-5
2,test_20231031_155629,1254659.png,342646,59502,283144,0.8263455578060155,4,6,80080,8383,71697,0.8953171828171829,22.628085333333335,3743.293184,12.398265174011183,133,6.0E-5
3,test_20231031_155629,10188041.png,221231,7742,213489,0.965004904375969,4,5,41731,1099,40632,0.9736646617622391,12.021692444444444,1415.9182933333334,16.620421680920458,133,6.0E-5
4,test_20231031_155629,10287332.png,216980,10444,206536,0.9518665314775555,3,6,22337,1436,20901,0.9357120472758204,9.952625777777778,956.3146133333333,18.32479568637085,133,6.0E-5
5,test_20231031_155629,11610969.png,368720,19097,349623,0.9482073117812975,4,6,84111,2803,81308,0.9666749890026275,23.451530666666667,3450.915978666667,12.751459754522989,133,6.0E-5
6,test_20231031_155629,10350842.png,212614,4072,208542,0.9808479215855964,3,6,42529,599,41930,0.9859154929577465,20.203443555555555,2580.173893333333,14.014313842185771,133,6.0E-5
7,test_20231031_155629,10863862.png,317432,6657,310775,0.979028579349278,3,6,66058,979,65079,0.9851796905749493,35.89375288888889,6568.835178666666,9.955919959241273,133,6.0E-5
8,test_20231031_155629,11382381.png,312486,797,311689,0.997449485736961,3,5,46745,109,46636,0.997668199807466,21.309107555555556,2485.130629333333,14.177311387814227,133,6.0E-5
9,test_20231031_155629,11079715.png,443815,98874,344941,0.7772179849712155,5,7,124136,13895,110241,0.8880663143648901,18.42161422222222,2518.297664,14.119732982444997,133,6.0E-5
10,test_20231031_155629,11551286.png,271883,617,271266,0.99773064148917,2,6,40092,89,40003,0.9977801057567595,17.32512711111111,1775.1936,15.638346373772247,133,6.0E-5
1,test_20231031_155630,10404007.png,502730,13952,488778,0.9722475284944204,3,6,61265,2031,59234,0.9668489349547049,26.42939377777778,3633.37456,12.527701898270605,133,7.000000000000001E-5
2,test_20231031_155630,1254659.png,342646,59502,283144,0.8263455578060155,4,6,80080,8383,71697,0.8953171828171829,22.628085333333335,3743.293184,12.398265174011183,133,7.000000000000001E-5
3,test_20231031_155630,10188041.png,221231,7742,213489,0.965004904375969,3,5,41731,1099,40632,0.9736646617622391,12.021692444444444,1415.9182933333334,16.620421680920458,133,7.000000000000001E-5
4,test_20231031_155630,10287332.png,216980,10444,206536,0.9518665314775555,3,6,22337,1436,20901,0.9357120472758204,9.952625777777778,956.3146133333333,18.32479568637085,133,7.000000000000001E-5
5,test_20231031_155630,11610969.png,368720,19097,349623,0.9482073117812975,3,5,84111,2803,81308,0.9666749890026275,23.451530666666667,3450.915978666667,12.751459754522989,133,7.000000000000001E-5
6,test_20231031_155630,10350842.png,212614,3932,208682,0.98150639186507,3,5,42529,578,41951,0.9864092736720825,21.983740444444443,3072.926976,13.255281209164664,133,7.000000000000001E-5
7,test_20231031_155630,10863862.png,317432,6657,310775,0.979028579349278,3,6,66058,979,65079,0.9851796905749493,35.89375288888889,6568.835178666666,9.955919959241273,133,7.000000000000001E-5
8,test_20231031_155630,11382381.png,312486,797,311689,0.997449485736961,3,6,46745,109,46636,0.997668199807466,21.309107555555556,2485.130629333333,14.177311387814227,133,7.000000000000001E-5
9,test_20231031_155630,11079715.png,443815,98874,344941,0.7772179849712155,5,6,124136,13895,110241,0.8880663143648901,18.42161422222222,2518.297664,14.119732982444997,133,7.000000000000001E-5
10,test_20231031_155630,11551286.png,271883,477,271406,0.9982455688660196,2,14,40092,68,40024,0.9983039010276364,17.651459555555554,1826.2984533333333,15.515086095512114,133,7.000000000000001E-5
1,test_20231031_155631,10404007.png,502730,13952,488778,0.9722475284944204,3,6,61265,2031,59234,0.9668489349547049,26.42939377777778,3633.37456,12.527701898270605,133,8.0E-5
2,test_20231031_155631,1254659.png,342646,59502,283144,0.8263455578060155,4,6,80080,8383,71697,0.8953171828171829,22.628085333333335,3743.293184,12.398265174011183,133,8.0E-5
3,test_20231031_155631,10188041.png,221231,7742,213489,0.965004904375969,3,6,41731,1099,40632,0.9736646617622391,12.021692444444444,1415.9182933333334,16.620421680920458,133,8.0E-5
4,test_20231031_155631,10287332.png,216980,10444,206536,0.9518665314775555,3,6,22337,1436,20901,0.9357120472758204,9.952625777777778,956.3146133333333,18.32479568637085,133,8.0E-5
5,test_20231031_155631,11610969.png,368720,19097,349623,0.9482073117812975,3,6,84111,2803,81308,0.9666749890026275,23.451530666666667,3450.915978666667,12.751459754522989,133,8.0E-5
6,test_20231031_155631,10350842.png,212614,3932,208682,0.98150639186507,2,6,42529,578,41951,0.9864092736720825,21.983740444444443,3072.926976,13.255281209164664,133,8.0E-5
7,test_20231031_155631,10863862.png,317432,6657,310775,0.979028579349278,3,6,66058,979,65079,0.9851796905749493,35.89375288888889,6568.835178666666,9.955919959241273,133,8.0E-5
8,test_20231031_155631,11382381.png,312486,797,311689,0.997449485736961,3,7,46745,109,46636,0.997668199807466,21.309107555555556,2485.130629333333,14.177311387814227,133,8.0E-5
9,test_20231031_155631,11079715.png,443815,98874,344941,0.7772179849712155,5,6,124136,13895,110241,0.8880663143648901,18.42161422222222,2518.297664,14.119732982444997,133,8.0E-5
10,test_20231031_155631,11551286.png,271883,477,271406,0.9982455688660196,3,5,40092,68,40024,0.9983039010276364,17.651459555555554,1826.2984533333333,15.515086095512114,133,8.0E-5
1,test_20231031_155632,10404007.png,502730,13952,488778,0.9722475284944204,4,5,61265,2031,59234,0.9668489349547049,26.42939377777778,3633.37456,12.527701898270605,133,9.0E-5
2,test_20231031_155632,1254659.png,342646,59502,283144,0.8263455578060155,4,6,80080,8383,71697,0.8953171828171829,22.628085333333335,3743.293184,12.398265174011183,133,9.0E-5
3,test_20231031_155632,10188041.png,221231,7742,213489,0.965004904375969,3,6,41731,1099,40632,0.9736646617622391,12.021692444444444,1415.9182933333334,16.620421680920458,133,9.0E-5
4,test_20231031_155632,10287332.png,216980,10444,206536,0.9518665314775555,3,6,22337,1436,20901,0.9357120472758204,9.952625777777778,956.3146133333333,18.32479568637085,133,9.0E-5
5,test_20231031_155632,11610969.png,368720,19097,349623,0.9482073117812975,3,5,84111,2803,81308,0.9666749890026275,23.451530666666667,3450.915978666667,12.751459754522989,133,9.0E-5
6,test_20231031_155632,10350842.png,212614,3932,208682,0.98150639186507,2,7,42529,578,41951,0.9864092736720825,21.983740444444443,3072.926976,13.255281209164664,133,9.0E-5
7,test_20231031_155632,10863862.png,317432,6657,310775,0.979028579349278,3,6,66058,979,65079,0.9851796905749493,35.89375288888889,6568.835178666666,9.955919959241273,133,9.0E-5
8,test_20231031_155632,11382381.png,312486,797,311689,0.997449485736961,3,6,46745,109,46636,0.997668199807466,21.309107555555556,2485.130629333333,14.177311387814227,133,9.0E-5
9,test_20231031_155632,11079715.png,443815,98874,344941,0.7772179849712155,5,7,124136,13895,110241,0.8880663143648901,18.42161422222222,2518.297664,14.119732982444997,133,9.0E-5
10,test_20231031_155632,11551286.png,271883,477,271406,0.9982455688660196,2,6,40092,68,40024,0.9983039010276364,17.651459555555554,1826.2984533333333,15.515086095512114,133,9.0E-5
1,test_20231031_155633,10404007.png,502730,13952,488778,0.9722475284944204,3,6,61265,2031,59234,0.9668489349547049,26.42939377777778,3633.37456,12.527701898270605,133,1.0E-4
2,test_20231031_155633,1254659.png,342646,59502,283144,0.8263455578060155,4,6,80080,8383,71697,0.8953171828171829,22.628085333333335,3743.293184,12.398265174011183,133,1.0E-4
3,test_20231031_155633,10188041.png,221231,7742,213489,0.965004904375969,4,5,41731,1099,40632,0.9736646617622391,12.021692444444444,1415.9182933333334,16.620421680920458,133,1.0E-4
4,test_20231031_155633,10287332.png,216980,10444,206536,0.9518665314775555,2,5,22337,1436,20901,0.9357120472758204,9.952625777777778,956.3146133333333,18.32479568637085,133,1.0E-4
5,test_20231031_155633,11610969.png,368720,19097,349623,0.9482073117812975,3,5,84111,2803,81308,0.9666749890026275,23.451530666666667,3450.915978666667,12.751459754522989,133,1.0E-4
6,test_20231031_155633,10350842.png,212614,3932,208682,0.98150639186507,2,6,42529,578,41951,0.9864092736720825,21.983740444444443,3072.926976,13.255281209164664,133,1.0E-4
7,test_20231031_155633,10863862.png,317432,6657,310775,0.979028579349278,2,5,66058,979,65079,0.9851796905749493,35.89375288888889,6568.835178666666,9.955919959241273,133,1.0E-4
8,test_20231031_155633,11382381.png,312486,797,311689,0.997449485736961,3,6,46745,109,46636,0.997668199807466,21.309107555555556,2485.130629333333,14.177311387814227,133,1.0E-4
9,test_20231031_155633,11079715.png,443815,98874,344941,0.7772179849712155,5,7,124136,13895,110241,0.8880663143648901,18.42161422222222,2518.297664,14.119732982444997,133,1.0E-4
10,test_20231031_155633,11551286.png,271883,477,271406,0.9982455688660196,2,5,40092,68,40024,0.9983039010276364,17.651459555555554,1826.2984533333333,15.515086095512114,133,1.0E-4
1,test_20231031_155634,10404007.png,502730,13952,488778,0.9722475284944204,3,6,61265,2031,59234,0.9668489349547049,26.42939377777778,3633.37456,12.527701898270605,133,1.1E-4
2,test_20231031_155634,1254659.png,342646,59502,283144,0.8263455578060155,5,6,80080,8383,71697,0.8953171828171829,22.628085333333335,3743.293184,12.398265174011183,133,1.1E-4
3,test_20231031_155634,10188041.png,221231,7742,213489,0.965004904375969,3,5,41731,1099,40632,0.9736646617622391,12.021692444444444,1415.9182933333334,16.620421680920458,133,1.1E-4
4,test_20231031_155634,10287332.png,216980,10444,206536,0.9518665314775555,2,6,22337,1436,20901,0.9357120472758204,9.952625777777778,956.3146133333333,18.32479568637085,133,1.1E-4
5,test_20231031_155634,11610969.png,368720,19097,349623,0.9482073117812975,4,6,84111,2803,81308,0.9666749890026275,23.451530666666667,3450.915978666667,12.751459754522989,133,1.1E-4
6,test_20231031_155634,10350842.png,212614,3932,208682,0.98150639186507,2,5,42529,578,41951,0.9864092736720825,21.983740444444443,3072.926976,13.255281209164664,133,1.1E-4
7,test_20231031_155634,10863862.png,317432,6657,310775,0.979028579349278,2,6,66058,979,65079,0.9851796905749493,35.89375288888889,6568.835178666666,9.955919959241273,133,1.1E-4
8,test_20231031_155634,11382381.png,312486,797,311689,0.997449485736961,3,6,46745,109,46636,0.997668199807466,21.309107555555556,2485.130629333333,14.177311387814227,133,1.1E-4
9,test_20231031_155634,11079715.png,443815,98874,344941,0.7772179849712155,5,6,124136,13895,110241,0.8880663143648901,18.42161422222222,2518.297664,14.119732982444997,133,1.1E-4
10,test_20231031_155634,11551286.png,271883,477,271406,0.9982455688660196,2,6,40092,68,40024,0.9983039010276364,17.651459555555554,1826.2984533333333,15.515086095512114,133,1.1E-4
1,test_20231031_155635,10404007.png,502730,13952,488778,0.9722475284944204,3,5,61265,2031,59234,0.9668489349547049,26.42939377777778,3633.37456,12.527701898270605,133,1.2E-4
2,test_20231031_155635,1254659.png,342646,59502,283144,0.8263455578060155,4,6,80080,8383,71697,0.8953171828171829,22.628085333333335,3743.293184,12.398265174011183,133,1.2E-4
3,test_20231031_155635,10188041.png,221231,7742,213489,0.965004904375969,3,6,41731,1099,40632,0.9736646617622391,12.021692444444444,1415.9182933333334,16.620421680920458,133,1.2E-4
4,test_20231031_155635,10287332.png,216980,10444,206536,0.9518665314775555,3,5,22337,1436,20901,0.9357120472758204,9.952625777777778,956.3146133333333,18.32479568637085,133,1.2E-4
5,test_20231031_155635,11610969.png,368720,19097,349623,0.9482073117812975,3,6,84111,2803,81308,0.9666749890026275,23.451530666666667,3450.915978666667,12.751459754522989,133,1.2E-4
6,test_20231031_155635,10350842.png,212614,3932,208682,0.98150639186507,2,6,42529,578,41951,0.9864092736720825,21.983740444444443,3072.926976,13.255281209164664,133,1.2E-4
7,test_20231031_155635,10863862.png,317432,6657,310775,0.979028579349278,3,6,66058,979,65079,0.9851796905749493,35.89375288888889,6568.835178666666,9.955919959241273,133,1.2E-4
8,test_20231031_155635,11382381.png,312486,777,311709,0.9975134886042895,2,5,46745,106,46639,0.9977323777944165,22.065804444444446,2630.8038773333333,13.929918876080027,133,1.2E-4
9,test_20231031_155635,11079715.png,443815,98874,344941,0.7772179849712155,5,6,124136,13895,110241,0.8880663143648901,18.42161422222222,2518.297664,14.119732982444997,133,1.2E-4
10,test_20231031_155635,11551286.png,271883,477,271406,0.9982455688660196,2,6,40092,68,40024,0.9983039010276364,17.651459555555554,1826.2984533333333,15.515086095512114,133,1.2E-4
1,test_20231031_155636,10404007.png,502730,13952,488778,0.9722475284944204,3,6,61265,2031,59234,0.9668489349547049,26.42939377777778,3633.37456,12.527701898270605,133,1.3000000000000002E-4
2,test_20231031_155636,1254659.png,342646,59502,283144,0.8263455578060155,4,6,80080,8383,71697,0.8953171828171829,22.628085333333335,3743.293184,12.398265174011183,133,1.3000000000000002E-4
3,test_20231031_155636,10188041.png,221231,7742,213489,0.965004904375969,3,5,41731,1099,40632,0.9736646617622391,12.021692444444444,1415.9182933333334,16.620421680920458,133,1.3000000000000002E-4
4,test_20231031_155636,10287332.png,216980,10444,206536,0.9518665314775555,3,6,22337,1436,20901,0.9357120472758204,9.952625777777778,956.3146133333333,18.32479568637085,133,1.3000000000000002E-4
5,test_20231031_155636,11610969.png,368720,19097,349623,0.9482073117812975,3,5,84111,2803,81308,0.9666749890026275,23.451530666666667,3450.915978666667,12.751459754522989,133,1.3000000000000002E-4
6,test_20231031_155636,10350842.png,212614,3932,208682,0.98150639186507,2,6,42529,578,41951,0.9864092736720825,21.983740444444443,3072.926976,13.255281209164664,133,1.3000000000000002E-4
7,test_20231031_155636,10863862.png,317432,6657,310775,0.979028579349278,2,5,66058,979,65079,0.9851796905749493,35.89375288888889,6568.835178666666,9.955919959241273,133,1.3000000000000002E-4
8,test_20231031_155636,11382381.png,312486,667,311819,0.997865504374596,3,6,46745,90,46655,0.9980746603914857,22.322282666666666,2670.9360426666667,13.864168721911659,133,1.3000000000000002E-4
9,test_20231031_155636,11079715.png,443815,98874,344941,0.7772179849712155,5,6,124136,13895,110241,0.8880663143648901,18.42161422222222,2518.297664,14.119732982444997,133,1.3000000000000002E-4
10,test_20231031_155636,11551286.png,271883,477,271406,0.9982455688660196,2,6,40092,68,40024,0.9983039010276364,17.651459555555554,1826.2984533333333,15.515086095512114,133,1.3000000000000002E-4
1,test_20231031_155637,10404007.png,502730,13952,488778,0.9722475284944204,4,6,61265,2031,59234,0.9668489349547049,26.42939377777778,3633.37456,12.527701898270605,133,1.4000000000000001E-4
2,test_20231031_155637,1254659.png,342646,59502,283144,0.8263455578060155,4,18,80080,8383,71697,0.8953171828171829,22.628085333333335,3743.293184,12.398265174011183,133,1.4000000000000001E-4
3,test_20231031_155637,10188041.png,221231,7742,213489,0.965004904375969,3,5,41731,1099,40632,0.9736646617622391,12.021692444444444,1415.9182933333334,16.620421680920458,133,1.4000000000000001E-4
4,test_20231031_155637,10287332.png,216980,10444,206536,0.9518665314775555,3,6,22337,1436,20901,0.9357120472758204,9.952625777777778,956.3146133333333,18.32479568637085,133,1.4000000000000001E-4
5,test_20231031_155637,11610969.png,368720,19097,349623,0.9482073117812975,3,5,84111,2803,81308,0.9666749890026275,23.451530666666667,3450.915978666667,12.751459754522989,133,1.4000000000000001E-4
6,test_20231031_155637,10350842.png,212614,3932,208682,0.98150639186507,3,6,42529,578,41951,0.9864092736720825,21.983740444444443,3072.926976,13.255281209164664,133,1.4000000000000001E-4
7,test_20231031_155637,10863862.png,317432,6657,310775,0.979028579349278,3,6,66058,979,65079,0.9851796905749493,35.89375288888889,6568.835178666666,9.955919959241273,133,1.4000000000000001E-4
8,test_20231031_155637,11382381.png,312486,667,311819,0.997865504374596,2,5,46745,90,46655,0.9980746603914857,22.322282666666666,2670.9360426666667,13.864168721911659,133,1.4000000000000001E-4
9,test_20231031_155637,11079715.png,443815,98874,344941,0.7772179849712155,5,6,124136,13895,110241,0.8880663143648901,18.42161422222222,2518.297664,14.119732982444997,133,1.4000000000000001E-4
10,test_20231031_155637,11551286.png,271883,477,271406,0.9982455688660196,2,14,40092,68,40024,0.9983039010276364,17.651459555555554,1826.2984533333333,15.515086095512114,133,1.4000000000000001E-4
1,test_20231031_155638,10404007.png,502730,13952,488778,0.9722475284944204,3,7,61265,2031,59234,0.9668489349547049,26.42939377777778,3633.37456,12.527701898270605,133,1.5000000000000001E-4
2,test_20231031_155638,1254659.png,342646,59502,283144,0.8263455578060155,4,6,80080,8383,71697,0.8953171828171829,22.628085333333335,3743.293184,12.398265174011183,133,1.5000000000000001E-4
3,test_20231031_155638,10188041.png,221231,7742,213489,0.965004904375969,2,5,41731,1099,40632,0.9736646617622391,12.021692444444444,1415.9182933333334,16.620421680920458,133,1.5000000000000001E-4
4,test_20231031_155638,10287332.png,216980,10444,206536,0.9518665314775555,2,5,22337,1436,20901,0.9357120472758204,9.952625777777778,956.3146133333333,18.32479568637085,133,1.5000000000000001E-4
5,test_20231031_155638,11610969.png,368720,19097,349623,0.9482073117812975,4,6,84111,2803,81308,0.9666749890026275,23.451530666666667,3450.915978666667,12.751459754522989,133,1.5000000000000001E-4
6,test_20231031_155638,10350842.png,212614,3932,208682,0.98150639186507,2,6,42529,578,41951,0.9864092736720825,21.983740444444443,3072.926976,13.255281209164664,133,1.5000000000000001E-4
7,test_20231031_155638,10863862.png,317432,6657,310775,0.979028579349278,2,5,66058,979,65079,0.9851796905749493,35.89375288888889,6568.835178666666,9.955919959241273,133,1.5000000000000001E-4
8,test_20231031_155638,11382381.png,312486,667,311819,0.997865504374596,2,5,46745,90,46655,0.9980746603914857,22.322282666666666,2670.9360426666667,13.864168721911659,133,1.5000000000000001E-4
9,test_20231031_155638,11079715.png,443815,98874,344941,0.7772179849712155,5,7,124136,13895,110241,0.8880663143648901,18.42161422222222,2518.297664,14.119732982444997,133,1.5000000000000001E-4
10,test_20231031_155638,11551286.png,271883,477,271406,0.9982455688660196,2,6,40092,68,40024,0.9983039010276364,17.651459555555554,1826.2984533333333,15.515086095512114,133,1.5000000000000001E-4
1,test_20231031_155639,10404007.png,502730,13952,488778,0.9722475284944204,4,6,61265,2031,59234,0.9668489349547049,26.42939377777778,3633.37456,12.527701898270605,133,1.6E-4
2,test_20231031_155639,1254659.png,342646,59502,283144,0.8263455578060155,4,6,80080,8383,71697,0.8953171828171829,22.628085333333335,3743.293184,12.398265174011183,133,1.6E-4
3,test_20231031_155639,10188041.png,221231,7742,213489,0.965004904375969,3,6,41731,1099,40632,0.9736646617622391,12.021692444444444,1415.9182933333334,16.620421680920458,133,1.6E-4
4,test_20231031_155639,10287332.png,216980,10252,206728,0.9527514056595078,3,6,22337,1412,20925,0.9367864977391771,10.08100088888889,982.629264,18.20690667012046,133,1.6E-4
5,test_20231031_155639,11610969.png,368720,19097,349623,0.9482073117812975,4,6,84111,2803,81308,0.9666749890026275,23.451530666666667,3450.915978666667,12.751459754522989,133,1.6E-4
6,test_20231031_155639,10350842.png,212614,3932,208682,0.98150639186507,2,5,42529,578,41951,0.9864092736720825,21.983740444444443,3072.926976,13.255281209164664,133,1.6E-4
7,test_20231031_155639,10863862.png,317432,6657,310775,0.979028579349278,2,6,66058,979,65079,0.9851796905749493,35.89375288888889,6568.835178666666,9.955919959241273,133,1.6E-4
8,test_20231031_155639,11382381.png,312486,667,311819,0.997865504374596,2,6,46745,90,46655,0.9980746603914857,22.322282666666666,2670.9360426666667,13.864168721911659,133,1.6E-4
9,test_20231031_155639,11079715.png,443815,98874,344941,0.7772179849712155,5,6,124136,13895,110241,0.8880663143648901,18.42161422222222,2518.297664,14.119732982444997,133,1.6E-4
10,test_20231031_155639,11551286.png,271883,477,271406,0.9982455688660196,2,5,40092,68,40024,0.9983039010276364,17.651459555555554,1826.2984533333333,15.515086095512114,133,1.6E-4
1,test_20231031_155640,10404007.png,502730,13952,488778,0.9722475284944204,3,5,61265,2031,59234,0.9668489349547049,26.42939377777778,3633.37456,12.527701898270605,133,1.7E-4
2,test_20231031_155640,1254659.png,342646,59502,283144,0.8263455578060155,5,6,80080,8383,71697,0.8953171828171829,22.628085333333335,3743.293184,12.398265174011183,133,1.7E-4
3,test_20231031_155640,10188041.png,221231,7742,213489,0.965004904375969,3,5,41731,1099,40632,0.9736646617622391,12.021692444444444,1415.9182933333334,16.620421680920458,133,1.7E-4
4,test_20231031_155640,10287332.png,216980,10252,206728,0.9527514056595078,2,6,22337,1412,20925,0.9367864977391771,10.08100088888889,982.629264,18.20690667012046,133,1.7E-4
5,test_20231031_155640,11610969.png,368720,19097,349623,0.9482073117812975,3,13,84111,2803,81308,0.9666749890026275,23.451530666666667,3450.915978666667,12.751459754522989,133,1.7E-4
6,test_20231031_155640,10350842.png,212614,3932,208682,0.98150639186507,2,5,42529,578,41951,0.9864092736720825,21.983740444444443,3072.926976,13.255281209164664,133,1.7E-4
7,test_20231031_155640,10863862.png,317432,6657,310775,0.979028579349278,3,6,66058,979,65079,0.9851796905749493,35.89375288888889,6568.835178666666,9.955919959241273,133,1.7E-4
8,test_20231031_155640,11382381.png,312486,667,311819,0.997865504374596,2,6,46745,90,46655,0.9980746603914857,22.322282666666666,2670.9360426666667,13.864168721911659,133,1.7E-4
9,test_20231031_155640,11079715.png,443815,98874,344941,0.7772179849712155,5,6,124136,13895,110241,0.8880663143648901,18.42161422222222,2518.297664,14.119732982444997,133,1.7E-4
10,test_20231031_155640,11551286.png,271883,477,271406,0.9982455688660196,2,6,40092,68,40024,0.9983039010276364,17.651459555555554,1826.2984533333333,15.515086095512114,133,1.7E-4
1,test_20231031_155641,10404007.png,502730,13952,488778,0.9722475284944204,3,6,61265,2031,59234,0.9668489349547049,26.42939377777778,3633.37456,12.527701898270605,133,1.8E-4
2,test_20231031_155641,1254659.png,342646,59502,283144,0.8263455578060155,4,6,80080,8383,71697,0.8953171828171829,22.628085333333335,3743.293184,12.398265174011183,133,1.8E-4
3,test_20231031_155641,10188041.png,221231,7742,213489,0.965004904375969,3,6,41731,1099,40632,0.9736646617622391,12.021692444444444,1415.9182933333334,16.620421680920458,133,1.8E-4
4,test_20231031_155641,10287332.png,216980,10252,206728,0.9527514056595078,2,5,22337,1412,20925,0.9367864977391771,10.08100088888889,982.629264,18.20690667012046,133,1.8E-4
5,test_20231031_155641,11610969.png,368720,19097,349623,0.9482073117812975,3,5,84111,2803,81308,0.9666749890026275,23.451530666666667,3450.915978666667,12.751459754522989,133,1.8E-4
6,test_20231031_155641,10350842.png,212614,3932,208682,0.98150639186507,2,5,42529,578,41951,0.9864092736720825,21.983740444444443,3072.926976,13.255281209164664,133,1.8E-4
7,test_20231031_155641,10863862.png,317432,6657,310775,0.979028579349278,3,5,66058,979,65079,0.9851796905749493,35.89375288888889,6568.835178666666,9.955919959241273,133,1.8E-4
8,test_20231031_155641,11382381.png,312486,667,311819,0.997865504374596,2,5,46745,90,46655,0.9980746603914857,22.322282666666666,2670.9360426666667,13.864168721911659,133,1.8E-4
9,test_20231031_155641,11079715.png,443815,98874,344941,0.7772179849712155,5,6,124136,13895,110241,0.8880663143648901,18.42161422222222,2518.297664,14.119732982444997,133,1.8E-4
10,test_20231031_155641,11551286.png,271883,477,271406,0.9982455688660196,2,5,40092,68,40024,0.9983039010276364,17.651459555555554,1826.2984533333333,15.515086095512114,133,1.8E-4
1,test_20231031_155642,10404007.png,502730,13952,488778,0.9722475284944204,3,5,61265,2031,59234,0.9668489349547049,26.42939377777778,3633.37456,12.527701898270605,133,1.9E-4
2,test_20231031_155642,1254659.png,342646,59502,283144,0.8263455578060155,4,6,80080,8383,71697,0.8953171828171829,22.628085333333335,3743.293184,12.398265174011183,133,1.9E-4
3,test_20231031_155642,10188041.png,221231,7742,213489,0.965004904375969,3,5,41731,1099,40632,0.9736646617622391,12.021692444444444,1415.9182933333334,16.620421680920458,133,1.9E-4
4,test_20231031_155642,10287332.png,216980,10252,206728,0.9527514056595078,2,5,22337,1412,20925,0.9367864977391771,10.08100088888889,982.629264,18.20690667012046,133,1.9E-4
5,test_20231031_155642,11610969.png,368720,19097,349623,0.9482073117812975,3,6,84111,2803,81308,0.9666749890026275,23.451530666666667,3450.915978666667,12.751459754522989,133,1.9E-4
6,test_20231031_155642,10350842.png,212614,3932,208682,0.98150639186507,2,6,42529,578,41951,0.9864092736720825,21.983740444444443,3072.926976,13.255281209164664,133,1.9E-4
7,test_20231031_155642,10863862.png,317432,6657,310775,0.979028579349278,2,5,66058,979,65079,0.9851796905749493,35.89375288888889,6568.835178666666,9.955919959241273,133,1.9E-4
8,test_20231031_155642,11382381.png,312486,667,311819,0.997865504374596,2,6,46745,90,46655,0.9980746603914857,22.322282666666666,2670.9360426666667,13.864168721911659,133,1.9E-4
9,test_20231031_155642,11079715.png,443815,98874,344941,0.7772179849712155,5,6,124136,13895,110241,0.8880663143648901,18.42161422222222,2518.297664,14.119732982444997,133,1.9E-4
10,test_20231031_155642,11551286.png,271883,477,271406,0.9982455688660196,3,5,40092,68,40024,0.9983039010276364,17.651459555555554,1826.2984533333333,15.515086095512114,133,1.9E-4
1,test_20231031_155643,10404007.png,502730,13952,488778,0.9722475284944204,4,11,61265,2031,59234,0.9668489349547049,26.42939377777778,3633.37456,12.527701898270605,133,2.0E-4
2,test_20231031_155643,1254659.png,342646,59502,283144,0.8263455578060155,5,6,80080,8383,71697,0.8953171828171829,22.628085333333335,3743.293184,12.398265174011183,133,2.0E-4
3,test_20231031_155643,10188041.png,221231,7742,213489,0.965004904375969,3,6,41731,1099,40632,0.9736646617622391,12.021692444444444,1415.9182933333334,16.620421680920458,133,2.0E-4
4,test_20231031_155643,10287332.png,216980,10252,206728,0.9527514056595078,2,6,22337,1412,20925,0.9367864977391771,10.08100088888889,982.629264,18.20690667012046,133,2.0E-4
5,test_20231031_155643,11610969.png,368720,19097,349623,0.9482073117812975,4,6,84111,2803,81308,0.9666749890026275,23.451530666666667,3450.915978666667,12.751459754522989,133,2.0E-4
6,test_20231031_155643,10350842.png,212614,3932,208682,0.98150639186507,3,6,42529,578,41951,0.9864092736720825,21.983740444444443,3072.926976,13.255281209164664,133,2.0E-4
7,test_20231031_155643,10863862.png,317432,6657,310775,0.979028579349278,2,9,66058,979,65079,0.9851796905749493,35.89375288888889,6568.835178666666,9.955919959241273,133,2.0E-4
8,test_20231031_155643,11382381.png,312486,667,311819,0.997865504374596,2,6,46745,90,46655,0.9980746603914857,22.322282666666666,2670.9360426666667,13.864168721911659,133,2.0E-4
9,test_20231031_155643,11079715.png,443815,98874,344941,0.7772179849712155,5,7,124136,13895,110241,0.8880663143648901,18.42161422222222,2518.297664,14.119732982444997,133,2.0E-4
10,test_20231031_155643,11551286.png,271883,267,271616,0.9990179599312939,2,6,40092,37,40055,0.9990771226179787,17.919265777777778,1867.1754613333333,15.418952296845859,133,2.0E-4
1,test_20231031_155644,10404007.png,502730,13952,488778,0.9722475284944204,3,6,61265,2031,59234,0.9668489349547049,26.42939377777778,3633.37456,12.527701898270605,133,2.1E-4
2,test_20231031_155644,1254659.png,342646,59502,283144,0.8263455578060155,4,6,80080,8383,71697,0.8953171828171829,22.628085333333335,3743.293184,12.398265174011183,133,2.1E-4
3,test_20231031_155644,10188041.png,221231,7742,213489,0.965004904375969,3,5,41731,1099,40632,0.9736646617622391,12.021692444444444,1415.9182933333334,16.620421680920458,133,2.1E-4
4,test_20231031_155644,10287332.png,216980,10252,206728,0.9527514056595078,2,6,22337,1412,20925,0.9367864977391771,10.08100088888889,982.629264,18.20690667012046,133,2.1E-4
5,test_20231031_155644,11610969.png,368720,19097,349623,0.9482073117812975,4,6,84111,2803,81308,0.9666749890026275,23.451530666666667,3450.915978666667,12.751459754522989,133,2.1E-4
6,test_20231031_155644,10350842.png,212614,3932,208682,0.98150639186507,3,6,42529,578,41951,0.9864092736720825,21.983740444444443,3072.926976,13.255281209164664,133,2.1E-4
7,test_20231031_155644,10863862.png,317432,6657,310775,0.979028579349278,3,6,66058,979,65079,0.9851796905749493,35.89375288888889,6568.835178666666,9.955919959241273,133,2.1E-4
8,test_20231031_155644,11382381.png,312486,667,311819,0.997865504374596,2,6,46745,90,46655,0.9980746603914857,22.322282666666666,2670.9360426666667,13.864168721911659,133,2.1E-4
9,test_20231031_155644,11079715.png,443815,98874,344941,0.7772179849712155,5,6,124136,13895,110241,0.8880663143648901,18.42161422222222,2518.297664,14.119732982444997,133,2.1E-4
10,test_20231031_155644,11551286.png,271883,267,271616,0.9990179599312939,2,6,40092,37,40055,0.9990771226179787,17.919265777777778,1867.1754613333333,15.418952296845859,133,2.1E-4
1,test_20231031_155645,10404007.png,502730,13952,488778,0.9722475284944204,3,6,61265,2031,59234,0.9668489349547049,26.42939377777778,3633.37456,12.527701898270605,133,2.2E-4
2,test_20231031_155645,1254659.png,342646,59502,283144,0.8263455578060155,5,6,80080,8383,71697,0.8953171828171829,22.628085333333335,3743.293184,12.398265174011183,133,2.2E-4
3,test_20231031_155645,10188041.png,221231,7742,213489,0.965004904375969,3,5,41731,1099,40632,0.9736646617622391,12.021692444444444,1415.9182933333334,16.620421680920458,133,2.2E-4
4,test_20231031_155645,10287332.png,216980,10252,206728,0.9527514056595078,3,6,22337,1412,20925,0.9367864977391771,10.08100088888889,982.629264,18.20690667012046,133,2.2E-4
5,test_20231031_155645,11610969.png,368720,19097,349623,0.9482073117812975,3,6,84111,2803,81308,0.9666749890026275,23.451530666666667,3450.915978666667,12.751459754522989,133,2.2E-4
6,test_20231031_155645,10350842.png,212614,3932,208682,0.98150639186507,2,5,42529,578,41951,0.9864092736720825,21.983740444444443,3072.926976,13.255281209164664,133,2.2E-4
7,test_20231031_155645,10863862.png,317432,6657,310775,0.979028579349278,3,6,66058,979,65079,0.9851796905749493,35.89375288888889,6568.835178666666,9.955919959241273,133,2.2E-4
8,test_20231031_155645,11382381.png,312486,667,311819,0.997865504374596,2,5,46745,90,46655,0.9980746603914857,22.322282666666666,2670.9360426666667,13.864168721911659,133,2.2E-4
9,test_20231031_155645,11079715.png,443815,98874,344941,0.7772179849712155,5,6,124136,13895,110241,0.8880663143648901,18.42161422222222,2518.297664,14.119732982444997,133,2.2E-4
10,test_20231031_155645,11551286.png,271883,267,271616,0.9990179599312939,2,6,40092,37,40055,0.9990771226179787,17.919265777777778,1867.1754613333333,15.418952296845859,133,2.2E-4
1,test_20231031_155646,10404007.png,502730,13952,488778,0.9722475284944204,3,6,61265,2031,59234,0.9668489349547049,26.42939377777778,3633.37456,12.527701898270605,133,2.3E-4
2,test_20231031_155646,1254659.png,342646,59502,283144,0.8263455578060155,5,6,80080,8383,71697,0.8953171828171829,22.628085333333335,3743.293184,12.398265174011183,133,2.3E-4
3,test_20231031_155646,10188041.png,221231,7742,213489,0.965004904375969,3,6,41731,1099,40632,0.9736646617622391,12.021692444444444,1415.9182933333334,16.620421680920458,133,2.3E-4
4,test_20231031_155646,10287332.png,216980,10252,206728,0.9527514056595078,3,5,22337,1412,20925,0.9367864977391771,10.08100088888889,982.629264,18.20690667012046,133,2.3E-4
5,test_20231031_155646,11610969.png,368720,19097,349623,0.9482073117812975,3,5,84111,2803,81308,0.9666749890026275,23.451530666666667,3450.915978666667,12.751459754522989,133,2.3E-4
6,test_20231031_155646,10350842.png,212614,3932,208682,0.98150639186507,2,5,42529,578,41951,0.9864092736720825,21.983740444444443,3072.926976,13.255281209164664,133,2.3E-4
7,test_20231031_155646,10863862.png,317432,6657,310775,0.979028579349278,2,5,66058,979,65079,0.9851796905749493,35.89375288888889,6568.835178666666,9.955919959241273,133,2.3E-4
8,test_20231031_155646,11382381.png,312486,667,311819,0.997865504374596,2,6,46745,90,46655,0.9980746603914857,22.322282666666666,2670.9360426666667,13.864168721911659,133,2.3E-4
9,test_20231031_155646,11079715.png,443815,98874,344941,0.7772179849712155,5,7,124136,13895,110241,0.8880663143648901,18.42161422222222,2518.297664,14.119732982444997,133,2.3E-4
10,test_20231031_155646,11551286.png,271883,267,271616,0.9990179599312939,2,6,40092,37,40055,0.9990771226179787,17.919265777777778,1867.1754613333333,15.418952296845859,133,2.3E-4
1,test_20231031_155647,10404007.png,502730,13952,488778,0.9722475284944204,4,6,61265,2031,59234,0.9668489349547049,26.42939377777778,3633.37456,12.527701898270605,133,2.4E-4
2,test_20231031_155647,1254659.png,342646,59502,283144,0.8263455578060155,4,7,80080,8383,71697,0.8953171828171829,22.628085333333335,3743.293184,12.398265174011183,133,2.4E-4
3,test_20231031_155647,10188041.png,221231,7742,213489,0.965004904375969,3,6,41731,1099,40632,0.9736646617622391,12.021692444444444,1415.9182933333334,16.620421680920458,133,2.4E-4
4,test_20231031_155647,10287332.png,216980,10252,206728,0.9527514056595078,3,5,22337,1412,20925,0.9367864977391771,10.08100088888889,982.629264,18.20690667012046,133,2.4E-4
5,test_20231031_155647,11610969.png,368720,19097,349623,0.9482073117812975,4,6,84111,2803,81308,0.9666749890026275,23.451530666666667,3450.915978666667,12.751459754522989,133,2.4E-4
6,test_20231031_155647,10350842.png,212614,3932,208682,0.98150639186507,2,6,42529,578,41951,0.9864092736720825,21.983740444444443,3072.926976,13.255281209164664,133,2.4E-4
7,test_20231031_155647,10863862.png,317432,6657,310775,0.979028579349278,2,5,66058,979,65079,0.9851796905749493,35.89375288888889,6568.835178666666,9.955919959241273,133,2.4E-4
8,test_20231031_155647,11382381.png,312486,667,311819,0.997865504374596,2,7,46745,90,46655,0.9980746603914857,22.322282666666666,2670.9360426666667,13.864168721911659,133,2.4E-4
9,test_20231031_155647,11079715.png,443815,98874,344941,0.7772179849712155,5,7,124136,13895,110241,0.8880663143648901,18.42161422222222,2518.297664,14.119732982444997,133,2.4E-4
10,test_20231031_155647,11551286.png,271883,267,271616,0.9990179599312939,2,6,40092,37,40055,0.9990771226179787,17.919265777777778,1867.1754613333333,15.418952296845859,133,2.4E-4
1,test_20231031_155648,10404007.png,502730,13952,488778,0.9722475284944204,3,6,61265,2031,59234,0.9668489349547049,26.42939377777778,3633.37456,12.527701898270605,133,2.5E-4
2,test_20231031_155648,1254659.png,342646,59502,283144,0.8263455578060155,5,6,80080,8383,71697,0.8953171828171829,22.628085333333335,3743.293184,12.398265174011183,133,2.5E-4
3,test_20231031_155648,10188041.png,221231,7742,213489,0.965004904375969,3,6,41731,1099,40632,0.9736646617622391,12.021692444444444,1415.9182933333334,16.620421680920458,133,2.5E-4
4,test_20231031_155648,10287332.png,216980,10252,206728,0.9527514056595078,2,6,22337,1412,20925,0.9367864977391771,10.08100088888889,982.629264,18.20690667012046,133,2.5E-4
5,test_20231031_155648,11610969.png,368720,19097,349623,0.9482073117812975,3,5,84111,2803,81308,0.9666749890026275,23.451530666666667,3450.915978666667,12.751459754522989,133,2.5E-4
6,test_20231031_155648,10350842.png,212614,3932,208682,0.98150639186507,3,6,42529,578,41951,0.9864092736720825,21.983740444444443,3072.926976,13.255281209164664,133,2.5E-4
7,test_20231031_155648,10863862.png,317432,6657,310775,0.979028579349278,3,6,66058,979,65079,0.9851796905749493,35.89375288888889,6568.835178666666,9.955919959241273,133,2.5E-4
8,test_20231031_155648,11382381.png,312486,667,311819,0.997865504374596,3,6,46745,90,46655,0.9980746603914857,22.322282666666666,2670.9360426666667,13.864168721911659,133,2.5E-4
9,test_20231031_155648,11079715.png,443815,98874,344941,0.7772179849712155,5,7,124136,13895,110241,0.8880663143648901,18.42161422222222,2518.297664,14.119732982444997,133,2.5E-4
10,test_20231031_155648,11551286.png,271883,267,271616,0.9990179599312939,2,6,40092,37,40055,0.9990771226179787,17.919265777777778,1867.1754613333333,15.418952296845859,133,2.5E-4
1,test_20231031_155649,10404007.png,502730,13872,488858,0.9724066596383745,3,6,61265,2019,59246,0.9670448053537909,26.43332977777778,3634.1775893333333,12.526742149506438,133,2.6000000000000003E-4
2,test_20231031_155649,1254659.png,342646,59442,283204,0.8265206656432587,5,6,80080,8377,71703,0.8953921078921079,22.63763911111111,3744.3753706666666,12.397009809413873,133,2.6000000000000003E-4
3,test_20231031_155649,10188041.png,221231,7682,213549,0.9652761141069741,3,6,41731,1091,40640,0.9738563657712492,12.255687111111111,1439.799552,16.54778326772516,133,2.6000000000000003E-4
4,test_20231031_155649,10287332.png,216980,10252,206728,0.9527514056595078,3,6,22337,1412,20925,0.9367864977391771,10.08100088888889,982.629264,18.20690667012046,133,2.6000000000000003E-4
5,test_20231031_155649,11610969.png,368720,18977,349743,0.9485327619874159,4,6,84111,2788,81323,0.9668533247732164,23.867306666666668,3517.9054613333333,12.667961966313278,133,2.6000000000000003E-4
6,test_20231031_155649,10350842.png,212614,3932,208682,0.98150639186507,3,5,42529,578,41951,0.9864092736720825,21.983740444444443,3072.926976,13.255281209164664,133,2.6000000000000003E-4
7,test_20231031_155649,10863862.png,317432,6617,310815,0.9791545905894806,2,5,66058,973,65085,0.9852705198461957,35.89944888888889,6569.9042346666665,9.955213216976183,133,2.6000000000000003E-4
8,test_20231031_155649,11382381.png,312486,547,311939,0.9982495215785667,2,6,46745,72,46673,0.9984597283131885,22.81680888888889,2740.878352,13.751906001286724,133,2.6000000000000003E-4
9,test_20231031_155649,11079715.png,443815,98874,344941,0.7772179849712155,6,6,124136,13895,110241,0.8880663143648901,18.42161422222222,2518.297664,14.119732982444997,133,2.6000000000000003E-4
10,test_20231031_155649,11551286.png,271883,164,271719,0.9993967993585476,2,6,40092,22,40070,0.9994512620971765,18.120286222222223,1899.5769013333334,15.344234809036362,133,2.6000000000000003E-4
1,test_20231031_155650,10404007.png,502730,13872,488858,0.9724066596383745,4,6,61265,2019,59246,0.9670448053537909,26.43332977777778,3634.1775893333333,12.526742149506438,133,2.7000000000000006E-4
2,test_20231031_155650,1254659.png,342646,59442,283204,0.8265206656432587,4,6,80080,8377,71703,0.8953921078921079,22.63763911111111,3744.3753706666666,12.397009809413873,133,2.7000000000000006E-4
3,test_20231031_155650,10188041.png,221231,7682,213549,0.9652761141069741,3,6,41731,1091,40640,0.9738563657712492,12.255687111111111,1439.799552,16.54778326772516,133,2.7000000000000006E-4
4,test_20231031_155650,10287332.png,216980,10252,206728,0.9527514056595078,3,6,22337,1412,20925,0.9367864977391771,10.08100088888889,982.629264,18.20690667012046,133,2.7000000000000006E-4
5,test_20231031_155650,11610969.png,368720,18977,349743,0.9485327619874159,3,7,84111,2788,81323,0.9668533247732164,23.867306666666668,3517.9054613333333,12.667961966313278,133,2.7000000000000006E-4
6,test_20231031_155650,10350842.png,212614,3932,208682,0.98150639186507,2,6,42529,578,41951,0.9864092736720825,21.983740444444443,3072.926976,13.255281209164664,133,2.7000000000000006E-4
7,test_20231031_155650,10863862.png,317432,6617,310815,0.9791545905894806,3,6,66058,973,65085,0.9852705198461957,35.89944888888889,6569.9042346666665,9.955213216976183,133,2.7000000000000006E-4
8,test_20231031_155650,11382381.png,312486,547,311939,0.9982495215785667,2,5,46745,72,46673,0.9984597283131885,22.81680888888889,2740.878352,13.751906001286724,133,2.7000000000000006E-4
9,test_20231031_155650,11079715.png,443815,98874,344941,0.7772179849712155,5,7,124136,13895,110241,0.8880663143648901,18.42161422222222,2518.297664,14.119732982444997,133,2.7000000000000006E-4
10,test_20231031_155650,11551286.png,271883,164,271719,0.9993967993585476,2,6,40092,22,40070,0.9994512620971765,18.120286222222223,1899.5769013333334,15.344234809036362,133,2.7000000000000006E-4
1,test_20231031_155651,10404007.png,502730,13872,488858,0.9724066596383745,4,6,61265,2019,59246,0.9670448053537909,26.43332977777778,3634.1775893333333,12.526742149506438,133,2.800000000000001E-4
2,test_20231031_155651,1254659.png,342646,59442,283204,0.8265206656432587,5,6,80080,8377,71703,0.8953921078921079,22.63763911111111,3744.3753706666666,12.397009809413873,133,2.800000000000001E-4
3,test_20231031_155651,10188041.png,221231,7682,213549,0.9652761141069741,4,5,41731,1091,40640,0.9738563657712492,12.255687111111111,1439.799552,16.54778326772516,133,2.800000000000001E-4
4,test_20231031_155651,10287332.png,216980,10252,206728,0.9527514056595078,2,5,22337,1412,20925,0.9367864977391771,10.08100088888889,982.629264,18.20690667012046,133,2.800000000000001E-4
5,test_20231031_155651,11610969.png,368720,18977,349743,0.9485327619874159,4,6,84111,2788,81323,0.9668533247732164,23.867306666666668,3517.9054613333333,12.667961966313278,133,2.800000000000001E-4
6,test_20231031_155651,10350842.png,212614,3932,208682,0.98150639186507,2,5,42529,578,41951,0.9864092736720825,21.983740444444443,3072.926976,13.255281209164664,133,2.800000000000001E-4
7,test_20231031_155651,10863862.png,317432,6617,310815,0.9791545905894806,3,6,66058,973,65085,0.9852705198461957,35.89944888888889,6569.9042346666665,9.955213216976183,133,2.800000000000001E-4
8,test_20231031_155651,11382381.png,312486,547,311939,0.9982495215785667,2,5,46745,72,46673,0.9984597283131885,22.81680888888889,2740.878352,13.751906001286724,133,2.800000000000001E-4
9,test_20231031_155651,11079715.png,443815,98874,344941,0.7772179849712155,5,6,124136,13895,110241,0.8880663143648901,18.42161422222222,2518.297664,14.119732982444997,133,2.800000000000001E-4
10,test_20231031_155651,11551286.png,271883,164,271719,0.9993967993585476,2,5,40092,22,40070,0.9994512620971765,18.120286222222223,1899.5769013333334,15.344234809036362,133,2.800000000000001E-4
1,test_20231031_155652,10404007.png,502730,13872,488858,0.9724066596383745,4,6,61265,2019,59246,0.9670448053537909,26.43332977777778,3634.1775893333333,12.526742149506438,133,2.900000000000001E-4
2,test_20231031_155652,1254659.png,342646,59442,283204,0.8265206656432587,4,6,80080,8377,71703,0.8953921078921079,22.63763911111111,3744.3753706666666,12.397009809413873,133,2.900000000000001E-4
3,test_20231031_155652,10188041.png,221231,7682,213549,0.9652761141069741,3,5,41731,1091,40640,0.9738563657712492,12.255687111111111,1439.799552,16.54778326772516,133,2.900000000000001E-4
4,test_20231031_155652,10287332.png,216980,10252,206728,0.9527514056595078,2,6,22337,1412,20925,0.9367864977391771,10.08100088888889,982.629264,18.20690667012046,133,2.900000000000001E-4
5,test_20231031_155652,11610969.png,368720,18977,349743,0.9485327619874159,4,6,84111,2788,81323,0.9668533247732164,23.867306666666668,3517.9054613333333,12.667961966313278,133,2.900000000000001E-4
6,test_20231031_155652,10350842.png,212614,3932,208682,0.98150639186507,2,6,42529,578,41951,0.9864092736720825,21.983740444444443,3072.926976,13.255281209164664,133,2.900000000000001E-4
7,test_20231031_155652,10863862.png,317432,6617,310815,0.9791545905894806,2,6,66058,973,65085,0.9852705198461957,35.89944888888889,6569.9042346666665,9.955213216976183,133,2.900000000000001E-4
8,test_20231031_155652,11382381.png,312486,547,311939,0.9982495215785667,2,5,46745,72,46673,0.9984597283131885,22.81680888888889,2740.878352,13.751906001286724,133,2.900000000000001E-4
9,test_20231031_155652,11079715.png,443815,98874,344941,0.7772179849712155,4,6,124136,13895,110241,0.8880663143648901,18.42161422222222,2518.297664,14.119732982444997,133,2.900000000000001E-4
10,test_20231031_155652,11551286.png,271883,164,271719,0.9993967993585476,2,6,40092,22,40070,0.9994512620971765,18.120286222222223,1899.5769013333334,15.344234809036362,133,2.900000000000001E-4
1,test_20231031_155653,10404007.png,502730,12787,489943,0.9745648757782508,3,6,61265,1869,59396,0.9694931853423652,26.516264888888887,3659.1609973333334,12.496988426862345,134,1.0E-5
2,test_20231031_155653,1254659.png,342646,57112,285534,0.8333206866561991,4,6,80080,8046,72034,0.8995254745254745,22.946245333333334,3855.036016,12.270519210290555,134,1.0E-5
3,test_20231031_155653,10188041.png,221231,7542,213689,0.9659089368126529,3,6,41731,1070,40661,0.9743595887949007,12.04232,1422.4973813333334,16.60028885290102,134,1.0E-5
4,test_20231031_155653,10287332.png,216980,10122,206858,0.9533505392202046,3,5,22337,1393,20944,0.9376371043560012,10.011550222222223,977.165808,18.231120986949595,134,1.0E-5
5,test_20231031_155653,11610969.png,368720,18252,350468,0.9504990236493817,3,6,84111,2682,81429,0.968113564218711,23.600170666666667,3494.751157333333,12.696641034884948,134,1.0E-5
6,test_20231031_155653,10350842.png,212614,3832,208782,0.9819767277789797,2,6,42529,563,41966,0.9867619741823227,20.466149333333334,2642.7065866666667,13.910314137276194,134,1.0E-5
7,test_20231031_155653,10863862.png,317432,6234,311198,0.9803611482144208,3,6,66058,916,65142,0.9861333979230373,36.010332444444444,6595.3394026666665,9.938432111883285,134,1.0E-5
8,test_20231031_155653,11382381.png,312486,787,311699,0.9974814871706252,3,6,46745,107,46638,0.9977109851320997,20.595329777777778,2391.5028426666668,14.344094594342474,134,1.0E-5
9,test_20231031_155653,11079715.png,443815,96804,347011,0.7818820905106858,5,7,124136,13603,110533,0.8904185731778049,18.573955555555557,2560.8911893333334,14.046892349086676,134,1.0E-5
10,test_20231031_155653,11551286.png,271883,557,271326,0.9979513246506769,2,6,40092,80,40012,0.9980045894442782,17.47336888888889,1793.4866346666668,15.593822162719512,134,1.0E-5
1,test_20231031_155654,10404007.png,502730,12787,489943,0.9745648757782508,3,6,61265,1869,59396,0.9694931853423652,26.516264888888887,3659.1609973333334,12.496988426862345,134,2.0E-5
2,test_20231031_155654,1254659.png,342646,57112,285534,0.8333206866561991,5,6,80080,8046,72034,0.8995254745254745,22.946245333333334,3855.036016,12.270519210290555,134,2.0E-5
3,test_20231031_155654,10188041.png,221231,7542,213689,0.9659089368126529,3,6,41731,1070,40661,0.9743595887949007,12.04232,1422.4973813333334,16.60028885290102,134,2.0E-5
4,test_20231031_155654,10287332.png,216980,10122,206858,0.9533505392202046,3,6,22337,1393,20944,0.9376371043560012,10.011550222222223,977.165808,18.231120986949595,134,2.0E-5
5,test_20231031_155654,11610969.png,368720,18252,350468,0.9504990236493817,3,6,84111,2682,81429,0.968113564218711,23.600170666666667,3494.751157333333,12.696641034884948,134,2.0E-5
6,test_20231031_155654,10350842.png,212614,3832,208782,0.9819767277789797,2,6,42529,563,41966,0.9867619741823227,20.466149333333334,2642.7065866666667,13.910314137276194,134,2.0E-5
7,test_20231031_155654,10863862.png,317432,6234,311198,0.9803611482144208,3,6,66058,916,65142,0.9861333979230373,36.010332444444444,6595.3394026666665,9.938432111883285,134,2.0E-5
8,test_20231031_155654,11382381.png,312486,777,311709,0.9975134886042895,2,5,46745,106,46639,0.9977323777944165,21.325146666666665,2490.063653333333,14.168699117890078,134,2.0E-5
9,test_20231031_155654,11079715.png,443815,96804,347011,0.7818820905106858,5,7,124136,13603,110533,0.8904185731778049,18.573955555555557,2560.8911893333334,14.046892349086676,134,2.0E-5
10,test_20231031_155654,11551286.png,271883,557,271326,0.9979513246506769,2,5,40092,80,40012,0.9980045894442782,17.47336888888889,1793.4866346666668,15.593822162719512,134,2.0E-5
1,test_20231031_155655,10404007.png,502730,12787,489943,0.9745648757782508,3,5,61265,1869,59396,0.9694931853423652,26.516264888888887,3659.1609973333334,12.496988426862345,134,3.0000000000000004E-5
2,test_20231031_155655,1254659.png,342646,57112,285534,0.8333206866561991,4,6,80080,8046,72034,0.8995254745254745,22.946245333333334,3855.036016,12.270519210290555,134,3.0000000000000004E-5
3,test_20231031_155655,10188041.png,221231,7542,213689,0.9659089368126529,3,6,41731,1070,40661,0.9743595887949007,12.04232,1422.4973813333334,16.60028885290102,134,3.0000000000000004E-5
4,test_20231031_155655,10287332.png,216980,10122,206858,0.9533505392202046,3,7,22337,1393,20944,0.9376371043560012,10.011550222222223,977.165808,18.231120986949595,134,3.0000000000000004E-5
5,test_20231031_155655,11610969.png,368720,18252,350468,0.9504990236493817,4,7,84111,2682,81429,0.968113564218711,23.600170666666667,3494.751157333333,12.696641034884948,134,3.0000000000000004E-5
6,test_20231031_155655,10350842.png,212614,3832,208782,0.9819767277789797,2,6,42529,563,41966,0.9867619741823227,20.466149333333334,2642.7065866666667,13.910314137276194,134,3.0000000000000004E-5
7,test_20231031_155655,10863862.png,317432,6234,311198,0.9803611482144208,3,5,66058,916,65142,0.9861333979230373,36.010332444444444,6595.3394026666665,9.938432111883285,134,3.0000000000000004E-5
8,test_20231031_155655,11382381.png,312486,777,311709,0.9975134886042895,3,6,46745,106,46639,0.9977323777944165,21.325146666666665,2490.063653333333,14.168699117890078,134,3.0000000000000004E-5
9,test_20231031_155655,11079715.png,443815,96804,347011,0.7818820905106858,5,6,124136,13603,110533,0.8904185731778049,18.573955555555557,2560.8911893333334,14.046892349086676,134,3.0000000000000004E-5
10,test_20231031_155655,11551286.png,271883,557,271326,0.9979513246506769,2,5,40092,80,40012,0.9980045894442782,17.47336888888889,1793.4866346666668,15.593822162719512,134,3.0000000000000004E-5
1,test_20231031_155656,10404007.png,502730,12787,489943,0.9745648757782508,3,5,61265,1869,59396,0.9694931853423652,26.516264888888887,3659.1609973333334,12.496988426862345,134,4.0E-5
2,test_20231031_155656,1254659.png,342646,57112,285534,0.8333206866561991,4,6,80080,8046,72034,0.8995254745254745,22.946245333333334,3855.036016,12.270519210290555,134,4.0E-5
3,test_20231031_155656,10188041.png,221231,7542,213689,0.9659089368126529,3,6,41731,1070,40661,0.9743595887949007,12.04232,1422.4973813333334,16.60028885290102,134,4.0E-5
4,test_20231031_155656,10287332.png,216980,10122,206858,0.9533505392202046,3,5,22337,1393,20944,0.9376371043560012,10.011550222222223,977.165808,18.231120986949595,134,4.0E-5
5,test_20231031_155656,11610969.png,368720,18252,350468,0.9504990236493817,3,5,84111,2682,81429,0.968113564218711,23.600170666666667,3494.751157333333,12.696641034884948,134,4.0E-5
6,test_20231031_155656,10350842.png,212614,3832,208782,0.9819767277789797,2,6,42529,563,41966,0.9867619741823227,20.466149333333334,2642.7065866666667,13.910314137276194,134,4.0E-5
7,test_20231031_155656,10863862.png,317432,6234,311198,0.9803611482144208,2,5,66058,916,65142,0.9861333979230373,36.010332444444444,6595.3394026666665,9.938432111883285,134,4.0E-5
8,test_20231031_155656,11382381.png,312486,777,311709,0.9975134886042895,3,6,46745,106,46639,0.9977323777944165,21.325146666666665,2490.063653333333,14.168699117890078,134,4.0E-5
9,test_20231031_155656,11079715.png,443815,96804,347011,0.7818820905106858,4,6,124136,13603,110533,0.8904185731778049,18.573955555555557,2560.8911893333334,14.046892349086676,134,4.0E-5
10,test_20231031_155656,11551286.png,271883,557,271326,0.9979513246506769,2,5,40092,80,40012,0.9980045894442782,17.47336888888889,1793.4866346666668,15.593822162719512,134,4.0E-5
1,test_20231031_155658,10404007.png,502730,12787,489943,0.9745648757782508,3,5,61265,1869,59396,0.9694931853423652,26.516264888888887,3659.1609973333334,12.496988426862345,134,5.0E-5
2,test_20231031_155658,1254659.png,342646,57112,285534,0.8333206866561991,4,6,80080,8046,72034,0.8995254745254745,22.946245333333334,3855.036016,12.270519210290555,134,5.0E-5
3,test_20231031_155658,10188041.png,221231,7542,213689,0.9659089368126529,3,14,41731,1070,40661,0.9743595887949007,12.04232,1422.4973813333334,16.60028885290102,134,5.0E-5
4,test_20231031_155658,10287332.png,216980,10122,206858,0.9533505392202046,2,5,22337,1393,20944,0.9376371043560012,10.011550222222223,977.165808,18.231120986949595,134,5.0E-5
5,test_20231031_155658,11610969.png,368720,18252,350468,0.9504990236493817,4,8,84111,2682,81429,0.968113564218711,23.600170666666667,3494.751157333333,12.696641034884948,134,5.0E-5
6,test_20231031_155658,10350842.png,212614,3832,208782,0.9819767277789797,2,5,42529,563,41966,0.9867619741823227,20.466149333333334,2642.7065866666667,13.910314137276194,134,5.0E-5
7,test_20231031_155658,10863862.png,317432,6234,311198,0.9803611482144208,3,6,66058,916,65142,0.9861333979230373,36.010332444444444,6595.3394026666665,9.938432111883285,134,5.0E-5
8,test_20231031_155658,11382381.png,312486,777,311709,0.9975134886042895,2,5,46745,106,46639,0.9977323777944165,21.325146666666665,2490.063653333333,14.168699117890078,134,5.0E-5
9,test_20231031_155658,11079715.png,443815,96804,347011,0.7818820905106858,5,6,124136,13603,110533,0.8904185731778049,18.573955555555557,2560.8911893333334,14.046892349086676,134,5.0E-5
10,test_20231031_155658,11551286.png,271883,557,271326,0.9979513246506769,2,5,40092,80,40012,0.9980045894442782,17.47336888888889,1793.4866346666668,15.593822162719512,134,5.0E-5
1,test_20231031_155659,10404007.png,502730,12787,489943,0.9745648757782508,3,6,61265,1869,59396,0.9694931853423652,26.516264888888887,3659.1609973333334,12.496988426862345,134,6.0E-5
2,test_20231031_155659,1254659.png,342646,57112,285534,0.8333206866561991,4,6,80080,8046,72034,0.8995254745254745,22.946245333333334,3855.036016,12.270519210290555,134,6.0E-5
3,test_20231031_155659,10188041.png,221231,7542,213689,0.9659089368126529,3,6,41731,1070,40661,0.9743595887949007,12.04232,1422.4973813333334,16.60028885290102,134,6.0E-5
4,test_20231031_155659,10287332.png,216980,10122,206858,0.9533505392202046,2,5,22337,1393,20944,0.9376371043560012,10.011550222222223,977.165808,18.231120986949595,134,6.0E-5
5,test_20231031_155659,11610969.png,368720,18252,350468,0.9504990236493817,3,5,84111,2682,81429,0.968113564218711,23.600170666666667,3494.751157333333,12.696641034884948,134,6.0E-5
6,test_20231031_155659,10350842.png,212614,3832,208782,0.9819767277789797,2,5,42529,563,41966,0.9867619741823227,20.466149333333334,2642.7065866666667,13.910314137276194,134,6.0E-5
7,test_20231031_155659,10863862.png,317432,6234,311198,0.9803611482144208,2,6,66058,916,65142,0.9861333979230373,36.010332444444444,6595.3394026666665,9.938432111883285,134,6.0E-5
8,test_20231031_155659,11382381.png,312486,777,311709,0.9975134886042895,2,5,46745,106,46639,0.9977323777944165,21.325146666666665,2490.063653333333,14.168699117890078,134,6.0E-5
9,test_20231031_155659,11079715.png,443815,96804,347011,0.7818820905106858,5,6,124136,13603,110533,0.8904185731778049,18.573955555555557,2560.8911893333334,14.046892349086676,134,6.0E-5
10,test_20231031_155659,11551286.png,271883,557,271326,0.9979513246506769,3,5,40092,80,40012,0.9980045894442782,17.47336888888889,1793.4866346666668,15.593822162719512,134,6.0E-5
1,test_20231031_155700,10404007.png,502730,12787,489943,0.9745648757782508,3,5,61265,1869,59396,0.9694931853423652,26.516264888888887,3659.1609973333334,12.496988426862345,134,7.000000000000001E-5
2,test_20231031_155700,1254659.png,342646,57112,285534,0.8333206866561991,12,6,80080,8046,72034,0.8995254745254745,22.946245333333334,3855.036016,12.270519210290555,134,7.000000000000001E-5
3,test_20231031_155700,10188041.png,221231,7542,213689,0.9659089368126529,3,5,41731,1070,40661,0.9743595887949007,12.04232,1422.4973813333334,16.60028885290102,134,7.000000000000001E-5
4,test_20231031_155700,10287332.png,216980,10122,206858,0.9533505392202046,3,5,22337,1393,20944,0.9376371043560012,10.011550222222223,977.165808,18.231120986949595,134,7.000000000000001E-5
5,test_20231031_155700,11610969.png,368720,18252,350468,0.9504990236493817,4,6,84111,2682,81429,0.968113564218711,23.600170666666667,3494.751157333333,12.696641034884948,134,7.000000000000001E-5
6,test_20231031_155700,10350842.png,212614,3712,208902,0.9825411308756714,2,6,42529,545,41984,0.9871852147946107,22.243114666666667,3134.937568,13.168514645506416,134,7.000000000000001E-5
7,test_20231031_155700,10863862.png,317432,6234,311198,0.9803611482144208,2,5,66058,916,65142,0.9861333979230373,36.010332444444444,6595.3394026666665,9.938432111883285,134,7.000000000000001E-5
8,test_20231031_155700,11382381.png,312486,777,311709,0.9975134886042895,3,5,46745,106,46639,0.9977323777944165,21.325146666666665,2490.063653333333,14.168699117890078,134,7.000000000000001E-5
9,test_20231031_155700,11079715.png,443815,96804,347011,0.7818820905106858,5,6,124136,13603,110533,0.8904185731778049,18.573955555555557,2560.8911893333334,14.046892349086676,134,7.000000000000001E-5
10,test_20231031_155700,11551286.png,271883,417,271466,0.9984662520275266,3,5,40092,59,40033,0.9985283847151551,17.799701333333335,1844.591488,15.471801606446313,134,7.000000000000001E-5
1,test_20231031_155701,10404007.png,502730,12787,489943,0.9745648757782508,4,6,61265,1869,59396,0.9694931853423652,26.516264888888887,3659.1609973333334,12.496988426862345,134,8.0E-5
2,test_20231031_155701,1254659.png,342646,57112,285534,0.8333206866561991,4,7,80080,8046,72034,0.8995254745254745,22.946245333333334,3855.036016,12.270519210290555,134,8.0E-5
3,test_20231031_155701,10188041.png,221231,7542,213689,0.9659089368126529,3,5,41731,1070,40661,0.9743595887949007,12.04232,1422.4973813333334,16.60028885290102,134,8.0E-5
4,test_20231031_155701,10287332.png,216980,10122,206858,0.9533505392202046,3,6,22337,1393,20944,0.9376371043560012,10.011550222222223,977.165808,18.231120986949595,134,8.0E-5
5,test_20231031_155701,11610969.png,368720,18252,350468,0.9504990236493817,3,5,84111,2682,81429,0.968113564218711,23.600170666666667,3494.751157333333,12.696641034884948,134,8.0E-5
6,test_20231031_155701,10350842.png,212614,3712,208902,0.9825411308756714,2,6,42529,545,41984,0.9871852147946107,22.243114666666667,3134.937568,13.168514645506416,134,8.0E-5
7,test_20231031_155701,10863862.png,317432,6234,311198,0.9803611482144208,3,6,66058,916,65142,0.9861333979230373,36.010332444444444,6595.3394026666665,9.938432111883285,134,8.0E-5
8,test_20231031_155701,11382381.png,312486,757,311729,0.9975774914716179,2,6,46745,103,46642,0.997796555781367,22.081843555555555,2635.736901333333,13.921783039602623,134,8.0E-5
9,test_20231031_155701,11079715.png,443815,96804,347011,0.7818820905106858,5,6,124136,13603,110533,0.8904185731778049,18.573955555555557,2560.8911893333334,14.046892349086676,134,8.0E-5
10,test_20231031_155701,11551286.png,271883,417,271466,0.9984662520275266,2,7,40092,59,40033,0.9985283847151551,17.799701333333335,1844.591488,15.471801606446313,134,8.0E-5
1,test_20231031_155702,10404007.png,502730,12787,489943,0.9745648757782508,3,6,61265,1869,59396,0.9694931853423652,26.516264888888887,3659.1609973333334,12.496988426862345,134,9.0E-5
2,test_20231031_155702,1254659.png,342646,57112,285534,0.8333206866561991,4,6,80080,8046,72034,0.8995254745254745,22.946245333333334,3855.036016,12.270519210290555,134,9.0E-5
3,test_20231031_155702,10188041.png,221231,7542,213689,0.9659089368126529,3,5,41731,1070,40661,0.9743595887949007,12.04232,1422.4973813333334,16.60028885290102,134,9.0E-5
4,test_20231031_155702,10287332.png,216980,10122,206858,0.9533505392202046,3,6,22337,1393,20944,0.9376371043560012,10.011550222222223,977.165808,18.231120986949595,134,9.0E-5
5,test_20231031_155702,11610969.png,368720,18252,350468,0.9504990236493817,4,6,84111,2682,81429,0.968113564218711,23.600170666666667,3494.751157333333,12.696641034884948,134,9.0E-5
6,test_20231031_155702,10350842.png,212614,3712,208902,0.9825411308756714,2,6,42529,545,41984,0.9871852147946107,22.243114666666667,3134.937568,13.168514645506416,134,9.0E-5
7,test_20231031_155702,10863862.png,317432,6234,311198,0.9803611482144208,2,5,66058,916,65142,0.9861333979230373,36.010332444444444,6595.3394026666665,9.938432111883285,134,9.0E-5
8,test_20231031_155702,11382381.png,312486,757,311729,0.9975774914716179,2,6,46745,103,46642,0.997796555781367,22.081843555555555,2635.736901333333,13.921783039602623,134,9.0E-5
9,test_20231031_155702,11079715.png,443815,96804,347011,0.7818820905106858,6,6,124136,13603,110533,0.8904185731778049,18.573955555555557,2560.8911893333334,14.046892349086676,134,9.0E-5
10,test_20231031_155702,11551286.png,271883,417,271466,0.9984662520275266,2,5,40092,59,40033,0.9985283847151551,17.799701333333335,1844.591488,15.471801606446313,134,9.0E-5
1,test_20231031_155703,10404007.png,502730,12787,489943,0.9745648757782508,3,5,61265,1869,59396,0.9694931853423652,26.516264888888887,3659.1609973333334,12.496988426862345,134,1.0E-4
2,test_20231031_155703,1254659.png,342646,57112,285534,0.8333206866561991,4,6,80080,8046,72034,0.8995254745254745,22.946245333333334,3855.036016,12.270519210290555,134,1.0E-4
3,test_20231031_155703,10188041.png,221231,7542,213689,0.9659089368126529,3,6,41731,1070,40661,0.9743595887949007,12.04232,1422.4973813333334,16.60028885290102,134,1.0E-4
4,test_20231031_155703,10287332.png,216980,10122,206858,0.9533505392202046,3,6,22337,1393,20944,0.9376371043560012,10.011550222222223,977.165808,18.231120986949595,134,1.0E-4
5,test_20231031_155703,11610969.png,368720,18252,350468,0.9504990236493817,4,6,84111,2682,81429,0.968113564218711,23.600170666666667,3494.751157333333,12.696641034884948,134,1.0E-4
6,test_20231031_155703,10350842.png,212614,3712,208902,0.9825411308756714,2,5,42529,545,41984,0.9871852147946107,22.243114666666667,3134.937568,13.168514645506416,134,1.0E-4
7,test_20231031_155703,10863862.png,317432,6234,311198,0.9803611482144208,3,6,66058,916,65142,0.9861333979230373,36.010332444444444,6595.3394026666665,9.938432111883285,134,1.0E-4
8,test_20231031_155703,11382381.png,312486,757,311729,0.9975774914716179,2,6,46745,103,46642,0.997796555781367,22.081843555555555,2635.736901333333,13.921783039602623,134,1.0E-4
9,test_20231031_155703,11079715.png,443815,96804,347011,0.7818820905106858,5,9,124136,13603,110533,0.8904185731778049,18.573955555555557,2560.8911893333334,14.046892349086676,134,1.0E-4
10,test_20231031_155703,11551286.png,271883,417,271466,0.9984662520275266,2,6,40092,59,40033,0.9985283847151551,17.799701333333335,1844.591488,15.471801606446313,134,1.0E-4
1,test_20231031_155704,10404007.png,502730,12787,489943,0.9745648757782508,3,6,61265,1869,59396,0.9694931853423652,26.516264888888887,3659.1609973333334,12.496988426862345,134,1.1E-4
2,test_20231031_155704,1254659.png,342646,57112,285534,0.8333206866561991,4,6,80080,8046,72034,0.8995254745254745,22.946245333333334,3855.036016,12.270519210290555,134,1.1E-4
3,test_20231031_155704,10188041.png,221231,7542,213689,0.9659089368126529,3,6,41731,1070,40661,0.9743595887949007,12.04232,1422.4973813333334,16.60028885290102,134,1.1E-4
4,test_20231031_155704,10287332.png,216980,10122,206858,0.9533505392202046,3,6,22337,1393,20944,0.9376371043560012,10.011550222222223,977.165808,18.231120986949595,134,1.1E-4
5,test_20231031_155704,11610969.png,368720,18252,350468,0.9504990236493817,4,6,84111,2682,81429,0.968113564218711,23.600170666666667,3494.751157333333,12.696641034884948,134,1.1E-4
6,test_20231031_155704,10350842.png,212614,3712,208902,0.9825411308756714,2,5,42529,545,41984,0.9871852147946107,22.243114666666667,3134.937568,13.168514645506416,134,1.1E-4
7,test_20231031_155704,10863862.png,317432,6234,311198,0.9803611482144208,3,6,66058,916,65142,0.9861333979230373,36.010332444444444,6595.3394026666665,9.938432111883285,134,1.1E-4
8,test_20231031_155704,11382381.png,312486,757,311729,0.9975774914716179,2,5,46745,103,46642,0.997796555781367,22.081843555555555,2635.736901333333,13.921783039602623,134,1.1E-4
9,test_20231031_155704,11079715.png,443815,96804,347011,0.7818820905106858,5,7,124136,13603,110533,0.8904185731778049,18.573955555555557,2560.8911893333334,14.046892349086676,134,1.1E-4
10,test_20231031_155704,11551286.png,271883,417,271466,0.9984662520275266,2,6,40092,59,40033,0.9985283847151551,17.799701333333335,1844.591488,15.471801606446313,134,1.1E-4
1,test_20231031_155705,10404007.png,502730,12787,489943,0.9745648757782508,3,5,61265,1869,59396,0.9694931853423652,26.516264888888887,3659.1609973333334,12.496988426862345,134,1.2E-4
2,test_20231031_155705,1254659.png,342646,57112,285534,0.8333206866561991,4,6,80080,8046,72034,0.8995254745254745,22.946245333333334,3855.036016,12.270519210290555,134,1.2E-4
3,test_20231031_155705,10188041.png,221231,7542,213689,0.9659089368126529,3,6,41731,1070,40661,0.9743595887949007,12.04232,1422.4973813333334,16.60028885290102,134,1.2E-4
4,test_20231031_155705,10287332.png,216980,10122,206858,0.9533505392202046,3,6,22337,1393,20944,0.9376371043560012,10.011550222222223,977.165808,18.231120986949595,134,1.2E-4
5,test_20231031_155705,11610969.png,368720,18252,350468,0.9504990236493817,3,6,84111,2682,81429,0.968113564218711,23.600170666666667,3494.751157333333,12.696641034884948,134,1.2E-4
6,test_20231031_155705,10350842.png,212614,3712,208902,0.9825411308756714,2,6,42529,545,41984,0.9871852147946107,22.243114666666667,3134.937568,13.168514645506416,134,1.2E-4
7,test_20231031_155705,10863862.png,317432,6234,311198,0.9803611482144208,2,5,66058,916,65142,0.9861333979230373,36.010332444444444,6595.3394026666665,9.938432111883285,134,1.2E-4
8,test_20231031_155705,11382381.png,312486,757,311729,0.9975774914716179,3,6,46745,103,46642,0.997796555781367,22.081843555555555,2635.736901333333,13.921783039602623,134,1.2E-4
9,test_20231031_155705,11079715.png,443815,96804,347011,0.7818820905106858,11,7,124136,13603,110533,0.8904185731778049,18.573955555555557,2560.8911893333334,14.046892349086676,134,1.2E-4
10,test_20231031_155705,11551286.png,271883,417,271466,0.9984662520275266,2,6,40092,59,40033,0.9985283847151551,17.799701333333335,1844.591488,15.471801606446313,134,1.2E-4
1,test_20231031_155706,10404007.png,502730,12787,489943,0.9745648757782508,3,6,61265,1869,59396,0.9694931853423652,26.516264888888887,3659.1609973333334,12.496988426862345,134,1.3000000000000002E-4
2,test_20231031_155706,1254659.png,342646,57112,285534,0.8333206866561991,4,6,80080,8046,72034,0.8995254745254745,22.946245333333334,3855.036016,12.270519210290555,134,1.3000000000000002E-4
3,test_20231031_155706,10188041.png,221231,7542,213689,0.9659089368126529,3,6,41731,1070,40661,0.9743595887949007,12.04232,1422.4973813333334,16.60028885290102,134,1.3000000000000002E-4
4,test_20231031_155706,10287332.png,216980,10122,206858,0.9533505392202046,3,5,22337,1393,20944,0.9376371043560012,10.011550222222223,977.165808,18.231120986949595,134,1.3000000000000002E-4
5,test_20231031_155706,11610969.png,368720,18252,350468,0.9504990236493817,4,6,84111,2682,81429,0.968113564218711,23.600170666666667,3494.751157333333,12.696641034884948,134,1.3000000000000002E-4
6,test_20231031_155706,10350842.png,212614,3712,208902,0.9825411308756714,2,6,42529,545,41984,0.9871852147946107,22.243114666666667,3134.937568,13.168514645506416,134,1.3000000000000002E-4
7,test_20231031_155706,10863862.png,317432,6234,311198,0.9803611482144208,2,5,66058,916,65142,0.9861333979230373,36.010332444444444,6595.3394026666665,9.938432111883285,134,1.3000000000000002E-4
8,test_20231031_155706,11382381.png,312486,647,311839,0.9979295072419244,2,5,46745,87,46658,0.9981388383784362,22.33832177777778,2675.8690666666666,13.85615501777858,134,1.3000000000000002E-4
9,test_20231031_155706,11079715.png,443815,96804,347011,0.7818820905106858,6,6,124136,13603,110533,0.8904185731778049,18.573955555555557,2560.8911893333334,14.046892349086676,134,1.3000000000000002E-4
10,test_20231031_155706,11551286.png,271883,417,271466,0.9984662520275266,2,5,40092,59,40033,0.9985283847151551,17.799701333333335,1844.591488,15.471801606446313,134,1.3000000000000002E-4
1,test_20231031_155707,10404007.png,502730,12787,489943,0.9745648757782508,3,5,61265,1869,59396,0.9694931853423652,26.516264888888887,3659.1609973333334,12.496988426862345,134,1.4000000000000001E-4
2,test_20231031_155707,1254659.png,342646,57112,285534,0.8333206866561991,4,6,80080,8046,72034,0.8995254745254745,22.946245333333334,3855.036016,12.270519210290555,134,1.4000000000000001E-4
3,test_20231031_155707,10188041.png,221231,7542,213689,0.9659089368126529,3,6,41731,1070,40661,0.9743595887949007,12.04232,1422.4973813333334,16.60028885290102,134,1.4000000000000001E-4
4,test_20231031_155707,10287332.png,216980,10122,206858,0.9533505392202046,2,6,22337,1393,20944,0.9376371043560012,10.011550222222223,977.165808,18.231120986949595,134,1.4000000000000001E-4
5,test_20231031_155707,11610969.png,368720,18252,350468,0.9504990236493817,3,6,84111,2682,81429,0.968113564218711,23.600170666666667,3494.751157333333,12.696641034884948,134,1.4000000000000001E-4
6,test_20231031_155707,10350842.png,212614,3712,208902,0.9825411308756714,2,6,42529,545,41984,0.9871852147946107,22.243114666666667,3134.937568,13.168514645506416,134,1.4000000000000001E-4
7,test_20231031_155707,10863862.png,317432,6234,311198,0.9803611482144208,2,6,66058,916,65142,0.9861333979230373,36.010332444444444,6595.3394026666665,9.938432111883285,134,1.4000000000000001E-4
8,test_20231031_155707,11382381.png,312486,647,311839,0.9979295072419244,2,5,46745,87,46658,0.9981388383784362,22.33832177777778,2675.8690666666666,13.85615501777858,134,1.4000000000000001E-4
9,test_20231031_155707,11079715.png,443815,96804,347011,0.7818820905106858,5,7,124136,13603,110533,0.8904185731778049,18.573955555555557,2560.8911893333334,14.046892349086676,134,1.4000000000000001E-4
10,test_20231031_155707,11551286.png,271883,417,271466,0.9984662520275266,2,5,40092,59,40033,0.9985283847151551,17.799701333333335,1844.591488,15.471801606446313,134,1.4000000000000001E-4
1,test_20231031_155708,10404007.png,502730,12787,489943,0.9745648757782508,3,5,61265,1869,59396,0.9694931853423652,26.516264888888887,3659.1609973333334,12.496988426862345,134,1.5000000000000001E-4
2,test_20231031_155708,1254659.png,342646,57112,285534,0.8333206866561991,4,7,80080,8046,72034,0.8995254745254745,22.946245333333334,3855.036016,12.270519210290555,134,1.5000000000000001E-4
3,test_20231031_155708,10188041.png,221231,7542,213689,0.9659089368126529,3,6,41731,1070,40661,0.9743595887949007,12.04232,1422.4973813333334,16.60028885290102,134,1.5000000000000001E-4
4,test_20231031_155708,10287332.png,216980,10122,206858,0.9533505392202046,3,6,22337,1393,20944,0.9376371043560012,10.011550222222223,977.165808,18.231120986949595,134,1.5000000000000001E-4
5,test_20231031_155708,11610969.png,368720,18252,350468,0.9504990236493817,4,6,84111,2682,81429,0.968113564218711,23.600170666666667,3494.751157333333,12.696641034884948,134,1.5000000000000001E-4
6,test_20231031_155708,10350842.png,212614,3712,208902,0.9825411308756714,3,6,42529,545,41984,0.9871852147946107,22.243114666666667,3134.937568,13.168514645506416,134,1.5000000000000001E-4
7,test_20231031_155708,10863862.png,317432,6234,311198,0.9803611482144208,2,6,66058,916,65142,0.9861333979230373,36.010332444444444,6595.3394026666665,9.938432111883285,134,1.5000000000000001E-4
8,test_20231031_155708,11382381.png,312486,647,311839,0.9979295072419244,2,6,46745,87,46658,0.9981388383784362,22.33832177777778,2675.8690666666666,13.85615501777858,134,1.5000000000000001E-4
9,test_20231031_155708,11079715.png,443815,96804,347011,0.7818820905106858,5,6,124136,13603,110533,0.8904185731778049,18.573955555555557,2560.8911893333334,14.046892349086676,134,1.5000000000000001E-4
10,test_20231031_155708,11551286.png,271883,417,271466,0.9984662520275266,3,5,40092,59,40033,0.9985283847151551,17.799701333333335,1844.591488,15.471801606446313,134,1.5000000000000001E-4
1,test_20231031_155709,10404007.png,502730,12787,489943,0.9745648757782508,3,5,61265,1869,59396,0.9694931853423652,26.516264888888887,3659.1609973333334,12.496988426862345,134,1.6E-4
2,test_20231031_155709,1254659.png,342646,57112,285534,0.8333206866561991,5,6,80080,8046,72034,0.8995254745254745,22.946245333333334,3855.036016,12.270519210290555,134,1.6E-4
3,test_20231031_155709,10188041.png,221231,7542,213689,0.9659089368126529,3,6,41731,1070,40661,0.9743595887949007,12.04232,1422.4973813333334,16.60028885290102,134,1.6E-4
4,test_20231031_155709,10287332.png,216980,9932,207048,0.9542261959627616,3,6,22337,1369,20968,0.938711554819358,10.139925333333334,1003.4804586666667,18.11571441220159,134,1.6E-4
5,test_20231031_155709,11610969.png,368720,18252,350468,0.9504990236493817,3,11,84111,2682,81429,0.968113564218711,23.600170666666667,3494.751157333333,12.696641034884948,134,1.6E-4
6,test_20231031_155709,10350842.png,212614,3712,208902,0.9825411308756714,2,6,42529,545,41984,0.9871852147946107,22.243114666666667,3134.937568,13.168514645506416,134,1.6E-4
7,test_20231031_155709,10863862.png,317432,6234,311198,0.9803611482144208,2,5,66058,916,65142,0.9861333979230373,36.010332444444444,6595.3394026666665,9.938432111883285,134,1.6E-4
8,test_20231031_155709,11382381.png,312486,647,311839,0.9979295072419244,2,6,46745,87,46658,0.9981388383784362,22.33832177777778,2675.8690666666666,13.85615501777858,134,1.6E-4
9,test_20231031_155709,11079715.png,443815,96804,347011,0.7818820905106858,5,6,124136,13603,110533,0.8904185731778049,18.573955555555557,2560.8911893333334,14.046892349086676,134,1.6E-4
10,test_20231031_155709,11551286.png,271883,417,271466,0.9984662520275266,2,5,40092,59,40033,0.9985283847151551,17.799701333333335,1844.591488,15.471801606446313,134,1.6E-4
1,test_20231031_155710,10404007.png,502730,12787,489943,0.9745648757782508,3,6,61265,1869,59396,0.9694931853423652,26.516264888888887,3659.1609973333334,12.496988426862345,134,1.7E-4
2,test_20231031_155710,1254659.png,342646,57112,285534,0.8333206866561991,4,6,80080,8046,72034,0.8995254745254745,22.946245333333334,3855.036016,12.270519210290555,134,1.7E-4
3,test_20231031_155710,10188041.png,221231,7542,213689,0.9659089368126529,3,6,41731,1070,40661,0.9743595887949007,12.04232,1422.4973813333334,16.60028885290102,134,1.7E-4
4,test_20231031_155710,10287332.png,216980,9932,207048,0.9542261959627616,2,5,22337,1369,20968,0.938711554819358,10.139925333333334,1003.4804586666667,18.11571441220159,134,1.7E-4
5,test_20231031_155710,11610969.png,368720,18252,350468,0.9504990236493817,4,6,84111,2682,81429,0.968113564218711,23.600170666666667,3494.751157333333,12.696641034884948,134,1.7E-4
6,test_20231031_155710,10350842.png,212614,3712,208902,0.9825411308756714,3,6,42529,545,41984,0.9871852147946107,22.243114666666667,3134.937568,13.168514645506416,134,1.7E-4
7,test_20231031_155710,10863862.png,317432,6234,311198,0.9803611482144208,3,6,66058,916,65142,0.9861333979230373,36.010332444444444,6595.3394026666665,9.938432111883285,134,1.7E-4
8,test_20231031_155710,11382381.png,312486,647,311839,0.9979295072419244,3,6,46745,87,46658,0.9981388383784362,22.33832177777778,2675.8690666666666,13.85615501777858,134,1.7E-4
9,test_20231031_155710,11079715.png,443815,96804,347011,0.7818820905106858,6,6,124136,13603,110533,0.8904185731778049,18.573955555555557,2560.8911893333334,14.046892349086676,134,1.7E-4
10,test_20231031_155710,11551286.png,271883,417,271466,0.9984662520275266,3,5,40092,59,40033,0.9985283847151551,17.799701333333335,1844.591488,15.471801606446313,134,1.7E-4
1,test_20231031_155711,10404007.png,502730,12787,489943,0.9745648757782508,4,17,61265,1869,59396,0.9694931853423652,26.516264888888887,3659.1609973333334,12.496988426862345,134,1.8E-4
2,test_20231031_155711,1254659.png,342646,57112,285534,0.8333206866561991,5,6,80080,8046,72034,0.8995254745254745,22.946245333333334,3855.036016,12.270519210290555,134,1.8E-4
3,test_20231031_155711,10188041.png,221231,7542,213689,0.9659089368126529,3,5,41731,1070,40661,0.9743595887949007,12.04232,1422.4973813333334,16.60028885290102,134,1.8E-4
4,test_20231031_155711,10287332.png,216980,9932,207048,0.9542261959627616,3,7,22337,1369,20968,0.938711554819358,10.139925333333334,1003.4804586666667,18.11571441220159,134,1.8E-4
5,test_20231031_155711,11610969.png,368720,18252,350468,0.9504990236493817,4,6,84111,2682,81429,0.968113564218711,23.600170666666667,3494.751157333333,12.696641034884948,134,1.8E-4
6,test_20231031_155711,10350842.png,212614,3712,208902,0.9825411308756714,3,6,42529,545,41984,0.9871852147946107,22.243114666666667,3134.937568,13.168514645506416,134,1.8E-4
7,test_20231031_155711,10863862.png,317432,6234,311198,0.9803611482144208,2,5,66058,916,65142,0.9861333979230373,36.010332444444444,6595.3394026666665,9.938432111883285,134,1.8E-4
8,test_20231031_155711,11382381.png,312486,647,311839,0.9979295072419244,3,6,46745,87,46658,0.9981388383784362,22.33832177777778,2675.8690666666666,13.85615501777858,134,1.8E-4
9,test_20231031_155711,11079715.png,443815,96804,347011,0.7818820905106858,7,7,124136,13603,110533,0.8904185731778049,18.573955555555557,2560.8911893333334,14.046892349086676,134,1.8E-4
10,test_20231031_155711,11551286.png,271883,204,271679,0.9992496772508763,3,6,40092,28,40064,0.9993016063054974,18.067507555555554,1885.468496,15.37661080624634,134,1.8E-4
1,test_20231031_155712,10404007.png,502730,12787,489943,0.9745648757782508,4,6,61265,1869,59396,0.9694931853423652,26.516264888888887,3659.1609973333334,12.496988426862345,134,1.9E-4
2,test_20231031_155712,1254659.png,342646,57112,285534,0.8333206866561991,5,6,80080,8046,72034,0.8995254745254745,22.946245333333334,3855.036016,12.270519210290555,134,1.9E-4
3,test_20231031_155712,10188041.png,221231,7542,213689,0.9659089368126529,3,6,41731,1070,40661,0.9743595887949007,12.04232,1422.4973813333334,16.60028885290102,134,1.9E-4
4,test_20231031_155712,10287332.png,216980,9932,207048,0.9542261959627616,2,6,22337,1369,20968,0.938711554819358,10.139925333333334,1003.4804586666667,18.11571441220159,134,1.9E-4
5,test_20231031_155712,11610969.png,368720,18252,350468,0.9504990236493817,3,5,84111,2682,81429,0.968113564218711,23.600170666666667,3494.751157333333,12.696641034884948,134,1.9E-4
6,test_20231031_155712,10350842.png,212614,3712,208902,0.9825411308756714,2,5,42529,545,41984,0.9871852147946107,22.243114666666667,3134.937568,13.168514645506416,134,1.9E-4
7,test_20231031_155712,10863862.png,317432,6234,311198,0.9803611482144208,2,5,66058,916,65142,0.9861333979230373,36.010332444444444,6595.3394026666665,9.938432111883285,134,1.9E-4
8,test_20231031_155712,11382381.png,312486,647,311839,0.9979295072419244,2,6,46745,87,46658,0.9981388383784362,22.33832177777778,2675.8690666666666,13.85615501777858,134,1.9E-4
9,test_20231031_155712,11079715.png,443815,96804,347011,0.7818820905106858,5,7,124136,13603,110533,0.8904185731778049,18.573955555555557,2560.8911893333334,14.046892349086676,134,1.9E-4
10,test_20231031_155712,11551286.png,271883,204,271679,0.9992496772508763,3,5,40092,28,40064,0.9993016063054974,18.067507555555554,1885.468496,15.37661080624634,134,1.9E-4
1,test_20231031_155713,10404007.png,502730,12787,489943,0.9745648757782508,3,6,61265,1869,59396,0.9694931853423652,26.516264888888887,3659.1609973333334,12.496988426862345,134,2.0E-4
2,test_20231031_155713,1254659.png,342646,57112,285534,0.8333206866561991,4,6,80080,8046,72034,0.8995254745254745,22.946245333333334,3855.036016,12.270519210290555,134,2.0E-4
3,test_20231031_155713,10188041.png,221231,7542,213689,0.9659089368126529,3,5,41731,1070,40661,0.9743595887949007,12.04232,1422.4973813333334,16.60028885290102,134,2.0E-4
4,test_20231031_155713,10287332.png,216980,9932,207048,0.9542261959627616,2,5,22337,1369,20968,0.938711554819358,10.139925333333334,1003.4804586666667,18.11571441220159,134,2.0E-4
5,test_20231031_155713,11610969.png,368720,18252,350468,0.9504990236493817,4,6,84111,2682,81429,0.968113564218711,23.600170666666667,3494.751157333333,12.696641034884948,134,2.0E-4
6,test_20231031_155713,10350842.png,212614,3712,208902,0.9825411308756714,2,6,42529,545,41984,0.9871852147946107,22.243114666666667,3134.937568,13.168514645506416,134,2.0E-4
7,test_20231031_155713,10863862.png,317432,6234,311198,0.9803611482144208,2,5,66058,916,65142,0.9861333979230373,36.010332444444444,6595.3394026666665,9.938432111883285,134,2.0E-4
8,test_20231031_155713,11382381.png,312486,647,311839,0.9979295072419244,2,6,46745,87,46658,0.9981388383784362,22.33832177777778,2675.8690666666666,13.85615501777858,134,2.0E-4
9,test_20231031_155713,11079715.png,443815,96804,347011,0.7818820905106858,5,6,124136,13603,110533,0.8904185731778049,18.573955555555557,2560.8911893333334,14.046892349086676,134,2.0E-4
10,test_20231031_155713,11551286.png,271883,204,271679,0.9992496772508763,2,6,40092,28,40064,0.9993016063054974,18.067507555555554,1885.468496,15.37661080624634,134,2.0E-4
1,test_20231031_155714,10404007.png,502730,12787,489943,0.9745648757782508,3,6,61265,1869,59396,0.9694931853423652,26.516264888888887,3659.1609973333334,12.496988426862345,134,2.1E-4
2,test_20231031_155714,1254659.png,342646,57112,285534,0.8333206866561991,4,6,80080,8046,72034,0.8995254745254745,22.946245333333334,3855.036016,12.270519210290555,134,2.1E-4
3,test_20231031_155714,10188041.png,221231,7542,213689,0.9659089368126529,3,6,41731,1070,40661,0.9743595887949007,12.04232,1422.4973813333334,16.60028885290102,134,2.1E-4
4,test_20231031_155714,10287332.png,216980,9932,207048,0.9542261959627616,3,6,22337,1369,20968,0.938711554819358,10.139925333333334,1003.4804586666667,18.11571441220159,134,2.1E-4
5,test_20231031_155714,11610969.png,368720,18252,350468,0.9504990236493817,4,6,84111,2682,81429,0.968113564218711,23.600170666666667,3494.751157333333,12.696641034884948,134,2.1E-4
6,test_20231031_155714,10350842.png,212614,3712,208902,0.9825411308756714,2,6,42529,545,41984,0.9871852147946107,22.243114666666667,3134.937568,13.168514645506416,134,2.1E-4
7,test_20231031_155714,10863862.png,317432,6234,311198,0.9803611482144208,2,9,66058,916,65142,0.9861333979230373,36.010332444444444,6595.3394026666665,9.938432111883285,134,2.1E-4
8,test_20231031_155714,11382381.png,312486,647,311839,0.9979295072419244,2,5,46745,87,46658,0.9981388383784362,22.33832177777778,2675.8690666666666,13.85615501777858,134,2.1E-4
9,test_20231031_155714,11079715.png,443815,96804,347011,0.7818820905106858,5,7,124136,13603,110533,0.8904185731778049,18.573955555555557,2560.8911893333334,14.046892349086676,134,2.1E-4
10,test_20231031_155714,11551286.png,271883,204,271679,0.9992496772508763,2,5,40092,28,40064,0.9993016063054974,18.067507555555554,1885.468496,15.37661080624634,134,2.1E-4
1,test_20231031_155715,10404007.png,502730,12787,489943,0.9745648757782508,3,13,61265,1869,59396,0.9694931853423652,26.516264888888887,3659.1609973333334,12.496988426862345,134,2.2E-4
2,test_20231031_155715,1254659.png,342646,57112,285534,0.8333206866561991,5,6,80080,8046,72034,0.8995254745254745,22.946245333333334,3855.036016,12.270519210290555,134,2.2E-4
3,test_20231031_155715,10188041.png,221231,7542,213689,0.9659089368126529,3,6,41731,1070,40661,0.9743595887949007,12.04232,1422.4973813333334,16.60028885290102,134,2.2E-4
4,test_20231031_155715,10287332.png,216980,9932,207048,0.9542261959627616,2,7,22337,1369,20968,0.938711554819358,10.139925333333334,1003.4804586666667,18.11571441220159,134,2.2E-4
5,test_20231031_155715,11610969.png,368720,18252,350468,0.9504990236493817,3,5,84111,2682,81429,0.968113564218711,23.600170666666667,3494.751157333333,12.696641034884948,134,2.2E-4
6,test_20231031_155715,10350842.png,212614,3712,208902,0.9825411308756714,3,6,42529,545,41984,0.9871852147946107,22.243114666666667,3134.937568,13.168514645506416,134,2.2E-4
7,test_20231031_155715,10863862.png,317432,6234,311198,0.9803611482144208,3,6,66058,916,65142,0.9861333979230373,36.010332444444444,6595.3394026666665,9.938432111883285,134,2.2E-4
8,test_20231031_155715,11382381.png,312486,647,311839,0.9979295072419244,2,5,46745,87,46658,0.9981388383784362,22.33832177777778,2675.8690666666666,13.85615501777858,134,2.2E-4
9,test_20231031_155715,11079715.png,443815,96804,347011,0.7818820905106858,7,6,124136,13603,110533,0.8904185731778049,18.573955555555557,2560.8911893333334,14.046892349086676,134,2.2E-4
10,test_20231031_155715,11551286.png,271883,204,271679,0.9992496772508763,2,6,40092,28,40064,0.9993016063054974,18.067507555555554,1885.468496,15.37661080624634,134,2.2E-4
1,test_20231031_155716,10404007.png,502730,12787,489943,0.9745648757782508,3,6,61265,1869,59396,0.9694931853423652,26.516264888888887,3659.1609973333334,12.496988426862345,134,2.3E-4
2,test_20231031_155716,1254659.png,342646,57112,285534,0.8333206866561991,4,6,80080,8046,72034,0.8995254745254745,22.946245333333334,3855.036016,12.270519210290555,134,2.3E-4
3,test_20231031_155716,10188041.png,221231,7542,213689,0.9659089368126529,3,6,41731,1070,40661,0.9743595887949007,12.04232,1422.4973813333334,16.60028885290102,134,2.3E-4
4,test_20231031_155716,10287332.png,216980,9932,207048,0.9542261959627616,3,6,22337,1369,20968,0.938711554819358,10.139925333333334,1003.4804586666667,18.11571441220159,134,2.3E-4
5,test_20231031_155716,11610969.png,368720,18252,350468,0.9504990236493817,4,6,84111,2682,81429,0.968113564218711,23.600170666666667,3494.751157333333,12.696641034884948,134,2.3E-4
6,test_20231031_155716,10350842.png,212614,3712,208902,0.9825411308756714,2,6,42529,545,41984,0.9871852147946107,22.243114666666667,3134.937568,13.168514645506416,134,2.3E-4
7,test_20231031_155716,10863862.png,317432,6234,311198,0.9803611482144208,3,6,66058,916,65142,0.9861333979230373,36.010332444444444,6595.3394026666665,9.938432111883285,134,2.3E-4
8,test_20231031_155716,11382381.png,312486,647,311839,0.9979295072419244,2,6,46745,87,46658,0.9981388383784362,22.33832177777778,2675.8690666666666,13.85615501777858,134,2.3E-4
9,test_20231031_155716,11079715.png,443815,96804,347011,0.7818820905106858,5,7,124136,13603,110533,0.8904185731778049,18.573955555555557,2560.8911893333334,14.046892349086676,134,2.3E-4
10,test_20231031_155716,11551286.png,271883,204,271679,0.9992496772508763,2,5,40092,28,40064,0.9993016063054974,18.067507555555554,1885.468496,15.37661080624634,134,2.3E-4
1,test_20231031_155717,10404007.png,502730,12787,489943,0.9745648757782508,4,5,61265,1869,59396,0.9694931853423652,26.516264888888887,3659.1609973333334,12.496988426862345,134,2.4E-4
2,test_20231031_155717,1254659.png,342646,57112,285534,0.8333206866561991,4,6,80080,8046,72034,0.8995254745254745,22.946245333333334,3855.036016,12.270519210290555,134,2.4E-4
3,test_20231031_155717,10188041.png,221231,7542,213689,0.9659089368126529,3,5,41731,1070,40661,0.9743595887949007,12.04232,1422.4973813333334,16.60028885290102,134,2.4E-4
4,test_20231031_155717,10287332.png,216980,9932,207048,0.9542261959627616,3,5,22337,1369,20968,0.938711554819358,10.139925333333334,1003.4804586666667,18.11571441220159,134,2.4E-4
5,test_20231031_155717,11610969.png,368720,18252,350468,0.9504990236493817,3,5,84111,2682,81429,0.968113564218711,23.600170666666667,3494.751157333333,12.696641034884948,134,2.4E-4
6,test_20231031_155717,10350842.png,212614,3712,208902,0.9825411308756714,2,5,42529,545,41984,0.9871852147946107,22.243114666666667,3134.937568,13.168514645506416,134,2.4E-4
7,test_20231031_155717,10863862.png,317432,6234,311198,0.9803611482144208,3,6,66058,916,65142,0.9861333979230373,36.010332444444444,6595.3394026666665,9.938432111883285,134,2.4E-4
8,test_20231031_155717,11382381.png,312486,647,311839,0.9979295072419244,2,5,46745,87,46658,0.9981388383784362,22.33832177777778,2675.8690666666666,13.85615501777858,134,2.4E-4
9,test_20231031_155717,11079715.png,443815,96804,347011,0.7818820905106858,5,7,124136,13603,110533,0.8904185731778049,18.573955555555557,2560.8911893333334,14.046892349086676,134,2.4E-4
10,test_20231031_155717,11551286.png,271883,204,271679,0.9992496772508763,2,5,40092,28,40064,0.9993016063054974,18.067507555555554,1885.468496,15.37661080624634,134,2.4E-4
1,test_20231031_155718,10404007.png,502730,12787,489943,0.9745648757782508,4,6,61265,1869,59396,0.9694931853423652,26.516264888888887,3659.1609973333334,12.496988426862345,134,2.5E-4
2,test_20231031_155718,1254659.png,342646,57112,285534,0.8333206866561991,4,6,80080,8046,72034,0.8995254745254745,22.946245333333334,3855.036016,12.270519210290555,134,2.5E-4
3,test_20231031_155718,10188041.png,221231,7542,213689,0.9659089368126529,3,6,41731,1070,40661,0.9743595887949007,12.04232,1422.4973813333334,16.60028885290102,134,2.5E-4
4,test_20231031_155718,10287332.png,216980,9932,207048,0.9542261959627616,2,5,22337,1369,20968,0.938711554819358,10.139925333333334,1003.4804586666667,18.11571441220159,134,2.5E-4
5,test_20231031_155718,11610969.png,368720,18252,350468,0.9504990236493817,4,6,84111,2682,81429,0.968113564218711,23.600170666666667,3494.751157333333,12.696641034884948,134,2.5E-4
6,test_20231031_155718,10350842.png,212614,3712,208902,0.9825411308756714,2,5,42529,545,41984,0.9871852147946107,22.243114666666667,3134.937568,13.168514645506416,134,2.5E-4
7,test_20231031_155718,10863862.png,317432,6234,311198,0.9803611482144208,3,6,66058,916,65142,0.9861333979230373,36.010332444444444,6595.3394026666665,9.938432111883285,134,2.5E-4
8,test_20231031_155718,11382381.png,312486,647,311839,0.9979295072419244,2,5,46745,87,46658,0.9981388383784362,22.33832177777778,2675.8690666666666,13.85615501777858,134,2.5E-4
9,test_20231031_155718,11079715.png,443815,96804,347011,0.7818820905106858,5,6,124136,13603,110533,0.8904185731778049,18.573955555555557,2560.8911893333334,14.046892349086676,134,2.5E-4
10,test_20231031_155718,11551286.png,271883,204,271679,0.9992496772508763,2,6,40092,28,40064,0.9993016063054974,18.067507555555554,1885.468496,15.37661080624634,134,2.5E-4
1,test_20231031_155719,10404007.png,502730,12687,490043,0.9747637897081932,3,6,61265,1854,59411,0.9697380233412226,26.522814222222223,3660.292986666667,12.495645111565782,134,2.6000000000000003E-4
2,test_20231031_155719,1254659.png,342646,57052,285594,0.8334957944934422,4,6,80080,8040,72040,0.8996003996003996,22.955799111111112,3856.1182026666665,12.269300228832059,134,2.6000000000000003E-4
3,test_20231031_155719,10188041.png,221231,7482,213749,0.966180146543658,3,6,41731,1062,40669,0.9745512928039107,12.276314666666666,1446.37864,16.52798361314215,134,2.6000000000000003E-4
4,test_20231031_155719,10287332.png,216980,9932,207048,0.9542261959627616,3,15,22337,1369,20968,0.938711554819358,10.139925333333334,1003.4804586666667,18.11571441220159,134,2.6000000000000003E-4
5,test_20231031_155719,11610969.png,368720,18132,350588,0.9508244738555001,3,5,84111,2667,81444,0.9682918999892999,24.015946666666668,3561.74064,12.614180691875706,134,2.6000000000000003E-4
6,test_20231031_155719,10350842.png,212614,3632,208982,0.9829173996067991,2,6,42529,533,41996,0.9874673752028028,22.303296,3145.339712,13.154128026352721,134,2.6000000000000003E-4
7,test_20231031_155719,10863862.png,317432,6032,311400,0.980997504977444,3,6,66058,887,65171,0.9865724060673953,36.62354311111111,6752.591344,9.836098931580938,134,2.6000000000000003E-4
8,test_20231031_155719,11382381.png,312486,527,311959,0.9983135244458952,2,5,46745,69,46676,0.9985239063001391,22.832848,2745.811376,13.744096608790418,134,2.6000000000000003E-4
9,test_20231031_155719,11079715.png,443815,96804,347011,0.7818820905106858,10,7,124136,13603,110533,0.8904185731778049,18.573955555555557,2560.8911893333334,14.046892349086676,134,2.6000000000000003E-4
10,test_20231031_155719,11551286.png,271883,164,271719,0.9993967993585476,2,6,40092,22,40070,0.9994512620971765,18.120286222222223,1899.5769013333334,15.344234809036362,134,2.6000000000000003E-4
1,test_20231031_155720,10404007.png,502730,12687,490043,0.9747637897081932,4,6,61265,1854,59411,0.9697380233412226,26.522814222222223,3660.292986666667,12.495645111565782,134,2.7000000000000006E-4
2,test_20231031_155720,1254659.png,342646,57052,285594,0.8334957944934422,4,6,80080,8040,72040,0.8996003996003996,22.955799111111112,3856.1182026666665,12.269300228832059,134,2.7000000000000006E-4
3,test_20231031_155720,10188041.png,221231,7482,213749,0.966180146543658,3,7,41731,1062,40669,0.9745512928039107,12.276314666666666,1446.37864,16.52798361314215,134,2.7000000000000006E-4
4,test_20231031_155720,10287332.png,216980,9932,207048,0.9542261959627616,3,6,22337,1369,20968,0.938711554819358,10.139925333333334,1003.4804586666667,18.11571441220159,134,2.7000000000000006E-4
5,test_20231031_155720,11610969.png,368720,18132,350588,0.9508244738555001,3,5,84111,2667,81444,0.9682918999892999,24.015946666666668,3561.74064,12.614180691875706,134,2.7000000000000006E-4
6,test_20231031_155720,10350842.png,212614,3632,208982,0.9829173996067991,2,10,42529,533,41996,0.9874673752028028,22.303296,3145.339712,13.154128026352721,134,2.7000000000000006E-4
7,test_20231031_155720,10863862.png,317432,6032,311400,0.980997504977444,3,6,66058,887,65171,0.9865724060673953,36.62354311111111,6752.591344,9.836098931580938,134,2.7000000000000006E-4
8,test_20231031_155720,11382381.png,312486,527,311959,0.9983135244458952,2,6,46745,69,46676,0.9985239063001391,22.832848,2745.811376,13.744096608790418,134,2.7000000000000006E-4
9,test_20231031_155720,11079715.png,443815,96804,347011,0.7818820905106858,5,6,124136,13603,110533,0.8904185731778049,18.573955555555557,2560.8911893333334,14.046892349086676,134,2.7000000000000006E-4
10,test_20231031_155720,11551286.png,271883,164,271719,0.9993967993585476,2,6,40092,22,40070,0.9994512620971765,18.120286222222223,1899.5769013333334,15.344234809036362,134,2.7000000000000006E-4
1,test_20231031_155721,10404007.png,502730,12687,490043,0.9747637897081932,3,6,61265,1854,59411,0.9697380233412226,26.522814222222223,3660.292986666667,12.495645111565782,134,2.800000000000001E-4
2,test_20231031_155721,1254659.png,342646,57052,285594,0.8334957944934422,5,6,80080,8040,72040,0.8996003996003996,22.955799111111112,3856.1182026666665,12.269300228832059,134,2.800000000000001E-4
3,test_20231031_155721,10188041.png,221231,7482,213749,0.966180146543658,3,6,41731,1062,40669,0.9745512928039107,12.276314666666666,1446.37864,16.52798361314215,134,2.800000000000001E-4
4,test_20231031_155721,10287332.png,216980,9932,207048,0.9542261959627616,2,5,22337,1369,20968,0.938711554819358,10.139925333333334,1003.4804586666667,18.11571441220159,134,2.800000000000001E-4
5,test_20231031_155721,11610969.png,368720,18132,350588,0.9508244738555001,3,6,84111,2667,81444,0.9682918999892999,24.015946666666668,3561.74064,12.614180691875706,134,2.800000000000001E-4
6,test_20231031_155721,10350842.png,212614,3632,208982,0.9829173996067991,2,5,42529,533,41996,0.9874673752028028,22.303296,3145.339712,13.154128026352721,134,2.800000000000001E-4
7,test_20231031_155721,10863862.png,317432,6032,311400,0.980997504977444,2,5,66058,887,65171,0.9865724060673953,36.62354311111111,6752.591344,9.836098931580938,134,2.800000000000001E-4
8,test_20231031_155721,11382381.png,312486,527,311959,0.9983135244458952,2,6,46745,69,46676,0.9985239063001391,22.832848,2745.811376,13.744096608790418,134,2.800000000000001E-4
9,test_20231031_155721,11079715.png,443815,96804,347011,0.7818820905106858,5,6,124136,13603,110533,0.8904185731778049,18.573955555555557,2560.8911893333334,14.046892349086676,134,2.800000000000001E-4
10,test_20231031_155721,11551286.png,271883,164,271719,0.9993967993585476,2,5,40092,22,40070,0.9994512620971765,18.120286222222223,1899.5769013333334,15.344234809036362,134,2.800000000000001E-4
1,test_20231031_155722,10404007.png,502730,12687,490043,0.9747637897081932,3,6,61265,1854,59411,0.9697380233412226,26.522814222222223,3660.292986666667,12.495645111565782,134,2.900000000000001E-4
2,test_20231031_155722,1254659.png,342646,57052,285594,0.8334957944934422,4,6,80080,8040,72040,0.8996003996003996,22.955799111111112,3856.1182026666665,12.269300228832059,134,2.900000000000001E-4
3,test_20231031_155722,10188041.png,221231,7482,213749,0.966180146543658,3,6,41731,1062,40669,0.9745512928039107,12.276314666666666,1446.37864,16.52798361314215,134,2.900000000000001E-4
4,test_20231031_155722,10287332.png,216980,9932,207048,0.9542261959627616,3,6,22337,1369,20968,0.938711554819358,10.139925333333334,1003.4804586666667,18.11571441220159,134,2.900000000000001E-4
5,test_20231031_155722,11610969.png,368720,18132,350588,0.9508244738555001,3,5,84111,2667,81444,0.9682918999892999,24.015946666666668,3561.74064,12.614180691875706,134,2.900000000000001E-4
6,test_20231031_155722,10350842.png,212614,3632,208982,0.9829173996067991,2,6,42529,533,41996,0.9874673752028028,22.303296,3145.339712,13.154128026352721,134,2.900000000000001E-4
7,test_20231031_155722,10863862.png,317432,6032,311400,0.980997504977444,2,5,66058,887,65171,0.9865724060673953,36.62354311111111,6752.591344,9.836098931580938,134,2.900000000000001E-4
8,test_20231031_155722,11382381.png,312486,527,311959,0.9983135244458952,2,5,46745,69,46676,0.9985239063001391,22.832848,2745.811376,13.744096608790418,134,2.900000000000001E-4
9,test_20231031_155722,11079715.png,443815,96804,347011,0.7818820905106858,5,6,124136,13603,110533,0.8904185731778049,18.573955555555557,2560.8911893333334,14.046892349086676,134,2.900000000000001E-4
10,test_20231031_155722,11551286.png,271883,164,271719,0.9993967993585476,2,6,40092,22,40070,0.9994512620971765,18.120286222222223,1899.5769013333334,15.344234809036362,134,2.900000000000001E-4
1,test_20231031_155723,10404007.png,502730,12162,490568,0.9758080878403914,3,6,61265,1779,59486,0.9709622133355097,26.55992,3673.92888,12.479496158993475,135,1.0E-5
2,test_20231031_155723,1254659.png,342646,55202,287444,0.8388949528084378,5,6,80080,7779,72301,0.9028596403596404,23.353802666666667,3980.109952,12.131852910838479,135,1.0E-5
3,test_20231031_155723,10188041.png,221231,7359,213872,0.9667361264922185,3,13,41731,1044,40687,0.9749826268241835,12.082014222222222,1435.143152,16.561851378307132,135,1.0E-5
4,test_20231031_155723,10287332.png,216980,10022,206958,0.9538114111899714,2,6,22337,1379,20958,0.9382638671262927,10.026462222222221,981.878768,18.210224918577968,135,1.0E-5
5,test_20231031_155723,11610969.png,368720,17337,351383,0.9529805814710349,3,6,84111,2551,81560,0.9696710299485204,24.066007111111112,3590.849722666667,12.578831306185476,135,1.0E-5
6,test_20231031_155723,10350842.png,212614,3512,209102,0.9834818027034908,3,7,42529,517,42012,0.9878435890803922,21.05091377777778,2753.8514826666665,13.731398461516449,135,1.0E-5
7,test_20231031_155723,10863862.png,317432,6032,311400,0.980997504977444,3,6,66058,886,65172,0.9865875442792698,36.04656,6605.741237333334,9.931588035317864,135,1.0E-5
8,test_20231031_155723,11382381.png,312486,787,311699,0.9974814871706252,3,6,46745,107,46638,0.9977109851320997,20.595329777777778,2391.5028426666668,14.344094594342474,135,1.0E-5
9,test_20231031_155723,11079715.png,443815,94754,349061,0.7865011322285187,4,7,124136,13324,110812,0.8926661081394599,18.728499555555555,2605.7314826666666,13.97150700682634,135,1.0E-5
10,test_20231031_155723,11551286.png,271883,517,271366,0.9980984467583482,2,6,40092,74,40018,0.9981542452359573,17.526147555555557,1807.59504,15.559792199013692,135,1.0E-5
1,test_20231031_155724,10404007.png,502730,12162,490568,0.9758080878403914,3,6,61265,1779,59486,0.9709622133355097,26.55992,3673.92888,12.479496158993475,135,2.0E-5
2,test_20231031_155724,1254659.png,342646,55202,287444,0.8388949528084378,5,6,80080,7779,72301,0.9028596403596404,23.353802666666667,3980.109952,12.131852910838479,135,2.0E-5
3,test_20231031_155724,10188041.png,221231,7359,213872,0.9667361264922185,3,5,41731,1044,40687,0.9749826268241835,12.082014222222222,1435.143152,16.561851378307132,135,2.0E-5
4,test_20231031_155724,10287332.png,216980,10022,206958,0.9538114111899714,3,5,22337,1379,20958,0.9382638671262927,10.026462222222221,981.878768,18.210224918577968,135,2.0E-5
5,test_20231031_155724,11610969.png,368720,17337,351383,0.9529805814710349,4,14,84111,2551,81560,0.9696710299485204,24.066007111111112,3590.849722666667,12.578831306185476,135,2.0E-5
6,test_20231031_155724,10350842.png,212614,3512,209102,0.9834818027034908,2,5,42529,517,42012,0.9878435890803922,21.05091377777778,2753.8514826666665,13.731398461516449,135,2.0E-5
7,test_20231031_155724,10863862.png,317432,6032,311400,0.980997504977444,2,6,66058,886,65172,0.9865875442792698,36.04656,6605.741237333334,9.931588035317864,135,2.0E-5
8,test_20231031_155724,11382381.png,312486,777,311709,0.9975134886042895,2,6,46745,106,46639,0.9977323777944165,21.325146666666665,2490.063653333333,14.168699117890078,135,2.0E-5
9,test_20231031_155724,11079715.png,443815,94754,349061,0.7865011322285187,5,7,124136,13324,110812,0.8926661081394599,18.728499555555555,2605.7314826666666,13.97150700682634,135,2.0E-5
10,test_20231031_155724,11551286.png,271883,517,271366,0.9980984467583482,2,6,40092,74,40018,0.9981542452359573,17.526147555555557,1807.59504,15.559792199013692,135,2.0E-5
1,test_20231031_155725,10404007.png,502730,12162,490568,0.9758080878403914,3,6,61265,1779,59486,0.9709622133355097,26.55992,3673.92888,12.479496158993475,135,3.0000000000000004E-5
2,test_20231031_155725,1254659.png,342646,55202,287444,0.8388949528084378,4,7,80080,7779,72301,0.9028596403596404,23.353802666666667,3980.109952,12.131852910838479,135,3.0000000000000004E-5
3,test_20231031_155725,10188041.png,221231,7359,213872,0.9667361264922185,3,6,41731,1044,40687,0.9749826268241835,12.082014222222222,1435.143152,16.561851378307132,135,3.0000000000000004E-5
4,test_20231031_155725,10287332.png,216980,10022,206958,0.9538114111899714,3,6,22337,1379,20958,0.9382638671262927,10.026462222222221,981.878768,18.210224918577968,135,3.0000000000000004E-5
5,test_20231031_155725,11610969.png,368720,17337,351383,0.9529805814710349,4,6,84111,2551,81560,0.9696710299485204,24.066007111111112,3590.849722666667,12.578831306185476,135,3.0000000000000004E-5
6,test_20231031_155725,10350842.png,212614,3512,209102,0.9834818027034908,2,5,42529,517,42012,0.9878435890803922,21.05091377777778,2753.8514826666665,13.731398461516449,135,3.0000000000000004E-5
7,test_20231031_155725,10863862.png,317432,6032,311400,0.980997504977444,2,5,66058,886,65172,0.9865875442792698,36.04656,6605.741237333334,9.931588035317864,135,3.0000000000000004E-5
8,test_20231031_155725,11382381.png,312486,777,311709,0.9975134886042895,3,6,46745,106,46639,0.9977323777944165,21.325146666666665,2490.063653333333,14.168699117890078,135,3.0000000000000004E-5
9,test_20231031_155725,11079715.png,443815,94754,349061,0.7865011322285187,5,6,124136,13324,110812,0.8926661081394599,18.728499555555555,2605.7314826666666,13.97150700682634,135,3.0000000000000004E-5
10,test_20231031_155725,11551286.png,271883,517,271366,0.9980984467583482,3,6,40092,74,40018,0.9981542452359573,17.526147555555557,1807.59504,15.559792199013692,135,3.0000000000000004E-5
1,test_20231031_155726,10404007.png,502730,12162,490568,0.9758080878403914,3,6,61265,1779,59486,0.9709622133355097,26.55992,3673.92888,12.479496158993475,135,4.0E-5
2,test_20231031_155726,1254659.png,342646,55202,287444,0.8388949528084378,5,6,80080,7779,72301,0.9028596403596404,23.353802666666667,3980.109952,12.131852910838479,135,4.0E-5
3,test_20231031_155726,10188041.png,221231,7359,213872,0.9667361264922185,3,6,41731,1044,40687,0.9749826268241835,12.082014222222222,1435.143152,16.561851378307132,135,4.0E-5
4,test_20231031_155726,10287332.png,216980,10022,206958,0.9538114111899714,3,6,22337,1379,20958,0.9382638671262927,10.026462222222221,981.878768,18.210224918577968,135,4.0E-5
5,test_20231031_155726,11610969.png,368720,17337,351383,0.9529805814710349,3,6,84111,2551,81560,0.9696710299485204,24.066007111111112,3590.849722666667,12.578831306185476,135,4.0E-5
6,test_20231031_155726,10350842.png,212614,3512,209102,0.9834818027034908,3,5,42529,517,42012,0.9878435890803922,21.05091377777778,2753.8514826666665,13.731398461516449,135,4.0E-5
7,test_20231031_155726,10863862.png,317432,6032,311400,0.980997504977444,3,5,66058,886,65172,0.9865875442792698,36.04656,6605.741237333334,9.931588035317864,135,4.0E-5
8,test_20231031_155726,11382381.png,312486,777,311709,0.9975134886042895,2,5,46745,106,46639,0.9977323777944165,21.325146666666665,2490.063653333333,14.168699117890078,135,4.0E-5
9,test_20231031_155726,11079715.png,443815,94754,349061,0.7865011322285187,5,7,124136,13324,110812,0.8926661081394599,18.728499555555555,2605.7314826666666,13.97150700682634,135,4.0E-5
10,test_20231031_155726,11551286.png,271883,517,271366,0.9980984467583482,2,6,40092,74,40018,0.9981542452359573,17.526147555555557,1807.59504,15.559792199013692,135,4.0E-5
1,test_20231031_155727,10404007.png,502730,12162,490568,0.9758080878403914,3,5,61265,1779,59486,0.9709622133355097,26.55992,3673.92888,12.479496158993475,135,5.0E-5
2,test_20231031_155727,1254659.png,342646,55202,287444,0.8388949528084378,5,6,80080,7779,72301,0.9028596403596404,23.353802666666667,3980.109952,12.131852910838479,135,5.0E-5
3,test_20231031_155727,10188041.png,221231,7359,213872,0.9667361264922185,3,6,41731,1044,40687,0.9749826268241835,12.082014222222222,1435.143152,16.561851378307132,135,5.0E-5
4,test_20231031_155727,10287332.png,216980,10022,206958,0.9538114111899714,3,6,22337,1379,20958,0.9382638671262927,10.026462222222221,981.878768,18.210224918577968,135,5.0E-5
5,test_20231031_155727,11610969.png,368720,17337,351383,0.9529805814710349,3,5,84111,2551,81560,0.9696710299485204,24.066007111111112,3590.849722666667,12.578831306185476,135,5.0E-5
6,test_20231031_155727,10350842.png,212614,3512,209102,0.9834818027034908,2,6,42529,517,42012,0.9878435890803922,21.05091377777778,2753.8514826666665,13.731398461516449,135,5.0E-5
7,test_20231031_155727,10863862.png,317432,6032,311400,0.980997504977444,3,6,66058,886,65172,0.9865875442792698,36.04656,6605.741237333334,9.931588035317864,135,5.0E-5
8,test_20231031_155727,11382381.png,312486,777,311709,0.9975134886042895,2,5,46745,106,46639,0.9977323777944165,21.325146666666665,2490.063653333333,14.168699117890078,135,5.0E-5
9,test_20231031_155727,11079715.png,443815,94754,349061,0.7865011322285187,5,6,124136,13324,110812,0.8926661081394599,18.728499555555555,2605.7314826666666,13.97150700682634,135,5.0E-5
10,test_20231031_155727,11551286.png,271883,517,271366,0.9980984467583482,3,21,40092,74,40018,0.9981542452359573,17.526147555555557,1807.59504,15.559792199013692,135,5.0E-5
1,test_20231031_155728,10404007.png,502730,12162,490568,0.9758080878403914,3,5,61265,1779,59486,0.9709622133355097,26.55992,3673.92888,12.479496158993475,135,6.0E-5
2,test_20231031_155728,1254659.png,342646,55202,287444,0.8388949528084378,5,6,80080,7779,72301,0.9028596403596404,23.353802666666667,3980.109952,12.131852910838479,135,6.0E-5
3,test_20231031_155728,10188041.png,221231,7359,213872,0.9667361264922185,3,6,41731,1044,40687,0.9749826268241835,12.082014222222222,1435.143152,16.561851378307132,135,6.0E-5
4,test_20231031_155728,10287332.png,216980,10022,206958,0.9538114111899714,2,6,22337,1379,20958,0.9382638671262927,10.026462222222221,981.878768,18.210224918577968,135,6.0E-5
5,test_20231031_155728,11610969.png,368720,17337,351383,0.9529805814710349,3,6,84111,2551,81560,0.9696710299485204,24.066007111111112,3590.849722666667,12.578831306185476,135,6.0E-5
6,test_20231031_155728,10350842.png,212614,3512,209102,0.9834818027034908,2,6,42529,517,42012,0.9878435890803922,21.05091377777778,2753.8514826666665,13.731398461516449,135,6.0E-5
7,test_20231031_155728,10863862.png,317432,6032,311400,0.980997504977444,2,5,66058,886,65172,0.9865875442792698,36.04656,6605.741237333334,9.931588035317864,135,6.0E-5
8,test_20231031_155728,11382381.png,312486,777,311709,0.9975134886042895,3,6,46745,106,46639,0.9977323777944165,21.325146666666665,2490.063653333333,14.168699117890078,135,6.0E-5
9,test_20231031_155728,11079715.png,443815,94754,349061,0.7865011322285187,5,6,124136,13324,110812,0.8926661081394599,18.728499555555555,2605.7314826666666,13.97150700682634,135,6.0E-5
10,test_20231031_155728,11551286.png,271883,517,271366,0.9980984467583482,3,15,40092,74,40018,0.9981542452359573,17.526147555555557,1807.59504,15.559792199013692,135,6.0E-5
1,test_20231031_155730,10404007.png,502730,12162,490568,0.9758080878403914,3,6,61265,1779,59486,0.9709622133355097,26.55992,3673.92888,12.479496158993475,135,7.000000000000001E-5
2,test_20231031_155730,1254659.png,342646,55202,287444,0.8388949528084378,4,6,80080,7779,72301,0.9028596403596404,23.353802666666667,3980.109952,12.131852910838479,135,7.000000000000001E-5
3,test_20231031_155730,10188041.png,221231,7359,213872,0.9667361264922185,3,5,41731,1044,40687,0.9749826268241835,12.082014222222222,1435.143152,16.561851378307132,135,7.000000000000001E-5
4,test_20231031_155730,10287332.png,216980,10022,206958,0.9538114111899714,2,6,22337,1379,20958,0.9382638671262927,10.026462222222221,981.878768,18.210224918577968,135,7.000000000000001E-5
5,test_20231031_155730,11610969.png,368720,17337,351383,0.9529805814710349,4,6,84111,2551,81560,0.9696710299485204,24.066007111111112,3590.849722666667,12.578831306185476,135,7.000000000000001E-5
6,test_20231031_155730,10350842.png,212614,3392,209222,0.9840462058001825,2,6,42529,499,42030,0.9882668296926803,22.827879111111113,3246.082464,13.0172081235082,135,7.000000000000001E-5
7,test_20231031_155730,10863862.png,317432,6032,311400,0.980997504977444,2,6,66058,886,65172,0.9865875442792698,36.04656,6605.741237333334,9.931588035317864,135,7.000000000000001E-5
8,test_20231031_155730,11382381.png,312486,757,311729,0.9975774914716179,3,6,46745,103,46642,0.997796555781367,22.081843555555555,2635.736901333333,13.921783039602623,135,7.000000000000001E-5
9,test_20231031_155730,11079715.png,443815,94754,349061,0.7865011322285187,5,7,124136,13324,110812,0.8926661081394599,18.728499555555555,2605.7314826666666,13.97150700682634,135,7.000000000000001E-5
10,test_20231031_155730,11551286.png,271883,377,271506,0.9986133741351979,2,6,40092,53,40039,0.9986780405068343,17.85248,1858.6998933333334,15.438710868521719,135,7.000000000000001E-5
1,test_20231031_155731,10404007.png,502730,12162,490568,0.9758080878403914,3,5,61265,1779,59486,0.9709622133355097,26.55992,3673.92888,12.479496158993475,135,8.0E-5
2,test_20231031_155731,1254659.png,342646,55202,287444,0.8388949528084378,4,6,80080,7779,72301,0.9028596403596404,23.353802666666667,3980.109952,12.131852910838479,135,8.0E-5
3,test_20231031_155731,10188041.png,221231,7359,213872,0.9667361264922185,3,5,41731,1044,40687,0.9749826268241835,12.082014222222222,1435.143152,16.561851378307132,135,8.0E-5
4,test_20231031_155731,10287332.png,216980,10022,206958,0.9538114111899714,3,5,22337,1379,20958,0.9382638671262927,10.026462222222221,981.878768,18.210224918577968,135,8.0E-5
5,test_20231031_155731,11610969.png,368720,17337,351383,0.9529805814710349,4,6,84111,2551,81560,0.9696710299485204,24.066007111111112,3590.849722666667,12.578831306185476,135,8.0E-5
6,test_20231031_155731,10350842.png,212614,3392,209222,0.9840462058001825,2,6,42529,499,42030,0.9882668296926803,22.827879111111113,3246.082464,13.0172081235082,135,8.0E-5
7,test_20231031_155731,10863862.png,317432,6032,311400,0.980997504977444,2,5,66058,886,65172,0.9865875442792698,36.04656,6605.741237333334,9.931588035317864,135,8.0E-5
8,test_20231031_155731,11382381.png,312486,757,311729,0.9975774914716179,3,5,46745,103,46642,0.997796555781367,22.081843555555555,2635.736901333333,13.921783039602623,135,8.0E-5
9,test_20231031_155731,11079715.png,443815,94754,349061,0.7865011322285187,5,6,124136,13324,110812,0.8926661081394599,18.728499555555555,2605.7314826666666,13.97150700682634,135,8.0E-5
10,test_20231031_155731,11551286.png,271883,377,271506,0.9986133741351979,2,5,40092,53,40039,0.9986780405068343,17.85248,1858.6998933333334,15.438710868521719,135,8.0E-5
1,test_20231031_155732,10404007.png,502730,12162,490568,0.9758080878403914,4,5,61265,1779,59486,0.9709622133355097,26.55992,3673.92888,12.479496158993475,135,9.0E-5
2,test_20231031_155732,1254659.png,342646,55202,287444,0.8388949528084378,4,12,80080,7779,72301,0.9028596403596404,23.353802666666667,3980.109952,12.131852910838479,135,9.0E-5
3,test_20231031_155732,10188041.png,221231,7359,213872,0.9667361264922185,3,5,41731,1044,40687,0.9749826268241835,12.082014222222222,1435.143152,16.561851378307132,135,9.0E-5
4,test_20231031_155732,10287332.png,216980,10022,206958,0.9538114111899714,4,6,22337,1379,20958,0.9382638671262927,10.026462222222221,981.878768,18.210224918577968,135,9.0E-5
5,test_20231031_155732,11610969.png,368720,17337,351383,0.9529805814710349,4,6,84111,2551,81560,0.9696710299485204,24.066007111111112,3590.849722666667,12.578831306185476,135,9.0E-5
6,test_20231031_155732,10350842.png,212614,3392,209222,0.9840462058001825,2,6,42529,499,42030,0.9882668296926803,22.827879111111113,3246.082464,13.0172081235082,135,9.0E-5
7,test_20231031_155732,10863862.png,317432,6032,311400,0.980997504977444,2,5,66058,886,65172,0.9865875442792698,36.04656,6605.741237333334,9.931588035317864,135,9.0E-5
8,test_20231031_155732,11382381.png,312486,757,311729,0.9975774914716179,3,6,46745,103,46642,0.997796555781367,22.081843555555555,2635.736901333333,13.921783039602623,135,9.0E-5
9,test_20231031_155732,11079715.png,443815,94754,349061,0.7865011322285187,5,6,124136,13324,110812,0.8926661081394599,18.728499555555555,2605.7314826666666,13.97150700682634,135,9.0E-5
10,test_20231031_155732,11551286.png,271883,377,271506,0.9986133741351979,2,5,40092,53,40039,0.9986780405068343,17.85248,1858.6998933333334,15.438710868521719,135,9.0E-5
1,test_20231031_155733,10404007.png,502730,12162,490568,0.9758080878403914,4,6,61265,1779,59486,0.9709622133355097,26.55992,3673.92888,12.479496158993475,135,1.0E-4
2,test_20231031_155733,1254659.png,342646,55202,287444,0.8388949528084378,4,6,80080,7779,72301,0.9028596403596404,23.353802666666667,3980.109952,12.131852910838479,135,1.0E-4
3,test_20231031_155733,10188041.png,221231,7359,213872,0.9667361264922185,3,5,41731,1044,40687,0.9749826268241835,12.082014222222222,1435.143152,16.561851378307132,135,1.0E-4
4,test_20231031_155733,10287332.png,216980,10022,206958,0.9538114111899714,2,5,22337,1379,20958,0.9382638671262927,10.026462222222221,981.878768,18.210224918577968,135,1.0E-4
5,test_20231031_155733,11610969.png,368720,17337,351383,0.9529805814710349,3,6,84111,2551,81560,0.9696710299485204,24.066007111111112,3590.849722666667,12.578831306185476,135,1.0E-4
6,test_20231031_155733,10350842.png,212614,3392,209222,0.9840462058001825,3,6,42529,499,42030,0.9882668296926803,22.827879111111113,3246.082464,13.0172081235082,135,1.0E-4
7,test_20231031_155733,10863862.png,317432,6032,311400,0.980997504977444,2,5,66058,886,65172,0.9865875442792698,36.04656,6605.741237333334,9.931588035317864,135,1.0E-4
8,test_20231031_155733,11382381.png,312486,757,311729,0.9975774914716179,2,5,46745,103,46642,0.997796555781367,22.081843555555555,2635.736901333333,13.921783039602623,135,1.0E-4
9,test_20231031_155733,11079715.png,443815,94754,349061,0.7865011322285187,6,8,124136,13324,110812,0.8926661081394599,18.728499555555555,2605.7314826666666,13.97150700682634,135,1.0E-4
10,test_20231031_155733,11551286.png,271883,377,271506,0.9986133741351979,2,6,40092,53,40039,0.9986780405068343,17.85248,1858.6998933333334,15.438710868521719,135,1.0E-4
1,test_20231031_155734,10404007.png,502730,12162,490568,0.9758080878403914,4,6,61265,1779,59486,0.9709622133355097,26.55992,3673.92888,12.479496158993475,135,1.1E-4
2,test_20231031_155734,1254659.png,342646,55202,287444,0.8388949528084378,4,6,80080,7779,72301,0.9028596403596404,23.353802666666667,3980.109952,12.131852910838479,135,1.1E-4
3,test_20231031_155734,10188041.png,221231,7359,213872,0.9667361264922185,3,6,41731,1044,40687,0.9749826268241835,12.082014222222222,1435.143152,16.561851378307132,135,1.1E-4
4,test_20231031_155734,10287332.png,216980,10022,206958,0.9538114111899714,3,6,22337,1379,20958,0.9382638671262927,10.026462222222221,981.878768,18.210224918577968,135,1.1E-4
5,test_20231031_155734,11610969.png,368720,17337,351383,0.9529805814710349,4,6,84111,2551,81560,0.9696710299485204,24.066007111111112,3590.849722666667,12.578831306185476,135,1.1E-4
6,test_20231031_155734,10350842.png,212614,3392,209222,0.9840462058001825,2,6,42529,499,42030,0.9882668296926803,22.827879111111113,3246.082464,13.0172081235082,135,1.1E-4
7,test_20231031_155734,10863862.png,317432,6032,311400,0.980997504977444,2,5,66058,886,65172,0.9865875442792698,36.04656,6605.741237333334,9.931588035317864,135,1.1E-4
8,test_20231031_155734,11382381.png,312486,757,311729,0.9975774914716179,2,5,46745,103,46642,0.997796555781367,22.081843555555555,2635.736901333333,13.921783039602623,135,1.1E-4
9,test_20231031_155734,11079715.png,443815,94754,349061,0.7865011322285187,5,6,124136,13324,110812,0.8926661081394599,18.728499555555555,2605.7314826666666,13.97150700682634,135,1.1E-4
10,test_20231031_155734,11551286.png,271883,377,271506,0.9986133741351979,2,5,40092,53,40039,0.9986780405068343,17.85248,1858.6998933333334,15.438710868521719,135,1.1E-4
1,test_20231031_155735,10404007.png,502730,12162,490568,0.9758080878403914,3,5,61265,1779,59486,0.9709622133355097,26.55992,3673.92888,12.479496158993475,135,1.2E-4
2,test_20231031_155735,1254659.png,342646,55202,287444,0.8388949528084378,5,6,80080,7779,72301,0.9028596403596404,23.353802666666667,3980.109952,12.131852910838479,135,1.2E-4
3,test_20231031_155735,10188041.png,221231,7359,213872,0.9667361264922185,2,5,41731,1044,40687,0.9749826268241835,12.082014222222222,1435.143152,16.561851378307132,135,1.2E-4
4,test_20231031_155735,10287332.png,216980,10022,206958,0.9538114111899714,2,5,22337,1379,20958,0.9382638671262927,10.026462222222221,981.878768,18.210224918577968,135,1.2E-4
5,test_20231031_155735,11610969.png,368720,17337,351383,0.9529805814710349,3,6,84111,2551,81560,0.9696710299485204,24.066007111111112,3590.849722666667,12.578831306185476,135,1.2E-4
6,test_20231031_155735,10350842.png,212614,3392,209222,0.9840462058001825,2,6,42529,499,42030,0.9882668296926803,22.827879111111113,3246.082464,13.0172081235082,135,1.2E-4
7,test_20231031_155735,10863862.png,317432,6032,311400,0.980997504977444,2,6,66058,886,65172,0.9865875442792698,36.04656,6605.741237333334,9.931588035317864,135,1.2E-4
8,test_20231031_155735,11382381.png,312486,647,311839,0.9979295072419244,2,6,46745,87,46658,0.9981388383784362,22.33832177777778,2675.8690666666666,13.85615501777858,135,1.2E-4
9,test_20231031_155735,11079715.png,443815,94754,349061,0.7865011322285187,5,12,124136,13324,110812,0.8926661081394599,18.728499555555555,2605.7314826666666,13.97150700682634,135,1.2E-4
10,test_20231031_155735,11551286.png,271883,377,271506,0.9986133741351979,2,5,40092,53,40039,0.9986780405068343,17.85248,1858.6998933333334,15.438710868521719,135,1.2E-4
1,test_20231031_155736,10404007.png,502730,12162,490568,0.9758080878403914,3,6,61265,1779,59486,0.9709622133355097,26.55992,3673.92888,12.479496158993475,135,1.3000000000000002E-4
2,test_20231031_155736,1254659.png,342646,55202,287444,0.8388949528084378,5,6,80080,7779,72301,0.9028596403596404,23.353802666666667,3980.109952,12.131852910838479,135,1.3000000000000002E-4
3,test_20231031_155736,10188041.png,221231,7359,213872,0.9667361264922185,3,6,41731,1044,40687,0.9749826268241835,12.082014222222222,1435.143152,16.561851378307132,135,1.3000000000000002E-4
4,test_20231031_155736,10287332.png,216980,10022,206958,0.9538114111899714,3,6,22337,1379,20958,0.9382638671262927,10.026462222222221,981.878768,18.210224918577968,135,1.3000000000000002E-4
5,test_20231031_155736,11610969.png,368720,17337,351383,0.9529805814710349,4,6,84111,2551,81560,0.9696710299485204,24.066007111111112,3590.849722666667,12.578831306185476,135,1.3000000000000002E-4
6,test_20231031_155736,10350842.png,212614,3392,209222,0.9840462058001825,3,6,42529,499,42030,0.9882668296926803,22.827879111111113,3246.082464,13.0172081235082,135,1.3000000000000002E-4
7,test_20231031_155736,10863862.png,317432,6032,311400,0.980997504977444,3,6,66058,886,65172,0.9865875442792698,36.04656,6605.741237333334,9.931588035317864,135,1.3000000000000002E-4
8,test_20231031_155736,11382381.png,312486,647,311839,0.9979295072419244,2,6,46745,87,46658,0.9981388383784362,22.33832177777778,2675.8690666666666,13.85615501777858,135,1.3000000000000002E-4
9,test_20231031_155736,11079715.png,443815,94754,349061,0.7865011322285187,6,6,124136,13324,110812,0.8926661081394599,18.728499555555555,2605.7314826666666,13.97150700682634,135,1.3000000000000002E-4
10,test_20231031_155736,11551286.png,271883,377,271506,0.9986133741351979,2,5,40092,53,40039,0.9986780405068343,17.85248,1858.6998933333334,15.438710868521719,135,1.3000000000000002E-4
1,test_20231031_155737,10404007.png,502730,12162,490568,0.9758080878403914,3,6,61265,1779,59486,0.9709622133355097,26.55992,3673.92888,12.479496158993475,135,1.4000000000000001E-4
2,test_20231031_155737,1254659.png,342646,55202,287444,0.8388949528084378,4,6,80080,7779,72301,0.9028596403596404,23.353802666666667,3980.109952,12.131852910838479,135,1.4000000000000001E-4
3,test_20231031_155737,10188041.png,221231,7359,213872,0.9667361264922185,3,6,41731,1044,40687,0.9749826268241835,12.082014222222222,1435.143152,16.561851378307132,135,1.4000000000000001E-4
4,test_20231031_155737,10287332.png,216980,10022,206958,0.9538114111899714,3,6,22337,1379,20958,0.9382638671262927,10.026462222222221,981.878768,18.210224918577968,135,1.4000000000000001E-4
5,test_20231031_155737,11610969.png,368720,17337,351383,0.9529805814710349,3,6,84111,2551,81560,0.9696710299485204,24.066007111111112,3590.849722666667,12.578831306185476,135,1.4000000000000001E-4
6,test_20231031_155737,10350842.png,212614,3392,209222,0.9840462058001825,2,6,42529,499,42030,0.9882668296926803,22.827879111111113,3246.082464,13.0172081235082,135,1.4000000000000001E-4
7,test_20231031_155737,10863862.png,317432,6032,311400,0.980997504977444,2,6,66058,886,65172,0.9865875442792698,36.04656,6605.741237333334,9.931588035317864,135,1.4000000000000001E-4
8,test_20231031_155737,11382381.png,312486,647,311839,0.9979295072419244,2,5,46745,87,46658,0.9981388383784362,22.33832177777778,2675.8690666666666,13.85615501777858,135,1.4000000000000001E-4
9,test_20231031_155737,11079715.png,443815,94754,349061,0.7865011322285187,5,6,124136,13324,110812,0.8926661081394599,18.728499555555555,2605.7314826666666,13.97150700682634,135,1.4000000000000001E-4
10,test_20231031_155737,11551286.png,271883,377,271506,0.9986133741351979,2,6,40092,53,40039,0.9986780405068343,17.85248,1858.6998933333334,15.438710868521719,135,1.4000000000000001E-4
1,test_20231031_155738,10404007.png,502730,12162,490568,0.9758080878403914,4,6,61265,1779,59486,0.9709622133355097,26.55992,3673.92888,12.479496158993475,135,1.5000000000000001E-4
2,test_20231031_155738,1254659.png,342646,55202,287444,0.8388949528084378,4,6,80080,7779,72301,0.9028596403596404,23.353802666666667,3980.109952,12.131852910838479,135,1.5000000000000001E-4
3,test_20231031_155738,10188041.png,221231,7359,213872,0.9667361264922185,3,5,41731,1044,40687,0.9749826268241835,12.082014222222222,1435.143152,16.561851378307132,135,1.5000000000000001E-4
4,test_20231031_155738,10287332.png,216980,10022,206958,0.9538114111899714,3,5,22337,1379,20958,0.9382638671262927,10.026462222222221,981.878768,18.210224918577968,135,1.5000000000000001E-4
5,test_20231031_155738,11610969.png,368720,17337,351383,0.9529805814710349,4,6,84111,2551,81560,0.9696710299485204,24.066007111111112,3590.849722666667,12.578831306185476,135,1.5000000000000001E-4
6,test_20231031_155738,10350842.png,212614,3392,209222,0.9840462058001825,2,6,42529,499,42030,0.9882668296926803,22.827879111111113,3246.082464,13.0172081235082,135,1.5000000000000001E-4
7,test_20231031_155738,10863862.png,317432,6032,311400,0.980997504977444,2,6,66058,886,65172,0.9865875442792698,36.04656,6605.741237333334,9.931588035317864,135,1.5000000000000001E-4
8,test_20231031_155738,11382381.png,312486,647,311839,0.9979295072419244,2,6,46745,87,46658,0.9981388383784362,22.33832177777778,2675.8690666666666,13.85615501777858,135,1.5000000000000001E-4
9,test_20231031_155738,11079715.png,443815,94754,349061,0.7865011322285187,5,7,124136,13324,110812,0.8926661081394599,18.728499555555555,2605.7314826666666,13.97150700682634,135,1.5000000000000001E-4
10,test_20231031_155738,11551286.png,271883,377,271506,0.9986133741351979,2,6,40092,53,40039,0.9986780405068343,17.85248,1858.6998933333334,15.438710868521719,135,1.5000000000000001E-4
1,test_20231031_155739,10404007.png,502730,12162,490568,0.9758080878403914,3,5,61265,1779,59486,0.9709622133355097,26.55992,3673.92888,12.479496158993475,135,1.6E-4
2,test_20231031_155739,1254659.png,342646,55202,287444,0.8388949528084378,4,6,80080,7779,72301,0.9028596403596404,23.353802666666667,3980.109952,12.131852910838479,135,1.6E-4
3,test_20231031_155739,10188041.png,221231,7359,213872,0.9667361264922185,3,6,41731,1044,40687,0.9749826268241835,12.082014222222222,1435.143152,16.561851378307132,135,1.6E-4
4,test_20231031_155739,10287332.png,216980,9832,207148,0.9546870679325283,2,5,22337,1355,20982,0.9393383175896495,10.154837333333333,1008.1934186666666,18.095365027648654,135,1.6E-4
5,test_20231031_155739,11610969.png,368720,17337,351383,0.9529805814710349,3,5,84111,2551,81560,0.9696710299485204,24.066007111111112,3590.849722666667,12.578831306185476,135,1.6E-4
6,test_20231031_155739,10350842.png,212614,3392,209222,0.9840462058001825,2,5,42529,499,42030,0.9882668296926803,22.827879111111113,3246.082464,13.0172081235082,135,1.6E-4
7,test_20231031_155739,10863862.png,317432,6032,311400,0.980997504977444,3,6,66058,886,65172,0.9865875442792698,36.04656,6605.741237333334,9.931588035317864,135,1.6E-4
8,test_20231031_155739,11382381.png,312486,647,311839,0.9979295072419244,2,5,46745,87,46658,0.9981388383784362,22.33832177777778,2675.8690666666666,13.85615501777858,135,1.6E-4
9,test_20231031_155739,11079715.png,443815,94754,349061,0.7865011322285187,5,7,124136,13324,110812,0.8926661081394599,18.728499555555555,2605.7314826666666,13.97150700682634,135,1.6E-4
10,test_20231031_155739,11551286.png,271883,377,271506,0.9986133741351979,3,6,40092,53,40039,0.9986780405068343,17.85248,1858.6998933333334,15.438710868521719,135,1.6E-4
1,test_20231031_155740,10404007.png,502730,12162,490568,0.9758080878403914,3,5,61265,1779,59486,0.9709622133355097,26.55992,3673.92888,12.479496158993475,135,1.7E-4
2,test_20231031_155740,1254659.png,342646,55202,287444,0.8388949528084378,4,6,80080,7779,72301,0.9028596403596404,23.353802666666667,3980.109952,12.131852910838479,135,1.7E-4
3,test_20231031_155740,10188041.png,221231,7359,213872,0.9667361264922185,2,5,41731,1044,40687,0.9749826268241835,12.082014222222222,1435.143152,16.561851378307132,135,1.7E-4
4,test_20231031_155740,10287332.png,216980,9832,207148,0.9546870679325283,2,5,22337,1355,20982,0.9393383175896495,10.154837333333333,1008.1934186666666,18.095365027648654,135,1.7E-4
5,test_20231031_155740,11610969.png,368720,17337,351383,0.9529805814710349,3,5,84111,2551,81560,0.9696710299485204,24.066007111111112,3590.849722666667,12.578831306185476,135,1.7E-4
6,test_20231031_155740,10350842.png,212614,3392,209222,0.9840462058001825,2,6,42529,499,42030,0.9882668296926803,22.827879111111113,3246.082464,13.0172081235082,135,1.7E-4
7,test_20231031_155740,10863862.png,317432,6032,311400,0.980997504977444,3,6,66058,886,65172,0.9865875442792698,36.04656,6605.741237333334,9.931588035317864,135,1.7E-4
8,test_20231031_155740,11382381.png,312486,647,311839,0.9979295072419244,3,5,46745,87,46658,0.9981388383784362,22.33832177777778,2675.8690666666666,13.85615501777858,135,1.7E-4
9,test_20231031_155740,11079715.png,443815,94754,349061,0.7865011322285187,5,7,124136,13324,110812,0.8926661081394599,18.728499555555555,2605.7314826666666,13.97150700682634,135,1.7E-4
10,test_20231031_155740,11551286.png,271883,377,271506,0.9986133741351979,2,5,40092,53,40039,0.9986780405068343,17.85248,1858.6998933333334,15.438710868521719,135,1.7E-4
1,test_20231031_155741,10404007.png,502730,12162,490568,0.9758080878403914,3,6,61265,1779,59486,0.9709622133355097,26.55992,3673.92888,12.479496158993475,135,1.8E-4
2,test_20231031_155741,1254659.png,342646,55202,287444,0.8388949528084378,4,6,80080,7779,72301,0.9028596403596404,23.353802666666667,3980.109952,12.131852910838479,135,1.8E-4
3,test_20231031_155741,10188041.png,221231,7359,213872,0.9667361264922185,3,6,41731,1044,40687,0.9749826268241835,12.082014222222222,1435.143152,16.561851378307132,135,1.8E-4
4,test_20231031_155741,10287332.png,216980,9832,207148,0.9546870679325283,2,6,22337,1355,20982,0.9393383175896495,10.154837333333333,1008.1934186666666,18.095365027648654,135,1.8E-4
5,test_20231031_155741,11610969.png,368720,17337,351383,0.9529805814710349,4,6,84111,2551,81560,0.9696710299485204,24.066007111111112,3590.849722666667,12.578831306185476,135,1.8E-4
6,test_20231031_155741,10350842.png,212614,3392,209222,0.9840462058001825,3,6,42529,499,42030,0.9882668296926803,22.827879111111113,3246.082464,13.0172081235082,135,1.8E-4
7,test_20231031_155741,10863862.png,317432,6032,311400,0.980997504977444,2,5,66058,886,65172,0.9865875442792698,36.04656,6605.741237333334,9.931588035317864,135,1.8E-4
8,test_20231031_155741,11382381.png,312486,647,311839,0.9979295072419244,3,6,46745,87,46658,0.9981388383784362,22.33832177777778,2675.8690666666666,13.85615501777858,135,1.8E-4
9,test_20231031_155741,11079715.png,443815,94754,349061,0.7865011322285187,5,6,124136,13324,110812,0.8926661081394599,18.728499555555555,2605.7314826666666,13.97150700682634,135,1.8E-4
10,test_20231031_155741,11551286.png,271883,164,271719,0.9993967993585476,2,5,40092,22,40070,0.9994512620971765,18.120286222222223,1899.5769013333334,15.344234809036362,135,1.8E-4
1,test_20231031_155742,10404007.png,502730,12162,490568,0.9758080878403914,3,5,61265,1779,59486,0.9709622133355097,26.55992,3673.92888,12.479496158993475,135,1.9E-4
2,test_20231031_155742,1254659.png,342646,55202,287444,0.8388949528084378,5,6,80080,7779,72301,0.9028596403596404,23.353802666666667,3980.109952,12.131852910838479,135,1.9E-4
3,test_20231031_155742,10188041.png,221231,7359,213872,0.9667361264922185,3,5,41731,1044,40687,0.9749826268241835,12.082014222222222,1435.143152,16.561851378307132,135,1.9E-4
4,test_20231031_155742,10287332.png,216980,9832,207148,0.9546870679325283,2,6,22337,1355,20982,0.9393383175896495,10.154837333333333,1008.1934186666666,18.095365027648654,135,1.9E-4
5,test_20231031_155742,11610969.png,368720,17337,351383,0.9529805814710349,3,5,84111,2551,81560,0.9696710299485204,24.066007111111112,3590.849722666667,12.578831306185476,135,1.9E-4
6,test_20231031_155742,10350842.png,212614,3392,209222,0.9840462058001825,2,5,42529,499,42030,0.9882668296926803,22.827879111111113,3246.082464,13.0172081235082,135,1.9E-4
7,test_20231031_155742,10863862.png,317432,6032,311400,0.980997504977444,2,5,66058,886,65172,0.9865875442792698,36.04656,6605.741237333334,9.931588035317864,135,1.9E-4
8,test_20231031_155742,11382381.png,312486,647,311839,0.9979295072419244,2,6,46745,87,46658,0.9981388383784362,22.33832177777778,2675.8690666666666,13.85615501777858,135,1.9E-4
9,test_20231031_155742,11079715.png,443815,94754,349061,0.7865011322285187,5,6,124136,13324,110812,0.8926661081394599,18.728499555555555,2605.7314826666666,13.97150700682634,135,1.9E-4
10,test_20231031_155742,11551286.png,271883,164,271719,0.9993967993585476,2,6,40092,22,40070,0.9994512620971765,18.120286222222223,1899.5769013333334,15.344234809036362,135,1.9E-4
1,test_20231031_155743,10404007.png,502730,12162,490568,0.9758080878403914,4,6,61265,1779,59486,0.9709622133355097,26.55992,3673.92888,12.479496158993475,135,2.0E-4
2,test_20231031_155743,1254659.png,342646,55202,287444,0.8388949528084378,4,7,80080,7779,72301,0.9028596403596404,23.353802666666667,3980.109952,12.131852910838479,135,2.0E-4
3,test_20231031_155743,10188041.png,221231,7359,213872,0.9667361264922185,3,5,41731,1044,40687,0.9749826268241835,12.082014222222222,1435.143152,16.561851378307132,135,2.0E-4
4,test_20231031_155743,10287332.png,216980,9832,207148,0.9546870679325283,3,6,22337,1355,20982,0.9393383175896495,10.154837333333333,1008.1934186666666,18.095365027648654,135,2.0E-4
5,test_20231031_155743,11610969.png,368720,17337,351383,0.9529805814710349,4,6,84111,2551,81560,0.9696710299485204,24.066007111111112,3590.849722666667,12.578831306185476,135,2.0E-4
6,test_20231031_155743,10350842.png,212614,3392,209222,0.9840462058001825,2,6,42529,499,42030,0.9882668296926803,22.827879111111113,3246.082464,13.0172081235082,135,2.0E-4
7,test_20231031_155743,10863862.png,317432,6032,311400,0.980997504977444,2,5,66058,886,65172,0.9865875442792698,36.04656,6605.741237333334,9.931588035317864,135,2.0E-4
8,test_20231031_155743,11382381.png,312486,647,311839,0.9979295072419244,2,6,46745,87,46658,0.9981388383784362,22.33832177777778,2675.8690666666666,13.85615501777858,135,2.0E-4
9,test_20231031_155743,11079715.png,443815,94754,349061,0.7865011322285187,5,6,124136,13324,110812,0.8926661081394599,18.728499555555555,2605.7314826666666,13.97150700682634,135,2.0E-4
10,test_20231031_155743,11551286.png,271883,164,271719,0.9993967993585476,2,5,40092,22,40070,0.9994512620971765,18.120286222222223,1899.5769013333334,15.344234809036362,135,2.0E-4
1,test_20231031_155744,10404007.png,502730,12162,490568,0.9758080878403914,3,6,61265,1779,59486,0.9709622133355097,26.55992,3673.92888,12.479496158993475,135,2.1E-4
2,test_20231031_155744,1254659.png,342646,55202,287444,0.8388949528084378,4,6,80080,7779,72301,0.9028596403596404,23.353802666666667,3980.109952,12.131852910838479,135,2.1E-4
3,test_20231031_155744,10188041.png,221231,7359,213872,0.9667361264922185,3,9,41731,1044,40687,0.9749826268241835,12.082014222222222,1435.143152,16.561851378307132,135,2.1E-4
4,test_20231031_155744,10287332.png,216980,9832,207148,0.9546870679325283,3,6,22337,1355,20982,0.9393383175896495,10.154837333333333,1008.1934186666666,18.095365027648654,135,2.1E-4
5,test_20231031_155744,11610969.png,368720,17337,351383,0.9529805814710349,3,6,84111,2551,81560,0.9696710299485204,24.066007111111112,3590.849722666667,12.578831306185476,135,2.1E-4
6,test_20231031_155744,10350842.png,212614,3392,209222,0.9840462058001825,2,6,42529,499,42030,0.9882668296926803,22.827879111111113,3246.082464,13.0172081235082,135,2.1E-4
7,test_20231031_155744,10863862.png,317432,6032,311400,0.980997504977444,3,6,66058,886,65172,0.9865875442792698,36.04656,6605.741237333334,9.931588035317864,135,2.1E-4
8,test_20231031_155744,11382381.png,312486,647,311839,0.9979295072419244,2,6,46745,87,46658,0.9981388383784362,22.33832177777778,2675.8690666666666,13.85615501777858,135,2.1E-4
9,test_20231031_155744,11079715.png,443815,94754,349061,0.7865011322285187,5,7,124136,13324,110812,0.8926661081394599,18.728499555555555,2605.7314826666666,13.97150700682634,135,2.1E-4
10,test_20231031_155744,11551286.png,271883,164,271719,0.9993967993585476,2,5,40092,22,40070,0.9994512620971765,18.120286222222223,1899.5769013333334,15.344234809036362,135,2.1E-4
1,test_20231031_155745,10404007.png,502730,12162,490568,0.9758080878403914,4,6,61265,1779,59486,0.9709622133355097,26.55992,3673.92888,12.479496158993475,135,2.2E-4
2,test_20231031_155745,1254659.png,342646,55202,287444,0.8388949528084378,5,6,80080,7779,72301,0.9028596403596404,23.353802666666667,3980.109952,12.131852910838479,135,2.2E-4
3,test_20231031_155745,10188041.png,221231,7359,213872,0.9667361264922185,4,5,41731,1044,40687,0.9749826268241835,12.082014222222222,1435.143152,16.561851378307132,135,2.2E-4
4,test_20231031_155745,10287332.png,216980,9832,207148,0.9546870679325283,3,6,22337,1355,20982,0.9393383175896495,10.154837333333333,1008.1934186666666,18.095365027648654,135,2.2E-4
5,test_20231031_155745,11610969.png,368720,17337,351383,0.9529805814710349,3,6,84111,2551,81560,0.9696710299485204,24.066007111111112,3590.849722666667,12.578831306185476,135,2.2E-4
6,test_20231031_155745,10350842.png,212614,3392,209222,0.9840462058001825,2,6,42529,499,42030,0.9882668296926803,22.827879111111113,3246.082464,13.0172081235082,135,2.2E-4
7,test_20231031_155745,10863862.png,317432,6032,311400,0.980997504977444,2,5,66058,886,65172,0.9865875442792698,36.04656,6605.741237333334,9.931588035317864,135,2.2E-4
8,test_20231031_155745,11382381.png,312486,647,311839,0.9979295072419244,2,5,46745,87,46658,0.9981388383784362,22.33832177777778,2675.8690666666666,13.85615501777858,135,2.2E-4
9,test_20231031_155745,11079715.png,443815,94754,349061,0.7865011322285187,5,8,124136,13324,110812,0.8926661081394599,18.728499555555555,2605.7314826666666,13.97150700682634,135,2.2E-4
10,test_20231031_155745,11551286.png,271883,164,271719,0.9993967993585476,2,6,40092,22,40070,0.9994512620971765,18.120286222222223,1899.5769013333334,15.344234809036362,135,2.2E-4
1,test_20231031_155746,10404007.png,502730,12162,490568,0.9758080878403914,3,5,61265,1779,59486,0.9709622133355097,26.55992,3673.92888,12.479496158993475,135,2.3E-4
2,test_20231031_155746,1254659.png,342646,55202,287444,0.8388949528084378,4,7,80080,7779,72301,0.9028596403596404,23.353802666666667,3980.109952,12.131852910838479,135,2.3E-4
3,test_20231031_155746,10188041.png,221231,7359,213872,0.9667361264922185,3,5,41731,1044,40687,0.9749826268241835,12.082014222222222,1435.143152,16.561851378307132,135,2.3E-4
4,test_20231031_155746,10287332.png,216980,9832,207148,0.9546870679325283,3,6,22337,1355,20982,0.9393383175896495,10.154837333333333,1008.1934186666666,18.095365027648654,135,2.3E-4
5,test_20231031_155746,11610969.png,368720,17337,351383,0.9529805814710349,3,5,84111,2551,81560,0.9696710299485204,24.066007111111112,3590.849722666667,12.578831306185476,135,2.3E-4
6,test_20231031_155746,10350842.png,212614,3392,209222,0.9840462058001825,2,6,42529,499,42030,0.9882668296926803,22.827879111111113,3246.082464,13.0172081235082,135,2.3E-4
7,test_20231031_155746,10863862.png,317432,6032,311400,0.980997504977444,3,6,66058,886,65172,0.9865875442792698,36.04656,6605.741237333334,9.931588035317864,135,2.3E-4
8,test_20231031_155746,11382381.png,312486,647,311839,0.9979295072419244,2,6,46745,87,46658,0.9981388383784362,22.33832177777778,2675.8690666666666,13.85615501777858,135,2.3E-4
9,test_20231031_155746,11079715.png,443815,94754,349061,0.7865011322285187,5,7,124136,13324,110812,0.8926661081394599,18.728499555555555,2605.7314826666666,13.97150700682634,135,2.3E-4
10,test_20231031_155746,11551286.png,271883,164,271719,0.9993967993585476,2,7,40092,22,40070,0.9994512620971765,18.120286222222223,1899.5769013333334,15.344234809036362,135,2.3E-4
1,test_20231031_155747,10404007.png,502730,12162,490568,0.9758080878403914,4,6,61265,1779,59486,0.9709622133355097,26.55992,3673.92888,12.479496158993475,135,2.4E-4
2,test_20231031_155747,1254659.png,342646,55202,287444,0.8388949528084378,5,6,80080,7779,72301,0.9028596403596404,23.353802666666667,3980.109952,12.131852910838479,135,2.4E-4
3,test_20231031_155747,10188041.png,221231,7359,213872,0.9667361264922185,3,6,41731,1044,40687,0.9749826268241835,12.082014222222222,1435.143152,16.561851378307132,135,2.4E-4
4,test_20231031_155747,10287332.png,216980,9832,207148,0.9546870679325283,2,5,22337,1355,20982,0.9393383175896495,10.154837333333333,1008.1934186666666,18.095365027648654,135,2.4E-4
5,test_20231031_155747,11610969.png,368720,17337,351383,0.9529805814710349,3,6,84111,2551,81560,0.9696710299485204,24.066007111111112,3590.849722666667,12.578831306185476,135,2.4E-4
6,test_20231031_155747,10350842.png,212614,3392,209222,0.9840462058001825,4,5,42529,499,42030,0.9882668296926803,22.827879111111113,3246.082464,13.0172081235082,135,2.4E-4
7,test_20231031_155747,10863862.png,317432,6032,311400,0.980997504977444,3,6,66058,886,65172,0.9865875442792698,36.04656,6605.741237333334,9.931588035317864,135,2.4E-4
8,test_20231031_155747,11382381.png,312486,647,311839,0.9979295072419244,2,5,46745,87,46658,0.9981388383784362,22.33832177777778,2675.8690666666666,13.85615501777858,135,2.4E-4
9,test_20231031_155747,11079715.png,443815,94754,349061,0.7865011322285187,5,7,124136,13324,110812,0.8926661081394599,18.728499555555555,2605.7314826666666,13.97150700682634,135,2.4E-4
10,test_20231031_155747,11551286.png,271883,164,271719,0.9993967993585476,2,6,40092,22,40070,0.9994512620971765,18.120286222222223,1899.5769013333334,15.344234809036362,135,2.4E-4
1,test_20231031_155748,10404007.png,502730,12162,490568,0.9758080878403914,3,5,61265,1779,59486,0.9709622133355097,26.55992,3673.92888,12.479496158993475,135,2.5E-4
2,test_20231031_155748,1254659.png,342646,55202,287444,0.8388949528084378,4,6,80080,7779,72301,0.9028596403596404,23.353802666666667,3980.109952,12.131852910838479,135,2.5E-4
3,test_20231031_155748,10188041.png,221231,7359,213872,0.9667361264922185,4,5,41731,1044,40687,0.9749826268241835,12.082014222222222,1435.143152,16.561851378307132,135,2.5E-4
4,test_20231031_155748,10287332.png,216980,9832,207148,0.9546870679325283,3,5,22337,1355,20982,0.9393383175896495,10.154837333333333,1008.1934186666666,18.095365027648654,135,2.5E-4
5,test_20231031_155748,11610969.png,368720,17337,351383,0.9529805814710349,3,6,84111,2551,81560,0.9696710299485204,24.066007111111112,3590.849722666667,12.578831306185476,135,2.5E-4
6,test_20231031_155748,10350842.png,212614,3392,209222,0.9840462058001825,2,5,42529,499,42030,0.9882668296926803,22.827879111111113,3246.082464,13.0172081235082,135,2.5E-4
7,test_20231031_155748,10863862.png,317432,6032,311400,0.980997504977444,2,5,66058,886,65172,0.9865875442792698,36.04656,6605.741237333334,9.931588035317864,135,2.5E-4
8,test_20231031_155748,11382381.png,312486,647,311839,0.9979295072419244,2,5,46745,87,46658,0.9981388383784362,22.33832177777778,2675.8690666666666,13.85615501777858,135,2.5E-4
9,test_20231031_155748,11079715.png,443815,94754,349061,0.7865011322285187,5,6,124136,13324,110812,0.8926661081394599,18.728499555555555,2605.7314826666666,13.97150700682634,135,2.5E-4
10,test_20231031_155748,11551286.png,271883,164,271719,0.9993967993585476,2,5,40092,22,40070,0.9994512620971765,18.120286222222223,1899.5769013333334,15.344234809036362,135,2.5E-4
1,test_20231031_155749,10404007.png,502730,11982,490748,0.976166132914288,4,6,61265,1754,59511,0.9713702766669388,26.782478222222224,3724.0032213333334,12.420703128854885,135,2.6000000000000003E-4
2,test_20231031_155749,1254659.png,342646,55142,287504,0.8390700606456809,4,6,80080,7773,72307,0.9029345654345654,23.363356444444445,3981.192138666667,12.13067223035364,135,2.6000000000000003E-4
3,test_20231031_155749,10188041.png,221231,7197,214034,0.9674683927659324,3,6,41731,1021,40710,0.9755337758500875,12.409082666666666,1482.392304,16.42117209237998,135,2.6000000000000003E-4
4,test_20231031_155749,10287332.png,216980,9832,207148,0.9546870679325283,3,7,22337,1355,20982,0.9393383175896495,10.154837333333333,1008.1934186666666,18.095365027648654,135,2.6000000000000003E-4
5,test_20231031_155749,11610969.png,368720,17257,351463,0.9531975482751139,7,6,84111,2540,81571,0.9698018095136189,24.103752888888888,3594.7265653333334,12.574144997187485,135,2.6000000000000003E-4
6,test_20231031_155749,10350842.png,212614,3329,209285,0.9843425174259456,2,6,42529,490,42039,0.9884784499988243,22.883356444444445,3250.8236266666668,13.010869533660298,135,2.6000000000000003E-4
7,test_20231031_155749,10863862.png,317432,5752,311680,0.9818795836588624,2,6,66058,845,65213,0.9872082109661207,36.77768711111111,6782.79896,9.81671415962192,135,2.6000000000000003E-4
8,test_20231031_155749,11382381.png,312486,527,311959,0.9983135244458952,1,6,46745,69,46676,0.9985239063001391,22.832848,2745.811376,13.744096608790418,135,2.6000000000000003E-4
9,test_20231031_155749,11079715.png,443815,94754,349061,0.7865011322285187,5,7,124136,13324,110812,0.8926661081394599,18.728499555555555,2605.7314826666666,13.97150700682634,135,2.6000000000000003E-4
10,test_20231031_155749,11551286.png,271883,164,271719,0.9993967993585476,2,5,40092,22,40070,0.9994512620971765,18.120286222222223,1899.5769013333334,15.344234809036362,135,2.6000000000000003E-4
1,test_20231031_155750,10404007.png,502730,11982,490748,0.976166132914288,3,6,61265,1754,59511,0.9713702766669388,26.782478222222224,3724.0032213333334,12.420703128854885,135,2.7000000000000006E-4
2,test_20231031_155750,1254659.png,342646,55142,287504,0.8390700606456809,4,6,80080,7773,72307,0.9029345654345654,23.363356444444445,3981.192138666667,12.13067223035364,135,2.7000000000000006E-4
3,test_20231031_155750,10188041.png,221231,7197,214034,0.9674683927659324,2,5,41731,1021,40710,0.9755337758500875,12.409082666666666,1482.392304,16.42117209237998,135,2.7000000000000006E-4
4,test_20231031_155750,10287332.png,216980,9832,207148,0.9546870679325283,3,6,22337,1355,20982,0.9393383175896495,10.154837333333333,1008.1934186666666,18.095365027648654,135,2.7000000000000006E-4
5,test_20231031_155750,11610969.png,368720,17257,351463,0.9531975482751139,3,6,84111,2540,81571,0.9698018095136189,24.103752888888888,3594.7265653333334,12.574144997187485,135,2.7000000000000006E-4
6,test_20231031_155750,10350842.png,212614,3329,209285,0.9843425174259456,2,6,42529,490,42039,0.9884784499988243,22.883356444444445,3250.8236266666668,13.010869533660298,135,2.7000000000000006E-4
7,test_20231031_155750,10863862.png,317432,5752,311680,0.9818795836588624,2,5,66058,845,65213,0.9872082109661207,36.77768711111111,6782.79896,9.81671415962192,135,2.7000000000000006E-4
8,test_20231031_155750,11382381.png,312486,527,311959,0.9983135244458952,1,5,46745,69,46676,0.9985239063001391,22.832848,2745.811376,13.744096608790418,135,2.7000000000000006E-4
9,test_20231031_155750,11079715.png,443815,94754,349061,0.7865011322285187,4,6,124136,13324,110812,0.8926661081394599,18.728499555555555,2605.7314826666666,13.97150700682634,135,2.7000000000000006E-4
10,test_20231031_155750,11551286.png,271883,164,271719,0.9993967993585476,2,5,40092,22,40070,0.9994512620971765,18.120286222222223,1899.5769013333334,15.344234809036362,135,2.7000000000000006E-4
1,test_20231031_155751,10404007.png,502730,11982,490748,0.976166132914288,3,6,61265,1754,59511,0.9713702766669388,26.782478222222224,3724.0032213333334,12.420703128854885,135,2.800000000000001E-4
2,test_20231031_155751,1254659.png,342646,55142,287504,0.8390700606456809,4,6,80080,7773,72307,0.9029345654345654,23.363356444444445,3981.192138666667,12.13067223035364,135,2.800000000000001E-4
3,test_20231031_155751,10188041.png,221231,7197,214034,0.9674683927659324,3,6,41731,1021,40710,0.9755337758500875,12.409082666666666,1482.392304,16.42117209237998,135,2.800000000000001E-4
4,test_20231031_155751,10287332.png,216980,9832,207148,0.9546870679325283,3,6,22337,1355,20982,0.9393383175896495,10.154837333333333,1008.1934186666666,18.095365027648654,135,2.800000000000001E-4
5,test_20231031_155751,11610969.png,368720,17257,351463,0.9531975482751139,3,5,84111,2540,81571,0.9698018095136189,24.103752888888888,3594.7265653333334,12.574144997187485,135,2.800000000000001E-4
6,test_20231031_155751,10350842.png,212614,3329,209285,0.9843425174259456,2,15,42529,490,42039,0.9884784499988243,22.883356444444445,3250.8236266666668,13.010869533660298,135,2.800000000000001E-4
7,test_20231031_155751,10863862.png,317432,5752,311680,0.9818795836588624,3,6,66058,845,65213,0.9872082109661207,36.77768711111111,6782.79896,9.81671415962192,135,2.800000000000001E-4
8,test_20231031_155751,11382381.png,312486,527,311959,0.9983135244458952,2,5,46745,69,46676,0.9985239063001391,22.832848,2745.811376,13.744096608790418,135,2.800000000000001E-4
9,test_20231031_155751,11079715.png,443815,94754,349061,0.7865011322285187,5,6,124136,13324,110812,0.8926661081394599,18.728499555555555,2605.7314826666666,13.97150700682634,135,2.800000000000001E-4
10,test_20231031_155751,11551286.png,271883,164,271719,0.9993967993585476,2,6,40092,22,40070,0.9994512620971765,18.120286222222223,1899.5769013333334,15.344234809036362,135,2.800000000000001E-4
1,test_20231031_155752,10404007.png,502730,11982,490748,0.976166132914288,3,6,61265,1754,59511,0.9713702766669388,26.782478222222224,3724.0032213333334,12.420703128854885,135,2.900000000000001E-4
2,test_20231031_155752,1254659.png,342646,55142,287504,0.8390700606456809,4,6,80080,7773,72307,0.9029345654345654,23.363356444444445,3981.192138666667,12.13067223035364,135,2.900000000000001E-4
3,test_20231031_155752,10188041.png,221231,7197,214034,0.9674683927659324,3,6,41731,1021,40710,0.9755337758500875,12.409082666666666,1482.392304,16.42117209237998,135,2.900000000000001E-4
4,test_20231031_155752,10287332.png,216980,9832,207148,0.9546870679325283,3,6,22337,1355,20982,0.9393383175896495,10.154837333333333,1008.1934186666666,18.095365027648654,135,2.900000000000001E-4
5,test_20231031_155752,11610969.png,368720,17257,351463,0.9531975482751139,3,5,84111,2540,81571,0.9698018095136189,24.103752888888888,3594.7265653333334,12.574144997187485,135,2.900000000000001E-4
6,test_20231031_155752,10350842.png,212614,3329,209285,0.9843425174259456,2,6,42529,490,42039,0.9884784499988243,22.883356444444445,3250.8236266666668,13.010869533660298,135,2.900000000000001E-4
7,test_20231031_155752,10863862.png,317432,5752,311680,0.9818795836588624,3,6,66058,845,65213,0.9872082109661207,36.77768711111111,6782.79896,9.81671415962192,135,2.900000000000001E-4
8,test_20231031_155752,11382381.png,312486,527,311959,0.9983135244458952,2,6,46745,69,46676,0.9985239063001391,22.832848,2745.811376,13.744096608790418,135,2.900000000000001E-4
9,test_20231031_155752,11079715.png,443815,94754,349061,0.7865011322285187,6,7,124136,13324,110812,0.8926661081394599,18.728499555555555,2605.7314826666666,13.97150700682634,135,2.900000000000001E-4
10,test_20231031_155752,11551286.png,271883,164,271719,0.9993967993585476,1,5,40092,22,40070,0.9994512620971765,18.120286222222223,1899.5769013333334,15.344234809036362,135,2.900000000000001E-4
