SN,TestID,FileName,OriginalFileSize,CompressedBinSize,FileSizeDifference,CompressionRate,CompressionTime,DecompressionTime,UniquePixelCountBefore,UniquePixelCountAfter,UniquePixelCountReduction,UniquePixelCountReductionRate,MAE,MSE,PSNR,QuadtreeThreshold,AllowedExceedingThresholdFactor
1,test_20231031_150237,10404007.png,502730,44612,458118,0.9112605175740457,30,20,61265,6320,54945,0.8968415898147393,23.988469333333335,2977.2318826666665,13.392676997378985,110,1.0E-4
2,test_20231031_150237,1254659.png,342646,104222,238424,0.6958318497808234,6,12,80080,14168,65912,0.823076923076923,17.388291555555554,2285.3256426666667,14.541322681746403,110,1.0E-4
3,test_20231031_150237,10188041.png,221231,13599,207632,0.9385303144676831,3,11,41731,1913,39818,0.9541587788454626,9.578883555555555,813.1110293333334,19.029305088353503,110,1.0E-4
4,test_20231031_150237,10287332.png,216980,16302,200678,0.9248686514886164,3,7,22337,2218,20119,0.9007028696781125,8.782759111111112,632.8933973333334,20.117497959512352,110,1.0E-4
5,test_20231031_150237,11610969.png,368720,42309,326411,0.8852543935777826,7,9,84111,6125,77986,0.9271795603428803,17.662497777777777,2100.2251573333333,14.90814504540811,110,1.0E-4
6,test_20231031_150237,10350842.png,212614,10444,202170,0.9508781171512695,3,7,42529,1529,41000,0.964048061322862,16.570321777777778,1764.44336,15.664726391377854,110,1.0E-4
7,test_20231031_150237,10863862.png,317432,23577,293855,0.9257258247435671,4,6,66058,3275,62783,0.9504223561112961,20.08175111111111,2404.3288693333334,14.320864897301146,110,1.0E-4
8,test_20231031_150237,11382381.png,312486,2457,310029,0.9921372477486992,3,7,46745,341,46404,0.9927051021499625,16.771829333333333,1637.4903786666666,15.989016039624108,110,1.0E-4
9,test_20231031_150237,11079715.png,443815,156082,287733,0.6483174295596138,6,7,124136,21528,102608,0.8265773023135916,14.749011555555555,1614.264208,16.05105743315916,110,1.0E-4
10,test_20231031_150237,11551286.png,271883,2347,269536,0.9913676103323856,3,5,40092,342,39750,0.9914696198742892,15.438896,1429.8152693333334,16.57800430180194,110,1.0E-4
1,test_20231031_150239,10404007.png,502730,44612,458118,0.9112605175740457,4,6,61265,6320,54945,0.8968415898147393,23.988469333333335,2977.2318826666665,13.392676997378985,110,2.0E-4
2,test_20231031_150239,1254659.png,342646,104222,238424,0.6958318497808234,5,6,80080,14168,65912,0.823076923076923,17.388291555555554,2285.3256426666667,14.541322681746403,110,2.0E-4
3,test_20231031_150239,10188041.png,221231,13599,207632,0.9385303144676831,4,6,41731,1913,39818,0.9541587788454626,9.578883555555555,813.1110293333334,19.029305088353503,110,2.0E-4
4,test_20231031_150239,10287332.png,216980,16052,200928,0.9260208314130335,3,8,22337,2188,20149,0.9020459327573085,8.913809777777777,659.944448,19.935729812994534,110,2.0E-4
5,test_20231031_150239,11610969.png,368720,42309,326411,0.8852543935777826,6,9,84111,6125,77986,0.9271795603428803,17.662497777777777,2100.2251573333333,14.90814504540811,110,2.0E-4
6,test_20231031_150239,10350842.png,212614,10444,202170,0.9508781171512695,4,9,42529,1529,41000,0.964048061322862,16.570321777777778,1764.44336,15.664726391377854,110,2.0E-4
7,test_20231031_150239,10863862.png,317432,23577,293855,0.9257258247435671,4,8,66058,3275,62783,0.9504223561112961,20.08175111111111,2404.3288693333334,14.320864897301146,110,2.0E-4
8,test_20231031_150239,11382381.png,312486,2347,310139,0.9924892635190057,4,7,46745,325,46420,0.9930473847470318,17.82406577777778,1777.1764213333333,15.633498182576378,110,2.0E-4
9,test_20231031_150239,11079715.png,443815,156082,287733,0.6483174295596138,6,13,124136,21528,102608,0.8265773023135916,14.749011555555555,1614.264208,16.05105743315916,110,2.0E-4
10,test_20231031_150239,11551286.png,271883,2144,269739,0.9921142550288176,3,6,40092,312,39780,0.9922178988326849,15.528675555555555,1436.6126613333333,16.557406711756357,110,2.0E-4
1,test_20231031_150240,10404007.png,502730,44612,458118,0.9112605175740457,5,7,61265,6320,54945,0.8968415898147393,23.988469333333335,2977.2318826666665,13.392676997378985,110,3.0000000000000003E-4
2,test_20231031_150240,1254659.png,342646,104139,238507,0.6960740822890097,5,8,80080,14161,65919,0.8231643356643357,17.40023822222222,2286.743573333333,14.538628936508067,110,3.0000000000000003E-4
3,test_20231031_150240,10188041.png,221231,13459,207772,0.9391631371733618,4,6,41731,1894,39837,0.9546140758668615,9.73372088888889,834.3248426666667,18.917451856378918,110,3.0000000000000003E-4
4,test_20231031_150240,10287332.png,216980,16012,200968,0.9262051802009402,2,11,22337,2182,20155,0.9023145453731477,9.015146666666666,678.0014826666667,19.818497172762928,110,3.0000000000000003E-4
5,test_20231031_150240,11610969.png,368720,42309,326411,0.8852543935777826,4,7,84111,6125,77986,0.9271795603428803,17.662497777777777,2100.2251573333333,14.90814504540811,110,3.0000000000000003E-4
6,test_20231031_150240,10350842.png,212614,10444,202170,0.9508781171512695,2,5,42529,1529,41000,0.964048061322862,16.570321777777778,1764.44336,15.664726391377854,110,3.0000000000000003E-4
7,test_20231031_150240,10863862.png,317432,23337,294095,0.9264818921847828,3,6,66058,3242,62816,0.9509219171031518,20.539557333333335,2460.170330666667,14.22115184208524,110,3.0000000000000003E-4
8,test_20231031_150240,11382381.png,312486,2347,310139,0.9924892635190057,2,5,46745,325,46420,0.9930473847470318,17.82406577777778,1777.1764213333333,15.633498182576378,110,3.0000000000000003E-4
9,test_20231031_150240,11079715.png,443815,156082,287733,0.6483174295596138,6,7,124136,21528,102608,0.8265773023135916,14.749011555555555,1614.264208,16.05105743315916,110,3.0000000000000003E-4
10,test_20231031_150240,11551286.png,271883,2144,269739,0.9921142550288176,2,6,40092,312,39780,0.9922178988326849,15.528675555555555,1436.6126613333333,16.557406711756357,110,3.0000000000000003E-4
1,test_20231031_150241,10404007.png,502730,44612,458118,0.9112605175740457,4,6,61265,6320,54945,0.8968415898147393,23.988469333333335,2977.2318826666665,13.392676997378985,110,4.0E-4
2,test_20231031_150241,1254659.png,342646,104139,238507,0.6960740822890097,5,7,80080,14161,65919,0.8231643356643357,17.40023822222222,2286.743573333333,14.538628936508067,110,4.0E-4
3,test_20231031_150241,10188041.png,221231,13459,207772,0.9391631371733618,3,5,41731,1894,39837,0.9546140758668615,9.73372088888889,834.3248426666667,18.917451856378918,110,4.0E-4
4,test_20231031_150241,10287332.png,216980,16012,200968,0.9262051802009402,2,6,22337,2182,20155,0.9023145453731477,9.015146666666666,678.0014826666667,19.818497172762928,110,4.0E-4
5,test_20231031_150241,11610969.png,368720,42309,326411,0.8852543935777826,4,6,84111,6125,77986,0.9271795603428803,17.662497777777777,2100.2251573333333,14.90814504540811,110,4.0E-4
6,test_20231031_150241,10350842.png,212614,10444,202170,0.9508781171512695,3,6,42529,1529,41000,0.964048061322862,16.570321777777778,1764.44336,15.664726391377854,110,4.0E-4
7,test_20231031_150241,10863862.png,317432,23337,294095,0.9264818921847828,3,6,66058,3242,62816,0.9509219171031518,20.539557333333335,2460.170330666667,14.22115184208524,110,4.0E-4
8,test_20231031_150241,11382381.png,312486,2042,310444,0.9934653072457647,2,6,46745,280,46465,0.9940100545512889,18.51503111111111,1892.3000693333333,15.360903555872536,110,4.0E-4
9,test_20231031_150241,11079715.png,443815,156082,287733,0.6483174295596138,6,7,124136,21528,102608,0.8265773023135916,14.749011555555555,1614.264208,16.05105743315916,110,4.0E-4
10,test_20231031_150241,11551286.png,271883,2144,269739,0.9921142550288176,3,6,40092,312,39780,0.9922178988326849,15.528675555555555,1436.6126613333333,16.557406711756357,110,4.0E-4
1,test_20231031_150242,10404007.png,502730,44612,458118,0.9112605175740457,4,6,61265,6320,54945,0.8968415898147393,23.988469333333335,2977.2318826666665,13.392676997378985,110,5.0E-4
2,test_20231031_150242,1254659.png,342646,104139,238507,0.6960740822890097,5,7,80080,14161,65919,0.8231643356643357,17.40023822222222,2286.743573333333,14.538628936508067,110,5.0E-4
3,test_20231031_150242,10188041.png,221231,13459,207772,0.9391631371733618,3,6,41731,1894,39837,0.9546140758668615,9.73372088888889,834.3248426666667,18.917451856378918,110,5.0E-4
4,test_20231031_150242,10287332.png,216980,16012,200968,0.9262051802009402,3,6,22337,2182,20155,0.9023145453731477,9.015146666666666,678.0014826666667,19.818497172762928,110,5.0E-4
5,test_20231031_150242,11610969.png,368720,42309,326411,0.8852543935777826,4,6,84111,6125,77986,0.9271795603428803,17.662497777777777,2100.2251573333333,14.90814504540811,110,5.0E-4
6,test_20231031_150242,10350842.png,212614,10444,202170,0.9508781171512695,3,6,42529,1529,41000,0.964048061322862,16.570321777777778,1764.44336,15.664726391377854,110,5.0E-4
7,test_20231031_150242,10863862.png,317432,23337,294095,0.9264818921847828,3,5,66058,3242,62816,0.9509219171031518,20.539557333333335,2460.170330666667,14.22115184208524,110,5.0E-4
8,test_20231031_150242,11382381.png,312486,1692,310794,0.9945853574240126,2,6,46745,230,46515,0.9950796876671302,19.014094222222223,1971.496704,15.182843055229895,110,5.0E-4
9,test_20231031_150242,11079715.png,443815,156082,287733,0.6483174295596138,6,7,124136,21528,102608,0.8265773023135916,14.749011555555555,1614.264208,16.05105743315916,110,5.0E-4
10,test_20231031_150242,11551286.png,271883,2144,269739,0.9921142550288176,3,6,40092,312,39780,0.9922178988326849,15.528675555555555,1436.6126613333333,16.557406711756357,110,5.0E-4
1,test_20231031_150244,10404007.png,502730,44612,458118,0.9112605175740457,4,6,61265,6320,54945,0.8968415898147393,23.988469333333335,2977.2318826666665,13.392676997378985,110,6.000000000000001E-4
2,test_20231031_150244,1254659.png,342646,104139,238507,0.6960740822890097,5,7,80080,14161,65919,0.8231643356643357,17.40023822222222,2286.743573333333,14.538628936508067,110,6.000000000000001E-4
3,test_20231031_150244,10188041.png,221231,13459,207772,0.9391631371733618,4,6,41731,1894,39837,0.9546140758668615,9.73372088888889,834.3248426666667,18.917451856378918,110,6.000000000000001E-4
4,test_20231031_150244,10287332.png,216980,15932,201048,0.9265738777767536,2,6,22337,2170,20167,0.902851770604826,9.076064,685.2587413333333,19.77225776651095,110,6.000000000000001E-4
5,test_20231031_150244,11610969.png,368720,42309,326411,0.8852543935777826,4,6,84111,6125,77986,0.9271795603428803,17.662497777777777,2100.2251573333333,14.90814504540811,110,6.000000000000001E-4
6,test_20231031_150244,10350842.png,212614,10444,202170,0.9508781171512695,3,5,42529,1529,41000,0.964048061322862,16.570321777777778,1764.44336,15.664726391377854,110,6.000000000000001E-4
7,test_20231031_150244,10863862.png,317432,23237,294195,0.9267969202852895,4,6,66058,3230,62828,0.9511035756456447,20.549978666666668,2461.8056373333334,14.218265990174125,110,6.000000000000001E-4
8,test_20231031_150244,11382381.png,312486,1692,310794,0.9945853574240126,2,6,46745,230,46515,0.9950796876671302,19.014094222222223,1971.496704,15.182843055229895,110,6.000000000000001E-4
9,test_20231031_150244,11079715.png,443815,156082,287733,0.6483174295596138,6,7,124136,21528,102608,0.8265773023135916,14.749011555555555,1614.264208,16.05105743315916,110,6.000000000000001E-4
10,test_20231031_150244,11551286.png,271883,1732,270151,0.9936296127378321,2,5,40092,251,39841,0.9937393993814227,15.888540444444445,1491.6687146666666,16.39407979666711,110,6.000000000000001E-4
1,test_20231031_150245,10404007.png,502730,44612,458118,0.9112605175740457,4,6,61265,6320,54945,0.8968415898147393,23.988469333333335,2977.2318826666665,13.392676997378985,110,7.000000000000001E-4
2,test_20231031_150245,1254659.png,342646,104139,238507,0.6960740822890097,5,7,80080,14161,65919,0.8231643356643357,17.40023822222222,2286.743573333333,14.538628936508067,110,7.000000000000001E-4
3,test_20231031_150245,10188041.png,221231,13459,207772,0.9391631371733618,3,6,41731,1894,39837,0.9546140758668615,9.73372088888889,834.3248426666667,18.917451856378918,110,7.000000000000001E-4
4,test_20231031_150245,10287332.png,216980,15932,201048,0.9265738777767536,3,6,22337,2170,20167,0.902851770604826,9.076064,685.2587413333333,19.77225776651095,110,7.000000000000001E-4
5,test_20231031_150245,11610969.png,368720,42309,326411,0.8852543935777826,4,6,84111,6125,77986,0.9271795603428803,17.662497777777777,2100.2251573333333,14.90814504540811,110,7.000000000000001E-4
6,test_20231031_150245,10350842.png,212614,10444,202170,0.9508781171512695,3,6,42529,1529,41000,0.964048061322862,16.570321777777778,1764.44336,15.664726391377854,110,7.000000000000001E-4
7,test_20231031_150245,10863862.png,317432,23237,294195,0.9267969202852895,3,5,66058,3230,62828,0.9511035756456447,20.549978666666668,2461.8056373333334,14.218265990174125,110,7.000000000000001E-4
8,test_20231031_150245,11382381.png,312486,1692,310794,0.9945853574240126,2,5,46745,230,46515,0.9950796876671302,19.014094222222223,1971.496704,15.182843055229895,110,7.000000000000001E-4
9,test_20231031_150245,11079715.png,443815,156082,287733,0.6483174295596138,6,7,124136,21528,102608,0.8265773023135916,14.749011555555555,1614.264208,16.05105743315916,110,7.000000000000001E-4
10,test_20231031_150245,11551286.png,271883,1732,270151,0.9936296127378321,3,6,40092,251,39841,0.9937393993814227,15.888540444444445,1491.6687146666666,16.39407979666711,110,7.000000000000001E-4
1,test_20231031_150246,10404007.png,502730,44469,458261,0.9115449644938635,5,6,61265,6300,54965,0.8971680404798825,24.026336,2983.887328,13.382979407776372,110,8.000000000000001E-4
2,test_20231031_150246,1254659.png,342646,104019,238627,0.6964242979634958,5,7,80080,14146,65934,0.8233516483516483,17.73601777777778,2338.304864,14.441792278139156,110,8.000000000000001E-4
3,test_20231031_150246,10188041.png,221231,13317,207914,0.9398050002034073,3,6,41731,1876,39855,0.9550454098871343,9.860412444444444,850.507136,18.834023990481626,110,8.000000000000001E-4
4,test_20231031_150246,10287332.png,216980,15932,201048,0.9265738777767536,3,6,22337,2170,20167,0.902851770604826,9.076064,685.2587413333333,19.77225776651095,110,8.000000000000001E-4
5,test_20231031_150246,11610969.png,368720,42309,326411,0.8852543935777826,4,7,84111,6125,77986,0.9271795603428803,17.662497777777777,2100.2251573333333,14.90814504540811,110,8.000000000000001E-4
6,test_20231031_150246,10350842.png,212614,10444,202170,0.9508781171512695,2,5,42529,1529,41000,0.964048061322862,16.570321777777778,1764.44336,15.664726391377854,110,8.000000000000001E-4
7,test_20231031_150246,10863862.png,317432,22997,294435,0.9275529877265052,3,6,66058,3194,62864,0.9516485512731236,20.60872,2472.5420106666666,14.199366814902143,110,8.000000000000001E-4
8,test_20231031_150246,11382381.png,312486,1692,310794,0.9945853574240126,2,5,46745,230,46515,0.9950796876671302,19.014094222222223,1971.496704,15.182843055229895,110,8.000000000000001E-4
9,test_20231031_150246,11079715.png,443815,156082,287733,0.6483174295596138,6,7,124136,21528,102608,0.8265773023135916,14.749011555555555,1614.264208,16.05105743315916,110,8.000000000000001E-4
10,test_20231031_150246,11551286.png,271883,1592,270291,0.9941445401146817,3,6,40092,230,39862,0.9942631946522997,16.121671111111112,1534.706784,16.270549479959495,110,8.000000000000001E-4
1,test_20231031_150247,10404007.png,502730,44469,458261,0.9115449644938635,4,6,61265,6300,54965,0.8971680404798825,24.026336,2983.887328,13.382979407776372,110,9.000000000000002E-4
2,test_20231031_150247,1254659.png,342646,104019,238627,0.6964242979634958,5,6,80080,14146,65934,0.8233516483516483,17.73601777777778,2338.304864,14.441792278139156,110,9.000000000000002E-4
3,test_20231031_150247,10188041.png,221231,13317,207914,0.9398050002034073,3,5,41731,1876,39855,0.9550454098871343,9.860412444444444,850.507136,18.834023990481626,110,9.000000000000002E-4
4,test_20231031_150247,10287332.png,216980,15932,201048,0.9265738777767536,3,6,22337,2170,20167,0.902851770604826,9.076064,685.2587413333333,19.77225776651095,110,9.000000000000002E-4
5,test_20231031_150247,11610969.png,368720,42309,326411,0.8852543935777826,3,6,84111,6125,77986,0.9271795603428803,17.662497777777777,2100.2251573333333,14.90814504540811,110,9.000000000000002E-4
6,test_20231031_150247,10350842.png,212614,10444,202170,0.9508781171512695,2,5,42529,1529,41000,0.964048061322862,16.570321777777778,1764.44336,15.664726391377854,110,9.000000000000002E-4
7,test_20231031_150247,10863862.png,317432,22997,294435,0.9275529877265052,4,6,66058,3194,62864,0.9516485512731236,20.60872,2472.5420106666666,14.199366814902143,110,9.000000000000002E-4
8,test_20231031_150247,11382381.png,312486,1692,310794,0.9945853574240126,2,5,46745,230,46515,0.9950796876671302,19.014094222222223,1971.496704,15.182843055229895,110,9.000000000000002E-4
9,test_20231031_150247,11079715.png,443815,156082,287733,0.6483174295596138,6,7,124136,21528,102608,0.8265773023135916,14.749011555555555,1614.264208,16.05105743315916,110,9.000000000000002E-4
10,test_20231031_150247,11551286.png,271883,1592,270291,0.9941445401146817,3,6,40092,230,39862,0.9942631946522997,16.121671111111112,1534.706784,16.270549479959495,110,9.000000000000002E-4
1,test_20231031_150248,10404007.png,502730,42562,460168,0.9153382531378672,5,6,61265,6051,55214,0.9012323512609157,24.086816,3002.6337066666665,13.355780053176534,111,1.0E-4
2,test_20231031_150248,1254659.png,342646,102352,240294,0.7012893773749,5,7,80080,13934,66146,0.825999000999001,17.548469333333333,2326.5860053333336,14.46361249431121,111,1.0E-4
3,test_20231031_150248,10188041.png,221231,13479,207752,0.9390727339296934,3,6,41731,1895,39836,0.9545901128657353,9.615207111111111,818.3408213333333,19.001461452195805,111,1.0E-4
4,test_20231031_150248,10287332.png,216980,16082,200898,0.9258825698221034,3,5,22337,2189,20148,0.902001163988002,8.817786666666667,639.4181706666667,20.072953871928956,111,1.0E-4
5,test_20231031_150248,11610969.png,368720,41072,327648,0.8886092427858537,4,6,84111,5950,78161,0.9292601443330837,17.776954666666665,2128.4956853333333,14.850075867107916,111,1.0E-4
6,test_20231031_150248,10350842.png,212614,10102,202512,0.9524866659768406,3,6,42529,1480,41049,0.9652002163229796,16.596364444444443,1770.9004426666668,15.648862143677517,111,1.0E-4
7,test_20231031_150248,10863862.png,317432,23097,294335,0.9272379596259986,3,6,66058,3209,62849,0.9514214780950074,20.177452444444445,2431.6214666666665,14.271843921311088,111,1.0E-4
8,test_20231031_150248,11382381.png,312486,2397,310089,0.9923292563506845,3,5,46745,332,46413,0.9928976361108139,16.784181333333333,1639.3545173333334,15.984074791261948,111,1.0E-4
9,test_20231031_150248,11079715.png,443815,153702,290113,0.6536800243344637,6,7,124136,21226,102910,0.8290101179351679,14.857429333333334,1638.0351146666667,15.987571533442999,111,1.0E-4
10,test_20231031_150248,11551286.png,271883,2304,269579,0.9915257665981323,3,6,40092,336,39756,0.9916192756659683,15.449232,1431.308656,16.57347063136679,111,1.0E-4
1,test_20231031_150249,10404007.png,502730,42562,460168,0.9153382531378672,4,6,61265,6051,55214,0.9012323512609157,24.086816,3002.6337066666665,13.355780053176534,111,2.0E-4
2,test_20231031_150249,1254659.png,342646,102352,240294,0.7012893773749,5,7,80080,13934,66146,0.825999000999001,17.548469333333333,2326.5860053333336,14.46361249431121,111,2.0E-4
3,test_20231031_150249,10188041.png,221231,13479,207752,0.9390727339296934,4,6,41731,1895,39836,0.9545901128657353,9.615207111111111,818.3408213333333,19.001461452195805,111,2.0E-4
4,test_20231031_150249,10287332.png,216980,15832,201148,0.9270347497465204,2,5,22337,2159,20178,0.903344227067198,8.948837333333334,666.4692213333333,19.893002631026448,111,2.0E-4
5,test_20231031_150249,11610969.png,368720,41072,327648,0.8886092427858537,4,6,84111,5950,78161,0.9292601443330837,17.776954666666665,2128.4956853333333,14.850075867107916,111,2.0E-4
6,test_20231031_150249,10350842.png,212614,10102,202512,0.9524866659768406,3,6,42529,1480,41049,0.9652002163229796,16.596364444444443,1770.9004426666668,15.648862143677517,111,2.0E-4
7,test_20231031_150249,10863862.png,317432,23097,294335,0.9272379596259986,3,6,66058,3209,62849,0.9514214780950074,20.177452444444445,2431.6214666666665,14.271843921311088,111,2.0E-4
8,test_20231031_150249,11382381.png,312486,2284,310202,0.9926908725510903,3,5,46745,316,46429,0.9932399187078832,17.83641777777778,1779.04056,15.628945112756188,111,2.0E-4
9,test_20231031_150249,11079715.png,443815,153702,290113,0.6536800243344637,6,7,124136,21226,102910,0.8290101179351679,14.857429333333334,1638.0351146666667,15.987571533442999,111,2.0E-4
10,test_20231031_150249,11551286.png,271883,2104,269779,0.9922613771364889,2,6,40092,306,39786,0.992367554624364,15.539011555555556,1438.106048,16.55289448142983,111,2.0E-4
1,test_20231031_150250,10404007.png,502730,42562,460168,0.9153382531378672,5,7,61265,6051,55214,0.9012323512609157,24.086816,3002.6337066666665,13.355780053176534,111,3.0000000000000003E-4
2,test_20231031_150250,1254659.png,342646,102272,240374,0.7015228544912242,5,7,80080,13927,66153,0.8260864135864135,17.560416,2328.003936,14.460966506195977,111,3.0000000000000003E-4
3,test_20231031_150250,10188041.png,221231,13337,207894,0.9397145969597389,3,5,41731,1876,39855,0.9550454098871343,9.770044444444444,839.5546346666666,18.89031397425179,111,3.0000000000000003E-4
4,test_20231031_150250,10287332.png,216980,15792,201188,0.9272190985344271,3,6,22337,2153,20184,0.9036128396830371,9.050174222222223,684.526256,19.776902500820096,111,3.0000000000000003E-4
5,test_20231031_150250,11610969.png,368720,41072,327648,0.8886092427858537,4,6,84111,5950,78161,0.9292601443330837,17.776954666666665,2128.4956853333333,14.850075867107916,111,3.0000000000000003E-4
6,test_20231031_150250,10350842.png,212614,10102,202512,0.9524866659768406,3,5,42529,1480,41049,0.9652002163229796,16.596364444444443,1770.9004426666668,15.648862143677517,111,3.0000000000000003E-4
7,test_20231031_150250,10863862.png,317432,22854,294578,0.9280034779102296,3,6,66058,3176,62882,0.9519210390868631,20.635258666666665,2487.462928,14.173237439265321,111,3.0000000000000003E-4
8,test_20231031_150250,11382381.png,312486,2284,310202,0.9926908725510903,3,5,46745,316,46429,0.9932399187078832,17.83641777777778,1779.04056,15.628945112756188,111,3.0000000000000003E-4
9,test_20231031_150250,11079715.png,443815,153702,290113,0.6536800243344637,6,7,124136,21226,102910,0.8290101179351679,14.857429333333334,1638.0351146666667,15.987571533442999,111,3.0000000000000003E-4
10,test_20231031_150250,11551286.png,271883,2104,269779,0.9922613771364889,2,6,40092,306,39786,0.992367554624364,15.539011555555556,1438.106048,16.55289448142983,111,3.0000000000000003E-4
1,test_20231031_150251,10404007.png,502730,42562,460168,0.9153382531378672,4,6,61265,6051,55214,0.9012323512609157,24.086816,3002.6337066666665,13.355780053176534,111,4.0E-4
2,test_20231031_150251,1254659.png,342646,102272,240374,0.7015228544912242,5,7,80080,13927,66153,0.8260864135864135,17.560416,2328.003936,14.460966506195977,111,4.0E-4
3,test_20231031_150251,10188041.png,221231,13337,207894,0.9397145969597389,4,6,41731,1876,39855,0.9550454098871343,9.770044444444444,839.5546346666666,18.89031397425179,111,4.0E-4
4,test_20231031_150251,10287332.png,216980,15792,201188,0.9272190985344271,3,5,22337,2153,20184,0.9036128396830371,9.050174222222223,684.526256,19.776902500820096,111,4.0E-4
5,test_20231031_150251,11610969.png,368720,41072,327648,0.8886092427858537,4,6,84111,5950,78161,0.9292601443330837,17.776954666666665,2128.4956853333333,14.850075867107916,111,4.0E-4
6,test_20231031_150251,10350842.png,212614,10102,202512,0.9524866659768406,2,5,42529,1480,41049,0.9652002163229796,16.596364444444443,1770.9004426666668,15.648862143677517,111,4.0E-4
7,test_20231031_150251,10863862.png,317432,22854,294578,0.9280034779102296,3,6,66058,3176,62882,0.9519210390868631,20.635258666666665,2487.462928,14.173237439265321,111,4.0E-4
8,test_20231031_150251,11382381.png,312486,1982,310504,0.99365731584775,3,6,46745,271,46474,0.9942025885121404,18.52738311111111,1894.164208,15.356627349139568,111,4.0E-4
9,test_20231031_150251,11079715.png,443815,153702,290113,0.6536800243344637,5,7,124136,21226,102910,0.8290101179351679,14.857429333333334,1638.0351146666667,15.987571533442999,111,4.0E-4
10,test_20231031_150251,11551286.png,271883,2104,269779,0.9922613771364889,2,5,40092,306,39786,0.992367554624364,15.539011555555556,1438.106048,16.55289448142983,111,4.0E-4
1,test_20231031_150252,10404007.png,502730,42562,460168,0.9153382531378672,4,6,61265,6051,55214,0.9012323512609157,24.086816,3002.6337066666665,13.355780053176534,111,5.0E-4
2,test_20231031_150252,1254659.png,342646,102272,240374,0.7015228544912242,6,6,80080,13927,66153,0.8260864135864135,17.560416,2328.003936,14.460966506195977,111,5.0E-4
3,test_20231031_150252,10188041.png,221231,13337,207894,0.9397145969597389,3,6,41731,1876,39855,0.9550454098871343,9.770044444444444,839.5546346666666,18.89031397425179,111,5.0E-4
4,test_20231031_150252,10287332.png,216980,15792,201188,0.9272190985344271,3,6,22337,2153,20184,0.9036128396830371,9.050174222222223,684.526256,19.776902500820096,111,5.0E-4
5,test_20231031_150252,11610969.png,368720,41072,327648,0.8886092427858537,3,6,84111,5950,78161,0.9292601443330837,17.776954666666665,2128.4956853333333,14.850075867107916,111,5.0E-4
6,test_20231031_150252,10350842.png,212614,10102,202512,0.9524866659768406,3,6,42529,1480,41049,0.9652002163229796,16.596364444444443,1770.9004426666668,15.648862143677517,111,5.0E-4
7,test_20231031_150252,10863862.png,317432,22854,294578,0.9280034779102296,3,6,66058,3176,62882,0.9519210390868631,20.635258666666665,2487.462928,14.173237439265321,111,5.0E-4
8,test_20231031_150252,11382381.png,312486,1692,310794,0.9945853574240126,3,6,46745,230,46515,0.9950796876671302,19.014094222222223,1971.496704,15.182843055229895,111,5.0E-4
9,test_20231031_150252,11079715.png,443815,153702,290113,0.6536800243344637,6,6,124136,21226,102910,0.8290101179351679,14.857429333333334,1638.0351146666667,15.987571533442999,111,5.0E-4
10,test_20231031_150252,11551286.png,271883,2104,269779,0.9922613771364889,2,5,40092,306,39786,0.992367554624364,15.539011555555556,1438.106048,16.55289448142983,111,5.0E-4
1,test_20231031_150253,10404007.png,502730,42482,460248,0.9154973842818213,4,6,61265,6039,55226,0.9014282216600016,24.120597333333333,3008.5279466666666,13.347263107950143,111,6.000000000000001E-4
2,test_20231031_150253,1254659.png,342646,102212,240434,0.7016979623284673,5,6,80080,13921,66159,0.8261613386613387,17.583310222222224,2329.983584,14.457274996716468,111,6.000000000000001E-4
3,test_20231031_150253,10188041.png,221231,13337,207894,0.9397145969597389,4,6,41731,1876,39855,0.9550454098871343,9.770044444444444,839.5546346666666,18.89031397425179,111,6.000000000000001E-4
4,test_20231031_150253,10287332.png,216980,15712,201268,0.9275877961102406,3,6,22337,2141,20196,0.9041500649147155,9.111091555555555,691.7835146666666,19.73110152386741,111,6.000000000000001E-4
5,test_20231031_150253,11610969.png,368720,41072,327648,0.8886092427858537,4,6,84111,5950,78161,0.9292601443330837,17.776954666666665,2128.4956853333333,14.850075867107916,111,6.000000000000001E-4
6,test_20231031_150253,10350842.png,212614,10102,202512,0.9524866659768406,3,6,42529,1480,41049,0.9652002163229796,16.596364444444443,1770.9004426666668,15.648862143677517,111,6.000000000000001E-4
7,test_20231031_150253,10863862.png,317432,22512,294920,0.929080874013962,3,6,66058,3128,62930,0.9526476732568349,20.704421333333332,2499.834608,14.151690846794882,111,6.000000000000001E-4
8,test_20231031_150253,11382381.png,312486,1692,310794,0.9945853574240126,3,6,46745,230,46515,0.9950796876671302,19.014094222222223,1971.496704,15.182843055229895,111,6.000000000000001E-4
9,test_20231031_150253,11079715.png,443815,153702,290113,0.6536800243344637,6,7,124136,21226,102910,0.8290101179351679,14.857429333333334,1638.0351146666667,15.987571533442999,111,6.000000000000001E-4
10,test_20231031_150253,11551286.png,271883,1672,270211,0.993850295899339,2,5,40092,242,39850,0.9939638830689415,15.980974222222223,1516.8482986666668,16.321382120827387,111,6.000000000000001E-4
1,test_20231031_150254,10404007.png,502730,42482,460248,0.9154973842818213,4,6,61265,6039,55226,0.9014282216600016,24.120597333333333,3008.5279466666666,13.347263107950143,111,7.000000000000001E-4
2,test_20231031_150254,1254659.png,342646,102212,240434,0.7016979623284673,5,6,80080,13921,66159,0.8261613386613387,17.583310222222224,2329.983584,14.457274996716468,111,7.000000000000001E-4
3,test_20231031_150254,10188041.png,221231,13337,207894,0.9397145969597389,3,5,41731,1876,39855,0.9550454098871343,9.770044444444444,839.5546346666666,18.89031397425179,111,7.000000000000001E-4
4,test_20231031_150254,10287332.png,216980,15712,201268,0.9275877961102406,4,6,22337,2141,20196,0.9041500649147155,9.111091555555555,691.7835146666666,19.73110152386741,111,7.000000000000001E-4
5,test_20231031_150254,11610969.png,368720,41072,327648,0.8886092427858537,4,6,84111,5950,78161,0.9292601443330837,17.776954666666665,2128.4956853333333,14.850075867107916,111,7.000000000000001E-4
6,test_20231031_150254,10350842.png,212614,10102,202512,0.9524866659768406,3,6,42529,1480,41049,0.9652002163229796,16.596364444444443,1770.9004426666668,15.648862143677517,111,7.000000000000001E-4
7,test_20231031_150254,10863862.png,317432,22512,294920,0.929080874013962,4,6,66058,3128,62930,0.9526476732568349,20.704421333333332,2499.834608,14.151690846794882,111,7.000000000000001E-4
8,test_20231031_150254,11382381.png,312486,1692,310794,0.9945853574240126,3,6,46745,230,46515,0.9950796876671302,19.014094222222223,1971.496704,15.182843055229895,111,7.000000000000001E-4
9,test_20231031_150254,11079715.png,443815,153702,290113,0.6536800243344637,6,7,124136,21226,102910,0.8290101179351679,14.857429333333334,1638.0351146666667,15.987571533442999,111,7.000000000000001E-4
10,test_20231031_150254,11551286.png,271883,1672,270211,0.993850295899339,2,5,40092,242,39850,0.9939638830689415,15.980974222222223,1516.8482986666668,16.321382120827387,111,7.000000000000001E-4
1,test_20231031_150255,10404007.png,502730,42259,460471,0.9159409623455931,4,6,61265,6010,55255,0.9019015751244593,24.133996444444445,3010.824688,13.343948923863012,111,8.000000000000001E-4
2,test_20231031_150255,1254659.png,342646,102152,240494,0.7018730701657103,5,7,80080,13912,66168,0.8262737262737263,17.896195555555554,2379.5652266666666,14.365827470501518,111,8.000000000000001E-4
3,test_20231031_150255,10188041.png,221231,13217,208014,0.9402570164217492,3,5,41731,1861,39870,0.9554048549040282,9.895552,855.5378666666667,18.808411244069966,111,8.000000000000001E-4
4,test_20231031_150255,10287332.png,216980,15712,201268,0.9275877961102406,3,6,22337,2141,20196,0.9041500649147155,9.111091555555555,691.7835146666666,19.73110152386741,111,8.000000000000001E-4
5,test_20231031_150255,11610969.png,368720,41072,327648,0.8886092427858537,5,14,84111,5950,78161,0.9292601443330837,17.776954666666665,2128.4956853333333,14.850075867107916,111,8.000000000000001E-4
6,test_20231031_150255,10350842.png,212614,10102,202512,0.9524866659768406,3,5,42529,1480,41049,0.9652002163229796,16.596364444444443,1770.9004426666668,15.648862143677517,111,8.000000000000001E-4
7,test_20231031_150255,10863862.png,317432,22512,294920,0.929080874013962,3,5,66058,3128,62930,0.9526476732568349,20.704421333333332,2499.834608,14.151690846794882,111,8.000000000000001E-4
8,test_20231031_150255,11382381.png,312486,1492,310994,0.9952253860972972,2,5,46745,201,46544,0.9957000748743181,19.88124977777778,2121.948410666667,14.863455398488405,111,8.000000000000001E-4
9,test_20231031_150255,11079715.png,443815,153702,290113,0.6536800243344637,6,7,124136,21226,102910,0.8290101179351679,14.857429333333334,1638.0351146666667,15.987571533442999,111,8.000000000000001E-4
10,test_20231031_150255,11551286.png,271883,1552,270331,0.994291662222353,2,5,40092,224,39868,0.9944128504439789,16.13200711111111,1536.2001706666667,16.266325518443356,111,8.000000000000001E-4
1,test_20231031_150256,10404007.png,502730,42259,460471,0.9159409623455931,5,10,61265,6010,55255,0.9019015751244593,24.133996444444445,3010.824688,13.343948923863012,111,9.000000000000002E-4
2,test_20231031_150256,1254659.png,342646,102152,240494,0.7018730701657103,11,7,80080,13912,66168,0.8262737262737263,17.896195555555554,2379.5652266666666,14.365827470501518,111,9.000000000000002E-4
3,test_20231031_150256,10188041.png,221231,13217,208014,0.9402570164217492,3,6,41731,1861,39870,0.9554048549040282,9.895552,855.5378666666667,18.808411244069966,111,9.000000000000002E-4
4,test_20231031_150256,10287332.png,216980,15712,201268,0.9275877961102406,3,6,22337,2141,20196,0.9041500649147155,9.111091555555555,691.7835146666666,19.73110152386741,111,9.000000000000002E-4
5,test_20231031_150256,11610969.png,368720,41072,327648,0.8886092427858537,4,6,84111,5950,78161,0.9292601443330837,17.776954666666665,2128.4956853333333,14.850075867107916,111,9.000000000000002E-4
6,test_20231031_150256,10350842.png,212614,10102,202512,0.9524866659768406,3,6,42529,1480,41049,0.9652002163229796,16.596364444444443,1770.9004426666668,15.648862143677517,111,9.000000000000002E-4
7,test_20231031_150256,10863862.png,317432,22512,294920,0.929080874013962,3,6,66058,3128,62930,0.9526476732568349,20.704421333333332,2499.834608,14.151690846794882,111,9.000000000000002E-4
8,test_20231031_150256,11382381.png,312486,1492,310994,0.9952253860972972,2,5,46745,201,46544,0.9957000748743181,19.88124977777778,2121.948410666667,14.863455398488405,111,9.000000000000002E-4
9,test_20231031_150256,11079715.png,443815,153702,290113,0.6536800243344637,6,7,124136,21226,102910,0.8290101179351679,14.857429333333334,1638.0351146666667,15.987571533442999,111,9.000000000000002E-4
10,test_20231031_150256,11551286.png,271883,1552,270331,0.994291662222353,2,5,40092,224,39868,0.9944128504439789,16.13200711111111,1536.2001706666667,16.266325518443356,111,9.000000000000002E-4
1,test_20231031_150257,10404007.png,502730,40562,462168,0.9193165317367176,4,6,61265,5781,55484,0.9056394352403493,24.198807111111112,3032.4103626666665,13.312923887817647,112,1.0E-4
2,test_20231031_150257,1254659.png,342646,100322,242324,0.707213859201625,5,7,80080,13688,66392,0.829070929070929,17.702723555555554,2370.512362666667,14.382381362798345,112,1.0E-4
3,test_20231031_150257,10188041.png,221231,13357,207874,0.9396241937160705,3,5,41731,1877,39854,0.955021446886008,9.619735111111112,819.4404426666666,18.99562966550357,112,1.0E-4
4,test_20231031_150257,10287332.png,216980,15639,201341,0.9279242326481704,2,6,22337,2128,20209,0.9047320589157004,8.884620444444444,655.7799306666667,19.96322239376424,112,1.0E-4
5,test_20231031_150257,11610969.png,368720,39927,328793,0.8917145801692341,8,6,84111,5787,78324,0.931198059706816,17.871916444444444,2153.556826666667,14.799240247357917,112,1.0E-4
6,test_20231031_150257,10350842.png,212614,9822,202792,0.9538036065357879,2,6,42529,1443,41086,0.9660702109149051,16.63639111111111,1781.0150933333334,15.624127609309976,112,1.0E-4
7,test_20231031_150257,10863862.png,317432,22312,295120,0.9297109302149752,4,6,66058,3109,62949,0.9529352992824488,20.32387911111111,2472.4010453333335,14.199614423279954,112,1.0E-4
8,test_20231031_150257,11382381.png,312486,2234,310252,0.9928508797194114,2,5,46745,309,46436,0.993389667344101,16.840869333333334,1653.1444533333333,15.947695565738101,112,1.0E-4
9,test_20231031_150257,11079715.png,443815,151127,292688,0.6594819913702781,5,7,124136,20873,103263,0.8318537732809177,14.988039111111112,1666.828928,15.911893317886015,112,1.0E-4
10,test_20231031_150257,11551286.png,271883,2224,269659,0.9918200108134749,2,5,40092,324,39768,0.9919185872493266,15.456133333333334,1432.7616906666667,16.56906400083397,112,1.0E-4
1,test_20231031_150258,10404007.png,502730,40562,462168,0.9193165317367176,4,6,61265,5781,55484,0.9056394352403493,24.198807111111112,3032.4103626666665,13.312923887817647,112,2.0E-4
2,test_20231031_150258,1254659.png,342646,100322,242324,0.707213859201625,5,17,80080,13688,66392,0.829070929070929,17.702723555555554,2370.512362666667,14.382381362798345,112,2.0E-4
3,test_20231031_150258,10188041.png,221231,13357,207874,0.9396241937160705,3,6,41731,1877,39854,0.955021446886008,9.619735111111112,819.4404426666666,18.99562966550357,112,2.0E-4
4,test_20231031_150258,10287332.png,216980,15387,201593,0.9290856300119826,3,6,22337,2098,20239,0.9060751219948964,9.01567111111111,682.8309813333333,19.78767143215982,112,2.0E-4
5,test_20231031_150258,11610969.png,368720,39927,328793,0.8917145801692341,5,6,84111,5787,78324,0.931198059706816,17.871916444444444,2153.556826666667,14.799240247357917,112,2.0E-4
6,test_20231031_150258,10350842.png,212614,9822,202792,0.9538036065357879,2,5,42529,1443,41086,0.9660702109149051,16.63639111111111,1781.0150933333334,15.624127609309976,112,2.0E-4
7,test_20231031_150258,10863862.png,317432,22312,295120,0.9297109302149752,3,5,66058,3109,62949,0.9529352992824488,20.32387911111111,2472.4010453333335,14.199614423279954,112,2.0E-4
8,test_20231031_150258,11382381.png,312486,2124,310362,0.993202895489718,3,11,46745,293,46452,0.9937319499411702,17.893105777777777,1792.830496,15.595411299402599,112,2.0E-4
9,test_20231031_150258,11079715.png,443815,151127,292688,0.6594819913702781,6,7,124136,20873,103263,0.8318537732809177,14.988039111111112,1666.828928,15.911893317886015,112,2.0E-4
10,test_20231031_150258,11551286.png,271883,2022,269861,0.992562977457215,2,5,40092,294,39798,0.9926668662077223,15.54591288888889,1439.5590826666667,16.548508668885816,112,2.0E-4
1,test_20231031_150259,10404007.png,502730,40562,462168,0.9193165317367176,4,6,61265,5781,55484,0.9056394352403493,24.198807111111112,3032.4103626666665,13.312923887817647,112,3.0000000000000003E-4
2,test_20231031_150259,1254659.png,342646,100242,242404,0.7074473363179492,5,7,80080,13681,66399,0.8291583416583417,17.71467022222222,2371.9302933333333,14.379784391038125,112,3.0000000000000003E-4
3,test_20231031_150259,10188041.png,221231,13217,208014,0.9402570164217492,4,6,41731,1858,39873,0.955476743907407,9.774572444444445,840.654256,18.884629448380224,112,3.0000000000000003E-4
4,test_20231031_150259,10287332.png,216980,15347,201633,0.9292699787998894,3,6,22337,2092,20245,0.9063437346107356,9.117008,700.888016,19.67431726522211,112,3.0000000000000003E-4
5,test_20231031_150259,11610969.png,368720,39927,328793,0.8917145801692341,4,6,84111,5787,78324,0.931198059706816,17.871916444444444,2153.556826666667,14.799240247357917,112,3.0000000000000003E-4
6,test_20231031_150259,10350842.png,212614,9822,202792,0.9538036065357879,2,6,42529,1443,41086,0.9660702109149051,16.63639111111111,1781.0150933333334,15.624127609309976,112,3.0000000000000003E-4
7,test_20231031_150259,10863862.png,317432,21829,295603,0.9312325159404219,3,5,66058,3040,63018,0.9539798359017833,20.840426666666666,2538.97888,14.084212725730012,112,3.0000000000000003E-4
8,test_20231031_150259,11382381.png,312486,2124,310362,0.993202895489718,3,5,46745,293,46452,0.9937319499411702,17.893105777777777,1792.830496,15.595411299402599,112,3.0000000000000003E-4
9,test_20231031_150259,11079715.png,443815,151127,292688,0.6594819913702781,6,7,124136,20873,103263,0.8318537732809177,14.988039111111112,1666.828928,15.911893317886015,112,3.0000000000000003E-4
10,test_20231031_150259,11551286.png,271883,2022,269861,0.992562977457215,2,5,40092,294,39798,0.9926668662077223,15.54591288888889,1439.5590826666667,16.548508668885816,112,3.0000000000000003E-4
1,test_20231031_150300,10404007.png,502730,40562,462168,0.9193165317367176,4,6,61265,5781,55484,0.9056394352403493,24.198807111111112,3032.4103626666665,13.312923887817647,112,4.0E-4
2,test_20231031_150300,1254659.png,342646,100242,242404,0.7074473363179492,5,7,80080,13681,66399,0.8291583416583417,17.71467022222222,2371.9302933333333,14.379784391038125,112,4.0E-4
3,test_20231031_150300,10188041.png,221231,13217,208014,0.9402570164217492,3,5,41731,1858,39873,0.955476743907407,9.774572444444445,840.654256,18.884629448380224,112,4.0E-4
4,test_20231031_150300,10287332.png,216980,15347,201633,0.9292699787998894,3,6,22337,2092,20245,0.9063437346107356,9.117008,700.888016,19.67431726522211,112,4.0E-4
5,test_20231031_150300,11610969.png,368720,39927,328793,0.8917145801692341,4,6,84111,5787,78324,0.931198059706816,17.871916444444444,2153.556826666667,14.799240247357917,112,4.0E-4
6,test_20231031_150300,10350842.png,212614,9822,202792,0.9538036065357879,2,5,42529,1443,41086,0.9660702109149051,16.63639111111111,1781.0150933333334,15.624127609309976,112,4.0E-4
7,test_20231031_150300,10863862.png,317432,21829,295603,0.9312325159404219,3,6,66058,3040,63018,0.9539798359017833,20.840426666666666,2538.97888,14.084212725730012,112,4.0E-4
8,test_20231031_150300,11382381.png,312486,1612,310874,0.9948413688933264,2,6,46745,219,46526,0.9953150069526152,19.040750222222222,1976.613024,15.171587082419844,112,4.0E-4
9,test_20231031_150300,11079715.png,443815,151127,292688,0.6594819913702781,6,7,124136,20873,103263,0.8318537732809177,14.988039111111112,1666.828928,15.911893317886015,112,4.0E-4
10,test_20231031_150300,11551286.png,271883,2022,269861,0.992562977457215,3,6,40092,294,39798,0.9926668662077223,15.54591288888889,1439.5590826666667,16.548508668885816,112,4.0E-4
1,test_20231031_150302,10404007.png,502730,40562,462168,0.9193165317367176,4,6,61265,5781,55484,0.9056394352403493,24.198807111111112,3032.4103626666665,13.312923887817647,112,5.0E-4
2,test_20231031_150302,1254659.png,342646,100242,242404,0.7074473363179492,5,7,80080,13681,66399,0.8291583416583417,17.71467022222222,2371.9302933333333,14.379784391038125,112,5.0E-4
3,test_20231031_150302,10188041.png,221231,13217,208014,0.9402570164217492,3,6,41731,1858,39873,0.955476743907407,9.774572444444445,840.654256,18.884629448380224,112,5.0E-4
4,test_20231031_150302,10287332.png,216980,15347,201633,0.9292699787998894,3,6,22337,2092,20245,0.9063437346107356,9.117008,700.888016,19.67431726522211,112,5.0E-4
5,test_20231031_150302,11610969.png,368720,39927,328793,0.8917145801692341,4,6,84111,5787,78324,0.931198059706816,17.871916444444444,2153.556826666667,14.799240247357917,112,5.0E-4
6,test_20231031_150302,10350842.png,212614,9822,202792,0.9538036065357879,2,5,42529,1443,41086,0.9660702109149051,16.63639111111111,1781.0150933333334,15.624127609309976,112,5.0E-4
7,test_20231031_150302,10863862.png,317432,21829,295603,0.9312325159404219,4,6,66058,3040,63018,0.9539798359017833,20.840426666666666,2538.97888,14.084212725730012,112,5.0E-4
8,test_20231031_150302,11382381.png,312486,1612,310874,0.9948413688933264,2,6,46745,219,46526,0.9953150069526152,19.040750222222222,1976.613024,15.171587082419844,112,5.0E-4
9,test_20231031_150302,11079715.png,443815,151127,292688,0.6594819913702781,6,6,124136,20873,103263,0.8318537732809177,14.988039111111112,1666.828928,15.911893317886015,112,5.0E-4
10,test_20231031_150302,11551286.png,271883,1652,270231,0.9939238569531748,3,6,40092,239,39853,0.994038710964781,15.832826666666667,1484.6633013333333,16.414523873174964,112,5.0E-4
1,test_20231031_150303,10404007.png,502730,40482,462248,0.9194756628806715,4,6,61265,5769,55496,0.9058353056394353,24.232588444444445,3038.3046026666666,13.304490493312972,112,6.000000000000001E-4
2,test_20231031_150303,1254659.png,342646,100182,242464,0.7076224441551923,5,7,80080,13675,66405,0.8292332667332667,17.737564444444445,2373.9099413333333,14.376161217016818,112,6.000000000000001E-4
3,test_20231031_150303,10188041.png,221231,13217,208014,0.9402570164217492,3,5,41731,1858,39873,0.955476743907407,9.774572444444445,840.654256,18.884629448380224,112,6.000000000000001E-4
4,test_20231031_150303,10287332.png,216980,15267,201713,0.9296386763757029,2,5,22337,2080,20257,0.9068809598424139,9.177925333333333,708.1452746666666,19.629579993447372,112,6.000000000000001E-4
5,test_20231031_150303,11610969.png,368720,39927,328793,0.8917145801692341,4,6,84111,5787,78324,0.931198059706816,17.871916444444444,2153.556826666667,14.799240247357917,112,6.000000000000001E-4
6,test_20231031_150303,10350842.png,212614,9822,202792,0.9538036065357879,2,5,42529,1443,41086,0.9660702109149051,16.63639111111111,1781.0150933333334,15.624127609309976,112,6.000000000000001E-4
7,test_20231031_150303,10863862.png,317432,21729,295703,0.9315475440409284,3,6,66058,3028,63030,0.9541614944442762,20.850848,2540.6141866666667,14.081416420290706,112,6.000000000000001E-4
8,test_20231031_150303,11382381.png,312486,1472,311014,0.9952893889646256,2,5,46745,198,46547,0.9957642528612686,19.881477333333333,2121.993936,14.86336222379639,112,6.000000000000001E-4
9,test_20231031_150303,11079715.png,443815,151127,292688,0.6594819913702781,6,7,124136,20873,103263,0.8318537732809177,14.988039111111112,1666.828928,15.911893317886015,112,6.000000000000001E-4
10,test_20231031_150303,11551286.png,271883,1592,270291,0.9941445401146817,2,5,40092,230,39862,0.9942631946522997,15.987875555555556,1518.3013333333333,16.31722387453005,112,6.000000000000001E-4
1,test_20231031_150304,10404007.png,502730,40482,462248,0.9194756628806715,4,6,61265,5769,55496,0.9058353056394353,24.232588444444445,3038.3046026666666,13.304490493312972,112,7.000000000000001E-4
2,test_20231031_150304,1254659.png,342646,100182,242464,0.7076224441551923,5,7,80080,13675,66405,0.8292332667332667,17.737564444444445,2373.9099413333333,14.376161217016818,112,7.000000000000001E-4
3,test_20231031_150304,10188041.png,221231,13217,208014,0.9402570164217492,4,6,41731,1858,39873,0.955476743907407,9.774572444444445,840.654256,18.884629448380224,112,7.000000000000001E-4
4,test_20231031_150304,10287332.png,216980,15267,201713,0.9296386763757029,3,5,22337,2080,20257,0.9068809598424139,9.177925333333333,708.1452746666666,19.629579993447372,112,7.000000000000001E-4
5,test_20231031_150304,11610969.png,368720,39927,328793,0.8917145801692341,4,6,84111,5787,78324,0.931198059706816,17.871916444444444,2153.556826666667,14.799240247357917,112,7.000000000000001E-4
6,test_20231031_150304,10350842.png,212614,9822,202792,0.9538036065357879,2,7,42529,1443,41086,0.9660702109149051,16.63639111111111,1781.0150933333334,15.624127609309976,112,7.000000000000001E-4
7,test_20231031_150304,10863862.png,317432,21729,295703,0.9315475440409284,3,6,66058,3028,63030,0.9541614944442762,20.850848,2540.6141866666667,14.081416420290706,112,7.000000000000001E-4
8,test_20231031_150304,11382381.png,312486,1472,311014,0.9952893889646256,2,5,46745,198,46547,0.9957642528612686,19.881477333333333,2121.993936,14.86336222379639,112,7.000000000000001E-4
9,test_20231031_150304,11079715.png,443815,151127,292688,0.6594819913702781,5,7,124136,20873,103263,0.8318537732809177,14.988039111111112,1666.828928,15.911893317886015,112,7.000000000000001E-4
10,test_20231031_150304,11551286.png,271883,1592,270291,0.9941445401146817,2,5,40092,230,39862,0.9942631946522997,15.987875555555556,1518.3013333333333,16.31722387453005,112,7.000000000000001E-4
1,test_20231031_150305,10404007.png,502730,40259,462471,0.9199192409444433,4,6,61265,5739,55526,0.9063249816371501,24.245987555555555,3040.601344,13.301208777347501,112,8.000000000000001E-4
2,test_20231031_150305,1254659.png,342646,100122,242524,0.7077975519924353,5,6,80080,13666,66414,0.8293456543456543,18.05044977777778,2423.491584,14.28638844970348,112,8.000000000000001E-4
3,test_20231031_150305,10188041.png,221231,13097,208134,0.9407994358837595,4,6,41731,1843,39888,0.9558361889243009,9.90008,856.637488,18.80283284882432,112,8.000000000000001E-4
4,test_20231031_150305,10287332.png,216980,15267,201713,0.9296386763757029,2,5,22337,2080,20257,0.9068809598424139,9.177925333333333,708.1452746666666,19.629579993447372,112,8.000000000000001E-4
5,test_20231031_150305,11610969.png,368720,39927,328793,0.8917145801692341,5,6,84111,5787,78324,0.931198059706816,17.871916444444444,2153.556826666667,14.799240247357917,112,8.000000000000001E-4
6,test_20231031_150305,10350842.png,212614,9822,202792,0.9538036065357879,2,6,42529,1443,41086,0.9660702109149051,16.63639111111111,1781.0150933333334,15.624127609309976,112,8.000000000000001E-4
7,test_20231031_150305,10863862.png,317432,21729,295703,0.9315475440409284,3,6,66058,3028,63030,0.9541614944442762,20.850848,2540.6141866666667,14.081416420290706,112,8.000000000000001E-4
8,test_20231031_150305,11382381.png,312486,1472,311014,0.9952893889646256,3,6,46745,198,46547,0.9957642528612686,19.881477333333333,2121.993936,14.86336222379639,112,8.000000000000001E-4
9,test_20231031_150305,11079715.png,443815,150927,292888,0.6599326295866521,6,7,124136,20848,103288,0.8320551653025714,15.302609777777779,1719.655104,15.776390078262308,112,8.000000000000001E-4
10,test_20231031_150305,11551286.png,271883,1452,270431,0.9946594674915313,2,5,40092,209,39883,0.9947869899231767,16.17663288888889,1545.593824,16.239849871795663,112,8.000000000000001E-4
1,test_20231031_150306,10404007.png,502730,40259,462471,0.9199192409444433,5,6,61265,5739,55526,0.9063249816371501,24.245987555555555,3040.601344,13.301208777347501,112,9.000000000000002E-4
2,test_20231031_150306,1254659.png,342646,100122,242524,0.7077975519924353,5,16,80080,13666,66414,0.8293456543456543,18.05044977777778,2423.491584,14.28638844970348,112,9.000000000000002E-4
3,test_20231031_150306,10188041.png,221231,13097,208134,0.9407994358837595,3,6,41731,1843,39888,0.9558361889243009,9.90008,856.637488,18.80283284882432,112,9.000000000000002E-4
4,test_20231031_150306,10287332.png,216980,15267,201713,0.9296386763757029,3,6,22337,2080,20257,0.9068809598424139,9.177925333333333,708.1452746666666,19.629579993447372,112,9.000000000000002E-4
5,test_20231031_150306,11610969.png,368720,39927,328793,0.8917145801692341,4,6,84111,5787,78324,0.931198059706816,17.871916444444444,2153.556826666667,14.799240247357917,112,9.000000000000002E-4
6,test_20231031_150306,10350842.png,212614,9822,202792,0.9538036065357879,3,6,42529,1443,41086,0.9660702109149051,16.63639111111111,1781.0150933333334,15.624127609309976,112,9.000000000000002E-4
7,test_20231031_150306,10863862.png,317432,21729,295703,0.9315475440409284,3,6,66058,3028,63030,0.9541614944442762,20.850848,2540.6141866666667,14.081416420290706,112,9.000000000000002E-4
8,test_20231031_150306,11382381.png,312486,1472,311014,0.9952893889646256,3,6,46745,198,46547,0.9957642528612686,19.881477333333333,2121.993936,14.86336222379639,112,9.000000000000002E-4
9,test_20231031_150306,11079715.png,443815,150927,292888,0.6599326295866521,6,8,124136,20848,103288,0.8320551653025714,15.302609777777779,1719.655104,15.776390078262308,112,9.000000000000002E-4
10,test_20231031_150306,11551286.png,271883,1452,270431,0.9946594674915313,3,6,40092,209,39883,0.9947869899231767,16.17663288888889,1545.593824,16.239849871795663,112,9.000000000000002E-4
1,test_20231031_150307,10404007.png,502730,38309,464421,0.9237980625783224,4,6,61265,5477,55788,0.9106014853505264,24.299555555555557,3059.95504,13.273653154397136,113,1.0E-4
2,test_20231031_150307,1254659.png,342646,97949,244697,0.7141393741645896,7,7,80080,13389,66691,0.8328046953046953,17.939141333333332,2430.0163893333333,14.274711581448962,113,1.0E-4
3,test_20231031_150307,10188041.png,221231,13097,208134,0.9407994358837595,3,6,41731,1839,39892,0.9559320409288059,9.643754666666666,825.0689813333333,18.9659010085128,113,1.0E-4
4,test_20231031_150307,10287332.png,216980,15437,201543,0.9288551940270993,3,6,22337,2101,20236,0.9059408156869768,8.90352888888889,660.6031946666667,19.93139691266148,113,1.0E-4
5,test_20231031_150307,11610969.png,368720,38862,329858,0.8946029507485355,4,6,84111,5636,78475,0.9329933064640772,17.97388266666667,2180.6100426666667,14.74502352996726,113,1.0E-4
6,test_20231031_150307,10350842.png,212614,9562,203052,0.9550264799119531,2,5,42529,1405,41124,0.96696371887418,16.672387555555556,1788.2648106666666,15.60648530247111,113,1.0E-4
7,test_20231031_150307,10863862.png,317432,21557,295875,0.9320893923737997,3,5,66058,3017,63041,0.9543280147748948,20.426,2499.7040053333335,14.151917747802575,113,1.0E-4
8,test_20231031_150307,11382381.png,312486,2094,310392,0.9932988997907106,3,6,46745,288,46457,0.9938389132527543,16.922416,1674.8856053333334,15.890952107900066,113,1.0E-4
9,test_20231031_150307,11079715.png,443815,148394,295421,0.6656399625970281,6,7,124136,20523,103613,0.8346732615840691,15.116928,1694.7479573333333,15.839752417379106,113,1.0E-4
10,test_20231031_150307,11551286.png,271883,2002,269881,0.9926365385110507,2,5,40092,291,39801,0.9927416941035618,15.464648888888888,1434.9022773333334,16.56258036006986,113,1.0E-4
1,test_20231031_150308,10404007.png,502730,38309,464421,0.9237980625783224,3,6,61265,5477,55788,0.9106014853505264,24.299555555555557,3059.95504,13.273653154397136,113,2.0E-4
2,test_20231031_150308,1254659.png,342646,97949,244697,0.7141393741645896,5,7,80080,13389,66691,0.8328046953046953,17.939141333333332,2430.0163893333333,14.274711581448962,113,2.0E-4
3,test_20231031_150308,10188041.png,221231,13097,208134,0.9407994358837595,3,5,41731,1839,39892,0.9559320409288059,9.643754666666666,825.0689813333333,18.9659010085128,113,2.0E-4
4,test_20231031_150308,10287332.png,216980,15187,201793,0.9300073739515162,2,5,22337,2071,20266,0.9072838787661728,9.034579555555556,687.6542453333333,19.757102323530237,113,2.0E-4
5,test_20231031_150308,11610969.png,368720,38862,329858,0.8946029507485355,4,6,84111,5636,78475,0.9329933064640772,17.97388266666667,2180.6100426666667,14.74502352996726,113,2.0E-4
6,test_20231031_150308,10350842.png,212614,9562,203052,0.9550264799119531,3,6,42529,1405,41124,0.96696371887418,16.672387555555556,1788.2648106666666,15.60648530247111,113,2.0E-4
7,test_20231031_150308,10863862.png,317432,21557,295875,0.9320893923737997,3,6,66058,3017,63041,0.9543280147748948,20.426,2499.7040053333335,14.151917747802575,113,2.0E-4
8,test_20231031_150308,11382381.png,312486,1982,310504,0.99365731584775,2,5,46745,272,46473,0.9941811958498236,17.974652444444445,1814.571648,15.543062399616902,113,2.0E-4
9,test_20231031_150308,11079715.png,443815,148394,295421,0.6656399625970281,6,7,124136,20523,103613,0.8346732615840691,15.116928,1694.7479573333333,15.839752417379106,113,2.0E-4
10,test_20231031_150308,11551286.png,271883,1822,270061,0.9932985879955716,3,6,40092,264,39828,0.993415145166118,15.554140444444444,1441.559232,16.54247869119572,113,2.0E-4
1,test_20231031_150309,10404007.png,502730,38309,464421,0.9237980625783224,4,5,61265,5477,55788,0.9106014853505264,24.299555555555557,3059.95504,13.273653154397136,113,3.0000000000000003E-4
2,test_20231031_150309,1254659.png,342646,97869,244777,0.7143728512809138,5,7,80080,13382,66698,0.8328921078921079,17.951088,2431.43432,14.272178183422177,113,3.0000000000000003E-4
3,test_20231031_150309,10188041.png,221231,12977,208254,0.9413418553457698,3,6,41731,1822,39909,0.9563394119479524,9.79904,846.0947946666666,18.856613376701063,113,3.0000000000000003E-4
4,test_20231031_150309,10287332.png,216980,15147,201833,0.930191722739423,3,6,22337,2065,20272,0.9075524913820119,9.135916444444444,705.71128,19.64453301670131,113,3.0000000000000003E-4
5,test_20231031_150309,11610969.png,368720,38862,329858,0.8946029507485355,4,6,84111,5636,78475,0.9329933064640772,17.97388266666667,2180.6100426666667,14.74502352996726,113,3.0000000000000003E-4
6,test_20231031_150309,10350842.png,212614,9562,203052,0.9550264799119531,3,6,42529,1405,41124,0.96696371887418,16.672387555555556,1788.2648106666666,15.60648530247111,113,3.0000000000000003E-4
7,test_20231031_150309,10863862.png,317432,21077,296355,0.9336015272562312,3,6,66058,2948,63110,0.9553725513942293,20.942547555555556,2566.28184,14.037760101403007,113,3.0000000000000003E-4
8,test_20231031_150309,11382381.png,312486,1982,310504,0.99365731584775,3,6,46745,272,46473,0.9941811958498236,17.974652444444445,1814.571648,15.543062399616902,113,3.0000000000000003E-4
9,test_20231031_150309,11079715.png,443815,148394,295421,0.6656399625970281,6,7,124136,20523,103613,0.8346732615840691,15.116928,1694.7479573333333,15.839752417379106,113,3.0000000000000003E-4
10,test_20231031_150309,11551286.png,271883,1822,270061,0.9932985879955716,3,6,40092,264,39828,0.993415145166118,15.554140444444444,1441.559232,16.54247869119572,113,3.0000000000000003E-4
1,test_20231031_150310,10404007.png,502730,38309,464421,0.9237980625783224,4,6,61265,5477,55788,0.9106014853505264,24.299555555555557,3059.95504,13.273653154397136,113,4.0E-4
2,test_20231031_150310,1254659.png,342646,97869,244777,0.7143728512809138,5,6,80080,13382,66698,0.8328921078921079,17.951088,2431.43432,14.272178183422177,113,4.0E-4
3,test_20231031_150310,10188041.png,221231,12977,208254,0.9413418553457698,3,6,41731,1822,39909,0.9563394119479524,9.79904,846.0947946666666,18.856613376701063,113,4.0E-4
4,test_20231031_150310,10287332.png,216980,15147,201833,0.930191722739423,2,5,22337,2065,20272,0.9075524913820119,9.135916444444444,705.71128,19.64453301670131,113,4.0E-4
5,test_20231031_150310,11610969.png,368720,38862,329858,0.8946029507485355,4,5,84111,5636,78475,0.9329933064640772,17.97388266666667,2180.6100426666667,14.74502352996726,113,4.0E-4
6,test_20231031_150310,10350842.png,212614,9562,203052,0.9550264799119531,2,5,42529,1405,41124,0.96696371887418,16.672387555555556,1788.2648106666666,15.60648530247111,113,4.0E-4
7,test_20231031_150310,10863862.png,317432,21077,296355,0.9336015272562312,3,6,66058,2948,63110,0.9553725513942293,20.942547555555556,2566.28184,14.037760101403007,113,4.0E-4
8,test_20231031_150310,11382381.png,312486,1472,311014,0.9952893889646256,2,6,46745,198,46547,0.9957642528612686,19.12229688888889,1998.354176,15.124078984740148,113,4.0E-4
9,test_20231031_150310,11079715.png,443815,148394,295421,0.6656399625970281,6,7,124136,20523,103613,0.8346732615840691,15.116928,1694.7479573333333,15.839752417379106,113,4.0E-4
10,test_20231031_150310,11551286.png,271883,1822,270061,0.9932985879955716,2,5,40092,264,39828,0.993415145166118,15.554140444444444,1441.559232,16.54247869119572,113,4.0E-4
1,test_20231031_150311,10404007.png,502730,38309,464421,0.9237980625783224,3,6,61265,5477,55788,0.9106014853505264,24.299555555555557,3059.95504,13.273653154397136,113,5.0E-4
2,test_20231031_150311,1254659.png,342646,97869,244777,0.7143728512809138,5,6,80080,13382,66698,0.8328921078921079,17.951088,2431.43432,14.272178183422177,113,5.0E-4
3,test_20231031_150311,10188041.png,221231,12977,208254,0.9413418553457698,3,6,41731,1822,39909,0.9563394119479524,9.79904,846.0947946666666,18.856613376701063,113,5.0E-4
4,test_20231031_150311,10287332.png,216980,15147,201833,0.930191722739423,3,6,22337,2065,20272,0.9075524913820119,9.135916444444444,705.71128,19.64453301670131,113,5.0E-4
5,test_20231031_150311,11610969.png,368720,38862,329858,0.8946029507485355,4,5,84111,5636,78475,0.9329933064640772,17.97388266666667,2180.6100426666667,14.74502352996726,113,5.0E-4
6,test_20231031_150311,10350842.png,212614,9562,203052,0.9550264799119531,2,5,42529,1405,41124,0.96696371887418,16.672387555555556,1788.2648106666666,15.60648530247111,113,5.0E-4
7,test_20231031_150311,10863862.png,317432,21077,296355,0.9336015272562312,4,6,66058,2948,63110,0.9553725513942293,20.942547555555556,2566.28184,14.037760101403007,113,5.0E-4
8,test_20231031_150311,11382381.png,312486,1472,311014,0.9952893889646256,2,5,46745,198,46547,0.9957642528612686,19.12229688888889,1998.354176,15.124078984740148,113,5.0E-4
9,test_20231031_150311,11079715.png,443815,148394,295421,0.6656399625970281,5,7,124136,20523,103613,0.8346732615840691,15.116928,1694.7479573333333,15.839752417379106,113,5.0E-4
10,test_20231031_150311,11551286.png,271883,1492,270391,0.99451234538386,2,5,40092,215,39877,0.9946373341314976,15.83781511111111,1486.2257546666667,16.4099557798489,113,5.0E-4
1,test_20231031_150312,10404007.png,502730,38229,464501,0.9239571937222764,4,6,61265,5465,55800,0.9107973557496123,24.33333688888889,3065.84928,13.265295601451335,113,6.000000000000001E-4
2,test_20231031_150312,1254659.png,342646,97809,244837,0.7145479591181569,5,6,80080,13376,66704,0.832967032967033,17.973982222222222,2433.413968,14.26864364257293,113,6.000000000000001E-4
3,test_20231031_150312,10188041.png,221231,12977,208254,0.9413418553457698,4,6,41731,1822,39909,0.9563394119479524,9.79904,846.0947946666666,18.856613376701063,113,6.000000000000001E-4
4,test_20231031_150312,10287332.png,216980,15067,201913,0.9305604203152364,2,5,22337,2053,20284,0.9080897166136903,9.196833777777778,712.9685386666666,19.600099948097636,113,6.000000000000001E-4
5,test_20231031_150312,11610969.png,368720,38862,329858,0.8946029507485355,4,5,84111,5636,78475,0.9329933064640772,17.97388266666667,2180.6100426666667,14.74502352996726,113,6.000000000000001E-4
6,test_20231031_150312,10350842.png,212614,9459,203155,0.9555109259032801,3,5,42529,1390,41139,0.96731641938442,17.136657777777778,1896.4858453333334,15.351307552298746,113,6.000000000000001E-4
7,test_20231031_150312,10863862.png,317432,20977,296455,0.9339165553567378,3,6,66058,2936,63122,0.9555542099367222,20.95296888888889,2567.9171466666667,14.034993536696753,113,6.000000000000001E-4
8,test_20231031_150312,11382381.png,312486,1332,311154,0.9957374090359248,3,5,46745,177,46568,0.9962134987699219,19.963024,2143.735088,14.819092444591817,113,6.000000000000001E-4
9,test_20231031_150312,11079715.png,443815,148394,295421,0.6656399625970281,6,7,124136,20523,103613,0.8346732615840691,15.116928,1694.7479573333333,15.839752417379106,113,6.000000000000001E-4
10,test_20231031_150312,11551286.png,271883,1432,270451,0.9947330285453669,2,6,40092,206,39886,0.9948618178190163,15.992864,1519.8637866666666,16.31275693548021,113,6.000000000000001E-4
1,test_20231031_150313,10404007.png,502730,38229,464501,0.9239571937222764,4,6,61265,5465,55800,0.9107973557496123,24.33333688888889,3065.84928,13.265295601451335,113,7.000000000000001E-4
2,test_20231031_150313,1254659.png,342646,97809,244837,0.7145479591181569,6,6,80080,13376,66704,0.832967032967033,17.973982222222222,2433.413968,14.26864364257293,113,7.000000000000001E-4
3,test_20231031_150313,10188041.png,221231,12977,208254,0.9413418553457698,4,6,41731,1822,39909,0.9563394119479524,9.79904,846.0947946666666,18.856613376701063,113,7.000000000000001E-4
4,test_20231031_150313,10287332.png,216980,15067,201913,0.9305604203152364,3,6,22337,2053,20284,0.9080897166136903,9.196833777777778,712.9685386666666,19.600099948097636,113,7.000000000000001E-4
5,test_20231031_150313,11610969.png,368720,38862,329858,0.8946029507485355,4,6,84111,5636,78475,0.9329933064640772,17.97388266666667,2180.6100426666667,14.74502352996726,113,7.000000000000001E-4
6,test_20231031_150313,10350842.png,212614,9459,203155,0.9555109259032801,3,6,42529,1390,41139,0.96731641938442,17.136657777777778,1896.4858453333334,15.351307552298746,113,7.000000000000001E-4
7,test_20231031_150313,10863862.png,317432,20977,296455,0.9339165553567378,3,6,66058,2936,63122,0.9555542099367222,20.95296888888889,2567.9171466666667,14.034993536696753,113,7.000000000000001E-4
8,test_20231031_150313,11382381.png,312486,1332,311154,0.9957374090359248,2,5,46745,177,46568,0.9962134987699219,19.963024,2143.735088,14.819092444591817,113,7.000000000000001E-4
9,test_20231031_150313,11079715.png,443815,148394,295421,0.6656399625970281,6,7,124136,20523,103613,0.8346732615840691,15.116928,1694.7479573333333,15.839752417379106,113,7.000000000000001E-4
10,test_20231031_150313,11551286.png,271883,1432,270451,0.9947330285453669,3,6,40092,206,39886,0.9948618178190163,15.992864,1519.8637866666666,16.31275693548021,113,7.000000000000001E-4
1,test_20231031_150314,10404007.png,502730,38007,464723,0.9243987826467488,4,6,61265,5435,55830,0.9112870317473272,24.346736,3068.1460213333335,13.26204335854915,113,8.000000000000001E-4
2,test_20231031_150314,1254659.png,342646,97747,244899,0.7147289038833081,6,7,80080,13367,66713,0.8330794205794205,18.286867555555556,2482.995610666667,14.181044090398585,113,8.000000000000001E-4
3,test_20231031_150314,10188041.png,221231,12857,208374,0.9418842748077801,3,6,41731,1807,39924,0.9566988569648462,9.924547555555556,862.0780266666667,18.775337852784727,113,8.000000000000001E-4
4,test_20231031_150314,10287332.png,216980,15067,201913,0.9305604203152364,2,5,22337,2053,20284,0.9080897166136903,9.196833777777778,712.9685386666666,19.600099948097636,113,8.000000000000001E-4
5,test_20231031_150314,11610969.png,368720,38862,329858,0.8946029507485355,4,6,84111,5636,78475,0.9329933064640772,17.97388266666667,2180.6100426666667,14.74502352996726,113,8.000000000000001E-4
6,test_20231031_150314,10350842.png,212614,9459,203155,0.9555109259032801,2,5,42529,1390,41139,0.96731641938442,17.136657777777778,1896.4858453333334,15.351307552298746,113,8.000000000000001E-4
7,test_20231031_150314,10863862.png,317432,20977,296455,0.9339165553567378,3,6,66058,2936,63122,0.9555542099367222,20.95296888888889,2567.9171466666667,14.034993536696753,113,8.000000000000001E-4
8,test_20231031_150314,11382381.png,312486,1332,311154,0.9957374090359248,3,6,46745,177,46568,0.9962134987699219,19.963024,2143.735088,14.819092444591817,113,8.000000000000001E-4
9,test_20231031_150314,11079715.png,443815,148194,295621,0.666090600813402,6,7,124136,20498,103638,0.8348746536057228,15.431498666666666,1747.5741333333333,15.706447529796908,113,8.000000000000001E-4
10,test_20231031_150314,11551286.png,271883,1312,270571,0.9951743948683809,2,6,40092,188,39904,0.9953107851940537,16.181056,1546.6630293333333,16.23684656374709,113,8.000000000000001E-4
1,test_20231031_150315,10404007.png,502730,38007,464723,0.9243987826467488,4,6,61265,5435,55830,0.9112870317473272,24.346736,3068.1460213333335,13.26204335854915,113,9.000000000000002E-4
2,test_20231031_150315,1254659.png,342646,97747,244899,0.7147289038833081,7,6,80080,13367,66713,0.8330794205794205,18.286867555555556,2482.995610666667,14.181044090398585,113,9.000000000000002E-4
3,test_20231031_150315,10188041.png,221231,12857,208374,0.9418842748077801,3,6,41731,1807,39924,0.9566988569648462,9.924547555555556,862.0780266666667,18.775337852784727,113,9.000000000000002E-4
4,test_20231031_150315,10287332.png,216980,15067,201913,0.9305604203152364,3,6,22337,2053,20284,0.9080897166136903,9.196833777777778,712.9685386666666,19.600099948097636,113,9.000000000000002E-4
5,test_20231031_150315,11610969.png,368720,38862,329858,0.8946029507485355,4,6,84111,5636,78475,0.9329933064640772,17.97388266666667,2180.6100426666667,14.74502352996726,113,9.000000000000002E-4
6,test_20231031_150315,10350842.png,212614,9459,203155,0.9555109259032801,3,6,42529,1390,41139,0.96731641938442,17.136657777777778,1896.4858453333334,15.351307552298746,113,9.000000000000002E-4
7,test_20231031_150315,10863862.png,317432,20977,296455,0.9339165553567378,4,6,66058,2936,63122,0.9555542099367222,20.95296888888889,2567.9171466666667,14.034993536696753,113,9.000000000000002E-4
8,test_20231031_150315,11382381.png,312486,1332,311154,0.9957374090359248,3,6,46745,177,46568,0.9962134987699219,19.963024,2143.735088,14.819092444591817,113,9.000000000000002E-4
9,test_20231031_150315,11079715.png,443815,148194,295621,0.666090600813402,6,7,124136,20498,103638,0.8348746536057228,15.431498666666666,1747.5741333333333,15.706447529796908,113,9.000000000000002E-4
10,test_20231031_150315,11551286.png,271883,1312,270571,0.9951743948683809,2,5,40092,188,39904,0.9953107851940537,16.181056,1546.6630293333333,16.23684656374709,113,9.000000000000002E-4
1,test_20231031_150316,10404007.png,502730,36462,466268,0.9274720028643606,4,6,61265,5229,56036,0.9146494735983024,24.503027555555555,3109.0042933333334,13.204590390917856,114,1.0E-4
2,test_20231031_150316,1254659.png,342646,96222,246424,0.719179561413237,5,6,80080,13169,66911,0.835551948051948,18.056108444444444,2461.5509386666668,14.21871533494074,114,1.0E-4
3,test_20231031_150316,10188041.png,221231,12757,208474,0.942336291026122,3,5,41731,1791,39940,0.9570822649828664,9.674622222222222,833.442768,18.922045784137556,114,1.0E-4
4,test_20231031_150316,10287332.png,216980,15167,201813,0.9300995483454696,3,6,22337,2062,20275,0.9076867976899315,8.98130488888889,672.0541653333333,19.85676083710833,114,1.0E-4
5,test_20231031_150316,11610969.png,368720,37707,331013,0.8977354089824257,4,6,84111,5474,78637,0.934919332786437,18.07580088888889,2206.0875413333333,14.694576188726817,114,1.0E-4
6,test_20231031_150316,10350842.png,212614,9299,203315,0.9562634633655357,3,6,42529,1366,41163,0.9678807402008042,16.69799822222222,1795.5919786666666,15.588727042299553,114,1.0E-4
7,test_20231031_150316,10863862.png,317432,20142,297290,0.9365470399959677,3,6,66058,2826,63232,0.9572194132429077,20.84991822222222,2593.607397333333,13.991761246927172,114,1.0E-4
8,test_20231031_150316,11382381.png,312486,2052,310434,0.9934333058121004,3,5,46745,282,46463,0.9939672692266552,16.950384,1682.572176,15.871066579771194,114,1.0E-4
9,test_20231031_150316,11079715.png,443815,146184,297631,0.6706195148879601,6,7,124136,20226,103910,0.8370657988013147,15.24816,1722.6300906666668,15.768883317249298,114,1.0E-4
10,test_20231031_150316,11551286.png,271883,1962,269921,0.992783660618722,2,6,40092,285,39807,0.992891349895241,15.465232,1435.0973066666666,16.561990114943146,114,1.0E-4
1,test_20231031_150317,10404007.png,502730,36462,466268,0.9274720028643606,4,6,61265,5229,56036,0.9146494735983024,24.503027555555555,3109.0042933333334,13.204590390917856,114,2.0E-4
2,test_20231031_150317,1254659.png,342646,96222,246424,0.719179561413237,5,7,80080,13169,66911,0.835551948051948,18.056108444444444,2461.5509386666668,14.21871533494074,114,2.0E-4
3,test_20231031_150317,10188041.png,221231,12757,208474,0.942336291026122,3,5,41731,1791,39940,0.9570822649828664,9.674622222222222,833.442768,18.922045784137556,114,2.0E-4
4,test_20231031_150317,10287332.png,216980,14917,202063,0.9312517282698867,3,6,22337,2032,20305,0.9090298607691274,9.112355555555556,699.105216,19.685378184706046,114,2.0E-4
5,test_20231031_150317,11610969.png,368720,37707,331013,0.8977354089824257,4,6,84111,5474,78637,0.934919332786437,18.07580088888889,2206.0875413333333,14.694576188726817,114,2.0E-4
6,test_20231031_150317,10350842.png,212614,9299,203315,0.9562634633655357,3,6,42529,1366,41163,0.9678807402008042,16.69799822222222,1795.5919786666666,15.588727042299553,114,2.0E-4
7,test_20231031_150317,10863862.png,317432,20142,297290,0.9365470399959677,3,6,66058,2826,63232,0.9572194132429077,20.84991822222222,2593.607397333333,13.991761246927172,114,2.0E-4
8,test_20231031_150317,11382381.png,312486,1942,310544,0.9937853215824068,3,6,46745,266,46479,0.9943095518237245,18.002620444444446,1822.2582186666666,15.524704432275218,114,2.0E-4
9,test_20231031_150317,11079715.png,443815,146184,297631,0.6706195148879601,6,7,124136,20226,103910,0.8370657988013147,15.24816,1722.6300906666668,15.768883317249298,114,2.0E-4
10,test_20231031_150317,11551286.png,271883,1782,270101,0.9934457101032429,3,6,40092,258,39834,0.9935648009577971,15.554723555555556,1441.7542613333333,16.541891171568725,114,2.0E-4
1,test_20231031_150318,10404007.png,502730,36382,466348,0.9276311340083147,4,6,61265,5217,56048,0.9148453439973884,24.53680888888889,3114.8985333333335,13.196364566242938,114,3.0000000000000003E-4
2,test_20231031_150318,1254659.png,342646,96142,246504,0.7194130385295612,5,7,80080,13162,66918,0.8356393606393606,18.06805511111111,2462.9688693333333,14.216214382542205,114,3.0000000000000003E-4
3,test_20231031_150318,10188041.png,221231,12677,208554,0.9426979040007956,4,6,41731,1779,39952,0.9573698209963816,9.827824,854.058224,18.815928818651265,114,3.0000000000000003E-4
4,test_20231031_150318,10287332.png,216980,14877,202103,0.9314360770577933,2,5,22337,2026,20311,0.9092984733849666,9.213692444444444,717.1622506666666,19.574629393735115,114,3.0000000000000003E-4
5,test_20231031_150318,11610969.png,368720,37707,331013,0.8977354089824257,3,6,84111,5474,78637,0.934919332786437,18.07580088888889,2206.0875413333333,14.694576188726817,114,3.0000000000000003E-4
6,test_20231031_150318,10350842.png,212614,9299,203315,0.9562634633655357,3,9,42529,1366,41163,0.9678807402008042,16.69799822222222,1795.5919786666666,15.588727042299553,114,3.0000000000000003E-4
7,test_20231031_150318,10863862.png,317432,19799,297633,0.9376275863807052,3,5,66058,2781,63277,0.9579006327772563,21.31814577777778,2651.084165333333,13.896568451455291,114,3.0000000000000003E-4
8,test_20231031_150318,11382381.png,312486,1822,310664,0.9941693387863776,3,6,46745,248,46497,0.9946946197454273,18.17149688888889,1859.4476533333334,15.436964041414456,114,3.0000000000000003E-4
9,test_20231031_150318,11079715.png,443815,146002,297813,0.6710295956648604,6,7,124136,20203,103933,0.837251079461236,15.561493333333333,1775.296672,15.638094219295418,114,3.0000000000000003E-4
10,test_20231031_150318,11551286.png,271883,1782,270101,0.9934457101032429,2,5,40092,258,39834,0.9935648009577971,15.554723555555556,1441.7542613333333,16.541891171568725,114,3.0000000000000003E-4
1,test_20231031_150319,10404007.png,502730,36382,466348,0.9276311340083147,4,6,61265,5217,56048,0.9148453439973884,24.53680888888889,3114.8985333333335,13.196364566242938,114,4.0E-4
2,test_20231031_150319,1254659.png,342646,96142,246504,0.7194130385295612,5,7,80080,13162,66918,0.8356393606393606,18.06805511111111,2462.9688693333333,14.216214382542205,114,4.0E-4
3,test_20231031_150319,10188041.png,221231,12677,208554,0.9426979040007956,3,6,41731,1779,39952,0.9573698209963816,9.827824,854.058224,18.815928818651265,114,4.0E-4
4,test_20231031_150319,10287332.png,216980,14877,202103,0.9314360770577933,2,5,22337,2026,20311,0.9092984733849666,9.213692444444444,717.1622506666666,19.574629393735115,114,4.0E-4
5,test_20231031_150319,11610969.png,368720,37707,331013,0.8977354089824257,4,6,84111,5474,78637,0.934919332786437,18.07580088888889,2206.0875413333333,14.694576188726817,114,4.0E-4
6,test_20231031_150319,10350842.png,212614,9299,203315,0.9562634633655357,3,6,42529,1366,41163,0.9678807402008042,16.69799822222222,1795.5919786666666,15.588727042299553,114,4.0E-4
7,test_20231031_150319,10863862.png,317432,19799,297633,0.9376275863807052,4,6,66058,2781,63277,0.9579006327772563,21.31814577777778,2651.084165333333,13.896568451455291,114,4.0E-4
8,test_20231031_150319,11382381.png,312486,1289,311197,0.995875015200681,3,6,46745,171,46574,0.9963418547438229,19.990992,2151.4216586666666,14.80354824452692,114,4.0E-4
9,test_20231031_150319,11079715.png,443815,146002,297813,0.6710295956648604,7,7,124136,20203,103933,0.837251079461236,15.561493333333333,1775.296672,15.638094219295418,114,4.0E-4
10,test_20231031_150319,11551286.png,271883,1782,270101,0.9934457101032429,2,5,40092,258,39834,0.9935648009577971,15.554723555555556,1441.7542613333333,16.541891171568725,114,4.0E-4
1,test_20231031_150320,10404007.png,502730,36382,466348,0.9276311340083147,4,6,61265,5217,56048,0.9148453439973884,24.53680888888889,3114.8985333333335,13.196364566242938,114,5.0E-4
2,test_20231031_150320,1254659.png,342646,96142,246504,0.7194130385295612,5,7,80080,13162,66918,0.8356393606393606,18.06805511111111,2462.9688693333333,14.216214382542205,114,5.0E-4
3,test_20231031_150320,10188041.png,221231,12677,208554,0.9426979040007956,4,5,41731,1779,39952,0.9573698209963816,9.827824,854.058224,18.815928818651265,114,5.0E-4
4,test_20231031_150320,10287332.png,216980,14877,202103,0.9314360770577933,2,6,22337,2026,20311,0.9092984733849666,9.213692444444444,717.1622506666666,19.574629393735115,114,5.0E-4
5,test_20231031_150320,11610969.png,368720,37707,331013,0.8977354089824257,4,6,84111,5474,78637,0.934919332786437,18.07580088888889,2206.0875413333333,14.694576188726817,114,5.0E-4
6,test_20231031_150320,10350842.png,212614,9299,203315,0.9562634633655357,2,5,42529,1366,41163,0.9678807402008042,16.69799822222222,1795.5919786666666,15.588727042299553,114,5.0E-4
7,test_20231031_150320,10863862.png,317432,19799,297633,0.9376275863807052,3,5,66058,2781,63277,0.9579006327772563,21.31814577777778,2651.084165333333,13.896568451455291,114,5.0E-4
8,test_20231031_150320,11382381.png,312486,1289,311197,0.995875015200681,3,6,46745,171,46574,0.9963418547438229,19.990992,2151.4216586666666,14.80354824452692,114,5.0E-4
9,test_20231031_150320,11079715.png,443815,146002,297813,0.6710295956648604,6,8,124136,20203,103933,0.837251079461236,15.561493333333333,1775.296672,15.638094219295418,114,5.0E-4
10,test_20231031_150320,11551286.png,271883,1452,270431,0.9946594674915313,3,6,40092,209,39883,0.9947869899231767,15.838398222222223,1486.420784,16.409385916178287,114,5.0E-4
1,test_20231031_150322,10404007.png,502730,36382,466348,0.9276311340083147,4,6,61265,5217,56048,0.9148453439973884,24.53680888888889,3114.8985333333335,13.196364566242938,114,6.000000000000001E-4
2,test_20231031_150322,1254659.png,342646,96022,246624,0.7197632542040473,5,6,80080,13147,66933,0.8358266733266733,18.40383466666667,2514.53016,14.12623511826446,114,6.000000000000001E-4
3,test_20231031_150322,10188041.png,221231,12677,208554,0.9426979040007956,3,5,41731,1779,39952,0.9573698209963816,9.827824,854.058224,18.815928818651265,114,6.000000000000001E-4
4,test_20231031_150322,10287332.png,216980,14877,202103,0.9314360770577933,4,6,22337,2026,20311,0.9092984733849666,9.213692444444444,717.1622506666666,19.574629393735115,114,6.000000000000001E-4
5,test_20231031_150322,11610969.png,368720,37707,331013,0.8977354089824257,4,6,84111,5474,78637,0.934919332786437,18.07580088888889,2206.0875413333333,14.694576188726817,114,6.000000000000001E-4
6,test_20231031_150322,10350842.png,212614,9197,203417,0.9567432059977236,3,10,42529,1351,41178,0.9682334407110442,17.162268444444443,1903.8130133333334,15.334560697949573,114,6.000000000000001E-4
7,test_20231031_150322,10863862.png,317432,19799,297633,0.9376275863807052,3,6,66058,2781,63277,0.9579006327772563,21.31814577777778,2651.084165333333,13.896568451455291,114,6.000000000000001E-4
8,test_20231031_150322,11382381.png,312486,1289,311197,0.995875015200681,3,6,46745,171,46574,0.9963418547438229,19.990992,2151.4216586666666,14.80354824452692,114,6.000000000000001E-4
9,test_20231031_150322,11079715.png,443815,146002,297813,0.6710295956648604,6,8,124136,20203,103933,0.837251079461236,15.561493333333333,1775.296672,15.638094219295418,114,6.000000000000001E-4
10,test_20231031_150322,11551286.png,271883,1289,270594,0.9952589900802918,2,5,40092,185,39907,0.9953856130898933,16.143914666666667,1538.91744,16.258650394862006,114,6.000000000000001E-4
1,test_20231031_150323,10404007.png,502730,36382,466348,0.9276311340083147,4,6,61265,5217,56048,0.9148453439973884,24.53680888888889,3114.8985333333335,13.196364566242938,114,7.000000000000001E-4
2,test_20231031_150323,1254659.png,342646,96022,246624,0.7197632542040473,5,7,80080,13147,66933,0.8358266733266733,18.40383466666667,2514.53016,14.12623511826446,114,7.000000000000001E-4
3,test_20231031_150323,10188041.png,221231,12677,208554,0.9426979040007956,3,6,41731,1779,39952,0.9573698209963816,9.827824,854.058224,18.815928818651265,114,7.000000000000001E-4
4,test_20231031_150323,10287332.png,216980,14877,202103,0.9314360770577933,2,6,22337,2026,20311,0.9092984733849666,9.213692444444444,717.1622506666666,19.574629393735115,114,7.000000000000001E-4
5,test_20231031_150323,11610969.png,368720,37707,331013,0.8977354089824257,4,6,84111,5474,78637,0.934919332786437,18.07580088888889,2206.0875413333333,14.694576188726817,114,7.000000000000001E-4
6,test_20231031_150323,10350842.png,212614,9197,203417,0.9567432059977236,3,6,42529,1351,41178,0.9682334407110442,17.162268444444443,1903.8130133333334,15.334560697949573,114,7.000000000000001E-4
7,test_20231031_150323,10863862.png,317432,19799,297633,0.9376275863807052,4,7,66058,2781,63277,0.9579006327772563,21.31814577777778,2651.084165333333,13.896568451455291,114,7.000000000000001E-4
8,test_20231031_150323,11382381.png,312486,1289,311197,0.995875015200681,5,13,46745,171,46574,0.9963418547438229,19.990992,2151.4216586666666,14.80354824452692,114,7.000000000000001E-4
9,test_20231031_150323,11079715.png,443815,146002,297813,0.6710295956648604,9,10,124136,20203,103933,0.837251079461236,15.561493333333333,1775.296672,15.638094219295418,114,7.000000000000001E-4
10,test_20231031_150323,11551286.png,271883,1289,270594,0.9952589900802918,3,7,40092,185,39907,0.9953856130898933,16.143914666666667,1538.91744,16.258650394862006,114,7.000000000000001E-4
1,test_20231031_150324,10404007.png,502730,36159,466571,0.9280747120720864,4,6,61265,5187,56078,0.9153350199951032,24.550208,3117.1952746666666,13.193163516440693,114,8.000000000000001E-4
2,test_20231031_150324,1254659.png,342646,96022,246624,0.7197632542040473,5,7,80080,13147,66933,0.8358266733266733,18.40383466666667,2514.53016,14.12623511826446,114,8.000000000000001E-4
3,test_20231031_150324,10188041.png,221231,12394,208837,0.9439771098987032,4,6,41731,1742,39989,0.9582564520380532,10.20136711111111,904.83224,18.56512294365357,114,8.000000000000001E-4
4,test_20231031_150324,10287332.png,216980,14877,202103,0.9314360770577933,3,6,22337,2026,20311,0.9092984733849666,9.213692444444444,717.1622506666666,19.574629393735115,114,8.000000000000001E-4
5,test_20231031_150324,11610969.png,368720,37707,331013,0.8977354089824257,4,6,84111,5474,78637,0.934919332786437,18.07580088888889,2206.0875413333333,14.694576188726817,114,8.000000000000001E-4
6,test_20231031_150324,10350842.png,212614,9097,203517,0.9572135419116333,3,7,42529,1336,41193,0.9685861412212843,17.231882666666667,1909.825984,15.320865630607445,114,8.000000000000001E-4
7,test_20231031_150324,10863862.png,317432,19779,297653,0.9376905920008065,4,13,66058,2778,63280,0.9579460474128796,21.64860977777778,2697.73432,13.820811838935498,114,8.000000000000001E-4
8,test_20231031_150324,11382381.png,312486,1229,311257,0.9960670238026663,2,6,46745,162,46583,0.9965343887046743,20.317936,2217.836378666667,14.671508580373438,114,8.000000000000001E-4
9,test_20231031_150324,11079715.png,443815,146002,297813,0.6710295956648604,7,8,124136,20203,103933,0.837251079461236,15.561493333333333,1775.296672,15.638094219295418,114,8.000000000000001E-4
10,test_20231031_150324,11551286.png,271883,1007,270876,0.9962962009393747,2,16,40092,146,39946,0.9963583757358077,16.945825777777777,1679.1749386666668,15.87984416999138,114,8.000000000000001E-4
1,test_20231031_150325,10404007.png,502730,36159,466571,0.9280747120720864,4,5,61265,5187,56078,0.9153350199951032,24.550208,3117.1952746666666,13.193163516440693,114,9.000000000000002E-4
2,test_20231031_150325,1254659.png,342646,96022,246624,0.7197632542040473,7,6,80080,13147,66933,0.8358266733266733,18.40383466666667,2514.53016,14.12623511826446,114,9.000000000000002E-4
3,test_20231031_150325,10188041.png,221231,12394,208837,0.9439771098987032,8,11,41731,1742,39989,0.9582564520380532,10.20136711111111,904.83224,18.56512294365357,114,9.000000000000002E-4
4,test_20231031_150325,10287332.png,216980,14877,202103,0.9314360770577933,2,6,22337,2026,20311,0.9092984733849666,9.213692444444444,717.1622506666666,19.574629393735115,114,9.000000000000002E-4
5,test_20231031_150325,11610969.png,368720,37707,331013,0.8977354089824257,5,7,84111,5474,78637,0.934919332786437,18.07580088888889,2206.0875413333333,14.694576188726817,114,9.000000000000002E-4
6,test_20231031_150325,10350842.png,212614,9097,203517,0.9572135419116333,3,6,42529,1336,41193,0.9685861412212843,17.231882666666667,1909.825984,15.320865630607445,114,9.000000000000002E-4
7,test_20231031_150325,10863862.png,317432,19779,297653,0.9376905920008065,4,8,66058,2778,63280,0.9579460474128796,21.64860977777778,2697.73432,13.820811838935498,114,9.000000000000002E-4
8,test_20231031_150325,11382381.png,312486,1229,311257,0.9960670238026663,2,5,46745,162,46583,0.9965343887046743,20.317936,2217.836378666667,14.671508580373438,114,9.000000000000002E-4
9,test_20231031_150325,11079715.png,443815,146002,297813,0.6710295956648604,5,7,124136,20203,103933,0.837251079461236,15.561493333333333,1775.296672,15.638094219295418,114,9.000000000000002E-4
10,test_20231031_150325,11551286.png,271883,1007,270876,0.9962962009393747,2,5,40092,146,39946,0.9963583757358077,16.945825777777777,1679.1749386666668,15.87984416999138,114,9.000000000000002E-4
1,test_20231031_150326,10404007.png,502730,35034,467696,0.9303124937839397,4,7,61265,5027,56238,0.917946625316249,24.568979555555554,3128.3709813333335,13.177621121346494,115,1.0E-4
2,test_20231031_150326,1254659.png,342646,94122,248524,0.7253083357167456,6,7,80080,12902,67178,0.8388861138861139,18.284115555555555,2522.058832,14.113251477367356,115,1.0E-4
3,test_20231031_150326,10188041.png,221231,12374,208857,0.9440675131423716,4,6,41731,1736,39995,0.9584002300448108,9.829038222222222,868.066848,18.74527190300103,115,1.0E-4
4,test_20231031_150326,10287332.png,216980,15067,201913,0.9305604203152364,3,6,22337,2049,20288,0.9082687916909165,9.019194666666667,678.6627893333333,19.814263231251328,115,1.0E-4
5,test_20231031_150326,11610969.png,368720,36682,332038,0.9005152961596876,6,9,84111,5328,78783,0.9366551342868352,18.225370666666667,2241.4289226666665,14.62555389240082,115,1.0E-4
6,test_20231031_150326,10350842.png,212614,9037,203577,0.9574957434599791,3,7,42529,1328,41201,0.968774248160079,16.729114666666668,1801.6705333333334,15.574049852333808,115,1.0E-4
7,test_20231031_150326,10863862.png,317432,19157,298275,0.9396500667859573,4,6,66058,2693,63365,0.9592327954222047,21.396314666666665,2685.50504,13.840543890969485,115,1.0E-4
8,test_20231031_150326,11382381.png,312486,2012,310474,0.9935613115467573,4,6,46745,276,46469,0.9940956252005562,17.15296888888889,1710.0382133333333,15.800745454147208,115,1.0E-4
9,test_20231031_150326,11079715.png,443815,144084,299731,0.6753512161598865,6,8,124136,19946,104190,0.8393213894438358,15.334839111111112,1742.9790133333333,15.717882029308365,115,1.0E-4
10,test_20231031_150326,11551286.png,271883,1922,269961,0.9929307827263933,3,6,40092,279,39813,0.9930410056869201,15.46832888888889,1435.6707573333333,16.56025506384924,115,1.0E-4
1,test_20231031_150327,10404007.png,502730,35034,467696,0.9303124937839397,4,6,61265,5027,56238,0.917946625316249,24.568979555555554,3128.3709813333335,13.177621121346494,115,2.0E-4
2,test_20231031_150327,1254659.png,342646,94122,248524,0.7253083357167456,7,9,80080,12902,67178,0.8388861138861139,18.284115555555555,2522.058832,14.113251477367356,115,2.0E-4
3,test_20231031_150327,10188041.png,221231,12374,208857,0.9440675131423716,6,8,41731,1736,39995,0.9584002300448108,9.829038222222222,868.066848,18.74527190300103,115,2.0E-4
4,test_20231031_150327,10287332.png,216980,14817,202163,0.9317126002396534,4,7,22337,2019,20318,0.9096118547701124,9.150245333333332,705.71384,19.644517262498585,115,2.0E-4
5,test_20231031_150327,11610969.png,368720,36682,332038,0.9005152961596876,4,7,84111,5328,78783,0.9366551342868352,18.225370666666667,2241.4289226666665,14.62555389240082,115,2.0E-4
6,test_20231031_150327,10350842.png,212614,9037,203577,0.9574957434599791,3,6,42529,1328,41201,0.968774248160079,16.729114666666668,1801.6705333333334,15.574049852333808,115,2.0E-4
7,test_20231031_150327,10863862.png,317432,19157,298275,0.9396500667859573,3,6,66058,2693,63365,0.9592327954222047,21.396314666666665,2685.50504,13.840543890969485,115,2.0E-4
8,test_20231031_150327,11382381.png,312486,1922,310564,0.9938493244497354,3,6,46745,263,46482,0.994373729810675,18.026890666666667,1828.99472,15.508679091247764,115,2.0E-4
9,test_20231031_150327,11079715.png,443815,144084,299731,0.6753512161598865,6,7,124136,19946,104190,0.8393213894438358,15.334839111111112,1742.9790133333333,15.717882029308365,115,2.0E-4
10,test_20231031_150327,11551286.png,271883,1742,270141,0.9935928322109142,3,6,40092,252,39840,0.9937144567494762,15.557820444444445,1442.327712,16.540164130064625,115,2.0E-4
1,test_20231031_150329,10404007.png,502730,34952,467778,0.9304756032064926,6,9,61265,5015,56250,0.918142495715335,24.602760888888888,3134.2652213333336,13.169446172075874,115,3.0000000000000003E-4
2,test_20231031_150329,1254659.png,342646,94042,248604,0.7255418128330697,12,15,80080,12895,67185,0.8389735264735265,18.296062222222222,2523.4767626666667,14.110810509629,115,3.0000000000000003E-4
3,test_20231031_150329,10188041.png,221231,12292,208939,0.9444381664414119,6,9,41731,1724,40007,0.9586877860583259,9.98224,888.682304,18.64333828557937,115,3.0000000000000003E-4
4,test_20231031_150329,10287332.png,216980,14797,202183,0.9318047746336068,3,6,22337,2016,20321,0.909746161078032,9.221587555555555,718.468656,19.56672534567697,115,3.0000000000000003E-4
5,test_20231031_150329,11610969.png,368720,36682,332038,0.9005152961596876,4,7,84111,5328,78783,0.9366551342868352,18.225370666666667,2241.4289226666665,14.62555389240082,115,3.0000000000000003E-4
6,test_20231031_150329,10350842.png,212614,9037,203577,0.9574957434599791,2,6,42529,1328,41201,0.968774248160079,16.729114666666668,1801.6705333333334,15.574049852333808,115,3.0000000000000003E-4
7,test_20231031_150329,10863862.png,317432,18917,298515,0.940406134227173,3,5,66058,2662,63396,0.9597020799903115,21.97788088888889,2776.3364373333334,13.696082679525237,115,3.0000000000000003E-4
8,test_20231031_150329,11382381.png,312486,1802,310684,0.9942333416537061,3,6,46745,245,46500,0.9947587977323777,18.19576711111111,1866.1841546666667,15.421258632530638,115,3.0000000000000003E-4
9,test_20231031_150329,11079715.png,443815,143902,299913,0.6757612969367868,7,7,124136,19923,104213,0.8395066701037572,15.648172444444445,1795.6455946666667,15.588597364813907,115,3.0000000000000003E-4
10,test_20231031_150329,11551286.png,271883,1722,270161,0.9936663932647499,3,7,40092,249,39843,0.9937892846453158,15.639918222222223,1466.0139093333332,16.469422700184243,115,3.0000000000000003E-4
1,test_20231031_150330,10404007.png,502730,34952,467778,0.9304756032064926,10,14,61265,5015,56250,0.918142495715335,24.602760888888888,3134.2652213333336,13.169446172075874,115,4.0E-4
2,test_20231031_150330,1254659.png,342646,94042,248604,0.7255418128330697,8,10,80080,12895,67185,0.8389735264735265,18.296062222222222,2523.4767626666667,14.110810509629,115,4.0E-4
3,test_20231031_150330,10188041.png,221231,12292,208939,0.9444381664414119,4,7,41731,1724,40007,0.9586877860583259,9.98224,888.682304,18.64333828557937,115,4.0E-4
4,test_20231031_150330,10287332.png,216980,14797,202183,0.9318047746336068,3,7,22337,2016,20321,0.909746161078032,9.221587555555555,718.468656,19.56672534567697,115,4.0E-4
5,test_20231031_150330,11610969.png,368720,36682,332038,0.9005152961596876,5,7,84111,5328,78783,0.9366551342868352,18.225370666666667,2241.4289226666665,14.62555389240082,115,4.0E-4
6,test_20231031_150330,10350842.png,212614,9037,203577,0.9574957434599791,3,7,42529,1328,41201,0.968774248160079,16.729114666666668,1801.6705333333334,15.574049852333808,115,4.0E-4
7,test_20231031_150330,10863862.png,317432,18917,298515,0.940406134227173,4,7,66058,2662,63396,0.9597020799903115,21.97788088888889,2776.3364373333334,13.696082679525237,115,4.0E-4
8,test_20231031_150330,11382381.png,312486,1269,311217,0.9959390180680094,3,5,46745,168,46577,0.9964060327307733,20.015262222222223,2158.15816,14.789970922085507,115,4.0E-4
9,test_20231031_150330,11079715.png,443815,143902,299913,0.6757612969367868,8,8,124136,19923,104213,0.8395066701037572,15.648172444444445,1795.6455946666667,15.588597364813907,115,4.0E-4
10,test_20231031_150330,11551286.png,271883,1722,270161,0.9936663932647499,5,9,40092,249,39843,0.9937892846453158,15.639918222222223,1466.0139093333332,16.469422700184243,115,4.0E-4
1,test_20231031_150331,10404007.png,502730,34952,467778,0.9304756032064926,7,11,61265,5015,56250,0.918142495715335,24.602760888888888,3134.2652213333336,13.169446172075874,115,5.0E-4
2,test_20231031_150331,1254659.png,342646,94042,248604,0.7255418128330697,10,12,80080,12895,67185,0.8389735264735265,18.296062222222222,2523.4767626666667,14.110810509629,115,5.0E-4
3,test_20231031_150331,10188041.png,221231,12292,208939,0.9444381664414119,5,8,41731,1724,40007,0.9586877860583259,9.98224,888.682304,18.64333828557937,115,5.0E-4
4,test_20231031_150331,10287332.png,216980,14797,202183,0.9318047746336068,4,7,22337,2016,20321,0.909746161078032,9.221587555555555,718.468656,19.56672534567697,115,5.0E-4
5,test_20231031_150331,11610969.png,368720,36682,332038,0.9005152961596876,5,7,84111,5328,78783,0.9366551342868352,18.225370666666667,2241.4289226666665,14.62555389240082,115,5.0E-4
6,test_20231031_150331,10350842.png,212614,9037,203577,0.9574957434599791,2,7,42529,1328,41201,0.968774248160079,16.729114666666668,1801.6705333333334,15.574049852333808,115,5.0E-4
7,test_20231031_150331,10863862.png,317432,18917,298515,0.940406134227173,4,7,66058,2662,63396,0.9597020799903115,21.97788088888889,2776.3364373333334,13.696082679525237,115,5.0E-4
8,test_20231031_150331,11382381.png,312486,1269,311217,0.9959390180680094,3,6,46745,168,46577,0.9964060327307733,20.015262222222223,2158.15816,14.789970922085507,115,5.0E-4
9,test_20231031_150331,11079715.png,443815,143902,299913,0.6757612969367868,6,7,124136,19923,104213,0.8395066701037572,15.648172444444445,1795.6455946666667,15.588597364813907,115,5.0E-4
10,test_20231031_150331,11551286.png,271883,1189,270694,0.9956267953494702,3,6,40092,173,39919,0.9956849246732515,16.48380088888889,1607.3163946666666,16.06978986324379,115,5.0E-4
1,test_20231031_150333,10404007.png,502730,34952,467778,0.9304756032064926,4,6,61265,5015,56250,0.918142495715335,24.602760888888888,3134.2652213333336,13.169446172075874,115,6.000000000000001E-4
2,test_20231031_150333,1254659.png,342646,93922,248724,0.7258920285075559,10,6,80080,12880,67200,0.8391608391608392,18.631841777777776,2575.038053333333,14.022967095370802,115,6.000000000000001E-4
3,test_20231031_150333,10188041.png,221231,12232,208999,0.944709376172417,3,6,41731,1715,40016,0.9589034530684623,10.10263111111111,912.3246826666667,18.529309361401197,115,6.000000000000001E-4
4,test_20231031_150333,10287332.png,216980,14797,202183,0.9318047746336068,2,6,22337,2016,20321,0.909746161078032,9.221587555555555,718.468656,19.56672534567697,115,6.000000000000001E-4
5,test_20231031_150333,11610969.png,368720,36682,332038,0.9005152961596876,11,6,84111,5328,78783,0.9366551342868352,18.225370666666667,2241.4289226666665,14.62555389240082,115,6.000000000000001E-4
6,test_20231031_150333,10350842.png,212614,8837,203777,0.9584364152877985,2,5,42529,1298,41231,0.9694796491805592,17.26299911111111,1915.9045386666667,15.30706494623887,115,6.000000000000001E-4
7,test_20231031_150333,10863862.png,317432,18917,298515,0.940406134227173,3,6,66058,2662,63396,0.9597020799903115,21.97788088888889,2776.3364373333334,13.696082679525237,115,6.000000000000001E-4
8,test_20231031_150333,11382381.png,312486,1269,311217,0.9959390180680094,3,6,46745,168,46577,0.9964060327307733,20.015262222222223,2158.15816,14.789970922085507,115,6.000000000000001E-4
9,test_20231031_150333,11079715.png,443815,143902,299913,0.6757612969367868,6,7,124136,19923,104213,0.8395066701037572,15.648172444444445,1795.6455946666667,15.588597364813907,115,6.000000000000001E-4
10,test_20231031_150333,11551286.png,271883,1027,270856,0.996222639885539,2,5,40092,149,39943,0.9962835478399681,16.744944,1644.067472,15.971607239923532,115,6.000000000000001E-4
1,test_20231031_150334,10404007.png,502730,34952,467778,0.9304756032064926,4,6,61265,5015,56250,0.918142495715335,24.602760888888888,3134.2652213333336,13.169446172075874,115,7.000000000000001E-4
2,test_20231031_150334,1254659.png,342646,93922,248724,0.7258920285075559,5,6,80080,12880,67200,0.8391608391608392,18.631841777777776,2575.038053333333,14.022967095370802,115,7.000000000000001E-4
3,test_20231031_150334,10188041.png,221231,12232,208999,0.944709376172417,3,5,41731,1715,40016,0.9589034530684623,10.10263111111111,912.3246826666667,18.529309361401197,115,7.000000000000001E-4
4,test_20231031_150334,10287332.png,216980,14797,202183,0.9318047746336068,3,6,22337,2016,20321,0.909746161078032,9.221587555555555,718.468656,19.56672534567697,115,7.000000000000001E-4
5,test_20231031_150334,11610969.png,368720,36682,332038,0.9005152961596876,4,6,84111,5328,78783,0.9366551342868352,18.225370666666667,2241.4289226666665,14.62555389240082,115,7.000000000000001E-4
6,test_20231031_150334,10350842.png,212614,8837,203777,0.9584364152877985,2,5,42529,1298,41231,0.9694796491805592,17.26299911111111,1915.9045386666667,15.30706494623887,115,7.000000000000001E-4
7,test_20231031_150334,10863862.png,317432,18917,298515,0.940406134227173,3,6,66058,2662,63396,0.9597020799903115,21.97788088888889,2776.3364373333334,13.696082679525237,115,7.000000000000001E-4
8,test_20231031_150334,11382381.png,312486,1269,311217,0.9959390180680094,2,5,46745,168,46577,0.9964060327307733,20.015262222222223,2158.15816,14.789970922085507,115,7.000000000000001E-4
9,test_20231031_150334,11079715.png,443815,143902,299913,0.6757612969367868,5,7,124136,19923,104213,0.8395066701037572,15.648172444444445,1795.6455946666667,15.588597364813907,115,7.000000000000001E-4
10,test_20231031_150334,11551286.png,271883,1027,270856,0.996222639885539,2,6,40092,149,39943,0.9962835478399681,16.744944,1644.067472,15.971607239923532,115,7.000000000000001E-4
1,test_20231031_150335,10404007.png,502730,34732,467998,0.9309132138523661,4,6,61265,4985,56280,0.9186321717130499,24.61616,3136.5619626666667,13.166264894382326,115,8.000000000000001E-4
2,test_20231031_150335,1254659.png,342646,93922,248724,0.7258920285075559,5,6,80080,12880,67200,0.8391608391608392,18.631841777777776,2575.038053333333,14.022967095370802,115,8.000000000000001E-4
3,test_20231031_150335,10188041.png,221231,12012,209219,0.9457038118527693,3,14,41731,1687,40044,0.9595744170999976,10.35578311111111,939.45632,18.402037684739067,115,8.000000000000001E-4
4,test_20231031_150335,10287332.png,216980,14797,202183,0.9318047746336068,3,6,22337,2016,20321,0.909746161078032,9.221587555555555,718.468656,19.56672534567697,115,8.000000000000001E-4
5,test_20231031_150335,11610969.png,368720,36682,332038,0.9005152961596876,4,6,84111,5328,78783,0.9366551342868352,18.225370666666667,2241.4289226666665,14.62555389240082,115,8.000000000000001E-4
6,test_20231031_150335,10350842.png,212614,8474,204140,0.9601437346552908,3,6,42529,1245,41284,0.970725857650074,18.19317511111111,2131.319248,14.844318537814418,115,8.000000000000001E-4
7,test_20231031_150335,10863862.png,317432,18837,298595,0.9406581567075784,3,5,66058,2650,63408,0.9598837385328045,22.019790222222223,2778.047136,13.693407505926526,115,8.000000000000001E-4
8,test_20231031_150335,11382381.png,312486,1209,311277,0.9961310266699949,2,5,46745,159,46586,0.9965985666916247,20.342206222222224,2224.57288,14.658337224793453,115,8.000000000000001E-4
9,test_20231031_150335,11079715.png,443815,143902,299913,0.6757612969367868,5,7,124136,19923,104213,0.8395066701037572,15.648172444444445,1795.6455946666667,15.588597364813907,115,8.000000000000001E-4
10,test_20231031_150335,11551286.png,271883,967,270916,0.996443323047046,2,6,40092,140,39952,0.9965080315274868,16.948922666666668,1679.7483893333333,15.878361275395243,115,8.000000000000001E-4
1,test_20231031_150336,10404007.png,502730,34732,467998,0.9309132138523661,5,6,61265,4985,56280,0.9186321717130499,24.61616,3136.5619626666667,13.166264894382326,115,9.000000000000002E-4
2,test_20231031_150336,1254659.png,342646,93922,248724,0.7258920285075559,4,16,80080,12880,67200,0.8391608391608392,18.631841777777776,2575.038053333333,14.022967095370802,115,9.000000000000002E-4
3,test_20231031_150336,10188041.png,221231,12012,209219,0.9457038118527693,3,5,41731,1687,40044,0.9595744170999976,10.35578311111111,939.45632,18.402037684739067,115,9.000000000000002E-4
4,test_20231031_150336,10287332.png,216980,14797,202183,0.9318047746336068,3,5,22337,2016,20321,0.909746161078032,9.221587555555555,718.468656,19.56672534567697,115,9.000000000000002E-4
5,test_20231031_150336,11610969.png,368720,36682,332038,0.9005152961596876,4,5,84111,5328,78783,0.9366551342868352,18.225370666666667,2241.4289226666665,14.62555389240082,115,9.000000000000002E-4
6,test_20231031_150336,10350842.png,212614,8474,204140,0.9601437346552908,2,5,42529,1245,41284,0.970725857650074,18.19317511111111,2131.319248,14.844318537814418,115,9.000000000000002E-4
7,test_20231031_150336,10863862.png,317432,18837,298595,0.9406581567075784,3,6,66058,2650,63408,0.9598837385328045,22.019790222222223,2778.047136,13.693407505926526,115,9.000000000000002E-4
8,test_20231031_150336,11382381.png,312486,1209,311277,0.9961310266699949,3,6,46745,159,46586,0.9965985666916247,20.342206222222224,2224.57288,14.658337224793453,115,9.000000000000002E-4
9,test_20231031_150336,11079715.png,443815,143902,299913,0.6757612969367868,8,7,124136,19923,104213,0.8395066701037572,15.648172444444445,1795.6455946666667,15.588597364813907,115,9.000000000000002E-4
10,test_20231031_150336,11551286.png,271883,967,270916,0.996443323047046,2,5,40092,140,39952,0.9965080315274868,16.948922666666668,1679.7483893333333,15.878361275395243,115,9.000000000000002E-4
1,test_20231031_150337,10404007.png,502730,33867,468863,0.9326338193463688,4,6,61265,4864,56401,0.9206071982371664,24.629676444444446,3146.2855093333333,13.152822307872965,116,1.0E-4
2,test_20231031_150337,1254659.png,342646,91799,250847,0.7320879274820077,5,6,80080,12601,67479,0.8426448551448551,18.810426666666668,2627.3261706666667,13.935663690382661,116,1.0E-4
3,test_20231031_150337,10188041.png,221231,11972,209259,0.9458846183401061,3,6,41731,1678,40053,0.959790084110134,9.876396444444444,878.3562293333333,18.694096751924906,116,1.0E-4
4,test_20231031_150337,10287332.png,216980,14797,202183,0.9318047746336068,3,6,22337,2014,20323,0.909835698616645,9.057381333333334,687.1478773333333,19.760301516119938,116,1.0E-4
5,test_20231031_150337,11610969.png,368720,35727,332993,0.9031053373833804,4,6,84111,5190,78921,0.9382958233762528,18.311834666666666,2264.81592,14.580474517274604,116,1.0E-4
6,test_20231031_150337,10350842.png,212614,8637,203977,0.959377087115618,3,6,42529,1270,41259,0.9701380234663406,16.81530311111111,1819.8883306666667,15.530356206098393,116,1.0E-4
7,test_20231031_150337,10863862.png,317432,18352,299080,0.9421860429950352,3,5,66058,2586,63472,0.960852584092767,21.802058666666667,2790.8487466666666,13.673440608422089,116,1.0E-4
8,test_20231031_150337,11382381.png,312486,1802,310684,0.9942333416537061,3,6,46745,245,46500,0.9947587977323777,18.117850666666666,1846.9126346666667,15.466340085676595,116,1.0E-4
9,test_20231031_150337,11079715.png,443815,141952,301863,0.6801550195464326,5,6,124136,19664,104472,0.8415930914480891,15.445934222222222,1768.086976,15.655767357860086,116,1.0E-4
10,test_20231031_150337,11551286.png,271883,1582,270301,0.9941813206415995,3,6,40092,231,39861,0.9942382520203532,15.632876444444445,1452.8704266666666,16.508534771224895,116,1.0E-4
1,test_20231031_150338,10404007.png,502730,33867,468863,0.9326338193463688,4,5,61265,4864,56401,0.9206071982371664,24.629676444444446,3146.2855093333333,13.152822307872965,116,2.0E-4
2,test_20231031_150338,1254659.png,342646,91799,250847,0.7320879274820077,4,7,80080,12601,67479,0.8426448551448551,18.810426666666668,2627.3261706666667,13.935663690382661,116,2.0E-4
3,test_20231031_150338,10188041.png,221231,11972,209259,0.9458846183401061,3,6,41731,1678,40053,0.959790084110134,9.876396444444444,878.3562293333333,18.694096751924906,116,2.0E-4
4,test_20231031_150338,10287332.png,216980,14544,202436,0.9329707807171168,3,6,22337,1984,20353,0.911178761695841,9.188432,714.198928,19.59261166879019,116,2.0E-4
5,test_20231031_150338,11610969.png,368720,35727,332993,0.9031053373833804,4,6,84111,5190,78921,0.9382958233762528,18.311834666666666,2264.81592,14.580474517274604,116,2.0E-4
6,test_20231031_150338,10350842.png,212614,8637,203977,0.959377087115618,3,6,42529,1270,41259,0.9701380234663406,16.81530311111111,1819.8883306666667,15.530356206098393,116,2.0E-4
7,test_20231031_150338,10863862.png,317432,18352,299080,0.9421860429950352,3,6,66058,2586,63472,0.960852584092767,21.802058666666667,2790.8487466666666,13.673440608422089,116,2.0E-4
8,test_20231031_150338,11382381.png,312486,1662,310824,0.9946813617250053,3,6,46745,224,46521,0.9952080436410311,18.958577777777776,1992.2935466666668,15.137270326511574,116,2.0E-4
9,test_20231031_150338,11079715.png,443815,141952,301863,0.6801550195464326,6,6,124136,19664,104472,0.8415930914480891,15.445934222222222,1768.086976,15.655767357860086,116,2.0E-4
10,test_20231031_150338,11551286.png,271883,1582,270301,0.9941813206415995,2,5,40092,231,39861,0.9942382520203532,15.632876444444445,1452.8704266666666,16.508534771224895,116,2.0E-4
1,test_20231031_150339,10404007.png,502730,33787,468943,0.9327929504903228,3,5,61265,4852,56413,0.9208030686362524,24.66345777777778,3152.1797493333333,13.144693862135295,116,3.0000000000000003E-4
2,test_20231031_150339,1254659.png,342646,91719,250927,0.7323214045983317,5,7,80080,12594,67486,0.8427322677322677,18.822373333333335,2628.744101333333,13.933320496904166,116,3.0000000000000003E-4
3,test_20231031_150339,10188041.png,221231,11892,209339,0.9462462313147796,4,6,41731,1666,40065,0.960077640123649,10.029598222222223,898.9716853333333,18.59334347774442,116,3.0000000000000003E-4
4,test_20231031_150339,10287332.png,216980,14524,202456,0.9330629551110702,3,6,22337,1981,20356,0.9113130680037606,9.259774222222223,726.953744,19.51573583247749,116,3.0000000000000003E-4
5,test_20231031_150339,11610969.png,368720,35727,332993,0.9031053373833804,4,6,84111,5190,78921,0.9382958233762528,18.311834666666666,2264.81592,14.580474517274604,116,3.0000000000000003E-4
6,test_20231031_150339,10350842.png,212614,8537,204077,0.9598474230295277,2,5,42529,1255,41274,0.9704907239765806,16.884917333333334,1825.9013013333333,15.516030627215432,116,3.0000000000000003E-4
7,test_20231031_150339,10863862.png,317432,18172,299260,0.9427530935759469,3,6,66058,2561,63497,0.9612310393896273,22.22465777777778,2848.9721173333332,13.58392162013667,116,3.0000000000000003E-4
8,test_20231031_150339,11382381.png,312486,1642,310844,0.9947453645923338,2,5,46745,221,46524,0.9952722216279816,19.05557688888889,2014.7817173333333,15.08852359568316,116,3.0000000000000003E-4
9,test_20231031_150339,11079715.png,443815,141772,302043,0.6805605939411692,5,6,124136,19641,104495,0.8417783721080105,15.759267555555555,1820.7535573333334,15.528291937293258,116,3.0000000000000003E-4
10,test_20231031_150339,11551286.png,271883,1562,270321,0.9942548816954352,3,6,40092,228,39864,0.9943130799161928,15.714974222222223,1476.556624,16.438302546266087,116,3.0000000000000003E-4
1,test_20231031_150340,10404007.png,502730,33787,468943,0.9327929504903228,4,5,61265,4852,56413,0.9208030686362524,24.66345777777778,3152.1797493333333,13.144693862135295,116,4.0E-4
2,test_20231031_150340,1254659.png,342646,91719,250927,0.7323214045983317,5,6,80080,12594,67486,0.8427322677322677,18.822373333333335,2628.744101333333,13.933320496904166,116,4.0E-4
3,test_20231031_150340,10188041.png,221231,11892,209339,0.9462462313147796,4,6,41731,1666,40065,0.960077640123649,10.029598222222223,898.9716853333333,18.59334347774442,116,4.0E-4
4,test_20231031_150340,10287332.png,216980,14524,202456,0.9330629551110702,3,6,22337,1981,20356,0.9113130680037606,9.259774222222223,726.953744,19.51573583247749,116,4.0E-4
5,test_20231031_150340,11610969.png,368720,35727,332993,0.9031053373833804,4,6,84111,5190,78921,0.9382958233762528,18.311834666666666,2264.81592,14.580474517274604,116,4.0E-4
6,test_20231031_150340,10350842.png,212614,8537,204077,0.9598474230295277,3,6,42529,1255,41274,0.9704907239765806,16.884917333333334,1825.9013013333333,15.516030627215432,116,4.0E-4
7,test_20231031_150340,10863862.png,317432,18172,299260,0.9427530935759469,4,6,66058,2561,63497,0.9612310393896273,22.22465777777778,2848.9721173333332,13.58392162013667,116,4.0E-4
8,test_20231031_150340,11382381.png,312486,1249,311237,0.9960030209353379,2,5,46745,165,46580,0.9964702107177238,20.03434488888889,2161.3748106666667,14.783502751093609,116,4.0E-4
9,test_20231031_150340,11079715.png,443815,141772,302043,0.6805605939411692,5,7,124136,19641,104495,0.8417783721080105,15.759267555555555,1820.7535573333334,15.528291937293258,116,4.0E-4
10,test_20231031_150340,11551286.png,271883,1382,270501,0.994916931179956,3,6,40092,201,39891,0.9949865309787489,16.274922666666665,1573.1751893333333,16.16303272367802,116,4.0E-4
1,test_20231031_150341,10404007.png,502730,33787,468943,0.9327929504903228,4,6,61265,4852,56413,0.9208030686362524,24.66345777777778,3152.1797493333333,13.144693862135295,116,5.0E-4
2,test_20231031_150341,1254659.png,342646,91719,250927,0.7323214045983317,5,6,80080,12594,67486,0.8427322677322677,18.822373333333335,2628.744101333333,13.933320496904166,116,5.0E-4
3,test_20231031_150341,10188041.png,221231,11892,209339,0.9462462313147796,3,6,41731,1666,40065,0.960077640123649,10.029598222222223,898.9716853333333,18.59334347774442,116,5.0E-4
4,test_20231031_150341,10287332.png,216980,14524,202456,0.9330629551110702,2,6,22337,1981,20356,0.9113130680037606,9.259774222222223,726.953744,19.51573583247749,116,5.0E-4
5,test_20231031_150341,11610969.png,368720,35727,332993,0.9031053373833804,4,6,84111,5190,78921,0.9382958233762528,18.311834666666666,2264.81592,14.580474517274604,116,5.0E-4
6,test_20231031_150341,10350842.png,212614,8537,204077,0.9598474230295277,2,6,42529,1255,41274,0.9704907239765806,16.884917333333334,1825.9013013333333,15.516030627215432,116,5.0E-4
7,test_20231031_150341,10863862.png,317432,18172,299260,0.9427530935759469,3,5,66058,2561,63497,0.9612310393896273,22.22465777777778,2848.9721173333332,13.58392162013667,116,5.0E-4
8,test_20231031_150341,11382381.png,312486,1249,311237,0.9960030209353379,2,6,46745,165,46580,0.9964702107177238,20.03434488888889,2161.3748106666667,14.783502751093609,116,5.0E-4
9,test_20231031_150341,11079715.png,443815,141772,302043,0.6805605939411692,5,7,124136,19641,104495,0.8417783721080105,15.759267555555555,1820.7535573333334,15.528291937293258,116,5.0E-4
10,test_20231031_150341,11551286.png,271883,1049,270834,0.9961417227263197,2,6,40092,152,39940,0.9962087199441285,16.558597333333335,1617.841712,16.04144332446876,116,5.0E-4
1,test_20231031_150342,10404007.png,502730,33787,468943,0.9327929504903228,4,6,61265,4852,56413,0.9208030686362524,24.66345777777778,3152.1797493333333,13.144693862135295,116,6.000000000000001E-4
2,test_20231031_150342,1254659.png,342646,91699,250947,0.7323797738774128,5,7,80080,12591,67489,0.8427697302697302,18.835500444444445,2629.94168,13.931342429237844,116,6.000000000000001E-4
3,test_20231031_150342,10188041.png,221231,11832,209399,0.9465174410457847,3,5,41731,1657,40074,0.9602933071337855,10.149989333333334,922.614064,18.48060290314891,116,6.000000000000001E-4
4,test_20231031_150342,10287332.png,216980,14524,202456,0.9330629551110702,2,6,22337,1981,20356,0.9113130680037606,9.259774222222223,726.953744,19.51573583247749,116,6.000000000000001E-4
5,test_20231031_150342,11610969.png,368720,35727,332993,0.9031053373833804,4,6,84111,5190,78921,0.9382958233762528,18.311834666666666,2264.81592,14.580474517274604,116,6.000000000000001E-4
6,test_20231031_150342,10350842.png,212614,8434,204180,0.9603318690208547,3,6,42529,1240,41289,0.9708434244868207,17.349187555555556,1934.122336,15.265964205059156,116,6.000000000000001E-4
7,test_20231031_150342,10863862.png,317432,18172,299260,0.9427530935759469,3,6,66058,2561,63497,0.9612310393896273,22.22465777777778,2848.9721173333332,13.58392162013667,116,6.000000000000001E-4
8,test_20231031_150342,11382381.png,312486,1249,311237,0.9960030209353379,2,5,46745,165,46580,0.9964702107177238,20.03434488888889,2161.3748106666667,14.783502751093609,116,6.000000000000001E-4
9,test_20231031_150342,11079715.png,443815,141772,302043,0.6805605939411692,6,6,124136,19641,104495,0.8417783721080105,15.759267555555555,1820.7535573333334,15.528291937293258,116,6.000000000000001E-4
10,test_20231031_150342,11551286.png,271883,927,270956,0.9965904451547173,2,6,40092,134,39958,0.9966576873191659,16.746789333333332,1644.6409546666666,15.97009260057086,116,6.000000000000001E-4
1,test_20231031_150343,10404007.png,502730,33787,468943,0.9327929504903228,4,6,61265,4852,56413,0.9208030686362524,24.66345777777778,3152.1797493333333,13.144693862135295,116,7.000000000000001E-4
2,test_20231031_150343,1254659.png,342646,91699,250947,0.7323797738774128,5,7,80080,12591,67489,0.8427697302697302,18.835500444444445,2629.94168,13.931342429237844,116,7.000000000000001E-4
3,test_20231031_150343,10188041.png,221231,11832,209399,0.9465174410457847,4,6,41731,1657,40074,0.9602933071337855,10.149989333333334,922.614064,18.48060290314891,116,7.000000000000001E-4
4,test_20231031_150343,10287332.png,216980,14524,202456,0.9330629551110702,2,6,22337,1981,20356,0.9113130680037606,9.259774222222223,726.953744,19.51573583247749,116,7.000000000000001E-4
5,test_20231031_150343,11610969.png,368720,35727,332993,0.9031053373833804,4,6,84111,5190,78921,0.9382958233762528,18.311834666666666,2264.81592,14.580474517274604,116,7.000000000000001E-4
6,test_20231031_150343,10350842.png,212614,8434,204180,0.9603318690208547,3,6,42529,1240,41289,0.9708434244868207,17.349187555555556,1934.122336,15.265964205059156,116,7.000000000000001E-4
7,test_20231031_150343,10863862.png,317432,18172,299260,0.9427530935759469,3,6,66058,2561,63497,0.9612310393896273,22.22465777777778,2848.9721173333332,13.58392162013667,116,7.000000000000001E-4
8,test_20231031_150343,11382381.png,312486,1249,311237,0.9960030209353379,2,6,46745,165,46580,0.9964702107177238,20.03434488888889,2161.3748106666667,14.783502751093609,116,7.000000000000001E-4
9,test_20231031_150343,11079715.png,443815,141772,302043,0.6805605939411692,5,7,124136,19641,104495,0.8417783721080105,15.759267555555555,1820.7535573333334,15.528291937293258,116,7.000000000000001E-4
10,test_20231031_150343,11551286.png,271883,927,270956,0.9965904451547173,2,5,40092,134,39958,0.9966576873191659,16.746789333333332,1644.6409546666666,15.97009260057086,116,7.000000000000001E-4
1,test_20231031_150344,10404007.png,502730,33427,469303,0.9335090406381159,4,6,61265,4802,56463,0.9216191952991104,24.694835555555557,3157.8188106666666,13.136931534303173,116,8.000000000000001E-4
2,test_20231031_150344,1254659.png,342646,91699,250947,0.7323797738774128,6,7,80080,12591,67489,0.8427697302697302,18.835500444444445,2629.94168,13.931342429237844,116,8.000000000000001E-4
3,test_20231031_150344,10188041.png,221231,11612,209619,0.9475118767261369,3,6,41731,1629,40102,0.9609642711653208,10.403141333333334,949.7457013333334,18.35473024307315,116,8.000000000000001E-4
4,test_20231031_150344,10287332.png,216980,14524,202456,0.9330629551110702,3,6,22337,1981,20356,0.9113130680037606,9.259774222222223,726.953744,19.51573583247749,116,8.000000000000001E-4
5,test_20231031_150344,11610969.png,368720,35447,333273,0.9038647211976567,4,13,84111,5151,78960,0.9387594963797838,18.76879466666667,2361.6078986666666,14.398725681751614,116,8.000000000000001E-4
6,test_20231031_150344,10350842.png,212614,8092,204522,0.9619404178464259,2,5,42529,1190,41339,0.9720190928542877,18.278197333333335,2149.2323306666667,14.80796995877768,116,8.000000000000001E-4
7,test_20231031_150344,10863862.png,317432,18092,299340,0.9430051160563522,4,6,66058,2549,63509,0.9614126979321203,22.26656711111111,2850.682816,13.581314630688599,116,8.000000000000001E-4
8,test_20231031_150344,11382381.png,312486,1069,311417,0.996579046741294,2,6,46745,138,46607,0.9970478126002781,21.280266666666666,2419.63232,14.293309839481578,116,8.000000000000001E-4
9,test_20231031_150344,11079715.png,443815,141772,302043,0.6805605939411692,5,6,124136,19641,104495,0.8417783721080105,15.759267555555555,1820.7535573333334,15.528291937293258,116,8.000000000000001E-4
10,test_20231031_150344,11551286.png,271883,867,271016,0.9968111283162242,3,6,40092,125,39967,0.9968821710066846,16.950768,1680.321872,15.876878804252392,116,8.000000000000001E-4
1,test_20231031_150345,10404007.png,502730,33427,469303,0.9335090406381159,4,6,61265,4802,56463,0.9216191952991104,24.694835555555557,3157.8188106666666,13.136931534303173,116,9.000000000000002E-4
2,test_20231031_150345,1254659.png,342646,91699,250947,0.7323797738774128,7,6,80080,12591,67489,0.8427697302697302,18.835500444444445,2629.94168,13.931342429237844,116,9.000000000000002E-4
3,test_20231031_150345,10188041.png,221231,11612,209619,0.9475118767261369,3,5,41731,1629,40102,0.9609642711653208,10.403141333333334,949.7457013333334,18.35473024307315,116,9.000000000000002E-4
4,test_20231031_150345,10287332.png,216980,14524,202456,0.9330629551110702,2,5,22337,1981,20356,0.9113130680037606,9.259774222222223,726.953744,19.51573583247749,116,9.000000000000002E-4
5,test_20231031_150345,11610969.png,368720,35447,333273,0.9038647211976567,4,6,84111,5151,78960,0.9387594963797838,18.76879466666667,2361.6078986666666,14.398725681751614,116,9.000000000000002E-4
6,test_20231031_150345,10350842.png,212614,8092,204522,0.9619404178464259,3,6,42529,1190,41339,0.9720190928542877,18.278197333333335,2149.2323306666667,14.80796995877768,116,9.000000000000002E-4
7,test_20231031_150345,10863862.png,317432,18092,299340,0.9430051160563522,4,6,66058,2549,63509,0.9614126979321203,22.26656711111111,2850.682816,13.581314630688599,116,9.000000000000002E-4
8,test_20231031_150345,11382381.png,312486,1069,311417,0.996579046741294,3,5,46745,138,46607,0.9970478126002781,21.280266666666666,2419.63232,14.293309839481578,116,9.000000000000002E-4
9,test_20231031_150345,11079715.png,443815,141772,302043,0.6805605939411692,6,7,124136,19641,104495,0.8417783721080105,15.759267555555555,1820.7535573333334,15.528291937293258,116,9.000000000000002E-4
10,test_20231031_150345,11551286.png,271883,627,271256,0.9976938609622521,2,5,40092,91,40001,0.9977302204928664,17.18488888888889,1728.3928213333334,15.754379070136029,116,9.000000000000002E-4
1,test_20231031_150346,10404007.png,502730,31677,471053,0.9369900344121098,4,6,61265,4551,56714,0.925716151146658,24.734689777777778,3176.4103306666666,13.111437610569578,117,1.0E-4
2,test_20231031_150346,1254659.png,342646,90072,252574,0.737128114730655,4,6,80080,12381,67699,0.8453921078921078,18.985667555555555,2670.5895786666665,13.864732109281695,117,1.0E-4
3,test_20231031_150346,10188041.png,221231,11792,209439,0.9466982475331215,3,6,41731,1653,40078,0.9603891591382905,9.969694222222222,899.8637813333333,18.589035886426927,117,1.0E-4
4,test_20231031_150346,10287332.png,216980,14594,202386,0.9327403447322333,3,6,22337,1986,20351,0.9110892241572279,9.070316444444444,690.6286986666667,19.738357396294425,117,1.0E-4
5,test_20231031_150346,11610969.png,368720,34742,333978,0.9057767411586027,4,6,84111,5048,79063,0.9399840686711607,18.42931377777778,2292.6691466666666,14.527389743212353,117,1.0E-4
6,test_20231031_150346,10350842.png,212614,8394,204220,0.9605200033864186,3,5,42529,1234,41295,0.9709845046909168,16.888302222222222,1838.429856,15.48633296547871,117,1.0E-4
7,test_20231031_150346,10863862.png,317432,17487,299945,0.944911036064417,3,6,66058,2468,63590,0.9626388930939478,22.312561777777777,2883.6580266666665,13.531366047988854,117,1.0E-4
8,test_20231031_150346,11382381.png,312486,1742,310744,0.9944253502556915,3,6,46745,236,46509,0.9949513316932292,18.244037333333335,1872.6613066666666,15.406211237738582,117,1.0E-4
9,test_20231031_150346,11079715.png,443815,139522,304293,0.685630273875376,6,7,124136,19343,104793,0.8441789650061223,15.88592888888889,1852.93208,15.452208605030451,117,1.0E-4
10,test_20231031_150346,11551286.png,271883,1562,270321,0.9942548816954352,3,6,40092,228,39864,0.9943130799161928,15.633242666666666,1453.037136,16.508036469458126,117,1.0E-4
1,test_20231031_150347,10404007.png,502730,31677,471053,0.9369900344121098,4,6,61265,4551,56714,0.925716151146658,24.734689777777778,3176.4103306666666,13.111437610569578,117,2.0E-4
2,test_20231031_150347,1254659.png,342646,90072,252574,0.737128114730655,5,6,80080,12381,67699,0.8453921078921078,18.985667555555555,2670.5895786666665,13.864732109281695,117,2.0E-4
3,test_20231031_150347,10188041.png,221231,11792,209439,0.9466982475331215,4,5,41731,1653,40078,0.9603891591382905,9.969694222222222,899.8637813333333,18.589035886426927,117,2.0E-4
4,test_20231031_150347,10287332.png,216980,14342,202638,0.9339017420960457,3,5,22337,1956,20381,0.9124322872364239,9.20136711111111,717.6797493333333,19.571496688878824,117,2.0E-4
5,test_20231031_150347,11610969.png,368720,34742,333978,0.9057767411586027,4,6,84111,5048,79063,0.9399840686711607,18.42931377777778,2292.6691466666666,14.527389743212353,117,2.0E-4
6,test_20231031_150347,10350842.png,212614,8394,204220,0.9605200033864186,3,5,42529,1234,41295,0.9709845046909168,16.888302222222222,1838.429856,15.48633296547871,117,2.0E-4
7,test_20231031_150347,10863862.png,317432,17487,299945,0.944911036064417,3,6,66058,2468,63590,0.9626388930939478,22.312561777777777,2883.6580266666665,13.531366047988854,117,2.0E-4
8,test_20231031_150347,11382381.png,312486,1602,310884,0.9948733703269906,3,6,46745,215,46530,0.9954005776018826,19.084764444444446,2018.0422186666667,15.081501131681227,117,2.0E-4
9,test_20231031_150347,11079715.png,443815,139522,304293,0.685630273875376,6,7,124136,19343,104793,0.8441789650061223,15.88592888888889,1852.93208,15.452208605030451,117,2.0E-4
10,test_20231031_150347,11551286.png,271883,1562,270321,0.9942548816954352,3,6,40092,228,39864,0.9943130799161928,15.633242666666666,1453.037136,16.508036469458126,117,2.0E-4
1,test_20231031_150348,10404007.png,502730,31597,471133,0.9371491655560639,4,6,61265,4539,56726,0.9259120215457439,24.76847111111111,3182.3045706666667,13.103386182946512,117,3.0000000000000003E-4
2,test_20231031_150348,1254659.png,342646,89972,252674,0.7374199611260601,4,6,80080,12371,67709,0.8455169830169831,19.010741333333332,2673.205088,13.860480818083612,117,3.0000000000000003E-4
3,test_20231031_150348,10188041.png,221231,11712,209519,0.947059860507795,3,5,41731,1641,40090,0.9606767151518056,10.122896,920.4792373333333,18.49066364022726,117,3.0000000000000003E-4
4,test_20231031_150348,10287332.png,216980,14322,202658,0.9339939164899991,2,5,22337,1953,20384,0.9125665935443434,9.272709333333333,730.4345653333334,19.49499044345034,117,3.0000000000000003E-4
5,test_20231031_150348,11610969.png,368720,34582,334138,0.9062106747667606,4,7,84111,5026,79085,0.9402456278013578,18.844698666666666,2385.15832,14.3556314930714,117,3.0000000000000003E-4
6,test_20231031_150348,10350842.png,212614,8192,204422,0.9614700819325162,2,5,42529,1204,41325,0.9716899057113969,17.422186666666665,1952.6638613333334,15.224528721793412,117,3.0000000000000003E-4
7,test_20231031_150348,10863862.png,317432,17347,300085,0.9453520754051261,3,6,66058,2448,63610,0.962941657331436,22.402908444444446,2894.7943466666666,13.514626450601803,117,3.0000000000000003E-4
8,test_20231031_150348,11382381.png,312486,1352,311134,0.9956734061685963,2,6,46745,180,46565,0.9961493207829715,19.567729777777778,2094.4224426666665,14.920160779780403,117,3.0000000000000003E-4
9,test_20231031_150348,11079715.png,443815,139522,304293,0.685630273875376,6,7,124136,19343,104793,0.8441789650061223,15.88592888888889,1852.93208,15.452208605030451,117,3.0000000000000003E-4
10,test_20231031_150348,11551286.png,271883,1542,270341,0.9943284427492708,2,5,40092,225,39867,0.9943879078120323,15.715340444444445,1476.7233333333334,16.437812237560706,117,3.0000000000000003E-4
1,test_20231031_150349,10404007.png,502730,31597,471133,0.9371491655560639,4,6,61265,4539,56726,0.9259120215457439,24.76847111111111,3182.3045706666667,13.103386182946512,117,4.0E-4
2,test_20231031_150349,1254659.png,342646,89972,252674,0.7374199611260601,5,7,80080,12371,67709,0.8455169830169831,19.010741333333332,2673.205088,13.860480818083612,117,4.0E-4
3,test_20231031_150349,10188041.png,221231,11712,209519,0.947059860507795,4,6,41731,1641,40090,0.9606767151518056,10.122896,920.4792373333333,18.49066364022726,117,4.0E-4
4,test_20231031_150349,10287332.png,216980,14322,202658,0.9339939164899991,2,5,22337,1953,20384,0.9125665935443434,9.272709333333333,730.4345653333334,19.49499044345034,117,4.0E-4
5,test_20231031_150349,11610969.png,368720,34582,334138,0.9062106747667606,4,6,84111,5026,79085,0.9402456278013578,18.844698666666666,2385.15832,14.3556314930714,117,4.0E-4
6,test_20231031_150349,10350842.png,212614,8192,204422,0.9614700819325162,3,6,42529,1204,41325,0.9716899057113969,17.422186666666665,1952.6638613333334,15.224528721793412,117,4.0E-4
7,test_20231031_150349,10863862.png,317432,17347,300085,0.9453520754051261,3,6,66058,2448,63610,0.962941657331436,22.402908444444446,2894.7943466666666,13.514626450601803,117,4.0E-4
8,test_20231031_150349,11382381.png,312486,1209,311277,0.9961310266699949,3,6,46745,159,46586,0.9965985666916247,20.063532444444444,2164.635312,14.77695621992387,117,4.0E-4
9,test_20231031_150349,11079715.png,443815,139522,304293,0.685630273875376,5,6,124136,19343,104793,0.8441789650061223,15.88592888888889,1852.93208,15.452208605030451,117,4.0E-4
10,test_20231031_150349,11551286.png,271883,1362,270521,0.9949904922337918,2,6,40092,198,39894,0.9950613588745885,16.275288888888888,1573.3418986666666,16.162572526313173,117,4.0E-4
1,test_20231031_150351,10404007.png,502730,31597,471133,0.9371491655560639,4,6,61265,4539,56726,0.9259120215457439,24.76847111111111,3182.3045706666667,13.103386182946512,117,5.0E-4
2,test_20231031_150351,1254659.png,342646,89972,252674,0.7374199611260601,10,6,80080,12371,67709,0.8455169830169831,19.010741333333332,2673.205088,13.860480818083612,117,5.0E-4
3,test_20231031_150351,10188041.png,221231,11712,209519,0.947059860507795,3,6,41731,1641,40090,0.9606767151518056,10.122896,920.4792373333333,18.49066364022726,117,5.0E-4
4,test_20231031_150351,10287332.png,216980,14322,202658,0.9339939164899991,2,6,22337,1953,20384,0.9125665935443434,9.272709333333333,730.4345653333334,19.49499044345034,117,5.0E-4
5,test_20231031_150351,11610969.png,368720,34582,334138,0.9062106747667606,3,6,84111,5026,79085,0.9402456278013578,18.844698666666666,2385.15832,14.3556314930714,117,5.0E-4
6,test_20231031_150351,10350842.png,212614,8192,204422,0.9614700819325162,3,6,42529,1204,41325,0.9716899057113969,17.422186666666665,1952.6638613333334,15.224528721793412,117,5.0E-4
7,test_20231031_150351,10863862.png,317432,17347,300085,0.9453520754051261,3,6,66058,2448,63610,0.962941657331436,22.402908444444446,2894.7943466666666,13.514626450601803,117,5.0E-4
8,test_20231031_150351,11382381.png,312486,1089,311397,0.9965150438739655,2,5,46745,141,46604,0.9969836346133276,20.975168,2356.8750293333333,14.407438057130474,117,5.0E-4
9,test_20231031_150351,11079715.png,443815,139522,304293,0.685630273875376,7,7,124136,19343,104793,0.8441789650061223,15.88592888888889,1852.93208,15.452208605030451,117,5.0E-4
10,test_20231031_150351,11551286.png,271883,1027,270856,0.996222639885539,2,5,40092,149,39943,0.9962835478399681,16.558963555555554,1618.0084213333334,16.040995831904958,117,5.0E-4
1,test_20231031_150352,10404007.png,502730,31377,471353,0.9375867762019374,4,7,61265,4509,56756,0.9264016975434588,24.78187022222222,3184.601312,13.100252911781293,117,6.000000000000001E-4
2,test_20231031_150352,1254659.png,342646,89972,252674,0.7374199611260601,5,7,80080,12371,67709,0.8455169830169831,19.010741333333332,2673.205088,13.860480818083612,117,6.000000000000001E-4
3,test_20231031_150352,10188041.png,221231,11549,209682,0.9477966469436924,3,6,41731,1620,40111,0.9611799381754571,10.341367111111111,955.479728,18.328588836172578,117,6.000000000000001E-4
4,test_20231031_150352,10287332.png,216980,14322,202658,0.9339939164899991,2,5,22337,1953,20384,0.9125665935443434,9.272709333333333,730.4345653333334,19.49499044345034,117,6.000000000000001E-4
5,test_20231031_150352,11610969.png,368720,34582,334138,0.9062106747667606,4,6,84111,5026,79085,0.9402456278013578,18.844698666666666,2385.15832,14.3556314930714,117,6.000000000000001E-4
6,test_20231031_150352,10350842.png,212614,8192,204422,0.9614700819325162,3,6,42529,1204,41325,0.9716899057113969,17.422186666666665,1952.6638613333334,15.224528721793412,117,6.000000000000001E-4
7,test_20231031_150352,10863862.png,317432,17347,300085,0.9453520754051261,3,6,66058,2448,63610,0.962941657331436,22.402908444444446,2894.7943466666666,13.514626450601803,117,6.000000000000001E-4
8,test_20231031_150352,11382381.png,312486,1049,311437,0.9966430496086225,2,5,46745,135,46610,0.9971119905872285,21.28302933333333,2420.0730986666667,14.292518767601603,117,6.000000000000001E-4
9,test_20231031_150352,11079715.png,443815,139522,304293,0.685630273875376,8,7,124136,19343,104793,0.8441789650061223,15.88592888888889,1852.93208,15.452208605030451,117,6.000000000000001E-4
10,test_20231031_150352,11551286.png,271883,927,270956,0.9965904451547173,3,5,40092,134,39958,0.9966576873191659,16.746789333333332,1644.6409546666666,15.97009260057086,117,6.000000000000001E-4
1,test_20231031_150353,10404007.png,502730,31377,471353,0.9375867762019374,4,6,61265,4509,56756,0.9264016975434588,24.78187022222222,3184.601312,13.100252911781293,117,7.000000000000001E-4
2,test_20231031_150353,1254659.png,342646,89972,252674,0.7374199611260601,5,6,80080,12371,67709,0.8455169830169831,19.010741333333332,2673.205088,13.860480818083612,117,7.000000000000001E-4
3,test_20231031_150353,10188041.png,221231,11549,209682,0.9477966469436924,3,6,41731,1620,40111,0.9611799381754571,10.341367111111111,955.479728,18.328588836172578,117,7.000000000000001E-4
4,test_20231031_150353,10287332.png,216980,14322,202658,0.9339939164899991,3,6,22337,1953,20384,0.9125665935443434,9.272709333333333,730.4345653333334,19.49499044345034,117,7.000000000000001E-4
5,test_20231031_150353,11610969.png,368720,34582,334138,0.9062106747667606,4,6,84111,5026,79085,0.9402456278013578,18.844698666666666,2385.15832,14.3556314930714,117,7.000000000000001E-4
6,test_20231031_150353,10350842.png,212614,8192,204422,0.9614700819325162,2,6,42529,1204,41325,0.9716899057113969,17.422186666666665,1952.6638613333334,15.224528721793412,117,7.000000000000001E-4
7,test_20231031_150353,10863862.png,317432,17347,300085,0.9453520754051261,3,6,66058,2448,63610,0.962941657331436,22.402908444444446,2894.7943466666666,13.514626450601803,117,7.000000000000001E-4
8,test_20231031_150353,11382381.png,312486,1049,311437,0.9966430496086225,3,6,46745,135,46610,0.9971119905872285,21.28302933333333,2420.0730986666667,14.292518767601603,117,7.000000000000001E-4
9,test_20231031_150353,11079715.png,443815,139522,304293,0.685630273875376,5,7,124136,19343,104793,0.8441789650061223,15.88592888888889,1852.93208,15.452208605030451,117,7.000000000000001E-4
10,test_20231031_150353,11551286.png,271883,927,270956,0.9965904451547173,2,25,40092,134,39958,0.9966576873191659,16.746789333333332,1644.6409546666666,15.97009260057086,117,7.000000000000001E-4
1,test_20231031_150354,10404007.png,502730,31074,471656,0.9381894854096633,4,6,61265,4466,56799,0.9271035664735167,24.814042666666666,3191.2726453333335,13.091164512825008,117,8.000000000000001E-4
2,test_20231031_150354,1254659.png,342646,89972,252674,0.7374199611260601,4,6,80080,12371,67709,0.8455169830169831,19.010741333333332,2673.205088,13.860480818083612,117,8.000000000000001E-4
3,test_20231031_150354,10188041.png,221231,11449,209782,0.9482486631620343,3,5,41731,1607,40124,0.9614914571900985,10.469011555555555,966.6281333333334,18.278209299102585,117,8.000000000000001E-4
4,test_20231031_150354,10287332.png,216980,14322,202658,0.9339939164899991,3,6,22337,1953,20384,0.9125665935443434,9.272709333333333,730.4345653333334,19.49499044345034,117,8.000000000000001E-4
5,test_20231031_150354,11610969.png,368720,34119,334601,0.9074663701453678,4,6,84111,4959,79152,0.9410421942433214,19.417427555555555,2508.4862026666665,14.136686442313518,117,8.000000000000001E-4
6,test_20231031_150354,10350842.png,212614,7732,204882,0.9636336271365009,3,6,42529,1136,41393,0.9732888146911519,18.686051555555554,2228.161792,14.651336380907754,117,8.000000000000001E-4
7,test_20231031_150354,10863862.png,317432,17287,300145,0.94554109226543,3,6,66058,2439,63619,0.9630779012383057,22.44475733333333,2896.66128,13.511826467574739,117,8.000000000000001E-4
8,test_20231031_150354,11382381.png,312486,1049,311437,0.9966430496086225,2,6,46745,135,46610,0.9971119905872285,21.28302933333333,2420.0730986666667,14.292518767601603,117,8.000000000000001E-4
9,test_20231031_150354,11079715.png,443815,139522,304293,0.685630273875376,5,6,124136,19343,104793,0.8441789650061223,15.88592888888889,1852.93208,15.452208605030451,117,8.000000000000001E-4
10,test_20231031_150354,11551286.png,271883,627,271256,0.9976938609622521,2,6,40092,91,40001,0.9977302204928664,17.18488888888889,1728.3928213333334,15.754379070136029,117,8.000000000000001E-4
1,test_20231031_150355,10404007.png,502730,31074,471656,0.9381894854096633,4,6,61265,4466,56799,0.9271035664735167,24.814042666666666,3191.2726453333335,13.091164512825008,117,9.000000000000002E-4
2,test_20231031_150355,1254659.png,342646,89972,252674,0.7374199611260601,6,7,80080,12371,67709,0.8455169830169831,19.010741333333332,2673.205088,13.860480818083612,117,9.000000000000002E-4
3,test_20231031_150355,10188041.png,221231,11449,209782,0.9482486631620343,3,6,41731,1607,40124,0.9614914571900985,10.469011555555555,966.6281333333334,18.278209299102585,117,9.000000000000002E-4
4,test_20231031_150355,10287332.png,216980,14322,202658,0.9339939164899991,7,6,22337,1953,20384,0.9125665935443434,9.272709333333333,730.4345653333334,19.49499044345034,117,9.000000000000002E-4
5,test_20231031_150355,11610969.png,368720,34119,334601,0.9074663701453678,4,6,84111,4959,79152,0.9410421942433214,19.417427555555555,2508.4862026666665,14.136686442313518,117,9.000000000000002E-4
6,test_20231031_150355,10350842.png,212614,7732,204882,0.9636336271365009,2,5,42529,1136,41393,0.9732888146911519,18.686051555555554,2228.161792,14.651336380907754,117,9.000000000000002E-4
7,test_20231031_150355,10863862.png,317432,17287,300145,0.94554109226543,3,6,66058,2439,63619,0.9630779012383057,22.44475733333333,2896.66128,13.511826467574739,117,9.000000000000002E-4
8,test_20231031_150355,11382381.png,312486,1049,311437,0.9966430496086225,2,5,46745,135,46610,0.9971119905872285,21.28302933333333,2420.0730986666667,14.292518767601603,117,9.000000000000002E-4
9,test_20231031_150355,11079715.png,443815,139522,304293,0.685630273875376,8,7,124136,19343,104793,0.8441789650061223,15.88592888888889,1852.93208,15.452208605030451,117,9.000000000000002E-4
10,test_20231031_150355,11551286.png,271883,627,271256,0.9976938609622521,2,6,40092,91,40001,0.9977302204928664,17.18488888888889,1728.3928213333334,15.754379070136029,117,9.000000000000002E-4
1,test_20231031_150356,10404007.png,502730,30312,472418,0.9397052095558251,4,6,61265,4360,56905,0.9288337549987759,24.800556444444446,3195.080944,13.085984958422706,118,1.0E-4
2,test_20231031_150356,1254659.png,342646,88192,254454,0.7426148269642722,5,6,80080,12146,67934,0.8483266733266733,19.181717333333335,2722.34336,13.781374604455063,118,1.0E-4
3,test_20231031_150356,10188041.png,221231,11529,209702,0.9478870501873607,3,6,41731,1616,40115,0.9612757901799621,10.019447111111111,910.5794613333334,18.537625105581533,118,1.0E-4
4,test_20231031_150356,10287332.png,216980,14474,202506,0.9332933910959536,3,5,22337,1969,20368,0.911850293235439,9.077187555555556,692.308,19.727810107156955,118,1.0E-4
5,test_20231031_150356,11610969.png,368720,33927,334793,0.9079870904751572,4,6,84111,4941,79170,0.941256197168028,18.572876444444443,2320.885616,14.474266239295016,118,1.0E-4
6,test_20231031_150356,10350842.png,212614,8092,204522,0.9619404178464259,2,5,42529,1188,41341,0.9720661195889864,16.911514666666665,1844.3901386666666,15.472275693407639,118,1.0E-4
7,test_20231031_150356,10863862.png,317432,16724,300708,0.9473147004712821,3,6,66058,2378,63680,0.9640013321626449,22.621194666666668,2958.6381653333333,13.419885056794993,118,1.0E-4
8,test_20231031_150356,11382381.png,312486,1482,311004,0.9952573875309614,2,5,46745,202,46543,0.9956786822120013,19.14695111111111,2032.8025066666667,15.049851732929183,118,1.0E-4
9,test_20231031_150356,11079715.png,443815,137332,306483,0.6905647623446707,6,7,124136,19058,105078,0.8464748340529742,15.998211555555555,1880.0749546666666,15.389051968440075,118,1.0E-4
10,test_20231031_150356,11551286.png,271883,1522,270361,0.9944020038031065,3,6,40092,222,39870,0.9944627357078719,15.663358222222222,1460.1056266666667,16.486960863032234,118,1.0E-4
1,test_20231031_150357,10404007.png,502730,30312,472418,0.9397052095558251,4,6,61265,4360,56905,0.9288337549987759,24.800556444444446,3195.080944,13.085984958422706,118,2.0E-4
2,test_20231031_150357,1254659.png,342646,88192,254454,0.7426148269642722,5,7,80080,12146,67934,0.8483266733266733,19.181717333333335,2722.34336,13.781374604455063,118,2.0E-4
3,test_20231031_150357,10188041.png,221231,11529,209702,0.9478870501873607,3,6,41731,1616,40115,0.9612757901799621,10.019447111111111,910.5794613333334,18.537625105581533,118,2.0E-4
4,test_20231031_150357,10287332.png,216980,14222,202758,0.9344547884597658,3,6,22337,1939,20398,0.9131933563146349,9.208238222222223,719.3590506666667,19.56134648786129,118,2.0E-4
5,test_20231031_150357,11610969.png,368720,33927,334793,0.9079870904751572,3,6,84111,4941,79170,0.941256197168028,18.572876444444443,2320.885616,14.474266239295016,118,2.0E-4
6,test_20231031_150357,10350842.png,212614,8092,204522,0.9619404178464259,3,6,42529,1188,41341,0.9720661195889864,16.911514666666665,1844.3901386666666,15.472275693407639,118,2.0E-4
7,test_20231031_150357,10863862.png,317432,16724,300708,0.9473147004712821,4,6,66058,2378,63680,0.9640013321626449,22.621194666666668,2958.6381653333333,13.419885056794993,118,2.0E-4
8,test_20231031_150357,11382381.png,312486,1482,311004,0.9952573875309614,3,10,46745,202,46543,0.9956786822120013,19.14695111111111,2032.8025066666667,15.049851732929183,118,2.0E-4
9,test_20231031_150357,11079715.png,443815,137332,306483,0.6905647623446707,6,7,124136,19058,105078,0.8464748340529742,15.998211555555555,1880.0749546666666,15.389051968440075,118,2.0E-4
10,test_20231031_150357,11551286.png,271883,1522,270361,0.9944020038031065,2,6,40092,222,39870,0.9944627357078719,15.663358222222222,1460.1056266666667,16.486960863032234,118,2.0E-4
1,test_20231031_150358,10404007.png,502730,30232,472498,0.9398643406997792,4,6,61265,4349,56916,0.9290133028646046,24.834337777777776,3200.975184,13.077980536383798,118,3.0000000000000003E-4
2,test_20231031_150358,1254659.png,342646,88092,254554,0.7429066733596774,4,6,80080,12136,67944,0.8484515484515485,19.206791111111112,2724.9588693333335,13.777204094685997,118,3.0000000000000003E-4
3,test_20231031_150358,10188041.png,221231,11449,209782,0.9482486631620343,3,5,41731,1604,40127,0.9615633461934773,10.172648888888888,931.1949173333334,18.44039764030429,118,3.0000000000000003E-4
4,test_20231031_150358,10287332.png,216980,14202,202778,0.9345469628537193,3,6,22337,1936,20401,0.9133276626225545,9.279580444444445,732.1138666666667,19.485017281439937,118,3.0000000000000003E-4
5,test_20231031_150358,11610969.png,368720,33767,334953,0.9084210240833153,4,7,84111,4919,79192,0.941517756298225,18.988261333333334,2413.3747893333334,14.304555891870805,118,3.0000000000000003E-4
6,test_20231031_150358,10350842.png,212614,7952,204662,0.9625988881258996,2,6,42529,1167,41362,0.9725599003033224,17.44026488888889,1956.686224,15.215591734884253,118,3.0000000000000003E-4
7,test_20231031_150358,10863862.png,317432,16584,300848,0.9477557398119912,3,6,66058,2358,63700,0.9643040964001333,22.711541333333333,2969.7744853333334,13.403568891580502,118,3.0000000000000003E-4
8,test_20231031_150358,11382381.png,312486,1229,311257,0.9960670238026663,3,6,46745,167,46578,0.9964274253930901,19.629916444444444,2109.182730666667,14.889661540623035,118,3.0000000000000003E-4
9,test_20231031_150358,11079715.png,443815,137332,306483,0.6905647623446707,6,7,124136,19058,105078,0.8464748340529742,15.998211555555555,1880.0749546666666,15.389051968440075,118,3.0000000000000003E-4
10,test_20231031_150358,11551286.png,271883,1502,270381,0.9944755648569421,2,16,40092,219,39873,0.9945375636037115,15.745456,1483.791824,16.417073871688427,118,3.0000000000000003E-4
1,test_20231031_150359,10404007.png,502730,30232,472498,0.9398643406997792,4,6,61265,4349,56916,0.9290133028646046,24.834337777777776,3200.975184,13.077980536383798,118,4.0E-4
2,test_20231031_150359,1254659.png,342646,88092,254554,0.7429066733596774,4,6,80080,12136,67944,0.8484515484515485,19.206791111111112,2724.9588693333335,13.777204094685997,118,4.0E-4
3,test_20231031_150359,10188041.png,221231,11449,209782,0.9482486631620343,3,5,41731,1604,40127,0.9615633461934773,10.172648888888888,931.1949173333334,18.44039764030429,118,4.0E-4
4,test_20231031_150359,10287332.png,216980,14202,202778,0.9345469628537193,2,5,22337,1936,20401,0.9133276626225545,9.279580444444445,732.1138666666667,19.485017281439937,118,4.0E-4
5,test_20231031_150359,11610969.png,368720,33767,334953,0.9084210240833153,4,6,84111,4919,79192,0.941517756298225,18.988261333333334,2413.3747893333334,14.304555891870805,118,4.0E-4
6,test_20231031_150359,10350842.png,212614,7952,204662,0.9625988881258996,2,5,42529,1167,41362,0.9725599003033224,17.44026488888889,1956.686224,15.215591734884253,118,4.0E-4
7,test_20231031_150359,10863862.png,317432,16584,300848,0.9477557398119912,3,6,66058,2358,63700,0.9643040964001333,22.711541333333333,2969.7744853333334,13.403568891580502,118,4.0E-4
8,test_20231031_150359,11382381.png,312486,987,311499,0.9968414584973406,3,5,46745,131,46614,0.9971975612364958,21.02876088888889,2370.6178346666666,14.382188134999502,118,4.0E-4
9,test_20231031_150359,11079715.png,443815,137332,306483,0.6905647623446707,5,7,124136,19058,105078,0.8464748340529742,15.998211555555555,1880.0749546666666,15.389051968440075,118,4.0E-4
10,test_20231031_150359,11551286.png,271883,987,270896,0.9963697619932104,2,5,40092,143,39949,0.9964332036316472,16.58907911111111,1625.076912,16.022064406811772,118,4.0E-4
1,test_20231031_150400,10404007.png,502730,30232,472498,0.9398643406997792,4,12,61265,4349,56916,0.9290133028646046,24.834337777777776,3200.975184,13.077980536383798,118,5.0E-4
2,test_20231031_150400,1254659.png,342646,88092,254554,0.7429066733596774,5,6,80080,12136,67944,0.8484515484515485,19.206791111111112,2724.9588693333335,13.777204094685997,118,5.0E-4
3,test_20231031_150400,10188041.png,221231,11449,209782,0.9482486631620343,3,6,41731,1604,40127,0.9615633461934773,10.172648888888888,931.1949173333334,18.44039764030429,118,5.0E-4
4,test_20231031_150400,10287332.png,216980,14202,202778,0.9345469628537193,3,7,22337,1936,20401,0.9133276626225545,9.279580444444445,732.1138666666667,19.485017281439937,118,5.0E-4
5,test_20231031_150400,11610969.png,368720,33767,334953,0.9084210240833153,4,6,84111,4919,79192,0.941517756298225,18.988261333333334,2413.3747893333334,14.304555891870805,118,5.0E-4
6,test_20231031_150400,10350842.png,212614,7952,204662,0.9625988881258996,2,6,42529,1167,41362,0.9725599003033224,17.44026488888889,1956.686224,15.215591734884253,118,5.0E-4
7,test_20231031_150400,10863862.png,317432,16584,300848,0.9477557398119912,3,8,66058,2358,63700,0.9643040964001333,22.711541333333333,2969.7744853333334,13.403568891580502,118,5.0E-4
8,test_20231031_150400,11382381.png,312486,987,311499,0.9968414584973406,3,6,46745,131,46614,0.9971975612364958,21.02876088888889,2370.6178346666666,14.382188134999502,118,5.0E-4
9,test_20231031_150400,11079715.png,443815,137332,306483,0.6905647623446707,6,6,124136,19058,105078,0.8464748340529742,15.998211555555555,1880.0749546666666,15.389051968440075,118,5.0E-4
10,test_20231031_150400,11551286.png,271883,987,270896,0.9963697619932104,2,5,40092,143,39949,0.9964332036316472,16.58907911111111,1625.076912,16.022064406811772,118,5.0E-4
1,test_20231031_150401,10404007.png,502730,29869,472861,0.9405863982654705,5,7,61265,4297,56968,0.929862074593977,24.854192,3204.698778666667,13.072931460179952,118,6.000000000000001E-4
2,test_20231031_150401,1254659.png,342646,88092,254554,0.7429066733596774,5,7,80080,12136,67944,0.8484515484515485,19.206791111111112,2724.9588693333335,13.777204094685997,118,6.000000000000001E-4
3,test_20231031_150401,10188041.png,221231,11287,209944,0.9489809294357482,3,6,41731,1583,40148,0.9620665692171287,10.39112,966.195408,18.280153917672955,118,6.000000000000001E-4
4,test_20231031_150401,10287332.png,216980,14202,202778,0.9345469628537193,3,6,22337,1936,20401,0.9133276626225545,9.279580444444445,732.1138666666667,19.485017281439937,118,6.000000000000001E-4
5,test_20231031_150401,11610969.png,368720,33427,335293,0.909343133000651,4,6,84111,4869,79242,0.9421122088668545,19.519415111111112,2532.3998666666666,14.09548078884506,118,6.000000000000001E-4
6,test_20231031_150401,10350842.png,212614,7672,204942,0.9639158286848467,2,5,42529,1126,41403,0.9735239483646453,18.33104888888889,2162.688890666667,14.78086311509485,118,6.000000000000001E-4
7,test_20231031_150401,10863862.png,317432,16584,300848,0.9477557398119912,3,5,66058,2358,63700,0.9643040964001333,22.711541333333333,2969.7744853333334,13.403568891580502,118,6.000000000000001E-4
8,test_20231031_150401,11382381.png,312486,947,311539,0.9969694642319976,3,6,46745,125,46620,0.9973259172103969,21.33662222222222,2433.815904,14.267926361524507,118,6.000000000000001E-4
9,test_20231031_150401,11079715.png,443815,137332,306483,0.6905647623446707,6,7,124136,19058,105078,0.8464748340529742,15.998211555555555,1880.0749546666666,15.389051968440075,118,6.000000000000001E-4
10,test_20231031_150401,11551286.png,271883,807,271076,0.9970318114777312,2,5,40092,116,39976,0.9971066546942033,17.68609777777778,1807.3256746666666,15.560439426918995,118,6.000000000000001E-4
1,test_20231031_150402,10404007.png,502730,29869,472861,0.9405863982654705,4,6,61265,4297,56968,0.929862074593977,24.854192,3204.698778666667,13.072931460179952,118,7.000000000000001E-4
2,test_20231031_150402,1254659.png,342646,88092,254554,0.7429066733596774,4,6,80080,12136,67944,0.8484515484515485,19.206791111111112,2724.9588693333335,13.777204094685997,118,7.000000000000001E-4
3,test_20231031_150402,10188041.png,221231,11287,209944,0.9489809294357482,3,6,41731,1583,40148,0.9620665692171287,10.39112,966.195408,18.280153917672955,118,7.000000000000001E-4
4,test_20231031_150402,10287332.png,216980,14202,202778,0.9345469628537193,2,5,22337,1936,20401,0.9133276626225545,9.279580444444445,732.1138666666667,19.485017281439937,118,7.000000000000001E-4
5,test_20231031_150402,11610969.png,368720,33427,335293,0.909343133000651,4,6,84111,4869,79242,0.9421122088668545,19.519415111111112,2532.3998666666666,14.09548078884506,118,7.000000000000001E-4
6,test_20231031_150402,10350842.png,212614,7672,204942,0.9639158286848467,2,6,42529,1126,41403,0.9735239483646453,18.33104888888889,2162.688890666667,14.78086311509485,118,7.000000000000001E-4
7,test_20231031_150402,10863862.png,317432,16584,300848,0.9477557398119912,3,5,66058,2358,63700,0.9643040964001333,22.711541333333333,2969.7744853333334,13.403568891580502,118,7.000000000000001E-4
8,test_20231031_150402,11382381.png,312486,947,311539,0.9969694642319976,2,5,46745,125,46620,0.9973259172103969,21.33662222222222,2433.815904,14.267926361524507,118,7.000000000000001E-4
9,test_20231031_150402,11079715.png,443815,137332,306483,0.6905647623446707,6,7,124136,19058,105078,0.8464748340529742,15.998211555555555,1880.0749546666666,15.389051968440075,118,7.000000000000001E-4
10,test_20231031_150402,11551286.png,271883,567,271316,0.9979145441237591,2,6,40092,82,40010,0.9979547041803851,17.920218666666667,1855.396624,15.446435988293219,118,7.000000000000001E-4
1,test_20231031_150403,10404007.png,502730,29427,473303,0.9414655978358164,5,7,61265,4234,57031,0.9308903941891782,24.896499555555554,3213.6712053333335,13.060789193720916,118,8.000000000000001E-4
2,test_20231031_150403,1254659.png,342646,88092,254554,0.7429066733596774,8,12,80080,12136,67944,0.8484515484515485,19.206791111111112,2724.9588693333335,13.777204094685997,118,8.000000000000001E-4
3,test_20231031_150403,10188041.png,221231,11187,210044,0.9494329456540901,3,6,41731,1570,40161,0.9623780882317702,10.518764444444445,977.3438133333333,18.23032992679429,118,8.000000000000001E-4
4,test_20231031_150403,10287332.png,216980,14202,202778,0.9345469628537193,3,7,22337,1936,20401,0.9133276626225545,9.279580444444445,732.1138666666667,19.485017281439937,118,8.000000000000001E-4
5,test_20231031_150403,11610969.png,368720,33327,335393,0.9096143415057496,3,6,84111,4854,79257,0.9422905446374433,19.55695111111111,2536.3416906666666,14.088726004693697,118,8.000000000000001E-4
6,test_20231031_150403,10350842.png,212614,7512,205102,0.9646683661471023,3,6,42529,1102,41427,0.9740882691810294,18.70272888888889,2231.8623413333335,14.644129565535328,118,8.000000000000001E-4
7,test_20231031_150403,10863862.png,317432,16524,300908,0.9479447566722952,3,6,66058,2349,63709,0.964440340307003,22.753390222222222,2971.6414186666666,13.400839579630173,118,8.000000000000001E-4
8,test_20231031_150403,11382381.png,312486,947,311539,0.9969694642319976,2,6,46745,125,46620,0.9973259172103969,21.33662222222222,2433.815904,14.267926361524507,118,8.000000000000001E-4
9,test_20231031_150403,11079715.png,443815,137332,306483,0.6905647623446707,6,7,124136,19058,105078,0.8464748340529742,15.998211555555555,1880.0749546666666,15.389051968440075,118,8.000000000000001E-4
10,test_20231031_150403,11551286.png,271883,567,271316,0.9979145441237591,2,5,40092,82,40010,0.9979547041803851,17.920218666666667,1855.396624,15.446435988293219,118,8.000000000000001E-4
1,test_20231031_150404,10404007.png,502730,29427,473303,0.9414655978358164,4,6,61265,4234,57031,0.9308903941891782,24.896499555555554,3213.6712053333335,13.060789193720916,118,9.000000000000002E-4
2,test_20231031_150404,1254659.png,342646,88092,254554,0.7429066733596774,6,7,80080,12136,67944,0.8484515484515485,19.206791111111112,2724.9588693333335,13.777204094685997,118,9.000000000000002E-4
3,test_20231031_150404,10188041.png,221231,11187,210044,0.9494329456540901,4,6,41731,1570,40161,0.9623780882317702,10.518764444444445,977.3438133333333,18.23032992679429,118,9.000000000000002E-4
4,test_20231031_150404,10287332.png,216980,14202,202778,0.9345469628537193,2,5,22337,1936,20401,0.9133276626225545,9.279580444444445,732.1138666666667,19.485017281439937,118,9.000000000000002E-4
5,test_20231031_150404,11610969.png,368720,33327,335393,0.9096143415057496,4,6,84111,4854,79257,0.9422905446374433,19.55695111111111,2536.3416906666666,14.088726004693697,118,9.000000000000002E-4
6,test_20231031_150404,10350842.png,212614,7512,205102,0.9646683661471023,2,6,42529,1102,41427,0.9740882691810294,18.70272888888889,2231.8623413333335,14.644129565535328,118,9.000000000000002E-4
7,test_20231031_150404,10863862.png,317432,16524,300908,0.9479447566722952,3,6,66058,2349,63709,0.964440340307003,22.753390222222222,2971.6414186666666,13.400839579630173,118,9.000000000000002E-4
8,test_20231031_150404,11382381.png,312486,947,311539,0.9969694642319976,3,6,46745,125,46620,0.9973259172103969,21.33662222222222,2433.815904,14.267926361524507,118,9.000000000000002E-4
9,test_20231031_150404,11079715.png,443815,137332,306483,0.6905647623446707,5,7,124136,19058,105078,0.8464748340529742,15.998211555555555,1880.0749546666666,15.389051968440075,118,9.000000000000002E-4
10,test_20231031_150404,11551286.png,271883,567,271316,0.9979145441237591,2,6,40092,82,40010,0.9979547041803851,17.920218666666667,1855.396624,15.446435988293219,118,9.000000000000002E-4
1,test_20231031_150405,10404007.png,502730,28864,473866,0.9425854832613928,3,6,61265,4157,57108,0.9321472292499796,24.88056,3217.1794826666664,13.056050705107438,119,1.0E-4
2,test_20231031_150405,1254659.png,342646,86484,256162,0.7475995633977925,4,6,80080,11940,68140,0.8508991008991009,19.493813333333332,2798.499050666667,13.661551969506212,119,1.0E-4
3,test_20231031_150405,10188041.png,221231,11287,209944,0.9489809294357482,3,6,41731,1585,40146,0.9620186432148763,10.129530666666666,932.9076746666667,18.43241695006526,119,1.0E-4
4,test_20231031_150405,10287332.png,216980,14232,202748,0.9344087012627892,3,5,22337,1937,20400,0.913282893853248,9.094965333333333,697.079072,19.697983165066027,119,1.0E-4
5,test_20231031_150405,11610969.png,368720,32782,335938,0.9110924278585376,3,5,84111,4776,79335,0.9432178906445055,18.815036444444445,2382.4364906666665,14.360590285231876,119,1.0E-4
6,test_20231031_150405,10350842.png,212614,7832,204782,0.9631632912225911,3,5,42529,1149,41380,0.9729831409156106,16.944677333333335,1852.7270346666667,15.45268922159092,119,1.0E-4
7,test_20231031_150405,10863862.png,317432,16322,301110,0.9485811134353185,3,6,66058,2323,63735,0.9648339338157377,22.752236444444446,2984.604368,13.381935906226355,119,1.0E-4
8,test_20231031_150405,11382381.png,312486,1402,311084,0.9955133990002752,3,5,46745,190,46555,0.9959353941598031,19.16794311111111,2039.7081386666666,15.035123320864711,119,1.0E-4
9,test_20231031_150405,11079715.png,443815,134879,308936,0.696091840068497,5,14,124136,18739,105397,0.849044596249275,16.172732444444446,1919.789856,15.298266682968674,119,1.0E-4
10,test_20231031_150405,11551286.png,271883,1462,270421,0.9946226869646134,2,6,40092,215,39877,0.9946373341314976,15.664478222222222,1460.3968373333332,16.48609477106633,119,1.0E-4
1,test_20231031_150406,10404007.png,502730,28864,473866,0.9425854832613928,4,6,61265,4157,57108,0.9321472292499796,24.88056,3217.1794826666664,13.056050705107438,119,2.0E-4
2,test_20231031_150406,1254659.png,342646,86484,256162,0.7475995633977925,5,7,80080,11940,68140,0.8508991008991009,19.493813333333332,2798.499050666667,13.661551969506212,119,2.0E-4
3,test_20231031_150406,10188041.png,221231,11287,209944,0.9489809294357482,3,10,41731,1585,40146,0.9620186432148763,10.129530666666666,932.9076746666667,18.43241695006526,119,2.0E-4
4,test_20231031_150406,10287332.png,216980,13982,202998,0.9355608811872062,3,6,22337,1907,20430,0.914625956932444,9.226016,724.1301226666667,19.532637470487003,119,2.0E-4
5,test_20231031_150406,11610969.png,368720,32782,335938,0.9110924278585376,4,8,84111,4776,79335,0.9432178906445055,18.815036444444445,2382.4364906666665,14.360590285231876,119,2.0E-4
6,test_20231031_150406,10350842.png,212614,7832,204782,0.9631632912225911,3,6,42529,1149,41380,0.9729831409156106,16.944677333333335,1852.7270346666667,15.45268922159092,119,2.0E-4
7,test_20231031_150406,10863862.png,317432,16322,301110,0.9485811134353185,3,6,66058,2323,63735,0.9648339338157377,22.752236444444446,2984.604368,13.381935906226355,119,2.0E-4
8,test_20231031_150406,11382381.png,312486,1402,311084,0.9955133990002752,3,6,46745,190,46555,0.9959353941598031,19.16794311111111,2039.7081386666666,15.035123320864711,119,2.0E-4
9,test_20231031_150406,11079715.png,443815,134879,308936,0.696091840068497,8,6,124136,18739,105397,0.849044596249275,16.172732444444446,1919.789856,15.298266682968674,119,2.0E-4
10,test_20231031_150406,11551286.png,271883,1462,270421,0.9946226869646134,2,6,40092,215,39877,0.9946373341314976,15.664478222222222,1460.3968373333332,16.48609477106633,119,2.0E-4
1,test_20231031_150407,10404007.png,502730,28482,474248,0.9433453344737732,4,6,61265,4103,57162,0.9330286460458663,24.933249777777778,3226.5467893333334,13.043423935162151,119,3.0000000000000003E-4
2,test_20231031_150407,1254659.png,342646,86402,256244,0.7478388774420247,4,6,80080,11933,68147,0.8509865134865136,19.50576,2799.9169813333333,13.659352063411694,119,3.0000000000000003E-4
3,test_20231031_150407,10188041.png,221231,11207,210024,0.9493425424104217,3,6,41731,1573,40158,0.9623061992283913,10.282732444444445,953.5231306666667,18.337491281958467,119,3.0000000000000003E-4
4,test_20231031_150407,10287332.png,216980,13962,203018,0.9356530555811595,3,6,22337,1904,20433,0.9147602632403635,9.297358222222222,736.8849386666667,19.456806808830528,119,3.0000000000000003E-4
5,test_20231031_150407,11610969.png,368720,32622,336098,0.9115263614666956,4,6,84111,4754,79357,0.9434794497747024,19.230421333333332,2474.925664,14.19518201719306,119,3.0000000000000003E-4
6,test_20231031_150407,10350842.png,212614,7692,204922,0.9638217615020648,2,6,42529,1128,41401,0.9734769216299466,17.473427555555556,1965.02312,15.197126963196443,119,3.0000000000000003E-4
7,test_20231031_150407,10863862.png,317432,16202,301230,0.9489591471559263,4,8,66058,2306,63752,0.9650912834176028,22.782085333333335,2989.8751626666667,13.37427305418678,119,3.0000000000000003E-4
8,test_20231031_150407,11382381.png,312486,1007,311479,0.9967774556300122,2,6,46745,134,46611,0.9971333832495454,20.861811555555555,2370.5086666666666,14.38238813413471,119,3.0000000000000003E-4
9,test_20231031_150407,11079715.png,443815,134879,308936,0.696091840068497,6,7,124136,18739,105397,0.849044596249275,16.172732444444446,1919.789856,15.298266682968674,119,3.0000000000000003E-4
10,test_20231031_150407,11551286.png,271883,1302,270581,0.9952111753952987,3,6,40092,191,39901,0.9952359572982141,16.06636622222222,1535.6389493333334,16.267912420109646,119,3.0000000000000003E-4
1,test_20231031_150409,10404007.png,502730,28482,474248,0.9433453344737732,4,6,61265,4103,57162,0.9330286460458663,24.933249777777778,3226.5467893333334,13.043423935162151,119,4.0E-4
2,test_20231031_150409,1254659.png,342646,86402,256244,0.7478388774420247,5,6,80080,11933,68147,0.8509865134865136,19.50576,2799.9169813333333,13.659352063411694,119,4.0E-4
3,test_20231031_150409,10188041.png,221231,11207,210024,0.9493425424104217,3,6,41731,1573,40158,0.9623061992283913,10.282732444444445,953.5231306666667,18.337491281958467,119,4.0E-4
4,test_20231031_150409,10287332.png,216980,13962,203018,0.9356530555811595,3,6,22337,1904,20433,0.9147602632403635,9.297358222222222,736.8849386666667,19.456806808830528,119,4.0E-4
5,test_20231031_150409,11610969.png,368720,32622,336098,0.9115263614666956,4,6,84111,4754,79357,0.9434794497747024,19.230421333333332,2474.925664,14.19518201719306,119,4.0E-4
6,test_20231031_150409,10350842.png,212614,7692,204922,0.9638217615020648,2,5,42529,1128,41401,0.9734769216299466,17.473427555555556,1965.02312,15.197126963196443,119,4.0E-4
7,test_20231031_150409,10863862.png,317432,16202,301230,0.9489591471559263,3,6,66058,2306,63752,0.9650912834176028,22.782085333333335,2989.8751626666667,13.37427305418678,119,4.0E-4
8,test_20231031_150409,11382381.png,312486,867,311619,0.9972254757013114,2,6,46745,113,46632,0.9975826291581987,21.35761422222222,2440.721536,14.25562127651933,119,4.0E-4
9,test_20231031_150409,11079715.png,443815,134879,308936,0.696091840068497,6,7,124136,18739,105397,0.849044596249275,16.172732444444446,1919.789856,15.298266682968674,119,4.0E-4
10,test_20231031_150409,11551286.png,271883,947,270936,0.9965168841008817,2,5,40092,139,39953,0.9965329741594333,16.59003911111111,1625.298352,16.021472658706333,119,4.0E-4
1,test_20231031_150410,10404007.png,502730,28482,474248,0.9433453344737732,7,6,61265,4103,57162,0.9330286460458663,24.933249777777778,3226.5467893333334,13.043423935162151,119,5.0E-4
2,test_20231031_150410,1254659.png,342646,86402,256244,0.7478388774420247,5,6,80080,11933,68147,0.8509865134865136,19.50576,2799.9169813333333,13.659352063411694,119,5.0E-4
3,test_20231031_150410,10188041.png,221231,11207,210024,0.9493425424104217,3,6,41731,1573,40158,0.9623061992283913,10.282732444444445,953.5231306666667,18.337491281958467,119,5.0E-4
4,test_20231031_150410,10287332.png,216980,13962,203018,0.9356530555811595,3,6,22337,1904,20433,0.9147602632403635,9.297358222222222,736.8849386666667,19.456806808830528,119,5.0E-4
5,test_20231031_150410,11610969.png,368720,32622,336098,0.9115263614666956,4,5,84111,4754,79357,0.9434794497747024,19.230421333333332,2474.925664,14.19518201719306,119,5.0E-4
6,test_20231031_150410,10350842.png,212614,7692,204922,0.9638217615020648,3,6,42529,1128,41401,0.9734769216299466,17.473427555555556,1965.02312,15.197126963196443,119,5.0E-4
7,test_20231031_150410,10863862.png,317432,16202,301230,0.9489591471559263,3,5,66058,2306,63752,0.9650912834176028,22.782085333333335,2989.8751626666667,13.37427305418678,119,5.0E-4
8,test_20231031_150410,11382381.png,312486,867,311619,0.9972254757013114,3,5,46745,113,46632,0.9975826291581987,21.35761422222222,2440.721536,14.25562127651933,119,5.0E-4
9,test_20231031_150410,11079715.png,443815,134879,308936,0.696091840068497,6,8,124136,18739,105397,0.849044596249275,16.172732444444446,1919.789856,15.298266682968674,119,5.0E-4
10,test_20231031_150410,11551286.png,271883,927,270956,0.9965904451547173,2,5,40092,136,39956,0.9966078020552729,17.295253333333335,1745.233664,15.712267793193245,119,5.0E-4
1,test_20231031_150411,10404007.png,502730,28382,474348,0.9435442484037158,4,6,61265,4090,57175,0.9332408389782094,24.93548977777778,3226.98008,13.042840763356448,119,6.000000000000001E-4
2,test_20231031_150411,1254659.png,342646,86402,256244,0.7478388774420247,5,6,80080,11933,68147,0.8509865134865136,19.50576,2799.9169813333333,13.659352063411694,119,6.000000000000001E-4
3,test_20231031_150411,10188041.png,221231,11107,210124,0.9497945586287636,3,5,41731,1559,40172,0.962641681244159,10.406085333333333,969.2385226666667,18.26649693899053,119,6.000000000000001E-4
4,test_20231031_150411,10287332.png,216980,13962,203018,0.9356530555811595,2,6,22337,1904,20433,0.9147602632403635,9.297358222222222,736.8849386666667,19.456806808830528,119,6.000000000000001E-4
5,test_20231031_150411,11610969.png,368720,32342,336378,0.9122857452809721,4,6,84111,4713,79398,0.9439669008809787,19.652298666666667,2565.75856,14.03864574375796,119,6.000000000000001E-4
6,test_20231031_150411,10350842.png,212614,7429,205185,0.9650587449556474,3,6,42529,1090,41439,0.9743704295892215,18.360709333333332,2170.492528,14.765220657652737,119,6.000000000000001E-4
7,test_20231031_150411,10863862.png,317432,16202,301230,0.9489591471559263,3,12,66058,2306,63752,0.9650912834176028,22.782085333333335,2989.8751626666667,13.37427305418678,119,6.000000000000001E-4
8,test_20231031_150411,11382381.png,312486,867,311619,0.9972254757013114,2,6,46745,113,46632,0.9975826291581987,21.35761422222222,2440.721536,14.25562127651933,119,6.000000000000001E-4
9,test_20231031_150411,11079715.png,443815,134879,308936,0.696091840068497,5,7,124136,18739,105397,0.849044596249275,16.172732444444446,1919.789856,15.298266682968674,119,6.000000000000001E-4
10,test_20231031_150411,11551286.png,271883,567,271316,0.9979145441237591,2,5,40092,82,40010,0.9979547041803851,17.920218666666667,1855.396624,15.446435988293219,119,6.000000000000001E-4
1,test_20231031_150412,10404007.png,502730,28382,474348,0.9435442484037158,4,6,61265,4090,57175,0.9332408389782094,24.93548977777778,3226.98008,13.042840763356448,119,7.000000000000001E-4
2,test_20231031_150412,1254659.png,342646,86402,256244,0.7478388774420247,5,6,80080,11933,68147,0.8509865134865136,19.50576,2799.9169813333333,13.659352063411694,119,7.000000000000001E-4
3,test_20231031_150412,10188041.png,221231,11107,210124,0.9497945586287636,4,6,41731,1559,40172,0.962641681244159,10.406085333333333,969.2385226666667,18.26649693899053,119,7.000000000000001E-4
4,test_20231031_150412,10287332.png,216980,13962,203018,0.9356530555811595,3,6,22337,1904,20433,0.9147602632403635,9.297358222222222,736.8849386666667,19.456806808830528,119,7.000000000000001E-4
5,test_20231031_150412,11610969.png,368720,32342,336378,0.9122857452809721,4,6,84111,4713,79398,0.9439669008809787,19.652298666666667,2565.75856,14.03864574375796,119,7.000000000000001E-4
6,test_20231031_150412,10350842.png,212614,7429,205185,0.9650587449556474,3,6,42529,1090,41439,0.9743704295892215,18.360709333333332,2170.492528,14.765220657652737,119,7.000000000000001E-4
7,test_20231031_150412,10863862.png,317432,16202,301230,0.9489591471559263,3,5,66058,2306,63752,0.9650912834176028,22.782085333333335,2989.8751626666667,13.37427305418678,119,7.000000000000001E-4
8,test_20231031_150412,11382381.png,312486,867,311619,0.9972254757013114,3,6,46745,113,46632,0.9975826291581987,21.35761422222222,2440.721536,14.25562127651933,119,7.000000000000001E-4
9,test_20231031_150412,11079715.png,443815,134879,308936,0.696091840068497,5,7,124136,18739,105397,0.849044596249275,16.172732444444446,1919.789856,15.298266682968674,119,7.000000000000001E-4
10,test_20231031_150412,11551286.png,271883,567,271316,0.9979145441237591,2,6,40092,82,40010,0.9979547041803851,17.920218666666667,1855.396624,15.446435988293219,119,7.000000000000001E-4
1,test_20231031_150413,10404007.png,502730,27859,474871,0.9445845682573151,4,6,61265,4014,57251,0.9344813515057537,24.981834666666668,3236.567648,13.029956721630942,119,8.000000000000001E-4
2,test_20231031_150413,1254659.png,342646,86402,256244,0.7478388774420247,4,7,80080,11933,68147,0.8509865134865136,19.50576,2799.9169813333333,13.659352063411694,119,8.000000000000001E-4
3,test_20231031_150413,10188041.png,221231,11007,210224,0.9502465748471055,4,6,41731,1546,40185,0.9629532002588004,10.533729777777777,980.386928,18.216828489195663,119,8.000000000000001E-4
4,test_20231031_150413,10287332.png,216980,13962,203018,0.9356530555811595,3,6,22337,1904,20433,0.9147602632403635,9.297358222222222,736.8849386666667,19.456806808830528,119,8.000000000000001E-4
5,test_20231031_150413,11610969.png,368720,32242,336478,0.9125569537860707,4,6,84111,4698,79413,0.9441452366515676,19.689834666666666,2569.700384,14.031978714514029,119,8.000000000000001E-4
6,test_20231031_150413,10350842.png,212614,7269,205345,0.9658112824179028,2,6,42529,1066,41463,0.9749347504056056,18.732389333333334,2239.665978666667,14.62897107908159,119,8.000000000000001E-4
7,test_20231031_150413,10863862.png,317432,16142,301290,0.9491481640162303,3,6,66058,2297,63761,0.9652275273244725,22.82393422222222,2991.742096,13.371562085443669,119,8.000000000000001E-4
8,test_20231031_150413,11382381.png,312486,867,311619,0.9972254757013114,2,5,46745,113,46632,0.9975826291581987,21.35761422222222,2440.721536,14.25562127651933,119,8.000000000000001E-4
9,test_20231031_150413,11079715.png,443815,134879,308936,0.696091840068497,6,7,124136,18739,105397,0.849044596249275,16.172732444444446,1919.789856,15.298266682968674,119,8.000000000000001E-4
10,test_20231031_150413,11551286.png,271883,567,271316,0.9979145441237591,2,5,40092,82,40010,0.9979547041803851,17.920218666666667,1855.396624,15.446435988293219,119,8.000000000000001E-4
1,test_20231031_150414,10404007.png,502730,27697,475033,0.9449068088238219,4,6,61265,3992,57273,0.9348404472374112,25.057685333333332,3253.2331733333335,13.007651687010817,119,9.000000000000002E-4
2,test_20231031_150414,1254659.png,342646,86402,256244,0.7478388774420247,7,7,80080,11933,68147,0.8509865134865136,19.50576,2799.9169813333333,13.659352063411694,119,9.000000000000002E-4
3,test_20231031_150414,10188041.png,221231,11007,210224,0.9502465748471055,3,6,41731,1546,40185,0.9629532002588004,10.533729777777777,980.386928,18.216828489195663,119,9.000000000000002E-4
4,test_20231031_150414,10287332.png,216980,13962,203018,0.9356530555811595,3,6,22337,1904,20433,0.9147602632403635,9.297358222222222,736.8849386666667,19.456806808830528,119,9.000000000000002E-4
5,test_20231031_150414,11610969.png,368720,32242,336478,0.9125569537860707,4,6,84111,4698,79413,0.9441452366515676,19.689834666666666,2569.700384,14.031978714514029,119,9.000000000000002E-4
6,test_20231031_150414,10350842.png,212614,7269,205345,0.9658112824179028,2,6,42529,1066,41463,0.9749347504056056,18.732389333333334,2239.665978666667,14.62897107908159,119,9.000000000000002E-4
7,test_20231031_150414,10863862.png,317432,16142,301290,0.9491481640162303,3,5,66058,2297,63761,0.9652275273244725,22.82393422222222,2991.742096,13.371562085443669,119,9.000000000000002E-4
8,test_20231031_150414,11382381.png,312486,867,311619,0.9972254757013114,3,6,46745,113,46632,0.9975826291581987,21.35761422222222,2440.721536,14.25562127651933,119,9.000000000000002E-4
9,test_20231031_150414,11079715.png,443815,134879,308936,0.696091840068497,5,7,124136,18739,105397,0.849044596249275,16.172732444444446,1919.789856,15.298266682968674,119,9.000000000000002E-4
10,test_20231031_150414,11551286.png,271883,567,271316,0.9979145441237591,2,6,40092,82,40010,0.9979547041803851,17.920218666666667,1855.396624,15.446435988293219,119,9.000000000000002E-4
1,test_20231031_150415,10404007.png,502730,27377,475353,0.9455433333996379,4,6,61265,3948,57317,0.9355586387007263,24.98091911111111,3241.6444,13.02314988723095,120,1.0E-4
2,test_20231031_150415,1254659.png,342646,84372,258274,0.7537633592687497,4,6,80080,11681,68399,0.8541333666333666,19.952688,2913.615216,13.48648164361196,120,1.0E-4
3,test_20231031_150415,10188041.png,221231,11047,210184,0.9500657683597687,3,6,41731,1550,40181,0.9628573482542954,10.226010666666667,952.9778293333334,18.33997563807963,120,1.0E-4
4,test_20231031_150415,10287332.png,216980,13912,203068,0.935883491566043,3,5,22337,1894,20443,0.9152079509334289,9.119530666666666,704.3960426666666,19.65263453454638,120,1.0E-4
5,test_20231031_150415,11610969.png,368720,31817,336903,0.9137095899327403,4,6,84111,4634,79477,0.9449061359394134,18.97863288888889,2421.380016,14.290174070724388,120,1.0E-4
6,test_20231031_150415,10350842.png,212614,7712,204902,0.9637276943192828,2,5,42529,1131,41398,0.9734063815278986,16.956055111111112,1855.6201013333334,15.445912924238282,120,1.0E-4
7,test_20231031_150415,10863862.png,317432,15377,302055,0.9515581289851055,3,6,66058,2195,63863,0.9667716249356626,23.047130666666668,3065.621008,13.26561897338453,120,1.0E-4
8,test_20231031_150415,11382381.png,312486,1362,311124,0.9956414047349321,2,5,46745,184,46561,0.9960637501337042,19.183123555555557,2043.048048,15.028017804636116,120,1.0E-4
9,test_20231031_150415,11079715.png,443815,132247,311568,0.702022238995978,6,7,124136,18385,105751,0.8518963072758909,16.302611555555554,1952.235056,15.225482537985677,120,1.0E-4
10,test_20231031_150415,11551286.png,271883,1462,270421,0.9946226869646134,2,6,40092,215,39877,0.9946373341314976,15.664478222222222,1460.3968373333332,16.48609477106633,120,1.0E-4
1,test_20231031_150416,10404007.png,502730,27377,475353,0.9455433333996379,4,6,61265,3948,57317,0.9355586387007263,24.98091911111111,3241.6444,13.02314988723095,120,2.0E-4
2,test_20231031_150416,1254659.png,342646,84372,258274,0.7537633592687497,4,6,80080,11681,68399,0.8541333666333666,19.952688,2913.615216,13.48648164361196,120,2.0E-4
3,test_20231031_150416,10188041.png,221231,11047,210184,0.9500657683597687,4,5,41731,1550,40181,0.9628573482542954,10.226010666666667,952.9778293333334,18.33997563807963,120,2.0E-4
4,test_20231031_150416,10287332.png,216980,13662,203318,0.93703567149046,2,6,22337,1864,20473,0.9165510140126247,9.250581333333333,731.4470933333333,19.488974424426054,120,2.0E-4
5,test_20231031_150416,11610969.png,368720,31817,336903,0.9137095899327403,3,6,84111,4634,79477,0.9449061359394134,18.97863288888889,2421.380016,14.290174070724388,120,2.0E-4
6,test_20231031_150416,10350842.png,212614,7712,204902,0.9637276943192828,3,6,42529,1131,41398,0.9734063815278986,16.956055111111112,1855.6201013333334,15.445912924238282,120,2.0E-4
7,test_20231031_150416,10863862.png,317432,15377,302055,0.9515581289851055,3,6,66058,2195,63863,0.9667716249356626,23.047130666666668,3065.621008,13.26561897338453,120,2.0E-4
8,test_20231031_150416,11382381.png,312486,1259,311227,0.9959710195016737,3,6,46745,169,46576,0.9963846400684565,20.086165333333334,2234.270282666667,14.639446517255376,120,2.0E-4
9,test_20231031_150416,11079715.png,443815,132247,311568,0.702022238995978,6,7,124136,18385,105751,0.8518963072758909,16.302611555555554,1952.235056,15.225482537985677,120,2.0E-4
10,test_20231031_150416,11551286.png,271883,1462,270421,0.9946226869646134,3,6,40092,215,39877,0.9946373341314976,15.664478222222222,1460.3968373333332,16.48609477106633,120,2.0E-4
1,test_20231031_150417,10404007.png,502730,27237,475493,0.9458218129015575,4,6,61265,3928,57337,0.9358850893658696,24.993056,3243.490410666667,13.020677425852345,120,3.0000000000000003E-4
2,test_20231031_150417,1254659.png,342646,84312,258334,0.7539384671059928,5,7,80080,11676,68404,0.8541958041958042,19.962241777777777,2914.6974026666667,13.484868869095994,120,3.0000000000000003E-4
3,test_20231031_150417,10188041.png,221231,10967,210264,0.9504273813344423,3,5,41731,1538,40193,0.9631449042678105,10.379212444444445,973.5932853333334,18.247027908726242,120,3.0000000000000003E-4
4,test_20231031_150417,10287332.png,216980,13642,203338,0.9371278458844133,3,6,22337,1861,20476,0.9166853203205444,9.321923555555555,744.2019093333333,19.413895809498406,120,3.0000000000000003E-4
5,test_20231031_150417,11610969.png,368720,31657,337063,0.9141435235408982,3,6,84111,4612,79499,0.9451676950696104,19.394017777777776,2513.8691893333335,14.127376856996587,120,3.0000000000000003E-4
6,test_20231031_150417,10350842.png,212614,7572,205042,0.9643861645987565,2,6,42529,1110,41419,0.9739001622422347,17.484805333333334,1967.9161866666666,15.190737629327984,120,3.0000000000000003E-4
7,test_20231031_150417,10863862.png,317432,15277,302155,0.951873157085612,3,5,66058,2180,63878,0.9669986981137788,23.077662222222223,3070.805008,13.258281206665272,120,3.0000000000000003E-4
8,test_20231031_150417,11382381.png,312486,987,311499,0.9968414584973406,3,6,46745,131,46614,0.9971975612364958,20.862908444444443,2370.7645866666667,14.381919295331382,120,3.0000000000000003E-4
9,test_20231031_150417,11079715.png,443815,132247,311568,0.702022238995978,5,7,124136,18385,105751,0.8518963072758909,16.302611555555554,1952.235056,15.225482537985677,120,3.0000000000000003E-4
10,test_20231031_150417,11551286.png,271883,1302,270581,0.9952111753952987,3,5,40092,191,39901,0.9952359572982141,16.06636622222222,1535.6389493333334,16.267912420109646,120,3.0000000000000003E-4
1,test_20231031_150418,10404007.png,502730,27237,475493,0.9458218129015575,4,6,61265,3928,57337,0.9358850893658696,24.993056,3243.490410666667,13.020677425852345,120,4.0E-4
2,test_20231031_150418,1254659.png,342646,84312,258334,0.7539384671059928,5,6,80080,11676,68404,0.8541958041958042,19.962241777777777,2914.6974026666667,13.484868869095994,120,4.0E-4
3,test_20231031_150418,10188041.png,221231,10967,210264,0.9504273813344423,4,6,41731,1538,40193,0.9631449042678105,10.379212444444445,973.5932853333334,18.247027908726242,120,4.0E-4
4,test_20231031_150418,10287332.png,216980,13642,203338,0.9371278458844133,3,6,22337,1861,20476,0.9166853203205444,9.321923555555555,744.2019093333333,19.413895809498406,120,4.0E-4
5,test_20231031_150418,11610969.png,368720,31657,337063,0.9141435235408982,4,6,84111,4612,79499,0.9451676950696104,19.394017777777776,2513.8691893333335,14.127376856996587,120,4.0E-4
6,test_20231031_150418,10350842.png,212614,7572,205042,0.9643861645987565,3,7,42529,1110,41419,0.9739001622422347,17.484805333333334,1967.9161866666666,15.190737629327984,120,4.0E-4
7,test_20231031_150418,10863862.png,317432,15277,302155,0.951873157085612,3,6,66058,2180,63878,0.9669986981137788,23.077662222222223,3070.805008,13.258281206665272,120,4.0E-4
8,test_20231031_150418,11382381.png,312486,847,311639,0.9972894785686399,3,5,46745,110,46635,0.9976468071451492,21.358711111111113,2440.977456,14.2551659242164,120,4.0E-4
9,test_20231031_150418,11079715.png,443815,132247,311568,0.702022238995978,6,7,124136,18385,105751,0.8518963072758909,16.302611555555554,1952.235056,15.225482537985677,120,4.0E-4
10,test_20231031_150418,11551286.png,271883,647,271236,0.9976202999084165,2,6,40092,94,39998,0.9976553925970268,17.770117333333335,1836.7047093333333,15.490410213370003,120,4.0E-4
1,test_20231031_150419,10404007.png,502730,27237,475493,0.9458218129015575,4,6,61265,3928,57337,0.9358850893658696,24.993056,3243.490410666667,13.020677425852345,120,5.0E-4
2,test_20231031_150419,1254659.png,342646,84312,258334,0.7539384671059928,4,6,80080,11676,68404,0.8541958041958042,19.962241777777777,2914.6974026666667,13.484868869095994,120,5.0E-4
3,test_20231031_150419,10188041.png,221231,10967,210264,0.9504273813344423,3,6,41731,1538,40193,0.9631449042678105,10.379212444444445,973.5932853333334,18.247027908726242,120,5.0E-4
4,test_20231031_150419,10287332.png,216980,13642,203338,0.9371278458844133,3,6,22337,1861,20476,0.9166853203205444,9.321923555555555,744.2019093333333,19.413895809498406,120,5.0E-4
5,test_20231031_150419,11610969.png,368720,31657,337063,0.9141435235408982,4,6,84111,4612,79499,0.9451676950696104,19.394017777777776,2513.8691893333335,14.127376856996587,120,5.0E-4
6,test_20231031_150419,10350842.png,212614,7572,205042,0.9643861645987565,2,6,42529,1110,41419,0.9739001622422347,17.484805333333334,1967.9161866666666,15.190737629327984,120,5.0E-4
7,test_20231031_150419,10863862.png,317432,15277,302155,0.951873157085612,4,6,66058,2180,63878,0.9669986981137788,23.077662222222223,3070.805008,13.258281206665272,120,5.0E-4
8,test_20231031_150419,11382381.png,312486,847,311639,0.9972894785686399,2,6,46745,110,46635,0.9976468071451492,21.358711111111113,2440.977456,14.2551659242164,120,5.0E-4
9,test_20231031_150419,11079715.png,443815,132247,311568,0.702022238995978,6,7,124136,18385,105751,0.8518963072758909,16.302611555555554,1952.235056,15.225482537985677,120,5.0E-4
10,test_20231031_150419,11551286.png,271883,647,271236,0.9976202999084165,1,5,40092,94,39998,0.9976553925970268,17.770117333333335,1836.7047093333333,15.490410213370003,120,5.0E-4
1,test_20231031_150420,10404007.png,502730,27117,475613,0.9460605096174886,4,6,61265,3912,57353,0.9361462498979842,25.00584,3245.6972,13.017723600120569,120,6.000000000000001E-4
2,test_20231031_150420,1254659.png,342646,84312,258334,0.7539384671059928,7,6,80080,11676,68404,0.8541958041958042,19.962241777777777,2914.6974026666667,13.484868869095994,120,6.000000000000001E-4
3,test_20231031_150420,10188041.png,221231,10867,210364,0.9508793975527842,3,6,41731,1524,40207,0.9634803862835781,10.502565333333333,989.3086773333333,18.177485425299558,120,6.000000000000001E-4
4,test_20231031_150420,10287332.png,216980,13642,203338,0.9371278458844133,3,6,22337,1861,20476,0.9166853203205444,9.321923555555555,744.2019093333333,19.413895809498406,120,6.000000000000001E-4
5,test_20231031_150420,11610969.png,368720,31297,337423,0.9151198741592537,3,5,84111,4559,79552,0.9457978147923577,19.816019555555556,2600.808432,13.979719963649465,120,6.000000000000001E-4
6,test_20231031_150420,10350842.png,212614,7309,205305,0.965623148052339,2,6,42529,1072,41457,0.9747936702015095,18.37208711111111,2173.3855946666667,14.75943576664335,120,6.000000000000001E-4
7,test_20231031_150420,10863862.png,317432,15277,302155,0.951873157085612,3,6,66058,2180,63878,0.9669986981137788,23.077662222222223,3070.805008,13.258281206665272,120,6.000000000000001E-4
8,test_20231031_150420,11382381.png,312486,847,311639,0.9972894785686399,2,5,46745,110,46635,0.9976468071451492,21.358711111111113,2440.977456,14.2551659242164,120,6.000000000000001E-4
9,test_20231031_150420,11079715.png,443815,132247,311568,0.702022238995978,5,7,124136,18385,105751,0.8518963072758909,16.302611555555554,1952.235056,15.225482537985677,120,6.000000000000001E-4
10,test_20231031_150420,11551286.png,271883,567,271316,0.9979145441237591,2,5,40092,82,40010,0.9979547041803851,17.920218666666667,1855.396624,15.446435988293219,120,6.000000000000001E-4
1,test_20231031_150421,10404007.png,502730,26794,475936,0.9467030016112028,4,6,61265,3866,57399,0.9368970864278136,25.095884444444444,3265.691738666667,12.991051732763237,120,7.000000000000001E-4
2,test_20231031_150421,1254659.png,342646,84312,258334,0.7539384671059928,5,6,80080,11676,68404,0.8541958041958042,19.962241777777777,2914.6974026666667,13.484868869095994,120,7.000000000000001E-4
3,test_20231031_150421,10188041.png,221231,10867,210364,0.9508793975527842,3,5,41731,1524,40207,0.9634803862835781,10.502565333333333,989.3086773333333,18.177485425299558,120,7.000000000000001E-4
4,test_20231031_150421,10287332.png,216980,13642,203338,0.9371278458844133,2,6,22337,1861,20476,0.9166853203205444,9.321923555555555,744.2019093333333,19.413895809498406,120,7.000000000000001E-4
5,test_20231031_150421,11610969.png,368720,31297,337423,0.9151198741592537,4,6,84111,4559,79552,0.9457978147923577,19.816019555555556,2600.808432,13.979719963649465,120,7.000000000000001E-4
6,test_20231031_150421,10350842.png,212614,7309,205305,0.965623148052339,2,5,42529,1072,41457,0.9747936702015095,18.37208711111111,2173.3855946666667,14.75943576664335,120,7.000000000000001E-4
7,test_20231031_150421,10863862.png,317432,15277,302155,0.951873157085612,3,6,66058,2180,63878,0.9669986981137788,23.077662222222223,3070.805008,13.258281206665272,120,7.000000000000001E-4
8,test_20231031_150421,11382381.png,312486,847,311639,0.9972894785686399,2,6,46745,110,46635,0.9976468071451492,21.358711111111113,2440.977456,14.2551659242164,120,7.000000000000001E-4
9,test_20231031_150421,11079715.png,443815,132247,311568,0.702022238995978,8,7,124136,18385,105751,0.8518963072758909,16.302611555555554,1952.235056,15.225482537985677,120,7.000000000000001E-4
10,test_20231031_150421,11551286.png,271883,567,271316,0.9979145441237591,2,6,40092,82,40010,0.9979547041803851,17.920218666666667,1855.396624,15.446435988293219,120,7.000000000000001E-4
1,test_20231031_150422,10404007.png,502730,26252,476478,0.9477811151114912,3,5,61265,3789,57476,0.938153921488615,25.131184,3274.4032693333334,12.979481956084404,120,8.000000000000001E-4
2,test_20231031_150422,1254659.png,342646,84312,258334,0.7539384671059928,5,7,80080,11676,68404,0.8541958041958042,19.962241777777777,2914.6974026666667,13.484868869095994,120,8.000000000000001E-4
3,test_20231031_150422,10188041.png,221231,10767,210464,0.9513314137711261,3,5,41731,1511,40220,0.9637919052982196,10.630209777777777,1000.4570826666667,18.128818977415765,120,8.000000000000001E-4
4,test_20231031_150422,10287332.png,216980,13642,203338,0.9371278458844133,3,6,22337,1861,20476,0.9166853203205444,9.321923555555555,744.2019093333333,19.413895809498406,120,8.000000000000001E-4
5,test_20231031_150422,11610969.png,368720,31297,337423,0.9151198741592537,5,6,84111,4559,79552,0.9457978147923577,19.816019555555556,2600.808432,13.979719963649465,120,8.000000000000001E-4
6,test_20231031_150422,10350842.png,212614,7167,205447,0.9662910250500908,3,5,42529,1051,41478,0.9752874509158457,18.742366222222223,2242.4111946666667,14.623651080056984,120,8.000000000000001E-4
7,test_20231031_150422,10863862.png,317432,15217,302215,0.952062173945916,3,6,66058,2171,63887,0.9671349420206485,23.119511111111112,3072.6719413333335,13.255641662718435,120,8.000000000000001E-4
8,test_20231031_150422,11382381.png,312486,847,311639,0.9972894785686399,2,5,46745,110,46635,0.9976468071451492,21.358711111111113,2440.977456,14.2551659242164,120,8.000000000000001E-4
9,test_20231031_150422,11079715.png,443815,132247,311568,0.702022238995978,5,6,124136,18385,105751,0.8518963072758909,16.302611555555554,1952.235056,15.225482537985677,120,8.000000000000001E-4
10,test_20231031_150422,11551286.png,271883,567,271316,0.9979145441237591,3,5,40092,82,40010,0.9979547041803851,17.920218666666667,1855.396624,15.446435988293219,120,8.000000000000001E-4
1,test_20231031_150423,10404007.png,502730,26252,476478,0.9477811151114912,4,6,61265,3789,57476,0.938153921488615,25.131184,3274.4032693333334,12.979481956084404,120,9.000000000000002E-4
2,test_20231031_150423,1254659.png,342646,84312,258334,0.7539384671059928,5,6,80080,11676,68404,0.8541958041958042,19.962241777777777,2914.6974026666667,13.484868869095994,120,9.000000000000002E-4
3,test_20231031_150423,10188041.png,221231,10767,210464,0.9513314137711261,3,6,41731,1511,40220,0.9637919052982196,10.630209777777777,1000.4570826666667,18.128818977415765,120,9.000000000000002E-4
4,test_20231031_150423,10287332.png,216980,13642,203338,0.9371278458844133,3,6,22337,1861,20476,0.9166853203205444,9.321923555555555,744.2019093333333,19.413895809498406,120,9.000000000000002E-4
5,test_20231031_150423,11610969.png,368720,31297,337423,0.9151198741592537,3,6,84111,4559,79552,0.9457978147923577,19.816019555555556,2600.808432,13.979719963649465,120,9.000000000000002E-4
6,test_20231031_150423,10350842.png,212614,7167,205447,0.9662910250500908,3,5,42529,1051,41478,0.9752874509158457,18.742366222222223,2242.4111946666667,14.623651080056984,120,9.000000000000002E-4
7,test_20231031_150423,10863862.png,317432,15217,302215,0.952062173945916,4,6,66058,2171,63887,0.9671349420206485,23.119511111111112,3072.6719413333335,13.255641662718435,120,9.000000000000002E-4
8,test_20231031_150423,11382381.png,312486,847,311639,0.9972894785686399,2,6,46745,110,46635,0.9976468071451492,21.358711111111113,2440.977456,14.2551659242164,120,9.000000000000002E-4
9,test_20231031_150423,11079715.png,443815,132247,311568,0.702022238995978,5,7,124136,18385,105751,0.8518963072758909,16.302611555555554,1952.235056,15.225482537985677,120,9.000000000000002E-4
10,test_20231031_150423,11551286.png,271883,567,271316,0.9979145441237591,1,5,40092,82,40010,0.9979547041803851,17.920218666666667,1855.396624,15.446435988293219,120,9.000000000000002E-4
1,test_20231031_150424,10404007.png,502730,26112,476618,0.9480595946134108,4,6,61265,3765,57500,0.9385456622867869,25.063852444444443,3263.948144,12.993371105880328,121,1.0E-4
2,test_20231031_150424,1254659.png,342646,82322,260324,0.7597462103745557,5,6,80080,11414,68666,0.8574675324675325,20.146789333333334,2968.9748,13.404738494515186,121,1.0E-4
3,test_20231031_150424,10188041.png,221231,10747,210484,0.9514218170147944,3,19,41731,1508,40223,0.9638637943015983,10.256744888888889,960.6228746666667,18.30527436879325,121,1.0E-4
4,test_20231031_150424,10287332.png,216980,13682,203298,0.9369434970965066,3,6,22337,1863,20474,0.9165957827819313,9.239728,729.57032,19.500132029302378,121,1.0E-4
5,test_20231031_150424,11610969.png,368720,30472,338248,0.9173573443263181,4,6,84111,4439,79672,0.9472245009570687,19.285690666666667,2490.9437173333336,14.167164460683386,121,1.0E-4
6,test_20231031_150424,10350842.png,212614,7329,205285,0.965529080869557,2,5,42529,1075,41454,0.9747231300994615,16.994460444444446,1865.2112533333334,15.423523338592997,121,1.0E-4
7,test_20231031_150424,10863862.png,317432,14797,302635,0.9533852919680436,3,6,66058,2120,63938,0.9679069908262437,23.245306666666668,3112.5087946666667,13.199697736252237,121,1.0E-4
8,test_20231031_150424,11382381.png,312486,1199,311287,0.9961630281036591,2,6,46745,164,46581,0.9964916033800406,20.298848,2271.7021546666665,14.56728970917017,121,1.0E-4
9,test_20231031_150424,11079715.png,443815,130027,313788,0.7070243231977288,6,7,124136,18094,106042,0.8542405104079397,16.408837333333334,1978.80552,15.166772476828436,121,1.0E-4
10,test_20231031_150424,11551286.png,271883,1362,270521,0.9949904922337918,2,5,40092,200,39892,0.9950114736106954,15.756325333333333,1488.0124746666668,16.404737887600753,121,1.0E-4
1,test_20231031_150425,10404007.png,502730,26112,476618,0.9480595946134108,3,6,61265,3765,57500,0.9385456622867869,25.063852444444443,3263.948144,12.993371105880328,121,2.0E-4
2,test_20231031_150425,1254659.png,342646,82322,260324,0.7597462103745557,5,7,80080,11414,68666,0.8574675324675325,20.146789333333334,2968.9748,13.404738494515186,121,2.0E-4
3,test_20231031_150425,10188041.png,221231,10747,210484,0.9514218170147944,3,6,41731,1508,40223,0.9638637943015983,10.256744888888889,960.6228746666667,18.30527436879325,121,2.0E-4
4,test_20231031_150425,10287332.png,216980,13429,203551,0.9381095031800166,2,5,22337,1833,20504,0.9179388458611273,9.370778666666666,756.6213706666666,19.342017571499717,121,2.0E-4
5,test_20231031_150425,11610969.png,368720,30472,338248,0.9173573443263181,4,5,84111,4439,79672,0.9472245009570687,19.285690666666667,2490.9437173333336,14.167164460683386,121,2.0E-4
6,test_20231031_150425,10350842.png,212614,7329,205285,0.965529080869557,2,5,42529,1075,41454,0.9747231300994615,16.994460444444446,1865.2112533333334,15.423523338592997,121,2.0E-4
7,test_20231031_150425,10863862.png,317432,14797,302635,0.9533852919680436,3,5,66058,2120,63938,0.9679069908262437,23.245306666666668,3112.5087946666667,13.199697736252237,121,2.0E-4
8,test_20231031_150425,11382381.png,312486,1199,311287,0.9961630281036591,2,9,46745,164,46581,0.9964916033800406,20.298848,2271.7021546666665,14.56728970917017,121,2.0E-4
9,test_20231031_150425,11079715.png,443815,130027,313788,0.7070243231977288,6,7,124136,18094,106042,0.8542405104079397,16.408837333333334,1978.80552,15.166772476828436,121,2.0E-4
10,test_20231031_150425,11551286.png,271883,1362,270521,0.9949904922337918,2,6,40092,200,39892,0.9950114736106954,15.756325333333333,1488.0124746666668,16.404737887600753,121,2.0E-4
1,test_20231031_150426,10404007.png,502730,25849,476881,0.9485827382491596,3,6,61265,3728,57537,0.9391495960173019,25.087061333333335,3268.065152,12.987896548459542,121,3.0000000000000003E-4
2,test_20231031_150426,1254659.png,342646,82262,260384,0.7599213182117988,5,6,80080,11409,68671,0.85752997002997,20.156343111111113,2970.0569866666665,13.403155786357337,121,3.0000000000000003E-4
3,test_20231031_150426,10188041.png,221231,10667,210564,0.9517834299894681,3,5,41731,1496,40235,0.9641513503151135,10.409946666666666,981.2383306666667,18.21305855911757,121,3.0000000000000003E-4
4,test_20231031_150426,10287332.png,216980,13429,203551,0.9381095031800166,2,6,22337,1833,20504,0.9179388458611273,9.370778666666666,756.6213706666666,19.342017571499717,121,3.0000000000000003E-4
5,test_20231031_150426,11610969.png,368720,30412,338308,0.9175200694293772,3,6,84111,4432,79679,0.9473077243166768,19.617939555555555,2565.311952,14.039401762955164,121,3.0000000000000003E-4
6,test_20231031_150426,10350842.png,212614,7187,205427,0.9661969578673089,2,6,42529,1054,41475,0.9752169108137977,17.523210666666667,1977.5073386666666,15.169622569983105,121,3.0000000000000003E-4
7,test_20231031_150426,10863862.png,317432,14697,302735,0.9537003200685501,3,6,66058,2105,63953,0.9681340640043599,23.275838222222223,3117.6927946666665,13.192470415975402,121,3.0000000000000003E-4
8,test_20231031_150426,11382381.png,312486,967,311519,0.9969054613646692,2,5,46745,130,46615,0.9972189538988127,21.068341333333333,2406.1475626666665,14.317581029153203,121,3.0000000000000003E-4
9,test_20231031_150426,11079715.png,443815,130027,313788,0.7070243231977288,6,7,124136,18094,106042,0.8542405104079397,16.408837333333334,1978.80552,15.166772476828436,121,3.0000000000000003E-4
10,test_20231031_150426,11551286.png,271883,1219,270664,0.9955164537687167,2,6,40092,179,39913,0.9955352688815724,16.076115555555557,1539.5683893333332,16.25681375358216,121,3.0000000000000003E-4
1,test_20231031_150427,10404007.png,502730,25849,476881,0.9485827382491596,3,6,61265,3728,57537,0.9391495960173019,25.087061333333335,3268.065152,12.987896548459542,121,4.0E-4
2,test_20231031_150427,1254659.png,342646,82262,260384,0.7599213182117988,6,6,80080,11409,68671,0.85752997002997,20.156343111111113,2970.0569866666665,13.403155786357337,121,4.0E-4
3,test_20231031_150427,10188041.png,221231,10667,210564,0.9517834299894681,3,5,41731,1496,40235,0.9641513503151135,10.409946666666666,981.2383306666667,18.21305855911757,121,4.0E-4
4,test_20231031_150427,10287332.png,216980,13429,203551,0.9381095031800166,2,6,22337,1833,20504,0.9179388458611273,9.370778666666666,756.6213706666666,19.342017571499717,121,4.0E-4
5,test_20231031_150427,11610969.png,368720,30412,338308,0.9175200694293772,4,6,84111,4432,79679,0.9473077243166768,19.617939555555555,2565.311952,14.039401762955164,121,4.0E-4
6,test_20231031_150427,10350842.png,212614,7187,205427,0.9661969578673089,2,6,42529,1054,41475,0.9752169108137977,17.523210666666667,1977.5073386666666,15.169622569983105,121,4.0E-4
7,test_20231031_150427,10863862.png,317432,14697,302735,0.9537003200685501,3,7,66058,2105,63953,0.9681340640043599,23.275838222222223,3117.6927946666665,13.192470415975402,121,4.0E-4
8,test_20231031_150427,11382381.png,312486,827,311659,0.9973534814359684,3,5,46745,109,46636,0.997668199807466,21.564144,2476.360432,14.192665047538828,121,4.0E-4
9,test_20231031_150427,11079715.png,443815,130027,313788,0.7070243231977288,5,7,124136,18094,106042,0.8542405104079397,16.408837333333334,1978.80552,15.166772476828436,121,4.0E-4
10,test_20231031_150427,11551286.png,271883,607,271276,0.9977674220160878,2,6,40092,88,40004,0.997805048388706,17.77655288888889,1839.618896,15.483524990035365,121,4.0E-4
1,test_20231031_150428,10404007.png,502730,25849,476881,0.9485827382491596,4,6,61265,3728,57537,0.9391495960173019,25.087061333333335,3268.065152,12.987896548459542,121,5.0E-4
2,test_20231031_150428,1254659.png,342646,82262,260384,0.7599213182117988,7,7,80080,11409,68671,0.85752997002997,20.156343111111113,2970.0569866666665,13.403155786357337,121,5.0E-4
3,test_20231031_150428,10188041.png,221231,10667,210564,0.9517834299894681,3,5,41731,1496,40235,0.9641513503151135,10.409946666666666,981.2383306666667,18.21305855911757,121,5.0E-4
4,test_20231031_150428,10287332.png,216980,13429,203551,0.9381095031800166,3,5,22337,1833,20504,0.9179388458611273,9.370778666666666,756.6213706666666,19.342017571499717,121,5.0E-4
5,test_20231031_150428,11610969.png,368720,30412,338308,0.9175200694293772,4,6,84111,4432,79679,0.9473077243166768,19.617939555555555,2565.311952,14.039401762955164,121,5.0E-4
6,test_20231031_150428,10350842.png,212614,7187,205427,0.9661969578673089,3,6,42529,1054,41475,0.9752169108137977,17.523210666666667,1977.5073386666666,15.169622569983105,121,5.0E-4
7,test_20231031_150428,10863862.png,317432,14697,302735,0.9537003200685501,3,5,66058,2105,63953,0.9681340640043599,23.275838222222223,3117.6927946666665,13.192470415975402,121,5.0E-4
8,test_20231031_150428,11382381.png,312486,827,311659,0.9973534814359684,2,6,46745,109,46636,0.997668199807466,21.564144,2476.360432,14.192665047538828,121,5.0E-4
9,test_20231031_150428,11079715.png,443815,130027,313788,0.7070243231977288,6,7,124136,18094,106042,0.8542405104079397,16.408837333333334,1978.80552,15.166772476828436,121,5.0E-4
10,test_20231031_150428,11551286.png,271883,607,271276,0.9977674220160878,2,5,40092,88,40004,0.997805048388706,17.77655288888889,1839.618896,15.483524990035365,121,5.0E-4
1,test_20231031_150429,10404007.png,502730,25407,477323,0.9494619378195055,3,6,61265,3666,57599,0.9401615930792458,25.18988977777778,3290.26648,12.958492878094653,121,6.000000000000001E-4
2,test_20231031_150429,1254659.png,342646,82262,260384,0.7599213182117988,5,7,80080,11409,68671,0.85752997002997,20.156343111111113,2970.0569866666665,13.403155786357337,121,6.000000000000001E-4
3,test_20231031_150429,10188041.png,221231,10567,210664,0.95223544620781,3,5,41731,1482,40249,0.9644868323308811,10.533299555555555,996.9537226666666,18.14405361490014,121,6.000000000000001E-4
4,test_20231031_150429,10287332.png,216980,13429,203551,0.9381095031800166,2,5,22337,1833,20504,0.9179388458611273,9.370778666666666,756.6213706666666,19.342017571499717,121,6.000000000000001E-4
5,test_20231031_150429,11610969.png,368720,30069,338651,0.9184503146018659,3,5,84111,4382,79729,0.9479021768853063,20.036851555555554,2651.808336,13.895382293801273,121,6.000000000000001E-4
6,test_20231031_150429,10350842.png,212614,6967,205647,0.9672316968779102,3,6,42529,1022,41507,0.9759693385689765,18.40685866666667,2182.083690666667,14.742089575588938,121,6.000000000000001E-4
7,test_20231031_150429,10863862.png,317432,14697,302735,0.9537003200685501,4,6,66058,2105,63953,0.9681340640043599,23.275838222222223,3117.6927946666665,13.192470415975402,121,6.000000000000001E-4
8,test_20231031_150429,11382381.png,312486,827,311659,0.9973534814359684,2,6,46745,109,46636,0.997668199807466,21.564144,2476.360432,14.192665047538828,121,6.000000000000001E-4
9,test_20231031_150429,11079715.png,443815,130027,313788,0.7070243231977288,5,6,124136,18094,106042,0.8542405104079397,16.408837333333334,1978.80552,15.166772476828436,121,6.000000000000001E-4
10,test_20231031_150429,11551286.png,271883,527,271356,0.9980616662314304,2,6,40092,76,40016,0.9981043599720643,17.926654222222222,1858.3108106666666,15.43962007470492,121,6.000000000000001E-4
1,test_20231031_150430,10404007.png,502730,25407,477323,0.9494619378195055,3,5,61265,3666,57599,0.9401615930792458,25.18988977777778,3290.26648,12.958492878094653,121,7.000000000000001E-4
2,test_20231031_150430,1254659.png,342646,82262,260384,0.7599213182117988,5,7,80080,11409,68671,0.85752997002997,20.156343111111113,2970.0569866666665,13.403155786357337,121,7.000000000000001E-4
3,test_20231031_150430,10188041.png,221231,10567,210664,0.95223544620781,3,6,41731,1482,40249,0.9644868323308811,10.533299555555555,996.9537226666666,18.14405361490014,121,7.000000000000001E-4
4,test_20231031_150430,10287332.png,216980,13429,203551,0.9381095031800166,2,5,22337,1833,20504,0.9179388458611273,9.370778666666666,756.6213706666666,19.342017571499717,121,7.000000000000001E-4
5,test_20231031_150430,11610969.png,368720,30069,338651,0.9184503146018659,4,11,84111,4382,79729,0.9479021768853063,20.036851555555554,2651.808336,13.895382293801273,121,7.000000000000001E-4
6,test_20231031_150430,10350842.png,212614,6967,205647,0.9672316968779102,2,7,42529,1022,41507,0.9759693385689765,18.40685866666667,2182.083690666667,14.742089575588938,121,7.000000000000001E-4
7,test_20231031_150430,10863862.png,317432,14697,302735,0.9537003200685501,3,6,66058,2105,63953,0.9681340640043599,23.275838222222223,3117.6927946666665,13.192470415975402,121,7.000000000000001E-4
8,test_20231031_150430,11382381.png,312486,827,311659,0.9973534814359684,2,6,46745,109,46636,0.997668199807466,21.564144,2476.360432,14.192665047538828,121,7.000000000000001E-4
9,test_20231031_150430,11079715.png,443815,130027,313788,0.7070243231977288,6,7,124136,18094,106042,0.8542405104079397,16.408837333333334,1978.80552,15.166772476828436,121,7.000000000000001E-4
10,test_20231031_150430,11551286.png,271883,527,271356,0.9980616662314304,2,5,40092,76,40016,0.9981043599720643,17.926654222222222,1858.3108106666666,15.43962007470492,121,7.000000000000001E-4
1,test_20231031_150431,10404007.png,502730,25107,477623,0.950058679609333,4,6,61265,3624,57641,0.9408471394760467,25.206074666666666,3294.1665333333335,12.953348101508894,121,8.000000000000001E-4
2,test_20231031_150431,1254659.png,342646,82262,260384,0.7599213182117988,6,7,80080,11409,68671,0.85752997002997,20.156343111111113,2970.0569866666665,13.403155786357337,121,8.000000000000001E-4
3,test_20231031_150431,10188041.png,221231,10484,210747,0.9526106196690337,3,5,41731,1472,40259,0.9647264623421438,10.660069333333333,1007.872112,18.09674932504763,121,8.000000000000001E-4
4,test_20231031_150431,10287332.png,216980,13429,203551,0.9381095031800166,2,6,22337,1833,20504,0.9179388458611273,9.370778666666666,756.6213706666666,19.342017571499717,121,8.000000000000001E-4
5,test_20231031_150431,11610969.png,368720,30069,338651,0.9184503146018659,3,5,84111,4382,79729,0.9479021768853063,20.036851555555554,2651.808336,13.895382293801273,121,8.000000000000001E-4
6,test_20231031_150431,10350842.png,212614,6847,205767,0.9677960999746018,3,6,42529,1004,41525,0.9763925791812645,18.767114666666668,2248.3353386666668,14.612192742239138,121,8.000000000000001E-4
7,test_20231031_150431,10863862.png,317432,14634,302798,0.9538987877718692,3,5,66058,2096,63962,0.9682703079112295,23.317687111111113,3119.559728,13.189870556931647,121,8.000000000000001E-4
8,test_20231031_150431,11382381.png,312486,827,311659,0.9973534814359684,2,5,46745,109,46636,0.997668199807466,21.564144,2476.360432,14.192665047538828,121,8.000000000000001E-4
9,test_20231031_150431,11079715.png,443815,130027,313788,0.7070243231977288,5,7,124136,18094,106042,0.8542405104079397,16.408837333333334,1978.80552,15.166772476828436,121,8.000000000000001E-4
10,test_20231031_150431,11551286.png,271883,527,271356,0.9980616662314304,2,5,40092,76,40016,0.9981043599720643,17.926654222222222,1858.3108106666666,15.43962007470492,121,8.000000000000001E-4
1,test_20231031_150432,10404007.png,502730,25107,477623,0.950058679609333,5,8,61265,3624,57641,0.9408471394760467,25.206074666666666,3294.1665333333335,12.953348101508894,121,9.000000000000002E-4
2,test_20231031_150432,1254659.png,342646,82262,260384,0.7599213182117988,8,10,80080,11409,68671,0.85752997002997,20.156343111111113,2970.0569866666665,13.403155786357337,121,9.000000000000002E-4
3,test_20231031_150432,10188041.png,221231,10484,210747,0.9526106196690337,5,7,41731,1472,40259,0.9647264623421438,10.660069333333333,1007.872112,18.09674932504763,121,9.000000000000002E-4
4,test_20231031_150432,10287332.png,216980,13429,203551,0.9381095031800166,3,6,22337,1833,20504,0.9179388458611273,9.370778666666666,756.6213706666666,19.342017571499717,121,9.000000000000002E-4
5,test_20231031_150432,11610969.png,368720,30069,338651,0.9184503146018659,6,5,84111,4382,79729,0.9479021768853063,20.036851555555554,2651.808336,13.895382293801273,121,9.000000000000002E-4
6,test_20231031_150432,10350842.png,212614,6847,205767,0.9677960999746018,2,5,42529,1004,41525,0.9763925791812645,18.767114666666668,2248.3353386666668,14.612192742239138,121,9.000000000000002E-4
7,test_20231031_150432,10863862.png,317432,14634,302798,0.9538987877718692,3,6,66058,2096,63962,0.9682703079112295,23.317687111111113,3119.559728,13.189870556931647,121,9.000000000000002E-4
8,test_20231031_150432,11382381.png,312486,827,311659,0.9973534814359684,3,6,46745,109,46636,0.997668199807466,21.564144,2476.360432,14.192665047538828,121,9.000000000000002E-4
9,test_20231031_150432,11079715.png,443815,130027,313788,0.7070243231977288,6,7,124136,18094,106042,0.8542405104079397,16.408837333333334,1978.80552,15.166772476828436,121,9.000000000000002E-4
10,test_20231031_150432,11551286.png,271883,527,271356,0.9980616662314304,2,5,40092,76,40016,0.9981043599720643,17.926654222222222,1858.3108106666666,15.43962007470492,121,9.000000000000002E-4
1,test_20231031_150434,10404007.png,502730,25187,477543,0.949899548465379,4,6,61265,3630,57635,0.9407492042765038,25.12879288888889,3282.03776,12.969367875434926,122,1.0E-4
2,test_20231031_150434,1254659.png,342646,79962,262684,0.7666337853061177,4,6,80080,11106,68974,0.8613136863136863,20.326528,3020.2829653333333,13.330327276703748,122,1.0E-4
3,test_20231031_150434,10188041.png,221231,10484,210747,0.9526106196690337,3,6,41731,1476,40255,0.9646306103376386,10.29104711111111,967.4823253333333,18.274373211101064,122,1.0E-4
4,test_20231031_150434,10287332.png,216980,13317,203663,0.9386256797861554,3,6,22337,1816,20521,0.9186999149393383,9.276503111111111,739.8157706666667,19.43956775926238,122,1.0E-4
5,test_20231031_150434,11610969.png,368720,29517,339203,0.9199473855500109,3,6,84111,4304,79807,0.9488295228923684,19.500469333333335,2542.365472,14.078423791408932,122,1.0E-4
6,test_20231031_150434,10350842.png,212614,7067,205547,0.9667613609640004,3,6,42529,1036,41493,0.9756401514260857,17.272896,1936.234528,15.261224004330279,122,1.0E-4
7,test_20231031_150434,10863862.png,317432,14152,303280,0.955417223216311,3,6,66058,2034,64024,0.9692088770474432,23.416272,3158.1188533333334,13.136518905548746,122,1.0E-4
8,test_20231031_150434,11382381.png,312486,1159,311327,0.996291033838316,3,6,46745,158,46587,0.9966199593539415,20.606709333333335,2334.900224,14.448120340351833,122,1.0E-4
9,test_20231031_150434,11079715.png,443815,127382,316433,0.7129840136092742,6,7,124136,17736,106400,0.8571244441580202,16.53779911111111,2010.815104,15.097082221479486,122,1.0E-4
10,test_20231031_150434,11551286.png,271883,1322,270561,0.9951376143414631,3,6,40092,194,39898,0.9951611294023746,15.757246222222221,1488.3021066666668,16.40389264375073,122,1.0E-4
1,test_20231031_150435,10404007.png,502730,25187,477543,0.949899548465379,4,6,61265,3630,57635,0.9407492042765038,25.12879288888889,3282.03776,12.969367875434926,122,2.0E-4
2,test_20231031_150435,1254659.png,342646,79962,262684,0.7666337853061177,5,6,80080,11106,68974,0.8613136863136863,20.326528,3020.2829653333333,13.330327276703748,122,2.0E-4
3,test_20231031_150435,10188041.png,221231,10484,210747,0.9526106196690337,4,6,41731,1476,40255,0.9646306103376386,10.29104711111111,967.4823253333333,18.274373211101064,122,2.0E-4
4,test_20231031_150435,10287332.png,216980,13087,203893,0.939685685316619,3,6,22337,1789,20548,0.9199086717106146,9.406264888888888,766.5465173333333,19.285418460243026,122,2.0E-4
5,test_20231031_150435,11610969.png,368720,29517,339203,0.9199473855500109,3,5,84111,4304,79807,0.9488295228923684,19.500469333333335,2542.365472,14.078423791408932,122,2.0E-4
6,test_20231031_150435,10350842.png,212614,7067,205547,0.9667613609640004,3,6,42529,1036,41493,0.9756401514260857,17.272896,1936.234528,15.261224004330279,122,2.0E-4
7,test_20231031_150435,10863862.png,317432,14152,303280,0.955417223216311,3,5,66058,2034,64024,0.9692088770474432,23.416272,3158.1188533333334,13.136518905548746,122,2.0E-4
8,test_20231031_150435,11382381.png,312486,1159,311327,0.996291033838316,2,5,46745,158,46587,0.9966199593539415,20.606709333333335,2334.900224,14.448120340351833,122,2.0E-4
9,test_20231031_150435,11079715.png,443815,127382,316433,0.7129840136092742,7,7,124136,17736,106400,0.8571244441580202,16.53779911111111,2010.815104,15.097082221479486,122,2.0E-4
10,test_20231031_150435,11551286.png,271883,1322,270561,0.9951376143414631,3,6,40092,194,39898,0.9951611294023746,15.757246222222221,1488.3021066666668,16.40389264375073,122,2.0E-4
1,test_20231031_150436,10404007.png,502730,24924,477806,0.9504226921011278,4,6,61265,3592,57673,0.9413694605402758,25.162432,3287.893781333333,12.961625820868626,122,3.0000000000000003E-4
2,test_20231031_150436,1254659.png,342646,79902,262744,0.7668088931433608,5,6,80080,11101,68979,0.861376123876124,20.33608177777778,3021.365152,13.328771450566173,122,3.0000000000000003E-4
3,test_20231031_150436,10188041.png,221231,10304,210927,0.9534242488620491,3,6,41731,1450,40281,0.9652536483669215,10.567601777777778,1003.8131733333333,18.114274701111977,122,3.0000000000000003E-4
4,test_20231031_150436,10287332.png,216980,13087,203893,0.939685685316619,3,6,22337,1789,20548,0.9199086717106146,9.406264888888888,766.5465173333333,19.285418460243026,122,3.0000000000000003E-4
5,test_20231031_150436,11610969.png,368720,29457,339263,0.92011011065307,4,6,84111,4297,79814,0.9489127462519765,19.832718222222223,2616.733706666667,13.953208321942551,122,3.0000000000000003E-4
6,test_20231031_150436,10350842.png,212614,6727,205887,0.9683605030712935,3,6,42529,986,41543,0.9768158197935526,18.680309333333334,2252.1961813333332,14.604741430901797,122,3.0000000000000003E-4
7,test_20231031_150436,10863862.png,317432,14072,303360,0.9556692456967162,3,6,66058,2022,64036,0.9693905355899362,23.44550577777778,3163.1715893333335,13.129576095846978,122,3.0000000000000003E-4
8,test_20231031_150436,11382381.png,312486,967,311519,0.9969054613646692,2,5,46745,130,46615,0.9972189538988127,21.068341333333333,2406.1475626666665,14.317581029153203,122,3.0000000000000003E-4
9,test_20231031_150436,11079715.png,443815,127382,316433,0.7129840136092742,6,7,124136,17736,106400,0.8571244441580202,16.53779911111111,2010.815104,15.097082221479486,122,3.0000000000000003E-4
10,test_20231031_150436,11551286.png,271883,847,271036,0.9968846893700599,2,6,40092,124,39968,0.9969071136386312,17.065274666666667,1704.2078666666666,15.81557795178707,122,3.0000000000000003E-4
1,test_20231031_150437,10404007.png,502730,24924,477806,0.9504226921011278,3,5,61265,3592,57673,0.9413694605402758,25.162432,3287.893781333333,12.961625820868626,122,4.0E-4
2,test_20231031_150437,1254659.png,342646,79902,262744,0.7668088931433608,5,6,80080,11101,68979,0.861376123876124,20.33608177777778,3021.365152,13.328771450566173,122,4.0E-4
3,test_20231031_150437,10188041.png,221231,10304,210927,0.9534242488620491,3,5,41731,1450,40281,0.9652536483669215,10.567601777777778,1003.8131733333333,18.114274701111977,122,4.0E-4
4,test_20231031_150437,10287332.png,216980,13087,203893,0.939685685316619,2,5,22337,1789,20548,0.9199086717106146,9.406264888888888,766.5465173333333,19.285418460243026,122,4.0E-4
5,test_20231031_150437,11610969.png,368720,29457,339263,0.92011011065307,4,6,84111,4297,79814,0.9489127462519765,19.832718222222223,2616.733706666667,13.953208321942551,122,4.0E-4
6,test_20231031_150437,10350842.png,212614,6727,205887,0.9683605030712935,3,6,42529,986,41543,0.9768158197935526,18.680309333333334,2252.1961813333332,14.604741430901797,122,4.0E-4
7,test_20231031_150437,10863862.png,317432,14072,303360,0.9556692456967162,3,6,66058,2022,64036,0.9693905355899362,23.44550577777778,3163.1715893333335,13.129576095846978,122,4.0E-4
8,test_20231031_150437,11382381.png,312486,827,311659,0.9973534814359684,2,6,46745,109,46636,0.997668199807466,21.564144,2476.360432,14.192665047538828,122,4.0E-4
9,test_20231031_150437,11079715.png,443815,127382,316433,0.7129840136092742,6,7,124136,17736,106400,0.8571244441580202,16.53779911111111,2010.815104,15.097082221479486,122,4.0E-4
10,test_20231031_150437,11551286.png,271883,607,271276,0.9977674220160878,2,6,40092,88,40004,0.997805048388706,17.77655288888889,1839.618896,15.483524990035365,122,4.0E-4
1,test_20231031_150438,10404007.png,502730,24924,477806,0.9504226921011278,4,5,61265,3592,57673,0.9413694605402758,25.162432,3287.893781333333,12.961625820868626,122,5.0E-4
2,test_20231031_150438,1254659.png,342646,79902,262744,0.7668088931433608,5,6,80080,11101,68979,0.861376123876124,20.33608177777778,3021.365152,13.328771450566173,122,5.0E-4
3,test_20231031_150438,10188041.png,221231,10304,210927,0.9534242488620491,3,6,41731,1450,40281,0.9652536483669215,10.567601777777778,1003.8131733333333,18.114274701111977,122,5.0E-4
4,test_20231031_150438,10287332.png,216980,13087,203893,0.939685685316619,2,5,22337,1789,20548,0.9199086717106146,9.406264888888888,766.5465173333333,19.285418460243026,122,5.0E-4
5,test_20231031_150438,11610969.png,368720,29457,339263,0.92011011065307,4,5,84111,4297,79814,0.9489127462519765,19.832718222222223,2616.733706666667,13.953208321942551,122,5.0E-4
6,test_20231031_150438,10350842.png,212614,6727,205887,0.9683605030712935,2,5,42529,986,41543,0.9768158197935526,18.680309333333334,2252.1961813333332,14.604741430901797,122,5.0E-4
7,test_20231031_150438,10863862.png,317432,14072,303360,0.9556692456967162,3,5,66058,2022,64036,0.9693905355899362,23.44550577777778,3163.1715893333335,13.129576095846978,122,5.0E-4
8,test_20231031_150438,11382381.png,312486,827,311659,0.9973534814359684,2,5,46745,109,46636,0.997668199807466,21.564144,2476.360432,14.192665047538828,122,5.0E-4
9,test_20231031_150438,11079715.png,443815,127382,316433,0.7129840136092742,5,6,124136,17736,106400,0.8571244441580202,16.53779911111111,2010.815104,15.097082221479486,122,5.0E-4
10,test_20231031_150438,11551286.png,271883,607,271276,0.9977674220160878,2,6,40092,88,40004,0.997805048388706,17.77655288888889,1839.618896,15.483524990035365,122,5.0E-4
1,test_20231031_150439,10404007.png,502730,24502,478228,0.9512621088854852,4,6,61265,3533,57732,0.9423324900024483,25.254716444444444,3308.321610666667,12.934726390234932,122,6.000000000000001E-4
2,test_20231031_150439,1254659.png,342646,79902,262744,0.7668088931433608,5,7,80080,11101,68979,0.861376123876124,20.33608177777778,3021.365152,13.328771450566173,122,6.000000000000001E-4
3,test_20231031_150439,10188041.png,221231,10304,210927,0.9534242488620491,3,5,41731,1450,40281,0.9652536483669215,10.567601777777778,1003.8131733333333,18.114274701111977,122,6.000000000000001E-4
4,test_20231031_150439,10287332.png,216980,13087,203893,0.939685685316619,3,6,22337,1789,20548,0.9199086717106146,9.406264888888888,766.5465173333333,19.285418460243026,122,6.000000000000001E-4
5,test_20231031_150439,11610969.png,368720,29117,339603,0.9210322195704057,3,6,84111,4247,79864,0.9495071988206061,20.25163022222222,2703.2300906666665,13.811973477796158,122,6.000000000000001E-4
6,test_20231031_150439,10350842.png,212614,6607,206007,0.9689249061679852,2,5,42529,968,41561,0.9772390604058407,19.040565333333333,2318.447829333333,14.478830331991979,122,6.000000000000001E-4
7,test_20231031_150439,10863862.png,317432,14012,303420,0.9558582625570201,3,5,66058,2013,64045,0.9695267794968059,23.48735466666667,3165.0385226666667,13.127013605493714,122,6.000000000000001E-4
8,test_20231031_150439,11382381.png,312486,827,311659,0.9973534814359684,2,5,46745,109,46636,0.997668199807466,21.564144,2476.360432,14.192665047538828,122,6.000000000000001E-4
9,test_20231031_150439,11079715.png,443815,127382,316433,0.7129840136092742,6,7,124136,17736,106400,0.8571244441580202,16.53779911111111,2010.815104,15.097082221479486,122,6.000000000000001E-4
10,test_20231031_150439,11551286.png,271883,527,271356,0.9980616662314304,5,5,40092,76,40016,0.9981043599720643,17.926654222222222,1858.3108106666666,15.43962007470492,122,6.000000000000001E-4
1,test_20231031_150440,10404007.png,502730,24502,478228,0.9512621088854852,4,6,61265,3533,57732,0.9423324900024483,25.254716444444444,3308.321610666667,12.934726390234932,122,7.000000000000001E-4
2,test_20231031_150440,1254659.png,342646,79902,262744,0.7668088931433608,4,10,80080,11101,68979,0.861376123876124,20.33608177777778,3021.365152,13.328771450566173,122,7.000000000000001E-4
3,test_20231031_150440,10188041.png,221231,10304,210927,0.9534242488620491,3,5,41731,1450,40281,0.9652536483669215,10.567601777777778,1003.8131733333333,18.114274701111977,122,7.000000000000001E-4
4,test_20231031_150440,10287332.png,216980,13087,203893,0.939685685316619,3,6,22337,1789,20548,0.9199086717106146,9.406264888888888,766.5465173333333,19.285418460243026,122,7.000000000000001E-4
5,test_20231031_150440,11610969.png,368720,29117,339603,0.9210322195704057,4,6,84111,4247,79864,0.9495071988206061,20.25163022222222,2703.2300906666665,13.811973477796158,122,7.000000000000001E-4
6,test_20231031_150440,10350842.png,212614,6607,206007,0.9689249061679852,3,6,42529,968,41561,0.9772390604058407,19.040565333333333,2318.447829333333,14.478830331991979,122,7.000000000000001E-4
7,test_20231031_150440,10863862.png,317432,14012,303420,0.9558582625570201,4,7,66058,2013,64045,0.9695267794968059,23.48735466666667,3165.0385226666667,13.127013605493714,122,7.000000000000001E-4
8,test_20231031_150440,11382381.png,312486,827,311659,0.9973534814359684,2,5,46745,109,46636,0.997668199807466,21.564144,2476.360432,14.192665047538828,122,7.000000000000001E-4
9,test_20231031_150440,11079715.png,443815,127382,316433,0.7129840136092742,5,6,124136,17736,106400,0.8571244441580202,16.53779911111111,2010.815104,15.097082221479486,122,7.000000000000001E-4
10,test_20231031_150440,11551286.png,271883,527,271356,0.9980616662314304,2,5,40092,76,40016,0.9981043599720643,17.926654222222222,1858.3108106666666,15.43962007470492,122,7.000000000000001E-4
1,test_20231031_150441,10404007.png,502730,24202,478528,0.9518588506753128,4,6,61265,3491,57774,0.9430180363992492,25.270901333333335,3312.221664,12.92960967468018,122,8.000000000000001E-4
2,test_20231031_150441,1254659.png,342646,79902,262744,0.7668088931433608,5,7,80080,11101,68979,0.861376123876124,20.33608177777778,3021.365152,13.328771450566173,122,8.000000000000001E-4
3,test_20231031_150441,10188041.png,221231,10222,211009,0.9537949021610895,3,7,41731,1440,40291,0.9654932783781841,10.694371555555556,1014.7315626666667,18.06729191792479,122,8.000000000000001E-4
4,test_20231031_150441,10287332.png,216980,13087,203893,0.939685685316619,3,6,22337,1789,20548,0.9199086717106146,9.406264888888888,766.5465173333333,19.285418460243026,122,8.000000000000001E-4
5,test_20231031_150441,11610969.png,368720,29117,339603,0.9210322195704057,4,6,84111,4247,79864,0.9495071988206061,20.25163022222222,2703.2300906666665,13.811973477796158,122,8.000000000000001E-4
6,test_20231031_150441,10350842.png,212614,6607,206007,0.9689249061679852,2,5,42529,968,41561,0.9772390604058407,19.040565333333333,2318.447829333333,14.478830331991979,122,8.000000000000001E-4
7,test_20231031_150441,10863862.png,317432,14012,303420,0.9558582625570201,6,6,66058,2013,64045,0.9695267794968059,23.48735466666667,3165.0385226666667,13.127013605493714,122,8.000000000000001E-4
8,test_20231031_150441,11382381.png,312486,827,311659,0.9973534814359684,2,6,46745,109,46636,0.997668199807466,21.564144,2476.360432,14.192665047538828,122,8.000000000000001E-4
9,test_20231031_150441,11079715.png,443815,127382,316433,0.7129840136092742,5,7,124136,17736,106400,0.8571244441580202,16.53779911111111,2010.815104,15.097082221479486,122,8.000000000000001E-4
10,test_20231031_150441,11551286.png,271883,527,271356,0.9980616662314304,2,13,40092,76,40016,0.9981043599720643,17.926654222222222,1858.3108106666666,15.43962007470492,122,8.000000000000001E-4
1,test_20231031_150442,10404007.png,502730,24202,478528,0.9518588506753128,4,6,61265,3491,57774,0.9430180363992492,25.270901333333335,3312.221664,12.92960967468018,122,9.000000000000002E-4
2,test_20231031_150442,1254659.png,342646,79902,262744,0.7668088931433608,5,6,80080,11101,68979,0.861376123876124,20.33608177777778,3021.365152,13.328771450566173,122,9.000000000000002E-4
3,test_20231031_150442,10188041.png,221231,10222,211009,0.9537949021610895,3,6,41731,1440,40291,0.9654932783781841,10.694371555555556,1014.7315626666667,18.06729191792479,122,9.000000000000002E-4
4,test_20231031_150442,10287332.png,216980,13087,203893,0.939685685316619,2,5,22337,1789,20548,0.9199086717106146,9.406264888888888,766.5465173333333,19.285418460243026,122,9.000000000000002E-4
5,test_20231031_150442,11610969.png,368720,29117,339603,0.9210322195704057,4,6,84111,4247,79864,0.9495071988206061,20.25163022222222,2703.2300906666665,13.811973477796158,122,9.000000000000002E-4
6,test_20231031_150442,10350842.png,212614,6607,206007,0.9689249061679852,2,5,42529,968,41561,0.9772390604058407,19.040565333333333,2318.447829333333,14.478830331991979,122,9.000000000000002E-4
7,test_20231031_150442,10863862.png,317432,14012,303420,0.9558582625570201,3,6,66058,2013,64045,0.9695267794968059,23.48735466666667,3165.0385226666667,13.127013605493714,122,9.000000000000002E-4
8,test_20231031_150442,11382381.png,312486,827,311659,0.9973534814359684,3,5,46745,109,46636,0.997668199807466,21.564144,2476.360432,14.192665047538828,122,9.000000000000002E-4
9,test_20231031_150442,11079715.png,443815,127382,316433,0.7129840136092742,5,6,124136,17736,106400,0.8571244441580202,16.53779911111111,2010.815104,15.097082221479486,122,9.000000000000002E-4
10,test_20231031_150442,11551286.png,271883,527,271356,0.9980616662314304,2,5,40092,76,40016,0.9981043599720643,17.926654222222222,1858.3108106666666,15.43962007470492,122,9.000000000000002E-4
1,test_20231031_150443,10404007.png,502730,24182,478548,0.9518986334613013,3,5,61265,3483,57782,0.9431486166653065,25.191109333333333,3298.676826666667,12.947405913275208,123,1.0E-4
2,test_20231031_150443,1254659.png,342646,78072,264574,0.7721496821792754,4,6,80080,10861,69219,0.8643731268731268,20.51848177777778,3069.789525333333,13.259717609997972,123,1.0E-4
3,test_20231031_150443,10188041.png,221231,10202,211029,0.9538853054047579,3,6,41731,1437,40294,0.9655651673815628,10.472250666666667,996.2625973333334,18.147065349528113,123,1.0E-4
4,test_20231031_150443,10287332.png,216980,12977,204003,0.9401926444833625,3,6,22337,1774,20563,0.9205802032502126,9.307064888888888,748.7130986666666,19.387649297314677,123,1.0E-4
5,test_20231031_150443,11610969.png,368720,28492,340228,0.9227272727272727,4,6,84111,4156,79955,0.9505891024955119,19.969996444444444,2649.321978666667,13.899456184782972,123,1.0E-4
6,test_20231031_150443,10350842.png,212614,6887,205727,0.967607965609038,3,6,42529,1009,41520,0.9762750123445179,17.477884444444445,1977.0087253333334,15.170717748340774,123,1.0E-4
7,test_20231031_150443,10863862.png,317432,13337,304095,0.9579847022354394,3,6,66058,1928,64130,0.9708135275061309,23.652634666666668,3218.7282186666666,13.053960533703744,123,1.0E-4
8,test_20231031_150443,11382381.png,312486,1159,311327,0.996291033838316,3,6,46745,158,46587,0.9966199593539415,20.606709333333335,2334.900224,14.448120340351833,123,1.0E-4
9,test_20231031_150443,11079715.png,443815,125192,318623,0.7179185020785688,5,7,124136,17444,106692,0.8594767029709351,16.64877511111111,2039.7730453333334,15.034985123844537,123,1.0E-4
10,test_20231031_150443,11551286.png,271883,1199,270684,0.9955900148225524,2,5,40092,176,39916,0.995610096777412,15.83984888888889,1503.00104,16.36121079771285,123,1.0E-4
1,test_20231031_150444,10404007.png,502730,24182,478548,0.9518986334613013,3,6,61265,3483,57782,0.9431486166653065,25.191109333333333,3298.676826666667,12.947405913275208,123,2.0E-4
2,test_20231031_150444,1254659.png,342646,78072,264574,0.7721496821792754,5,6,80080,10861,69219,0.8643731268731268,20.51848177777778,3069.789525333333,13.259717609997972,123,2.0E-4
3,test_20231031_150444,10188041.png,221231,10202,211029,0.9538853054047579,3,6,41731,1437,40294,0.9655651673815628,10.472250666666667,996.2625973333334,18.147065349528113,123,2.0E-4
4,test_20231031_150444,10287332.png,216980,12767,204213,0.9411604756198728,3,6,22337,1747,20590,0.921788960021489,9.436826666666667,775.4438453333333,19.235300075188995,123,2.0E-4
5,test_20231031_150444,11610969.png,368720,28492,340228,0.9227272727272727,4,6,84111,4156,79955,0.9505891024955119,19.969996444444444,2649.321978666667,13.899456184782972,123,2.0E-4
6,test_20231031_150444,10350842.png,212614,6887,205727,0.967607965609038,2,6,42529,1009,41520,0.9762750123445179,17.477884444444445,1977.0087253333334,15.170717748340774,123,2.0E-4
7,test_20231031_150444,10863862.png,317432,13337,304095,0.9579847022354394,4,6,66058,1928,64130,0.9708135275061309,23.652634666666668,3218.7282186666666,13.053960533703744,123,2.0E-4
8,test_20231031_150444,11382381.png,312486,1159,311327,0.996291033838316,3,6,46745,158,46587,0.9966199593539415,20.606709333333335,2334.900224,14.448120340351833,123,2.0E-4
9,test_20231031_150444,11079715.png,443815,125192,318623,0.7179185020785688,5,7,124136,17444,106692,0.8594767029709351,16.64877511111111,2039.7730453333334,15.034985123844537,123,2.0E-4
10,test_20231031_150444,11551286.png,271883,1179,270704,0.995663575876388,2,6,40092,173,39919,0.9956849246732515,16.545063111111112,1622.936352,16.027788727836416,123,2.0E-4
1,test_20231031_150445,10404007.png,502730,24062,478668,0.9521373301772323,4,6,61265,3466,57799,0.9434260997306783,25.205253333333335,3301.279184,12.943981073817032,123,3.0000000000000003E-4
2,test_20231031_150445,1254659.png,342646,78012,264634,0.7723247900165185,4,7,80080,10856,69224,0.8644355644355645,20.528035555555554,3070.871712,13.258186870279811,123,3.0000000000000003E-4
3,test_20231031_150445,10188041.png,221231,10102,211129,0.9543373216230998,3,6,41731,1423,40308,0.9659006493973306,10.595603555555556,1011.9779893333333,18.079092942287858,123,3.0000000000000003E-4
4,test_20231031_150445,10287332.png,216980,12767,204213,0.9411604756198728,3,6,22337,1747,20590,0.921788960021489,9.436826666666667,775.4438453333333,19.235300075188995,123,3.0000000000000003E-4
5,test_20231031_150445,11610969.png,368720,28252,340468,0.9233781731395097,4,5,84111,4121,79990,0.9510052192935525,20.351372444444443,2731.876538666667,13.766192924277291,123,3.0000000000000003E-4
6,test_20231031_150445,10350842.png,212614,6467,206147,0.9695833764474587,2,10,42529,947,41582,0.9777328411201768,19.205194666666667,2350.2698026666667,14.419626402627658,123,3.0000000000000003E-4
7,test_20231031_150445,10863862.png,317432,13257,304175,0.9582367247158446,3,5,66058,1916,64142,0.9709951860486239,23.681868444444444,3223.7809546666667,13.047148356167963,123,3.0000000000000003E-4
8,test_20231031_150445,11382381.png,312486,967,311519,0.9969054613646692,3,6,46745,130,46615,0.9972189538988127,21.068341333333333,2406.1475626666665,14.317581029153203,123,3.0000000000000003E-4
9,test_20231031_150445,11079715.png,443815,125192,318623,0.7179185020785688,6,7,124136,17444,106692,0.8594767029709351,16.64877511111111,2039.7730453333334,15.034985123844537,123,3.0000000000000003E-4
10,test_20231031_150445,11551286.png,271883,547,271336,0.9979881051775947,2,6,40092,79,40013,0.9980295320762247,17.838736,1852.2023093333332,15.453919395217167,123,3.0000000000000003E-4
1,test_20231031_150446,10404007.png,502730,24062,478668,0.9521373301772323,3,5,61265,3466,57799,0.9434260997306783,25.205253333333335,3301.279184,12.943981073817032,123,4.0E-4
2,test_20231031_150446,1254659.png,342646,78012,264634,0.7723247900165185,4,7,80080,10856,69224,0.8644355644355645,20.528035555555554,3070.871712,13.258186870279811,123,4.0E-4
3,test_20231031_150446,10188041.png,221231,10102,211129,0.9543373216230998,3,5,41731,1423,40308,0.9659006493973306,10.595603555555556,1011.9779893333333,18.079092942287858,123,4.0E-4
4,test_20231031_150446,10287332.png,216980,12767,204213,0.9411604756198728,2,5,22337,1747,20590,0.921788960021489,9.436826666666667,775.4438453333333,19.235300075188995,123,4.0E-4
5,test_20231031_150446,11610969.png,368720,28252,340468,0.9233781731395097,4,5,84111,4121,79990,0.9510052192935525,20.351372444444443,2731.876538666667,13.766192924277291,123,4.0E-4
6,test_20231031_150446,10350842.png,212614,6467,206147,0.9695833764474587,2,5,42529,947,41582,0.9777328411201768,19.205194666666667,2350.2698026666667,14.419626402627658,123,4.0E-4
7,test_20231031_150446,10863862.png,317432,13257,304175,0.9582367247158446,3,6,66058,1916,64142,0.9709951860486239,23.681868444444444,3223.7809546666667,13.047148356167963,123,4.0E-4
8,test_20231031_150446,11382381.png,312486,827,311659,0.9973534814359684,3,5,46745,109,46636,0.997668199807466,21.564144,2476.360432,14.192665047538828,123,4.0E-4
9,test_20231031_150446,11079715.png,443815,125192,318623,0.7179185020785688,5,7,124136,17444,106692,0.8594767029709351,16.64877511111111,2039.7730453333334,15.034985123844537,123,4.0E-4
10,test_20231031_150446,11551286.png,271883,547,271336,0.9979881051775947,2,5,40092,79,40013,0.9980295320762247,17.838736,1852.2023093333332,15.453919395217167,123,4.0E-4
1,test_20231031_150447,10404007.png,502730,23739,478991,0.9527798221709466,4,6,61265,3420,57845,0.9441769362605076,25.295297777777776,3321.273722666667,12.917756914288205,123,5.0E-4
2,test_20231031_150447,1254659.png,342646,78012,264634,0.7723247900165185,5,7,80080,10856,69224,0.8644355644355645,20.528035555555554,3070.871712,13.258186870279811,123,5.0E-4
3,test_20231031_150447,10188041.png,221231,10102,211129,0.9543373216230998,3,5,41731,1423,40308,0.9659006493973306,10.595603555555556,1011.9779893333333,18.079092942287858,123,5.0E-4
4,test_20231031_150447,10287332.png,216980,12767,204213,0.9411604756198728,2,6,22337,1747,20590,0.921788960021489,9.436826666666667,775.4438453333333,19.235300075188995,123,5.0E-4
5,test_20231031_150447,11610969.png,368720,28252,340468,0.9233781731395097,4,6,84111,4121,79990,0.9510052192935525,20.351372444444443,2731.876538666667,13.766192924277291,123,5.0E-4
6,test_20231031_150447,10350842.png,212614,6467,206147,0.9695833764474587,3,6,42529,947,41582,0.9777328411201768,19.205194666666667,2350.2698026666667,14.419626402627658,123,5.0E-4
7,test_20231031_150447,10863862.png,317432,13257,304175,0.9582367247158446,3,5,66058,1916,64142,0.9709951860486239,23.681868444444444,3223.7809546666667,13.047148356167963,123,5.0E-4
8,test_20231031_150447,11382381.png,312486,827,311659,0.9973534814359684,2,12,46745,109,46636,0.997668199807466,21.564144,2476.360432,14.192665047538828,123,5.0E-4
9,test_20231031_150447,11079715.png,443815,125192,318623,0.7179185020785688,6,7,124136,17444,106692,0.8594767029709351,16.64877511111111,2039.7730453333334,15.034985123844537,123,5.0E-4
10,test_20231031_150447,11551286.png,271883,547,271336,0.9979881051775947,2,5,40092,79,40013,0.9980295320762247,17.838736,1852.2023093333332,15.453919395217167,123,5.0E-4
1,test_20231031_150448,10404007.png,502730,23337,479393,0.9535794561693155,4,15,61265,3365,57900,0.9450746755896515,25.313722666666667,3325.6070666666665,12.912094265254296,123,6.000000000000001E-4
2,test_20231031_150448,1254659.png,342646,78012,264634,0.7723247900165185,5,7,80080,10856,69224,0.8644355644355645,20.528035555555554,3070.871712,13.258186870279811,123,6.000000000000001E-4
3,test_20231031_150448,10188041.png,221231,10082,211149,0.9544277248667682,3,5,41731,1420,40311,0.9659725384007093,10.853313777777778,1051.0199413333332,17.91469404755111,123,6.000000000000001E-4
4,test_20231031_150448,10287332.png,216980,12767,204213,0.9411604756198728,3,6,22337,1747,20590,0.921788960021489,9.436826666666667,775.4438453333333,19.235300075188995,123,6.000000000000001E-4
5,test_20231031_150448,11610969.png,368720,28152,340568,0.9236493816446084,3,6,84111,4106,80005,0.9511835550641414,20.388908444444443,2735.818362666667,13.759931006817341,123,6.000000000000001E-4
6,test_20231031_150448,10350842.png,212614,6467,206147,0.9695833764474587,3,6,42529,947,41582,0.9777328411201768,19.205194666666667,2350.2698026666667,14.419626402627658,123,6.000000000000001E-4
7,test_20231031_150448,10863862.png,317432,13197,304235,0.9584257415761486,4,6,66058,1907,64151,0.9711314299554936,23.723717333333333,3225.647888,13.044634028505238,123,6.000000000000001E-4
8,test_20231031_150448,11382381.png,312486,827,311659,0.9973534814359684,2,6,46745,109,46636,0.997668199807466,21.564144,2476.360432,14.192665047538828,123,6.000000000000001E-4
9,test_20231031_150448,11079715.png,443815,125192,318623,0.7179185020785688,5,6,124136,17444,106692,0.8594767029709351,16.64877511111111,2039.7730453333334,15.034985123844537,123,6.000000000000001E-4
10,test_20231031_150448,11551286.png,271883,467,271416,0.9982823493929374,2,5,40092,67,40025,0.998328843659583,17.988837333333333,1870.894224,15.410311266718583,123,6.000000000000001E-4
1,test_20231031_150449,10404007.png,502730,23337,479393,0.9535794561693155,4,6,61265,3365,57900,0.9450746755896515,25.313722666666667,3325.6070666666665,12.912094265254296,123,7.000000000000001E-4
2,test_20231031_150449,1254659.png,342646,78012,264634,0.7723247900165185,5,6,80080,10856,69224,0.8644355644355645,20.528035555555554,3070.871712,13.258186870279811,123,7.000000000000001E-4
3,test_20231031_150449,10188041.png,221231,10082,211149,0.9544277248667682,3,6,41731,1420,40311,0.9659725384007093,10.853313777777778,1051.0199413333332,17.91469404755111,123,7.000000000000001E-4
4,test_20231031_150449,10287332.png,216980,12767,204213,0.9411604756198728,3,6,22337,1747,20590,0.921788960021489,9.436826666666667,775.4438453333333,19.235300075188995,123,7.000000000000001E-4
5,test_20231031_150449,11610969.png,368720,28152,340568,0.9236493816446084,4,6,84111,4106,80005,0.9511835550641414,20.388908444444443,2735.818362666667,13.759931006817341,123,7.000000000000001E-4
6,test_20231031_150449,10350842.png,212614,6467,206147,0.9695833764474587,3,6,42529,947,41582,0.9777328411201768,19.205194666666667,2350.2698026666667,14.419626402627658,123,7.000000000000001E-4
7,test_20231031_150449,10863862.png,317432,13197,304235,0.9584257415761486,3,6,66058,1907,64151,0.9711314299554936,23.723717333333333,3225.647888,13.044634028505238,123,7.000000000000001E-4
8,test_20231031_150449,11382381.png,312486,827,311659,0.9973534814359684,2,5,46745,109,46636,0.997668199807466,21.564144,2476.360432,14.192665047538828,123,7.000000000000001E-4
9,test_20231031_150449,11079715.png,443815,125192,318623,0.7179185020785688,5,6,124136,17444,106692,0.8594767029709351,16.64877511111111,2039.7730453333334,15.034985123844537,123,7.000000000000001E-4
10,test_20231031_150449,11551286.png,271883,467,271416,0.9982823493929374,2,5,40092,67,40025,0.998328843659583,17.988837333333333,1870.894224,15.410311266718583,123,7.000000000000001E-4
1,test_20231031_150450,10404007.png,502730,23337,479393,0.9535794561693155,4,6,61265,3365,57900,0.9450746755896515,25.313722666666667,3325.6070666666665,12.912094265254296,123,8.000000000000001E-4
2,test_20231031_150450,1254659.png,342646,78012,264634,0.7723247900165185,5,6,80080,10856,69224,0.8644355644355645,20.528035555555554,3070.871712,13.258186870279811,123,8.000000000000001E-4
3,test_20231031_150450,10188041.png,221231,10002,211229,0.9547893378414417,4,6,41731,1410,40321,0.9662121684119719,10.980083555555556,1061.9383306666666,17.8698106392361,123,8.000000000000001E-4
4,test_20231031_150450,10287332.png,216980,12767,204213,0.9411604756198728,2,5,22337,1747,20590,0.921788960021489,9.436826666666667,775.4438453333333,19.235300075188995,123,8.000000000000001E-4
5,test_20231031_150450,11610969.png,368720,27849,340871,0.9244711434150575,4,6,84111,4062,80049,0.9517066733245354,21.206458666666666,2901.9369866666666,13.503923830349978,123,8.000000000000001E-4
6,test_20231031_150450,10350842.png,212614,6467,206147,0.9695833764474587,3,5,42529,947,41582,0.9777328411201768,19.205194666666667,2350.2698026666667,14.419626402627658,123,8.000000000000001E-4
7,test_20231031_150450,10863862.png,317432,13197,304235,0.9584257415761486,4,6,66058,1907,64151,0.9711314299554936,23.723717333333333,3225.647888,13.044634028505238,123,8.000000000000001E-4
8,test_20231031_150450,11382381.png,312486,827,311659,0.9973534814359684,3,6,46745,109,46636,0.997668199807466,21.564144,2476.360432,14.192665047538828,123,8.000000000000001E-4
9,test_20231031_150450,11079715.png,443815,125192,318623,0.7179185020785688,6,7,124136,17444,106692,0.8594767029709351,16.64877511111111,2039.7730453333334,15.034985123844537,123,8.000000000000001E-4
10,test_20231031_150450,11551286.png,271883,467,271416,0.9982823493929374,2,5,40092,67,40025,0.998328843659583,17.988837333333333,1870.894224,15.410311266718583,123,8.000000000000001E-4
1,test_20231031_150451,10404007.png,502730,23077,479653,0.954096632387166,4,6,61265,3328,57937,0.9456786093201665,25.358901333333332,3334.2294613333333,12.90084876245235,123,9.000000000000002E-4
2,test_20231031_150451,1254659.png,342646,78012,264634,0.7723247900165185,5,6,80080,10856,69224,0.8644355644355645,20.528035555555554,3070.871712,13.258186870279811,123,9.000000000000002E-4
3,test_20231031_150451,10188041.png,221231,10002,211229,0.9547893378414417,4,6,41731,1410,40321,0.9662121684119719,10.980083555555556,1061.9383306666666,17.8698106392361,123,9.000000000000002E-4
4,test_20231031_150451,10287332.png,216980,12767,204213,0.9411604756198728,3,6,22337,1747,20590,0.921788960021489,9.436826666666667,775.4438453333333,19.235300075188995,123,9.000000000000002E-4
5,test_20231031_150451,11610969.png,368720,27849,340871,0.9244711434150575,4,6,84111,4062,80049,0.9517066733245354,21.206458666666666,2901.9369866666666,13.503923830349978,123,9.000000000000002E-4
6,test_20231031_150451,10350842.png,212614,6467,206147,0.9695833764474587,3,6,42529,947,41582,0.9777328411201768,19.205194666666667,2350.2698026666667,14.419626402627658,123,9.000000000000002E-4
7,test_20231031_150451,10863862.png,317432,13197,304235,0.9584257415761486,3,6,66058,1907,64151,0.9711314299554936,23.723717333333333,3225.647888,13.044634028505238,123,9.000000000000002E-4
8,test_20231031_150451,11382381.png,312486,827,311659,0.9973534814359684,2,5,46745,109,46636,0.997668199807466,21.564144,2476.360432,14.192665047538828,123,9.000000000000002E-4
9,test_20231031_150451,11079715.png,443815,125192,318623,0.7179185020785688,6,7,124136,17444,106692,0.8594767029709351,16.64877511111111,2039.7730453333334,15.034985123844537,123,9.000000000000002E-4
10,test_20231031_150451,11551286.png,271883,467,271416,0.9982823493929374,2,6,40092,67,40025,0.998328843659583,17.988837333333333,1870.894224,15.410311266718583,123,9.000000000000002E-4
1,test_20231031_150452,10404007.png,502730,22884,479846,0.9544805362719552,3,6,61265,3295,57970,0.9462172529176528,25.586942222222223,3400.765381333333,12.815036898605106,124,1.0E-4
2,test_20231031_150452,1254659.png,342646,76264,266382,0.7774262650082009,4,7,80080,10638,69442,0.8671578421578422,20.667370666666667,3113.3477866666667,13.198527231942004,124,1.0E-4
3,test_20231031_150452,10188041.png,221231,10142,211089,0.954156515135763,3,5,41731,1428,40303,0.9657808343916993,10.476305777777778,997.11648,18.1433446668218,124,1.0E-4
4,test_20231031_150452,10287332.png,216980,12897,204083,0.940561342059176,2,6,22337,1766,20571,0.9209383534046649,9.311077333333333,749.8733493333333,19.38092441916683,124,1.0E-4
5,test_20231031_150452,11610969.png,368720,27227,341493,0.9261580603167715,3,7,84111,3970,80141,0.9528004660508138,20.228828444444446,2711.644832,13.798475553202607,124,1.0E-4
6,test_20231031_150452,10350842.png,212614,6344,206270,0.9701618896215677,2,6,42529,929,41600,0.9781560817324649,19.196949333333333,2355.988128,14.409072631896374,124,1.0E-4
7,test_20231031_150452,10863862.png,317432,12977,304455,0.9591188033972631,3,5,66058,1885,64173,0.9714644706167308,23.722218666666667,3236.9452053333334,13.029450130942488,124,1.0E-4
8,test_20231031_150452,11382381.png,312486,1099,311387,0.9964830424403013,3,6,46745,149,46596,0.996812493314793,20.626588444444444,2338.262816,14.441870374793048,124,1.0E-4
9,test_20231031_150452,11079715.png,443815,122782,321033,0.7233486925858748,5,6,124136,17120,107016,0.8620867435715667,16.763402666666668,2067.635402666667,14.97606401189655,124,1.0E-4
10,test_20231031_150452,11551286.png,271883,1199,270684,0.9955900148225524,2,5,40092,176,39916,0.995610096777412,15.83984888888889,1503.00104,16.36121079771285,124,1.0E-4
1,test_20231031_150453,10404007.png,502730,22884,479846,0.9544805362719552,3,6,61265,3295,57970,0.9462172529176528,25.586942222222223,3400.765381333333,12.815036898605106,124,2.0E-4
2,test_20231031_150453,1254659.png,342646,76264,266382,0.7774262650082009,5,6,80080,10638,69442,0.8671578421578422,20.667370666666667,3113.3477866666667,13.198527231942004,124,2.0E-4
3,test_20231031_150453,10188041.png,221231,10142,211089,0.954156515135763,3,5,41731,1428,40303,0.9657808343916993,10.476305777777778,997.11648,18.1433446668218,124,2.0E-4
4,test_20231031_150453,10287332.png,216980,12687,204293,0.9415291731956862,4,6,22337,1739,20598,0.9221471101759413,9.440839111111112,776.604096,19.22880684076492,124,2.0E-4
5,test_20231031_150453,11610969.png,368720,27227,341493,0.9261580603167715,3,6,84111,3970,80141,0.9528004660508138,20.228828444444446,2711.644832,13.798475553202607,124,2.0E-4
6,test_20231031_150453,10350842.png,212614,6344,206270,0.9701618896215677,3,6,42529,929,41600,0.9781560817324649,19.196949333333333,2355.988128,14.409072631896374,124,2.0E-4
7,test_20231031_150453,10863862.png,317432,12977,304455,0.9591188033972631,3,5,66058,1885,64173,0.9714644706167308,23.722218666666667,3236.9452053333334,13.029450130942488,124,2.0E-4
8,test_20231031_150453,11382381.png,312486,907,311579,0.9970974699666545,2,5,46745,121,46624,0.9974114878596642,21.088220444444445,2409.5101546666665,14.311515999312824,124,2.0E-4
9,test_20231031_150453,11079715.png,443815,122782,321033,0.7233486925858748,6,6,124136,17120,107016,0.8620867435715667,16.763402666666668,2067.635402666667,14.97606401189655,124,2.0E-4
10,test_20231031_150453,11551286.png,271883,977,270906,0.9964065425201282,2,5,40092,143,39949,0.9964332036316472,17.00562311111111,1711.9347146666667,15.795931622093908,124,2.0E-4
1,test_20231031_150454,10404007.png,502730,22704,480026,0.9548385813458516,4,6,61265,3271,57994,0.9466089937158247,25.603198222222222,3403.693370666667,12.811299320833328,124,3.0000000000000003E-4
2,test_20231031_150454,1254659.png,342646,76204,266442,0.777601372845444,5,7,80080,10632,69448,0.8672327672327672,20.676924444444445,3114.4299733333332,13.197017904793334,124,3.0000000000000003E-4
3,test_20231031_150454,10188041.png,221231,10042,211189,0.954608531354105,4,6,41731,1414,40317,0.9661163164074669,10.599658666666667,1012.831872,18.07543001512229,124,3.0000000000000003E-4
4,test_20231031_150454,10287332.png,216980,12687,204293,0.9415291731956862,3,6,22337,1739,20598,0.9221471101759413,9.440839111111112,776.604096,19.22880684076492,124,3.0000000000000003E-4
5,test_20231031_150454,11610969.png,368720,26582,342138,0.9279073551746583,3,5,84111,3877,80234,0.9539061478284647,21.465290666666668,2964.25984,13.411640906658562,124,3.0000000000000003E-4
6,test_20231031_150454,10350842.png,212614,6264,206350,0.9705381583526955,2,6,42529,917,41612,0.978438242140657,19.265742222222222,2361.7458346666667,14.398472027898631,124,3.0000000000000003E-4
7,test_20231031_150454,10863862.png,317432,12917,304515,0.959307820257567,3,6,66058,1876,64182,0.9716007145236005,23.73152711111111,3238.389536,13.027512733498073,124,3.0000000000000003E-4
8,test_20231031_150454,11382381.png,312486,767,311719,0.9975454900379537,2,5,46745,100,46645,0.9978607337683175,21.58402311111111,2479.723024,14.186771864393144,124,3.0000000000000003E-4
9,test_20231031_150454,11079715.png,443815,122782,321033,0.7233486925858748,6,7,124136,17120,107016,0.8620867435715667,16.763402666666668,2067.635402666667,14.97606401189655,124,3.0000000000000003E-4
10,test_20231031_150454,11551286.png,271883,547,271336,0.9979881051775947,2,5,40092,79,40013,0.9980295320762247,17.838736,1852.2023093333332,15.453919395217167,124,3.0000000000000003E-4
1,test_20231031_150455,10404007.png,502730,22704,480026,0.9548385813458516,3,5,61265,3271,57994,0.9466089937158247,25.603198222222222,3403.693370666667,12.811299320833328,124,4.0E-4
2,test_20231031_150455,1254659.png,342646,76204,266442,0.777601372845444,5,6,80080,10632,69448,0.8672327672327672,20.676924444444445,3114.4299733333332,13.197017904793334,124,4.0E-4
3,test_20231031_150455,10188041.png,221231,10042,211189,0.954608531354105,3,6,41731,1414,40317,0.9661163164074669,10.599658666666667,1012.831872,18.07543001512229,124,4.0E-4
4,test_20231031_150455,10287332.png,216980,12687,204293,0.9415291731956862,2,5,22337,1739,20598,0.9221471101759413,9.440839111111112,776.604096,19.22880684076492,124,4.0E-4
5,test_20231031_150455,11610969.png,368720,26582,342138,0.9279073551746583,4,6,84111,3877,80234,0.9539061478284647,21.465290666666668,2964.25984,13.411640906658562,124,4.0E-4
6,test_20231031_150455,10350842.png,212614,6264,206350,0.9705381583526955,3,6,42529,917,41612,0.978438242140657,19.265742222222222,2361.7458346666667,14.398472027898631,124,4.0E-4
7,test_20231031_150455,10863862.png,317432,12917,304515,0.959307820257567,4,6,66058,1876,64182,0.9716007145236005,23.73152711111111,3238.389536,13.027512733498073,124,4.0E-4
8,test_20231031_150455,11382381.png,312486,767,311719,0.9975454900379537,2,6,46745,100,46645,0.9978607337683175,21.58402311111111,2479.723024,14.186771864393144,124,4.0E-4
9,test_20231031_150455,11079715.png,443815,122782,321033,0.7233486925858748,6,7,124136,17120,107016,0.8620867435715667,16.763402666666668,2067.635402666667,14.97606401189655,124,4.0E-4
10,test_20231031_150455,11551286.png,271883,547,271336,0.9979881051775947,2,6,40092,79,40013,0.9980295320762247,17.838736,1852.2023093333332,15.453919395217167,124,4.0E-4
1,test_20231031_150457,10404007.png,502730,22382,480348,0.9554790842002665,4,6,61265,3225,58040,0.9473598302456542,25.693242666666666,3423.687909333333,12.785861917295664,124,5.0E-4
2,test_20231031_150457,1254659.png,342646,76204,266442,0.777601372845444,5,6,80080,10632,69448,0.8672327672327672,20.676924444444445,3114.4299733333332,13.197017904793334,124,5.0E-4
3,test_20231031_150457,10188041.png,221231,10042,211189,0.954608531354105,4,5,41731,1414,40317,0.9661163164074669,10.599658666666667,1012.831872,18.07543001512229,124,5.0E-4
4,test_20231031_150457,10287332.png,216980,12687,204293,0.9415291731956862,2,5,22337,1739,20598,0.9221471101759413,9.440839111111112,776.604096,19.22880684076492,124,5.0E-4
5,test_20231031_150457,11610969.png,368720,26582,342138,0.9279073551746583,4,6,84111,3877,80234,0.9539061478284647,21.465290666666668,2964.25984,13.411640906658562,124,5.0E-4
6,test_20231031_150457,10350842.png,212614,6264,206350,0.9705381583526955,3,5,42529,917,41612,0.978438242140657,19.265742222222222,2361.7458346666667,14.398472027898631,124,5.0E-4
7,test_20231031_150457,10863862.png,317432,12917,304515,0.959307820257567,4,6,66058,1876,64182,0.9716007145236005,23.73152711111111,3238.389536,13.027512733498073,124,5.0E-4
8,test_20231031_150457,11382381.png,312486,767,311719,0.9975454900379537,2,6,46745,100,46645,0.9978607337683175,21.58402311111111,2479.723024,14.186771864393144,124,5.0E-4
9,test_20231031_150457,11079715.png,443815,122782,321033,0.7233486925858748,6,7,124136,17120,107016,0.8620867435715667,16.763402666666668,2067.635402666667,14.97606401189655,124,5.0E-4
10,test_20231031_150457,11551286.png,271883,547,271336,0.9979881051775947,3,6,40092,79,40013,0.9980295320762247,17.838736,1852.2023093333332,15.453919395217167,124,5.0E-4
1,test_20231031_150458,10404007.png,502730,22102,480628,0.9560360432041056,3,5,61265,3186,58079,0.9479964090426835,25.709000888888887,3427.5201546666667,12.781003436398297,124,6.000000000000001E-4
2,test_20231031_150458,1254659.png,342646,76204,266442,0.777601372845444,5,6,80080,10632,69448,0.8672327672327672,20.676924444444445,3114.4299733333332,13.197017904793334,124,6.000000000000001E-4
3,test_20231031_150458,10188041.png,221231,10022,211209,0.9546989345977733,3,5,41731,1411,40320,0.9661882054108457,10.857368888888889,1051.873824,17.911167130910616,124,6.000000000000001E-4
4,test_20231031_150458,10287332.png,216980,12687,204293,0.9415291731956862,2,5,22337,1739,20598,0.9221471101759413,9.440839111111112,776.604096,19.22880684076492,124,6.000000000000001E-4
5,test_20231031_150458,11610969.png,368720,26582,342138,0.9279073551746583,4,6,84111,3877,80234,0.9539061478284647,21.465290666666668,2964.25984,13.411640906658562,124,6.000000000000001E-4
6,test_20231031_150458,10350842.png,212614,6264,206350,0.9705381583526955,2,6,42529,917,41612,0.978438242140657,19.265742222222222,2361.7458346666667,14.398472027898631,124,6.000000000000001E-4
7,test_20231031_150458,10863862.png,317432,12857,304575,0.9594968371178709,4,6,66058,1867,64191,0.9717369584304701,23.773376,3240.2564693333334,13.025009744859632,124,6.000000000000001E-4
8,test_20231031_150458,11382381.png,312486,767,311719,0.9975454900379537,3,6,46745,100,46645,0.9978607337683175,21.58402311111111,2479.723024,14.186771864393144,124,6.000000000000001E-4
9,test_20231031_150458,11079715.png,443815,122782,321033,0.7233486925858748,5,7,124136,17120,107016,0.8620867435715667,16.763402666666668,2067.635402666667,14.97606401189655,124,6.000000000000001E-4
10,test_20231031_150458,11551286.png,271883,467,271416,0.9982823493929374,2,5,40092,67,40025,0.998328843659583,17.988837333333333,1870.894224,15.410311266718583,124,6.000000000000001E-4
1,test_20231031_150459,10404007.png,502730,22102,480628,0.9560360432041056,4,6,61265,3186,58079,0.9479964090426835,25.709000888888887,3427.5201546666667,12.781003436398297,124,7.000000000000001E-4
2,test_20231031_150459,1254659.png,342646,76204,266442,0.777601372845444,5,6,80080,10632,69448,0.8672327672327672,20.676924444444445,3114.4299733333332,13.197017904793334,124,7.000000000000001E-4
3,test_20231031_150459,10188041.png,221231,10022,211209,0.9546989345977733,3,5,41731,1411,40320,0.9661882054108457,10.857368888888889,1051.873824,17.911167130910616,124,7.000000000000001E-4
4,test_20231031_150459,10287332.png,216980,12687,204293,0.9415291731956862,3,6,22337,1739,20598,0.9221471101759413,9.440839111111112,776.604096,19.22880684076492,124,7.000000000000001E-4
5,test_20231031_150459,11610969.png,368720,26582,342138,0.9279073551746583,4,6,84111,3877,80234,0.9539061478284647,21.465290666666668,2964.25984,13.411640906658562,124,7.000000000000001E-4
6,test_20231031_150459,10350842.png,212614,6264,206350,0.9705381583526955,2,5,42529,917,41612,0.978438242140657,19.265742222222222,2361.7458346666667,14.398472027898631,124,7.000000000000001E-4
7,test_20231031_150459,10863862.png,317432,12857,304575,0.9594968371178709,4,7,66058,1867,64191,0.9717369584304701,23.773376,3240.2564693333334,13.025009744859632,124,7.000000000000001E-4
8,test_20231031_150459,11382381.png,312486,767,311719,0.9975454900379537,3,6,46745,100,46645,0.9978607337683175,21.58402311111111,2479.723024,14.186771864393144,124,7.000000000000001E-4
9,test_20231031_150459,11079715.png,443815,122782,321033,0.7233486925858748,5,7,124136,17120,107016,0.8620867435715667,16.763402666666668,2067.635402666667,14.97606401189655,124,7.000000000000001E-4
10,test_20231031_150459,11551286.png,271883,467,271416,0.9982823493929374,2,5,40092,67,40025,0.998328843659583,17.988837333333333,1870.894224,15.410311266718583,124,7.000000000000001E-4
1,test_20231031_150500,10404007.png,502730,21839,480891,0.9565591868398544,4,6,61265,3149,58116,0.9486003427731984,25.754179555555556,3436.142549333333,12.770091885071036,124,8.000000000000001E-4
2,test_20231031_150500,1254659.png,342646,76204,266442,0.777601372845444,4,6,80080,10632,69448,0.8672327672327672,20.676924444444445,3114.4299733333332,13.197017904793334,124,8.000000000000001E-4
3,test_20231031_150500,10188041.png,221231,9942,211289,0.9550605475724468,4,5,41731,1401,40330,0.9664278354221083,10.984138666666666,1062.7922133333334,17.86631997025374,124,8.000000000000001E-4
4,test_20231031_150500,10287332.png,216980,12687,204293,0.9415291731956862,2,5,22337,1739,20598,0.9221471101759413,9.440839111111112,776.604096,19.22880684076492,124,8.000000000000001E-4
5,test_20231031_150500,11610969.png,368720,26502,342218,0.9281243219787373,4,6,84111,3866,80245,0.9540369273935633,21.558876444444444,2980.7761066666667,13.3875100452361,124,8.000000000000001E-4
6,test_20231031_150500,10350842.png,212614,6264,206350,0.9705381583526955,3,6,42529,917,41612,0.978438242140657,19.265742222222222,2361.7458346666667,14.398472027898631,124,8.000000000000001E-4
7,test_20231031_150500,10863862.png,317432,12857,304575,0.9594968371178709,3,5,66058,1867,64191,0.9717369584304701,23.773376,3240.2564693333334,13.025009744859632,124,8.000000000000001E-4
8,test_20231031_150500,11382381.png,312486,767,311719,0.9975454900379537,2,6,46745,100,46645,0.9978607337683175,21.58402311111111,2479.723024,14.186771864393144,124,8.000000000000001E-4
9,test_20231031_150500,11079715.png,443815,122782,321033,0.7233486925858748,5,6,124136,17120,107016,0.8620867435715667,16.763402666666668,2067.635402666667,14.97606401189655,124,8.000000000000001E-4
10,test_20231031_150500,11551286.png,271883,467,271416,0.9982823493929374,2,6,40092,67,40025,0.998328843659583,17.988837333333333,1870.894224,15.410311266718583,124,8.000000000000001E-4
1,test_20231031_150501,10404007.png,502730,21839,480891,0.9565591868398544,4,6,61265,3149,58116,0.9486003427731984,25.754179555555556,3436.142549333333,12.770091885071036,124,9.000000000000002E-4
2,test_20231031_150501,1254659.png,342646,76204,266442,0.777601372845444,5,6,80080,10632,69448,0.8672327672327672,20.676924444444445,3114.4299733333332,13.197017904793334,124,9.000000000000002E-4
3,test_20231031_150501,10188041.png,221231,9842,211389,0.9555125637907889,3,6,41731,1390,40341,0.9666914284344972,11.031626666666666,1067.9992426666668,17.84509416139609,124,9.000000000000002E-4
4,test_20231031_150501,10287332.png,216980,12687,204293,0.9415291731956862,3,6,22337,1739,20598,0.9221471101759413,9.440839111111112,776.604096,19.22880684076492,124,9.000000000000002E-4
5,test_20231031_150501,11610969.png,368720,26502,342218,0.9281243219787373,4,6,84111,3866,80245,0.9540369273935633,21.558876444444444,2980.7761066666667,13.3875100452361,124,9.000000000000002E-4
6,test_20231031_150501,10350842.png,212614,6264,206350,0.9705381583526955,3,6,42529,917,41612,0.978438242140657,19.265742222222222,2361.7458346666667,14.398472027898631,124,9.000000000000002E-4
7,test_20231031_150501,10863862.png,317432,12857,304575,0.9594968371178709,4,6,66058,1867,64191,0.9717369584304701,23.773376,3240.2564693333334,13.025009744859632,124,9.000000000000002E-4
8,test_20231031_150501,11382381.png,312486,767,311719,0.9975454900379537,2,5,46745,100,46645,0.9978607337683175,21.58402311111111,2479.723024,14.186771864393144,124,9.000000000000002E-4
9,test_20231031_150501,11079715.png,443815,122782,321033,0.7233486925858748,6,7,124136,17120,107016,0.8620867435715667,16.763402666666668,2067.635402666667,14.97606401189655,124,9.000000000000002E-4
10,test_20231031_150501,11551286.png,271883,467,271416,0.9982823493929374,2,5,40092,67,40025,0.998328843659583,17.988837333333333,1870.894224,15.410311266718583,124,9.000000000000002E-4
1,test_20231031_150502,10404007.png,502730,21859,480871,0.9565194040538659,3,5,61265,3161,58104,0.9484044723741125,25.648606222222224,3418.377488,12.792603411306079,125,1.0E-4
2,test_20231031_150502,1254659.png,342646,74757,267889,0.7818243901869568,4,6,80080,10445,69635,0.869567932067932,20.832983111111112,3162.755813333333,13.130146982015201,125,1.0E-4
3,test_20231031_150502,10188041.png,221231,9952,211279,0.9550153459506127,3,6,41731,1403,40328,0.9663799094198557,10.516405333333333,1008.327776,18.094786301784424,125,1.0E-4
4,test_20231031_150502,10287332.png,216980,12797,204183,0.9410222140289428,3,5,22337,1754,20583,0.9214755786363433,9.318817777777777,752.2076,19.367426438243534,125,1.0E-4
5,test_20231031_150502,11610969.png,368720,26082,342638,0.9292633977001519,3,5,84111,3804,80307,0.9547740485786639,21.12351288888889,2899.7180693333335,13.507245860327119,125,1.0E-4
6,test_20231031_150502,10350842.png,212614,6184,206430,0.9709144270838233,3,6,42529,906,41623,0.9786968891814997,19.249219555555555,2368.0866986666665,14.386827624524777,125,1.0E-4
7,test_20231031_150502,10863862.png,317432,12282,305150,0.9613082486957837,3,6,66058,1783,64275,0.9730085682279209,23.971452444444445,3305.626730666667,12.938265491291542,125,1.0E-4
8,test_20231031_150502,11382381.png,312486,1039,311447,0.9966750510422867,3,5,46745,140,46605,0.9970050272756444,20.829804444444445,2368.9669066666665,14.385213669887252,125,1.0E-4
9,test_20231031_150502,11079715.png,443815,120387,323428,0.7287450852269527,6,7,124136,16809,107327,0.8645920603209383,16.86984177777778,2095.0260693333335,14.918909294142013,125,1.0E-4
10,test_20231031_150502,11551286.png,271883,1059,270824,0.9961049421994019,3,6,40092,155,39937,0.996133892048289,15.857982222222223,1506.99288,16.349691604338467,125,1.0E-4
1,test_20231031_150503,10404007.png,502730,21859,480871,0.9565194040538659,4,6,61265,3161,58104,0.9484044723741125,25.648606222222224,3418.377488,12.792603411306079,125,2.0E-4
2,test_20231031_150503,1254659.png,342646,74757,267889,0.7818243901869568,5,6,80080,10445,69635,0.869567932067932,20.832983111111112,3162.755813333333,13.130146982015201,125,2.0E-4
3,test_20231031_150503,10188041.png,221231,9952,211279,0.9550153459506127,4,6,41731,1403,40328,0.9663799094198557,10.516405333333333,1008.327776,18.094786301784424,125,2.0E-4
4,test_20231031_150503,10287332.png,216980,12584,204396,0.942003871324546,3,6,22337,1727,20610,0.9226843354076196,9.448579555555556,778.9383466666667,19.21577276445775,125,2.0E-4
5,test_20231031_150503,11610969.png,368720,26082,342638,0.9292633977001519,3,6,84111,3804,80307,0.9547740485786639,21.12351288888889,2899.7180693333335,13.507245860327119,125,2.0E-4
6,test_20231031_150503,10350842.png,212614,6184,206430,0.9709144270838233,2,6,42529,906,41623,0.9786968891814997,19.249219555555555,2368.0866986666665,14.386827624524777,125,2.0E-4
7,test_20231031_150503,10863862.png,317432,12282,305150,0.9613082486957837,3,6,66058,1783,64275,0.9730085682279209,23.971452444444445,3305.626730666667,12.938265491291542,125,2.0E-4
8,test_20231031_150503,11382381.png,312486,907,311579,0.9970974699666545,2,6,46745,121,46624,0.9974114878596642,21.088220444444445,2409.5101546666665,14.311515999312824,125,2.0E-4
9,test_20231031_150503,11079715.png,443815,120387,323428,0.7287450852269527,5,7,124136,16809,107327,0.8645920603209383,16.86984177777778,2095.0260693333335,14.918909294142013,125,2.0E-4
10,test_20231031_150503,11551286.png,271883,877,271006,0.9967743477893064,2,5,40092,128,39964,0.9968073431108451,17.018796444444444,1715.096528,15.787917931083486,125,2.0E-4
1,test_20231031_150504,10404007.png,502730,21619,481111,0.956996797485728,3,5,61265,3126,58139,0.9489757610381131,25.66681422222222,3421.940368,12.788079237733479,125,3.0000000000000003E-4
2,test_20231031_150504,1254659.png,342646,74697,267949,0.7819994980241999,4,12,80080,10439,69641,0.8696428571428572,20.84253688888889,3163.838,13.12866122928261,125,3.0000000000000003E-4
3,test_20231031_150504,10188041.png,221231,9852,211379,0.9554673621689547,4,5,41731,1388,40343,0.9667393544367496,10.639758222222222,1024.043168,18.02762096387238,125,3.0000000000000003E-4
4,test_20231031_150504,10287332.png,216980,12584,204396,0.942003871324546,2,5,22337,1727,20610,0.9226843354076196,9.448579555555556,778.9383466666667,19.21577276445775,125,3.0000000000000003E-4
5,test_20231031_150504,11610969.png,368720,25759,342961,0.9301394011716207,3,5,84111,3758,80353,0.9553209449418031,21.541429333333333,2985.787157333333,13.380215151782494,125,3.0000000000000003E-4
6,test_20231031_150504,10350842.png,212614,6102,206512,0.9713001025332292,3,6,42529,894,41635,0.9789790495896917,19.318012444444445,2373.8444053333333,14.37628111337661,125,3.0000000000000003E-4
7,test_20231031_150504,10863862.png,317432,12162,305270,0.9616862824163915,3,5,66058,1765,64293,0.9732810560416604,24.022609777777777,3308.937994666667,12.933917317637896,125,3.0000000000000003E-4
8,test_20231031_150504,11382381.png,312486,767,311719,0.9975454900379537,2,5,46745,100,46645,0.9978607337683175,21.58402311111111,2479.723024,14.186771864393144,125,3.0000000000000003E-4
9,test_20231031_150504,11079715.png,443815,120387,323428,0.7287450852269527,5,7,124136,16809,107327,0.8645920603209383,16.86984177777778,2095.0260693333335,14.918909294142013,125,3.0000000000000003E-4
10,test_20231031_150504,11551286.png,271883,447,271436,0.9983559104467731,2,6,40092,64,40028,0.9984036715554225,17.85190933333333,1855.3641226666666,15.446512065144763,125,3.0000000000000003E-4
1,test_20231031_150505,10404007.png,502730,21297,481433,0.9576373003401428,4,6,61265,3080,58185,0.9497265975679425,25.756858666666666,3441.934906666667,12.76277708107859,125,4.0E-4
2,test_20231031_150505,1254659.png,342646,74697,267949,0.7819994980241999,6,6,80080,10439,69641,0.8696428571428572,20.84253688888889,3163.838,13.12866122928261,125,4.0E-4
3,test_20231031_150505,10188041.png,221231,9852,211379,0.9554673621689547,3,6,41731,1388,40343,0.9667393544367496,10.639758222222222,1024.043168,18.02762096387238,125,4.0E-4
4,test_20231031_150505,10287332.png,216980,12584,204396,0.942003871324546,2,5,22337,1727,20610,0.9226843354076196,9.448579555555556,778.9383466666667,19.21577276445775,125,4.0E-4
5,test_20231031_150505,11610969.png,368720,25759,342961,0.9301394011716207,3,5,84111,3758,80353,0.9553209449418031,21.541429333333333,2985.787157333333,13.380215151782494,125,4.0E-4
6,test_20231031_150505,10350842.png,212614,6102,206512,0.9713001025332292,2,12,42529,894,41635,0.9789790495896917,19.318012444444445,2373.8444053333333,14.37628111337661,125,4.0E-4
7,test_20231031_150505,10863862.png,317432,12162,305270,0.9616862824163915,3,5,66058,1765,64293,0.9732810560416604,24.022609777777777,3308.937994666667,12.933917317637896,125,4.0E-4
8,test_20231031_150505,11382381.png,312486,767,311719,0.9975454900379537,2,5,46745,100,46645,0.9978607337683175,21.58402311111111,2479.723024,14.186771864393144,125,4.0E-4
9,test_20231031_150505,11079715.png,443815,120387,323428,0.7287450852269527,5,6,124136,16809,107327,0.8645920603209383,16.86984177777778,2095.0260693333335,14.918909294142013,125,4.0E-4
10,test_20231031_150505,11551286.png,271883,447,271436,0.9983559104467731,2,5,40092,64,40028,0.9984036715554225,17.85190933333333,1855.3641226666666,15.446512065144763,125,4.0E-4
1,test_20231031_150506,10404007.png,502730,21297,481433,0.9576373003401428,4,6,61265,3080,58185,0.9497265975679425,25.756858666666666,3441.934906666667,12.76277708107859,125,5.0E-4
2,test_20231031_150506,1254659.png,342646,74697,267949,0.7819994980241999,5,6,80080,10439,69641,0.8696428571428572,20.84253688888889,3163.838,13.12866122928261,125,5.0E-4
3,test_20231031_150506,10188041.png,221231,9852,211379,0.9554673621689547,4,5,41731,1388,40343,0.9667393544367496,10.639758222222222,1024.043168,18.02762096387238,125,5.0E-4
4,test_20231031_150506,10287332.png,216980,12584,204396,0.942003871324546,3,6,22337,1727,20610,0.9226843354076196,9.448579555555556,778.9383466666667,19.21577276445775,125,5.0E-4
5,test_20231031_150506,11610969.png,368720,25759,342961,0.9301394011716207,4,6,84111,3758,80353,0.9553209449418031,21.541429333333333,2985.787157333333,13.380215151782494,125,5.0E-4
6,test_20231031_150506,10350842.png,212614,6102,206512,0.9713001025332292,2,5,42529,894,41635,0.9789790495896917,19.318012444444445,2373.8444053333333,14.37628111337661,125,5.0E-4
7,test_20231031_150506,10863862.png,317432,12162,305270,0.9616862824163915,3,5,66058,1765,64293,0.9732810560416604,24.022609777777777,3308.937994666667,12.933917317637896,125,5.0E-4
8,test_20231031_150506,11382381.png,312486,767,311719,0.9975454900379537,2,7,46745,100,46645,0.9978607337683175,21.58402311111111,2479.723024,14.186771864393144,125,5.0E-4
9,test_20231031_150506,11079715.png,443815,120387,323428,0.7287450852269527,5,6,124136,16809,107327,0.8645920603209383,16.86984177777778,2095.0260693333335,14.918909294142013,125,5.0E-4
10,test_20231031_150506,11551286.png,271883,447,271436,0.9983559104467731,2,6,40092,64,40028,0.9984036715554225,17.85190933333333,1855.3641226666666,15.446512065144763,125,5.0E-4
1,test_20231031_150507,10404007.png,502730,21177,481553,0.9578759970560738,3,6,61265,3065,58200,0.9499714355668,25.765313777777777,3444.1170506666667,12.760024580413443,125,6.000000000000001E-4
2,test_20231031_150507,1254659.png,342646,74697,267949,0.7819994980241999,5,6,80080,10439,69641,0.8696428571428572,20.84253688888889,3163.838,13.12866122928261,125,6.000000000000001E-4
3,test_20231031_150507,10188041.png,221231,9752,211479,0.9559193783872966,3,5,41731,1375,40356,0.9670508734513911,11.024238222222221,1074.0035093333333,17.82074660433971,125,6.000000000000001E-4
4,test_20231031_150507,10287332.png,216980,12584,204396,0.942003871324546,3,6,22337,1727,20610,0.9226843354076196,9.448579555555556,778.9383466666667,19.21577276445775,125,6.000000000000001E-4
5,test_20231031_150507,11610969.png,368720,25697,343023,0.930307550444782,3,5,84111,3750,80361,0.9554160573527838,21.631701333333332,3001.576629333333,13.357309256291893,125,6.000000000000001E-4
6,test_20231031_150507,10350842.png,212614,6102,206512,0.9713001025332292,3,5,42529,894,41635,0.9789790495896917,19.318012444444445,2373.8444053333333,14.37628111337661,125,6.000000000000001E-4
7,test_20231031_150507,10863862.png,317432,12162,305270,0.9616862824163915,4,5,66058,1765,64293,0.9732810560416604,24.022609777777777,3308.937994666667,12.933917317637896,125,6.000000000000001E-4
8,test_20231031_150507,11382381.png,312486,767,311719,0.9975454900379537,2,6,46745,100,46645,0.9978607337683175,21.58402311111111,2479.723024,14.186771864393144,125,6.000000000000001E-4
9,test_20231031_150507,11079715.png,443815,120387,323428,0.7287450852269527,5,7,124136,16809,107327,0.8645920603209383,16.86984177777778,2095.0260693333335,14.918909294142013,125,6.000000000000001E-4
10,test_20231031_150507,11551286.png,271883,367,271516,0.9986501546621157,2,6,40092,52,40040,0.9987029831387808,18.002010666666667,1874.0560373333333,15.402977880083654,125,6.000000000000001E-4
1,test_20231031_150508,10404007.png,502730,21177,481553,0.9578759970560738,4,6,61265,3065,58200,0.9499714355668,25.765313777777777,3444.1170506666667,12.760024580413443,125,7.000000000000001E-4
2,test_20231031_150508,1254659.png,342646,74697,267949,0.7819994980241999,5,6,80080,10439,69641,0.8696428571428572,20.84253688888889,3163.838,13.12866122928261,125,7.000000000000001E-4
3,test_20231031_150508,10188041.png,221231,9752,211479,0.9559193783872966,3,5,41731,1375,40356,0.9670508734513911,11.024238222222221,1074.0035093333333,17.82074660433971,125,7.000000000000001E-4
4,test_20231031_150508,10287332.png,216980,12584,204396,0.942003871324546,2,6,22337,1727,20610,0.9226843354076196,9.448579555555556,778.9383466666667,19.21577276445775,125,7.000000000000001E-4
5,test_20231031_150508,11610969.png,368720,25697,343023,0.930307550444782,3,6,84111,3750,80361,0.9554160573527838,21.631701333333332,3001.576629333333,13.357309256291893,125,7.000000000000001E-4
6,test_20231031_150508,10350842.png,212614,6102,206512,0.9713001025332292,2,5,42529,894,41635,0.9789790495896917,19.318012444444445,2373.8444053333333,14.37628111337661,125,7.000000000000001E-4
7,test_20231031_150508,10863862.png,317432,12162,305270,0.9616862824163915,3,5,66058,1765,64293,0.9732810560416604,24.022609777777777,3308.937994666667,12.933917317637896,125,7.000000000000001E-4
8,test_20231031_150508,11382381.png,312486,767,311719,0.9975454900379537,2,5,46745,100,46645,0.9978607337683175,21.58402311111111,2479.723024,14.186771864393144,125,7.000000000000001E-4
9,test_20231031_150508,11079715.png,443815,120387,323428,0.7287450852269527,5,7,124136,16809,107327,0.8645920603209383,16.86984177777778,2095.0260693333335,14.918909294142013,125,7.000000000000001E-4
10,test_20231031_150508,11551286.png,271883,367,271516,0.9986501546621157,2,5,40092,52,40040,0.9987029831387808,18.002010666666667,1874.0560373333333,15.402977880083654,125,7.000000000000001E-4
1,test_20231031_150509,10404007.png,502730,20937,481793,0.9583533904879359,4,6,61265,3030,58235,0.9505427242308007,25.80952177777778,3452.553962666667,12.749398856360063,125,8.000000000000001E-4
2,test_20231031_150509,1254659.png,342646,74697,267949,0.7819994980241999,5,7,80080,10439,69641,0.8696428571428572,20.84253688888889,3163.838,13.12866122928261,125,8.000000000000001E-4
3,test_20231031_150509,10188041.png,221231,9632,211599,0.9564617978493068,3,6,41731,1357,40374,0.9674822074716638,11.119096888888889,1097.8743786666666,17.72527710893187,125,8.000000000000001E-4
4,test_20231031_150509,10287332.png,216980,12584,204396,0.942003871324546,2,5,22337,1727,20610,0.9226843354076196,9.448579555555556,778.9383466666667,19.21577276445775,125,8.000000000000001E-4
5,test_20231031_150509,11610969.png,368720,25697,343023,0.930307550444782,4,6,84111,3750,80361,0.9554160573527838,21.631701333333332,3001.576629333333,13.357309256291893,125,8.000000000000001E-4
6,test_20231031_150509,10350842.png,212614,6102,206512,0.9713001025332292,3,5,42529,894,41635,0.9789790495896917,19.318012444444445,2373.8444053333333,14.37628111337661,125,8.000000000000001E-4
7,test_20231031_150509,10863862.png,317432,12162,305270,0.9616862824163915,3,6,66058,1765,64293,0.9732810560416604,24.022609777777777,3308.937994666667,12.933917317637896,125,8.000000000000001E-4
8,test_20231031_150509,11382381.png,312486,767,311719,0.9975454900379537,3,6,46745,100,46645,0.9978607337683175,21.58402311111111,2479.723024,14.186771864393144,125,8.000000000000001E-4
9,test_20231031_150509,11079715.png,443815,120387,323428,0.7287450852269527,5,7,124136,16809,107327,0.8645920603209383,16.86984177777778,2095.0260693333335,14.918909294142013,125,8.000000000000001E-4
10,test_20231031_150509,11551286.png,271883,367,271516,0.9986501546621157,2,5,40092,52,40040,0.9987029831387808,18.002010666666667,1874.0560373333333,15.402977880083654,125,8.000000000000001E-4
1,test_20231031_150510,10404007.png,502730,20937,481793,0.9583533904879359,4,6,61265,3030,58235,0.9505427242308007,25.80952177777778,3452.553962666667,12.749398856360063,125,9.000000000000002E-4
2,test_20231031_150510,1254659.png,342646,74697,267949,0.7819994980241999,4,6,80080,10439,69641,0.8696428571428572,20.84253688888889,3163.838,13.12866122928261,125,9.000000000000002E-4
3,test_20231031_150510,10188041.png,221231,9532,211699,0.9569138140676487,3,5,41731,1346,40385,0.9677458004840527,11.166584888888888,1103.081408,17.704727960790887,125,9.000000000000002E-4
4,test_20231031_150510,10287332.png,216980,12584,204396,0.942003871324546,2,5,22337,1727,20610,0.9226843354076196,9.448579555555556,778.9383466666667,19.21577276445775,125,9.000000000000002E-4
5,test_20231031_150510,11610969.png,368720,25697,343023,0.930307550444782,4,6,84111,3750,80361,0.9554160573527838,21.631701333333332,3001.576629333333,13.357309256291893,125,9.000000000000002E-4
6,test_20231031_150510,10350842.png,212614,6102,206512,0.9713001025332292,3,6,42529,894,41635,0.9789790495896917,19.318012444444445,2373.8444053333333,14.37628111337661,125,9.000000000000002E-4
7,test_20231031_150510,10863862.png,317432,12162,305270,0.9616862824163915,4,6,66058,1765,64293,0.9732810560416604,24.022609777777777,3308.937994666667,12.933917317637896,125,9.000000000000002E-4
8,test_20231031_150510,11382381.png,312486,767,311719,0.9975454900379537,2,10,46745,100,46645,0.9978607337683175,21.58402311111111,2479.723024,14.186771864393144,125,9.000000000000002E-4
9,test_20231031_150510,11079715.png,443815,120387,323428,0.7287450852269527,5,7,124136,16809,107327,0.8645920603209383,16.86984177777778,2095.0260693333335,14.918909294142013,125,9.000000000000002E-4
10,test_20231031_150510,11551286.png,271883,367,271516,0.9986501546621157,2,5,40092,52,40040,0.9987029831387808,18.002010666666667,1874.0560373333333,15.402977880083654,125,9.000000000000002E-4
1,test_20231031_150511,10404007.png,502730,20834,481896,0.9585582718357767,3,5,61265,3016,58249,0.9507712396964009,25.686528,3429.773024,12.778149806752824,126,1.0E-4
2,test_20231031_150511,1254659.png,342646,73249,269397,0.7862254338296668,5,19,80080,10244,69836,0.8720779220779221,20.98264711111111,3208.4044853333335,13.067912460579436,126,1.0E-4
3,test_20231031_150511,10188041.png,221231,9692,211539,0.9561905881183017,4,6,41731,1366,40365,0.9672665404615274,10.568042666666667,1021.7253333333333,18.037461991689202,126,1.0E-4
4,test_20231031_150511,10287332.png,216980,12574,204406,0.9420499585215227,3,5,22337,1723,20614,0.9228634104848458,9.367333333333333,764.1768586666667,19.29886478922929,126,1.0E-4
5,test_20231031_150511,11610969.png,368720,25357,343363,0.9312296593621177,4,6,84111,3701,80410,0.9559986208700408,21.3076,2937.504816,13.451017735675183,126,1.0E-4
6,test_20231031_150511,10350842.png,212614,6082,206532,0.9713941697160112,2,5,42529,891,41638,0.9790495896917397,19.26112,2371.9918826666667,14.379671623979055,126,1.0E-4
7,test_20231031_150511,10863862.png,317432,11479,305953,0.9638379243428514,3,5,66058,1667,64391,0.9747646008053529,24.188906666666668,3362.179488,12.864594665868092,126,1.0E-4
8,test_20231031_150511,11382381.png,312486,997,311489,0.9968094570636764,4,5,46745,135,46610,0.9971119905872285,20.87208,2373.5487946666667,14.376821966329306,126,1.0E-4
9,test_20231031_150511,11079715.png,443815,118057,325758,0.733995020447709,5,7,124136,16497,107639,0.8671054327511761,17.022149333333335,2131.304528,14.84434853255526,126,1.0E-4
10,test_20231031_150511,11551286.png,271883,1039,270844,0.9961785032532376,3,6,40092,152,39940,0.9962087199441285,15.859841777777778,1507.39176,16.348542239511865,126,1.0E-4
1,test_20231031_150512,10404007.png,502730,20834,481896,0.9585582718357767,4,6,61265,3016,58249,0.9507712396964009,25.686528,3429.773024,12.778149806752824,126,2.0E-4
2,test_20231031_150512,1254659.png,342646,73249,269397,0.7862254338296668,5,6,80080,10244,69836,0.8720779220779221,20.98264711111111,3208.4044853333335,13.067912460579436,126,2.0E-4
3,test_20231031_150512,10188041.png,221231,9692,211539,0.9561905881183017,3,5,41731,1366,40365,0.9672665404615274,10.568042666666667,1021.7253333333333,18.037461991689202,126,2.0E-4
4,test_20231031_150512,10287332.png,216980,12364,204616,0.943017789658033,2,5,22337,1696,20641,0.9240721672561221,9.497095111111111,790.9076053333333,19.149546091497648,126,2.0E-4
5,test_20231031_150512,11610969.png,368720,25357,343363,0.9312296593621177,4,6,84111,3701,80410,0.9559986208700408,21.3076,2937.504816,13.451017735675183,126,2.0E-4
6,test_20231031_150512,10350842.png,212614,6082,206532,0.9713941697160112,2,5,42529,891,41638,0.9790495896917397,19.26112,2371.9918826666667,14.379671623979055,126,2.0E-4
7,test_20231031_150512,10863862.png,317432,11479,305953,0.9638379243428514,3,5,66058,1667,64391,0.9747646008053529,24.188906666666668,3362.179488,12.864594665868092,126,2.0E-4
8,test_20231031_150512,11382381.png,312486,867,311619,0.9972254757013114,3,10,46745,116,46629,0.9975184511712483,21.130496,2414.0920426666667,14.303265363409706,126,2.0E-4
9,test_20231031_150512,11079715.png,443815,118057,325758,0.733995020447709,5,6,124136,16497,107639,0.8671054327511761,17.022149333333335,2131.304528,14.84434853255526,126,2.0E-4
10,test_20231031_150512,11551286.png,271883,737,271146,0.9972892751661561,6,6,40092,107,39985,0.997331138381722,17.57074488888889,1811.3484693333332,15.5507835243661,126,2.0E-4
1,test_20231031_150513,10404007.png,502730,20754,481976,0.9587174029797306,3,5,61265,3004,58261,0.9509671100954868,25.695610666666667,3431.257168,12.776270918184878,126,3.0000000000000003E-4
2,test_20231031_150513,1254659.png,342646,73189,269457,0.7864005416669099,15,7,80080,10238,69842,0.8721528471528471,20.99220088888889,3209.486672,13.066447843337867,126,3.0000000000000003E-4
3,test_20231031_150513,10188041.png,221231,9592,211639,0.9566426043366436,3,6,41731,1351,40380,0.9676259854784213,10.691395555555555,1037.4407253333334,17.971170683956313,126,3.0000000000000003E-4
4,test_20231031_150513,10287332.png,216980,12364,204616,0.943017789658033,3,6,22337,1696,20641,0.9240721672561221,9.497095111111111,790.9076053333333,19.149546091497648,126,3.0000000000000003E-4
5,test_20231031_150513,11610969.png,368720,25037,343683,0.9320975265784335,9,5,84111,3655,80456,0.9565455172331799,21.725516444444445,3023.573904,13.3255977251099,126,3.0000000000000003E-4
6,test_20231031_150513,10350842.png,212614,6002,206612,0.971770438447139,2,7,42529,879,41650,0.9793317500999318,19.329912888888888,2377.7495893333335,14.369142455293513,126,3.0000000000000003E-4
7,test_20231031_150513,10863862.png,317432,11359,306073,0.9642159580634593,3,7,66058,1649,64409,0.9750370886190923,24.240064,3365.490752,12.860319593671788,126,3.0000000000000003E-4
8,test_20231031_150513,11382381.png,312486,747,311739,0.9976094929052821,2,5,46745,98,46647,0.9979035190929512,21.62502222222222,2484.034352,14.179227634129312,126,3.0000000000000003E-4
9,test_20231031_150513,11079715.png,443815,118057,325758,0.733995020447709,5,7,124136,16497,107639,0.8671054327511761,17.022149333333335,2131.304528,14.84434853255526,126,3.0000000000000003E-4
10,test_20231031_150513,11551286.png,271883,427,271456,0.9984294715006087,2,5,40092,61,40031,0.9984784994512621,17.85376888888889,1855.7630026666666,15.445578486866474,126,3.0000000000000003E-4
1,test_20231031_150514,10404007.png,502730,20472,482258,0.9592783402621685,3,6,61265,2964,58301,0.9516200114257732,25.783781333333334,3450.961552,12.75140240129671,126,4.0E-4
2,test_20231031_150514,1254659.png,342646,73189,269457,0.7864005416669099,5,7,80080,10238,69842,0.8721528471528471,20.99220088888889,3209.486672,13.066447843337867,126,4.0E-4
3,test_20231031_150514,10188041.png,221231,9592,211639,0.9566426043366436,3,6,41731,1351,40380,0.9676259854784213,10.691395555555555,1037.4407253333334,17.971170683956313,126,4.0E-4
4,test_20231031_150514,10287332.png,216980,12364,204616,0.943017789658033,2,5,22337,1696,20641,0.9240721672561221,9.497095111111111,790.9076053333333,19.149546091497648,126,4.0E-4
5,test_20231031_150514,11610969.png,368720,25037,343683,0.9320975265784335,4,6,84111,3655,80456,0.9565455172331799,21.725516444444445,3023.573904,13.3255977251099,126,4.0E-4
6,test_20231031_150514,10350842.png,212614,6002,206612,0.971770438447139,3,5,42529,879,41650,0.9793317500999318,19.329912888888888,2377.7495893333335,14.369142455293513,126,4.0E-4
7,test_20231031_150514,10863862.png,317432,11359,306073,0.9642159580634593,4,6,66058,1649,64409,0.9750370886190923,24.240064,3365.490752,12.860319593671788,126,4.0E-4
8,test_20231031_150514,11382381.png,312486,747,311739,0.9976094929052821,3,5,46745,98,46647,0.9979035190929512,21.62502222222222,2484.034352,14.179227634129312,126,4.0E-4
9,test_20231031_150514,11079715.png,443815,118057,325758,0.733995020447709,5,6,124136,16497,107639,0.8671054327511761,17.022149333333335,2131.304528,14.84434853255526,126,4.0E-4
10,test_20231031_150514,11551286.png,271883,427,271456,0.9984294715006087,2,5,40092,61,40031,0.9984784994512621,17.85376888888889,1855.7630026666666,15.445578486866474,126,4.0E-4
1,test_20231031_150515,10404007.png,502730,20472,482258,0.9592783402621685,3,5,61265,2964,58301,0.9516200114257732,25.783781333333334,3450.961552,12.75140240129671,126,5.0E-4
2,test_20231031_150515,1254659.png,342646,73189,269457,0.7864005416669099,4,6,80080,10238,69842,0.8721528471528471,20.99220088888889,3209.486672,13.066447843337867,126,5.0E-4
3,test_20231031_150515,10188041.png,221231,9592,211639,0.9566426043366436,3,6,41731,1351,40380,0.9676259854784213,10.691395555555555,1037.4407253333334,17.971170683956313,126,5.0E-4
4,test_20231031_150515,10287332.png,216980,12364,204616,0.943017789658033,3,6,22337,1696,20641,0.9240721672561221,9.497095111111111,790.9076053333333,19.149546091497648,126,5.0E-4
5,test_20231031_150515,11610969.png,368720,25037,343683,0.9320975265784335,3,6,84111,3655,80456,0.9565455172331799,21.725516444444445,3023.573904,13.3255977251099,126,5.0E-4
6,test_20231031_150515,10350842.png,212614,6002,206612,0.971770438447139,2,5,42529,879,41650,0.9793317500999318,19.329912888888888,2377.7495893333335,14.369142455293513,126,5.0E-4
7,test_20231031_150515,10863862.png,317432,10292,307140,0.9675773078958643,3,5,66058,1495,64563,0.9773683732477519,26.677214222222222,4038.738533333333,12.068346228764726,126,5.0E-4
8,test_20231031_150515,11382381.png,312486,747,311739,0.9976094929052821,3,6,46745,98,46647,0.9979035190929512,21.62502222222222,2484.034352,14.179227634129312,126,5.0E-4
9,test_20231031_150515,11079715.png,443815,118057,325758,0.733995020447709,6,7,124136,16497,107639,0.8671054327511761,17.022149333333335,2131.304528,14.84434853255526,126,5.0E-4
10,test_20231031_150515,11551286.png,271883,427,271456,0.9984294715006087,2,5,40092,61,40031,0.9984784994512621,17.85376888888889,1855.7630026666666,15.445578486866474,126,5.0E-4
1,test_20231031_150516,10404007.png,502730,20152,482578,0.9599148648379846,3,6,61265,2920,58345,0.9523382028890884,25.83563022222222,3461.3983253333336,12.738287816430331,126,6.000000000000001E-4
2,test_20231031_150516,1254659.png,342646,73189,269457,0.7864005416669099,4,6,80080,10238,69842,0.8721528471528471,20.99220088888889,3209.486672,13.066447843337867,126,6.000000000000001E-4
3,test_20231031_150516,10188041.png,221231,9489,211742,0.9571081810415357,3,6,41731,1338,40393,0.9679375044930627,11.075875555555555,1087.4010666666666,17.766906061885894,126,6.000000000000001E-4
4,test_20231031_150516,10287332.png,216980,12364,204616,0.943017789658033,3,6,22337,1696,20641,0.9240721672561221,9.497095111111111,790.9076053333333,19.149546091497648,126,6.000000000000001E-4
5,test_20231031_150516,11610969.png,368720,25037,343683,0.9320975265784335,4,5,84111,3655,80456,0.9565455172331799,21.725516444444445,3023.573904,13.3255977251099,126,6.000000000000001E-4
6,test_20231031_150516,10350842.png,212614,6002,206612,0.971770438447139,3,6,42529,879,41650,0.9793317500999318,19.329912888888888,2377.7495893333335,14.369142455293513,126,6.000000000000001E-4
7,test_20231031_150516,10863862.png,317432,10292,307140,0.9675773078958643,3,5,66058,1495,64563,0.9773683732477519,26.677214222222222,4038.738533333333,12.068346228764726,126,6.000000000000001E-4
8,test_20231031_150516,11382381.png,312486,747,311739,0.9976094929052821,3,6,46745,98,46647,0.9979035190929512,21.62502222222222,2484.034352,14.179227634129312,126,6.000000000000001E-4
9,test_20231031_150516,11079715.png,443815,118057,325758,0.733995020447709,5,6,124136,16497,107639,0.8671054327511761,17.022149333333335,2131.304528,14.84434853255526,126,6.000000000000001E-4
10,test_20231031_150516,11551286.png,271883,367,271516,0.9986501546621157,2,5,40092,52,40040,0.9987029831387808,18.002010666666667,1874.0560373333333,15.402977880083654,126,6.000000000000001E-4
1,test_20231031_150517,10404007.png,502730,20152,482578,0.9599148648379846,3,6,61265,2920,58345,0.9523382028890884,25.83563022222222,3461.3983253333336,12.738287816430331,126,7.000000000000001E-4
2,test_20231031_150517,1254659.png,342646,73189,269457,0.7864005416669099,4,6,80080,10238,69842,0.8721528471528471,20.99220088888889,3209.486672,13.066447843337867,126,7.000000000000001E-4
3,test_20231031_150517,10188041.png,221231,9489,211742,0.9571081810415357,4,6,41731,1338,40393,0.9679375044930627,11.075875555555555,1087.4010666666666,17.766906061885894,126,7.000000000000001E-4
4,test_20231031_150517,10287332.png,216980,12364,204616,0.943017789658033,3,6,22337,1696,20641,0.9240721672561221,9.497095111111111,790.9076053333333,19.149546091497648,126,7.000000000000001E-4
5,test_20231031_150517,11610969.png,368720,25037,343683,0.9320975265784335,4,6,84111,3655,80456,0.9565455172331799,21.725516444444445,3023.573904,13.3255977251099,126,7.000000000000001E-4
6,test_20231031_150517,10350842.png,212614,6002,206612,0.971770438447139,2,5,42529,879,41650,0.9793317500999318,19.329912888888888,2377.7495893333335,14.369142455293513,126,7.000000000000001E-4
7,test_20231031_150517,10863862.png,317432,10292,307140,0.9675773078958643,3,6,66058,1495,64563,0.9773683732477519,26.677214222222222,4038.738533333333,12.068346228764726,126,7.000000000000001E-4
8,test_20231031_150517,11382381.png,312486,747,311739,0.9976094929052821,2,5,46745,98,46647,0.9979035190929512,21.62502222222222,2484.034352,14.179227634129312,126,7.000000000000001E-4
9,test_20231031_150517,11079715.png,443815,118057,325758,0.733995020447709,5,6,124136,16497,107639,0.8671054327511761,17.022149333333335,2131.304528,14.84434853255526,126,7.000000000000001E-4
10,test_20231031_150517,11551286.png,271883,367,271516,0.9986501546621157,2,6,40092,52,40040,0.9987029831387808,18.002010666666667,1874.0560373333333,15.402977880083654,126,7.000000000000001E-4
1,test_20231031_150518,10404007.png,502730,20012,482718,0.9601933443399041,3,6,61265,2900,58365,0.9526646535542316,25.84072888888889,3462.5373013333333,12.736859001886254,126,8.000000000000001E-4
2,test_20231031_150518,1254659.png,342646,73189,269457,0.7864005416669099,4,6,80080,10238,69842,0.8721528471528471,20.99220088888889,3209.486672,13.066447843337867,126,8.000000000000001E-4
3,test_20231031_150518,10188041.png,221231,9369,211862,0.9576506005035461,3,5,41731,1320,40411,0.9683688385133354,11.170734222222222,1111.271936,17.672600140304922,126,8.000000000000001E-4
4,test_20231031_150518,10287332.png,216980,12364,204616,0.943017789658033,3,6,22337,1696,20641,0.9240721672561221,9.497095111111111,790.9076053333333,19.149546091497648,126,8.000000000000001E-4
5,test_20231031_150518,11610969.png,368720,24997,343723,0.932206009980473,4,6,84111,3653,80458,0.9565692953359252,22.103546666666666,3086.686544,13.235878321707402,126,8.000000000000001E-4
6,test_20231031_150518,10350842.png,212614,6002,206612,0.971770438447139,2,5,42529,879,41650,0.9793317500999318,19.329912888888888,2377.7495893333335,14.369142455293513,126,8.000000000000001E-4
7,test_20231031_150518,10863862.png,317432,10292,307140,0.9675773078958643,4,6,66058,1495,64563,0.9773683732477519,26.677214222222222,4038.738533333333,12.068346228764726,126,8.000000000000001E-4
8,test_20231031_150518,11382381.png,312486,747,311739,0.9976094929052821,3,6,46745,98,46647,0.9979035190929512,21.62502222222222,2484.034352,14.179227634129312,126,8.000000000000001E-4
9,test_20231031_150518,11079715.png,443815,118057,325758,0.733995020447709,5,7,124136,16497,107639,0.8671054327511761,17.022149333333335,2131.304528,14.84434853255526,126,8.000000000000001E-4
10,test_20231031_150518,11551286.png,271883,367,271516,0.9986501546621157,2,6,40092,52,40040,0.9987029831387808,18.002010666666667,1874.0560373333333,15.402977880083654,126,8.000000000000001E-4
1,test_20231031_150519,10404007.png,502730,20012,482718,0.9601933443399041,4,6,61265,2900,58365,0.9526646535542316,25.84072888888889,3462.5373013333333,12.736859001886254,126,9.000000000000002E-4
2,test_20231031_150519,1254659.png,342646,73189,269457,0.7864005416669099,5,6,80080,10238,69842,0.8721528471528471,20.99220088888889,3209.486672,13.066447843337867,126,9.000000000000002E-4
3,test_20231031_150519,10188041.png,221231,9269,211962,0.958102616721888,3,6,41731,1309,40422,0.9686324315257243,11.218222222222222,1116.4789653333332,17.65229815570365,126,9.000000000000002E-4
4,test_20231031_150519,10287332.png,216980,12364,204616,0.943017789658033,3,6,22337,1696,20641,0.9240721672561221,9.497095111111111,790.9076053333333,19.149546091497648,126,9.000000000000002E-4
5,test_20231031_150519,11610969.png,368720,24997,343723,0.932206009980473,4,6,84111,3653,80458,0.9565692953359252,22.103546666666666,3086.686544,13.235878321707402,126,9.000000000000002E-4
6,test_20231031_150519,10350842.png,212614,4294,208320,0.9798037758567169,2,6,42529,628,41901,0.9852336053046157,23.505242666666668,3390.545104,12.828108347509533,126,9.000000000000002E-4
7,test_20231031_150519,10863862.png,317432,10292,307140,0.9675773078958643,3,5,66058,1495,64563,0.9773683732477519,26.677214222222222,4038.738533333333,12.068346228764726,126,9.000000000000002E-4
8,test_20231031_150519,11382381.png,312486,747,311739,0.9976094929052821,2,5,46745,98,46647,0.9979035190929512,21.62502222222222,2484.034352,14.179227634129312,126,9.000000000000002E-4
9,test_20231031_150519,11079715.png,443815,118057,325758,0.733995020447709,8,7,124136,16497,107639,0.8671054327511761,17.022149333333335,2131.304528,14.84434853255526,126,9.000000000000002E-4
10,test_20231031_150519,11551286.png,271883,367,271516,0.9986501546621157,2,7,40092,52,40040,0.9987029831387808,18.002010666666667,1874.0560373333333,15.402977880083654,126,9.000000000000002E-4
1,test_20231031_150520,10404007.png,502730,19649,483081,0.9609154019055954,4,6,61265,2845,58420,0.9535623928833755,25.79059377777778,3461.428794666667,12.738249587356849,127,1.0E-4
2,test_20231031_150520,1254659.png,342646,71682,270964,0.7907986668456658,4,6,80080,10037,70043,0.8746628371628371,21.233608888888888,3282.5188533333335,12.968731317042248,127,1.0E-4
3,test_20231031_150520,10188041.png,221231,9489,211742,0.9571081810415357,3,6,41731,1337,40394,0.967961467494189,10.60381511111111,1029.055584,18.006415272400552,127,1.0E-4
4,test_20231031_150520,10287332.png,216980,12312,204668,0.9432574430823117,2,6,22337,1688,20649,0.9244303174105744,9.401898666666666,774.2090986666667,19.242220899357278,127,1.0E-4
5,test_20231031_150520,11610969.png,368720,24512,344208,0.9335213712302017,4,6,84111,3579,80532,0.9574490851374968,21.428912,2970.4620213333333,13.402563567661467,127,1.0E-4
6,test_20231031_150520,10350842.png,212614,5842,206772,0.9725229759093945,2,5,42529,859,41670,0.9798020174469185,19.341116444444445,2392.76384,14.341805239536118,127,1.0E-4
7,test_20231031_150520,10863862.png,317432,11017,306415,0.9652933541671918,3,5,66058,1602,64456,0.9757485845771897,24.437365333333332,3426.7552746666665,12.781972709279499,127,1.0E-4
8,test_20231031_150520,11382381.png,312486,957,311529,0.9969374627983334,3,6,46745,131,46614,0.9971975612364958,21.075297777777777,2410.7878986666665,14.309213580767988,127,1.0E-4
9,test_20231031_150520,11079715.png,443815,115577,328238,0.7395829343307458,5,6,124136,16143,107993,0.8699571437777921,17.25776711111111,2193.2968,14.719829558750817,127,1.0E-4
10,test_20231031_150520,11551286.png,271883,917,270966,0.9966272256816351,2,5,40092,134,39958,0.9966576873191659,15.986103111111111,1528.055536,16.289412222433906,127,1.0E-4
1,test_20231031_150521,10404007.png,502730,19649,483081,0.9609154019055954,3,6,61265,2845,58420,0.9535623928833755,25.79059377777778,3461.428794666667,12.738249587356849,127,2.0E-4
2,test_20231031_150521,1254659.png,342646,71682,270964,0.7907986668456658,4,7,80080,10037,70043,0.8746628371628371,21.233608888888888,3282.5188533333335,12.968731317042248,127,2.0E-4
3,test_20231031_150521,10188041.png,221231,9489,211742,0.9571081810415357,3,6,41731,1337,40394,0.967961467494189,10.60381511111111,1029.055584,18.006415272400552,127,2.0E-4
4,test_20231031_150521,10287332.png,216980,12102,204878,0.944225274218822,2,5,22337,1661,20676,0.9256390741818508,9.531660444444444,800.9398453333333,19.09480461289071,127,2.0E-4
5,test_20231031_150521,11610969.png,368720,24512,344208,0.9335213712302017,3,6,84111,3579,80532,0.9574490851374968,21.428912,2970.4620213333333,13.402563567661467,127,2.0E-4
6,test_20231031_150521,10350842.png,212614,5842,206772,0.9725229759093945,2,6,42529,859,41670,0.9798020174469185,19.341116444444445,2392.76384,14.341805239536118,127,2.0E-4
7,test_20231031_150521,10863862.png,317432,11017,306415,0.9652933541671918,3,6,66058,1602,64456,0.9757485845771897,24.437365333333332,3426.7552746666665,12.781972709279499,127,2.0E-4
8,test_20231031_150521,11382381.png,312486,827,311659,0.9973534814359684,2,5,46745,112,46633,0.9976040218205156,21.333713777777778,2451.331146666667,14.236783774592807,127,2.0E-4
9,test_20231031_150521,11079715.png,443815,115577,328238,0.7395829343307458,5,6,124136,16143,107993,0.8699571437777921,17.25776711111111,2193.2968,14.719829558750817,127,2.0E-4
10,test_20231031_150521,11551286.png,271883,697,271186,0.9974363972738274,2,5,40092,101,39991,0.9974807941734012,17.572291555555555,1811.64304,15.55007731009529,127,2.0E-4
1,test_20231031_150522,10404007.png,502730,19467,483263,0.9612774252580908,4,6,61265,2821,58444,0.9539541336815474,25.804821333333333,3464.2128746666667,12.734757894589483,127,3.0000000000000003E-4
2,test_20231031_150522,1254659.png,342646,71622,271024,0.7909737746829089,5,6,80080,10031,70049,0.8747377622377622,21.243162666666667,3283.60104,12.96729976321864,127,3.0000000000000003E-4
3,test_20231031_150522,10188041.png,221231,9449,211782,0.9572889875288726,3,6,41731,1331,40400,0.9681052455009466,10.71383111111111,1042.626304,17.949516834977533,127,3.0000000000000003E-4
4,test_20231031_150522,10287332.png,216980,12102,204878,0.944225274218822,3,6,22337,1661,20676,0.9256390741818508,9.531660444444444,800.9398453333333,19.09480461289071,127,3.0000000000000003E-4
5,test_20231031_150522,11610969.png,368720,24192,344528,0.9343892384465177,4,6,84111,3533,80578,0.957995981500636,21.846828444444444,3056.5311093333335,13.278515404761055,127,3.0000000000000003E-4
6,test_20231031_150522,10350842.png,212614,5762,206852,0.9728992446405222,3,6,42529,847,41682,0.9800841778551106,19.409909333333335,2398.521546666667,14.33136736645771,127,3.0000000000000003E-4
7,test_20231031_150522,10863862.png,317432,10897,306535,0.9656713878877996,3,5,66058,1584,64474,0.9760210723909292,24.488522666666668,3430.0665386666665,12.77777816015962,127,3.0000000000000003E-4
8,test_20231031_150522,11382381.png,312486,707,311779,0.9977374986399391,2,5,46745,94,46651,0.9979890897422184,21.82824,2521.273456,14.11460409284577,127,3.0000000000000003E-4
9,test_20231031_150522,11079715.png,443815,115577,328238,0.7395829343307458,5,7,124136,16143,107993,0.8699571437777921,17.25776711111111,2193.2968,14.719829558750817,127,3.0000000000000003E-4
10,test_20231031_150522,11551286.png,271883,407,271476,0.9985030325544444,2,5,40092,58,40034,0.9985533273471017,17.855009777777777,1855.9584906666666,15.44512102064812,127,3.0000000000000003E-4
1,test_20231031_150524,10404007.png,502730,19187,483543,0.9618343842619299,4,6,61265,2780,58485,0.954623357545091,25.892992,3483.917258666667,12.710125286916409,127,4.0E-4
2,test_20231031_150524,1254659.png,342646,71622,271024,0.7909737746829089,5,6,80080,10031,70049,0.8747377622377622,21.243162666666667,3283.60104,12.96729976321864,127,4.0E-4
3,test_20231031_150524,10188041.png,221231,9449,211782,0.9572889875288726,3,6,41731,1331,40400,0.9681052455009466,10.71383111111111,1042.626304,17.949516834977533,127,4.0E-4
4,test_20231031_150524,10287332.png,216980,12102,204878,0.944225274218822,3,6,22337,1661,20676,0.9256390741818508,9.531660444444444,800.9398453333333,19.09480461289071,127,4.0E-4
5,test_20231031_150524,11610969.png,368720,24192,344528,0.9343892384465177,4,7,84111,3533,80578,0.957995981500636,21.846828444444444,3056.5311093333335,13.278515404761055,127,4.0E-4
6,test_20231031_150524,10350842.png,212614,5762,206852,0.9728992446405222,3,6,42529,847,41682,0.9800841778551106,19.409909333333335,2398.521546666667,14.33136736645771,127,4.0E-4
7,test_20231031_150524,10863862.png,317432,9872,307560,0.9689004259179919,3,6,66058,1435,64623,0.9782766659602168,26.91376177777778,4100.150074666667,12.002806077074947,127,4.0E-4
8,test_20231031_150524,11382381.png,312486,707,311779,0.9977374986399391,3,6,46745,94,46651,0.9979890897422184,21.82824,2521.273456,14.11460409284577,127,4.0E-4
9,test_20231031_150524,11079715.png,443815,115577,328238,0.7395829343307458,5,7,124136,16143,107993,0.8699571437777921,17.25776711111111,2193.2968,14.719829558750817,127,4.0E-4
10,test_20231031_150524,11551286.png,271883,407,271476,0.9985030325544444,2,5,40092,58,40034,0.9985533273471017,17.855009777777777,1855.9584906666666,15.44512102064812,127,4.0E-4
1,test_20231031_150525,10404007.png,502730,19187,483543,0.9618343842619299,4,5,61265,2780,58485,0.954623357545091,25.892992,3483.917258666667,12.710125286916409,127,5.0E-4
2,test_20231031_150525,1254659.png,342646,71622,271024,0.7909737746829089,4,6,80080,10031,70049,0.8747377622377622,21.243162666666667,3283.60104,12.96729976321864,127,5.0E-4
3,test_20231031_150525,10188041.png,221231,9449,211782,0.9572889875288726,3,6,41731,1331,40400,0.9681052455009466,10.71383111111111,1042.626304,17.949516834977533,127,5.0E-4
4,test_20231031_150525,10287332.png,216980,12102,204878,0.944225274218822,2,5,22337,1661,20676,0.9256390741818508,9.531660444444444,800.9398453333333,19.09480461289071,127,5.0E-4
5,test_20231031_150525,11610969.png,368720,24192,344528,0.9343892384465177,5,6,84111,3533,80578,0.957995981500636,21.846828444444444,3056.5311093333335,13.278515404761055,127,5.0E-4
6,test_20231031_150525,10350842.png,212614,5762,206852,0.9728992446405222,2,5,42529,847,41682,0.9800841778551106,19.409909333333335,2398.521546666667,14.33136736645771,127,5.0E-4
7,test_20231031_150525,10863862.png,317432,9872,307560,0.9689004259179919,3,6,66058,1435,64623,0.9782766659602168,26.91376177777778,4100.150074666667,12.002806077074947,127,5.0E-4
8,test_20231031_150525,11382381.png,312486,707,311779,0.9977374986399391,2,6,46745,94,46651,0.9979890897422184,21.82824,2521.273456,14.11460409284577,127,5.0E-4
9,test_20231031_150525,11079715.png,443815,115577,328238,0.7395829343307458,5,7,124136,16143,107993,0.8699571437777921,17.25776711111111,2193.2968,14.719829558750817,127,5.0E-4
10,test_20231031_150525,11551286.png,271883,407,271476,0.9985030325544444,2,6,40092,58,40034,0.9985533273471017,17.855009777777777,1855.9584906666666,15.44512102064812,127,5.0E-4
1,test_20231031_150526,10404007.png,502730,18927,483803,0.9623515604797804,3,6,61265,2745,58520,0.9551946462090917,25.943144888888888,3493.450917333333,12.698257150325322,127,6.000000000000001E-4
2,test_20231031_150526,1254659.png,342646,71622,271024,0.7909737746829089,5,6,80080,10031,70049,0.8747377622377622,21.243162666666667,3283.60104,12.96729976321864,127,6.000000000000001E-4
3,test_20231031_150526,10188041.png,221231,9369,211862,0.9576506005035461,3,6,41731,1321,40410,0.9683448755122092,11.097500444444444,1092.3682453333333,17.7471129396718,127,6.000000000000001E-4
4,test_20231031_150526,10287332.png,216980,12102,204878,0.944225274218822,2,5,22337,1661,20676,0.9256390741818508,9.531660444444444,800.9398453333333,19.09480461289071,127,6.000000000000001E-4
5,test_20231031_150526,11610969.png,368720,23932,344788,0.9350943805597743,4,6,84111,3494,80617,0.9584596545041671,22.325708444444444,3166.5979893333333,13.124874291967245,127,6.000000000000001E-4
6,test_20231031_150526,10350842.png,212614,5762,206852,0.9728992446405222,2,6,42529,847,41682,0.9800841778551106,19.409909333333335,2398.521546666667,14.33136736645771,127,6.000000000000001E-4
7,test_20231031_150526,10863862.png,317432,9872,307560,0.9689004259179919,3,11,66058,1435,64623,0.9782766659602168,26.91376177777778,4100.150074666667,12.002806077074947,127,6.000000000000001E-4
8,test_20231031_150526,11382381.png,312486,707,311779,0.9977374986399391,2,5,46745,94,46651,0.9979890897422184,21.82824,2521.273456,14.11460409284577,127,6.000000000000001E-4
9,test_20231031_150526,11079715.png,443815,115577,328238,0.7395829343307458,5,6,124136,16143,107993,0.8699571437777921,17.25776711111111,2193.2968,14.719829558750817,127,6.000000000000001E-4
10,test_20231031_150526,11551286.png,271883,347,271536,0.9987237157159513,2,5,40092,49,40043,0.9987778110346204,18.003251555555554,1874.2515253333333,15.402524879051395,127,6.000000000000001E-4
1,test_20231031_150527,10404007.png,502730,18927,483803,0.9623515604797804,3,6,61265,2745,58520,0.9551946462090917,25.943144888888888,3493.450917333333,12.698257150325322,127,7.000000000000001E-4
2,test_20231031_150527,1254659.png,342646,71622,271024,0.7909737746829089,5,6,80080,10031,70049,0.8747377622377622,21.243162666666667,3283.60104,12.96729976321864,127,7.000000000000001E-4
3,test_20231031_150527,10188041.png,221231,9369,211862,0.9576506005035461,3,6,41731,1321,40410,0.9683448755122092,11.097500444444444,1092.3682453333333,17.7471129396718,127,7.000000000000001E-4
4,test_20231031_150527,10287332.png,216980,12102,204878,0.944225274218822,3,6,22337,1661,20676,0.9256390741818508,9.531660444444444,800.9398453333333,19.09480461289071,127,7.000000000000001E-4
5,test_20231031_150527,11610969.png,368720,23932,344788,0.9350943805597743,4,6,84111,3494,80617,0.9584596545041671,22.325708444444444,3166.5979893333333,13.124874291967245,127,7.000000000000001E-4
6,test_20231031_150527,10350842.png,212614,5762,206852,0.9728992446405222,2,5,42529,847,41682,0.9800841778551106,19.409909333333335,2398.521546666667,14.33136736645771,127,7.000000000000001E-4
7,test_20231031_150527,10863862.png,317432,9872,307560,0.9689004259179919,3,6,66058,1435,64623,0.9782766659602168,26.91376177777778,4100.150074666667,12.002806077074947,127,7.000000000000001E-4
8,test_20231031_150527,11382381.png,312486,707,311779,0.9977374986399391,3,5,46745,94,46651,0.9979890897422184,21.82824,2521.273456,14.11460409284577,127,7.000000000000001E-4
9,test_20231031_150527,11079715.png,443815,115577,328238,0.7395829343307458,6,7,124136,16143,107993,0.8699571437777921,17.25776711111111,2193.2968,14.719829558750817,127,7.000000000000001E-4
10,test_20231031_150527,11551286.png,271883,347,271536,0.9987237157159513,2,5,40092,49,40043,0.9987778110346204,18.003251555555554,1874.2515253333333,15.402524879051395,127,7.000000000000001E-4
1,test_20231031_150528,10404007.png,502730,18787,483943,0.9626300399816999,3,5,61265,2725,58540,0.9555210968742349,25.948243555555557,3494.5898933333333,12.69684144309177,127,8.000000000000001E-4
2,test_20231031_150528,1254659.png,342646,71622,271024,0.7909737746829089,5,6,80080,10031,70049,0.8747377622377622,21.243162666666667,3283.60104,12.96729976321864,127,8.000000000000001E-4
3,test_20231031_150528,10188041.png,221231,9147,212084,0.9586540765082652,3,6,41731,1291,40440,0.9690637655459969,11.23984711111111,1121.446144,17.633019388786877,127,8.000000000000001E-4
4,test_20231031_150528,10287332.png,216980,12102,204878,0.944225274218822,2,6,22337,1661,20676,0.9256390741818508,9.531660444444444,800.9398453333333,19.09480461289071,127,8.000000000000001E-4
5,test_20231031_150528,11610969.png,368720,23889,344831,0.9352110002169668,3,6,84111,3492,80619,0.9584834326069123,22.703738666666666,3229.710629333333,13.039167480456243,127,8.000000000000001E-4
6,test_20231031_150528,10350842.png,212614,5762,206852,0.9728992446405222,3,6,42529,847,41682,0.9800841778551106,19.409909333333335,2398.521546666667,14.33136736645771,127,8.000000000000001E-4
7,test_20231031_150528,10863862.png,317432,9872,307560,0.9689004259179919,4,6,66058,1435,64623,0.9782766659602168,26.91376177777778,4100.150074666667,12.002806077074947,127,8.000000000000001E-4
8,test_20231031_150528,11382381.png,312486,707,311779,0.9977374986399391,2,6,46745,94,46651,0.9979890897422184,21.82824,2521.273456,14.11460409284577,127,8.000000000000001E-4
9,test_20231031_150528,11079715.png,443815,115577,328238,0.7395829343307458,5,7,124136,16143,107993,0.8699571437777921,17.25776711111111,2193.2968,14.719829558750817,127,8.000000000000001E-4
10,test_20231031_150528,11551286.png,271883,347,271536,0.9987237157159513,2,5,40092,49,40043,0.9987778110346204,18.003251555555554,1874.2515253333333,15.402524879051395,127,8.000000000000001E-4
1,test_20231031_150529,10404007.png,502730,18787,483943,0.9626300399816999,4,6,61265,2725,58540,0.9555210968742349,25.948243555555557,3494.5898933333333,12.69684144309177,127,9.000000000000002E-4
2,test_20231031_150529,1254659.png,342646,71622,271024,0.7909737746829089,5,6,80080,10031,70049,0.8747377622377622,21.243162666666667,3283.60104,12.96729976321864,127,9.000000000000002E-4
3,test_20231031_150529,10188041.png,221231,9147,212084,0.9586540765082652,4,5,41731,1291,40440,0.9690637655459969,11.23984711111111,1121.446144,17.633019388786877,127,9.000000000000002E-4
4,test_20231031_150529,10287332.png,216980,12102,204878,0.944225274218822,3,6,22337,1661,20676,0.9256390741818508,9.531660444444444,800.9398453333333,19.09480461289071,127,9.000000000000002E-4
5,test_20231031_150529,11610969.png,368720,23889,344831,0.9352110002169668,4,6,84111,3492,80619,0.9584834326069123,22.703738666666666,3229.710629333333,13.039167480456243,127,9.000000000000002E-4
6,test_20231031_150529,10350842.png,212614,4112,208502,0.9806597872200326,2,5,42529,603,41926,0.9858214394883491,23.584798222222222,3411.2040586666667,12.801726611315217,127,9.000000000000002E-4
7,test_20231031_150529,10863862.png,317432,9872,307560,0.9689004259179919,4,6,66058,1435,64623,0.9782766659602168,26.91376177777778,4100.150074666667,12.002806077074947,127,9.000000000000002E-4
8,test_20231031_150529,11382381.png,312486,707,311779,0.9977374986399391,2,5,46745,94,46651,0.9979890897422184,21.82824,2521.273456,14.11460409284577,127,9.000000000000002E-4
9,test_20231031_150529,11079715.png,443815,115577,328238,0.7395829343307458,6,7,124136,16143,107993,0.8699571437777921,17.25776711111111,2193.2968,14.719829558750817,127,9.000000000000002E-4
10,test_20231031_150529,11551286.png,271883,347,271536,0.9987237157159513,2,6,40092,49,40043,0.9987778110346204,18.003251555555554,1874.2515253333333,15.402524879051395,127,9.000000000000002E-4
1,test_20231031_150530,10404007.png,502730,18534,484196,0.9631332922244544,3,5,61265,2687,58578,0.956141353138007,25.885536,3487.714848,12.705393906287338,128,1.0E-4
2,test_20231031_150530,1254659.png,342646,69592,273054,0.7968982565096339,5,6,80080,9768,70312,0.878021978021978,21.430725333333335,3345.388144,12.88633847428336,128,1.0E-4
3,test_20231031_150530,10188041.png,221231,9309,211922,0.9579218102345513,3,6,41731,1311,40420,0.9685845055234718,10.629137777777778,1035.1340373333333,17.980837715530228,128,1.0E-4
4,test_20231031_150530,10287332.png,216980,12152,204828,0.9439948382339386,3,6,22337,1664,20673,0.9255047678739311,9.449086222222222,786.1254666666666,19.175884953215455,128,1.0E-4
5,test_20231031_150530,11610969.png,368720,24032,344688,0.9348231720546756,3,6,84111,3509,80602,0.9582813187335782,21.529770666666668,2995.306272,13.366391249809656,128,1.0E-4
6,test_20231031_150530,10350842.png,212614,5642,206972,0.9734636477372139,3,6,42529,830,41699,0.9804839051000493,19.393774222222223,2404.812736,14.319990975752292,128,1.0E-4
7,test_20231031_150530,10863862.png,317432,10677,306755,0.966364449708914,3,5,66058,1554,64504,0.9764752187471616,24.58188977777778,3464.000261333333,12.735024447582767,128,1.0E-4
8,test_20231031_150530,11382381.png,312486,917,311569,0.9970654685329903,3,6,46745,126,46619,0.99730452454808,21.089132444444445,2412.4090613333333,14.306294097973675,128,1.0E-4
9,test_20231031_150530,11079715.png,443815,113162,330653,0.7450243907934613,5,6,124136,15824,108312,0.872526905974093,17.42231111111111,2238.1416106666666,14.631927993255129,128,1.0E-4
10,test_20231031_150530,11551286.png,271883,797,271086,0.997068592004649,2,5,40092,116,39976,0.9971066546942033,16.03718577777778,1539.4418613333332,16.257170689141084,128,1.0E-4
1,test_20231031_150531,10404007.png,502730,18534,484196,0.9631332922244544,4,6,61265,2687,58578,0.956141353138007,25.885536,3487.714848,12.705393906287338,128,2.0E-4
2,test_20231031_150531,1254659.png,342646,69592,273054,0.7968982565096339,5,6,80080,9768,70312,0.878021978021978,21.430725333333335,3345.388144,12.88633847428336,128,2.0E-4
3,test_20231031_150531,10188041.png,221231,9309,211922,0.9579218102345513,3,5,41731,1311,40420,0.9685845055234718,10.629137777777778,1035.1340373333333,17.980837715530228,128,2.0E-4
4,test_20231031_150531,10287332.png,216980,11942,205038,0.9449626693704489,2,5,22337,1637,20700,0.9267135246452075,9.578848,812.8562133333334,19.03066631114696,128,2.0E-4
5,test_20231031_150531,11610969.png,368720,24032,344688,0.9348231720546756,3,6,84111,3509,80602,0.9582813187335782,21.529770666666668,2995.306272,13.366391249809656,128,2.0E-4
6,test_20231031_150531,10350842.png,212614,5642,206972,0.9734636477372139,2,6,42529,830,41699,0.9804839051000493,19.393774222222223,2404.812736,14.319990975752292,128,2.0E-4
7,test_20231031_150531,10863862.png,317432,10677,306755,0.966364449708914,3,5,66058,1554,64504,0.9764752187471616,24.58188977777778,3464.000261333333,12.735024447582767,128,2.0E-4
8,test_20231031_150531,11382381.png,312486,787,311699,0.9974814871706252,2,5,46745,107,46638,0.9977109851320997,21.347548444444445,2452.9523093333332,14.233912561978928,128,2.0E-4
9,test_20231031_150531,11079715.png,443815,113162,330653,0.7450243907934613,6,7,124136,15824,108312,0.872526905974093,17.42231111111111,2238.1416106666666,14.631927993255129,128,2.0E-4
10,test_20231031_150531,11551286.png,271883,597,271286,0.9978042025430056,2,6,40092,86,40006,0.997854933652599,17.58564977777778,1815.0887466666666,15.541824966498465,128,2.0E-4
1,test_20231031_150532,10404007.png,502730,18032,484698,0.9641318401527659,3,5,61265,2618,58647,0.9572676079327511,25.992037333333332,3511.230128,12.676210665648235,128,3.0000000000000003E-4
2,test_20231031_150532,1254659.png,342646,69532,273114,0.7970733643468769,4,6,80080,9762,70318,0.8780969030969031,21.44027911111111,3346.4703306666665,12.884933819048644,128,3.0000000000000003E-4
3,test_20231031_150532,10188041.png,221231,9269,211962,0.958102616721888,3,6,41731,1305,40426,0.9687282835302293,10.994965333333333,1087.4147413333333,17.76685144730885,128,3.0000000000000003E-4
4,test_20231031_150532,10287332.png,216980,11942,205038,0.9449626693704489,2,6,22337,1637,20700,0.9267135246452075,9.578848,812.8562133333334,19.03066631114696,128,3.0000000000000003E-4
5,test_20231031_150532,11610969.png,368720,23467,345253,0.9363555001084833,3,5,84111,3427,80684,0.9592562209461307,22.418577777777777,3189.8884373333335,13.093048664934157,128,3.0000000000000003E-4
6,test_20231031_150532,10350842.png,212614,5562,207052,0.9738399164683417,2,5,42529,818,41711,0.9807660655082414,19.46256711111111,2410.5704426666666,14.30960533734045,128,3.0000000000000003E-4
7,test_20231031_150532,10863862.png,317432,10557,306875,0.966742483429522,3,10,66058,1536,64522,0.976747706560901,24.63304711111111,3467.3115253333335,12.730874976784207,128,3.0000000000000003E-4
8,test_20231031_150532,11382381.png,312486,667,311819,0.997865504374596,2,5,46745,89,46656,0.9980960530538026,21.842074666666665,2522.8946186666667,14.11181250456314,128,3.0000000000000003E-4
9,test_20231031_150532,11079715.png,443815,113162,330653,0.7450243907934613,5,6,124136,15824,108312,0.872526905974093,17.42231111111111,2238.1416106666666,14.631927993255129,128,3.0000000000000003E-4
10,test_20231031_150532,11551286.png,271883,267,271616,0.9990179599312939,2,5,40092,37,40055,0.9990771226179787,18.016108444444445,1877.54488,15.394900338849709,128,3.0000000000000003E-4
1,test_20231031_150533,10404007.png,502730,18032,484698,0.9641318401527659,3,6,61265,2618,58647,0.9572676079327511,25.992037333333332,3511.230128,12.676210665648235,128,4.0E-4
2,test_20231031_150533,1254659.png,342646,69532,273114,0.7970733643468769,4,6,80080,9762,70318,0.8780969030969031,21.44027911111111,3346.4703306666665,12.884933819048644,128,4.0E-4
3,test_20231031_150533,10188041.png,221231,9269,211962,0.958102616721888,3,5,41731,1305,40426,0.9687282835302293,10.994965333333333,1087.4147413333333,17.76685144730885,128,4.0E-4
4,test_20231031_150533,10287332.png,216980,11942,205038,0.9449626693704489,3,6,22337,1637,20700,0.9267135246452075,9.578848,812.8562133333334,19.03066631114696,128,4.0E-4
5,test_20231031_150533,11610969.png,368720,23467,345253,0.9363555001084833,4,6,84111,3427,80684,0.9592562209461307,22.418577777777777,3189.8884373333335,13.093048664934157,128,4.0E-4
6,test_20231031_150533,10350842.png,212614,5562,207052,0.9738399164683417,2,5,42529,818,41711,0.9807660655082414,19.46256711111111,2410.5704426666666,14.30960533734045,128,4.0E-4
7,test_20231031_150533,10863862.png,317432,9612,307820,0.969719498979309,3,6,66058,1397,64661,0.9788519180114444,27.040947555555555,4133.234704,11.967902936558898,128,4.0E-4
8,test_20231031_150533,11382381.png,312486,667,311819,0.997865504374596,2,5,46745,89,46656,0.9980960530538026,21.842074666666665,2522.8946186666667,14.11181250456314,128,4.0E-4
9,test_20231031_150533,11079715.png,443815,113162,330653,0.7450243907934613,5,7,124136,15824,108312,0.872526905974093,17.42231111111111,2238.1416106666666,14.631927993255129,128,4.0E-4
10,test_20231031_150533,11551286.png,271883,267,271616,0.9990179599312939,2,15,40092,37,40055,0.9990771226179787,18.016108444444445,1877.54488,15.394900338849709,128,4.0E-4
1,test_20231031_150534,10404007.png,502730,18032,484698,0.9641318401527659,4,6,61265,2618,58647,0.9572676079327511,25.992037333333332,3511.230128,12.676210665648235,128,5.0E-4
2,test_20231031_150534,1254659.png,342646,69532,273114,0.7970733643468769,4,7,80080,9762,70318,0.8780969030969031,21.44027911111111,3346.4703306666665,12.884933819048644,128,5.0E-4
3,test_20231031_150534,10188041.png,221231,9269,211962,0.958102616721888,3,6,41731,1305,40426,0.9687282835302293,10.994965333333333,1087.4147413333333,17.76685144730885,128,5.0E-4
4,test_20231031_150534,10287332.png,216980,11942,205038,0.9449626693704489,2,5,22337,1637,20700,0.9267135246452075,9.578848,812.8562133333334,19.03066631114696,128,5.0E-4
5,test_20231031_150534,11610969.png,368720,23467,345253,0.9363555001084833,4,6,84111,3427,80684,0.9592562209461307,22.418577777777777,3189.8884373333335,13.093048664934157,128,5.0E-4
6,test_20231031_150534,10350842.png,212614,5562,207052,0.9738399164683417,2,6,42529,818,41711,0.9807660655082414,19.46256711111111,2410.5704426666666,14.30960533734045,128,5.0E-4
7,test_20231031_150534,10863862.png,317432,9612,307820,0.969719498979309,3,5,66058,1397,64661,0.9788519180114444,27.040947555555555,4133.234704,11.967902936558898,128,5.0E-4
8,test_20231031_150534,11382381.png,312486,667,311819,0.997865504374596,2,6,46745,89,46656,0.9980960530538026,21.842074666666665,2522.8946186666667,14.11181250456314,128,5.0E-4
9,test_20231031_150534,11079715.png,443815,113162,330653,0.7450243907934613,5,7,124136,15824,108312,0.872526905974093,17.42231111111111,2238.1416106666666,14.631927993255129,128,5.0E-4
10,test_20231031_150534,11551286.png,271883,267,271616,0.9990179599312939,2,6,40092,37,40055,0.9990771226179787,18.016108444444445,1877.54488,15.394900338849709,128,5.0E-4
1,test_20231031_150535,10404007.png,502730,17872,484858,0.964450102440674,4,6,61265,2595,58670,0.9576430261976658,26.03386666666667,3518.705610666667,12.666974273692194,128,6.000000000000001E-4
2,test_20231031_150535,1254659.png,342646,69532,273114,0.7970733643468769,5,6,80080,9762,70318,0.8780969030969031,21.44027911111111,3346.4703306666665,12.884933819048644,128,6.000000000000001E-4
3,test_20231031_150535,10188041.png,221231,9207,212024,0.9583828667772599,3,5,41731,1298,40433,0.9688960245381132,11.120924444444444,1098.1147306666667,17.724326434383556,128,6.000000000000001E-4
4,test_20231031_150535,10287332.png,216980,11942,205038,0.9449626693704489,2,5,22337,1637,20700,0.9267135246452075,9.578848,812.8562133333334,19.03066631114696,128,6.000000000000001E-4
5,test_20231031_150535,11610969.png,368720,23427,345293,0.9364639835105228,3,6,84111,3425,80686,0.9592799990488758,22.796608,3253.0010773333333,13.007961537557941,128,6.000000000000001E-4
6,test_20231031_150535,10350842.png,212614,5562,207052,0.9738399164683417,3,5,42529,818,41711,0.9807660655082414,19.46256711111111,2410.5704426666666,14.30960533734045,128,6.000000000000001E-4
7,test_20231031_150535,10863862.png,317432,9612,307820,0.969719498979309,3,6,66058,1397,64661,0.9788519180114444,27.040947555555555,4133.234704,11.967902936558898,128,6.000000000000001E-4
8,test_20231031_150535,11382381.png,312486,667,311819,0.997865504374596,2,6,46745,89,46656,0.9980960530538026,21.842074666666665,2522.8946186666667,14.11181250456314,128,6.000000000000001E-4
9,test_20231031_150535,11079715.png,443815,113162,330653,0.7450243907934613,5,7,124136,15824,108312,0.872526905974093,17.42231111111111,2238.1416106666666,14.631927993255129,128,6.000000000000001E-4
10,test_20231031_150535,11551286.png,271883,267,271616,0.9990179599312939,2,5,40092,37,40055,0.9990771226179787,18.016108444444445,1877.54488,15.394900338849709,128,6.000000000000001E-4
1,test_20231031_150536,10404007.png,502730,17872,484858,0.964450102440674,4,6,61265,2595,58670,0.9576430261976658,26.03386666666667,3518.705610666667,12.666974273692194,128,7.000000000000001E-4
2,test_20231031_150536,1254659.png,342646,69532,273114,0.7970733643468769,5,6,80080,9762,70318,0.8780969030969031,21.44027911111111,3346.4703306666665,12.884933819048644,128,7.000000000000001E-4
3,test_20231031_150536,10188041.png,221231,9207,212024,0.9583828667772599,3,6,41731,1298,40433,0.9688960245381132,11.120924444444444,1098.1147306666667,17.724326434383556,128,7.000000000000001E-4
4,test_20231031_150536,10287332.png,216980,11942,205038,0.9449626693704489,3,6,22337,1637,20700,0.9267135246452075,9.578848,812.8562133333334,19.03066631114696,128,7.000000000000001E-4
5,test_20231031_150536,11610969.png,368720,23427,345293,0.9364639835105228,3,6,84111,3425,80686,0.9592799990488758,22.796608,3253.0010773333333,13.007961537557941,128,7.000000000000001E-4
6,test_20231031_150536,10350842.png,212614,5562,207052,0.9738399164683417,2,5,42529,818,41711,0.9807660655082414,19.46256711111111,2410.5704426666666,14.30960533734045,128,7.000000000000001E-4
7,test_20231031_150536,10863862.png,317432,9612,307820,0.969719498979309,3,9,66058,1397,64661,0.9788519180114444,27.040947555555555,4133.234704,11.967902936558898,128,7.000000000000001E-4
8,test_20231031_150536,11382381.png,312486,667,311819,0.997865504374596,2,5,46745,89,46656,0.9980960530538026,21.842074666666665,2522.8946186666667,14.11181250456314,128,7.000000000000001E-4
9,test_20231031_150536,11079715.png,443815,113162,330653,0.7450243907934613,5,6,124136,15824,108312,0.872526905974093,17.42231111111111,2238.1416106666666,14.631927993255129,128,7.000000000000001E-4
10,test_20231031_150536,11551286.png,271883,267,271616,0.9990179599312939,2,7,40092,37,40055,0.9990771226179787,18.016108444444445,1877.54488,15.394900338849709,128,7.000000000000001E-4
1,test_20231031_150537,10404007.png,502730,17792,484938,0.9646092335846279,4,5,61265,2583,58682,0.9578388965967518,26.03775288888889,3519.475594666667,12.666024028752677,128,8.000000000000001E-4
2,test_20231031_150537,1254659.png,342646,69532,273114,0.7970733643468769,4,6,80080,9762,70318,0.8780969030969031,21.44027911111111,3346.4703306666665,12.884933819048644,128,8.000000000000001E-4
3,test_20231031_150537,10188041.png,221231,8987,212244,0.9593773024576122,4,6,41731,1268,40463,0.969614914571901,11.263271111111111,1127.1926293333333,17.61082220591244,128,8.000000000000001E-4
4,test_20231031_150537,10287332.png,216980,11942,205038,0.9449626693704489,2,5,22337,1637,20700,0.9267135246452075,9.578848,812.8562133333334,19.03066631114696,128,8.000000000000001E-4
5,test_20231031_150537,11610969.png,368720,23407,345313,0.9365182252115426,4,6,84111,3424,80687,0.9592918881002485,22.902257777777777,3263.1791573333335,12.994394424875402,128,8.000000000000001E-4
6,test_20231031_150537,10350842.png,212614,5522,207092,0.9740280508339055,3,6,42529,812,41717,0.9809071457123375,19.516519111111112,2419.365386666667,14.293788978678773,128,8.000000000000001E-4
7,test_20231031_150537,10863862.png,317432,9509,307923,0.9700439779228307,3,5,66058,1384,64674,0.9790487147658119,27.16096888888889,4153.414896,11.94675044724713,128,8.000000000000001E-4
8,test_20231031_150537,11382381.png,312486,667,311819,0.997865504374596,2,5,46745,89,46656,0.9980960530538026,21.842074666666665,2522.8946186666667,14.11181250456314,128,8.000000000000001E-4
9,test_20231031_150537,11079715.png,443815,112982,330833,0.7454299651881977,5,7,124136,15797,108339,0.8727444093574789,17.65957511111111,2280.1507466666667,14.551168005861816,128,8.000000000000001E-4
10,test_20231031_150537,11551286.png,271883,267,271616,0.9990179599312939,2,6,40092,37,40055,0.9990771226179787,18.016108444444445,1877.54488,15.394900338849709,128,8.000000000000001E-4
1,test_20231031_150538,10404007.png,502730,17792,484938,0.9646092335846279,3,5,61265,2583,58682,0.9578388965967518,26.03775288888889,3519.475594666667,12.666024028752677,128,9.000000000000002E-4
2,test_20231031_150538,1254659.png,342646,69532,273114,0.7970733643468769,4,7,80080,9762,70318,0.8780969030969031,21.44027911111111,3346.4703306666665,12.884933819048644,128,9.000000000000002E-4
3,test_20231031_150538,10188041.png,221231,8987,212244,0.9593773024576122,3,6,41731,1268,40463,0.969614914571901,11.263271111111111,1127.1926293333333,17.61082220591244,128,9.000000000000002E-4
4,test_20231031_150538,10287332.png,216980,11942,205038,0.9449626693704489,3,6,22337,1637,20700,0.9267135246452075,9.578848,812.8562133333334,19.03066631114696,128,9.000000000000002E-4
5,test_20231031_150538,11610969.png,368720,23407,345313,0.9365182252115426,4,6,84111,3424,80687,0.9592918881002485,22.902257777777777,3263.1791573333335,12.994394424875402,128,9.000000000000002E-4
6,test_20231031_150538,10350842.png,212614,3932,208682,0.98150639186507,2,6,42529,576,41953,0.9864563004067812,23.636912,3423.166224,12.786523725061926,128,9.000000000000002E-4
7,test_20231031_150538,10863862.png,317432,9509,307923,0.9700439779228307,3,5,66058,1384,64674,0.9790487147658119,27.16096888888889,4153.414896,11.94675044724713,128,9.000000000000002E-4
8,test_20231031_150538,11382381.png,312486,667,311819,0.997865504374596,2,6,46745,89,46656,0.9980960530538026,21.842074666666665,2522.8946186666667,14.11181250456314,128,9.000000000000002E-4
9,test_20231031_150538,11079715.png,443815,112982,330833,0.7454299651881977,5,6,124136,15797,108339,0.8727444093574789,17.65957511111111,2280.1507466666667,14.551168005861816,128,9.000000000000002E-4
10,test_20231031_150538,11551286.png,271883,267,271616,0.9990179599312939,2,6,40092,37,40055,0.9990771226179787,18.016108444444445,1877.54488,15.394900338849709,128,9.000000000000002E-4
1,test_20231031_150539,10404007.png,502730,17207,485523,0.9657728800747917,3,5,61265,2499,58766,0.9592099893903534,26.117214222222223,3546.187088,12.633187167032132,129,1.0E-4
2,test_20231031_150539,1254659.png,342646,67202,275444,0.8038733853598174,4,16,80080,9440,70640,0.8821178821178821,21.685260444444445,3425.6872266666664,12.78332652540119,129,1.0E-4
3,test_20231031_150539,10188041.png,221231,8907,212324,0.9597389154322857,3,6,41731,1262,40469,0.9697586925786585,10.89088711111111,1117.198944,17.64949844343051,129,1.0E-4
4,test_20231031_150539,10287332.png,216980,11792,205188,0.945653977325099,3,6,22337,1617,20720,0.9276089000313381,9.499649777777778,803.2418826666667,19.082340154783257,129,1.0E-4
5,test_20231031_150539,11610969.png,368720,22372,346348,0.9393252332393144,4,6,84111,3270,80841,0.9611228020116275,22.074186666666666,3125.7853333333333,13.18121211800863,129,1.0E-4
6,test_20231031_150539,10350842.png,212614,5359,207255,0.9747946983735785,2,5,42529,788,41741,0.9814714665287215,19.497994666666667,2427.775552,14.27871827160568,129,1.0E-4
7,test_20231031_150539,10863862.png,317432,7622,309810,0.9759885581793896,3,6,66058,1113,64945,0.9831511701837778,35.65140977777778,6505.424832,9.998046977614175,129,1.0E-4
8,test_20231031_150539,11382381.png,312486,817,311669,0.9973854828696326,2,6,46745,112,46633,0.9976040218205156,21.216531555555555,2458.9940213333334,14.223228880483061,129,1.0E-4
9,test_20231031_150539,11079715.png,443815,110349,333466,0.7513626173067607,6,9,124136,15456,108680,0.8754913965328349,17.57312,2279.878944,14.551685732308561,129,1.0E-4
10,test_20231031_150539,11551286.png,271883,737,271146,0.9972892751661561,2,6,40092,107,39985,0.997331138381722,16.330346666666667,1599.3003733333333,16.09150322243563,129,1.0E-4
1,test_20231031_150540,10404007.png,502730,17207,485523,0.9657728800747917,3,5,61265,2499,58766,0.9592099893903534,26.117214222222223,3546.187088,12.633187167032132,129,2.0E-4
2,test_20231031_150540,1254659.png,342646,67202,275444,0.8038733853598174,5,7,80080,9440,70640,0.8821178821178821,21.685260444444445,3425.6872266666664,12.78332652540119,129,2.0E-4
3,test_20231031_150540,10188041.png,221231,8907,212324,0.9597389154322857,3,5,41731,1262,40469,0.9697586925786585,10.89088711111111,1117.198944,17.64949844343051,129,2.0E-4
4,test_20231031_150540,10287332.png,216980,11579,205401,0.9466356346207023,3,6,22337,1590,20747,0.9288176568026145,9.629411555555556,829.9726293333333,18.940165903297878,129,2.0E-4
5,test_20231031_150540,11610969.png,368720,22372,346348,0.9393252332393144,4,6,84111,3270,80841,0.9611228020116275,22.074186666666666,3125.7853333333333,13.18121211800863,129,2.0E-4
6,test_20231031_150540,10350842.png,212614,5359,207255,0.9747946983735785,2,18,42529,788,41741,0.9814714665287215,19.497994666666667,2427.775552,14.27871827160568,129,2.0E-4
7,test_20231031_150540,10863862.png,317432,7622,309810,0.9759885581793896,3,6,66058,1113,64945,0.9831511701837778,35.65140977777778,6505.424832,9.998046977614175,129,2.0E-4
8,test_20231031_150540,11382381.png,312486,707,311779,0.9977374986399391,2,5,46745,96,46649,0.9979463044175848,21.47300977777778,2499.126186666667,14.152921756540431,129,2.0E-4
9,test_20231031_150540,11079715.png,443815,110349,333466,0.7513626173067607,5,7,124136,15456,108680,0.8754913965328349,17.57312,2279.878944,14.551685732308561,129,2.0E-4
10,test_20231031_150540,11551286.png,271883,597,271286,0.9978042025430056,2,5,40092,86,40006,0.997854933652599,17.58564977777778,1815.0887466666666,15.541824966498465,129,2.0E-4
1,test_20231031_150541,10404007.png,502730,17007,485723,0.9661707079346766,4,6,61265,2473,58792,0.9596343752550396,26.13115911111111,3549.4145653333335,12.629236337316815,129,3.0000000000000003E-4
2,test_20231031_150541,1254659.png,342646,67139,275507,0.8040572485889227,5,6,80080,9434,70646,0.8821928071928072,21.694814222222224,3426.7694133333334,12.781954790485319,129,3.0000000000000003E-4
3,test_20231031_150541,10188041.png,221231,8867,212364,0.9599197219196225,3,6,41731,1256,40475,0.9699024705854161,11.256714666666667,1169.479648,17.450876925151316,129,3.0000000000000003E-4
4,test_20231031_150541,10287332.png,216980,11579,205401,0.9466356346207023,3,6,22337,1590,20747,0.9288176568026145,9.629411555555556,829.9726293333333,18.940165903297878,129,3.0000000000000003E-4
5,test_20231031_150541,11610969.png,368720,21849,346871,0.9407436537209807,4,6,84111,3194,80917,0.9620263699159444,22.960643555555556,3319.495392,12.920082907559944,129,3.0000000000000003E-4
6,test_20231031_150541,10350842.png,212614,5279,207335,0.9751709671047062,3,5,42529,776,41753,0.9817536269369136,19.566787555555557,2433.533258666667,14.268430748223048,129,3.0000000000000003E-4
7,test_20231031_150541,10863862.png,317432,7562,309870,0.9761775750396935,2,6,66058,1104,64954,0.9832874140906476,35.66071822222222,6506.869162666667,9.99708286653367,129,3.0000000000000003E-4
8,test_20231031_150541,11382381.png,312486,587,311899,0.9981215158439098,2,5,46745,78,46667,0.9983313723392876,21.967536,2569.068496,14.03304677372966,129,3.0000000000000003E-4
9,test_20231031_150541,11079715.png,443815,110349,333466,0.7513626173067607,6,7,124136,15456,108680,0.8754913965328349,17.57312,2279.878944,14.551685732308561,129,3.0000000000000003E-4
10,test_20231031_150541,11551286.png,271883,267,271616,0.9990179599312939,4,6,40092,37,40055,0.9990771226179787,18.016108444444445,1877.54488,15.394900338849709,129,3.0000000000000003E-4
1,test_20231031_150542,10404007.png,502730,17007,485723,0.9661707079346766,4,6,61265,2473,58792,0.9596343752550396,26.13115911111111,3549.4145653333335,12.629236337316815,129,4.0E-4
2,test_20231031_150542,1254659.png,342646,67139,275507,0.8040572485889227,4,7,80080,9434,70646,0.8821928071928072,21.694814222222224,3426.7694133333334,12.781954790485319,129,4.0E-4
3,test_20231031_150542,10188041.png,221231,8867,212364,0.9599197219196225,3,6,41731,1256,40475,0.9699024705854161,11.256714666666667,1169.479648,17.450876925151316,129,4.0E-4
4,test_20231031_150542,10287332.png,216980,11579,205401,0.9466356346207023,3,6,22337,1590,20747,0.9288176568026145,9.629411555555556,829.9726293333333,18.940165903297878,129,4.0E-4
5,test_20231031_150542,11610969.png,368720,21849,346871,0.9407436537209807,4,6,84111,3194,80917,0.9620263699159444,22.960643555555556,3319.495392,12.920082907559944,129,4.0E-4
6,test_20231031_150542,10350842.png,212614,5279,207335,0.9751709671047062,2,6,42529,776,41753,0.9817536269369136,19.566787555555557,2433.533258666667,14.268430748223048,129,4.0E-4
7,test_20231031_150542,10863862.png,317432,7562,309870,0.9761775750396935,2,6,66058,1104,64954,0.9832874140906476,35.66071822222222,6506.869162666667,9.99708286653367,129,4.0E-4
8,test_20231031_150542,11382381.png,312486,587,311899,0.9981215158439098,3,5,46745,78,46667,0.9983313723392876,21.967536,2569.068496,14.03304677372966,129,4.0E-4
9,test_20231031_150542,11079715.png,443815,110349,333466,0.7513626173067607,5,7,124136,15456,108680,0.8754913965328349,17.57312,2279.878944,14.551685732308561,129,4.0E-4
10,test_20231031_150542,11551286.png,271883,267,271616,0.9990179599312939,2,5,40092,37,40055,0.9990771226179787,18.016108444444445,1877.54488,15.394900338849709,129,4.0E-4
1,test_20231031_150543,10404007.png,502730,16847,485883,0.9664889702225847,3,5,61265,2450,58815,0.9600097935199543,26.172988444444446,3556.890048,12.62009920558409,129,5.0E-4
2,test_20231031_150543,1254659.png,342646,67139,275507,0.8040572485889227,4,6,80080,9434,70646,0.8821928071928072,21.694814222222224,3426.7694133333334,12.781954790485319,129,5.0E-4
3,test_20231031_150543,10188041.png,221231,8867,212364,0.9599197219196225,3,6,41731,1256,40475,0.9699024705854161,11.256714666666667,1169.479648,17.450876925151316,129,5.0E-4
4,test_20231031_150543,10287332.png,216980,11579,205401,0.9466356346207023,2,5,22337,1590,20747,0.9288176568026145,9.629411555555556,829.9726293333333,18.940165903297878,129,5.0E-4
5,test_20231031_150543,11610969.png,368720,21849,346871,0.9407436537209807,3,6,84111,3194,80917,0.9620263699159444,22.960643555555556,3319.495392,12.920082907559944,129,5.0E-4
6,test_20231031_150543,10350842.png,212614,5279,207335,0.9751709671047062,2,5,42529,776,41753,0.9817536269369136,19.566787555555557,2433.533258666667,14.268430748223048,129,5.0E-4
7,test_20231031_150543,10863862.png,317432,7562,309870,0.9761775750396935,3,6,66058,1104,64954,0.9832874140906476,35.66071822222222,6506.869162666667,9.99708286653367,129,5.0E-4
8,test_20231031_150543,11382381.png,312486,587,311899,0.9981215158439098,2,5,46745,78,46667,0.9983313723392876,21.967536,2569.068496,14.03304677372966,129,5.0E-4
9,test_20231031_150543,11079715.png,443815,110349,333466,0.7513626173067607,5,6,124136,15456,108680,0.8754913965328349,17.57312,2279.878944,14.551685732308561,129,5.0E-4
10,test_20231031_150543,11551286.png,271883,267,271616,0.9990179599312939,2,6,40092,37,40055,0.9990771226179787,18.016108444444445,1877.54488,15.394900338849709,129,5.0E-4
1,test_20231031_150544,10404007.png,502730,16847,485883,0.9664889702225847,3,6,61265,2450,58815,0.9600097935199543,26.172988444444446,3556.890048,12.62009920558409,129,6.000000000000001E-4
2,test_20231031_150544,1254659.png,342646,67139,275507,0.8040572485889227,5,6,80080,9434,70646,0.8821928071928072,21.694814222222224,3426.7694133333334,12.781954790485319,129,6.000000000000001E-4
3,test_20231031_150544,10188041.png,221231,8687,212544,0.9607333511126379,3,5,41731,1231,40500,0.9705015456135726,11.477532444444444,1204.0505066666667,17.324356560835014,129,6.000000000000001E-4
4,test_20231031_150544,10287332.png,216980,11579,205401,0.9466356346207023,3,6,22337,1590,20747,0.9288176568026145,9.629411555555556,829.9726293333333,18.940165903297878,129,6.000000000000001E-4
5,test_20231031_150544,11610969.png,368720,21809,346911,0.9408521371230202,3,5,84111,3190,80921,0.9620739261214347,23.338673777777778,3382.608032,12.838286851023904,129,6.000000000000001E-4
6,test_20231031_150544,10350842.png,212614,5279,207335,0.9751709671047062,3,6,42529,776,41753,0.9817536269369136,19.566787555555557,2433.533258666667,14.268430748223048,129,6.000000000000001E-4
7,test_20231031_150544,10863862.png,317432,7459,309973,0.9765020539832153,2,6,66058,1091,64967,0.983484210845015,35.780739555555556,6527.049354666667,9.983634642163107,129,6.000000000000001E-4
8,test_20231031_150544,11382381.png,312486,567,311919,0.9981855187112383,2,5,46745,75,46670,0.9983955503262381,22.72423288888889,2714.741744,13.793518398308729,129,6.000000000000001E-4
9,test_20231031_150544,11079715.png,443815,110169,333646,0.7517681917014972,5,12,124136,15429,108707,0.8757088999162209,17.810384,2321.88808,14.47239078889067,129,6.000000000000001E-4
10,test_20231031_150544,11551286.png,271883,267,271616,0.9990179599312939,2,6,40092,37,40055,0.9990771226179787,18.016108444444445,1877.54488,15.394900338849709,129,6.000000000000001E-4
1,test_20231031_150545,10404007.png,502730,16847,485883,0.9664889702225847,4,6,61265,2450,58815,0.9600097935199543,26.172988444444446,3556.890048,12.62009920558409,129,7.000000000000001E-4
2,test_20231031_150545,1254659.png,342646,67139,275507,0.8040572485889227,4,6,80080,9434,70646,0.8821928071928072,21.694814222222224,3426.7694133333334,12.781954790485319,129,7.000000000000001E-4
3,test_20231031_150545,10188041.png,221231,8687,212544,0.9607333511126379,3,15,41731,1231,40500,0.9705015456135726,11.477532444444444,1204.0505066666667,17.324356560835014,129,7.000000000000001E-4
4,test_20231031_150545,10287332.png,216980,11579,205401,0.9466356346207023,3,6,22337,1590,20747,0.9288176568026145,9.629411555555556,829.9726293333333,18.940165903297878,129,7.000000000000001E-4
5,test_20231031_150545,11610969.png,368720,21809,346911,0.9408521371230202,3,5,84111,3190,80921,0.9620739261214347,23.338673777777778,3382.608032,12.838286851023904,129,7.000000000000001E-4
6,test_20231031_150545,10350842.png,212614,5279,207335,0.9751709671047062,3,6,42529,776,41753,0.9817536269369136,19.566787555555557,2433.533258666667,14.268430748223048,129,7.000000000000001E-4
7,test_20231031_150545,10863862.png,317432,7459,309973,0.9765020539832153,3,13,66058,1091,64967,0.983484210845015,35.780739555555556,6527.049354666667,9.983634642163107,129,7.000000000000001E-4
8,test_20231031_150545,11382381.png,312486,567,311919,0.9981855187112383,2,5,46745,75,46670,0.9983955503262381,22.72423288888889,2714.741744,13.793518398308729,129,7.000000000000001E-4
9,test_20231031_150545,11079715.png,443815,110169,333646,0.7517681917014972,5,7,124136,15429,108707,0.8757088999162209,17.810384,2321.88808,14.47239078889067,129,7.000000000000001E-4
10,test_20231031_150545,11551286.png,271883,267,271616,0.9990179599312939,2,6,40092,37,40055,0.9990771226179787,18.016108444444445,1877.54488,15.394900338849709,129,7.000000000000001E-4
1,test_20231031_150546,10404007.png,502730,16787,485943,0.9666083185805502,4,6,61265,2441,58824,0.9601566963192687,26.176508444444444,3557.550464,12.61929291582764,129,8.000000000000001E-4
2,test_20231031_150546,1254659.png,342646,67139,275507,0.8040572485889227,5,6,80080,9434,70646,0.8821928071928072,21.694814222222224,3426.7694133333334,12.781954790485319,129,8.000000000000001E-4
3,test_20231031_150546,10188041.png,221231,8607,212624,0.9610949640873114,3,6,41731,1221,40510,0.9707411756248353,11.516433777777777,1208.135008,17.30964891853339,129,8.000000000000001E-4
4,test_20231031_150546,10287332.png,216980,11579,205401,0.9466356346207023,2,6,22337,1590,20747,0.9288176568026145,9.629411555555556,829.9726293333333,18.940165903297878,129,8.000000000000001E-4
5,test_20231031_150546,11610969.png,368720,21789,346931,0.9409063788240399,4,14,84111,3189,80922,0.9620858151728073,23.444323555555556,3392.786112,12.825238791497249,129,8.000000000000001E-4
6,test_20231031_150546,10350842.png,212614,4254,208360,0.9799919102222807,3,6,42529,624,41905,0.9853276587740131,23.09414577777778,3256.7716213333333,13.002930558100143,129,8.000000000000001E-4
7,test_20231031_150546,10863862.png,317432,7459,309973,0.9765020539832153,3,5,66058,1091,64967,0.983484210845015,35.780739555555556,6527.049354666667,9.983634642163107,129,8.000000000000001E-4
8,test_20231031_150546,11382381.png,312486,567,311919,0.9981855187112383,2,5,46745,75,46670,0.9983955503262381,22.72423288888889,2714.741744,13.793518398308729,129,8.000000000000001E-4
9,test_20231031_150546,11079715.png,443815,110169,333646,0.7517681917014972,5,6,124136,15429,108707,0.8757088999162209,17.810384,2321.88808,14.47239078889067,129,8.000000000000001E-4
10,test_20231031_150546,11551286.png,271883,267,271616,0.9990179599312939,3,6,40092,37,40055,0.9990771226179787,18.016108444444445,1877.54488,15.394900338849709,129,8.000000000000001E-4
1,test_20231031_150547,10404007.png,502730,16787,485943,0.9666083185805502,3,6,61265,2441,58824,0.9601566963192687,26.176508444444444,3557.550464,12.61929291582764,129,9.000000000000002E-4
2,test_20231031_150547,1254659.png,342646,67139,275507,0.8040572485889227,4,6,80080,9434,70646,0.8821928071928072,21.694814222222224,3426.7694133333334,12.781954790485319,129,9.000000000000002E-4
3,test_20231031_150547,10188041.png,221231,8607,212624,0.9610949640873114,3,6,41731,1221,40510,0.9707411756248353,11.516433777777777,1208.135008,17.30964891853339,129,9.000000000000002E-4
4,test_20231031_150547,10287332.png,216980,11579,205401,0.9466356346207023,2,7,22337,1590,20747,0.9288176568026145,9.629411555555556,829.9726293333333,18.940165903297878,129,9.000000000000002E-4
5,test_20231031_150547,11610969.png,368720,21789,346931,0.9409063788240399,4,7,84111,3189,80922,0.9620858151728073,23.444323555555556,3392.786112,12.825238791497249,129,9.000000000000002E-4
6,test_20231031_150547,10350842.png,212614,3732,208882,0.9824470636928895,2,6,42529,546,41983,0.9871617014272615,24.194565333333333,3524.7187893333335,12.659558872319822,129,9.000000000000002E-4
7,test_20231031_150547,10863862.png,317432,7459,309973,0.9765020539832153,3,6,66058,1091,64967,0.983484210845015,35.780739555555556,6527.049354666667,9.983634642163107,129,9.000000000000002E-4
8,test_20231031_150547,11382381.png,312486,567,311919,0.9981855187112383,2,5,46745,75,46670,0.9983955503262381,22.72423288888889,2714.741744,13.793518398308729,129,9.000000000000002E-4
9,test_20231031_150547,11079715.png,443815,110169,333646,0.7517681917014972,5,7,124136,15429,108707,0.8757088999162209,17.810384,2321.88808,14.47239078889067,129,9.000000000000002E-4
10,test_20231031_150547,11551286.png,271883,267,271616,0.9990179599312939,3,6,40092,37,40055,0.9990771226179787,18.016108444444445,1877.54488,15.394900338849709,129,9.000000000000002E-4
1,test_20231031_150548,10404007.png,502730,16402,486328,0.9673741372108289,3,5,61265,2384,58881,0.961087080714927,26.161904,3559.777616,12.61657492996368,130,1.0E-4
2,test_20231031_150548,1254659.png,342646,65252,277394,0.8095643900702183,5,6,80080,9171,70909,0.885477022977023,21.881578666666666,3492.428917333333,12.699527853441253,130,1.0E-4
3,test_20231031_150548,10188041.png,221231,8404,212827,0.9620125570105456,4,6,41731,1193,40538,0.9714121396563705,11.447850666666668,1280.5076586666667,17.056981805572335,130,1.0E-4
4,test_20231031_150548,10287332.png,216980,11449,205531,0.9472347681813992,3,6,22337,1574,20763,0.929533957111519,9.561258666666667,823.894464,18.97208776158452,130,1.0E-4
5,test_20231031_150548,11610969.png,368720,21407,347313,0.9419423953135171,4,6,84111,3130,80981,0.9627872692037902,22.610574222222223,3255.403008,13.004756004317752,130,1.0E-4
6,test_20231031_150548,10350842.png,212614,4817,207797,0.977343919026969,3,5,42529,707,41822,0.983376049284018,19.67007111111111,2460.5717813333335,14.22044321803745,130,1.0E-4
7,test_20231031_150548,10863862.png,317432,7439,309993,0.9765650596033166,3,6,66058,1092,64966,0.9834690726331405,35.67820088888889,6511.628522666667,9.993907440417022,130,1.0E-4
8,test_20231031_150548,11382381.png,312486,817,311669,0.9973854828696326,2,5,46745,112,46633,0.9976040218205156,21.216531555555555,2458.9940213333334,14.223228880483061,130,1.0E-4
9,test_20231031_150548,11079715.png,443815,107837,335978,0.7570226333044174,7,6,124136,15131,109005,0.8781094928143327,17.708771555555554,2317.625856,14.480370335498858,130,1.0E-4
10,test_20231031_150548,11551286.png,271883,657,271226,0.9975835193814987,3,6,40092,95,39997,0.9976304499650803,17.08696,1727.1593013333334,15.75747965107392,130,1.0E-4
1,test_20231031_150550,10404007.png,502730,16402,486328,0.9673741372108289,3,5,61265,2384,58881,0.961087080714927,26.161904,3559.777616,12.61657492996368,130,2.0E-4
2,test_20231031_150550,1254659.png,342646,65252,277394,0.8095643900702183,4,6,80080,9171,70909,0.885477022977023,21.881578666666666,3492.428917333333,12.699527853441253,130,2.0E-4
3,test_20231031_150550,10188041.png,221231,8404,212827,0.9620125570105456,3,5,41731,1193,40538,0.9714121396563705,11.447850666666668,1280.5076586666667,17.056981805572335,130,2.0E-4
4,test_20231031_150550,10287332.png,216980,11257,205723,0.9481196423633514,2,5,22337,1550,20787,0.9306084075748757,9.689633777777777,850.2091146666667,18.835546043579313,130,2.0E-4
5,test_20231031_150550,11610969.png,368720,21407,347313,0.9419423953135171,4,6,84111,3130,80981,0.9627872692037902,22.610574222222223,3255.403008,13.004756004317752,130,2.0E-4
6,test_20231031_150550,10350842.png,212614,4817,207797,0.977343919026969,2,5,42529,707,41822,0.983376049284018,19.67007111111111,2460.5717813333335,14.22044321803745,130,2.0E-4
7,test_20231031_150550,10863862.png,317432,7439,309993,0.9765650596033166,2,5,66058,1092,64966,0.9834690726331405,35.67820088888889,6511.628522666667,9.993907440417022,130,2.0E-4
8,test_20231031_150550,11382381.png,312486,707,311779,0.9977374986399391,3,6,46745,96,46649,0.9979463044175848,21.47300977777778,2499.126186666667,14.152921756540431,130,2.0E-4
9,test_20231031_150550,11079715.png,443815,107837,335978,0.7570226333044174,6,7,124136,15131,109005,0.8781094928143327,17.708771555555554,2317.625856,14.480370335498858,130,2.0E-4
10,test_20231031_150550,11551286.png,271883,267,271616,0.9990179599312939,2,6,40092,37,40055,0.9990771226179787,17.919265777777778,1867.1754613333333,15.418952296845859,130,2.0E-4
1,test_20231031_150551,10404007.png,502730,16282,486448,0.9676128339267599,4,6,61265,2367,58898,0.9613645637802987,26.166622222222223,3560.861381333333,12.615252932576213,130,3.0000000000000003E-4
2,test_20231031_150551,1254659.png,342646,65192,277454,0.8097394979074614,4,6,80080,9165,70915,0.885551948051948,21.891132444444445,3493.511104,12.698182328858888,130,3.0000000000000003E-4
3,test_20231031_150551,10188041.png,221231,8364,212867,0.9621933634978823,3,6,41731,1187,40544,0.9715559176631281,11.813678222222222,1332.7883626666667,16.88319168860807,130,3.0000000000000003E-4
4,test_20231031_150551,10287332.png,216980,11257,205723,0.9481196423633514,2,5,22337,1550,20787,0.9306084075748757,9.689633777777777,850.2091146666667,18.835546043579313,130,3.0000000000000003E-4
5,test_20231031_150551,11610969.png,368720,21127,347593,0.9427017791277934,4,6,84111,3090,81021,0.9632628312586938,23.026140444444444,3340.5999893333333,12.892558854769415,130,3.0000000000000003E-4
6,test_20231031_150551,10350842.png,212614,4817,207797,0.977343919026969,2,6,42529,707,41822,0.983376049284018,19.67007111111111,2460.5717813333335,14.22044321803745,130,3.0000000000000003E-4
7,test_20231031_150551,10863862.png,317432,7399,310033,0.9766910708435192,2,6,66058,1086,64972,0.983559901904387,35.68389688888889,6512.697578666666,9.993194489713737,130,3.0000000000000003E-4
8,test_20231031_150551,11382381.png,312486,587,311899,0.9981215158439098,2,5,46745,78,46667,0.9983313723392876,21.967536,2569.068496,14.03304677372966,130,3.0000000000000003E-4
9,test_20231031_150551,11079715.png,443815,107837,335978,0.7570226333044174,5,7,124136,15131,109005,0.8781094928143327,17.708771555555554,2317.625856,14.480370335498858,130,3.0000000000000003E-4
10,test_20231031_150551,11551286.png,271883,204,271679,0.9992496772508763,2,5,40092,28,40064,0.9993016063054974,18.067507555555554,1885.468496,15.37661080624634,130,3.0000000000000003E-4
1,test_20231031_150552,10404007.png,502730,16122,486608,0.9679310962146679,5,6,61265,2344,58921,0.9617399820452134,26.208451555555556,3568.336864,12.606145142471787,130,4.0E-4
2,test_20231031_150552,1254659.png,342646,65192,277454,0.8097394979074614,4,6,80080,9165,70915,0.885551948051948,21.891132444444445,3493.511104,12.698182328858888,130,4.0E-4
3,test_20231031_150552,10188041.png,221231,8364,212867,0.9621933634978823,3,5,41731,1187,40544,0.9715559176631281,11.813678222222222,1332.7883626666667,16.88319168860807,130,4.0E-4
4,test_20231031_150552,10287332.png,216980,11257,205723,0.9481196423633514,2,5,22337,1550,20787,0.9306084075748757,9.689633777777777,850.2091146666667,18.835546043579313,130,4.0E-4
5,test_20231031_150552,11610969.png,368720,21127,347593,0.9427017791277934,3,6,84111,3090,81021,0.9632628312586938,23.026140444444444,3340.5999893333333,12.892558854769415,130,4.0E-4
6,test_20231031_150552,10350842.png,212614,4817,207797,0.977343919026969,3,6,42529,707,41822,0.983376049284018,19.67007111111111,2460.5717813333335,14.22044321803745,130,4.0E-4
7,test_20231031_150552,10863862.png,317432,7399,310033,0.9766910708435192,2,5,66058,1086,64972,0.983559901904387,35.68389688888889,6512.697578666666,9.993194489713737,130,4.0E-4
8,test_20231031_150552,11382381.png,312486,587,311899,0.9981215158439098,2,5,46745,78,46667,0.9983313723392876,21.967536,2569.068496,14.03304677372966,130,4.0E-4
9,test_20231031_150552,11079715.png,443815,107837,335978,0.7570226333044174,5,7,124136,15131,109005,0.8781094928143327,17.708771555555554,2317.625856,14.480370335498858,130,4.0E-4
10,test_20231031_150552,11551286.png,271883,204,271679,0.9992496772508763,2,5,40092,28,40064,0.9993016063054974,18.067507555555554,1885.468496,15.37661080624634,130,4.0E-4
1,test_20231031_150553,10404007.png,502730,16122,486608,0.9679310962146679,3,6,61265,2344,58921,0.9617399820452134,26.208451555555556,3568.336864,12.606145142471787,130,5.0E-4
2,test_20231031_150553,1254659.png,342646,65192,277454,0.8097394979074614,4,6,80080,9165,70915,0.885551948051948,21.891132444444445,3493.511104,12.698182328858888,130,5.0E-4
3,test_20231031_150553,10188041.png,221231,8364,212867,0.9621933634978823,3,6,41731,1187,40544,0.9715559176631281,11.813678222222222,1332.7883626666667,16.88319168860807,130,5.0E-4
4,test_20231031_150553,10287332.png,216980,11257,205723,0.9481196423633514,3,6,22337,1550,20787,0.9306084075748757,9.689633777777777,850.2091146666667,18.835546043579313,130,5.0E-4
5,test_20231031_150553,11610969.png,368720,21127,347593,0.9427017791277934,4,6,84111,3090,81021,0.9632628312586938,23.026140444444444,3340.5999893333333,12.892558854769415,130,5.0E-4
6,test_20231031_150553,10350842.png,212614,4817,207797,0.977343919026969,2,8,42529,707,41822,0.983376049284018,19.67007111111111,2460.5717813333335,14.22044321803745,130,5.0E-4
7,test_20231031_150553,10863862.png,317432,7399,310033,0.9766910708435192,3,6,66058,1086,64972,0.983559901904387,35.68389688888889,6512.697578666666,9.993194489713737,130,5.0E-4
8,test_20231031_150553,11382381.png,312486,567,311919,0.9981855187112383,2,5,46745,75,46670,0.9983955503262381,22.72423288888889,2714.741744,13.793518398308729,130,5.0E-4
9,test_20231031_150553,11079715.png,443815,107837,335978,0.7570226333044174,6,7,124136,15131,109005,0.8781094928143327,17.708771555555554,2317.625856,14.480370335498858,130,5.0E-4
10,test_20231031_150553,11551286.png,271883,204,271679,0.9992496772508763,2,6,40092,28,40064,0.9993016063054974,18.067507555555554,1885.468496,15.37661080624634,130,5.0E-4
1,test_20231031_150554,10404007.png,502730,16122,486608,0.9679310962146679,4,6,61265,2344,58921,0.9617399820452134,26.208451555555556,3568.336864,12.606145142471787,130,6.000000000000001E-4
2,test_20231031_150554,1254659.png,342646,65192,277454,0.8097394979074614,5,6,80080,9165,70915,0.885551948051948,21.891132444444445,3493.511104,12.698182328858888,130,6.000000000000001E-4
3,test_20231031_150554,10188041.png,221231,8202,213029,0.9629256297715962,3,5,41731,1165,40566,0.9720831036879058,12.03271111111111,1366.8562453333334,16.7735751941011,130,6.000000000000001E-4
4,test_20231031_150554,10287332.png,216980,11257,205723,0.9481196423633514,2,5,22337,1550,20787,0.9306084075748757,9.689633777777777,850.2091146666667,18.835546043579313,130,6.000000000000001E-4
5,test_20231031_150554,11610969.png,368720,21087,347633,0.9428102625298329,4,6,84111,3086,81025,0.9633103874641842,23.404170666666666,3403.7126293333336,12.811274747794313,130,6.000000000000001E-4
6,test_20231031_150554,10350842.png,212614,4737,207877,0.9777201877580969,3,8,42529,695,41834,0.9836582096922101,19.730252444444446,2470.973925333333,14.202121982839607,130,6.000000000000001E-4
7,test_20231031_150554,10863862.png,317432,7319,310113,0.9769430933239245,2,5,66058,1074,64984,0.98374156044688,35.801813333333335,6532.50336,9.980007190886644,130,6.000000000000001E-4
8,test_20231031_150554,11382381.png,312486,567,311919,0.9981855187112383,3,7,46745,75,46670,0.9983955503262381,22.72423288888889,2714.741744,13.793518398308729,130,6.000000000000001E-4
9,test_20231031_150554,11079715.png,443815,107657,336158,0.7574282076991539,7,7,124136,15104,109032,0.8783269961977186,17.946035555555557,2359.634992,14.402355329911469,130,6.000000000000001E-4
10,test_20231031_150554,11551286.png,271883,164,271719,0.9993967993585476,2,5,40092,22,40070,0.9994512620971765,18.120286222222223,1899.5769013333334,15.344234809036362,130,6.000000000000001E-4
1,test_20231031_150555,10404007.png,502730,16122,486608,0.9679310962146679,4,5,61265,2344,58921,0.9617399820452134,26.208451555555556,3568.336864,12.606145142471787,130,7.000000000000001E-4
2,test_20231031_150555,1254659.png,342646,65192,277454,0.8097394979074614,4,6,80080,9165,70915,0.885551948051948,21.891132444444445,3493.511104,12.698182328858888,130,7.000000000000001E-4
3,test_20231031_150555,10188041.png,221231,8122,213109,0.9632872427462698,3,6,41731,1155,40576,0.9723227336991684,12.071612444444444,1370.9407466666667,16.760616762839437,130,7.000000000000001E-4
4,test_20231031_150555,10287332.png,216980,11257,205723,0.9481196423633514,3,6,22337,1550,20787,0.9306084075748757,9.689633777777777,850.2091146666667,18.835546043579313,130,7.000000000000001E-4
5,test_20231031_150555,11610969.png,368720,21087,347633,0.9428102625298329,4,6,84111,3086,81025,0.9633103874641842,23.404170666666666,3403.7126293333336,12.811274747794313,130,7.000000000000001E-4
6,test_20231031_150555,10350842.png,212614,4737,207877,0.9777201877580969,3,5,42529,695,41834,0.9836582096922101,19.730252444444446,2470.973925333333,14.202121982839607,130,7.000000000000001E-4
7,test_20231031_150555,10863862.png,317432,7319,310113,0.9769430933239245,2,5,66058,1074,64984,0.98374156044688,35.801813333333335,6532.50336,9.980007190886644,130,7.000000000000001E-4
8,test_20231031_150555,11382381.png,312486,567,311919,0.9981855187112383,3,5,46745,75,46670,0.9983955503262381,22.72423288888889,2714.741744,13.793518398308729,130,7.000000000000001E-4
9,test_20231031_150555,11079715.png,443815,107657,336158,0.7574282076991539,5,6,124136,15104,109032,0.8783269961977186,17.946035555555557,2359.634992,14.402355329911469,130,7.000000000000001E-4
10,test_20231031_150555,11551286.png,271883,164,271719,0.9993967993585476,2,6,40092,22,40070,0.9994512620971765,18.120286222222223,1899.5769013333334,15.344234809036362,130,7.000000000000001E-4
1,test_20231031_150556,10404007.png,502730,16062,486668,0.9680504445726335,3,5,61265,2335,58930,0.9618868848445279,26.211971555555557,3568.99728,12.605341438961224,130,8.000000000000001E-4
2,test_20231031_150556,1254659.png,342646,65192,277454,0.8097394979074614,4,6,80080,9165,70915,0.885551948051948,21.891132444444445,3493.511104,12.698182328858888,130,8.000000000000001E-4
3,test_20231031_150556,10188041.png,221231,8122,213109,0.9632872427462698,3,5,41731,1155,40576,0.9723227336991684,12.071612444444444,1370.9407466666667,16.760616762839437,130,8.000000000000001E-4
4,test_20231031_150556,10287332.png,216980,11257,205723,0.9481196423633514,2,5,22337,1550,20787,0.9306084075748757,9.689633777777777,850.2091146666667,18.835546043579313,130,8.000000000000001E-4
5,test_20231031_150556,11610969.png,368720,21067,347653,0.9428645042308527,4,6,84111,3085,81026,0.9633222765155568,23.509820444444443,3413.8907093333332,12.798307471627746,130,8.000000000000001E-4
6,test_20231031_150556,10350842.png,212614,3732,208882,0.9824470636928895,2,5,42529,546,41983,0.9871617014272615,23.254716444444444,3293.3420266666667,12.954435246046875,130,8.000000000000001E-4
7,test_20231031_150556,10863862.png,317432,7077,310355,0.9777054613271504,3,6,66058,1039,65019,0.9842713978624845,36.419152,6690.678650666667,9.87610189394349,130,8.000000000000001E-4
8,test_20231031_150556,11382381.png,312486,567,311919,0.9981855187112383,2,5,46745,75,46670,0.9983955503262381,22.72423288888889,2714.741744,13.793518398308729,130,8.000000000000001E-4
9,test_20231031_150556,11079715.png,443815,107637,336178,0.7574732715207914,5,9,124136,15102,109034,0.8783431075594509,17.963148444444446,2364.288805333333,14.393798349777816,130,8.000000000000001E-4
10,test_20231031_150556,11551286.png,271883,164,271719,0.9993967993585476,1,5,40092,22,40070,0.9994512620971765,18.120286222222223,1899.5769013333334,15.344234809036362,130,8.000000000000001E-4
1,test_20231031_150557,10404007.png,502730,16062,486668,0.9680504445726335,4,6,61265,2335,58930,0.9618868848445279,26.211971555555557,3568.99728,12.605341438961224,130,9.000000000000002E-4
2,test_20231031_150557,1254659.png,342646,65192,277454,0.8097394979074614,4,6,80080,9165,70915,0.885551948051948,21.891132444444445,3493.511104,12.698182328858888,130,9.000000000000002E-4
3,test_20231031_150557,10188041.png,221231,8122,213109,0.9632872427462698,3,5,41731,1155,40576,0.9723227336991684,12.071612444444444,1370.9407466666667,16.760616762839437,130,9.000000000000002E-4
4,test_20231031_150557,10287332.png,216980,11257,205723,0.9481196423633514,2,5,22337,1550,20787,0.9306084075748757,9.689633777777777,850.2091146666667,18.835546043579313,130,9.000000000000002E-4
5,test_20231031_150557,11610969.png,368720,21067,347653,0.9428645042308527,4,6,84111,3085,81026,0.9633222765155568,23.509820444444443,3413.8907093333332,12.798307471627746,130,9.000000000000002E-4
6,test_20231031_150557,10350842.png,212614,3269,209345,0.9846247189742915,2,5,42529,477,42052,0.9887841237743658,24.34659911111111,3559.0051413333335,12.617517454824732,130,9.000000000000002E-4
7,test_20231031_150557,10863862.png,317432,7077,310355,0.9777054613271504,2,6,66058,1039,65019,0.9842713978624845,36.419152,6690.678650666667,9.87610189394349,130,9.000000000000002E-4
8,test_20231031_150557,11382381.png,312486,567,311919,0.9981855187112383,2,5,46745,75,46670,0.9983955503262381,22.72423288888889,2714.741744,13.793518398308729,130,9.000000000000002E-4
9,test_20231031_150557,11079715.png,443815,107637,336178,0.7574732715207914,5,7,124136,15102,109034,0.8783431075594509,17.963148444444446,2364.288805333333,14.393798349777816,130,9.000000000000002E-4
10,test_20231031_150557,11551286.png,271883,164,271719,0.9993967993585476,2,5,40092,22,40070,0.9994512620971765,18.120286222222223,1899.5769013333334,15.344234809036362,130,9.000000000000002E-4
