SN,TestID,FileName,OriginalFileSize,CompressedBinSize,FileSizeDifference,CompressionRate,CompressionTime,DecompressionTime,UniquePixelCountBefore,UniquePixelCountAfter,UniquePixelCountReduction,UniquePixelCountReductionRate,MAE,MSE,PSNR,QuadtreeThreshold,AllowedExceedingThresholdFactor
1,test_20231101_134331,10404007.png,502730,27377,475353,0.9455433333996379,20,12,61265,3948,57317,0.9355586387007263,24.98091911111111,3241.6444,13.02314988723095,120,0.0
2,test_20231101_134331,1254659.png,342646,84372,258274,0.7537633592687497,3,8,80080,11681,68399,0.8541333666333666,19.952688,2913.615216,13.48648164361196,120,0.0
3,test_20231101_134331,10188041.png,221231,11047,210184,0.9500657683597687,3,8,41731,1550,40181,0.9628573482542954,10.226010666666667,952.9778293333334,18.33997563807963,120,0.0
4,test_20231101_134331,10287332.png,216980,13912,203068,0.935883491566043,1,4,22337,1894,20443,0.9152079509334289,9.119530666666666,704.3960426666666,19.65263453454638,120,0.0
5,test_20231101_134331,11610969.png,368720,31817,336903,0.9137095899327403,3,4,84111,4634,79477,0.9449061359394134,18.97863288888889,2421.380016,14.290174070724388,120,0.0
6,test_20231101_134331,10350842.png,212614,7712,204902,0.9637276943192828,2,4,42529,1131,41398,0.9734063815278986,16.956055111111112,1855.6201013333334,15.445912924238282,120,0.0
7,test_20231101_134331,10863862.png,317432,15377,302055,0.9515581289851055,3,4,66058,2195,63863,0.9667716249356626,23.047130666666668,3065.621008,13.26561897338453,120,0.0
8,test_20231101_134331,11382381.png,312486,1432,311054,0.9954173946992825,1,4,46745,194,46551,0.9958498235105359,18.314965333333333,1924.6423786666667,15.28730316581977,120,0.0
9,test_20231101_134331,11079715.png,443815,132247,311568,0.702022238995978,4,4,124136,18385,105751,0.8518963072758909,16.302611555555554,1952.235056,15.225482537985677,120,0.0
10,test_20231101_134331,11551286.png,271883,1602,270281,0.9941077595877639,1,3,40092,236,39856,0.9941135388606206,15.576856888888889,1453.958336,16.50528399121057,120,0.0
1,test_20231101_134333,10404007.png,502730,27377,475353,0.9455433333996379,2,4,61265,3948,57317,0.9355586387007263,24.98091911111111,3241.6444,13.02314988723095,120,1.0E-5
2,test_20231101_134333,1254659.png,342646,84372,258274,0.7537633592687497,3,9,80080,11681,68399,0.8541333666333666,19.952688,2913.615216,13.48648164361196,120,1.0E-5
3,test_20231101_134333,10188041.png,221231,11047,210184,0.9500657683597687,2,4,41731,1550,40181,0.9628573482542954,10.226010666666667,952.9778293333334,18.33997563807963,120,1.0E-5
4,test_20231101_134333,10287332.png,216980,13912,203068,0.935883491566043,2,4,22337,1894,20443,0.9152079509334289,9.119530666666666,704.3960426666666,19.65263453454638,120,1.0E-5
5,test_20231101_134333,11610969.png,368720,31817,336903,0.9137095899327403,2,4,84111,4634,79477,0.9449061359394134,18.97863288888889,2421.380016,14.290174070724388,120,1.0E-5
6,test_20231101_134333,10350842.png,212614,7712,204902,0.9637276943192828,1,4,42529,1131,41398,0.9734063815278986,16.956055111111112,1855.6201013333334,15.445912924238282,120,1.0E-5
7,test_20231101_134333,10863862.png,317432,15377,302055,0.9515581289851055,2,4,66058,2195,63863,0.9667716249356626,23.047130666666668,3065.621008,13.26561897338453,120,1.0E-5
8,test_20231101_134333,11382381.png,312486,1432,311054,0.9954173946992825,2,4,46745,194,46551,0.9958498235105359,18.314965333333333,1924.6423786666667,15.28730316581977,120,1.0E-5
9,test_20231101_134333,11079715.png,443815,132247,311568,0.702022238995978,3,4,124136,18385,105751,0.8518963072758909,16.302611555555554,1952.235056,15.225482537985677,120,1.0E-5
10,test_20231101_134333,11551286.png,271883,1602,270281,0.9941077595877639,2,4,40092,236,39856,0.9941135388606206,15.576856888888889,1453.958336,16.50528399121057,120,1.0E-5
1,test_20231101_134333,10404007.png,502730,27377,475353,0.9455433333996379,2,4,61265,3948,57317,0.9355586387007263,24.98091911111111,3241.6444,13.02314988723095,120,2.0E-5
2,test_20231101_134333,1254659.png,342646,84372,258274,0.7537633592687497,4,4,80080,11681,68399,0.8541333666333666,19.952688,2913.615216,13.48648164361196,120,2.0E-5
3,test_20231101_134333,10188041.png,221231,11047,210184,0.9500657683597687,3,5,41731,1550,40181,0.9628573482542954,10.226010666666667,952.9778293333334,18.33997563807963,120,2.0E-5
4,test_20231101_134333,10287332.png,216980,13912,203068,0.935883491566043,2,4,22337,1894,20443,0.9152079509334289,9.119530666666666,704.3960426666666,19.65263453454638,120,2.0E-5
5,test_20231101_134333,11610969.png,368720,31817,336903,0.9137095899327403,2,3,84111,4634,79477,0.9449061359394134,18.97863288888889,2421.380016,14.290174070724388,120,2.0E-5
6,test_20231101_134333,10350842.png,212614,7712,204902,0.9637276943192828,2,4,42529,1131,41398,0.9734063815278986,16.956055111111112,1855.6201013333334,15.445912924238282,120,2.0E-5
7,test_20231101_134333,10863862.png,317432,15377,302055,0.9515581289851055,2,4,66058,2195,63863,0.9667716249356626,23.047130666666668,3065.621008,13.26561897338453,120,2.0E-5
8,test_20231101_134333,11382381.png,312486,1432,311054,0.9954173946992825,2,4,46745,194,46551,0.9958498235105359,18.314965333333333,1924.6423786666667,15.28730316581977,120,2.0E-5
9,test_20231101_134333,11079715.png,443815,132247,311568,0.702022238995978,3,4,124136,18385,105751,0.8518963072758909,16.302611555555554,1952.235056,15.225482537985677,120,2.0E-5
10,test_20231101_134333,11551286.png,271883,1602,270281,0.9941077595877639,1,3,40092,236,39856,0.9941135388606206,15.576856888888889,1453.958336,16.50528399121057,120,2.0E-5
1,test_20231101_134334,10404007.png,502730,27377,475353,0.9455433333996379,2,4,61265,3948,57317,0.9355586387007263,24.98091911111111,3241.6444,13.02314988723095,120,3.0000000000000004E-5
2,test_20231101_134334,1254659.png,342646,84372,258274,0.7537633592687497,4,4,80080,11681,68399,0.8541333666333666,19.952688,2913.615216,13.48648164361196,120,3.0000000000000004E-5
3,test_20231101_134334,10188041.png,221231,11047,210184,0.9500657683597687,1,3,41731,1550,40181,0.9628573482542954,10.226010666666667,952.9778293333334,18.33997563807963,120,3.0000000000000004E-5
4,test_20231101_134334,10287332.png,216980,13912,203068,0.935883491566043,2,3,22337,1894,20443,0.9152079509334289,9.119530666666666,704.3960426666666,19.65263453454638,120,3.0000000000000004E-5
5,test_20231101_134334,11610969.png,368720,31817,336903,0.9137095899327403,2,4,84111,4634,79477,0.9449061359394134,18.97863288888889,2421.380016,14.290174070724388,120,3.0000000000000004E-5
6,test_20231101_134334,10350842.png,212614,7712,204902,0.9637276943192828,1,3,42529,1131,41398,0.9734063815278986,16.956055111111112,1855.6201013333334,15.445912924238282,120,3.0000000000000004E-5
7,test_20231101_134334,10863862.png,317432,15377,302055,0.9515581289851055,2,9,66058,2195,63863,0.9667716249356626,23.047130666666668,3065.621008,13.26561897338453,120,3.0000000000000004E-5
8,test_20231101_134334,11382381.png,312486,1432,311054,0.9954173946992825,1,3,46745,194,46551,0.9958498235105359,18.314965333333333,1924.6423786666667,15.28730316581977,120,3.0000000000000004E-5
9,test_20231101_134334,11079715.png,443815,132247,311568,0.702022238995978,3,4,124136,18385,105751,0.8518963072758909,16.302611555555554,1952.235056,15.225482537985677,120,3.0000000000000004E-5
10,test_20231101_134334,11551286.png,271883,1602,270281,0.9941077595877639,3,5,40092,236,39856,0.9941135388606206,15.576856888888889,1453.958336,16.50528399121057,120,3.0000000000000004E-5
1,test_20231101_134335,10404007.png,502730,27377,475353,0.9455433333996379,2,4,61265,3948,57317,0.9355586387007263,24.98091911111111,3241.6444,13.02314988723095,120,4.0E-5
2,test_20231101_134335,1254659.png,342646,84372,258274,0.7537633592687497,4,4,80080,11681,68399,0.8541333666333666,19.952688,2913.615216,13.48648164361196,120,4.0E-5
3,test_20231101_134335,10188041.png,221231,11047,210184,0.9500657683597687,2,4,41731,1550,40181,0.9628573482542954,10.226010666666667,952.9778293333334,18.33997563807963,120,4.0E-5
4,test_20231101_134335,10287332.png,216980,13912,203068,0.935883491566043,2,4,22337,1894,20443,0.9152079509334289,9.119530666666666,704.3960426666666,19.65263453454638,120,4.0E-5
5,test_20231101_134335,11610969.png,368720,31817,336903,0.9137095899327403,2,4,84111,4634,79477,0.9449061359394134,18.97863288888889,2421.380016,14.290174070724388,120,4.0E-5
6,test_20231101_134335,10350842.png,212614,7712,204902,0.9637276943192828,2,4,42529,1131,41398,0.9734063815278986,16.956055111111112,1855.6201013333334,15.445912924238282,120,4.0E-5
7,test_20231101_134335,10863862.png,317432,15377,302055,0.9515581289851055,2,4,66058,2195,63863,0.9667716249356626,23.047130666666668,3065.621008,13.26561897338453,120,4.0E-5
8,test_20231101_134335,11382381.png,312486,1432,311054,0.9954173946992825,2,3,46745,194,46551,0.9958498235105359,18.314965333333333,1924.6423786666667,15.28730316581977,120,4.0E-5
9,test_20231101_134335,11079715.png,443815,132247,311568,0.702022238995978,4,4,124136,18385,105751,0.8518963072758909,16.302611555555554,1952.235056,15.225482537985677,120,4.0E-5
10,test_20231101_134335,11551286.png,271883,1602,270281,0.9941077595877639,2,4,40092,236,39856,0.9941135388606206,15.576856888888889,1453.958336,16.50528399121057,120,4.0E-5
1,test_20231101_134336,10404007.png,502730,27377,475353,0.9455433333996379,2,4,61265,3948,57317,0.9355586387007263,24.98091911111111,3241.6444,13.02314988723095,120,5.0E-5
2,test_20231101_134336,1254659.png,342646,84372,258274,0.7537633592687497,3,4,80080,11681,68399,0.8541333666333666,19.952688,2913.615216,13.48648164361196,120,5.0E-5
3,test_20231101_134336,10188041.png,221231,11047,210184,0.9500657683597687,3,4,41731,1550,40181,0.9628573482542954,10.226010666666667,952.9778293333334,18.33997563807963,120,5.0E-5
4,test_20231101_134336,10287332.png,216980,13912,203068,0.935883491566043,1,4,22337,1894,20443,0.9152079509334289,9.119530666666666,704.3960426666666,19.65263453454638,120,5.0E-5
5,test_20231101_134336,11610969.png,368720,31817,336903,0.9137095899327403,2,3,84111,4634,79477,0.9449061359394134,18.97863288888889,2421.380016,14.290174070724388,120,5.0E-5
6,test_20231101_134336,10350842.png,212614,7712,204902,0.9637276943192828,1,3,42529,1131,41398,0.9734063815278986,16.956055111111112,1855.6201013333334,15.445912924238282,120,5.0E-5
7,test_20231101_134336,10863862.png,317432,15377,302055,0.9515581289851055,2,4,66058,2195,63863,0.9667716249356626,23.047130666666668,3065.621008,13.26561897338453,120,5.0E-5
8,test_20231101_134336,11382381.png,312486,1432,311054,0.9954173946992825,2,3,46745,194,46551,0.9958498235105359,18.314965333333333,1924.6423786666667,15.28730316581977,120,5.0E-5
9,test_20231101_134336,11079715.png,443815,132247,311568,0.702022238995978,4,5,124136,18385,105751,0.8518963072758909,16.302611555555554,1952.235056,15.225482537985677,120,5.0E-5
10,test_20231101_134336,11551286.png,271883,1602,270281,0.9941077595877639,2,4,40092,236,39856,0.9941135388606206,15.576856888888889,1453.958336,16.50528399121057,120,5.0E-5
1,test_20231101_134336,10404007.png,502730,27377,475353,0.9455433333996379,2,5,61265,3948,57317,0.9355586387007263,24.98091911111111,3241.6444,13.02314988723095,120,6.0E-5
2,test_20231101_134336,1254659.png,342646,84372,258274,0.7537633592687497,4,4,80080,11681,68399,0.8541333666333666,19.952688,2913.615216,13.48648164361196,120,6.0E-5
3,test_20231101_134336,10188041.png,221231,11047,210184,0.9500657683597687,2,3,41731,1550,40181,0.9628573482542954,10.226010666666667,952.9778293333334,18.33997563807963,120,6.0E-5
4,test_20231101_134336,10287332.png,216980,13912,203068,0.935883491566043,1,3,22337,1894,20443,0.9152079509334289,9.119530666666666,704.3960426666666,19.65263453454638,120,6.0E-5
5,test_20231101_134336,11610969.png,368720,31817,336903,0.9137095899327403,3,4,84111,4634,79477,0.9449061359394134,18.97863288888889,2421.380016,14.290174070724388,120,6.0E-5
6,test_20231101_134336,10350842.png,212614,7712,204902,0.9637276943192828,2,4,42529,1131,41398,0.9734063815278986,16.956055111111112,1855.6201013333334,15.445912924238282,120,6.0E-5
7,test_20231101_134336,10863862.png,317432,15377,302055,0.9515581289851055,3,3,66058,2195,63863,0.9667716249356626,23.047130666666668,3065.621008,13.26561897338453,120,6.0E-5
8,test_20231101_134336,11382381.png,312486,1432,311054,0.9954173946992825,2,3,46745,194,46551,0.9958498235105359,18.314965333333333,1924.6423786666667,15.28730316581977,120,6.0E-5
9,test_20231101_134336,11079715.png,443815,132247,311568,0.702022238995978,3,9,124136,18385,105751,0.8518963072758909,16.302611555555554,1952.235056,15.225482537985677,120,6.0E-5
10,test_20231101_134336,11551286.png,271883,1602,270281,0.9941077595877639,2,4,40092,236,39856,0.9941135388606206,15.576856888888889,1453.958336,16.50528399121057,120,6.0E-5
1,test_20231101_134337,10404007.png,502730,27377,475353,0.9455433333996379,2,4,61265,3948,57317,0.9355586387007263,24.98091911111111,3241.6444,13.02314988723095,120,7.000000000000001E-5
2,test_20231101_134337,1254659.png,342646,84372,258274,0.7537633592687497,3,4,80080,11681,68399,0.8541333666333666,19.952688,2913.615216,13.48648164361196,120,7.000000000000001E-5
3,test_20231101_134337,10188041.png,221231,11047,210184,0.9500657683597687,2,3,41731,1550,40181,0.9628573482542954,10.226010666666667,952.9778293333334,18.33997563807963,120,7.000000000000001E-5
4,test_20231101_134337,10287332.png,216980,13912,203068,0.935883491566043,2,4,22337,1894,20443,0.9152079509334289,9.119530666666666,704.3960426666666,19.65263453454638,120,7.000000000000001E-5
5,test_20231101_134337,11610969.png,368720,31817,336903,0.9137095899327403,2,4,84111,4634,79477,0.9449061359394134,18.97863288888889,2421.380016,14.290174070724388,120,7.000000000000001E-5
6,test_20231101_134337,10350842.png,212614,7712,204902,0.9637276943192828,2,4,42529,1131,41398,0.9734063815278986,16.956055111111112,1855.6201013333334,15.445912924238282,120,7.000000000000001E-5
7,test_20231101_134337,10863862.png,317432,15377,302055,0.9515581289851055,2,4,66058,2195,63863,0.9667716249356626,23.047130666666668,3065.621008,13.26561897338453,120,7.000000000000001E-5
8,test_20231101_134337,11382381.png,312486,1362,311124,0.9956414047349321,2,3,46745,184,46561,0.9960637501337042,19.183123555555557,2043.048048,15.028017804636116,120,7.000000000000001E-5
9,test_20231101_134337,11079715.png,443815,132247,311568,0.702022238995978,3,5,124136,18385,105751,0.8518963072758909,16.302611555555554,1952.235056,15.225482537985677,120,7.000000000000001E-5
10,test_20231101_134337,11551286.png,271883,1462,270421,0.9946226869646134,1,3,40092,215,39877,0.9946373341314976,15.664478222222222,1460.3968373333332,16.48609477106633,120,7.000000000000001E-5
1,test_20231101_134338,10404007.png,502730,27377,475353,0.9455433333996379,2,3,61265,3948,57317,0.9355586387007263,24.98091911111111,3241.6444,13.02314988723095,120,8.0E-5
2,test_20231101_134338,1254659.png,342646,84372,258274,0.7537633592687497,3,4,80080,11681,68399,0.8541333666333666,19.952688,2913.615216,13.48648164361196,120,8.0E-5
3,test_20231101_134338,10188041.png,221231,11047,210184,0.9500657683597687,2,4,41731,1550,40181,0.9628573482542954,10.226010666666667,952.9778293333334,18.33997563807963,120,8.0E-5
4,test_20231101_134338,10287332.png,216980,13912,203068,0.935883491566043,2,4,22337,1894,20443,0.9152079509334289,9.119530666666666,704.3960426666666,19.65263453454638,120,8.0E-5
5,test_20231101_134338,11610969.png,368720,31817,336903,0.9137095899327403,3,3,84111,4634,79477,0.9449061359394134,18.97863288888889,2421.380016,14.290174070724388,120,8.0E-5
6,test_20231101_134338,10350842.png,212614,7712,204902,0.9637276943192828,1,3,42529,1131,41398,0.9734063815278986,16.956055111111112,1855.6201013333334,15.445912924238282,120,8.0E-5
7,test_20231101_134338,10863862.png,317432,15377,302055,0.9515581289851055,2,4,66058,2195,63863,0.9667716249356626,23.047130666666668,3065.621008,13.26561897338453,120,8.0E-5
8,test_20231101_134338,11382381.png,312486,1362,311124,0.9956414047349321,2,4,46745,184,46561,0.9960637501337042,19.183123555555557,2043.048048,15.028017804636116,120,8.0E-5
9,test_20231101_134338,11079715.png,443815,132247,311568,0.702022238995978,3,4,124136,18385,105751,0.8518963072758909,16.302611555555554,1952.235056,15.225482537985677,120,8.0E-5
10,test_20231101_134338,11551286.png,271883,1462,270421,0.9946226869646134,2,3,40092,215,39877,0.9946373341314976,15.664478222222222,1460.3968373333332,16.48609477106633,120,8.0E-5
1,test_20231101_134338,10404007.png,502730,27377,475353,0.9455433333996379,3,4,61265,3948,57317,0.9355586387007263,24.98091911111111,3241.6444,13.02314988723095,120,9.0E-5
2,test_20231101_134338,1254659.png,342646,84372,258274,0.7537633592687497,3,4,80080,11681,68399,0.8541333666333666,19.952688,2913.615216,13.48648164361196,120,9.0E-5
3,test_20231101_134338,10188041.png,221231,11047,210184,0.9500657683597687,2,4,41731,1550,40181,0.9628573482542954,10.226010666666667,952.9778293333334,18.33997563807963,120,9.0E-5
4,test_20231101_134338,10287332.png,216980,13912,203068,0.935883491566043,1,3,22337,1894,20443,0.9152079509334289,9.119530666666666,704.3960426666666,19.65263453454638,120,9.0E-5
5,test_20231101_134338,11610969.png,368720,31817,336903,0.9137095899327403,2,4,84111,4634,79477,0.9449061359394134,18.97863288888889,2421.380016,14.290174070724388,120,9.0E-5
6,test_20231101_134338,10350842.png,212614,7712,204902,0.9637276943192828,2,3,42529,1131,41398,0.9734063815278986,16.956055111111112,1855.6201013333334,15.445912924238282,120,9.0E-5
7,test_20231101_134338,10863862.png,317432,15377,302055,0.9515581289851055,2,4,66058,2195,63863,0.9667716249356626,23.047130666666668,3065.621008,13.26561897338453,120,9.0E-5
8,test_20231101_134338,11382381.png,312486,1362,311124,0.9956414047349321,2,3,46745,184,46561,0.9960637501337042,19.183123555555557,2043.048048,15.028017804636116,120,9.0E-5
9,test_20231101_134338,11079715.png,443815,132247,311568,0.702022238995978,3,5,124136,18385,105751,0.8518963072758909,16.302611555555554,1952.235056,15.225482537985677,120,9.0E-5
10,test_20231101_134338,11551286.png,271883,1462,270421,0.9946226869646134,2,4,40092,215,39877,0.9946373341314976,15.664478222222222,1460.3968373333332,16.48609477106633,120,9.0E-5
1,test_20231101_134339,10404007.png,502730,27377,475353,0.9455433333996379,2,3,61265,3948,57317,0.9355586387007263,24.98091911111111,3241.6444,13.02314988723095,120,1.0E-4
2,test_20231101_134339,1254659.png,342646,84372,258274,0.7537633592687497,3,4,80080,11681,68399,0.8541333666333666,19.952688,2913.615216,13.48648164361196,120,1.0E-4
3,test_20231101_134339,10188041.png,221231,11047,210184,0.9500657683597687,2,3,41731,1550,40181,0.9628573482542954,10.226010666666667,952.9778293333334,18.33997563807963,120,1.0E-4
4,test_20231101_134339,10287332.png,216980,13912,203068,0.935883491566043,1,3,22337,1894,20443,0.9152079509334289,9.119530666666666,704.3960426666666,19.65263453454638,120,1.0E-4
5,test_20231101_134339,11610969.png,368720,31817,336903,0.9137095899327403,2,3,84111,4634,79477,0.9449061359394134,18.97863288888889,2421.380016,14.290174070724388,120,1.0E-4
6,test_20231101_134339,10350842.png,212614,7712,204902,0.9637276943192828,2,3,42529,1131,41398,0.9734063815278986,16.956055111111112,1855.6201013333334,15.445912924238282,120,1.0E-4
7,test_20231101_134339,10863862.png,317432,15377,302055,0.9515581289851055,2,4,66058,2195,63863,0.9667716249356626,23.047130666666668,3065.621008,13.26561897338453,120,1.0E-4
8,test_20231101_134339,11382381.png,312486,1362,311124,0.9956414047349321,2,4,46745,184,46561,0.9960637501337042,19.183123555555557,2043.048048,15.028017804636116,120,1.0E-4
9,test_20231101_134339,11079715.png,443815,132247,311568,0.702022238995978,4,4,124136,18385,105751,0.8518963072758909,16.302611555555554,1952.235056,15.225482537985677,120,1.0E-4
10,test_20231101_134339,11551286.png,271883,1462,270421,0.9946226869646134,1,4,40092,215,39877,0.9946373341314976,15.664478222222222,1460.3968373333332,16.48609477106633,120,1.0E-4
1,test_20231101_134340,10404007.png,502730,27377,475353,0.9455433333996379,3,3,61265,3948,57317,0.9355586387007263,24.98091911111111,3241.6444,13.02314988723095,120,1.1E-4
2,test_20231101_134340,1254659.png,342646,84372,258274,0.7537633592687497,3,4,80080,11681,68399,0.8541333666333666,19.952688,2913.615216,13.48648164361196,120,1.1E-4
3,test_20231101_134340,10188041.png,221231,11047,210184,0.9500657683597687,2,4,41731,1550,40181,0.9628573482542954,10.226010666666667,952.9778293333334,18.33997563807963,120,1.1E-4
4,test_20231101_134340,10287332.png,216980,13912,203068,0.935883491566043,1,4,22337,1894,20443,0.9152079509334289,9.119530666666666,704.3960426666666,19.65263453454638,120,1.1E-4
5,test_20231101_134340,11610969.png,368720,31817,336903,0.9137095899327403,3,4,84111,4634,79477,0.9449061359394134,18.97863288888889,2421.380016,14.290174070724388,120,1.1E-4
6,test_20231101_134340,10350842.png,212614,7712,204902,0.9637276943192828,1,3,42529,1131,41398,0.9734063815278986,16.956055111111112,1855.6201013333334,15.445912924238282,120,1.1E-4
7,test_20231101_134340,10863862.png,317432,15377,302055,0.9515581289851055,2,3,66058,2195,63863,0.9667716249356626,23.047130666666668,3065.621008,13.26561897338453,120,1.1E-4
8,test_20231101_134340,11382381.png,312486,1362,311124,0.9956414047349321,2,4,46745,184,46561,0.9960637501337042,19.183123555555557,2043.048048,15.028017804636116,120,1.1E-4
9,test_20231101_134340,11079715.png,443815,132247,311568,0.702022238995978,3,5,124136,18385,105751,0.8518963072758909,16.302611555555554,1952.235056,15.225482537985677,120,1.1E-4
10,test_20231101_134340,11551286.png,271883,1462,270421,0.9946226869646134,2,3,40092,215,39877,0.9946373341314976,15.664478222222222,1460.3968373333332,16.48609477106633,120,1.1E-4
1,test_20231101_134340,10404007.png,502730,27377,475353,0.9455433333996379,3,3,61265,3948,57317,0.9355586387007263,24.98091911111111,3241.6444,13.02314988723095,120,1.2E-4
2,test_20231101_134340,1254659.png,342646,84372,258274,0.7537633592687497,4,5,80080,11681,68399,0.8541333666333666,19.952688,2913.615216,13.48648164361196,120,1.2E-4
3,test_20231101_134340,10188041.png,221231,11047,210184,0.9500657683597687,2,3,41731,1550,40181,0.9628573482542954,10.226010666666667,952.9778293333334,18.33997563807963,120,1.2E-4
4,test_20231101_134340,10287332.png,216980,13912,203068,0.935883491566043,2,4,22337,1894,20443,0.9152079509334289,9.119530666666666,704.3960426666666,19.65263453454638,120,1.2E-4
5,test_20231101_134340,11610969.png,368720,31817,336903,0.9137095899327403,2,3,84111,4634,79477,0.9449061359394134,18.97863288888889,2421.380016,14.290174070724388,120,1.2E-4
6,test_20231101_134340,10350842.png,212614,7712,204902,0.9637276943192828,1,3,42529,1131,41398,0.9734063815278986,16.956055111111112,1855.6201013333334,15.445912924238282,120,1.2E-4
7,test_20231101_134340,10863862.png,317432,15377,302055,0.9515581289851055,2,4,66058,2195,63863,0.9667716249356626,23.047130666666668,3065.621008,13.26561897338453,120,1.2E-4
8,test_20231101_134340,11382381.png,312486,1362,311124,0.9956414047349321,2,4,46745,184,46561,0.9960637501337042,19.183123555555557,2043.048048,15.028017804636116,120,1.2E-4
9,test_20231101_134340,11079715.png,443815,132247,311568,0.702022238995978,3,4,124136,18385,105751,0.8518963072758909,16.302611555555554,1952.235056,15.225482537985677,120,1.2E-4
10,test_20231101_134340,11551286.png,271883,1462,270421,0.9946226869646134,1,3,40092,215,39877,0.9946373341314976,15.664478222222222,1460.3968373333332,16.48609477106633,120,1.2E-4
1,test_20231101_134341,10404007.png,502730,27377,475353,0.9455433333996379,2,4,61265,3948,57317,0.9355586387007263,24.98091911111111,3241.6444,13.02314988723095,120,1.3000000000000002E-4
2,test_20231101_134341,1254659.png,342646,84372,258274,0.7537633592687497,2,4,80080,11681,68399,0.8541333666333666,19.952688,2913.615216,13.48648164361196,120,1.3000000000000002E-4
3,test_20231101_134341,10188041.png,221231,11047,210184,0.9500657683597687,2,3,41731,1550,40181,0.9628573482542954,10.226010666666667,952.9778293333334,18.33997563807963,120,1.3000000000000002E-4
4,test_20231101_134341,10287332.png,216980,13912,203068,0.935883491566043,2,3,22337,1894,20443,0.9152079509334289,9.119530666666666,704.3960426666666,19.65263453454638,120,1.3000000000000002E-4
5,test_20231101_134341,11610969.png,368720,31817,336903,0.9137095899327403,3,4,84111,4634,79477,0.9449061359394134,18.97863288888889,2421.380016,14.290174070724388,120,1.3000000000000002E-4
6,test_20231101_134341,10350842.png,212614,7712,204902,0.9637276943192828,1,3,42529,1131,41398,0.9734063815278986,16.956055111111112,1855.6201013333334,15.445912924238282,120,1.3000000000000002E-4
7,test_20231101_134341,10863862.png,317432,15377,302055,0.9515581289851055,2,3,66058,2195,63863,0.9667716249356626,23.047130666666668,3065.621008,13.26561897338453,120,1.3000000000000002E-4
8,test_20231101_134341,11382381.png,312486,1259,311227,0.9959710195016737,2,4,46745,169,46576,0.9963846400684565,20.086165333333334,2234.270282666667,14.639446517255376,120,1.3000000000000002E-4
9,test_20231101_134341,11079715.png,443815,132247,311568,0.702022238995978,3,5,124136,18385,105751,0.8518963072758909,16.302611555555554,1952.235056,15.225482537985677,120,1.3000000000000002E-4
10,test_20231101_134341,11551286.png,271883,1462,270421,0.9946226869646134,1,3,40092,215,39877,0.9946373341314976,15.664478222222222,1460.3968373333332,16.48609477106633,120,1.3000000000000002E-4
1,test_20231101_134342,10404007.png,502730,27377,475353,0.9455433333996379,3,4,61265,3948,57317,0.9355586387007263,24.98091911111111,3241.6444,13.02314988723095,120,1.4000000000000001E-4
2,test_20231101_134342,1254659.png,342646,84372,258274,0.7537633592687497,3,4,80080,11681,68399,0.8541333666333666,19.952688,2913.615216,13.48648164361196,120,1.4000000000000001E-4
3,test_20231101_134342,10188041.png,221231,11047,210184,0.9500657683597687,2,3,41731,1550,40181,0.9628573482542954,10.226010666666667,952.9778293333334,18.33997563807963,120,1.4000000000000001E-4
4,test_20231101_134342,10287332.png,216980,13912,203068,0.935883491566043,2,4,22337,1894,20443,0.9152079509334289,9.119530666666666,704.3960426666666,19.65263453454638,120,1.4000000000000001E-4
5,test_20231101_134342,11610969.png,368720,31817,336903,0.9137095899327403,3,4,84111,4634,79477,0.9449061359394134,18.97863288888889,2421.380016,14.290174070724388,120,1.4000000000000001E-4
6,test_20231101_134342,10350842.png,212614,7712,204902,0.9637276943192828,2,3,42529,1131,41398,0.9734063815278986,16.956055111111112,1855.6201013333334,15.445912924238282,120,1.4000000000000001E-4
7,test_20231101_134342,10863862.png,317432,15377,302055,0.9515581289851055,2,4,66058,2195,63863,0.9667716249356626,23.047130666666668,3065.621008,13.26561897338453,120,1.4000000000000001E-4
8,test_20231101_134342,11382381.png,312486,1259,311227,0.9959710195016737,2,4,46745,169,46576,0.9963846400684565,20.086165333333334,2234.270282666667,14.639446517255376,120,1.4000000000000001E-4
9,test_20231101_134342,11079715.png,443815,132247,311568,0.702022238995978,4,4,124136,18385,105751,0.8518963072758909,16.302611555555554,1952.235056,15.225482537985677,120,1.4000000000000001E-4
10,test_20231101_134342,11551286.png,271883,1462,270421,0.9946226869646134,1,4,40092,215,39877,0.9946373341314976,15.664478222222222,1460.3968373333332,16.48609477106633,120,1.4000000000000001E-4
1,test_20231101_134342,10404007.png,502730,27377,475353,0.9455433333996379,3,4,61265,3948,57317,0.9355586387007263,24.98091911111111,3241.6444,13.02314988723095,120,1.5000000000000001E-4
2,test_20231101_134342,1254659.png,342646,84372,258274,0.7537633592687497,3,4,80080,11681,68399,0.8541333666333666,19.952688,2913.615216,13.48648164361196,120,1.5000000000000001E-4
3,test_20231101_134342,10188041.png,221231,11047,210184,0.9500657683597687,2,4,41731,1550,40181,0.9628573482542954,10.226010666666667,952.9778293333334,18.33997563807963,120,1.5000000000000001E-4
4,test_20231101_134342,10287332.png,216980,13912,203068,0.935883491566043,2,3,22337,1894,20443,0.9152079509334289,9.119530666666666,704.3960426666666,19.65263453454638,120,1.5000000000000001E-4
5,test_20231101_134342,11610969.png,368720,31817,336903,0.9137095899327403,2,3,84111,4634,79477,0.9449061359394134,18.97863288888889,2421.380016,14.290174070724388,120,1.5000000000000001E-4
6,test_20231101_134342,10350842.png,212614,7712,204902,0.9637276943192828,2,4,42529,1131,41398,0.9734063815278986,16.956055111111112,1855.6201013333334,15.445912924238282,120,1.5000000000000001E-4
7,test_20231101_134342,10863862.png,317432,15377,302055,0.9515581289851055,2,4,66058,2195,63863,0.9667716249356626,23.047130666666668,3065.621008,13.26561897338453,120,1.5000000000000001E-4
8,test_20231101_134342,11382381.png,312486,1259,311227,0.9959710195016737,2,4,46745,169,46576,0.9963846400684565,20.086165333333334,2234.270282666667,14.639446517255376,120,1.5000000000000001E-4
9,test_20231101_134342,11079715.png,443815,132247,311568,0.702022238995978,3,4,124136,18385,105751,0.8518963072758909,16.302611555555554,1952.235056,15.225482537985677,120,1.5000000000000001E-4
10,test_20231101_134342,11551286.png,271883,1462,270421,0.9946226869646134,2,4,40092,215,39877,0.9946373341314976,15.664478222222222,1460.3968373333332,16.48609477106633,120,1.5000000000000001E-4
1,test_20231101_134343,10404007.png,502730,27377,475353,0.9455433333996379,2,4,61265,3948,57317,0.9355586387007263,24.98091911111111,3241.6444,13.02314988723095,120,1.6E-4
2,test_20231101_134343,1254659.png,342646,84372,258274,0.7537633592687497,3,4,80080,11681,68399,0.8541333666333666,19.952688,2913.615216,13.48648164361196,120,1.6E-4
3,test_20231101_134343,10188041.png,221231,11047,210184,0.9500657683597687,2,3,41731,1550,40181,0.9628573482542954,10.226010666666667,952.9778293333334,18.33997563807963,120,1.6E-4
4,test_20231101_134343,10287332.png,216980,13662,203318,0.93703567149046,2,4,22337,1864,20473,0.9165510140126247,9.250581333333333,731.4470933333333,19.488974424426054,120,1.6E-4
5,test_20231101_134343,11610969.png,368720,31817,336903,0.9137095899327403,2,3,84111,4634,79477,0.9449061359394134,18.97863288888889,2421.380016,14.290174070724388,120,1.6E-4
6,test_20231101_134343,10350842.png,212614,7712,204902,0.9637276943192828,2,4,42529,1131,41398,0.9734063815278986,16.956055111111112,1855.6201013333334,15.445912924238282,120,1.6E-4
7,test_20231101_134343,10863862.png,317432,15377,302055,0.9515581289851055,1,3,66058,2195,63863,0.9667716249356626,23.047130666666668,3065.621008,13.26561897338453,120,1.6E-4
8,test_20231101_134343,11382381.png,312486,1259,311227,0.9959710195016737,2,4,46745,169,46576,0.9963846400684565,20.086165333333334,2234.270282666667,14.639446517255376,120,1.6E-4
9,test_20231101_134343,11079715.png,443815,132247,311568,0.702022238995978,4,4,124136,18385,105751,0.8518963072758909,16.302611555555554,1952.235056,15.225482537985677,120,1.6E-4
10,test_20231101_134343,11551286.png,271883,1462,270421,0.9946226869646134,2,4,40092,215,39877,0.9946373341314976,15.664478222222222,1460.3968373333332,16.48609477106633,120,1.6E-4
1,test_20231101_134344,10404007.png,502730,27377,475353,0.9455433333996379,2,11,61265,3948,57317,0.9355586387007263,24.98091911111111,3241.6444,13.02314988723095,120,1.7E-4
2,test_20231101_134344,1254659.png,342646,84372,258274,0.7537633592687497,3,4,80080,11681,68399,0.8541333666333666,19.952688,2913.615216,13.48648164361196,120,1.7E-4
3,test_20231101_134344,10188041.png,221231,11047,210184,0.9500657683597687,2,3,41731,1550,40181,0.9628573482542954,10.226010666666667,952.9778293333334,18.33997563807963,120,1.7E-4
4,test_20231101_134344,10287332.png,216980,13662,203318,0.93703567149046,2,3,22337,1864,20473,0.9165510140126247,9.250581333333333,731.4470933333333,19.488974424426054,120,1.7E-4
5,test_20231101_134344,11610969.png,368720,31817,336903,0.9137095899327403,2,3,84111,4634,79477,0.9449061359394134,18.97863288888889,2421.380016,14.290174070724388,120,1.7E-4
6,test_20231101_134344,10350842.png,212614,7712,204902,0.9637276943192828,1,4,42529,1131,41398,0.9734063815278986,16.956055111111112,1855.6201013333334,15.445912924238282,120,1.7E-4
7,test_20231101_134344,10863862.png,317432,15377,302055,0.9515581289851055,2,3,66058,2195,63863,0.9667716249356626,23.047130666666668,3065.621008,13.26561897338453,120,1.7E-4
8,test_20231101_134344,11382381.png,312486,1259,311227,0.9959710195016737,2,4,46745,169,46576,0.9963846400684565,20.086165333333334,2234.270282666667,14.639446517255376,120,1.7E-4
9,test_20231101_134344,11079715.png,443815,132247,311568,0.702022238995978,3,4,124136,18385,105751,0.8518963072758909,16.302611555555554,1952.235056,15.225482537985677,120,1.7E-4
10,test_20231101_134344,11551286.png,271883,1462,270421,0.9946226869646134,2,3,40092,215,39877,0.9946373341314976,15.664478222222222,1460.3968373333332,16.48609477106633,120,1.7E-4
1,test_20231101_134344,10404007.png,502730,27377,475353,0.9455433333996379,2,3,61265,3948,57317,0.9355586387007263,24.98091911111111,3241.6444,13.02314988723095,120,1.8E-4
2,test_20231101_134344,1254659.png,342646,84372,258274,0.7537633592687497,3,4,80080,11681,68399,0.8541333666333666,19.952688,2913.615216,13.48648164361196,120,1.8E-4
3,test_20231101_134344,10188041.png,221231,11047,210184,0.9500657683597687,2,3,41731,1550,40181,0.9628573482542954,10.226010666666667,952.9778293333334,18.33997563807963,120,1.8E-4
4,test_20231101_134344,10287332.png,216980,13662,203318,0.93703567149046,2,4,22337,1864,20473,0.9165510140126247,9.250581333333333,731.4470933333333,19.488974424426054,120,1.8E-4
5,test_20231101_134344,11610969.png,368720,31817,336903,0.9137095899327403,2,4,84111,4634,79477,0.9449061359394134,18.97863288888889,2421.380016,14.290174070724388,120,1.8E-4
6,test_20231101_134344,10350842.png,212614,7712,204902,0.9637276943192828,2,3,42529,1131,41398,0.9734063815278986,16.956055111111112,1855.6201013333334,15.445912924238282,120,1.8E-4
7,test_20231101_134344,10863862.png,317432,15377,302055,0.9515581289851055,2,3,66058,2195,63863,0.9667716249356626,23.047130666666668,3065.621008,13.26561897338453,120,1.8E-4
8,test_20231101_134344,11382381.png,312486,1259,311227,0.9959710195016737,2,3,46745,169,46576,0.9963846400684565,20.086165333333334,2234.270282666667,14.639446517255376,120,1.8E-4
9,test_20231101_134344,11079715.png,443815,132247,311568,0.702022238995978,3,4,124136,18385,105751,0.8518963072758909,16.302611555555554,1952.235056,15.225482537985677,120,1.8E-4
10,test_20231101_134344,11551286.png,271883,1462,270421,0.9946226869646134,1,4,40092,215,39877,0.9946373341314976,15.664478222222222,1460.3968373333332,16.48609477106633,120,1.8E-4
1,test_20231101_134345,10404007.png,502730,27377,475353,0.9455433333996379,2,4,61265,3948,57317,0.9355586387007263,24.98091911111111,3241.6444,13.02314988723095,120,1.9E-4
2,test_20231101_134345,1254659.png,342646,84372,258274,0.7537633592687497,3,4,80080,11681,68399,0.8541333666333666,19.952688,2913.615216,13.48648164361196,120,1.9E-4
3,test_20231101_134345,10188041.png,221231,11047,210184,0.9500657683597687,2,4,41731,1550,40181,0.9628573482542954,10.226010666666667,952.9778293333334,18.33997563807963,120,1.9E-4
4,test_20231101_134345,10287332.png,216980,13662,203318,0.93703567149046,2,4,22337,1864,20473,0.9165510140126247,9.250581333333333,731.4470933333333,19.488974424426054,120,1.9E-4
5,test_20231101_134345,11610969.png,368720,31817,336903,0.9137095899327403,2,3,84111,4634,79477,0.9449061359394134,18.97863288888889,2421.380016,14.290174070724388,120,1.9E-4
6,test_20231101_134345,10350842.png,212614,7712,204902,0.9637276943192828,1,3,42529,1131,41398,0.9734063815278986,16.956055111111112,1855.6201013333334,15.445912924238282,120,1.9E-4
7,test_20231101_134345,10863862.png,317432,15377,302055,0.9515581289851055,2,3,66058,2195,63863,0.9667716249356626,23.047130666666668,3065.621008,13.26561897338453,120,1.9E-4
8,test_20231101_134345,11382381.png,312486,1259,311227,0.9959710195016737,1,3,46745,169,46576,0.9963846400684565,20.086165333333334,2234.270282666667,14.639446517255376,120,1.9E-4
9,test_20231101_134345,11079715.png,443815,132247,311568,0.702022238995978,4,4,124136,18385,105751,0.8518963072758909,16.302611555555554,1952.235056,15.225482537985677,120,1.9E-4
10,test_20231101_134345,11551286.png,271883,1462,270421,0.9946226869646134,2,4,40092,215,39877,0.9946373341314976,15.664478222222222,1460.3968373333332,16.48609477106633,120,1.9E-4
1,test_20231101_134346,10404007.png,502730,27377,475353,0.9455433333996379,2,3,61265,3948,57317,0.9355586387007263,24.98091911111111,3241.6444,13.02314988723095,120,2.0E-4
2,test_20231101_134346,1254659.png,342646,84372,258274,0.7537633592687497,3,4,80080,11681,68399,0.8541333666333666,19.952688,2913.615216,13.48648164361196,120,2.0E-4
3,test_20231101_134346,10188041.png,221231,11047,210184,0.9500657683597687,2,3,41731,1550,40181,0.9628573482542954,10.226010666666667,952.9778293333334,18.33997563807963,120,2.0E-4
4,test_20231101_134346,10287332.png,216980,13662,203318,0.93703567149046,2,4,22337,1864,20473,0.9165510140126247,9.250581333333333,731.4470933333333,19.488974424426054,120,2.0E-4
5,test_20231101_134346,11610969.png,368720,31817,336903,0.9137095899327403,2,4,84111,4634,79477,0.9449061359394134,18.97863288888889,2421.380016,14.290174070724388,120,2.0E-4
6,test_20231101_134346,10350842.png,212614,7712,204902,0.9637276943192828,1,3,42529,1131,41398,0.9734063815278986,16.956055111111112,1855.6201013333334,15.445912924238282,120,2.0E-4
7,test_20231101_134346,10863862.png,317432,15377,302055,0.9515581289851055,2,4,66058,2195,63863,0.9667716249356626,23.047130666666668,3065.621008,13.26561897338453,120,2.0E-4
8,test_20231101_134346,11382381.png,312486,1259,311227,0.9959710195016737,2,3,46745,169,46576,0.9963846400684565,20.086165333333334,2234.270282666667,14.639446517255376,120,2.0E-4
9,test_20231101_134346,11079715.png,443815,132247,311568,0.702022238995978,4,4,124136,18385,105751,0.8518963072758909,16.302611555555554,1952.235056,15.225482537985677,120,2.0E-4
10,test_20231101_134346,11551286.png,271883,1462,270421,0.9946226869646134,2,4,40092,215,39877,0.9946373341314976,15.664478222222222,1460.3968373333332,16.48609477106633,120,2.0E-4
1,test_20231101_134346,10404007.png,502730,27377,475353,0.9455433333996379,2,4,61265,3948,57317,0.9355586387007263,24.98091911111111,3241.6444,13.02314988723095,120,2.1E-4
2,test_20231101_134346,1254659.png,342646,84372,258274,0.7537633592687497,3,4,80080,11681,68399,0.8541333666333666,19.952688,2913.615216,13.48648164361196,120,2.1E-4
3,test_20231101_134346,10188041.png,221231,11047,210184,0.9500657683597687,2,3,41731,1550,40181,0.9628573482542954,10.226010666666667,952.9778293333334,18.33997563807963,120,2.1E-4
4,test_20231101_134346,10287332.png,216980,13662,203318,0.93703567149046,1,4,22337,1864,20473,0.9165510140126247,9.250581333333333,731.4470933333333,19.488974424426054,120,2.1E-4
5,test_20231101_134346,11610969.png,368720,31817,336903,0.9137095899327403,3,4,84111,4634,79477,0.9449061359394134,18.97863288888889,2421.380016,14.290174070724388,120,2.1E-4
6,test_20231101_134346,10350842.png,212614,7712,204902,0.9637276943192828,1,3,42529,1131,41398,0.9734063815278986,16.956055111111112,1855.6201013333334,15.445912924238282,120,2.1E-4
7,test_20231101_134346,10863862.png,317432,15377,302055,0.9515581289851055,2,3,66058,2195,63863,0.9667716249356626,23.047130666666668,3065.621008,13.26561897338453,120,2.1E-4
8,test_20231101_134346,11382381.png,312486,1259,311227,0.9959710195016737,2,4,46745,169,46576,0.9963846400684565,20.086165333333334,2234.270282666667,14.639446517255376,120,2.1E-4
9,test_20231101_134346,11079715.png,443815,132247,311568,0.702022238995978,4,4,124136,18385,105751,0.8518963072758909,16.302611555555554,1952.235056,15.225482537985677,120,2.1E-4
10,test_20231101_134346,11551286.png,271883,1462,270421,0.9946226869646134,2,4,40092,215,39877,0.9946373341314976,15.664478222222222,1460.3968373333332,16.48609477106633,120,2.1E-4
1,test_20231101_134347,10404007.png,502730,27377,475353,0.9455433333996379,3,4,61265,3948,57317,0.9355586387007263,24.98091911111111,3241.6444,13.02314988723095,120,2.2E-4
2,test_20231101_134347,1254659.png,342646,84372,258274,0.7537633592687497,3,4,80080,11681,68399,0.8541333666333666,19.952688,2913.615216,13.48648164361196,120,2.2E-4
3,test_20231101_134347,10188041.png,221231,11047,210184,0.9500657683597687,3,3,41731,1550,40181,0.9628573482542954,10.226010666666667,952.9778293333334,18.33997563807963,120,2.2E-4
4,test_20231101_134347,10287332.png,216980,13662,203318,0.93703567149046,2,4,22337,1864,20473,0.9165510140126247,9.250581333333333,731.4470933333333,19.488974424426054,120,2.2E-4
5,test_20231101_134347,11610969.png,368720,31817,336903,0.9137095899327403,2,4,84111,4634,79477,0.9449061359394134,18.97863288888889,2421.380016,14.290174070724388,120,2.2E-4
6,test_20231101_134347,10350842.png,212614,7712,204902,0.9637276943192828,1,3,42529,1131,41398,0.9734063815278986,16.956055111111112,1855.6201013333334,15.445912924238282,120,2.2E-4
7,test_20231101_134347,10863862.png,317432,15377,302055,0.9515581289851055,2,3,66058,2195,63863,0.9667716249356626,23.047130666666668,3065.621008,13.26561897338453,120,2.2E-4
8,test_20231101_134347,11382381.png,312486,1259,311227,0.9959710195016737,1,3,46745,169,46576,0.9963846400684565,20.086165333333334,2234.270282666667,14.639446517255376,120,2.2E-4
9,test_20231101_134347,11079715.png,443815,132247,311568,0.702022238995978,4,4,124136,18385,105751,0.8518963072758909,16.302611555555554,1952.235056,15.225482537985677,120,2.2E-4
10,test_20231101_134347,11551286.png,271883,1462,270421,0.9946226869646134,2,4,40092,215,39877,0.9946373341314976,15.664478222222222,1460.3968373333332,16.48609477106633,120,2.2E-4
1,test_20231101_134348,10404007.png,502730,27377,475353,0.9455433333996379,3,4,61265,3948,57317,0.9355586387007263,24.98091911111111,3241.6444,13.02314988723095,120,2.3E-4
2,test_20231101_134348,1254659.png,342646,84372,258274,0.7537633592687497,4,4,80080,11681,68399,0.8541333666333666,19.952688,2913.615216,13.48648164361196,120,2.3E-4
3,test_20231101_134348,10188041.png,221231,11047,210184,0.9500657683597687,2,4,41731,1550,40181,0.9628573482542954,10.226010666666667,952.9778293333334,18.33997563807963,120,2.3E-4
4,test_20231101_134348,10287332.png,216980,13662,203318,0.93703567149046,1,3,22337,1864,20473,0.9165510140126247,9.250581333333333,731.4470933333333,19.488974424426054,120,2.3E-4
5,test_20231101_134348,11610969.png,368720,31817,336903,0.9137095899327403,3,3,84111,4634,79477,0.9449061359394134,18.97863288888889,2421.380016,14.290174070724388,120,2.3E-4
6,test_20231101_134348,10350842.png,212614,7712,204902,0.9637276943192828,1,4,42529,1131,41398,0.9734063815278986,16.956055111111112,1855.6201013333334,15.445912924238282,120,2.3E-4
7,test_20231101_134348,10863862.png,317432,15377,302055,0.9515581289851055,2,4,66058,2195,63863,0.9667716249356626,23.047130666666668,3065.621008,13.26561897338453,120,2.3E-4
8,test_20231101_134348,11382381.png,312486,1259,311227,0.9959710195016737,2,4,46745,169,46576,0.9963846400684565,20.086165333333334,2234.270282666667,14.639446517255376,120,2.3E-4
9,test_20231101_134348,11079715.png,443815,132247,311568,0.702022238995978,3,4,124136,18385,105751,0.8518963072758909,16.302611555555554,1952.235056,15.225482537985677,120,2.3E-4
10,test_20231101_134348,11551286.png,271883,1462,270421,0.9946226869646134,2,4,40092,215,39877,0.9946373341314976,15.664478222222222,1460.3968373333332,16.48609477106633,120,2.3E-4
1,test_20231101_134348,10404007.png,502730,27377,475353,0.9455433333996379,2,4,61265,3948,57317,0.9355586387007263,24.98091911111111,3241.6444,13.02314988723095,120,2.4E-4
2,test_20231101_134348,1254659.png,342646,84372,258274,0.7537633592687497,3,4,80080,11681,68399,0.8541333666333666,19.952688,2913.615216,13.48648164361196,120,2.4E-4
3,test_20231101_134348,10188041.png,221231,11047,210184,0.9500657683597687,2,4,41731,1550,40181,0.9628573482542954,10.226010666666667,952.9778293333334,18.33997563807963,120,2.4E-4
4,test_20231101_134348,10287332.png,216980,13662,203318,0.93703567149046,2,3,22337,1864,20473,0.9165510140126247,9.250581333333333,731.4470933333333,19.488974424426054,120,2.4E-4
5,test_20231101_134348,11610969.png,368720,31817,336903,0.9137095899327403,2,3,84111,4634,79477,0.9449061359394134,18.97863288888889,2421.380016,14.290174070724388,120,2.4E-4
6,test_20231101_134348,10350842.png,212614,7712,204902,0.9637276943192828,2,3,42529,1131,41398,0.9734063815278986,16.956055111111112,1855.6201013333334,15.445912924238282,120,2.4E-4
7,test_20231101_134348,10863862.png,317432,15377,302055,0.9515581289851055,2,3,66058,2195,63863,0.9667716249356626,23.047130666666668,3065.621008,13.26561897338453,120,2.4E-4
8,test_20231101_134348,11382381.png,312486,1259,311227,0.9959710195016737,2,4,46745,169,46576,0.9963846400684565,20.086165333333334,2234.270282666667,14.639446517255376,120,2.4E-4
9,test_20231101_134348,11079715.png,443815,132247,311568,0.702022238995978,4,4,124136,18385,105751,0.8518963072758909,16.302611555555554,1952.235056,15.225482537985677,120,2.4E-4
10,test_20231101_134348,11551286.png,271883,1462,270421,0.9946226869646134,2,3,40092,215,39877,0.9946373341314976,15.664478222222222,1460.3968373333332,16.48609477106633,120,2.4E-4
1,test_20231101_134349,10404007.png,502730,27377,475353,0.9455433333996379,3,4,61265,3948,57317,0.9355586387007263,24.98091911111111,3241.6444,13.02314988723095,120,2.5E-4
2,test_20231101_134349,1254659.png,342646,84372,258274,0.7537633592687497,3,4,80080,11681,68399,0.8541333666333666,19.952688,2913.615216,13.48648164361196,120,2.5E-4
3,test_20231101_134349,10188041.png,221231,11047,210184,0.9500657683597687,2,4,41731,1550,40181,0.9628573482542954,10.226010666666667,952.9778293333334,18.33997563807963,120,2.5E-4
4,test_20231101_134349,10287332.png,216980,13662,203318,0.93703567149046,2,4,22337,1864,20473,0.9165510140126247,9.250581333333333,731.4470933333333,19.488974424426054,120,2.5E-4
5,test_20231101_134349,11610969.png,368720,31817,336903,0.9137095899327403,3,4,84111,4634,79477,0.9449061359394134,18.97863288888889,2421.380016,14.290174070724388,120,2.5E-4
6,test_20231101_134349,10350842.png,212614,7712,204902,0.9637276943192828,1,4,42529,1131,41398,0.9734063815278986,16.956055111111112,1855.6201013333334,15.445912924238282,120,2.5E-4
7,test_20231101_134349,10863862.png,317432,15377,302055,0.9515581289851055,2,4,66058,2195,63863,0.9667716249356626,23.047130666666668,3065.621008,13.26561897338453,120,2.5E-4
8,test_20231101_134349,11382381.png,312486,1259,311227,0.9959710195016737,2,4,46745,169,46576,0.9963846400684565,20.086165333333334,2234.270282666667,14.639446517255376,120,2.5E-4
9,test_20231101_134349,11079715.png,443815,132247,311568,0.702022238995978,4,4,124136,18385,105751,0.8518963072758909,16.302611555555554,1952.235056,15.225482537985677,120,2.5E-4
10,test_20231101_134349,11551286.png,271883,1462,270421,0.9946226869646134,2,4,40092,215,39877,0.9946373341314976,15.664478222222222,1460.3968373333332,16.48609477106633,120,2.5E-4
1,test_20231101_134350,10404007.png,502730,27237,475493,0.9458218129015575,2,3,61265,3928,57337,0.9358850893658696,24.993056,3243.490410666667,13.020677425852345,120,2.6000000000000003E-4
2,test_20231101_134350,1254659.png,342646,84312,258334,0.7539384671059928,3,4,80080,11676,68404,0.8541958041958042,19.962241777777777,2914.6974026666667,13.484868869095994,120,2.6000000000000003E-4
3,test_20231101_134350,10188041.png,221231,10967,210264,0.9504273813344423,2,4,41731,1538,40193,0.9631449042678105,10.379212444444445,973.5932853333334,18.247027908726242,120,2.6000000000000003E-4
4,test_20231101_134350,10287332.png,216980,13642,203338,0.9371278458844133,1,3,22337,1861,20476,0.9166853203205444,9.321923555555555,744.2019093333333,19.413895809498406,120,2.6000000000000003E-4
5,test_20231101_134350,11610969.png,368720,31657,337063,0.9141435235408982,2,4,84111,4612,79499,0.9451676950696104,19.394017777777776,2513.8691893333335,14.127376856996587,120,2.6000000000000003E-4
6,test_20231101_134350,10350842.png,212614,7572,205042,0.9643861645987565,2,4,42529,1110,41419,0.9739001622422347,17.484805333333334,1967.9161866666666,15.190737629327984,120,2.6000000000000003E-4
7,test_20231101_134350,10863862.png,317432,15277,302155,0.951873157085612,2,4,66058,2180,63878,0.9669986981137788,23.077662222222223,3070.805008,13.258281206665272,120,2.6000000000000003E-4
8,test_20231101_134350,11382381.png,312486,1219,311267,0.9960990252363305,2,4,46745,163,46582,0.9965129960423574,20.394026666666665,2297.468352,14.518308232456395,120,2.6000000000000003E-4
9,test_20231101_134350,11079715.png,443815,132247,311568,0.702022238995978,4,4,124136,18385,105751,0.8518963072758909,16.302611555555554,1952.235056,15.225482537985677,120,2.6000000000000003E-4
10,test_20231101_134350,11551286.png,271883,1302,270581,0.9952111753952987,2,4,40092,191,39901,0.9952359572982141,16.06636622222222,1535.6389493333334,16.267912420109646,120,2.6000000000000003E-4
1,test_20231101_134350,10404007.png,502730,27237,475493,0.9458218129015575,3,4,61265,3928,57337,0.9358850893658696,24.993056,3243.490410666667,13.020677425852345,120,2.7000000000000006E-4
2,test_20231101_134350,1254659.png,342646,84312,258334,0.7539384671059928,3,4,80080,11676,68404,0.8541958041958042,19.962241777777777,2914.6974026666667,13.484868869095994,120,2.7000000000000006E-4
3,test_20231101_134350,10188041.png,221231,10967,210264,0.9504273813344423,2,4,41731,1538,40193,0.9631449042678105,10.379212444444445,973.5932853333334,18.247027908726242,120,2.7000000000000006E-4
4,test_20231101_134350,10287332.png,216980,13642,203338,0.9371278458844133,1,4,22337,1861,20476,0.9166853203205444,9.321923555555555,744.2019093333333,19.413895809498406,120,2.7000000000000006E-4
5,test_20231101_134350,11610969.png,368720,31657,337063,0.9141435235408982,2,4,84111,4612,79499,0.9451676950696104,19.394017777777776,2513.8691893333335,14.127376856996587,120,2.7000000000000006E-4
6,test_20231101_134350,10350842.png,212614,7572,205042,0.9643861645987565,1,4,42529,1110,41419,0.9739001622422347,17.484805333333334,1967.9161866666666,15.190737629327984,120,2.7000000000000006E-4
7,test_20231101_134350,10863862.png,317432,15277,302155,0.951873157085612,2,8,66058,2180,63878,0.9669986981137788,23.077662222222223,3070.805008,13.258281206665272,120,2.7000000000000006E-4
8,test_20231101_134350,11382381.png,312486,1219,311267,0.9960990252363305,1,3,46745,163,46582,0.9965129960423574,20.394026666666665,2297.468352,14.518308232456395,120,2.7000000000000006E-4
9,test_20231101_134350,11079715.png,443815,132247,311568,0.702022238995978,4,4,124136,18385,105751,0.8518963072758909,16.302611555555554,1952.235056,15.225482537985677,120,2.7000000000000006E-4
10,test_20231101_134350,11551286.png,271883,1302,270581,0.9952111753952987,1,3,40092,191,39901,0.9952359572982141,16.06636622222222,1535.6389493333334,16.267912420109646,120,2.7000000000000006E-4
1,test_20231101_134351,10404007.png,502730,27237,475493,0.9458218129015575,3,4,61265,3928,57337,0.9358850893658696,24.993056,3243.490410666667,13.020677425852345,120,2.800000000000001E-4
2,test_20231101_134351,1254659.png,342646,84312,258334,0.7539384671059928,3,4,80080,11676,68404,0.8541958041958042,19.962241777777777,2914.6974026666667,13.484868869095994,120,2.800000000000001E-4
3,test_20231101_134351,10188041.png,221231,10967,210264,0.9504273813344423,2,4,41731,1538,40193,0.9631449042678105,10.379212444444445,973.5932853333334,18.247027908726242,120,2.800000000000001E-4
4,test_20231101_134351,10287332.png,216980,13642,203338,0.9371278458844133,1,4,22337,1861,20476,0.9166853203205444,9.321923555555555,744.2019093333333,19.413895809498406,120,2.800000000000001E-4
5,test_20231101_134351,11610969.png,368720,31657,337063,0.9141435235408982,3,3,84111,4612,79499,0.9451676950696104,19.394017777777776,2513.8691893333335,14.127376856996587,120,2.800000000000001E-4
6,test_20231101_134351,10350842.png,212614,7572,205042,0.9643861645987565,1,3,42529,1110,41419,0.9739001622422347,17.484805333333334,1967.9161866666666,15.190737629327984,120,2.800000000000001E-4
7,test_20231101_134351,10863862.png,317432,15277,302155,0.951873157085612,2,4,66058,2180,63878,0.9669986981137788,23.077662222222223,3070.805008,13.258281206665272,120,2.800000000000001E-4
8,test_20231101_134351,11382381.png,312486,1219,311267,0.9960990252363305,1,4,46745,163,46582,0.9965129960423574,20.394026666666665,2297.468352,14.518308232456395,120,2.800000000000001E-4
9,test_20231101_134351,11079715.png,443815,132247,311568,0.702022238995978,4,4,124136,18385,105751,0.8518963072758909,16.302611555555554,1952.235056,15.225482537985677,120,2.800000000000001E-4
10,test_20231101_134351,11551286.png,271883,1302,270581,0.9952111753952987,2,4,40092,191,39901,0.9952359572982141,16.06636622222222,1535.6389493333334,16.267912420109646,120,2.800000000000001E-4
1,test_20231101_134352,10404007.png,502730,27237,475493,0.9458218129015575,3,3,61265,3928,57337,0.9358850893658696,24.993056,3243.490410666667,13.020677425852345,120,2.900000000000001E-4
2,test_20231101_134352,1254659.png,342646,84312,258334,0.7539384671059928,3,4,80080,11676,68404,0.8541958041958042,19.962241777777777,2914.6974026666667,13.484868869095994,120,2.900000000000001E-4
3,test_20231101_134352,10188041.png,221231,10967,210264,0.9504273813344423,2,4,41731,1538,40193,0.9631449042678105,10.379212444444445,973.5932853333334,18.247027908726242,120,2.900000000000001E-4
4,test_20231101_134352,10287332.png,216980,13642,203338,0.9371278458844133,2,8,22337,1861,20476,0.9166853203205444,9.321923555555555,744.2019093333333,19.413895809498406,120,2.900000000000001E-4
5,test_20231101_134352,11610969.png,368720,31657,337063,0.9141435235408982,2,4,84111,4612,79499,0.9451676950696104,19.394017777777776,2513.8691893333335,14.127376856996587,120,2.900000000000001E-4
6,test_20231101_134352,10350842.png,212614,7572,205042,0.9643861645987565,2,4,42529,1110,41419,0.9739001622422347,17.484805333333334,1967.9161866666666,15.190737629327984,120,2.900000000000001E-4
7,test_20231101_134352,10863862.png,317432,15277,302155,0.951873157085612,2,3,66058,2180,63878,0.9669986981137788,23.077662222222223,3070.805008,13.258281206665272,120,2.900000000000001E-4
8,test_20231101_134352,11382381.png,312486,987,311499,0.9968414584973406,1,3,46745,131,46614,0.9971975612364958,20.862908444444443,2370.7645866666667,14.381919295331382,120,2.900000000000001E-4
9,test_20231101_134352,11079715.png,443815,132247,311568,0.702022238995978,4,5,124136,18385,105751,0.8518963072758909,16.302611555555554,1952.235056,15.225482537985677,120,2.900000000000001E-4
10,test_20231101_134352,11551286.png,271883,1302,270581,0.9952111753952987,2,4,40092,191,39901,0.9952359572982141,16.06636622222222,1535.6389493333334,16.267912420109646,120,2.900000000000001E-4
1,test_20231101_134353,10404007.png,502730,27237,475493,0.9458218129015575,3,4,61265,3928,57337,0.9358850893658696,24.993056,3243.490410666667,13.020677425852345,120,3.0000000000000014E-4
2,test_20231101_134353,1254659.png,342646,84312,258334,0.7539384671059928,2,4,80080,11676,68404,0.8541958041958042,19.962241777777777,2914.6974026666667,13.484868869095994,120,3.0000000000000014E-4
3,test_20231101_134353,10188041.png,221231,10967,210264,0.9504273813344423,2,4,41731,1538,40193,0.9631449042678105,10.379212444444445,973.5932853333334,18.247027908726242,120,3.0000000000000014E-4
4,test_20231101_134353,10287332.png,216980,13642,203338,0.9371278458844133,2,3,22337,1861,20476,0.9166853203205444,9.321923555555555,744.2019093333333,19.413895809498406,120,3.0000000000000014E-4
5,test_20231101_134353,11610969.png,368720,31657,337063,0.9141435235408982,3,4,84111,4612,79499,0.9451676950696104,19.394017777777776,2513.8691893333335,14.127376856996587,120,3.0000000000000014E-4
6,test_20231101_134353,10350842.png,212614,7572,205042,0.9643861645987565,1,4,42529,1110,41419,0.9739001622422347,17.484805333333334,1967.9161866666666,15.190737629327984,120,3.0000000000000014E-4
7,test_20231101_134353,10863862.png,317432,15277,302155,0.951873157085612,2,4,66058,2180,63878,0.9669986981137788,23.077662222222223,3070.805008,13.258281206665272,120,3.0000000000000014E-4
8,test_20231101_134353,11382381.png,312486,987,311499,0.9968414584973406,1,4,46745,131,46614,0.9971975612364958,20.862908444444443,2370.7645866666667,14.381919295331382,120,3.0000000000000014E-4
9,test_20231101_134353,11079715.png,443815,132247,311568,0.702022238995978,3,4,124136,18385,105751,0.8518963072758909,16.302611555555554,1952.235056,15.225482537985677,120,3.0000000000000014E-4
10,test_20231101_134353,11551286.png,271883,1302,270581,0.9952111753952987,1,3,40092,191,39901,0.9952359572982141,16.06636622222222,1535.6389493333334,16.267912420109646,120,3.0000000000000014E-4
1,test_20231101_134353,10404007.png,502730,27237,475493,0.9458218129015575,2,4,61265,3928,57337,0.9358850893658696,24.993056,3243.490410666667,13.020677425852345,120,3.1000000000000016E-4
2,test_20231101_134353,1254659.png,342646,84312,258334,0.7539384671059928,3,4,80080,11676,68404,0.8541958041958042,19.962241777777777,2914.6974026666667,13.484868869095994,120,3.1000000000000016E-4
3,test_20231101_134353,10188041.png,221231,10967,210264,0.9504273813344423,2,3,41731,1538,40193,0.9631449042678105,10.379212444444445,973.5932853333334,18.247027908726242,120,3.1000000000000016E-4
4,test_20231101_134353,10287332.png,216980,13642,203338,0.9371278458844133,2,4,22337,1861,20476,0.9166853203205444,9.321923555555555,744.2019093333333,19.413895809498406,120,3.1000000000000016E-4
5,test_20231101_134353,11610969.png,368720,31657,337063,0.9141435235408982,2,4,84111,4612,79499,0.9451676950696104,19.394017777777776,2513.8691893333335,14.127376856996587,120,3.1000000000000016E-4
6,test_20231101_134353,10350842.png,212614,7572,205042,0.9643861645987565,2,3,42529,1110,41419,0.9739001622422347,17.484805333333334,1967.9161866666666,15.190737629327984,120,3.1000000000000016E-4
7,test_20231101_134353,10863862.png,317432,15277,302155,0.951873157085612,2,3,66058,2180,63878,0.9669986981137788,23.077662222222223,3070.805008,13.258281206665272,120,3.1000000000000016E-4
8,test_20231101_134353,11382381.png,312486,987,311499,0.9968414584973406,1,4,46745,131,46614,0.9971975612364958,20.862908444444443,2370.7645866666667,14.381919295331382,120,3.1000000000000016E-4
9,test_20231101_134353,11079715.png,443815,132247,311568,0.702022238995978,4,5,124136,18385,105751,0.8518963072758909,16.302611555555554,1952.235056,15.225482537985677,120,3.1000000000000016E-4
10,test_20231101_134353,11551286.png,271883,967,270916,0.996443323047046,1,4,40092,142,39950,0.9964581462635937,16.350040888888888,1580.305472,16.14339316963399,120,3.1000000000000016E-4
1,test_20231101_134354,10404007.png,502730,27237,475493,0.9458218129015575,2,4,61265,3928,57337,0.9358850893658696,24.993056,3243.490410666667,13.020677425852345,120,3.200000000000002E-4
2,test_20231101_134354,1254659.png,342646,84312,258334,0.7539384671059928,3,4,80080,11676,68404,0.8541958041958042,19.962241777777777,2914.6974026666667,13.484868869095994,120,3.200000000000002E-4
3,test_20231101_134354,10188041.png,221231,10967,210264,0.9504273813344423,2,3,41731,1538,40193,0.9631449042678105,10.379212444444445,973.5932853333334,18.247027908726242,120,3.200000000000002E-4
4,test_20231101_134354,10287332.png,216980,13642,203338,0.9371278458844133,2,4,22337,1861,20476,0.9166853203205444,9.321923555555555,744.2019093333333,19.413895809498406,120,3.200000000000002E-4
5,test_20231101_134354,11610969.png,368720,31657,337063,0.9141435235408982,2,4,84111,4612,79499,0.9451676950696104,19.394017777777776,2513.8691893333335,14.127376856996587,120,3.200000000000002E-4
6,test_20231101_134354,10350842.png,212614,7572,205042,0.9643861645987565,2,3,42529,1110,41419,0.9739001622422347,17.484805333333334,1967.9161866666666,15.190737629327984,120,3.200000000000002E-4
7,test_20231101_134354,10863862.png,317432,15277,302155,0.951873157085612,2,3,66058,2180,63878,0.9669986981137788,23.077662222222223,3070.805008,13.258281206665272,120,3.200000000000002E-4
8,test_20231101_134354,11382381.png,312486,847,311639,0.9972894785686399,1,3,46745,110,46635,0.9976468071451492,21.358711111111113,2440.977456,14.2551659242164,120,3.200000000000002E-4
9,test_20231101_134354,11079715.png,443815,132247,311568,0.702022238995978,4,4,124136,18385,105751,0.8518963072758909,16.302611555555554,1952.235056,15.225482537985677,120,3.200000000000002E-4
10,test_20231101_134354,11551286.png,271883,947,270936,0.9965168841008817,2,4,40092,139,39953,0.9965329741594333,16.59003911111111,1625.298352,16.021472658706333,120,3.200000000000002E-4
1,test_20231101_134355,10404007.png,502730,27237,475493,0.9458218129015575,2,4,61265,3928,57337,0.9358850893658696,24.993056,3243.490410666667,13.020677425852345,120,3.300000000000002E-4
2,test_20231101_134355,1254659.png,342646,84312,258334,0.7539384671059928,3,4,80080,11676,68404,0.8541958041958042,19.962241777777777,2914.6974026666667,13.484868869095994,120,3.300000000000002E-4
3,test_20231101_134355,10188041.png,221231,10967,210264,0.9504273813344423,3,4,41731,1538,40193,0.9631449042678105,10.379212444444445,973.5932853333334,18.247027908726242,120,3.300000000000002E-4
4,test_20231101_134355,10287332.png,216980,13642,203338,0.9371278458844133,2,4,22337,1861,20476,0.9166853203205444,9.321923555555555,744.2019093333333,19.413895809498406,120,3.300000000000002E-4
5,test_20231101_134355,11610969.png,368720,31657,337063,0.9141435235408982,2,4,84111,4612,79499,0.9451676950696104,19.394017777777776,2513.8691893333335,14.127376856996587,120,3.300000000000002E-4
6,test_20231101_134355,10350842.png,212614,7572,205042,0.9643861645987565,1,4,42529,1110,41419,0.9739001622422347,17.484805333333334,1967.9161866666666,15.190737629327984,120,3.300000000000002E-4
7,test_20231101_134355,10863862.png,317432,15277,302155,0.951873157085612,2,4,66058,2180,63878,0.9669986981137788,23.077662222222223,3070.805008,13.258281206665272,120,3.300000000000002E-4
8,test_20231101_134355,11382381.png,312486,847,311639,0.9972894785686399,1,3,46745,110,46635,0.9976468071451492,21.358711111111113,2440.977456,14.2551659242164,120,3.300000000000002E-4
9,test_20231101_134355,11079715.png,443815,132247,311568,0.702022238995978,3,4,124136,18385,105751,0.8518963072758909,16.302611555555554,1952.235056,15.225482537985677,120,3.300000000000002E-4
10,test_20231101_134355,11551286.png,271883,947,270936,0.9965168841008817,1,4,40092,139,39953,0.9965329741594333,16.59003911111111,1625.298352,16.021472658706333,120,3.300000000000002E-4
1,test_20231101_134355,10404007.png,502730,27237,475493,0.9458218129015575,2,3,61265,3928,57337,0.9358850893658696,24.993056,3243.490410666667,13.020677425852345,120,3.4000000000000024E-4
2,test_20231101_134355,1254659.png,342646,84312,258334,0.7539384671059928,3,4,80080,11676,68404,0.8541958041958042,19.962241777777777,2914.6974026666667,13.484868869095994,120,3.4000000000000024E-4
3,test_20231101_134355,10188041.png,221231,10967,210264,0.9504273813344423,2,4,41731,1538,40193,0.9631449042678105,10.379212444444445,973.5932853333334,18.247027908726242,120,3.4000000000000024E-4
4,test_20231101_134355,10287332.png,216980,13642,203338,0.9371278458844133,2,4,22337,1861,20476,0.9166853203205444,9.321923555555555,744.2019093333333,19.413895809498406,120,3.4000000000000024E-4
5,test_20231101_134355,11610969.png,368720,31657,337063,0.9141435235408982,2,3,84111,4612,79499,0.9451676950696104,19.394017777777776,2513.8691893333335,14.127376856996587,120,3.4000000000000024E-4
6,test_20231101_134355,10350842.png,212614,7572,205042,0.9643861645987565,2,4,42529,1110,41419,0.9739001622422347,17.484805333333334,1967.9161866666666,15.190737629327984,120,3.4000000000000024E-4
7,test_20231101_134355,10863862.png,317432,15277,302155,0.951873157085612,2,3,66058,2180,63878,0.9669986981137788,23.077662222222223,3070.805008,13.258281206665272,120,3.4000000000000024E-4
8,test_20231101_134355,11382381.png,312486,847,311639,0.9972894785686399,1,3,46745,110,46635,0.9976468071451492,21.358711111111113,2440.977456,14.2551659242164,120,3.4000000000000024E-4
9,test_20231101_134355,11079715.png,443815,132247,311568,0.702022238995978,3,5,124136,18385,105751,0.8518963072758909,16.302611555555554,1952.235056,15.225482537985677,120,3.4000000000000024E-4
10,test_20231101_134355,11551286.png,271883,947,270936,0.9965168841008817,2,10,40092,139,39953,0.9965329741594333,16.59003911111111,1625.298352,16.021472658706333,120,3.4000000000000024E-4
1,test_20231101_134356,10404007.png,502730,27237,475493,0.9458218129015575,3,3,61265,3928,57337,0.9358850893658696,24.993056,3243.490410666667,13.020677425852345,120,3.5000000000000027E-4
2,test_20231101_134356,1254659.png,342646,84312,258334,0.7539384671059928,3,4,80080,11676,68404,0.8541958041958042,19.962241777777777,2914.6974026666667,13.484868869095994,120,3.5000000000000027E-4
3,test_20231101_134356,10188041.png,221231,10967,210264,0.9504273813344423,2,4,41731,1538,40193,0.9631449042678105,10.379212444444445,973.5932853333334,18.247027908726242,120,3.5000000000000027E-4
4,test_20231101_134356,10287332.png,216980,13642,203338,0.9371278458844133,2,4,22337,1861,20476,0.9166853203205444,9.321923555555555,744.2019093333333,19.413895809498406,120,3.5000000000000027E-4
5,test_20231101_134356,11610969.png,368720,31657,337063,0.9141435235408982,3,4,84111,4612,79499,0.9451676950696104,19.394017777777776,2513.8691893333335,14.127376856996587,120,3.5000000000000027E-4
6,test_20231101_134356,10350842.png,212614,7572,205042,0.9643861645987565,1,3,42529,1110,41419,0.9739001622422347,17.484805333333334,1967.9161866666666,15.190737629327984,120,3.5000000000000027E-4
7,test_20231101_134356,10863862.png,317432,15277,302155,0.951873157085612,2,4,66058,2180,63878,0.9669986981137788,23.077662222222223,3070.805008,13.258281206665272,120,3.5000000000000027E-4
8,test_20231101_134356,11382381.png,312486,847,311639,0.9972894785686399,1,4,46745,110,46635,0.9976468071451492,21.358711111111113,2440.977456,14.2551659242164,120,3.5000000000000027E-4
9,test_20231101_134356,11079715.png,443815,132247,311568,0.702022238995978,9,5,124136,18385,105751,0.8518963072758909,16.302611555555554,1952.235056,15.225482537985677,120,3.5000000000000027E-4
10,test_20231101_134356,11551286.png,271883,947,270936,0.9965168841008817,1,4,40092,139,39953,0.9965329741594333,16.59003911111111,1625.298352,16.021472658706333,120,3.5000000000000027E-4
1,test_20231101_134357,10404007.png,502730,27237,475493,0.9458218129015575,2,3,61265,3928,57337,0.9358850893658696,24.993056,3243.490410666667,13.020677425852345,120,3.600000000000003E-4
2,test_20231101_134357,1254659.png,342646,84312,258334,0.7539384671059928,3,4,80080,11676,68404,0.8541958041958042,19.962241777777777,2914.6974026666667,13.484868869095994,120,3.600000000000003E-4
3,test_20231101_134357,10188041.png,221231,10967,210264,0.9504273813344423,2,3,41731,1538,40193,0.9631449042678105,10.379212444444445,973.5932853333334,18.247027908726242,120,3.600000000000003E-4
4,test_20231101_134357,10287332.png,216980,13642,203338,0.9371278458844133,1,4,22337,1861,20476,0.9166853203205444,9.321923555555555,744.2019093333333,19.413895809498406,120,3.600000000000003E-4
5,test_20231101_134357,11610969.png,368720,31657,337063,0.9141435235408982,3,4,84111,4612,79499,0.9451676950696104,19.394017777777776,2513.8691893333335,14.127376856996587,120,3.600000000000003E-4
6,test_20231101_134357,10350842.png,212614,7572,205042,0.9643861645987565,1,4,42529,1110,41419,0.9739001622422347,17.484805333333334,1967.9161866666666,15.190737629327984,120,3.600000000000003E-4
7,test_20231101_134357,10863862.png,317432,15277,302155,0.951873157085612,2,4,66058,2180,63878,0.9669986981137788,23.077662222222223,3070.805008,13.258281206665272,120,3.600000000000003E-4
8,test_20231101_134357,11382381.png,312486,847,311639,0.9972894785686399,2,3,46745,110,46635,0.9976468071451492,21.358711111111113,2440.977456,14.2551659242164,120,3.600000000000003E-4
9,test_20231101_134357,11079715.png,443815,132247,311568,0.702022238995978,3,5,124136,18385,105751,0.8518963072758909,16.302611555555554,1952.235056,15.225482537985677,120,3.600000000000003E-4
10,test_20231101_134357,11551286.png,271883,947,270936,0.9965168841008817,2,3,40092,139,39953,0.9965329741594333,16.59003911111111,1625.298352,16.021472658706333,120,3.600000000000003E-4
1,test_20231101_134357,10404007.png,502730,27237,475493,0.9458218129015575,2,4,61265,3928,57337,0.9358850893658696,24.993056,3243.490410666667,13.020677425852345,120,3.700000000000003E-4
2,test_20231101_134357,1254659.png,342646,84312,258334,0.7539384671059928,3,4,80080,11676,68404,0.8541958041958042,19.962241777777777,2914.6974026666667,13.484868869095994,120,3.700000000000003E-4
3,test_20231101_134357,10188041.png,221231,10967,210264,0.9504273813344423,2,3,41731,1538,40193,0.9631449042678105,10.379212444444445,973.5932853333334,18.247027908726242,120,3.700000000000003E-4
4,test_20231101_134357,10287332.png,216980,13642,203338,0.9371278458844133,1,4,22337,1861,20476,0.9166853203205444,9.321923555555555,744.2019093333333,19.413895809498406,120,3.700000000000003E-4
5,test_20231101_134357,11610969.png,368720,31657,337063,0.9141435235408982,2,4,84111,4612,79499,0.9451676950696104,19.394017777777776,2513.8691893333335,14.127376856996587,120,3.700000000000003E-4
6,test_20231101_134357,10350842.png,212614,7572,205042,0.9643861645987565,1,4,42529,1110,41419,0.9739001622422347,17.484805333333334,1967.9161866666666,15.190737629327984,120,3.700000000000003E-4
7,test_20231101_134357,10863862.png,317432,15277,302155,0.951873157085612,2,4,66058,2180,63878,0.9669986981137788,23.077662222222223,3070.805008,13.258281206665272,120,3.700000000000003E-4
8,test_20231101_134357,11382381.png,312486,847,311639,0.9972894785686399,1,3,46745,110,46635,0.9976468071451492,21.358711111111113,2440.977456,14.2551659242164,120,3.700000000000003E-4
9,test_20231101_134357,11079715.png,443815,132247,311568,0.702022238995978,4,4,124136,18385,105751,0.8518963072758909,16.302611555555554,1952.235056,15.225482537985677,120,3.700000000000003E-4
10,test_20231101_134357,11551286.png,271883,947,270936,0.9965168841008817,1,3,40092,139,39953,0.9965329741594333,16.59003911111111,1625.298352,16.021472658706333,120,3.700000000000003E-4
1,test_20231101_134358,10404007.png,502730,27237,475493,0.9458218129015575,2,3,61265,3928,57337,0.9358850893658696,24.993056,3243.490410666667,13.020677425852345,120,3.8000000000000035E-4
2,test_20231101_134358,1254659.png,342646,84312,258334,0.7539384671059928,3,4,80080,11676,68404,0.8541958041958042,19.962241777777777,2914.6974026666667,13.484868869095994,120,3.8000000000000035E-4
3,test_20231101_134358,10188041.png,221231,10967,210264,0.9504273813344423,2,4,41731,1538,40193,0.9631449042678105,10.379212444444445,973.5932853333334,18.247027908726242,120,3.8000000000000035E-4
4,test_20231101_134358,10287332.png,216980,13642,203338,0.9371278458844133,2,4,22337,1861,20476,0.9166853203205444,9.321923555555555,744.2019093333333,19.413895809498406,120,3.8000000000000035E-4
5,test_20231101_134358,11610969.png,368720,31657,337063,0.9141435235408982,2,4,84111,4612,79499,0.9451676950696104,19.394017777777776,2513.8691893333335,14.127376856996587,120,3.8000000000000035E-4
6,test_20231101_134358,10350842.png,212614,7572,205042,0.9643861645987565,2,4,42529,1110,41419,0.9739001622422347,17.484805333333334,1967.9161866666666,15.190737629327984,120,3.8000000000000035E-4
7,test_20231101_134358,10863862.png,317432,15277,302155,0.951873157085612,2,4,66058,2180,63878,0.9669986981137788,23.077662222222223,3070.805008,13.258281206665272,120,3.8000000000000035E-4
8,test_20231101_134358,11382381.png,312486,847,311639,0.9972894785686399,1,3,46745,110,46635,0.9976468071451492,21.358711111111113,2440.977456,14.2551659242164,120,3.8000000000000035E-4
9,test_20231101_134358,11079715.png,443815,132247,311568,0.702022238995978,3,4,124136,18385,105751,0.8518963072758909,16.302611555555554,1952.235056,15.225482537985677,120,3.8000000000000035E-4
10,test_20231101_134358,11551286.png,271883,947,270936,0.9965168841008817,1,3,40092,139,39953,0.9965329741594333,16.59003911111111,1625.298352,16.021472658706333,120,3.8000000000000035E-4
1,test_20231101_134359,10404007.png,502730,27237,475493,0.9458218129015575,3,4,61265,3928,57337,0.9358850893658696,24.993056,3243.490410666667,13.020677425852345,120,3.9000000000000037E-4
2,test_20231101_134359,1254659.png,342646,84312,258334,0.7539384671059928,3,4,80080,11676,68404,0.8541958041958042,19.962241777777777,2914.6974026666667,13.484868869095994,120,3.9000000000000037E-4
3,test_20231101_134359,10188041.png,221231,10967,210264,0.9504273813344423,2,3,41731,1538,40193,0.9631449042678105,10.379212444444445,973.5932853333334,18.247027908726242,120,3.9000000000000037E-4
4,test_20231101_134359,10287332.png,216980,13642,203338,0.9371278458844133,1,3,22337,1861,20476,0.9166853203205444,9.321923555555555,744.2019093333333,19.413895809498406,120,3.9000000000000037E-4
5,test_20231101_134359,11610969.png,368720,31657,337063,0.9141435235408982,2,4,84111,4612,79499,0.9451676950696104,19.394017777777776,2513.8691893333335,14.127376856996587,120,3.9000000000000037E-4
6,test_20231101_134359,10350842.png,212614,7572,205042,0.9643861645987565,2,4,42529,1110,41419,0.9739001622422347,17.484805333333334,1967.9161866666666,15.190737629327984,120,3.9000000000000037E-4
7,test_20231101_134359,10863862.png,317432,15277,302155,0.951873157085612,2,4,66058,2180,63878,0.9669986981137788,23.077662222222223,3070.805008,13.258281206665272,120,3.9000000000000037E-4
8,test_20231101_134359,11382381.png,312486,847,311639,0.9972894785686399,1,4,46745,110,46635,0.9976468071451492,21.358711111111113,2440.977456,14.2551659242164,120,3.9000000000000037E-4
9,test_20231101_134359,11079715.png,443815,132247,311568,0.702022238995978,3,4,124136,18385,105751,0.8518963072758909,16.302611555555554,1952.235056,15.225482537985677,120,3.9000000000000037E-4
10,test_20231101_134359,11551286.png,271883,647,271236,0.9976202999084165,1,4,40092,94,39998,0.9976553925970268,17.770117333333335,1836.7047093333333,15.490410213370003,120,3.9000000000000037E-4
1,test_20231101_134359,10404007.png,502730,27237,475493,0.9458218129015575,5,4,61265,3928,57337,0.9358850893658696,24.993056,3243.490410666667,13.020677425852345,120,4.000000000000004E-4
2,test_20231101_134359,1254659.png,342646,84312,258334,0.7539384671059928,3,4,80080,11676,68404,0.8541958041958042,19.962241777777777,2914.6974026666667,13.484868869095994,120,4.000000000000004E-4
3,test_20231101_134359,10188041.png,221231,10967,210264,0.9504273813344423,2,4,41731,1538,40193,0.9631449042678105,10.379212444444445,973.5932853333334,18.247027908726242,120,4.000000000000004E-4
4,test_20231101_134359,10287332.png,216980,13642,203338,0.9371278458844133,2,4,22337,1861,20476,0.9166853203205444,9.321923555555555,744.2019093333333,19.413895809498406,120,4.000000000000004E-4
5,test_20231101_134359,11610969.png,368720,31657,337063,0.9141435235408982,2,4,84111,4612,79499,0.9451676950696104,19.394017777777776,2513.8691893333335,14.127376856996587,120,4.000000000000004E-4
6,test_20231101_134359,10350842.png,212614,7572,205042,0.9643861645987565,2,3,42529,1110,41419,0.9739001622422347,17.484805333333334,1967.9161866666666,15.190737629327984,120,4.000000000000004E-4
7,test_20231101_134359,10863862.png,317432,15277,302155,0.951873157085612,1,3,66058,2180,63878,0.9669986981137788,23.077662222222223,3070.805008,13.258281206665272,120,4.000000000000004E-4
8,test_20231101_134359,11382381.png,312486,847,311639,0.9972894785686399,1,3,46745,110,46635,0.9976468071451492,21.358711111111113,2440.977456,14.2551659242164,120,4.000000000000004E-4
9,test_20231101_134359,11079715.png,443815,132247,311568,0.702022238995978,4,4,124136,18385,105751,0.8518963072758909,16.302611555555554,1952.235056,15.225482537985677,120,4.000000000000004E-4
10,test_20231101_134359,11551286.png,271883,647,271236,0.9976202999084165,1,3,40092,94,39998,0.9976553925970268,17.770117333333335,1836.7047093333333,15.490410213370003,120,4.000000000000004E-4
1,test_20231101_134400,10404007.png,502730,27237,475493,0.9458218129015575,2,4,61265,3928,57337,0.9358850893658696,24.993056,3243.490410666667,13.020677425852345,120,4.100000000000004E-4
2,test_20231101_134400,1254659.png,342646,84312,258334,0.7539384671059928,3,4,80080,11676,68404,0.8541958041958042,19.962241777777777,2914.6974026666667,13.484868869095994,120,4.100000000000004E-4
3,test_20231101_134400,10188041.png,221231,10967,210264,0.9504273813344423,1,3,41731,1538,40193,0.9631449042678105,10.379212444444445,973.5932853333334,18.247027908726242,120,4.100000000000004E-4
4,test_20231101_134400,10287332.png,216980,13642,203338,0.9371278458844133,2,4,22337,1861,20476,0.9166853203205444,9.321923555555555,744.2019093333333,19.413895809498406,120,4.100000000000004E-4
5,test_20231101_134400,11610969.png,368720,31657,337063,0.9141435235408982,2,3,84111,4612,79499,0.9451676950696104,19.394017777777776,2513.8691893333335,14.127376856996587,120,4.100000000000004E-4
6,test_20231101_134400,10350842.png,212614,7572,205042,0.9643861645987565,1,3,42529,1110,41419,0.9739001622422347,17.484805333333334,1967.9161866666666,15.190737629327984,120,4.100000000000004E-4
7,test_20231101_134400,10863862.png,317432,15277,302155,0.951873157085612,2,4,66058,2180,63878,0.9669986981137788,23.077662222222223,3070.805008,13.258281206665272,120,4.100000000000004E-4
8,test_20231101_134400,11382381.png,312486,847,311639,0.9972894785686399,1,4,46745,110,46635,0.9976468071451492,21.358711111111113,2440.977456,14.2551659242164,120,4.100000000000004E-4
9,test_20231101_134400,11079715.png,443815,132247,311568,0.702022238995978,3,4,124136,18385,105751,0.8518963072758909,16.302611555555554,1952.235056,15.225482537985677,120,4.100000000000004E-4
10,test_20231101_134400,11551286.png,271883,647,271236,0.9976202999084165,2,3,40092,94,39998,0.9976553925970268,17.770117333333335,1836.7047093333333,15.490410213370003,120,4.100000000000004E-4
1,test_20231101_134401,10404007.png,502730,27237,475493,0.9458218129015575,2,4,61265,3928,57337,0.9358850893658696,24.993056,3243.490410666667,13.020677425852345,120,4.2000000000000045E-4
2,test_20231101_134401,1254659.png,342646,84312,258334,0.7539384671059928,3,4,80080,11676,68404,0.8541958041958042,19.962241777777777,2914.6974026666667,13.484868869095994,120,4.2000000000000045E-4
3,test_20231101_134401,10188041.png,221231,10967,210264,0.9504273813344423,2,4,41731,1538,40193,0.9631449042678105,10.379212444444445,973.5932853333334,18.247027908726242,120,4.2000000000000045E-4
4,test_20231101_134401,10287332.png,216980,13642,203338,0.9371278458844133,2,4,22337,1861,20476,0.9166853203205444,9.321923555555555,744.2019093333333,19.413895809498406,120,4.2000000000000045E-4
5,test_20231101_134401,11610969.png,368720,31657,337063,0.9141435235408982,3,4,84111,4612,79499,0.9451676950696104,19.394017777777776,2513.8691893333335,14.127376856996587,120,4.2000000000000045E-4
6,test_20231101_134401,10350842.png,212614,7572,205042,0.9643861645987565,1,3,42529,1110,41419,0.9739001622422347,17.484805333333334,1967.9161866666666,15.190737629327984,120,4.2000000000000045E-4
7,test_20231101_134401,10863862.png,317432,15277,302155,0.951873157085612,2,4,66058,2180,63878,0.9669986981137788,23.077662222222223,3070.805008,13.258281206665272,120,4.2000000000000045E-4
8,test_20231101_134401,11382381.png,312486,847,311639,0.9972894785686399,2,4,46745,110,46635,0.9976468071451492,21.358711111111113,2440.977456,14.2551659242164,120,4.2000000000000045E-4
9,test_20231101_134401,11079715.png,443815,132247,311568,0.702022238995978,4,5,124136,18385,105751,0.8518963072758909,16.302611555555554,1952.235056,15.225482537985677,120,4.2000000000000045E-4
10,test_20231101_134401,11551286.png,271883,647,271236,0.9976202999084165,2,3,40092,94,39998,0.9976553925970268,17.770117333333335,1836.7047093333333,15.490410213370003,120,4.2000000000000045E-4
1,test_20231101_134401,10404007.png,502730,27237,475493,0.9458218129015575,2,4,61265,3928,57337,0.9358850893658696,24.993056,3243.490410666667,13.020677425852345,120,4.300000000000005E-4
2,test_20231101_134401,1254659.png,342646,84312,258334,0.7539384671059928,2,4,80080,11676,68404,0.8541958041958042,19.962241777777777,2914.6974026666667,13.484868869095994,120,4.300000000000005E-4
3,test_20231101_134401,10188041.png,221231,10967,210264,0.9504273813344423,2,12,41731,1538,40193,0.9631449042678105,10.379212444444445,973.5932853333334,18.247027908726242,120,4.300000000000005E-4
4,test_20231101_134401,10287332.png,216980,13642,203338,0.9371278458844133,1,4,22337,1861,20476,0.9166853203205444,9.321923555555555,744.2019093333333,19.413895809498406,120,4.300000000000005E-4
5,test_20231101_134401,11610969.png,368720,31657,337063,0.9141435235408982,3,4,84111,4612,79499,0.9451676950696104,19.394017777777776,2513.8691893333335,14.127376856996587,120,4.300000000000005E-4
6,test_20231101_134401,10350842.png,212614,7572,205042,0.9643861645987565,1,4,42529,1110,41419,0.9739001622422347,17.484805333333334,1967.9161866666666,15.190737629327984,120,4.300000000000005E-4
7,test_20231101_134401,10863862.png,317432,15277,302155,0.951873157085612,2,3,66058,2180,63878,0.9669986981137788,23.077662222222223,3070.805008,13.258281206665272,120,4.300000000000005E-4
8,test_20231101_134401,11382381.png,312486,847,311639,0.9972894785686399,1,4,46745,110,46635,0.9976468071451492,21.358711111111113,2440.977456,14.2551659242164,120,4.300000000000005E-4
9,test_20231101_134401,11079715.png,443815,132247,311568,0.702022238995978,3,5,124136,18385,105751,0.8518963072758909,16.302611555555554,1952.235056,15.225482537985677,120,4.300000000000005E-4
10,test_20231101_134401,11551286.png,271883,647,271236,0.9976202999084165,1,4,40092,94,39998,0.9976553925970268,17.770117333333335,1836.7047093333333,15.490410213370003,120,4.300000000000005E-4
1,test_20231101_134402,10404007.png,502730,27237,475493,0.9458218129015575,2,4,61265,3928,57337,0.9358850893658696,24.993056,3243.490410666667,13.020677425852345,120,4.400000000000005E-4
2,test_20231101_134402,1254659.png,342646,84312,258334,0.7539384671059928,3,4,80080,11676,68404,0.8541958041958042,19.962241777777777,2914.6974026666667,13.484868869095994,120,4.400000000000005E-4
3,test_20231101_134402,10188041.png,221231,10967,210264,0.9504273813344423,2,4,41731,1538,40193,0.9631449042678105,10.379212444444445,973.5932853333334,18.247027908726242,120,4.400000000000005E-4
4,test_20231101_134402,10287332.png,216980,13642,203338,0.9371278458844133,2,3,22337,1861,20476,0.9166853203205444,9.321923555555555,744.2019093333333,19.413895809498406,120,4.400000000000005E-4
5,test_20231101_134402,11610969.png,368720,31657,337063,0.9141435235408982,2,3,84111,4612,79499,0.9451676950696104,19.394017777777776,2513.8691893333335,14.127376856996587,120,4.400000000000005E-4
6,test_20231101_134402,10350842.png,212614,7572,205042,0.9643861645987565,2,4,42529,1110,41419,0.9739001622422347,17.484805333333334,1967.9161866666666,15.190737629327984,120,4.400000000000005E-4
7,test_20231101_134402,10863862.png,317432,15277,302155,0.951873157085612,2,4,66058,2180,63878,0.9669986981137788,23.077662222222223,3070.805008,13.258281206665272,120,4.400000000000005E-4
8,test_20231101_134402,11382381.png,312486,847,311639,0.9972894785686399,2,4,46745,110,46635,0.9976468071451492,21.358711111111113,2440.977456,14.2551659242164,120,4.400000000000005E-4
9,test_20231101_134402,11079715.png,443815,132247,311568,0.702022238995978,4,4,124136,18385,105751,0.8518963072758909,16.302611555555554,1952.235056,15.225482537985677,120,4.400000000000005E-4
10,test_20231101_134402,11551286.png,271883,647,271236,0.9976202999084165,1,3,40092,94,39998,0.9976553925970268,17.770117333333335,1836.7047093333333,15.490410213370003,120,4.400000000000005E-4
1,test_20231101_134403,10404007.png,502730,27237,475493,0.9458218129015575,2,3,61265,3928,57337,0.9358850893658696,24.993056,3243.490410666667,13.020677425852345,120,4.5000000000000053E-4
2,test_20231101_134403,1254659.png,342646,84312,258334,0.7539384671059928,3,4,80080,11676,68404,0.8541958041958042,19.962241777777777,2914.6974026666667,13.484868869095994,120,4.5000000000000053E-4
3,test_20231101_134403,10188041.png,221231,10967,210264,0.9504273813344423,2,4,41731,1538,40193,0.9631449042678105,10.379212444444445,973.5932853333334,18.247027908726242,120,4.5000000000000053E-4
4,test_20231101_134403,10287332.png,216980,13642,203338,0.9371278458844133,1,4,22337,1861,20476,0.9166853203205444,9.321923555555555,744.2019093333333,19.413895809498406,120,4.5000000000000053E-4
5,test_20231101_134403,11610969.png,368720,31657,337063,0.9141435235408982,2,4,84111,4612,79499,0.9451676950696104,19.394017777777776,2513.8691893333335,14.127376856996587,120,4.5000000000000053E-4
6,test_20231101_134403,10350842.png,212614,7572,205042,0.9643861645987565,1,3,42529,1110,41419,0.9739001622422347,17.484805333333334,1967.9161866666666,15.190737629327984,120,4.5000000000000053E-4
7,test_20231101_134403,10863862.png,317432,15277,302155,0.951873157085612,2,3,66058,2180,63878,0.9669986981137788,23.077662222222223,3070.805008,13.258281206665272,120,4.5000000000000053E-4
8,test_20231101_134403,11382381.png,312486,847,311639,0.9972894785686399,1,3,46745,110,46635,0.9976468071451492,21.358711111111113,2440.977456,14.2551659242164,120,4.5000000000000053E-4
9,test_20231101_134403,11079715.png,443815,132247,311568,0.702022238995978,3,5,124136,18385,105751,0.8518963072758909,16.302611555555554,1952.235056,15.225482537985677,120,4.5000000000000053E-4
10,test_20231101_134403,11551286.png,271883,647,271236,0.9976202999084165,1,4,40092,94,39998,0.9976553925970268,17.770117333333335,1836.7047093333333,15.490410213370003,120,4.5000000000000053E-4
1,test_20231101_134403,10404007.png,502730,27237,475493,0.9458218129015575,2,4,61265,3928,57337,0.9358850893658696,24.993056,3243.490410666667,13.020677425852345,120,4.6000000000000056E-4
2,test_20231101_134403,1254659.png,342646,84312,258334,0.7539384671059928,3,4,80080,11676,68404,0.8541958041958042,19.962241777777777,2914.6974026666667,13.484868869095994,120,4.6000000000000056E-4
3,test_20231101_134403,10188041.png,221231,10967,210264,0.9504273813344423,2,3,41731,1538,40193,0.9631449042678105,10.379212444444445,973.5932853333334,18.247027908726242,120,4.6000000000000056E-4
4,test_20231101_134403,10287332.png,216980,13642,203338,0.9371278458844133,1,3,22337,1861,20476,0.9166853203205444,9.321923555555555,744.2019093333333,19.413895809498406,120,4.6000000000000056E-4
5,test_20231101_134403,11610969.png,368720,31657,337063,0.9141435235408982,3,4,84111,4612,79499,0.9451676950696104,19.394017777777776,2513.8691893333335,14.127376856996587,120,4.6000000000000056E-4
6,test_20231101_134403,10350842.png,212614,7572,205042,0.9643861645987565,2,4,42529,1110,41419,0.9739001622422347,17.484805333333334,1967.9161866666666,15.190737629327984,120,4.6000000000000056E-4
7,test_20231101_134403,10863862.png,317432,15277,302155,0.951873157085612,2,4,66058,2180,63878,0.9669986981137788,23.077662222222223,3070.805008,13.258281206665272,120,4.6000000000000056E-4
8,test_20231101_134403,11382381.png,312486,847,311639,0.9972894785686399,1,3,46745,110,46635,0.9976468071451492,21.358711111111113,2440.977456,14.2551659242164,120,4.6000000000000056E-4
9,test_20231101_134403,11079715.png,443815,132247,311568,0.702022238995978,4,4,124136,18385,105751,0.8518963072758909,16.302611555555554,1952.235056,15.225482537985677,120,4.6000000000000056E-4
10,test_20231101_134403,11551286.png,271883,647,271236,0.9976202999084165,1,4,40092,94,39998,0.9976553925970268,17.770117333333335,1836.7047093333333,15.490410213370003,120,4.6000000000000056E-4
1,test_20231101_134404,10404007.png,502730,27237,475493,0.9458218129015575,3,4,61265,3928,57337,0.9358850893658696,24.993056,3243.490410666667,13.020677425852345,120,4.700000000000006E-4
2,test_20231101_134404,1254659.png,342646,84312,258334,0.7539384671059928,3,4,80080,11676,68404,0.8541958041958042,19.962241777777777,2914.6974026666667,13.484868869095994,120,4.700000000000006E-4
3,test_20231101_134404,10188041.png,221231,10967,210264,0.9504273813344423,2,4,41731,1538,40193,0.9631449042678105,10.379212444444445,973.5932853333334,18.247027908726242,120,4.700000000000006E-4
4,test_20231101_134404,10287332.png,216980,13642,203338,0.9371278458844133,2,3,22337,1861,20476,0.9166853203205444,9.321923555555555,744.2019093333333,19.413895809498406,120,4.700000000000006E-4
5,test_20231101_134404,11610969.png,368720,31657,337063,0.9141435235408982,2,4,84111,4612,79499,0.9451676950696104,19.394017777777776,2513.8691893333335,14.127376856996587,120,4.700000000000006E-4
6,test_20231101_134404,10350842.png,212614,7572,205042,0.9643861645987565,2,3,42529,1110,41419,0.9739001622422347,17.484805333333334,1967.9161866666666,15.190737629327984,120,4.700000000000006E-4
7,test_20231101_134404,10863862.png,317432,15277,302155,0.951873157085612,2,4,66058,2180,63878,0.9669986981137788,23.077662222222223,3070.805008,13.258281206665272,120,4.700000000000006E-4
8,test_20231101_134404,11382381.png,312486,847,311639,0.9972894785686399,1,3,46745,110,46635,0.9976468071451492,21.358711111111113,2440.977456,14.2551659242164,120,4.700000000000006E-4
9,test_20231101_134404,11079715.png,443815,132247,311568,0.702022238995978,3,5,124136,18385,105751,0.8518963072758909,16.302611555555554,1952.235056,15.225482537985677,120,4.700000000000006E-4
10,test_20231101_134404,11551286.png,271883,647,271236,0.9976202999084165,1,3,40092,94,39998,0.9976553925970268,17.770117333333335,1836.7047093333333,15.490410213370003,120,4.700000000000006E-4
1,test_20231101_134405,10404007.png,502730,27237,475493,0.9458218129015575,3,4,61265,3928,57337,0.9358850893658696,24.993056,3243.490410666667,13.020677425852345,120,4.800000000000006E-4
2,test_20231101_134405,1254659.png,342646,84312,258334,0.7539384671059928,4,4,80080,11676,68404,0.8541958041958042,19.962241777777777,2914.6974026666667,13.484868869095994,120,4.800000000000006E-4
3,test_20231101_134405,10188041.png,221231,10967,210264,0.9504273813344423,3,4,41731,1538,40193,0.9631449042678105,10.379212444444445,973.5932853333334,18.247027908726242,120,4.800000000000006E-4
4,test_20231101_134405,10287332.png,216980,13642,203338,0.9371278458844133,2,4,22337,1861,20476,0.9166853203205444,9.321923555555555,744.2019093333333,19.413895809498406,120,4.800000000000006E-4
5,test_20231101_134405,11610969.png,368720,31657,337063,0.9141435235408982,3,4,84111,4612,79499,0.9451676950696104,19.394017777777776,2513.8691893333335,14.127376856996587,120,4.800000000000006E-4
6,test_20231101_134405,10350842.png,212614,7572,205042,0.9643861645987565,1,3,42529,1110,41419,0.9739001622422347,17.484805333333334,1967.9161866666666,15.190737629327984,120,4.800000000000006E-4
7,test_20231101_134405,10863862.png,317432,15277,302155,0.951873157085612,3,4,66058,2180,63878,0.9669986981137788,23.077662222222223,3070.805008,13.258281206665272,120,4.800000000000006E-4
8,test_20231101_134405,11382381.png,312486,847,311639,0.9972894785686399,2,4,46745,110,46635,0.9976468071451492,21.358711111111113,2440.977456,14.2551659242164,120,4.800000000000006E-4
9,test_20231101_134405,11079715.png,443815,132247,311568,0.702022238995978,4,4,124136,18385,105751,0.8518963072758909,16.302611555555554,1952.235056,15.225482537985677,120,4.800000000000006E-4
10,test_20231101_134405,11551286.png,271883,647,271236,0.9976202999084165,1,15,40092,94,39998,0.9976553925970268,17.770117333333335,1836.7047093333333,15.490410213370003,120,4.800000000000006E-4
1,test_20231101_134405,10404007.png,502730,27237,475493,0.9458218129015575,3,4,61265,3928,57337,0.9358850893658696,24.993056,3243.490410666667,13.020677425852345,120,4.900000000000006E-4
2,test_20231101_134405,1254659.png,342646,84312,258334,0.7539384671059928,4,4,80080,11676,68404,0.8541958041958042,19.962241777777777,2914.6974026666667,13.484868869095994,120,4.900000000000006E-4
3,test_20231101_134405,10188041.png,221231,10967,210264,0.9504273813344423,2,4,41731,1538,40193,0.9631449042678105,10.379212444444445,973.5932853333334,18.247027908726242,120,4.900000000000006E-4
4,test_20231101_134405,10287332.png,216980,13642,203338,0.9371278458844133,2,4,22337,1861,20476,0.9166853203205444,9.321923555555555,744.2019093333333,19.413895809498406,120,4.900000000000006E-4
5,test_20231101_134405,11610969.png,368720,31657,337063,0.9141435235408982,3,4,84111,4612,79499,0.9451676950696104,19.394017777777776,2513.8691893333335,14.127376856996587,120,4.900000000000006E-4
6,test_20231101_134405,10350842.png,212614,7572,205042,0.9643861645987565,2,4,42529,1110,41419,0.9739001622422347,17.484805333333334,1967.9161866666666,15.190737629327984,120,4.900000000000006E-4
7,test_20231101_134405,10863862.png,317432,15277,302155,0.951873157085612,4,5,66058,2180,63878,0.9669986981137788,23.077662222222223,3070.805008,13.258281206665272,120,4.900000000000006E-4
8,test_20231101_134405,11382381.png,312486,847,311639,0.9972894785686399,1,4,46745,110,46635,0.9976468071451492,21.358711111111113,2440.977456,14.2551659242164,120,4.900000000000006E-4
9,test_20231101_134405,11079715.png,443815,132247,311568,0.702022238995978,4,5,124136,18385,105751,0.8518963072758909,16.302611555555554,1952.235056,15.225482537985677,120,4.900000000000006E-4
10,test_20231101_134405,11551286.png,271883,647,271236,0.9976202999084165,2,3,40092,94,39998,0.9976553925970268,17.770117333333335,1836.7047093333333,15.490410213370003,120,4.900000000000006E-4
1,test_20231101_134406,10404007.png,502730,27237,475493,0.9458218129015575,3,4,61265,3928,57337,0.9358850893658696,24.993056,3243.490410666667,13.020677425852345,120,5.000000000000007E-4
2,test_20231101_134406,1254659.png,342646,84312,258334,0.7539384671059928,3,4,80080,11676,68404,0.8541958041958042,19.962241777777777,2914.6974026666667,13.484868869095994,120,5.000000000000007E-4
3,test_20231101_134406,10188041.png,221231,10967,210264,0.9504273813344423,2,5,41731,1538,40193,0.9631449042678105,10.379212444444445,973.5932853333334,18.247027908726242,120,5.000000000000007E-4
4,test_20231101_134406,10287332.png,216980,13642,203338,0.9371278458844133,2,4,22337,1861,20476,0.9166853203205444,9.321923555555555,744.2019093333333,19.413895809498406,120,5.000000000000007E-4
5,test_20231101_134406,11610969.png,368720,31657,337063,0.9141435235408982,3,4,84111,4612,79499,0.9451676950696104,19.394017777777776,2513.8691893333335,14.127376856996587,120,5.000000000000007E-4
6,test_20231101_134406,10350842.png,212614,7572,205042,0.9643861645987565,2,6,42529,1110,41419,0.9739001622422347,17.484805333333334,1967.9161866666666,15.190737629327984,120,5.000000000000007E-4
7,test_20231101_134406,10863862.png,317432,15277,302155,0.951873157085612,2,3,66058,2180,63878,0.9669986981137788,23.077662222222223,3070.805008,13.258281206665272,120,5.000000000000007E-4
8,test_20231101_134406,11382381.png,312486,847,311639,0.9972894785686399,1,4,46745,110,46635,0.9976468071451492,21.358711111111113,2440.977456,14.2551659242164,120,5.000000000000007E-4
9,test_20231101_134406,11079715.png,443815,132247,311568,0.702022238995978,3,4,124136,18385,105751,0.8518963072758909,16.302611555555554,1952.235056,15.225482537985677,120,5.000000000000007E-4
10,test_20231101_134406,11551286.png,271883,647,271236,0.9976202999084165,1,4,40092,94,39998,0.9976553925970268,17.770117333333335,1836.7047093333333,15.490410213370003,120,5.000000000000007E-4
1,test_20231101_134407,10404007.png,502730,27117,475613,0.9460605096174886,3,4,61265,3912,57353,0.9361462498979842,25.00584,3245.6972,13.017723600120569,120,5.100000000000007E-4
2,test_20231101_134407,1254659.png,342646,84312,258334,0.7539384671059928,3,4,80080,11676,68404,0.8541958041958042,19.962241777777777,2914.6974026666667,13.484868869095994,120,5.100000000000007E-4
3,test_20231101_134407,10188041.png,221231,10867,210364,0.9508793975527842,2,4,41731,1524,40207,0.9634803862835781,10.502565333333333,989.3086773333333,18.177485425299558,120,5.100000000000007E-4
4,test_20231101_134407,10287332.png,216980,13642,203338,0.9371278458844133,2,4,22337,1861,20476,0.9166853203205444,9.321923555555555,744.2019093333333,19.413895809498406,120,5.100000000000007E-4
5,test_20231101_134407,11610969.png,368720,31297,337423,0.9151198741592537,2,7,84111,4559,79552,0.9457978147923577,19.816019555555556,2600.808432,13.979719963649465,120,5.100000000000007E-4
6,test_20231101_134407,10350842.png,212614,7309,205305,0.965623148052339,2,4,42529,1072,41457,0.9747936702015095,18.37208711111111,2173.3855946666667,14.75943576664335,120,5.100000000000007E-4
7,test_20231101_134407,10863862.png,317432,15277,302155,0.951873157085612,2,4,66058,2180,63878,0.9669986981137788,23.077662222222223,3070.805008,13.258281206665272,120,5.100000000000007E-4
8,test_20231101_134407,11382381.png,312486,847,311639,0.9972894785686399,1,4,46745,110,46635,0.9976468071451492,21.358711111111113,2440.977456,14.2551659242164,120,5.100000000000007E-4
9,test_20231101_134407,11079715.png,443815,132247,311568,0.702022238995978,4,4,124136,18385,105751,0.8518963072758909,16.302611555555554,1952.235056,15.225482537985677,120,5.100000000000007E-4
10,test_20231101_134407,11551286.png,271883,567,271316,0.9979145441237591,2,3,40092,82,40010,0.9979547041803851,17.920218666666667,1855.396624,15.446435988293219,120,5.100000000000007E-4
1,test_20231101_134407,10404007.png,502730,27117,475613,0.9460605096174886,2,3,61265,3912,57353,0.9361462498979842,25.00584,3245.6972,13.017723600120569,120,5.200000000000007E-4
2,test_20231101_134407,1254659.png,342646,84312,258334,0.7539384671059928,3,4,80080,11676,68404,0.8541958041958042,19.962241777777777,2914.6974026666667,13.484868869095994,120,5.200000000000007E-4
3,test_20231101_134407,10188041.png,221231,10867,210364,0.9508793975527842,2,3,41731,1524,40207,0.9634803862835781,10.502565333333333,989.3086773333333,18.177485425299558,120,5.200000000000007E-4
4,test_20231101_134407,10287332.png,216980,13642,203338,0.9371278458844133,1,5,22337,1861,20476,0.9166853203205444,9.321923555555555,744.2019093333333,19.413895809498406,120,5.200000000000007E-4
5,test_20231101_134407,11610969.png,368720,31297,337423,0.9151198741592537,2,3,84111,4559,79552,0.9457978147923577,19.816019555555556,2600.808432,13.979719963649465,120,5.200000000000007E-4
6,test_20231101_134407,10350842.png,212614,7309,205305,0.965623148052339,2,4,42529,1072,41457,0.9747936702015095,18.37208711111111,2173.3855946666667,14.75943576664335,120,5.200000000000007E-4
7,test_20231101_134407,10863862.png,317432,15277,302155,0.951873157085612,2,4,66058,2180,63878,0.9669986981137788,23.077662222222223,3070.805008,13.258281206665272,120,5.200000000000007E-4
8,test_20231101_134407,11382381.png,312486,847,311639,0.9972894785686399,1,3,46745,110,46635,0.9976468071451492,21.358711111111113,2440.977456,14.2551659242164,120,5.200000000000007E-4
9,test_20231101_134407,11079715.png,443815,132247,311568,0.702022238995978,4,4,124136,18385,105751,0.8518963072758909,16.302611555555554,1952.235056,15.225482537985677,120,5.200000000000007E-4
10,test_20231101_134407,11551286.png,271883,567,271316,0.9979145441237591,1,4,40092,82,40010,0.9979547041803851,17.920218666666667,1855.396624,15.446435988293219,120,5.200000000000007E-4
1,test_20231101_134408,10404007.png,502730,27117,475613,0.9460605096174886,2,3,61265,3912,57353,0.9361462498979842,25.00584,3245.6972,13.017723600120569,120,5.300000000000007E-4
2,test_20231101_134408,1254659.png,342646,84312,258334,0.7539384671059928,3,4,80080,11676,68404,0.8541958041958042,19.962241777777777,2914.6974026666667,13.484868869095994,120,5.300000000000007E-4
3,test_20231101_134408,10188041.png,221231,10867,210364,0.9508793975527842,2,3,41731,1524,40207,0.9634803862835781,10.502565333333333,989.3086773333333,18.177485425299558,120,5.300000000000007E-4
4,test_20231101_134408,10287332.png,216980,13642,203338,0.9371278458844133,2,3,22337,1861,20476,0.9166853203205444,9.321923555555555,744.2019093333333,19.413895809498406,120,5.300000000000007E-4
5,test_20231101_134408,11610969.png,368720,31297,337423,0.9151198741592537,2,4,84111,4559,79552,0.9457978147923577,19.816019555555556,2600.808432,13.979719963649465,120,5.300000000000007E-4
6,test_20231101_134408,10350842.png,212614,7309,205305,0.965623148052339,1,3,42529,1072,41457,0.9747936702015095,18.37208711111111,2173.3855946666667,14.75943576664335,120,5.300000000000007E-4
7,test_20231101_134408,10863862.png,317432,15277,302155,0.951873157085612,2,3,66058,2180,63878,0.9669986981137788,23.077662222222223,3070.805008,13.258281206665272,120,5.300000000000007E-4
8,test_20231101_134408,11382381.png,312486,847,311639,0.9972894785686399,1,4,46745,110,46635,0.9976468071451492,21.358711111111113,2440.977456,14.2551659242164,120,5.300000000000007E-4
9,test_20231101_134408,11079715.png,443815,132247,311568,0.702022238995978,3,4,124136,18385,105751,0.8518963072758909,16.302611555555554,1952.235056,15.225482537985677,120,5.300000000000007E-4
10,test_20231101_134408,11551286.png,271883,567,271316,0.9979145441237591,1,3,40092,82,40010,0.9979547041803851,17.920218666666667,1855.396624,15.446435988293219,120,5.300000000000007E-4
1,test_20231101_134409,10404007.png,502730,27117,475613,0.9460605096174886,2,3,61265,3912,57353,0.9361462498979842,25.00584,3245.6972,13.017723600120569,120,5.400000000000008E-4
2,test_20231101_134409,1254659.png,342646,84312,258334,0.7539384671059928,3,4,80080,11676,68404,0.8541958041958042,19.962241777777777,2914.6974026666667,13.484868869095994,120,5.400000000000008E-4
3,test_20231101_134409,10188041.png,221231,10867,210364,0.9508793975527842,2,4,41731,1524,40207,0.9634803862835781,10.502565333333333,989.3086773333333,18.177485425299558,120,5.400000000000008E-4
4,test_20231101_134409,10287332.png,216980,13642,203338,0.9371278458844133,1,3,22337,1861,20476,0.9166853203205444,9.321923555555555,744.2019093333333,19.413895809498406,120,5.400000000000008E-4
5,test_20231101_134409,11610969.png,368720,31297,337423,0.9151198741592537,2,3,84111,4559,79552,0.9457978147923577,19.816019555555556,2600.808432,13.979719963649465,120,5.400000000000008E-4
6,test_20231101_134409,10350842.png,212614,7309,205305,0.965623148052339,2,3,42529,1072,41457,0.9747936702015095,18.37208711111111,2173.3855946666667,14.75943576664335,120,5.400000000000008E-4
7,test_20231101_134409,10863862.png,317432,15277,302155,0.951873157085612,2,3,66058,2180,63878,0.9669986981137788,23.077662222222223,3070.805008,13.258281206665272,120,5.400000000000008E-4
8,test_20231101_134409,11382381.png,312486,847,311639,0.9972894785686399,2,3,46745,110,46635,0.9976468071451492,21.358711111111113,2440.977456,14.2551659242164,120,5.400000000000008E-4
9,test_20231101_134409,11079715.png,443815,132247,311568,0.702022238995978,3,4,124136,18385,105751,0.8518963072758909,16.302611555555554,1952.235056,15.225482537985677,120,5.400000000000008E-4
10,test_20231101_134409,11551286.png,271883,567,271316,0.9979145441237591,1,3,40092,82,40010,0.9979547041803851,17.920218666666667,1855.396624,15.446435988293219,120,5.400000000000008E-4
1,test_20231101_134409,10404007.png,502730,27117,475613,0.9460605096174886,2,4,61265,3912,57353,0.9361462498979842,25.00584,3245.6972,13.017723600120569,120,5.500000000000008E-4
2,test_20231101_134409,1254659.png,342646,84312,258334,0.7539384671059928,3,4,80080,11676,68404,0.8541958041958042,19.962241777777777,2914.6974026666667,13.484868869095994,120,5.500000000000008E-4
3,test_20231101_134409,10188041.png,221231,10867,210364,0.9508793975527842,2,3,41731,1524,40207,0.9634803862835781,10.502565333333333,989.3086773333333,18.177485425299558,120,5.500000000000008E-4
4,test_20231101_134409,10287332.png,216980,13642,203338,0.9371278458844133,2,4,22337,1861,20476,0.9166853203205444,9.321923555555555,744.2019093333333,19.413895809498406,120,5.500000000000008E-4
5,test_20231101_134409,11610969.png,368720,31297,337423,0.9151198741592537,2,8,84111,4559,79552,0.9457978147923577,19.816019555555556,2600.808432,13.979719963649465,120,5.500000000000008E-4
6,test_20231101_134409,10350842.png,212614,7309,205305,0.965623148052339,1,4,42529,1072,41457,0.9747936702015095,18.37208711111111,2173.3855946666667,14.75943576664335,120,5.500000000000008E-4
7,test_20231101_134409,10863862.png,317432,15277,302155,0.951873157085612,2,3,66058,2180,63878,0.9669986981137788,23.077662222222223,3070.805008,13.258281206665272,120,5.500000000000008E-4
8,test_20231101_134409,11382381.png,312486,847,311639,0.9972894785686399,1,4,46745,110,46635,0.9976468071451492,21.358711111111113,2440.977456,14.2551659242164,120,5.500000000000008E-4
9,test_20231101_134409,11079715.png,443815,132247,311568,0.702022238995978,5,4,124136,18385,105751,0.8518963072758909,16.302611555555554,1952.235056,15.225482537985677,120,5.500000000000008E-4
10,test_20231101_134409,11551286.png,271883,567,271316,0.9979145441237591,1,4,40092,82,40010,0.9979547041803851,17.920218666666667,1855.396624,15.446435988293219,120,5.500000000000008E-4
1,test_20231101_134410,10404007.png,502730,27117,475613,0.9460605096174886,2,3,61265,3912,57353,0.9361462498979842,25.00584,3245.6972,13.017723600120569,120,5.600000000000008E-4
2,test_20231101_134410,1254659.png,342646,84312,258334,0.7539384671059928,5,4,80080,11676,68404,0.8541958041958042,19.962241777777777,2914.6974026666667,13.484868869095994,120,5.600000000000008E-4
3,test_20231101_134410,10188041.png,221231,10867,210364,0.9508793975527842,2,3,41731,1524,40207,0.9634803862835781,10.502565333333333,989.3086773333333,18.177485425299558,120,5.600000000000008E-4
4,test_20231101_134410,10287332.png,216980,13642,203338,0.9371278458844133,2,3,22337,1861,20476,0.9166853203205444,9.321923555555555,744.2019093333333,19.413895809498406,120,5.600000000000008E-4
5,test_20231101_134410,11610969.png,368720,31297,337423,0.9151198741592537,3,4,84111,4559,79552,0.9457978147923577,19.816019555555556,2600.808432,13.979719963649465,120,5.600000000000008E-4
6,test_20231101_134410,10350842.png,212614,7309,205305,0.965623148052339,1,3,42529,1072,41457,0.9747936702015095,18.37208711111111,2173.3855946666667,14.75943576664335,120,5.600000000000008E-4
7,test_20231101_134410,10863862.png,317432,15277,302155,0.951873157085612,1,3,66058,2180,63878,0.9669986981137788,23.077662222222223,3070.805008,13.258281206665272,120,5.600000000000008E-4
8,test_20231101_134410,11382381.png,312486,847,311639,0.9972894785686399,1,4,46745,110,46635,0.9976468071451492,21.358711111111113,2440.977456,14.2551659242164,120,5.600000000000008E-4
9,test_20231101_134410,11079715.png,443815,132247,311568,0.702022238995978,3,5,124136,18385,105751,0.8518963072758909,16.302611555555554,1952.235056,15.225482537985677,120,5.600000000000008E-4
10,test_20231101_134410,11551286.png,271883,567,271316,0.9979145441237591,1,4,40092,82,40010,0.9979547041803851,17.920218666666667,1855.396624,15.446435988293219,120,5.600000000000008E-4
1,test_20231101_134411,10404007.png,502730,27117,475613,0.9460605096174886,3,4,61265,3912,57353,0.9361462498979842,25.00584,3245.6972,13.017723600120569,120,5.700000000000008E-4
2,test_20231101_134411,1254659.png,342646,84312,258334,0.7539384671059928,3,4,80080,11676,68404,0.8541958041958042,19.962241777777777,2914.6974026666667,13.484868869095994,120,5.700000000000008E-4
3,test_20231101_134411,10188041.png,221231,10867,210364,0.9508793975527842,2,4,41731,1524,40207,0.9634803862835781,10.502565333333333,989.3086773333333,18.177485425299558,120,5.700000000000008E-4
4,test_20231101_134411,10287332.png,216980,13642,203338,0.9371278458844133,2,4,22337,1861,20476,0.9166853203205444,9.321923555555555,744.2019093333333,19.413895809498406,120,5.700000000000008E-4
5,test_20231101_134411,11610969.png,368720,31297,337423,0.9151198741592537,2,3,84111,4559,79552,0.9457978147923577,19.816019555555556,2600.808432,13.979719963649465,120,5.700000000000008E-4
6,test_20231101_134411,10350842.png,212614,7309,205305,0.965623148052339,2,4,42529,1072,41457,0.9747936702015095,18.37208711111111,2173.3855946666667,14.75943576664335,120,5.700000000000008E-4
7,test_20231101_134411,10863862.png,317432,15277,302155,0.951873157085612,2,4,66058,2180,63878,0.9669986981137788,23.077662222222223,3070.805008,13.258281206665272,120,5.700000000000008E-4
8,test_20231101_134411,11382381.png,312486,847,311639,0.9972894785686399,2,3,46745,110,46635,0.9976468071451492,21.358711111111113,2440.977456,14.2551659242164,120,5.700000000000008E-4
9,test_20231101_134411,11079715.png,443815,132247,311568,0.702022238995978,3,4,124136,18385,105751,0.8518963072758909,16.302611555555554,1952.235056,15.225482537985677,120,5.700000000000008E-4
10,test_20231101_134411,11551286.png,271883,567,271316,0.9979145441237591,1,4,40092,82,40010,0.9979547041803851,17.920218666666667,1855.396624,15.446435988293219,120,5.700000000000008E-4
1,test_20231101_134411,10404007.png,502730,27117,475613,0.9460605096174886,2,3,61265,3912,57353,0.9361462498979842,25.00584,3245.6972,13.017723600120569,120,5.800000000000009E-4
2,test_20231101_134411,1254659.png,342646,84312,258334,0.7539384671059928,3,4,80080,11676,68404,0.8541958041958042,19.962241777777777,2914.6974026666667,13.484868869095994,120,5.800000000000009E-4
3,test_20231101_134411,10188041.png,221231,10867,210364,0.9508793975527842,2,3,41731,1524,40207,0.9634803862835781,10.502565333333333,989.3086773333333,18.177485425299558,120,5.800000000000009E-4
4,test_20231101_134411,10287332.png,216980,13642,203338,0.9371278458844133,1,3,22337,1861,20476,0.9166853203205444,9.321923555555555,744.2019093333333,19.413895809498406,120,5.800000000000009E-4
5,test_20231101_134411,11610969.png,368720,31297,337423,0.9151198741592537,2,4,84111,4559,79552,0.9457978147923577,19.816019555555556,2600.808432,13.979719963649465,120,5.800000000000009E-4
6,test_20231101_134411,10350842.png,212614,7309,205305,0.965623148052339,2,4,42529,1072,41457,0.9747936702015095,18.37208711111111,2173.3855946666667,14.75943576664335,120,5.800000000000009E-4
7,test_20231101_134411,10863862.png,317432,15277,302155,0.951873157085612,2,4,66058,2180,63878,0.9669986981137788,23.077662222222223,3070.805008,13.258281206665272,120,5.800000000000009E-4
8,test_20231101_134411,11382381.png,312486,847,311639,0.9972894785686399,2,3,46745,110,46635,0.9976468071451492,21.358711111111113,2440.977456,14.2551659242164,120,5.800000000000009E-4
9,test_20231101_134411,11079715.png,443815,132247,311568,0.702022238995978,3,4,124136,18385,105751,0.8518963072758909,16.302611555555554,1952.235056,15.225482537985677,120,5.800000000000009E-4
10,test_20231101_134411,11551286.png,271883,567,271316,0.9979145441237591,1,10,40092,82,40010,0.9979547041803851,17.920218666666667,1855.396624,15.446435988293219,120,5.800000000000009E-4
1,test_20231101_134412,10404007.png,502730,27117,475613,0.9460605096174886,3,4,61265,3912,57353,0.9361462498979842,25.00584,3245.6972,13.017723600120569,120,5.900000000000009E-4
2,test_20231101_134412,1254659.png,342646,84312,258334,0.7539384671059928,3,4,80080,11676,68404,0.8541958041958042,19.962241777777777,2914.6974026666667,13.484868869095994,120,5.900000000000009E-4
3,test_20231101_134412,10188041.png,221231,10867,210364,0.9508793975527842,2,3,41731,1524,40207,0.9634803862835781,10.502565333333333,989.3086773333333,18.177485425299558,120,5.900000000000009E-4
4,test_20231101_134412,10287332.png,216980,13642,203338,0.9371278458844133,2,4,22337,1861,20476,0.9166853203205444,9.321923555555555,744.2019093333333,19.413895809498406,120,5.900000000000009E-4
5,test_20231101_134412,11610969.png,368720,31297,337423,0.9151198741592537,2,4,84111,4559,79552,0.9457978147923577,19.816019555555556,2600.808432,13.979719963649465,120,5.900000000000009E-4
6,test_20231101_134412,10350842.png,212614,7309,205305,0.965623148052339,1,3,42529,1072,41457,0.9747936702015095,18.37208711111111,2173.3855946666667,14.75943576664335,120,5.900000000000009E-4
7,test_20231101_134412,10863862.png,317432,15277,302155,0.951873157085612,2,4,66058,2180,63878,0.9669986981137788,23.077662222222223,3070.805008,13.258281206665272,120,5.900000000000009E-4
8,test_20231101_134412,11382381.png,312486,847,311639,0.9972894785686399,1,4,46745,110,46635,0.9976468071451492,21.358711111111113,2440.977456,14.2551659242164,120,5.900000000000009E-4
9,test_20231101_134412,11079715.png,443815,132247,311568,0.702022238995978,3,4,124136,18385,105751,0.8518963072758909,16.302611555555554,1952.235056,15.225482537985677,120,5.900000000000009E-4
10,test_20231101_134412,11551286.png,271883,567,271316,0.9979145441237591,1,4,40092,82,40010,0.9979547041803851,17.920218666666667,1855.396624,15.446435988293219,120,5.900000000000009E-4
1,test_20231101_134413,10404007.png,502730,27117,475613,0.9460605096174886,2,4,61265,3912,57353,0.9361462498979842,25.00584,3245.6972,13.017723600120569,120,6.000000000000009E-4
2,test_20231101_134413,1254659.png,342646,84312,258334,0.7539384671059928,3,4,80080,11676,68404,0.8541958041958042,19.962241777777777,2914.6974026666667,13.484868869095994,120,6.000000000000009E-4
3,test_20231101_134413,10188041.png,221231,10867,210364,0.9508793975527842,2,4,41731,1524,40207,0.9634803862835781,10.502565333333333,989.3086773333333,18.177485425299558,120,6.000000000000009E-4
4,test_20231101_134413,10287332.png,216980,13642,203338,0.9371278458844133,1,3,22337,1861,20476,0.9166853203205444,9.321923555555555,744.2019093333333,19.413895809498406,120,6.000000000000009E-4
5,test_20231101_134413,11610969.png,368720,31297,337423,0.9151198741592537,2,4,84111,4559,79552,0.9457978147923577,19.816019555555556,2600.808432,13.979719963649465,120,6.000000000000009E-4
6,test_20231101_134413,10350842.png,212614,7309,205305,0.965623148052339,2,3,42529,1072,41457,0.9747936702015095,18.37208711111111,2173.3855946666667,14.75943576664335,120,6.000000000000009E-4
7,test_20231101_134413,10863862.png,317432,15277,302155,0.951873157085612,2,4,66058,2180,63878,0.9669986981137788,23.077662222222223,3070.805008,13.258281206665272,120,6.000000000000009E-4
8,test_20231101_134413,11382381.png,312486,847,311639,0.9972894785686399,1,4,46745,110,46635,0.9976468071451492,21.358711111111113,2440.977456,14.2551659242164,120,6.000000000000009E-4
9,test_20231101_134413,11079715.png,443815,132247,311568,0.702022238995978,4,4,124136,18385,105751,0.8518963072758909,16.302611555555554,1952.235056,15.225482537985677,120,6.000000000000009E-4
10,test_20231101_134413,11551286.png,271883,567,271316,0.9979145441237591,2,4,40092,82,40010,0.9979547041803851,17.920218666666667,1855.396624,15.446435988293219,120,6.000000000000009E-4
1,test_20231101_134413,10404007.png,502730,27117,475613,0.9460605096174886,3,4,61265,3912,57353,0.9361462498979842,25.00584,3245.6972,13.017723600120569,120,6.10000000000001E-4
2,test_20231101_134413,1254659.png,342646,84312,258334,0.7539384671059928,4,4,80080,11676,68404,0.8541958041958042,19.962241777777777,2914.6974026666667,13.484868869095994,120,6.10000000000001E-4
3,test_20231101_134413,10188041.png,221231,10867,210364,0.9508793975527842,2,3,41731,1524,40207,0.9634803862835781,10.502565333333333,989.3086773333333,18.177485425299558,120,6.10000000000001E-4
4,test_20231101_134413,10287332.png,216980,13642,203338,0.9371278458844133,2,4,22337,1861,20476,0.9166853203205444,9.321923555555555,744.2019093333333,19.413895809498406,120,6.10000000000001E-4
5,test_20231101_134413,11610969.png,368720,31297,337423,0.9151198741592537,3,3,84111,4559,79552,0.9457978147923577,19.816019555555556,2600.808432,13.979719963649465,120,6.10000000000001E-4
6,test_20231101_134413,10350842.png,212614,7309,205305,0.965623148052339,1,3,42529,1072,41457,0.9747936702015095,18.37208711111111,2173.3855946666667,14.75943576664335,120,6.10000000000001E-4
7,test_20231101_134413,10863862.png,317432,15277,302155,0.951873157085612,2,4,66058,2180,63878,0.9669986981137788,23.077662222222223,3070.805008,13.258281206665272,120,6.10000000000001E-4
8,test_20231101_134413,11382381.png,312486,847,311639,0.9972894785686399,2,3,46745,110,46635,0.9976468071451492,21.358711111111113,2440.977456,14.2551659242164,120,6.10000000000001E-4
9,test_20231101_134413,11079715.png,443815,132247,311568,0.702022238995978,3,4,124136,18385,105751,0.8518963072758909,16.302611555555554,1952.235056,15.225482537985677,120,6.10000000000001E-4
10,test_20231101_134413,11551286.png,271883,567,271316,0.9979145441237591,2,3,40092,82,40010,0.9979547041803851,17.920218666666667,1855.396624,15.446435988293219,120,6.10000000000001E-4
1,test_20231101_134414,10404007.png,502730,27117,475613,0.9460605096174886,2,4,61265,3912,57353,0.9361462498979842,25.00584,3245.6972,13.017723600120569,120,6.20000000000001E-4
2,test_20231101_134414,1254659.png,342646,84312,258334,0.7539384671059928,3,4,80080,11676,68404,0.8541958041958042,19.962241777777777,2914.6974026666667,13.484868869095994,120,6.20000000000001E-4
3,test_20231101_134414,10188041.png,221231,10867,210364,0.9508793975527842,2,3,41731,1524,40207,0.9634803862835781,10.502565333333333,989.3086773333333,18.177485425299558,120,6.20000000000001E-4
4,test_20231101_134414,10287332.png,216980,13642,203338,0.9371278458844133,1,3,22337,1861,20476,0.9166853203205444,9.321923555555555,744.2019093333333,19.413895809498406,120,6.20000000000001E-4
5,test_20231101_134414,11610969.png,368720,31297,337423,0.9151198741592537,2,3,84111,4559,79552,0.9457978147923577,19.816019555555556,2600.808432,13.979719963649465,120,6.20000000000001E-4
6,test_20231101_134414,10350842.png,212614,7309,205305,0.965623148052339,1,3,42529,1072,41457,0.9747936702015095,18.37208711111111,2173.3855946666667,14.75943576664335,120,6.20000000000001E-4
7,test_20231101_134414,10863862.png,317432,15277,302155,0.951873157085612,2,4,66058,2180,63878,0.9669986981137788,23.077662222222223,3070.805008,13.258281206665272,120,6.20000000000001E-4
8,test_20231101_134414,11382381.png,312486,847,311639,0.9972894785686399,2,3,46745,110,46635,0.9976468071451492,21.358711111111113,2440.977456,14.2551659242164,120,6.20000000000001E-4
9,test_20231101_134414,11079715.png,443815,132247,311568,0.702022238995978,3,4,124136,18385,105751,0.8518963072758909,16.302611555555554,1952.235056,15.225482537985677,120,6.20000000000001E-4
10,test_20231101_134414,11551286.png,271883,567,271316,0.9979145441237591,2,3,40092,82,40010,0.9979547041803851,17.920218666666667,1855.396624,15.446435988293219,120,6.20000000000001E-4
1,test_20231101_134415,10404007.png,502730,27117,475613,0.9460605096174886,3,3,61265,3912,57353,0.9361462498979842,25.00584,3245.6972,13.017723600120569,120,6.30000000000001E-4
2,test_20231101_134415,1254659.png,342646,84312,258334,0.7539384671059928,3,4,80080,11676,68404,0.8541958041958042,19.962241777777777,2914.6974026666667,13.484868869095994,120,6.30000000000001E-4
3,test_20231101_134415,10188041.png,221231,10867,210364,0.9508793975527842,2,3,41731,1524,40207,0.9634803862835781,10.502565333333333,989.3086773333333,18.177485425299558,120,6.30000000000001E-4
4,test_20231101_134415,10287332.png,216980,13642,203338,0.9371278458844133,2,4,22337,1861,20476,0.9166853203205444,9.321923555555555,744.2019093333333,19.413895809498406,120,6.30000000000001E-4
5,test_20231101_134415,11610969.png,368720,31297,337423,0.9151198741592537,3,4,84111,4559,79552,0.9457978147923577,19.816019555555556,2600.808432,13.979719963649465,120,6.30000000000001E-4
6,test_20231101_134415,10350842.png,212614,7309,205305,0.965623148052339,1,4,42529,1072,41457,0.9747936702015095,18.37208711111111,2173.3855946666667,14.75943576664335,120,6.30000000000001E-4
7,test_20231101_134415,10863862.png,317432,15277,302155,0.951873157085612,2,4,66058,2180,63878,0.9669986981137788,23.077662222222223,3070.805008,13.258281206665272,120,6.30000000000001E-4
8,test_20231101_134415,11382381.png,312486,847,311639,0.9972894785686399,2,3,46745,110,46635,0.9976468071451492,21.358711111111113,2440.977456,14.2551659242164,120,6.30000000000001E-4
9,test_20231101_134415,11079715.png,443815,132247,311568,0.702022238995978,3,5,124136,18385,105751,0.8518963072758909,16.302611555555554,1952.235056,15.225482537985677,120,6.30000000000001E-4
10,test_20231101_134415,11551286.png,271883,567,271316,0.9979145441237591,1,4,40092,82,40010,0.9979547041803851,17.920218666666667,1855.396624,15.446435988293219,120,6.30000000000001E-4
1,test_20231101_134415,10404007.png,502730,26794,475936,0.9467030016112028,2,4,61265,3866,57399,0.9368970864278136,25.095884444444444,3265.691738666667,12.991051732763237,120,6.40000000000001E-4
2,test_20231101_134415,1254659.png,342646,84312,258334,0.7539384671059928,3,4,80080,11676,68404,0.8541958041958042,19.962241777777777,2914.6974026666667,13.484868869095994,120,6.40000000000001E-4
3,test_20231101_134415,10188041.png,221231,10867,210364,0.9508793975527842,2,3,41731,1524,40207,0.9634803862835781,10.502565333333333,989.3086773333333,18.177485425299558,120,6.40000000000001E-4
4,test_20231101_134415,10287332.png,216980,13642,203338,0.9371278458844133,1,4,22337,1861,20476,0.9166853203205444,9.321923555555555,744.2019093333333,19.413895809498406,120,6.40000000000001E-4
5,test_20231101_134415,11610969.png,368720,31297,337423,0.9151198741592537,2,4,84111,4559,79552,0.9457978147923577,19.816019555555556,2600.808432,13.979719963649465,120,6.40000000000001E-4
6,test_20231101_134415,10350842.png,212614,7309,205305,0.965623148052339,2,4,42529,1072,41457,0.9747936702015095,18.37208711111111,2173.3855946666667,14.75943576664335,120,6.40000000000001E-4
7,test_20231101_134415,10863862.png,317432,15277,302155,0.951873157085612,2,4,66058,2180,63878,0.9669986981137788,23.077662222222223,3070.805008,13.258281206665272,120,6.40000000000001E-4
8,test_20231101_134415,11382381.png,312486,847,311639,0.9972894785686399,2,3,46745,110,46635,0.9976468071451492,21.358711111111113,2440.977456,14.2551659242164,120,6.40000000000001E-4
9,test_20231101_134415,11079715.png,443815,132247,311568,0.702022238995978,4,4,124136,18385,105751,0.8518963072758909,16.302611555555554,1952.235056,15.225482537985677,120,6.40000000000001E-4
10,test_20231101_134415,11551286.png,271883,567,271316,0.9979145441237591,2,4,40092,82,40010,0.9979547041803851,17.920218666666667,1855.396624,15.446435988293219,120,6.40000000000001E-4
1,test_20231101_134416,10404007.png,502730,26794,475936,0.9467030016112028,2,3,61265,3866,57399,0.9368970864278136,25.095884444444444,3265.691738666667,12.991051732763237,120,6.500000000000011E-4
2,test_20231101_134416,1254659.png,342646,84312,258334,0.7539384671059928,3,3,80080,11676,68404,0.8541958041958042,19.962241777777777,2914.6974026666667,13.484868869095994,120,6.500000000000011E-4
3,test_20231101_134416,10188041.png,221231,10867,210364,0.9508793975527842,2,3,41731,1524,40207,0.9634803862835781,10.502565333333333,989.3086773333333,18.177485425299558,120,6.500000000000011E-4
4,test_20231101_134416,10287332.png,216980,13642,203338,0.9371278458844133,2,4,22337,1861,20476,0.9166853203205444,9.321923555555555,744.2019093333333,19.413895809498406,120,6.500000000000011E-4
5,test_20231101_134416,11610969.png,368720,31297,337423,0.9151198741592537,3,4,84111,4559,79552,0.9457978147923577,19.816019555555556,2600.808432,13.979719963649465,120,6.500000000000011E-4
6,test_20231101_134416,10350842.png,212614,7309,205305,0.965623148052339,1,4,42529,1072,41457,0.9747936702015095,18.37208711111111,2173.3855946666667,14.75943576664335,120,6.500000000000011E-4
7,test_20231101_134416,10863862.png,317432,15277,302155,0.951873157085612,2,4,66058,2180,63878,0.9669986981137788,23.077662222222223,3070.805008,13.258281206665272,120,6.500000000000011E-4
8,test_20231101_134416,11382381.png,312486,847,311639,0.9972894785686399,1,3,46745,110,46635,0.9976468071451492,21.358711111111113,2440.977456,14.2551659242164,120,6.500000000000011E-4
9,test_20231101_134416,11079715.png,443815,132247,311568,0.702022238995978,4,4,124136,18385,105751,0.8518963072758909,16.302611555555554,1952.235056,15.225482537985677,120,6.500000000000011E-4
10,test_20231101_134416,11551286.png,271883,567,271316,0.9979145441237591,1,4,40092,82,40010,0.9979547041803851,17.920218666666667,1855.396624,15.446435988293219,120,6.500000000000011E-4
1,test_20231101_134417,10404007.png,502730,26794,475936,0.9467030016112028,3,4,61265,3866,57399,0.9368970864278136,25.095884444444444,3265.691738666667,12.991051732763237,120,6.600000000000011E-4
2,test_20231101_134417,1254659.png,342646,84312,258334,0.7539384671059928,3,4,80080,11676,68404,0.8541958041958042,19.962241777777777,2914.6974026666667,13.484868869095994,120,6.600000000000011E-4
3,test_20231101_134417,10188041.png,221231,10867,210364,0.9508793975527842,2,3,41731,1524,40207,0.9634803862835781,10.502565333333333,989.3086773333333,18.177485425299558,120,6.600000000000011E-4
4,test_20231101_134417,10287332.png,216980,13642,203338,0.9371278458844133,2,4,22337,1861,20476,0.9166853203205444,9.321923555555555,744.2019093333333,19.413895809498406,120,6.600000000000011E-4
5,test_20231101_134417,11610969.png,368720,31297,337423,0.9151198741592537,2,4,84111,4559,79552,0.9457978147923577,19.816019555555556,2600.808432,13.979719963649465,120,6.600000000000011E-4
6,test_20231101_134417,10350842.png,212614,7309,205305,0.965623148052339,2,3,42529,1072,41457,0.9747936702015095,18.37208711111111,2173.3855946666667,14.75943576664335,120,6.600000000000011E-4
7,test_20231101_134417,10863862.png,317432,15277,302155,0.951873157085612,2,3,66058,2180,63878,0.9669986981137788,23.077662222222223,3070.805008,13.258281206665272,120,6.600000000000011E-4
8,test_20231101_134417,11382381.png,312486,847,311639,0.9972894785686399,1,3,46745,110,46635,0.9976468071451492,21.358711111111113,2440.977456,14.2551659242164,120,6.600000000000011E-4
9,test_20231101_134417,11079715.png,443815,132247,311568,0.702022238995978,3,4,124136,18385,105751,0.8518963072758909,16.302611555555554,1952.235056,15.225482537985677,120,6.600000000000011E-4
10,test_20231101_134417,11551286.png,271883,567,271316,0.9979145441237591,1,3,40092,82,40010,0.9979547041803851,17.920218666666667,1855.396624,15.446435988293219,120,6.600000000000011E-4
1,test_20231101_134418,10404007.png,502730,26794,475936,0.9467030016112028,2,3,61265,3866,57399,0.9368970864278136,25.095884444444444,3265.691738666667,12.991051732763237,120,6.700000000000011E-4
2,test_20231101_134418,1254659.png,342646,84312,258334,0.7539384671059928,3,4,80080,11676,68404,0.8541958041958042,19.962241777777777,2914.6974026666667,13.484868869095994,120,6.700000000000011E-4
3,test_20231101_134418,10188041.png,221231,10867,210364,0.9508793975527842,2,4,41731,1524,40207,0.9634803862835781,10.502565333333333,989.3086773333333,18.177485425299558,120,6.700000000000011E-4
4,test_20231101_134418,10287332.png,216980,13642,203338,0.9371278458844133,2,4,22337,1861,20476,0.9166853203205444,9.321923555555555,744.2019093333333,19.413895809498406,120,6.700000000000011E-4
5,test_20231101_134418,11610969.png,368720,31297,337423,0.9151198741592537,2,4,84111,4559,79552,0.9457978147923577,19.816019555555556,2600.808432,13.979719963649465,120,6.700000000000011E-4
6,test_20231101_134418,10350842.png,212614,7309,205305,0.965623148052339,1,3,42529,1072,41457,0.9747936702015095,18.37208711111111,2173.3855946666667,14.75943576664335,120,6.700000000000011E-4
7,test_20231101_134418,10863862.png,317432,15277,302155,0.951873157085612,2,4,66058,2180,63878,0.9669986981137788,23.077662222222223,3070.805008,13.258281206665272,120,6.700000000000011E-4
8,test_20231101_134418,11382381.png,312486,847,311639,0.9972894785686399,2,3,46745,110,46635,0.9976468071451492,21.358711111111113,2440.977456,14.2551659242164,120,6.700000000000011E-4
9,test_20231101_134418,11079715.png,443815,132247,311568,0.702022238995978,4,4,124136,18385,105751,0.8518963072758909,16.302611555555554,1952.235056,15.225482537985677,120,6.700000000000011E-4
10,test_20231101_134418,11551286.png,271883,567,271316,0.9979145441237591,1,3,40092,82,40010,0.9979547041803851,17.920218666666667,1855.396624,15.446435988293219,120,6.700000000000011E-4
1,test_20231101_134418,10404007.png,502730,26794,475936,0.9467030016112028,3,4,61265,3866,57399,0.9368970864278136,25.095884444444444,3265.691738666667,12.991051732763237,120,6.800000000000011E-4
2,test_20231101_134418,1254659.png,342646,84312,258334,0.7539384671059928,4,4,80080,11676,68404,0.8541958041958042,19.962241777777777,2914.6974026666667,13.484868869095994,120,6.800000000000011E-4
3,test_20231101_134418,10188041.png,221231,10867,210364,0.9508793975527842,2,4,41731,1524,40207,0.9634803862835781,10.502565333333333,989.3086773333333,18.177485425299558,120,6.800000000000011E-4
4,test_20231101_134418,10287332.png,216980,13642,203338,0.9371278458844133,1,4,22337,1861,20476,0.9166853203205444,9.321923555555555,744.2019093333333,19.413895809498406,120,6.800000000000011E-4
5,test_20231101_134418,11610969.png,368720,31297,337423,0.9151198741592537,3,4,84111,4559,79552,0.9457978147923577,19.816019555555556,2600.808432,13.979719963649465,120,6.800000000000011E-4
6,test_20231101_134418,10350842.png,212614,7309,205305,0.965623148052339,2,3,42529,1072,41457,0.9747936702015095,18.37208711111111,2173.3855946666667,14.75943576664335,120,6.800000000000011E-4
7,test_20231101_134418,10863862.png,317432,15277,302155,0.951873157085612,2,3,66058,2180,63878,0.9669986981137788,23.077662222222223,3070.805008,13.258281206665272,120,6.800000000000011E-4
8,test_20231101_134418,11382381.png,312486,847,311639,0.9972894785686399,2,3,46745,110,46635,0.9976468071451492,21.358711111111113,2440.977456,14.2551659242164,120,6.800000000000011E-4
9,test_20231101_134418,11079715.png,443815,132247,311568,0.702022238995978,4,5,124136,18385,105751,0.8518963072758909,16.302611555555554,1952.235056,15.225482537985677,120,6.800000000000011E-4
10,test_20231101_134418,11551286.png,271883,567,271316,0.9979145441237591,1,3,40092,82,40010,0.9979547041803851,17.920218666666667,1855.396624,15.446435988293219,120,6.800000000000011E-4
1,test_20231101_134419,10404007.png,502730,26794,475936,0.9467030016112028,2,3,61265,3866,57399,0.9368970864278136,25.095884444444444,3265.691738666667,12.991051732763237,120,6.900000000000012E-4
2,test_20231101_134419,1254659.png,342646,84312,258334,0.7539384671059928,3,14,80080,11676,68404,0.8541958041958042,19.962241777777777,2914.6974026666667,13.484868869095994,120,6.900000000000012E-4
3,test_20231101_134419,10188041.png,221231,10867,210364,0.9508793975527842,2,3,41731,1524,40207,0.9634803862835781,10.502565333333333,989.3086773333333,18.177485425299558,120,6.900000000000012E-4
4,test_20231101_134419,10287332.png,216980,13642,203338,0.9371278458844133,2,4,22337,1861,20476,0.9166853203205444,9.321923555555555,744.2019093333333,19.413895809498406,120,6.900000000000012E-4
5,test_20231101_134419,11610969.png,368720,31297,337423,0.9151198741592537,2,3,84111,4559,79552,0.9457978147923577,19.816019555555556,2600.808432,13.979719963649465,120,6.900000000000012E-4
6,test_20231101_134419,10350842.png,212614,7309,205305,0.965623148052339,2,3,42529,1072,41457,0.9747936702015095,18.37208711111111,2173.3855946666667,14.75943576664335,120,6.900000000000012E-4
7,test_20231101_134419,10863862.png,317432,15277,302155,0.951873157085612,2,3,66058,2180,63878,0.9669986981137788,23.077662222222223,3070.805008,13.258281206665272,120,6.900000000000012E-4
8,test_20231101_134419,11382381.png,312486,847,311639,0.9972894785686399,2,4,46745,110,46635,0.9976468071451492,21.358711111111113,2440.977456,14.2551659242164,120,6.900000000000012E-4
9,test_20231101_134419,11079715.png,443815,132247,311568,0.702022238995978,3,4,124136,18385,105751,0.8518963072758909,16.302611555555554,1952.235056,15.225482537985677,120,6.900000000000012E-4
10,test_20231101_134419,11551286.png,271883,567,271316,0.9979145441237591,1,3,40092,82,40010,0.9979547041803851,17.920218666666667,1855.396624,15.446435988293219,120,6.900000000000012E-4
1,test_20231101_134420,10404007.png,502730,26794,475936,0.9467030016112028,2,4,61265,3866,57399,0.9368970864278136,25.095884444444444,3265.691738666667,12.991051732763237,120,7.000000000000012E-4
2,test_20231101_134420,1254659.png,342646,84312,258334,0.7539384671059928,3,5,80080,11676,68404,0.8541958041958042,19.962241777777777,2914.6974026666667,13.484868869095994,120,7.000000000000012E-4
3,test_20231101_134420,10188041.png,221231,10867,210364,0.9508793975527842,2,4,41731,1524,40207,0.9634803862835781,10.502565333333333,989.3086773333333,18.177485425299558,120,7.000000000000012E-4
4,test_20231101_134420,10287332.png,216980,13642,203338,0.9371278458844133,1,3,22337,1861,20476,0.9166853203205444,9.321923555555555,744.2019093333333,19.413895809498406,120,7.000000000000012E-4
5,test_20231101_134420,11610969.png,368720,31297,337423,0.9151198741592537,3,4,84111,4559,79552,0.9457978147923577,19.816019555555556,2600.808432,13.979719963649465,120,7.000000000000012E-4
6,test_20231101_134420,10350842.png,212614,7309,205305,0.965623148052339,1,3,42529,1072,41457,0.9747936702015095,18.37208711111111,2173.3855946666667,14.75943576664335,120,7.000000000000012E-4
7,test_20231101_134420,10863862.png,317432,15277,302155,0.951873157085612,2,4,66058,2180,63878,0.9669986981137788,23.077662222222223,3070.805008,13.258281206665272,120,7.000000000000012E-4
8,test_20231101_134420,11382381.png,312486,847,311639,0.9972894785686399,2,3,46745,110,46635,0.9976468071451492,21.358711111111113,2440.977456,14.2551659242164,120,7.000000000000012E-4
9,test_20231101_134420,11079715.png,443815,132247,311568,0.702022238995978,4,4,124136,18385,105751,0.8518963072758909,16.302611555555554,1952.235056,15.225482537985677,120,7.000000000000012E-4
10,test_20231101_134420,11551286.png,271883,567,271316,0.9979145441237591,1,3,40092,82,40010,0.9979547041803851,17.920218666666667,1855.396624,15.446435988293219,120,7.000000000000012E-4
1,test_20231101_134420,10404007.png,502730,26794,475936,0.9467030016112028,3,4,61265,3866,57399,0.9368970864278136,25.095884444444444,3265.691738666667,12.991051732763237,120,7.100000000000012E-4
2,test_20231101_134420,1254659.png,342646,84312,258334,0.7539384671059928,3,4,80080,11676,68404,0.8541958041958042,19.962241777777777,2914.6974026666667,13.484868869095994,120,7.100000000000012E-4
3,test_20231101_134420,10188041.png,221231,10867,210364,0.9508793975527842,2,3,41731,1524,40207,0.9634803862835781,10.502565333333333,989.3086773333333,18.177485425299558,120,7.100000000000012E-4
4,test_20231101_134420,10287332.png,216980,13642,203338,0.9371278458844133,1,3,22337,1861,20476,0.9166853203205444,9.321923555555555,744.2019093333333,19.413895809498406,120,7.100000000000012E-4
5,test_20231101_134420,11610969.png,368720,31297,337423,0.9151198741592537,3,4,84111,4559,79552,0.9457978147923577,19.816019555555556,2600.808432,13.979719963649465,120,7.100000000000012E-4
6,test_20231101_134420,10350842.png,212614,7309,205305,0.965623148052339,1,4,42529,1072,41457,0.9747936702015095,18.37208711111111,2173.3855946666667,14.75943576664335,120,7.100000000000012E-4
7,test_20231101_134420,10863862.png,317432,15277,302155,0.951873157085612,2,4,66058,2180,63878,0.9669986981137788,23.077662222222223,3070.805008,13.258281206665272,120,7.100000000000012E-4
8,test_20231101_134420,11382381.png,312486,847,311639,0.9972894785686399,1,3,46745,110,46635,0.9976468071451492,21.358711111111113,2440.977456,14.2551659242164,120,7.100000000000012E-4
9,test_20231101_134420,11079715.png,443815,132247,311568,0.702022238995978,4,4,124136,18385,105751,0.8518963072758909,16.302611555555554,1952.235056,15.225482537985677,120,7.100000000000012E-4
10,test_20231101_134420,11551286.png,271883,567,271316,0.9979145441237591,1,3,40092,82,40010,0.9979547041803851,17.920218666666667,1855.396624,15.446435988293219,120,7.100000000000012E-4
1,test_20231101_134421,10404007.png,502730,26794,475936,0.9467030016112028,2,3,61265,3866,57399,0.9368970864278136,25.095884444444444,3265.691738666667,12.991051732763237,120,7.200000000000012E-4
2,test_20231101_134421,1254659.png,342646,84312,258334,0.7539384671059928,3,3,80080,11676,68404,0.8541958041958042,19.962241777777777,2914.6974026666667,13.484868869095994,120,7.200000000000012E-4
3,test_20231101_134421,10188041.png,221231,10867,210364,0.9508793975527842,2,3,41731,1524,40207,0.9634803862835781,10.502565333333333,989.3086773333333,18.177485425299558,120,7.200000000000012E-4
4,test_20231101_134421,10287332.png,216980,13642,203338,0.9371278458844133,2,4,22337,1861,20476,0.9166853203205444,9.321923555555555,744.2019093333333,19.413895809498406,120,7.200000000000012E-4
5,test_20231101_134421,11610969.png,368720,31297,337423,0.9151198741592537,3,3,84111,4559,79552,0.9457978147923577,19.816019555555556,2600.808432,13.979719963649465,120,7.200000000000012E-4
6,test_20231101_134421,10350842.png,212614,7309,205305,0.965623148052339,2,4,42529,1072,41457,0.9747936702015095,18.37208711111111,2173.3855946666667,14.75943576664335,120,7.200000000000012E-4
7,test_20231101_134421,10863862.png,317432,15277,302155,0.951873157085612,2,4,66058,2180,63878,0.9669986981137788,23.077662222222223,3070.805008,13.258281206665272,120,7.200000000000012E-4
8,test_20231101_134421,11382381.png,312486,847,311639,0.9972894785686399,1,4,46745,110,46635,0.9976468071451492,21.358711111111113,2440.977456,14.2551659242164,120,7.200000000000012E-4
9,test_20231101_134421,11079715.png,443815,132247,311568,0.702022238995978,4,4,124136,18385,105751,0.8518963072758909,16.302611555555554,1952.235056,15.225482537985677,120,7.200000000000012E-4
10,test_20231101_134421,11551286.png,271883,567,271316,0.9979145441237591,2,4,40092,82,40010,0.9979547041803851,17.920218666666667,1855.396624,15.446435988293219,120,7.200000000000012E-4
1,test_20231101_134422,10404007.png,502730,26794,475936,0.9467030016112028,2,4,61265,3866,57399,0.9368970864278136,25.095884444444444,3265.691738666667,12.991051732763237,120,7.300000000000013E-4
2,test_20231101_134422,1254659.png,342646,84312,258334,0.7539384671059928,3,4,80080,11676,68404,0.8541958041958042,19.962241777777777,2914.6974026666667,13.484868869095994,120,7.300000000000013E-4
3,test_20231101_134422,10188041.png,221231,10867,210364,0.9508793975527842,2,3,41731,1524,40207,0.9634803862835781,10.502565333333333,989.3086773333333,18.177485425299558,120,7.300000000000013E-4
4,test_20231101_134422,10287332.png,216980,13642,203338,0.9371278458844133,2,4,22337,1861,20476,0.9166853203205444,9.321923555555555,744.2019093333333,19.413895809498406,120,7.300000000000013E-4
5,test_20231101_134422,11610969.png,368720,31297,337423,0.9151198741592537,2,4,84111,4559,79552,0.9457978147923577,19.816019555555556,2600.808432,13.979719963649465,120,7.300000000000013E-4
6,test_20231101_134422,10350842.png,212614,7309,205305,0.965623148052339,1,3,42529,1072,41457,0.9747936702015095,18.37208711111111,2173.3855946666667,14.75943576664335,120,7.300000000000013E-4
7,test_20231101_134422,10863862.png,317432,15277,302155,0.951873157085612,2,3,66058,2180,63878,0.9669986981137788,23.077662222222223,3070.805008,13.258281206665272,120,7.300000000000013E-4
8,test_20231101_134422,11382381.png,312486,847,311639,0.9972894785686399,2,4,46745,110,46635,0.9976468071451492,21.358711111111113,2440.977456,14.2551659242164,120,7.300000000000013E-4
9,test_20231101_134422,11079715.png,443815,132247,311568,0.702022238995978,3,4,124136,18385,105751,0.8518963072758909,16.302611555555554,1952.235056,15.225482537985677,120,7.300000000000013E-4
10,test_20231101_134422,11551286.png,271883,567,271316,0.9979145441237591,1,4,40092,82,40010,0.9979547041803851,17.920218666666667,1855.396624,15.446435988293219,120,7.300000000000013E-4
1,test_20231101_134422,10404007.png,502730,26794,475936,0.9467030016112028,2,4,61265,3866,57399,0.9368970864278136,25.095884444444444,3265.691738666667,12.991051732763237,120,7.400000000000013E-4
2,test_20231101_134422,1254659.png,342646,84312,258334,0.7539384671059928,3,4,80080,11676,68404,0.8541958041958042,19.962241777777777,2914.6974026666667,13.484868869095994,120,7.400000000000013E-4
3,test_20231101_134422,10188041.png,221231,10867,210364,0.9508793975527842,2,3,41731,1524,40207,0.9634803862835781,10.502565333333333,989.3086773333333,18.177485425299558,120,7.400000000000013E-4
4,test_20231101_134422,10287332.png,216980,13642,203338,0.9371278458844133,1,4,22337,1861,20476,0.9166853203205444,9.321923555555555,744.2019093333333,19.413895809498406,120,7.400000000000013E-4
5,test_20231101_134422,11610969.png,368720,31297,337423,0.9151198741592537,2,4,84111,4559,79552,0.9457978147923577,19.816019555555556,2600.808432,13.979719963649465,120,7.400000000000013E-4
6,test_20231101_134422,10350842.png,212614,7309,205305,0.965623148052339,2,4,42529,1072,41457,0.9747936702015095,18.37208711111111,2173.3855946666667,14.75943576664335,120,7.400000000000013E-4
7,test_20231101_134422,10863862.png,317432,15277,302155,0.951873157085612,2,3,66058,2180,63878,0.9669986981137788,23.077662222222223,3070.805008,13.258281206665272,120,7.400000000000013E-4
8,test_20231101_134422,11382381.png,312486,847,311639,0.9972894785686399,2,3,46745,110,46635,0.9976468071451492,21.358711111111113,2440.977456,14.2551659242164,120,7.400000000000013E-4
9,test_20231101_134422,11079715.png,443815,132247,311568,0.702022238995978,3,5,124136,18385,105751,0.8518963072758909,16.302611555555554,1952.235056,15.225482537985677,120,7.400000000000013E-4
10,test_20231101_134422,11551286.png,271883,567,271316,0.9979145441237591,2,3,40092,82,40010,0.9979547041803851,17.920218666666667,1855.396624,15.446435988293219,120,7.400000000000013E-4
1,test_20231101_134423,10404007.png,502730,26794,475936,0.9467030016112028,2,4,61265,3866,57399,0.9368970864278136,25.095884444444444,3265.691738666667,12.991051732763237,120,7.500000000000013E-4
2,test_20231101_134423,1254659.png,342646,84312,258334,0.7539384671059928,3,4,80080,11676,68404,0.8541958041958042,19.962241777777777,2914.6974026666667,13.484868869095994,120,7.500000000000013E-4
3,test_20231101_134423,10188041.png,221231,10867,210364,0.9508793975527842,3,3,41731,1524,40207,0.9634803862835781,10.502565333333333,989.3086773333333,18.177485425299558,120,7.500000000000013E-4
4,test_20231101_134423,10287332.png,216980,13642,203338,0.9371278458844133,1,3,22337,1861,20476,0.9166853203205444,9.321923555555555,744.2019093333333,19.413895809498406,120,7.500000000000013E-4
5,test_20231101_134423,11610969.png,368720,31297,337423,0.9151198741592537,2,4,84111,4559,79552,0.9457978147923577,19.816019555555556,2600.808432,13.979719963649465,120,7.500000000000013E-4
6,test_20231101_134423,10350842.png,212614,7309,205305,0.965623148052339,2,4,42529,1072,41457,0.9747936702015095,18.37208711111111,2173.3855946666667,14.75943576664335,120,7.500000000000013E-4
7,test_20231101_134423,10863862.png,317432,15277,302155,0.951873157085612,2,3,66058,2180,63878,0.9669986981137788,23.077662222222223,3070.805008,13.258281206665272,120,7.500000000000013E-4
8,test_20231101_134423,11382381.png,312486,847,311639,0.9972894785686399,2,3,46745,110,46635,0.9976468071451492,21.358711111111113,2440.977456,14.2551659242164,120,7.500000000000013E-4
9,test_20231101_134423,11079715.png,443815,132247,311568,0.702022238995978,4,4,124136,18385,105751,0.8518963072758909,16.302611555555554,1952.235056,15.225482537985677,120,7.500000000000013E-4
10,test_20231101_134423,11551286.png,271883,567,271316,0.9979145441237591,1,3,40092,82,40010,0.9979547041803851,17.920218666666667,1855.396624,15.446435988293219,120,7.500000000000013E-4
1,test_20231101_134424,10404007.png,502730,26252,476478,0.9477811151114912,3,3,61265,3789,57476,0.938153921488615,25.131184,3274.4032693333334,12.979481956084404,120,7.600000000000013E-4
2,test_20231101_134424,1254659.png,342646,84312,258334,0.7539384671059928,3,6,80080,11676,68404,0.8541958041958042,19.962241777777777,2914.6974026666667,13.484868869095994,120,7.600000000000013E-4
3,test_20231101_134424,10188041.png,221231,10767,210464,0.9513314137711261,2,3,41731,1511,40220,0.9637919052982196,10.630209777777777,1000.4570826666667,18.128818977415765,120,7.600000000000013E-4
4,test_20231101_134424,10287332.png,216980,13642,203338,0.9371278458844133,2,4,22337,1861,20476,0.9166853203205444,9.321923555555555,744.2019093333333,19.413895809498406,120,7.600000000000013E-4
5,test_20231101_134424,11610969.png,368720,31297,337423,0.9151198741592537,2,4,84111,4559,79552,0.9457978147923577,19.816019555555556,2600.808432,13.979719963649465,120,7.600000000000013E-4
6,test_20231101_134424,10350842.png,212614,7167,205447,0.9662910250500908,2,3,42529,1051,41478,0.9752874509158457,18.742366222222223,2242.4111946666667,14.623651080056984,120,7.600000000000013E-4
7,test_20231101_134424,10863862.png,317432,15217,302215,0.952062173945916,2,3,66058,2171,63887,0.9671349420206485,23.119511111111112,3072.6719413333335,13.255641662718435,120,7.600000000000013E-4
8,test_20231101_134424,11382381.png,312486,847,311639,0.9972894785686399,1,4,46745,110,46635,0.9976468071451492,21.358711111111113,2440.977456,14.2551659242164,120,7.600000000000013E-4
9,test_20231101_134424,11079715.png,443815,132247,311568,0.702022238995978,4,4,124136,18385,105751,0.8518963072758909,16.302611555555554,1952.235056,15.225482537985677,120,7.600000000000013E-4
10,test_20231101_134424,11551286.png,271883,567,271316,0.9979145441237591,2,3,40092,82,40010,0.9979547041803851,17.920218666666667,1855.396624,15.446435988293219,120,7.600000000000013E-4
1,test_20231101_134424,10404007.png,502730,26252,476478,0.9477811151114912,2,3,61265,3789,57476,0.938153921488615,25.131184,3274.4032693333334,12.979481956084404,120,7.700000000000014E-4
2,test_20231101_134424,1254659.png,342646,84312,258334,0.7539384671059928,3,4,80080,11676,68404,0.8541958041958042,19.962241777777777,2914.6974026666667,13.484868869095994,120,7.700000000000014E-4
3,test_20231101_134424,10188041.png,221231,10767,210464,0.9513314137711261,2,3,41731,1511,40220,0.9637919052982196,10.630209777777777,1000.4570826666667,18.128818977415765,120,7.700000000000014E-4
4,test_20231101_134424,10287332.png,216980,13642,203338,0.9371278458844133,2,4,22337,1861,20476,0.9166853203205444,9.321923555555555,744.2019093333333,19.413895809498406,120,7.700000000000014E-4
5,test_20231101_134424,11610969.png,368720,31297,337423,0.9151198741592537,2,4,84111,4559,79552,0.9457978147923577,19.816019555555556,2600.808432,13.979719963649465,120,7.700000000000014E-4
6,test_20231101_134424,10350842.png,212614,7167,205447,0.9662910250500908,1,3,42529,1051,41478,0.9752874509158457,18.742366222222223,2242.4111946666667,14.623651080056984,120,7.700000000000014E-4
7,test_20231101_134424,10863862.png,317432,15217,302215,0.952062173945916,2,4,66058,2171,63887,0.9671349420206485,23.119511111111112,3072.6719413333335,13.255641662718435,120,7.700000000000014E-4
8,test_20231101_134424,11382381.png,312486,847,311639,0.9972894785686399,2,4,46745,110,46635,0.9976468071451492,21.358711111111113,2440.977456,14.2551659242164,120,7.700000000000014E-4
9,test_20231101_134424,11079715.png,443815,132247,311568,0.702022238995978,3,5,124136,18385,105751,0.8518963072758909,16.302611555555554,1952.235056,15.225482537985677,120,7.700000000000014E-4
10,test_20231101_134424,11551286.png,271883,567,271316,0.9979145441237591,2,4,40092,82,40010,0.9979547041803851,17.920218666666667,1855.396624,15.446435988293219,120,7.700000000000014E-4
1,test_20231101_134425,10404007.png,502730,26252,476478,0.9477811151114912,2,4,61265,3789,57476,0.938153921488615,25.131184,3274.4032693333334,12.979481956084404,120,7.800000000000014E-4
2,test_20231101_134425,1254659.png,342646,84312,258334,0.7539384671059928,3,4,80080,11676,68404,0.8541958041958042,19.962241777777777,2914.6974026666667,13.484868869095994,120,7.800000000000014E-4
3,test_20231101_134425,10188041.png,221231,10767,210464,0.9513314137711261,2,4,41731,1511,40220,0.9637919052982196,10.630209777777777,1000.4570826666667,18.128818977415765,120,7.800000000000014E-4
4,test_20231101_134425,10287332.png,216980,13642,203338,0.9371278458844133,1,4,22337,1861,20476,0.9166853203205444,9.321923555555555,744.2019093333333,19.413895809498406,120,7.800000000000014E-4
5,test_20231101_134425,11610969.png,368720,31297,337423,0.9151198741592537,3,8,84111,4559,79552,0.9457978147923577,19.816019555555556,2600.808432,13.979719963649465,120,7.800000000000014E-4
6,test_20231101_134425,10350842.png,212614,7167,205447,0.9662910250500908,2,4,42529,1051,41478,0.9752874509158457,18.742366222222223,2242.4111946666667,14.623651080056984,120,7.800000000000014E-4
7,test_20231101_134425,10863862.png,317432,15217,302215,0.952062173945916,2,4,66058,2171,63887,0.9671349420206485,23.119511111111112,3072.6719413333335,13.255641662718435,120,7.800000000000014E-4
8,test_20231101_134425,11382381.png,312486,847,311639,0.9972894785686399,1,4,46745,110,46635,0.9976468071451492,21.358711111111113,2440.977456,14.2551659242164,120,7.800000000000014E-4
9,test_20231101_134425,11079715.png,443815,132247,311568,0.702022238995978,3,4,124136,18385,105751,0.8518963072758909,16.302611555555554,1952.235056,15.225482537985677,120,7.800000000000014E-4
10,test_20231101_134425,11551286.png,271883,567,271316,0.9979145441237591,2,3,40092,82,40010,0.9979547041803851,17.920218666666667,1855.396624,15.446435988293219,120,7.800000000000014E-4
1,test_20231101_134426,10404007.png,502730,26252,476478,0.9477811151114912,3,4,61265,3789,57476,0.938153921488615,25.131184,3274.4032693333334,12.979481956084404,120,7.900000000000014E-4
2,test_20231101_134426,1254659.png,342646,84312,258334,0.7539384671059928,3,4,80080,11676,68404,0.8541958041958042,19.962241777777777,2914.6974026666667,13.484868869095994,120,7.900000000000014E-4
3,test_20231101_134426,10188041.png,221231,10767,210464,0.9513314137711261,2,4,41731,1511,40220,0.9637919052982196,10.630209777777777,1000.4570826666667,18.128818977415765,120,7.900000000000014E-4
4,test_20231101_134426,10287332.png,216980,13642,203338,0.9371278458844133,2,4,22337,1861,20476,0.9166853203205444,9.321923555555555,744.2019093333333,19.413895809498406,120,7.900000000000014E-4
5,test_20231101_134426,11610969.png,368720,31297,337423,0.9151198741592537,3,4,84111,4559,79552,0.9457978147923577,19.816019555555556,2600.808432,13.979719963649465,120,7.900000000000014E-4
6,test_20231101_134426,10350842.png,212614,7167,205447,0.9662910250500908,1,3,42529,1051,41478,0.9752874509158457,18.742366222222223,2242.4111946666667,14.623651080056984,120,7.900000000000014E-4
7,test_20231101_134426,10863862.png,317432,15217,302215,0.952062173945916,2,3,66058,2171,63887,0.9671349420206485,23.119511111111112,3072.6719413333335,13.255641662718435,120,7.900000000000014E-4
8,test_20231101_134426,11382381.png,312486,847,311639,0.9972894785686399,2,3,46745,110,46635,0.9976468071451492,21.358711111111113,2440.977456,14.2551659242164,120,7.900000000000014E-4
9,test_20231101_134426,11079715.png,443815,132247,311568,0.702022238995978,3,4,124136,18385,105751,0.8518963072758909,16.302611555555554,1952.235056,15.225482537985677,120,7.900000000000014E-4
10,test_20231101_134426,11551286.png,271883,567,271316,0.9979145441237591,2,4,40092,82,40010,0.9979547041803851,17.920218666666667,1855.396624,15.446435988293219,120,7.900000000000014E-4
1,test_20231101_134426,10404007.png,502730,26252,476478,0.9477811151114912,2,4,61265,3789,57476,0.938153921488615,25.131184,3274.4032693333334,12.979481956084404,120,8.000000000000014E-4
2,test_20231101_134426,1254659.png,342646,84312,258334,0.7539384671059928,3,4,80080,11676,68404,0.8541958041958042,19.962241777777777,2914.6974026666667,13.484868869095994,120,8.000000000000014E-4
3,test_20231101_134426,10188041.png,221231,10767,210464,0.9513314137711261,2,4,41731,1511,40220,0.9637919052982196,10.630209777777777,1000.4570826666667,18.128818977415765,120,8.000000000000014E-4
4,test_20231101_134426,10287332.png,216980,13642,203338,0.9371278458844133,2,4,22337,1861,20476,0.9166853203205444,9.321923555555555,744.2019093333333,19.413895809498406,120,8.000000000000014E-4
5,test_20231101_134426,11610969.png,368720,31297,337423,0.9151198741592537,3,3,84111,4559,79552,0.9457978147923577,19.816019555555556,2600.808432,13.979719963649465,120,8.000000000000014E-4
6,test_20231101_134426,10350842.png,212614,7167,205447,0.9662910250500908,2,4,42529,1051,41478,0.9752874509158457,18.742366222222223,2242.4111946666667,14.623651080056984,120,8.000000000000014E-4
7,test_20231101_134426,10863862.png,317432,15217,302215,0.952062173945916,2,3,66058,2171,63887,0.9671349420206485,23.119511111111112,3072.6719413333335,13.255641662718435,120,8.000000000000014E-4
8,test_20231101_134426,11382381.png,312486,847,311639,0.9972894785686399,2,4,46745,110,46635,0.9976468071451492,21.358711111111113,2440.977456,14.2551659242164,120,8.000000000000014E-4
9,test_20231101_134426,11079715.png,443815,132247,311568,0.702022238995978,4,4,124136,18385,105751,0.8518963072758909,16.302611555555554,1952.235056,15.225482537985677,120,8.000000000000014E-4
10,test_20231101_134426,11551286.png,271883,567,271316,0.9979145441237591,1,3,40092,82,40010,0.9979547041803851,17.920218666666667,1855.396624,15.446435988293219,120,8.000000000000014E-4
1,test_20231101_134427,10404007.png,502730,26252,476478,0.9477811151114912,3,4,61265,3789,57476,0.938153921488615,25.131184,3274.4032693333334,12.979481956084404,120,8.100000000000015E-4
2,test_20231101_134427,1254659.png,342646,84312,258334,0.7539384671059928,3,4,80080,11676,68404,0.8541958041958042,19.962241777777777,2914.6974026666667,13.484868869095994,120,8.100000000000015E-4
3,test_20231101_134427,10188041.png,221231,10767,210464,0.9513314137711261,2,4,41731,1511,40220,0.9637919052982196,10.630209777777777,1000.4570826666667,18.128818977415765,120,8.100000000000015E-4
4,test_20231101_134427,10287332.png,216980,13642,203338,0.9371278458844133,2,4,22337,1861,20476,0.9166853203205444,9.321923555555555,744.2019093333333,19.413895809498406,120,8.100000000000015E-4
5,test_20231101_134427,11610969.png,368720,31297,337423,0.9151198741592537,2,3,84111,4559,79552,0.9457978147923577,19.816019555555556,2600.808432,13.979719963649465,120,8.100000000000015E-4
6,test_20231101_134427,10350842.png,212614,7167,205447,0.9662910250500908,2,4,42529,1051,41478,0.9752874509158457,18.742366222222223,2242.4111946666667,14.623651080056984,120,8.100000000000015E-4
7,test_20231101_134427,10863862.png,317432,15217,302215,0.952062173945916,3,4,66058,2171,63887,0.9671349420206485,23.119511111111112,3072.6719413333335,13.255641662718435,120,8.100000000000015E-4
8,test_20231101_134427,11382381.png,312486,847,311639,0.9972894785686399,2,3,46745,110,46635,0.9976468071451492,21.358711111111113,2440.977456,14.2551659242164,120,8.100000000000015E-4
9,test_20231101_134427,11079715.png,443815,132247,311568,0.702022238995978,4,4,124136,18385,105751,0.8518963072758909,16.302611555555554,1952.235056,15.225482537985677,120,8.100000000000015E-4
10,test_20231101_134427,11551286.png,271883,567,271316,0.9979145441237591,1,3,40092,82,40010,0.9979547041803851,17.920218666666667,1855.396624,15.446435988293219,120,8.100000000000015E-4
1,test_20231101_134428,10404007.png,502730,26252,476478,0.9477811151114912,2,11,61265,3789,57476,0.938153921488615,25.131184,3274.4032693333334,12.979481956084404,120,8.200000000000015E-4
2,test_20231101_134428,1254659.png,342646,84312,258334,0.7539384671059928,3,4,80080,11676,68404,0.8541958041958042,19.962241777777777,2914.6974026666667,13.484868869095994,120,8.200000000000015E-4
3,test_20231101_134428,10188041.png,221231,10767,210464,0.9513314137711261,2,4,41731,1511,40220,0.9637919052982196,10.630209777777777,1000.4570826666667,18.128818977415765,120,8.200000000000015E-4
4,test_20231101_134428,10287332.png,216980,13642,203338,0.9371278458844133,1,3,22337,1861,20476,0.9166853203205444,9.321923555555555,744.2019093333333,19.413895809498406,120,8.200000000000015E-4
5,test_20231101_134428,11610969.png,368720,31297,337423,0.9151198741592537,2,4,84111,4559,79552,0.9457978147923577,19.816019555555556,2600.808432,13.979719963649465,120,8.200000000000015E-4
6,test_20231101_134428,10350842.png,212614,7167,205447,0.9662910250500908,1,3,42529,1051,41478,0.9752874509158457,18.742366222222223,2242.4111946666667,14.623651080056984,120,8.200000000000015E-4
7,test_20231101_134428,10863862.png,317432,15217,302215,0.952062173945916,2,4,66058,2171,63887,0.9671349420206485,23.119511111111112,3072.6719413333335,13.255641662718435,120,8.200000000000015E-4
8,test_20231101_134428,11382381.png,312486,847,311639,0.9972894785686399,2,4,46745,110,46635,0.9976468071451492,21.358711111111113,2440.977456,14.2551659242164,120,8.200000000000015E-4
9,test_20231101_134428,11079715.png,443815,132247,311568,0.702022238995978,3,5,124136,18385,105751,0.8518963072758909,16.302611555555554,1952.235056,15.225482537985677,120,8.200000000000015E-4
10,test_20231101_134428,11551286.png,271883,567,271316,0.9979145441237591,1,4,40092,82,40010,0.9979547041803851,17.920218666666667,1855.396624,15.446435988293219,120,8.200000000000015E-4
1,test_20231101_134428,10404007.png,502730,26252,476478,0.9477811151114912,2,4,61265,3789,57476,0.938153921488615,25.131184,3274.4032693333334,12.979481956084404,120,8.300000000000015E-4
2,test_20231101_134428,1254659.png,342646,84312,258334,0.7539384671059928,3,4,80080,11676,68404,0.8541958041958042,19.962241777777777,2914.6974026666667,13.484868869095994,120,8.300000000000015E-4
3,test_20231101_134428,10188041.png,221231,10767,210464,0.9513314137711261,2,3,41731,1511,40220,0.9637919052982196,10.630209777777777,1000.4570826666667,18.128818977415765,120,8.300000000000015E-4
4,test_20231101_134428,10287332.png,216980,13642,203338,0.9371278458844133,2,4,22337,1861,20476,0.9166853203205444,9.321923555555555,744.2019093333333,19.413895809498406,120,8.300000000000015E-4
5,test_20231101_134428,11610969.png,368720,31297,337423,0.9151198741592537,3,3,84111,4559,79552,0.9457978147923577,19.816019555555556,2600.808432,13.979719963649465,120,8.300000000000015E-4
6,test_20231101_134428,10350842.png,212614,7167,205447,0.9662910250500908,2,3,42529,1051,41478,0.9752874509158457,18.742366222222223,2242.4111946666667,14.623651080056984,120,8.300000000000015E-4
7,test_20231101_134428,10863862.png,317432,15217,302215,0.952062173945916,2,4,66058,2171,63887,0.9671349420206485,23.119511111111112,3072.6719413333335,13.255641662718435,120,8.300000000000015E-4
8,test_20231101_134428,11382381.png,312486,847,311639,0.9972894785686399,1,3,46745,110,46635,0.9976468071451492,21.358711111111113,2440.977456,14.2551659242164,120,8.300000000000015E-4
9,test_20231101_134428,11079715.png,443815,132247,311568,0.702022238995978,3,4,124136,18385,105751,0.8518963072758909,16.302611555555554,1952.235056,15.225482537985677,120,8.300000000000015E-4
10,test_20231101_134428,11551286.png,271883,567,271316,0.9979145441237591,1,3,40092,82,40010,0.9979547041803851,17.920218666666667,1855.396624,15.446435988293219,120,8.300000000000015E-4
1,test_20231101_134429,10404007.png,502730,26252,476478,0.9477811151114912,2,4,61265,3789,57476,0.938153921488615,25.131184,3274.4032693333334,12.979481956084404,120,8.400000000000016E-4
2,test_20231101_134429,1254659.png,342646,84312,258334,0.7539384671059928,3,4,80080,11676,68404,0.8541958041958042,19.962241777777777,2914.6974026666667,13.484868869095994,120,8.400000000000016E-4
3,test_20231101_134429,10188041.png,221231,10767,210464,0.9513314137711261,2,3,41731,1511,40220,0.9637919052982196,10.630209777777777,1000.4570826666667,18.128818977415765,120,8.400000000000016E-4
4,test_20231101_134429,10287332.png,216980,13642,203338,0.9371278458844133,2,4,22337,1861,20476,0.9166853203205444,9.321923555555555,744.2019093333333,19.413895809498406,120,8.400000000000016E-4
5,test_20231101_134429,11610969.png,368720,31297,337423,0.9151198741592537,2,4,84111,4559,79552,0.9457978147923577,19.816019555555556,2600.808432,13.979719963649465,120,8.400000000000016E-4
6,test_20231101_134429,10350842.png,212614,7167,205447,0.9662910250500908,2,4,42529,1051,41478,0.9752874509158457,18.742366222222223,2242.4111946666667,14.623651080056984,120,8.400000000000016E-4
7,test_20231101_134429,10863862.png,317432,15217,302215,0.952062173945916,2,3,66058,2171,63887,0.9671349420206485,23.119511111111112,3072.6719413333335,13.255641662718435,120,8.400000000000016E-4
8,test_20231101_134429,11382381.png,312486,847,311639,0.9972894785686399,1,3,46745,110,46635,0.9976468071451492,21.358711111111113,2440.977456,14.2551659242164,120,8.400000000000016E-4
9,test_20231101_134429,11079715.png,443815,132247,311568,0.702022238995978,3,5,124136,18385,105751,0.8518963072758909,16.302611555555554,1952.235056,15.225482537985677,120,8.400000000000016E-4
10,test_20231101_134429,11551286.png,271883,567,271316,0.9979145441237591,1,3,40092,82,40010,0.9979547041803851,17.920218666666667,1855.396624,15.446435988293219,120,8.400000000000016E-4
1,test_20231101_134430,10404007.png,502730,26252,476478,0.9477811151114912,3,3,61265,3789,57476,0.938153921488615,25.131184,3274.4032693333334,12.979481956084404,120,8.500000000000016E-4
2,test_20231101_134430,1254659.png,342646,84312,258334,0.7539384671059928,3,4,80080,11676,68404,0.8541958041958042,19.962241777777777,2914.6974026666667,13.484868869095994,120,8.500000000000016E-4
3,test_20231101_134430,10188041.png,221231,10767,210464,0.9513314137711261,2,4,41731,1511,40220,0.9637919052982196,10.630209777777777,1000.4570826666667,18.128818977415765,120,8.500000000000016E-4
4,test_20231101_134430,10287332.png,216980,13642,203338,0.9371278458844133,1,4,22337,1861,20476,0.9166853203205444,9.321923555555555,744.2019093333333,19.413895809498406,120,8.500000000000016E-4
5,test_20231101_134430,11610969.png,368720,31297,337423,0.9151198741592537,2,3,84111,4559,79552,0.9457978147923577,19.816019555555556,2600.808432,13.979719963649465,120,8.500000000000016E-4
6,test_20231101_134430,10350842.png,212614,7167,205447,0.9662910250500908,1,4,42529,1051,41478,0.9752874509158457,18.742366222222223,2242.4111946666667,14.623651080056984,120,8.500000000000016E-4
7,test_20231101_134430,10863862.png,317432,15217,302215,0.952062173945916,2,4,66058,2171,63887,0.9671349420206485,23.119511111111112,3072.6719413333335,13.255641662718435,120,8.500000000000016E-4
8,test_20231101_134430,11382381.png,312486,847,311639,0.9972894785686399,2,3,46745,110,46635,0.9976468071451492,21.358711111111113,2440.977456,14.2551659242164,120,8.500000000000016E-4
9,test_20231101_134430,11079715.png,443815,132247,311568,0.702022238995978,3,5,124136,18385,105751,0.8518963072758909,16.302611555555554,1952.235056,15.225482537985677,120,8.500000000000016E-4
10,test_20231101_134430,11551286.png,271883,567,271316,0.9979145441237591,1,3,40092,82,40010,0.9979547041803851,17.920218666666667,1855.396624,15.446435988293219,120,8.500000000000016E-4
1,test_20231101_134430,10404007.png,502730,26252,476478,0.9477811151114912,2,4,61265,3789,57476,0.938153921488615,25.131184,3274.4032693333334,12.979481956084404,120,8.600000000000016E-4
2,test_20231101_134430,1254659.png,342646,84312,258334,0.7539384671059928,3,4,80080,11676,68404,0.8541958041958042,19.962241777777777,2914.6974026666667,13.484868869095994,120,8.600000000000016E-4
3,test_20231101_134430,10188041.png,221231,10767,210464,0.9513314137711261,2,3,41731,1511,40220,0.9637919052982196,10.630209777777777,1000.4570826666667,18.128818977415765,120,8.600000000000016E-4
4,test_20231101_134430,10287332.png,216980,13642,203338,0.9371278458844133,2,4,22337,1861,20476,0.9166853203205444,9.321923555555555,744.2019093333333,19.413895809498406,120,8.600000000000016E-4
5,test_20231101_134430,11610969.png,368720,31297,337423,0.9151198741592537,2,5,84111,4559,79552,0.9457978147923577,19.816019555555556,2600.808432,13.979719963649465,120,8.600000000000016E-4
6,test_20231101_134430,10350842.png,212614,7167,205447,0.9662910250500908,1,4,42529,1051,41478,0.9752874509158457,18.742366222222223,2242.4111946666667,14.623651080056984,120,8.600000000000016E-4
7,test_20231101_134430,10863862.png,317432,15217,302215,0.952062173945916,2,4,66058,2171,63887,0.9671349420206485,23.119511111111112,3072.6719413333335,13.255641662718435,120,8.600000000000016E-4
8,test_20231101_134430,11382381.png,312486,847,311639,0.9972894785686399,2,3,46745,110,46635,0.9976468071451492,21.358711111111113,2440.977456,14.2551659242164,120,8.600000000000016E-4
9,test_20231101_134430,11079715.png,443815,132247,311568,0.702022238995978,3,5,124136,18385,105751,0.8518963072758909,16.302611555555554,1952.235056,15.225482537985677,120,8.600000000000016E-4
10,test_20231101_134430,11551286.png,271883,567,271316,0.9979145441237591,1,3,40092,82,40010,0.9979547041803851,17.920218666666667,1855.396624,15.446435988293219,120,8.600000000000016E-4
1,test_20231101_134431,10404007.png,502730,26252,476478,0.9477811151114912,2,4,61265,3789,57476,0.938153921488615,25.131184,3274.4032693333334,12.979481956084404,120,8.700000000000016E-4
2,test_20231101_134431,1254659.png,342646,84312,258334,0.7539384671059928,3,4,80080,11676,68404,0.8541958041958042,19.962241777777777,2914.6974026666667,13.484868869095994,120,8.700000000000016E-4
3,test_20231101_134431,10188041.png,221231,10767,210464,0.9513314137711261,2,4,41731,1511,40220,0.9637919052982196,10.630209777777777,1000.4570826666667,18.128818977415765,120,8.700000000000016E-4
4,test_20231101_134431,10287332.png,216980,13642,203338,0.9371278458844133,2,4,22337,1861,20476,0.9166853203205444,9.321923555555555,744.2019093333333,19.413895809498406,120,8.700000000000016E-4
5,test_20231101_134431,11610969.png,368720,31297,337423,0.9151198741592537,3,4,84111,4559,79552,0.9457978147923577,19.816019555555556,2600.808432,13.979719963649465,120,8.700000000000016E-4
6,test_20231101_134431,10350842.png,212614,7167,205447,0.9662910250500908,2,4,42529,1051,41478,0.9752874509158457,18.742366222222223,2242.4111946666667,14.623651080056984,120,8.700000000000016E-4
7,test_20231101_134431,10863862.png,317432,15217,302215,0.952062173945916,2,4,66058,2171,63887,0.9671349420206485,23.119511111111112,3072.6719413333335,13.255641662718435,120,8.700000000000016E-4
8,test_20231101_134431,11382381.png,312486,847,311639,0.9972894785686399,1,3,46745,110,46635,0.9976468071451492,21.358711111111113,2440.977456,14.2551659242164,120,8.700000000000016E-4
9,test_20231101_134431,11079715.png,443815,132247,311568,0.702022238995978,4,5,124136,18385,105751,0.8518963072758909,16.302611555555554,1952.235056,15.225482537985677,120,8.700000000000016E-4
10,test_20231101_134431,11551286.png,271883,567,271316,0.9979145441237591,1,4,40092,82,40010,0.9979547041803851,17.920218666666667,1855.396624,15.446435988293219,120,8.700000000000016E-4
1,test_20231101_134432,10404007.png,502730,26252,476478,0.9477811151114912,3,3,61265,3789,57476,0.938153921488615,25.131184,3274.4032693333334,12.979481956084404,120,8.800000000000017E-4
2,test_20231101_134432,1254659.png,342646,84312,258334,0.7539384671059928,3,4,80080,11676,68404,0.8541958041958042,19.962241777777777,2914.6974026666667,13.484868869095994,120,8.800000000000017E-4
3,test_20231101_134432,10188041.png,221231,10767,210464,0.9513314137711261,2,3,41731,1511,40220,0.9637919052982196,10.630209777777777,1000.4570826666667,18.128818977415765,120,8.800000000000017E-4
4,test_20231101_134432,10287332.png,216980,13642,203338,0.9371278458844133,1,3,22337,1861,20476,0.9166853203205444,9.321923555555555,744.2019093333333,19.413895809498406,120,8.800000000000017E-4
5,test_20231101_134432,11610969.png,368720,31297,337423,0.9151198741592537,3,3,84111,4559,79552,0.9457978147923577,19.816019555555556,2600.808432,13.979719963649465,120,8.800000000000017E-4
6,test_20231101_134432,10350842.png,212614,7167,205447,0.9662910250500908,2,4,42529,1051,41478,0.9752874509158457,18.742366222222223,2242.4111946666667,14.623651080056984,120,8.800000000000017E-4
7,test_20231101_134432,10863862.png,317432,15217,302215,0.952062173945916,3,4,66058,2171,63887,0.9671349420206485,23.119511111111112,3072.6719413333335,13.255641662718435,120,8.800000000000017E-4
8,test_20231101_134432,11382381.png,312486,847,311639,0.9972894785686399,1,4,46745,110,46635,0.9976468071451492,21.358711111111113,2440.977456,14.2551659242164,120,8.800000000000017E-4
9,test_20231101_134432,11079715.png,443815,132247,311568,0.702022238995978,3,5,124136,18385,105751,0.8518963072758909,16.302611555555554,1952.235056,15.225482537985677,120,8.800000000000017E-4
10,test_20231101_134432,11551286.png,271883,567,271316,0.9979145441237591,1,4,40092,82,40010,0.9979547041803851,17.920218666666667,1855.396624,15.446435988293219,120,8.800000000000017E-4
1,test_20231101_134432,10404007.png,502730,26252,476478,0.9477811151114912,2,3,61265,3789,57476,0.938153921488615,25.131184,3274.4032693333334,12.979481956084404,120,8.900000000000017E-4
2,test_20231101_134432,1254659.png,342646,84312,258334,0.7539384671059928,3,4,80080,11676,68404,0.8541958041958042,19.962241777777777,2914.6974026666667,13.484868869095994,120,8.900000000000017E-4
3,test_20231101_134432,10188041.png,221231,10767,210464,0.9513314137711261,2,4,41731,1511,40220,0.9637919052982196,10.630209777777777,1000.4570826666667,18.128818977415765,120,8.900000000000017E-4
4,test_20231101_134432,10287332.png,216980,13642,203338,0.9371278458844133,2,4,22337,1861,20476,0.9166853203205444,9.321923555555555,744.2019093333333,19.413895809498406,120,8.900000000000017E-4
5,test_20231101_134432,11610969.png,368720,31297,337423,0.9151198741592537,2,4,84111,4559,79552,0.9457978147923577,19.816019555555556,2600.808432,13.979719963649465,120,8.900000000000017E-4
6,test_20231101_134432,10350842.png,212614,7167,205447,0.9662910250500908,1,4,42529,1051,41478,0.9752874509158457,18.742366222222223,2242.4111946666667,14.623651080056984,120,8.900000000000017E-4
7,test_20231101_134432,10863862.png,317432,15217,302215,0.952062173945916,2,3,66058,2171,63887,0.9671349420206485,23.119511111111112,3072.6719413333335,13.255641662718435,120,8.900000000000017E-4
8,test_20231101_134432,11382381.png,312486,847,311639,0.9972894785686399,2,3,46745,110,46635,0.9976468071451492,21.358711111111113,2440.977456,14.2551659242164,120,8.900000000000017E-4
9,test_20231101_134432,11079715.png,443815,132247,311568,0.702022238995978,3,5,124136,18385,105751,0.8518963072758909,16.302611555555554,1952.235056,15.225482537985677,120,8.900000000000017E-4
10,test_20231101_134432,11551286.png,271883,567,271316,0.9979145441237591,1,4,40092,82,40010,0.9979547041803851,17.920218666666667,1855.396624,15.446435988293219,120,8.900000000000017E-4
1,test_20231101_134433,10404007.png,502730,26252,476478,0.9477811151114912,2,3,61265,3789,57476,0.938153921488615,25.131184,3274.4032693333334,12.979481956084404,120,9.000000000000017E-4
2,test_20231101_134433,1254659.png,342646,84312,258334,0.7539384671059928,3,4,80080,11676,68404,0.8541958041958042,19.962241777777777,2914.6974026666667,13.484868869095994,120,9.000000000000017E-4
3,test_20231101_134433,10188041.png,221231,10767,210464,0.9513314137711261,2,4,41731,1511,40220,0.9637919052982196,10.630209777777777,1000.4570826666667,18.128818977415765,120,9.000000000000017E-4
4,test_20231101_134433,10287332.png,216980,13642,203338,0.9371278458844133,1,3,22337,1861,20476,0.9166853203205444,9.321923555555555,744.2019093333333,19.413895809498406,120,9.000000000000017E-4
5,test_20231101_134433,11610969.png,368720,31297,337423,0.9151198741592537,2,3,84111,4559,79552,0.9457978147923577,19.816019555555556,2600.808432,13.979719963649465,120,9.000000000000017E-4
6,test_20231101_134433,10350842.png,212614,7167,205447,0.9662910250500908,1,3,42529,1051,41478,0.9752874509158457,18.742366222222223,2242.4111946666667,14.623651080056984,120,9.000000000000017E-4
7,test_20231101_134433,10863862.png,317432,15217,302215,0.952062173945916,2,3,66058,2171,63887,0.9671349420206485,23.119511111111112,3072.6719413333335,13.255641662718435,120,9.000000000000017E-4
8,test_20231101_134433,11382381.png,312486,847,311639,0.9972894785686399,1,3,46745,110,46635,0.9976468071451492,21.358711111111113,2440.977456,14.2551659242164,120,9.000000000000017E-4
9,test_20231101_134433,11079715.png,443815,132247,311568,0.702022238995978,4,4,124136,18385,105751,0.8518963072758909,16.302611555555554,1952.235056,15.225482537985677,120,9.000000000000017E-4
10,test_20231101_134433,11551286.png,271883,567,271316,0.9979145441237591,1,3,40092,82,40010,0.9979547041803851,17.920218666666667,1855.396624,15.446435988293219,120,9.000000000000017E-4
1,test_20231101_134434,10404007.png,502730,26252,476478,0.9477811151114912,3,4,61265,3789,57476,0.938153921488615,25.131184,3274.4032693333334,12.979481956084404,120,9.100000000000017E-4
2,test_20231101_134434,1254659.png,342646,84312,258334,0.7539384671059928,3,13,80080,11676,68404,0.8541958041958042,19.962241777777777,2914.6974026666667,13.484868869095994,120,9.100000000000017E-4
3,test_20231101_134434,10188041.png,221231,10767,210464,0.9513314137711261,2,4,41731,1511,40220,0.9637919052982196,10.630209777777777,1000.4570826666667,18.128818977415765,120,9.100000000000017E-4
4,test_20231101_134434,10287332.png,216980,13642,203338,0.9371278458844133,2,4,22337,1861,20476,0.9166853203205444,9.321923555555555,744.2019093333333,19.413895809498406,120,9.100000000000017E-4
5,test_20231101_134434,11610969.png,368720,31297,337423,0.9151198741592537,2,4,84111,4559,79552,0.9457978147923577,19.816019555555556,2600.808432,13.979719963649465,120,9.100000000000017E-4
6,test_20231101_134434,10350842.png,212614,7167,205447,0.9662910250500908,2,4,42529,1051,41478,0.9752874509158457,18.742366222222223,2242.4111946666667,14.623651080056984,120,9.100000000000017E-4
7,test_20231101_134434,10863862.png,317432,15217,302215,0.952062173945916,2,4,66058,2171,63887,0.9671349420206485,23.119511111111112,3072.6719413333335,13.255641662718435,120,9.100000000000017E-4
8,test_20231101_134434,11382381.png,312486,847,311639,0.9972894785686399,1,4,46745,110,46635,0.9976468071451492,21.358711111111113,2440.977456,14.2551659242164,120,9.100000000000017E-4
9,test_20231101_134434,11079715.png,443815,132247,311568,0.702022238995978,4,4,124136,18385,105751,0.8518963072758909,16.302611555555554,1952.235056,15.225482537985677,120,9.100000000000017E-4
10,test_20231101_134434,11551286.png,271883,567,271316,0.9979145441237591,1,3,40092,82,40010,0.9979547041803851,17.920218666666667,1855.396624,15.446435988293219,120,9.100000000000017E-4
1,test_20231101_134434,10404007.png,502730,26252,476478,0.9477811151114912,2,4,61265,3789,57476,0.938153921488615,25.131184,3274.4032693333334,12.979481956084404,120,9.200000000000018E-4
2,test_20231101_134434,1254659.png,342646,84312,258334,0.7539384671059928,3,4,80080,11676,68404,0.8541958041958042,19.962241777777777,2914.6974026666667,13.484868869095994,120,9.200000000000018E-4
3,test_20231101_134434,10188041.png,221231,10767,210464,0.9513314137711261,2,3,41731,1511,40220,0.9637919052982196,10.630209777777777,1000.4570826666667,18.128818977415765,120,9.200000000000018E-4
4,test_20231101_134434,10287332.png,216980,13642,203338,0.9371278458844133,1,3,22337,1861,20476,0.9166853203205444,9.321923555555555,744.2019093333333,19.413895809498406,120,9.200000000000018E-4
5,test_20231101_134434,11610969.png,368720,31297,337423,0.9151198741592537,2,3,84111,4559,79552,0.9457978147923577,19.816019555555556,2600.808432,13.979719963649465,120,9.200000000000018E-4
6,test_20231101_134434,10350842.png,212614,7167,205447,0.9662910250500908,2,4,42529,1051,41478,0.9752874509158457,18.742366222222223,2242.4111946666667,14.623651080056984,120,9.200000000000018E-4
7,test_20231101_134434,10863862.png,317432,15217,302215,0.952062173945916,2,3,66058,2171,63887,0.9671349420206485,23.119511111111112,3072.6719413333335,13.255641662718435,120,9.200000000000018E-4
8,test_20231101_134434,11382381.png,312486,847,311639,0.9972894785686399,2,3,46745,110,46635,0.9976468071451492,21.358711111111113,2440.977456,14.2551659242164,120,9.200000000000018E-4
9,test_20231101_134434,11079715.png,443815,132247,311568,0.702022238995978,4,4,124136,18385,105751,0.8518963072758909,16.302611555555554,1952.235056,15.225482537985677,120,9.200000000000018E-4
10,test_20231101_134434,11551286.png,271883,567,271316,0.9979145441237591,1,3,40092,82,40010,0.9979547041803851,17.920218666666667,1855.396624,15.446435988293219,120,9.200000000000018E-4
1,test_20231101_134435,10404007.png,502730,26252,476478,0.9477811151114912,2,13,61265,3789,57476,0.938153921488615,25.131184,3274.4032693333334,12.979481956084404,120,9.300000000000018E-4
2,test_20231101_134435,1254659.png,342646,84312,258334,0.7539384671059928,3,4,80080,11676,68404,0.8541958041958042,19.962241777777777,2914.6974026666667,13.484868869095994,120,9.300000000000018E-4
3,test_20231101_134435,10188041.png,221231,10767,210464,0.9513314137711261,2,4,41731,1511,40220,0.9637919052982196,10.630209777777777,1000.4570826666667,18.128818977415765,120,9.300000000000018E-4
4,test_20231101_134435,10287332.png,216980,13642,203338,0.9371278458844133,2,3,22337,1861,20476,0.9166853203205444,9.321923555555555,744.2019093333333,19.413895809498406,120,9.300000000000018E-4
5,test_20231101_134435,11610969.png,368720,31297,337423,0.9151198741592537,2,4,84111,4559,79552,0.9457978147923577,19.816019555555556,2600.808432,13.979719963649465,120,9.300000000000018E-4
6,test_20231101_134435,10350842.png,212614,7167,205447,0.9662910250500908,2,4,42529,1051,41478,0.9752874509158457,18.742366222222223,2242.4111946666667,14.623651080056984,120,9.300000000000018E-4
7,test_20231101_134435,10863862.png,317432,15217,302215,0.952062173945916,2,4,66058,2171,63887,0.9671349420206485,23.119511111111112,3072.6719413333335,13.255641662718435,120,9.300000000000018E-4
8,test_20231101_134435,11382381.png,312486,847,311639,0.9972894785686399,2,3,46745,110,46635,0.9976468071451492,21.358711111111113,2440.977456,14.2551659242164,120,9.300000000000018E-4
9,test_20231101_134435,11079715.png,443815,132247,311568,0.702022238995978,4,4,124136,18385,105751,0.8518963072758909,16.302611555555554,1952.235056,15.225482537985677,120,9.300000000000018E-4
10,test_20231101_134435,11551286.png,271883,567,271316,0.9979145441237591,2,4,40092,82,40010,0.9979547041803851,17.920218666666667,1855.396624,15.446435988293219,120,9.300000000000018E-4
1,test_20231101_134436,10404007.png,502730,26252,476478,0.9477811151114912,2,4,61265,3789,57476,0.938153921488615,25.131184,3274.4032693333334,12.979481956084404,120,9.400000000000018E-4
2,test_20231101_134436,1254659.png,342646,84312,258334,0.7539384671059928,3,4,80080,11676,68404,0.8541958041958042,19.962241777777777,2914.6974026666667,13.484868869095994,120,9.400000000000018E-4
3,test_20231101_134436,10188041.png,221231,10767,210464,0.9513314137711261,2,4,41731,1511,40220,0.9637919052982196,10.630209777777777,1000.4570826666667,18.128818977415765,120,9.400000000000018E-4
4,test_20231101_134436,10287332.png,216980,13642,203338,0.9371278458844133,3,3,22337,1861,20476,0.9166853203205444,9.321923555555555,744.2019093333333,19.413895809498406,120,9.400000000000018E-4
5,test_20231101_134436,11610969.png,368720,31297,337423,0.9151198741592537,3,3,84111,4559,79552,0.9457978147923577,19.816019555555556,2600.808432,13.979719963649465,120,9.400000000000018E-4
6,test_20231101_134436,10350842.png,212614,7167,205447,0.9662910250500908,1,3,42529,1051,41478,0.9752874509158457,18.742366222222223,2242.4111946666667,14.623651080056984,120,9.400000000000018E-4
7,test_20231101_134436,10863862.png,317432,15217,302215,0.952062173945916,2,3,66058,2171,63887,0.9671349420206485,23.119511111111112,3072.6719413333335,13.255641662718435,120,9.400000000000018E-4
8,test_20231101_134436,11382381.png,312486,847,311639,0.9972894785686399,2,3,46745,110,46635,0.9976468071451492,21.358711111111113,2440.977456,14.2551659242164,120,9.400000000000018E-4
9,test_20231101_134436,11079715.png,443815,132247,311568,0.702022238995978,4,4,124136,18385,105751,0.8518963072758909,16.302611555555554,1952.235056,15.225482537985677,120,9.400000000000018E-4
10,test_20231101_134436,11551286.png,271883,567,271316,0.9979145441237591,1,3,40092,82,40010,0.9979547041803851,17.920218666666667,1855.396624,15.446435988293219,120,9.400000000000018E-4
1,test_20231101_134437,10404007.png,502730,26252,476478,0.9477811151114912,2,4,61265,3789,57476,0.938153921488615,25.131184,3274.4032693333334,12.979481956084404,120,9.500000000000018E-4
2,test_20231101_134437,1254659.png,342646,84312,258334,0.7539384671059928,3,4,80080,11676,68404,0.8541958041958042,19.962241777777777,2914.6974026666667,13.484868869095994,120,9.500000000000018E-4
3,test_20231101_134437,10188041.png,221231,10767,210464,0.9513314137711261,2,3,41731,1511,40220,0.9637919052982196,10.630209777777777,1000.4570826666667,18.128818977415765,120,9.500000000000018E-4
4,test_20231101_134437,10287332.png,216980,13642,203338,0.9371278458844133,1,3,22337,1861,20476,0.9166853203205444,9.321923555555555,744.2019093333333,19.413895809498406,120,9.500000000000018E-4
5,test_20231101_134437,11610969.png,368720,31297,337423,0.9151198741592537,2,3,84111,4559,79552,0.9457978147923577,19.816019555555556,2600.808432,13.979719963649465,120,9.500000000000018E-4
6,test_20231101_134437,10350842.png,212614,7167,205447,0.9662910250500908,2,3,42529,1051,41478,0.9752874509158457,18.742366222222223,2242.4111946666667,14.623651080056984,120,9.500000000000018E-4
7,test_20231101_134437,10863862.png,317432,15217,302215,0.952062173945916,2,4,66058,2171,63887,0.9671349420206485,23.119511111111112,3072.6719413333335,13.255641662718435,120,9.500000000000018E-4
8,test_20231101_134437,11382381.png,312486,847,311639,0.9972894785686399,1,3,46745,110,46635,0.9976468071451492,21.358711111111113,2440.977456,14.2551659242164,120,9.500000000000018E-4
9,test_20231101_134437,11079715.png,443815,132247,311568,0.702022238995978,3,5,124136,18385,105751,0.8518963072758909,16.302611555555554,1952.235056,15.225482537985677,120,9.500000000000018E-4
10,test_20231101_134437,11551286.png,271883,567,271316,0.9979145441237591,1,3,40092,82,40010,0.9979547041803851,17.920218666666667,1855.396624,15.446435988293219,120,9.500000000000018E-4
1,test_20231101_134437,10404007.png,502730,26252,476478,0.9477811151114912,3,4,61265,3789,57476,0.938153921488615,25.131184,3274.4032693333334,12.979481956084404,120,9.600000000000019E-4
2,test_20231101_134437,1254659.png,342646,84312,258334,0.7539384671059928,3,4,80080,11676,68404,0.8541958041958042,19.962241777777777,2914.6974026666667,13.484868869095994,120,9.600000000000019E-4
3,test_20231101_134437,10188041.png,221231,10647,210584,0.9518738332331365,2,4,41731,1498,40233,0.964103424312861,10.677793777777778,1005.6859466666667,18.106179794755448,120,9.600000000000019E-4
4,test_20231101_134437,10287332.png,216980,13642,203338,0.9371278458844133,1,4,22337,1861,20476,0.9166853203205444,9.321923555555555,744.2019093333333,19.413895809498406,120,9.600000000000019E-4
5,test_20231101_134437,11610969.png,368720,31297,337423,0.9151198741592537,3,4,84111,4559,79552,0.9457978147923577,19.816019555555556,2600.808432,13.979719963649465,120,9.600000000000019E-4
6,test_20231101_134437,10350842.png,212614,7167,205447,0.9662910250500908,1,3,42529,1051,41478,0.9752874509158457,18.742366222222223,2242.4111946666667,14.623651080056984,120,9.600000000000019E-4
7,test_20231101_134437,10863862.png,317432,15217,302215,0.952062173945916,2,3,66058,2171,63887,0.9671349420206485,23.119511111111112,3072.6719413333335,13.255641662718435,120,9.600000000000019E-4
8,test_20231101_134437,11382381.png,312486,847,311639,0.9972894785686399,2,3,46745,110,46635,0.9976468071451492,21.358711111111113,2440.977456,14.2551659242164,120,9.600000000000019E-4
9,test_20231101_134437,11079715.png,443815,132247,311568,0.702022238995978,3,5,124136,18385,105751,0.8518963072758909,16.302611555555554,1952.235056,15.225482537985677,120,9.600000000000019E-4
10,test_20231101_134437,11551286.png,271883,567,271316,0.9979145441237591,1,4,40092,82,40010,0.9979547041803851,17.920218666666667,1855.396624,15.446435988293219,120,9.600000000000019E-4
1,test_20231101_134438,10404007.png,502730,26252,476478,0.9477811151114912,2,3,61265,3789,57476,0.938153921488615,25.131184,3274.4032693333334,12.979481956084404,120,9.700000000000019E-4
2,test_20231101_134438,1254659.png,342646,84312,258334,0.7539384671059928,3,4,80080,11676,68404,0.8541958041958042,19.962241777777777,2914.6974026666667,13.484868869095994,120,9.700000000000019E-4
3,test_20231101_134438,10188041.png,221231,10647,210584,0.9518738332331365,2,3,41731,1498,40233,0.964103424312861,10.677793777777778,1005.6859466666667,18.106179794755448,120,9.700000000000019E-4
4,test_20231101_134438,10287332.png,216980,13642,203338,0.9371278458844133,2,3,22337,1861,20476,0.9166853203205444,9.321923555555555,744.2019093333333,19.413895809498406,120,9.700000000000019E-4
5,test_20231101_134438,11610969.png,368720,31297,337423,0.9151198741592537,3,4,84111,4559,79552,0.9457978147923577,19.816019555555556,2600.808432,13.979719963649465,120,9.700000000000019E-4
6,test_20231101_134438,10350842.png,212614,7167,205447,0.9662910250500908,2,3,42529,1051,41478,0.9752874509158457,18.742366222222223,2242.4111946666667,14.623651080056984,120,9.700000000000019E-4
7,test_20231101_134438,10863862.png,317432,15217,302215,0.952062173945916,2,3,66058,2171,63887,0.9671349420206485,23.119511111111112,3072.6719413333335,13.255641662718435,120,9.700000000000019E-4
8,test_20231101_134438,11382381.png,312486,847,311639,0.9972894785686399,1,4,46745,110,46635,0.9976468071451492,21.358711111111113,2440.977456,14.2551659242164,120,9.700000000000019E-4
9,test_20231101_134438,11079715.png,443815,132247,311568,0.702022238995978,4,5,124136,18385,105751,0.8518963072758909,16.302611555555554,1952.235056,15.225482537985677,120,9.700000000000019E-4
10,test_20231101_134438,11551286.png,271883,567,271316,0.9979145441237591,2,3,40092,82,40010,0.9979547041803851,17.920218666666667,1855.396624,15.446435988293219,120,9.700000000000019E-4
1,test_20231101_134439,10404007.png,502730,25769,476961,0.9487418693931136,2,4,61265,3726,57539,0.9391822410838162,25.164213333333333,3281.9456746666665,12.969489728734926,120,9.80000000000002E-4
2,test_20231101_134439,1254659.png,342646,84152,258494,0.7544054213386411,3,4,80080,11662,68418,0.8543706293706294,20.031966222222223,2929.3778613333334,13.463049657968673,120,9.80000000000002E-4
3,test_20231101_134439,10188041.png,221231,10504,210727,0.9525202164253653,2,3,41731,1483,40248,0.9644628693297549,10.761733333333334,1020.367216,18.04323864418027,120,9.80000000000002E-4
4,test_20231101_134439,10287332.png,216980,13559,203421,0.9375103696193198,1,3,22337,1850,20487,0.9171777767829162,9.35664,750.804448,19.375535240148544,120,9.80000000000002E-4
5,test_20231101_134439,11610969.png,368720,30692,338028,0.9167606856151009,2,3,84111,4481,79630,0.9467251607994198,20.176567111111112,2670.363557333333,13.865099683440906,120,9.80000000000002E-4
6,test_20231101_134439,10350842.png,212614,7047,205567,0.9668554281467824,1,4,42529,1033,41496,0.9757106915281337,18.897082666666666,2271.0700746666666,14.568498261323061,120,9.80000000000002E-4
7,test_20231101_134439,10863862.png,317432,14797,302635,0.9533852919680436,2,4,66058,2114,63944,0.9679978200974901,23.30008,3113.238448,13.198679755902349,120,9.80000000000002E-4
8,test_20231101_134439,11382381.png,312486,767,311719,0.9975454900379537,2,3,46745,101,46644,0.9978393411060006,21.620851555555557,2482.477712,14.181950028339719,120,9.80000000000002E-4
9,test_20231101_134439,11079715.png,443815,132167,311648,0.7022024942825276,3,4,124136,18379,105757,0.8519446413610878,16.32134222222222,1955.1006453333334,15.219112418020991,120,9.80000000000002E-4
10,test_20231101_134439,11551286.png,271883,487,271396,0.9982087883391018,1,3,40092,70,40022,0.9982540157637434,17.985697777777776,1870.2736906666667,15.411751962304145,120,9.80000000000002E-4
1,test_20231101_134439,10404007.png,502730,25769,476961,0.9487418693931136,2,4,61265,3726,57539,0.9391822410838162,25.164213333333333,3281.9456746666665,12.969489728734926,120,9.90000000000002E-4
2,test_20231101_134439,1254659.png,342646,84152,258494,0.7544054213386411,3,4,80080,11662,68418,0.8543706293706294,20.031966222222223,2929.3778613333334,13.463049657968673,120,9.90000000000002E-4
3,test_20231101_134439,10188041.png,221231,10504,210727,0.9525202164253653,2,3,41731,1483,40248,0.9644628693297549,10.761733333333334,1020.367216,18.04323864418027,120,9.90000000000002E-4
4,test_20231101_134439,10287332.png,216980,13559,203421,0.9375103696193198,1,4,22337,1850,20487,0.9171777767829162,9.35664,750.804448,19.375535240148544,120,9.90000000000002E-4
5,test_20231101_134439,11610969.png,368720,30692,338028,0.9167606856151009,2,4,84111,4481,79630,0.9467251607994198,20.176567111111112,2670.363557333333,13.865099683440906,120,9.90000000000002E-4
6,test_20231101_134439,10350842.png,212614,7047,205567,0.9668554281467824,1,4,42529,1033,41496,0.9757106915281337,18.897082666666666,2271.0700746666666,14.568498261323061,120,9.90000000000002E-4
7,test_20231101_134439,10863862.png,317432,14797,302635,0.9533852919680436,2,4,66058,2114,63944,0.9679978200974901,23.30008,3113.238448,13.198679755902349,120,9.90000000000002E-4
8,test_20231101_134439,11382381.png,312486,767,311719,0.9975454900379537,1,4,46745,101,46644,0.9978393411060006,21.620851555555557,2482.477712,14.181950028339719,120,9.90000000000002E-4
9,test_20231101_134439,11079715.png,443815,132167,311648,0.7022024942825276,3,5,124136,18379,105757,0.8519446413610878,16.32134222222222,1955.1006453333334,15.219112418020991,120,9.90000000000002E-4
10,test_20231101_134439,11551286.png,271883,487,271396,0.9982087883391018,1,3,40092,70,40022,0.9982540157637434,17.985697777777776,1870.2736906666667,15.411751962304145,120,9.90000000000002E-4
1,test_20231101_134440,10404007.png,502730,26112,476618,0.9480595946134108,2,3,61265,3765,57500,0.9385456622867869,25.063852444444443,3263.948144,12.993371105880328,121,0.0
2,test_20231101_134440,1254659.png,342646,82322,260324,0.7597462103745557,3,4,80080,11414,68666,0.8574675324675325,20.146789333333334,2968.9748,13.404738494515186,121,0.0
3,test_20231101_134440,10188041.png,221231,10747,210484,0.9514218170147944,2,4,41731,1508,40223,0.9638637943015983,10.256744888888889,960.6228746666667,18.30527436879325,121,0.0
4,test_20231101_134440,10287332.png,216980,13682,203298,0.9369434970965066,2,4,22337,1863,20474,0.9165957827819313,9.239728,729.57032,19.500132029302378,121,0.0
5,test_20231101_134440,11610969.png,368720,30472,338248,0.9173573443263181,3,3,84111,4439,79672,0.9472245009570687,19.285690666666667,2490.9437173333336,14.167164460683386,121,0.0
6,test_20231101_134440,10350842.png,212614,7329,205285,0.965529080869557,2,3,42529,1075,41454,0.9747231300994615,16.994460444444446,1865.2112533333334,15.423523338592997,121,0.0
7,test_20231101_134440,10863862.png,317432,14797,302635,0.9533852919680436,2,3,66058,2120,63938,0.9679069908262437,23.245306666666668,3112.5087946666667,13.199697736252237,121,0.0
8,test_20231101_134440,11382381.png,312486,1269,311217,0.9959390180680094,1,3,46745,174,46571,0.9962776767568724,19.43068977777778,2153.2964853333333,14.799765293355192,121,0.0
9,test_20231101_134440,11079715.png,443815,130027,313788,0.7070243231977288,4,4,124136,18094,106042,0.8542405104079397,16.408837333333334,1978.80552,15.166772476828436,121,0.0
10,test_20231101_134440,11551286.png,271883,1502,270381,0.9944755648569421,1,3,40092,221,39871,0.9944876783398184,15.668704,1481.5739733333332,16.423570206721926,121,0.0
1,test_20231101_134441,10404007.png,502730,26112,476618,0.9480595946134108,2,4,61265,3765,57500,0.9385456622867869,25.063852444444443,3263.948144,12.993371105880328,121,1.0E-5
2,test_20231101_134441,1254659.png,342646,82322,260324,0.7597462103745557,3,4,80080,11414,68666,0.8574675324675325,20.146789333333334,2968.9748,13.404738494515186,121,1.0E-5
3,test_20231101_134441,10188041.png,221231,10747,210484,0.9514218170147944,2,4,41731,1508,40223,0.9638637943015983,10.256744888888889,960.6228746666667,18.30527436879325,121,1.0E-5
4,test_20231101_134441,10287332.png,216980,13682,203298,0.9369434970965066,2,4,22337,1863,20474,0.9165957827819313,9.239728,729.57032,19.500132029302378,121,1.0E-5
5,test_20231101_134441,11610969.png,368720,30472,338248,0.9173573443263181,2,4,84111,4439,79672,0.9472245009570687,19.285690666666667,2490.9437173333336,14.167164460683386,121,1.0E-5
6,test_20231101_134441,10350842.png,212614,7329,205285,0.965529080869557,1,3,42529,1075,41454,0.9747231300994615,16.994460444444446,1865.2112533333334,15.423523338592997,121,1.0E-5
7,test_20231101_134441,10863862.png,317432,14797,302635,0.9533852919680436,2,4,66058,2120,63938,0.9679069908262437,23.245306666666668,3112.5087946666667,13.199697736252237,121,1.0E-5
8,test_20231101_134441,11382381.png,312486,1269,311217,0.9959390180680094,2,4,46745,174,46571,0.9962776767568724,19.43068977777778,2153.2964853333333,14.799765293355192,121,1.0E-5
9,test_20231101_134441,11079715.png,443815,130027,313788,0.7070243231977288,3,4,124136,18094,106042,0.8542405104079397,16.408837333333334,1978.80552,15.166772476828436,121,1.0E-5
10,test_20231101_134441,11551286.png,271883,1502,270381,0.9944755648569421,2,3,40092,221,39871,0.9944876783398184,15.668704,1481.5739733333332,16.423570206721926,121,1.0E-5
1,test_20231101_134441,10404007.png,502730,26112,476618,0.9480595946134108,2,4,61265,3765,57500,0.9385456622867869,25.063852444444443,3263.948144,12.993371105880328,121,2.0E-5
2,test_20231101_134441,1254659.png,342646,82322,260324,0.7597462103745557,3,4,80080,11414,68666,0.8574675324675325,20.146789333333334,2968.9748,13.404738494515186,121,2.0E-5
3,test_20231101_134441,10188041.png,221231,10747,210484,0.9514218170147944,2,4,41731,1508,40223,0.9638637943015983,10.256744888888889,960.6228746666667,18.30527436879325,121,2.0E-5
4,test_20231101_134441,10287332.png,216980,13682,203298,0.9369434970965066,2,4,22337,1863,20474,0.9165957827819313,9.239728,729.57032,19.500132029302378,121,2.0E-5
5,test_20231101_134441,11610969.png,368720,30472,338248,0.9173573443263181,2,3,84111,4439,79672,0.9472245009570687,19.285690666666667,2490.9437173333336,14.167164460683386,121,2.0E-5
6,test_20231101_134441,10350842.png,212614,7329,205285,0.965529080869557,2,4,42529,1075,41454,0.9747231300994615,16.994460444444446,1865.2112533333334,15.423523338592997,121,2.0E-5
7,test_20231101_134441,10863862.png,317432,14797,302635,0.9533852919680436,2,3,66058,2120,63938,0.9679069908262437,23.245306666666668,3112.5087946666667,13.199697736252237,121,2.0E-5
8,test_20231101_134441,11382381.png,312486,1269,311217,0.9959390180680094,2,4,46745,174,46571,0.9962776767568724,19.43068977777778,2153.2964853333333,14.799765293355192,121,2.0E-5
9,test_20231101_134441,11079715.png,443815,130027,313788,0.7070243231977288,4,5,124136,18094,106042,0.8542405104079397,16.408837333333334,1978.80552,15.166772476828436,121,2.0E-5
10,test_20231101_134441,11551286.png,271883,1502,270381,0.9944755648569421,1,4,40092,221,39871,0.9944876783398184,15.668704,1481.5739733333332,16.423570206721926,121,2.0E-5
1,test_20231101_134442,10404007.png,502730,26112,476618,0.9480595946134108,2,3,61265,3765,57500,0.9385456622867869,25.063852444444443,3263.948144,12.993371105880328,121,3.0000000000000004E-5
2,test_20231101_134442,1254659.png,342646,82322,260324,0.7597462103745557,2,4,80080,11414,68666,0.8574675324675325,20.146789333333334,2968.9748,13.404738494515186,121,3.0000000000000004E-5
3,test_20231101_134442,10188041.png,221231,10747,210484,0.9514218170147944,2,4,41731,1508,40223,0.9638637943015983,10.256744888888889,960.6228746666667,18.30527436879325,121,3.0000000000000004E-5
4,test_20231101_134442,10287332.png,216980,13682,203298,0.9369434970965066,2,4,22337,1863,20474,0.9165957827819313,9.239728,729.57032,19.500132029302378,121,3.0000000000000004E-5
5,test_20231101_134442,11610969.png,368720,30472,338248,0.9173573443263181,2,4,84111,4439,79672,0.9472245009570687,19.285690666666667,2490.9437173333336,14.167164460683386,121,3.0000000000000004E-5
6,test_20231101_134442,10350842.png,212614,7329,205285,0.965529080869557,1,4,42529,1075,41454,0.9747231300994615,16.994460444444446,1865.2112533333334,15.423523338592997,121,3.0000000000000004E-5
7,test_20231101_134442,10863862.png,317432,14797,302635,0.9533852919680436,2,4,66058,2120,63938,0.9679069908262437,23.245306666666668,3112.5087946666667,13.199697736252237,121,3.0000000000000004E-5
8,test_20231101_134442,11382381.png,312486,1269,311217,0.9959390180680094,2,3,46745,174,46571,0.9962776767568724,19.43068977777778,2153.2964853333333,14.799765293355192,121,3.0000000000000004E-5
9,test_20231101_134442,11079715.png,443815,130027,313788,0.7070243231977288,3,4,124136,18094,106042,0.8542405104079397,16.408837333333334,1978.80552,15.166772476828436,121,3.0000000000000004E-5
10,test_20231101_134442,11551286.png,271883,1502,270381,0.9944755648569421,1,3,40092,221,39871,0.9944876783398184,15.668704,1481.5739733333332,16.423570206721926,121,3.0000000000000004E-5
1,test_20231101_134443,10404007.png,502730,26112,476618,0.9480595946134108,2,4,61265,3765,57500,0.9385456622867869,25.063852444444443,3263.948144,12.993371105880328,121,4.0E-5
2,test_20231101_134443,1254659.png,342646,82322,260324,0.7597462103745557,3,4,80080,11414,68666,0.8574675324675325,20.146789333333334,2968.9748,13.404738494515186,121,4.0E-5
3,test_20231101_134443,10188041.png,221231,10747,210484,0.9514218170147944,2,3,41731,1508,40223,0.9638637943015983,10.256744888888889,960.6228746666667,18.30527436879325,121,4.0E-5
4,test_20231101_134443,10287332.png,216980,13682,203298,0.9369434970965066,2,4,22337,1863,20474,0.9165957827819313,9.239728,729.57032,19.500132029302378,121,4.0E-5
5,test_20231101_134443,11610969.png,368720,30472,338248,0.9173573443263181,2,4,84111,4439,79672,0.9472245009570687,19.285690666666667,2490.9437173333336,14.167164460683386,121,4.0E-5
6,test_20231101_134443,10350842.png,212614,7329,205285,0.965529080869557,2,4,42529,1075,41454,0.9747231300994615,16.994460444444446,1865.2112533333334,15.423523338592997,121,4.0E-5
7,test_20231101_134443,10863862.png,317432,14797,302635,0.9533852919680436,2,4,66058,2120,63938,0.9679069908262437,23.245306666666668,3112.5087946666667,13.199697736252237,121,4.0E-5
8,test_20231101_134443,11382381.png,312486,1269,311217,0.9959390180680094,1,3,46745,174,46571,0.9962776767568724,19.43068977777778,2153.2964853333333,14.799765293355192,121,4.0E-5
9,test_20231101_134443,11079715.png,443815,130027,313788,0.7070243231977288,3,4,124136,18094,106042,0.8542405104079397,16.408837333333334,1978.80552,15.166772476828436,121,4.0E-5
10,test_20231101_134443,11551286.png,271883,1502,270381,0.9944755648569421,2,4,40092,221,39871,0.9944876783398184,15.668704,1481.5739733333332,16.423570206721926,121,4.0E-5
1,test_20231101_134443,10404007.png,502730,26112,476618,0.9480595946134108,2,3,61265,3765,57500,0.9385456622867869,25.063852444444443,3263.948144,12.993371105880328,121,5.0E-5
2,test_20231101_134443,1254659.png,342646,82322,260324,0.7597462103745557,3,4,80080,11414,68666,0.8574675324675325,20.146789333333334,2968.9748,13.404738494515186,121,5.0E-5
3,test_20231101_134443,10188041.png,221231,10747,210484,0.9514218170147944,2,4,41731,1508,40223,0.9638637943015983,10.256744888888889,960.6228746666667,18.30527436879325,121,5.0E-5
4,test_20231101_134443,10287332.png,216980,13682,203298,0.9369434970965066,1,9,22337,1863,20474,0.9165957827819313,9.239728,729.57032,19.500132029302378,121,5.0E-5
5,test_20231101_134443,11610969.png,368720,30472,338248,0.9173573443263181,3,4,84111,4439,79672,0.9472245009570687,19.285690666666667,2490.9437173333336,14.167164460683386,121,5.0E-5
6,test_20231101_134443,10350842.png,212614,7329,205285,0.965529080869557,1,4,42529,1075,41454,0.9747231300994615,16.994460444444446,1865.2112533333334,15.423523338592997,121,5.0E-5
7,test_20231101_134443,10863862.png,317432,14797,302635,0.9533852919680436,2,3,66058,2120,63938,0.9679069908262437,23.245306666666668,3112.5087946666667,13.199697736252237,121,5.0E-5
8,test_20231101_134443,11382381.png,312486,1269,311217,0.9959390180680094,2,4,46745,174,46571,0.9962776767568724,19.43068977777778,2153.2964853333333,14.799765293355192,121,5.0E-5
9,test_20231101_134443,11079715.png,443815,130027,313788,0.7070243231977288,3,5,124136,18094,106042,0.8542405104079397,16.408837333333334,1978.80552,15.166772476828436,121,5.0E-5
10,test_20231101_134443,11551286.png,271883,1502,270381,0.9944755648569421,1,3,40092,221,39871,0.9944876783398184,15.668704,1481.5739733333332,16.423570206721926,121,5.0E-5
1,test_20231101_134444,10404007.png,502730,26112,476618,0.9480595946134108,2,3,61265,3765,57500,0.9385456622867869,25.063852444444443,3263.948144,12.993371105880328,121,6.0E-5
2,test_20231101_134444,1254659.png,342646,82322,260324,0.7597462103745557,3,4,80080,11414,68666,0.8574675324675325,20.146789333333334,2968.9748,13.404738494515186,121,6.0E-5
3,test_20231101_134444,10188041.png,221231,10747,210484,0.9514218170147944,2,4,41731,1508,40223,0.9638637943015983,10.256744888888889,960.6228746666667,18.30527436879325,121,6.0E-5
4,test_20231101_134444,10287332.png,216980,13682,203298,0.9369434970965066,1,3,22337,1863,20474,0.9165957827819313,9.239728,729.57032,19.500132029302378,121,6.0E-5
5,test_20231101_134444,11610969.png,368720,30472,338248,0.9173573443263181,2,4,84111,4439,79672,0.9472245009570687,19.285690666666667,2490.9437173333336,14.167164460683386,121,6.0E-5
6,test_20231101_134444,10350842.png,212614,7329,205285,0.965529080869557,2,4,42529,1075,41454,0.9747231300994615,16.994460444444446,1865.2112533333334,15.423523338592997,121,6.0E-5
7,test_20231101_134444,10863862.png,317432,14797,302635,0.9533852919680436,2,4,66058,2120,63938,0.9679069908262437,23.245306666666668,3112.5087946666667,13.199697736252237,121,6.0E-5
8,test_20231101_134444,11382381.png,312486,1269,311217,0.9959390180680094,1,4,46745,174,46571,0.9962776767568724,19.43068977777778,2153.2964853333333,14.799765293355192,121,6.0E-5
9,test_20231101_134444,11079715.png,443815,130027,313788,0.7070243231977288,4,4,124136,18094,106042,0.8542405104079397,16.408837333333334,1978.80552,15.166772476828436,121,6.0E-5
10,test_20231101_134444,11551286.png,271883,1502,270381,0.9944755648569421,1,3,40092,221,39871,0.9944876783398184,15.668704,1481.5739733333332,16.423570206721926,121,6.0E-5
1,test_20231101_134445,10404007.png,502730,26112,476618,0.9480595946134108,2,4,61265,3765,57500,0.9385456622867869,25.063852444444443,3263.948144,12.993371105880328,121,7.000000000000001E-5
2,test_20231101_134445,1254659.png,342646,82322,260324,0.7597462103745557,3,4,80080,11414,68666,0.8574675324675325,20.146789333333334,2968.9748,13.404738494515186,121,7.000000000000001E-5
3,test_20231101_134445,10188041.png,221231,10747,210484,0.9514218170147944,2,4,41731,1508,40223,0.9638637943015983,10.256744888888889,960.6228746666667,18.30527436879325,121,7.000000000000001E-5
4,test_20231101_134445,10287332.png,216980,13682,203298,0.9369434970965066,1,3,22337,1863,20474,0.9165957827819313,9.239728,729.57032,19.500132029302378,121,7.000000000000001E-5
5,test_20231101_134445,11610969.png,368720,30472,338248,0.9173573443263181,2,4,84111,4439,79672,0.9472245009570687,19.285690666666667,2490.9437173333336,14.167164460683386,121,7.000000000000001E-5
6,test_20231101_134445,10350842.png,212614,7329,205285,0.965529080869557,2,4,42529,1075,41454,0.9747231300994615,16.994460444444446,1865.2112533333334,15.423523338592997,121,7.000000000000001E-5
7,test_20231101_134445,10863862.png,317432,14797,302635,0.9533852919680436,2,3,66058,2120,63938,0.9679069908262437,23.245306666666668,3112.5087946666667,13.199697736252237,121,7.000000000000001E-5
8,test_20231101_134445,11382381.png,312486,1199,311287,0.9961630281036591,2,4,46745,164,46581,0.9964916033800406,20.298848,2271.7021546666665,14.56728970917017,121,7.000000000000001E-5
9,test_20231101_134445,11079715.png,443815,130027,313788,0.7070243231977288,4,4,124136,18094,106042,0.8542405104079397,16.408837333333334,1978.80552,15.166772476828436,121,7.000000000000001E-5
10,test_20231101_134445,11551286.png,271883,1362,270521,0.9949904922337918,1,3,40092,200,39892,0.9950114736106954,15.756325333333333,1488.0124746666668,16.404737887600753,121,7.000000000000001E-5
1,test_20231101_134445,10404007.png,502730,26112,476618,0.9480595946134108,2,4,61265,3765,57500,0.9385456622867869,25.063852444444443,3263.948144,12.993371105880328,121,8.0E-5
2,test_20231101_134445,1254659.png,342646,82322,260324,0.7597462103745557,3,4,80080,11414,68666,0.8574675324675325,20.146789333333334,2968.9748,13.404738494515186,121,8.0E-5
3,test_20231101_134445,10188041.png,221231,10747,210484,0.9514218170147944,2,4,41731,1508,40223,0.9638637943015983,10.256744888888889,960.6228746666667,18.30527436879325,121,8.0E-5
4,test_20231101_134445,10287332.png,216980,13682,203298,0.9369434970965066,2,4,22337,1863,20474,0.9165957827819313,9.239728,729.57032,19.500132029302378,121,8.0E-5
5,test_20231101_134445,11610969.png,368720,30472,338248,0.9173573443263181,2,3,84111,4439,79672,0.9472245009570687,19.285690666666667,2490.9437173333336,14.167164460683386,121,8.0E-5
6,test_20231101_134445,10350842.png,212614,7329,205285,0.965529080869557,2,3,42529,1075,41454,0.9747231300994615,16.994460444444446,1865.2112533333334,15.423523338592997,121,8.0E-5
7,test_20231101_134445,10863862.png,317432,14797,302635,0.9533852919680436,2,4,66058,2120,63938,0.9679069908262437,23.245306666666668,3112.5087946666667,13.199697736252237,121,8.0E-5
8,test_20231101_134445,11382381.png,312486,1199,311287,0.9961630281036591,2,4,46745,164,46581,0.9964916033800406,20.298848,2271.7021546666665,14.56728970917017,121,8.0E-5
9,test_20231101_134445,11079715.png,443815,130027,313788,0.7070243231977288,4,10,124136,18094,106042,0.8542405104079397,16.408837333333334,1978.80552,15.166772476828436,121,8.0E-5
10,test_20231101_134445,11551286.png,271883,1362,270521,0.9949904922337918,2,4,40092,200,39892,0.9950114736106954,15.756325333333333,1488.0124746666668,16.404737887600753,121,8.0E-5
1,test_20231101_134446,10404007.png,502730,26112,476618,0.9480595946134108,2,3,61265,3765,57500,0.9385456622867869,25.063852444444443,3263.948144,12.993371105880328,121,9.0E-5
2,test_20231101_134446,1254659.png,342646,82322,260324,0.7597462103745557,3,4,80080,11414,68666,0.8574675324675325,20.146789333333334,2968.9748,13.404738494515186,121,9.0E-5
3,test_20231101_134446,10188041.png,221231,10747,210484,0.9514218170147944,2,4,41731,1508,40223,0.9638637943015983,10.256744888888889,960.6228746666667,18.30527436879325,121,9.0E-5
4,test_20231101_134446,10287332.png,216980,13682,203298,0.9369434970965066,2,4,22337,1863,20474,0.9165957827819313,9.239728,729.57032,19.500132029302378,121,9.0E-5
5,test_20231101_134446,11610969.png,368720,30472,338248,0.9173573443263181,2,3,84111,4439,79672,0.9472245009570687,19.285690666666667,2490.9437173333336,14.167164460683386,121,9.0E-5
6,test_20231101_134446,10350842.png,212614,7329,205285,0.965529080869557,2,3,42529,1075,41454,0.9747231300994615,16.994460444444446,1865.2112533333334,15.423523338592997,121,9.0E-5
7,test_20231101_134446,10863862.png,317432,14797,302635,0.9533852919680436,2,3,66058,2120,63938,0.9679069908262437,23.245306666666668,3112.5087946666667,13.199697736252237,121,9.0E-5
8,test_20231101_134446,11382381.png,312486,1199,311287,0.9961630281036591,2,4,46745,164,46581,0.9964916033800406,20.298848,2271.7021546666665,14.56728970917017,121,9.0E-5
9,test_20231101_134446,11079715.png,443815,130027,313788,0.7070243231977288,3,5,124136,18094,106042,0.8542405104079397,16.408837333333334,1978.80552,15.166772476828436,121,9.0E-5
10,test_20231101_134446,11551286.png,271883,1362,270521,0.9949904922337918,1,4,40092,200,39892,0.9950114736106954,15.756325333333333,1488.0124746666668,16.404737887600753,121,9.0E-5
1,test_20231101_134447,10404007.png,502730,26112,476618,0.9480595946134108,2,3,61265,3765,57500,0.9385456622867869,25.063852444444443,3263.948144,12.993371105880328,121,1.0E-4
2,test_20231101_134447,1254659.png,342646,82322,260324,0.7597462103745557,3,4,80080,11414,68666,0.8574675324675325,20.146789333333334,2968.9748,13.404738494515186,121,1.0E-4
3,test_20231101_134447,10188041.png,221231,10747,210484,0.9514218170147944,2,16,41731,1508,40223,0.9638637943015983,10.256744888888889,960.6228746666667,18.30527436879325,121,1.0E-4
4,test_20231101_134447,10287332.png,216980,13682,203298,0.9369434970965066,2,4,22337,1863,20474,0.9165957827819313,9.239728,729.57032,19.500132029302378,121,1.0E-4
5,test_20231101_134447,11610969.png,368720,30472,338248,0.9173573443263181,2,3,84111,4439,79672,0.9472245009570687,19.285690666666667,2490.9437173333336,14.167164460683386,121,1.0E-4
6,test_20231101_134447,10350842.png,212614,7329,205285,0.965529080869557,1,3,42529,1075,41454,0.9747231300994615,16.994460444444446,1865.2112533333334,15.423523338592997,121,1.0E-4
7,test_20231101_134447,10863862.png,317432,14797,302635,0.9533852919680436,2,3,66058,2120,63938,0.9679069908262437,23.245306666666668,3112.5087946666667,13.199697736252237,121,1.0E-4
8,test_20231101_134447,11382381.png,312486,1199,311287,0.9961630281036591,1,3,46745,164,46581,0.9964916033800406,20.298848,2271.7021546666665,14.56728970917017,121,1.0E-4
9,test_20231101_134447,11079715.png,443815,130027,313788,0.7070243231977288,3,5,124136,18094,106042,0.8542405104079397,16.408837333333334,1978.80552,15.166772476828436,121,1.0E-4
10,test_20231101_134447,11551286.png,271883,1362,270521,0.9949904922337918,2,4,40092,200,39892,0.9950114736106954,15.756325333333333,1488.0124746666668,16.404737887600753,121,1.0E-4
1,test_20231101_134447,10404007.png,502730,26112,476618,0.9480595946134108,2,4,61265,3765,57500,0.9385456622867869,25.063852444444443,3263.948144,12.993371105880328,121,1.1E-4
2,test_20231101_134447,1254659.png,342646,82322,260324,0.7597462103745557,3,4,80080,11414,68666,0.8574675324675325,20.146789333333334,2968.9748,13.404738494515186,121,1.1E-4
3,test_20231101_134447,10188041.png,221231,10747,210484,0.9514218170147944,2,3,41731,1508,40223,0.9638637943015983,10.256744888888889,960.6228746666667,18.30527436879325,121,1.1E-4
4,test_20231101_134447,10287332.png,216980,13682,203298,0.9369434970965066,1,3,22337,1863,20474,0.9165957827819313,9.239728,729.57032,19.500132029302378,121,1.1E-4
5,test_20231101_134447,11610969.png,368720,30472,338248,0.9173573443263181,2,3,84111,4439,79672,0.9472245009570687,19.285690666666667,2490.9437173333336,14.167164460683386,121,1.1E-4
6,test_20231101_134447,10350842.png,212614,7329,205285,0.965529080869557,1,3,42529,1075,41454,0.9747231300994615,16.994460444444446,1865.2112533333334,15.423523338592997,121,1.1E-4
7,test_20231101_134447,10863862.png,317432,14797,302635,0.9533852919680436,2,4,66058,2120,63938,0.9679069908262437,23.245306666666668,3112.5087946666667,13.199697736252237,121,1.1E-4
8,test_20231101_134447,11382381.png,312486,1199,311287,0.9961630281036591,1,3,46745,164,46581,0.9964916033800406,20.298848,2271.7021546666665,14.56728970917017,121,1.1E-4
9,test_20231101_134447,11079715.png,443815,130027,313788,0.7070243231977288,4,11,124136,18094,106042,0.8542405104079397,16.408837333333334,1978.80552,15.166772476828436,121,1.1E-4
10,test_20231101_134447,11551286.png,271883,1362,270521,0.9949904922337918,2,3,40092,200,39892,0.9950114736106954,15.756325333333333,1488.0124746666668,16.404737887600753,121,1.1E-4
1,test_20231101_134448,10404007.png,502730,26112,476618,0.9480595946134108,3,3,61265,3765,57500,0.9385456622867869,25.063852444444443,3263.948144,12.993371105880328,121,1.2E-4
2,test_20231101_134448,1254659.png,342646,82322,260324,0.7597462103745557,3,4,80080,11414,68666,0.8574675324675325,20.146789333333334,2968.9748,13.404738494515186,121,1.2E-4
3,test_20231101_134448,10188041.png,221231,10747,210484,0.9514218170147944,2,4,41731,1508,40223,0.9638637943015983,10.256744888888889,960.6228746666667,18.30527436879325,121,1.2E-4
4,test_20231101_134448,10287332.png,216980,13682,203298,0.9369434970965066,1,3,22337,1863,20474,0.9165957827819313,9.239728,729.57032,19.500132029302378,121,1.2E-4
5,test_20231101_134448,11610969.png,368720,30472,338248,0.9173573443263181,3,4,84111,4439,79672,0.9472245009570687,19.285690666666667,2490.9437173333336,14.167164460683386,121,1.2E-4
6,test_20231101_134448,10350842.png,212614,7329,205285,0.965529080869557,2,3,42529,1075,41454,0.9747231300994615,16.994460444444446,1865.2112533333334,15.423523338592997,121,1.2E-4
7,test_20231101_134448,10863862.png,317432,14797,302635,0.9533852919680436,2,4,66058,2120,63938,0.9679069908262437,23.245306666666668,3112.5087946666667,13.199697736252237,121,1.2E-4
8,test_20231101_134448,11382381.png,312486,1199,311287,0.9961630281036591,2,4,46745,164,46581,0.9964916033800406,20.298848,2271.7021546666665,14.56728970917017,121,1.2E-4
9,test_20231101_134448,11079715.png,443815,130027,313788,0.7070243231977288,3,4,124136,18094,106042,0.8542405104079397,16.408837333333334,1978.80552,15.166772476828436,121,1.2E-4
10,test_20231101_134448,11551286.png,271883,1362,270521,0.9949904922337918,2,3,40092,200,39892,0.9950114736106954,15.756325333333333,1488.0124746666668,16.404737887600753,121,1.2E-4
1,test_20231101_134449,10404007.png,502730,26112,476618,0.9480595946134108,3,4,61265,3765,57500,0.9385456622867869,25.063852444444443,3263.948144,12.993371105880328,121,1.3000000000000002E-4
2,test_20231101_134449,1254659.png,342646,82322,260324,0.7597462103745557,3,4,80080,11414,68666,0.8574675324675325,20.146789333333334,2968.9748,13.404738494515186,121,1.3000000000000002E-4
3,test_20231101_134449,10188041.png,221231,10747,210484,0.9514218170147944,2,4,41731,1508,40223,0.9638637943015983,10.256744888888889,960.6228746666667,18.30527436879325,121,1.3000000000000002E-4
4,test_20231101_134449,10287332.png,216980,13682,203298,0.9369434970965066,2,4,22337,1863,20474,0.9165957827819313,9.239728,729.57032,19.500132029302378,121,1.3000000000000002E-4
5,test_20231101_134449,11610969.png,368720,30472,338248,0.9173573443263181,3,4,84111,4439,79672,0.9472245009570687,19.285690666666667,2490.9437173333336,14.167164460683386,121,1.3000000000000002E-4
6,test_20231101_134449,10350842.png,212614,7329,205285,0.965529080869557,1,4,42529,1075,41454,0.9747231300994615,16.994460444444446,1865.2112533333334,15.423523338592997,121,1.3000000000000002E-4
7,test_20231101_134449,10863862.png,317432,14797,302635,0.9533852919680436,2,3,66058,2120,63938,0.9679069908262437,23.245306666666668,3112.5087946666667,13.199697736252237,121,1.3000000000000002E-4
8,test_20231101_134449,11382381.png,312486,1199,311287,0.9961630281036591,2,4,46745,164,46581,0.9964916033800406,20.298848,2271.7021546666665,14.56728970917017,121,1.3000000000000002E-4
9,test_20231101_134449,11079715.png,443815,130027,313788,0.7070243231977288,4,4,124136,18094,106042,0.8542405104079397,16.408837333333334,1978.80552,15.166772476828436,121,1.3000000000000002E-4
10,test_20231101_134449,11551286.png,271883,1362,270521,0.9949904922337918,1,3,40092,200,39892,0.9950114736106954,15.756325333333333,1488.0124746666668,16.404737887600753,121,1.3000000000000002E-4
1,test_20231101_134449,10404007.png,502730,26112,476618,0.9480595946134108,2,3,61265,3765,57500,0.9385456622867869,25.063852444444443,3263.948144,12.993371105880328,121,1.4000000000000001E-4
2,test_20231101_134449,1254659.png,342646,82322,260324,0.7597462103745557,3,4,80080,11414,68666,0.8574675324675325,20.146789333333334,2968.9748,13.404738494515186,121,1.4000000000000001E-4
3,test_20231101_134449,10188041.png,221231,10747,210484,0.9514218170147944,2,4,41731,1508,40223,0.9638637943015983,10.256744888888889,960.6228746666667,18.30527436879325,121,1.4000000000000001E-4
4,test_20231101_134449,10287332.png,216980,13682,203298,0.9369434970965066,2,3,22337,1863,20474,0.9165957827819313,9.239728,729.57032,19.500132029302378,121,1.4000000000000001E-4
5,test_20231101_134449,11610969.png,368720,30472,338248,0.9173573443263181,2,3,84111,4439,79672,0.9472245009570687,19.285690666666667,2490.9437173333336,14.167164460683386,121,1.4000000000000001E-4
6,test_20231101_134449,10350842.png,212614,7329,205285,0.965529080869557,2,3,42529,1075,41454,0.9747231300994615,16.994460444444446,1865.2112533333334,15.423523338592997,121,1.4000000000000001E-4
7,test_20231101_134449,10863862.png,317432,14797,302635,0.9533852919680436,1,3,66058,2120,63938,0.9679069908262437,23.245306666666668,3112.5087946666667,13.199697736252237,121,1.4000000000000001E-4
8,test_20231101_134449,11382381.png,312486,1199,311287,0.9961630281036591,2,4,46745,164,46581,0.9964916033800406,20.298848,2271.7021546666665,14.56728970917017,121,1.4000000000000001E-4
9,test_20231101_134449,11079715.png,443815,130027,313788,0.7070243231977288,3,4,124136,18094,106042,0.8542405104079397,16.408837333333334,1978.80552,15.166772476828436,121,1.4000000000000001E-4
10,test_20231101_134449,11551286.png,271883,1362,270521,0.9949904922337918,1,4,40092,200,39892,0.9950114736106954,15.756325333333333,1488.0124746666668,16.404737887600753,121,1.4000000000000001E-4
1,test_20231101_134450,10404007.png,502730,26112,476618,0.9480595946134108,3,4,61265,3765,57500,0.9385456622867869,25.063852444444443,3263.948144,12.993371105880328,121,1.5000000000000001E-4
2,test_20231101_134450,1254659.png,342646,82322,260324,0.7597462103745557,4,4,80080,11414,68666,0.8574675324675325,20.146789333333334,2968.9748,13.404738494515186,121,1.5000000000000001E-4
3,test_20231101_134450,10188041.png,221231,10747,210484,0.9514218170147944,2,3,41731,1508,40223,0.9638637943015983,10.256744888888889,960.6228746666667,18.30527436879325,121,1.5000000000000001E-4
4,test_20231101_134450,10287332.png,216980,13682,203298,0.9369434970965066,1,3,22337,1863,20474,0.9165957827819313,9.239728,729.57032,19.500132029302378,121,1.5000000000000001E-4
5,test_20231101_134450,11610969.png,368720,30472,338248,0.9173573443263181,2,3,84111,4439,79672,0.9472245009570687,19.285690666666667,2490.9437173333336,14.167164460683386,121,1.5000000000000001E-4
6,test_20231101_134450,10350842.png,212614,7329,205285,0.965529080869557,1,4,42529,1075,41454,0.9747231300994615,16.994460444444446,1865.2112533333334,15.423523338592997,121,1.5000000000000001E-4
7,test_20231101_134450,10863862.png,317432,14797,302635,0.9533852919680436,1,3,66058,2120,63938,0.9679069908262437,23.245306666666668,3112.5087946666667,13.199697736252237,121,1.5000000000000001E-4
8,test_20231101_134450,11382381.png,312486,1199,311287,0.9961630281036591,1,3,46745,164,46581,0.9964916033800406,20.298848,2271.7021546666665,14.56728970917017,121,1.5000000000000001E-4
9,test_20231101_134450,11079715.png,443815,130027,313788,0.7070243231977288,3,4,124136,18094,106042,0.8542405104079397,16.408837333333334,1978.80552,15.166772476828436,121,1.5000000000000001E-4
10,test_20231101_134450,11551286.png,271883,1362,270521,0.9949904922337918,1,3,40092,200,39892,0.9950114736106954,15.756325333333333,1488.0124746666668,16.404737887600753,121,1.5000000000000001E-4
1,test_20231101_134451,10404007.png,502730,26112,476618,0.9480595946134108,2,4,61265,3765,57500,0.9385456622867869,25.063852444444443,3263.948144,12.993371105880328,121,1.6E-4
2,test_20231101_134451,1254659.png,342646,82322,260324,0.7597462103745557,3,4,80080,11414,68666,0.8574675324675325,20.146789333333334,2968.9748,13.404738494515186,121,1.6E-4
3,test_20231101_134451,10188041.png,221231,10747,210484,0.9514218170147944,2,3,41731,1508,40223,0.9638637943015983,10.256744888888889,960.6228746666667,18.30527436879325,121,1.6E-4
4,test_20231101_134451,10287332.png,216980,13429,203551,0.9381095031800166,1,3,22337,1833,20504,0.9179388458611273,9.370778666666666,756.6213706666666,19.342017571499717,121,1.6E-4
5,test_20231101_134451,11610969.png,368720,30472,338248,0.9173573443263181,3,4,84111,4439,79672,0.9472245009570687,19.285690666666667,2490.9437173333336,14.167164460683386,121,1.6E-4
6,test_20231101_134451,10350842.png,212614,7329,205285,0.965529080869557,1,4,42529,1075,41454,0.9747231300994615,16.994460444444446,1865.2112533333334,15.423523338592997,121,1.6E-4
7,test_20231101_134451,10863862.png,317432,14797,302635,0.9533852919680436,2,4,66058,2120,63938,0.9679069908262437,23.245306666666668,3112.5087946666667,13.199697736252237,121,1.6E-4
8,test_20231101_134451,11382381.png,312486,1199,311287,0.9961630281036591,2,3,46745,164,46581,0.9964916033800406,20.298848,2271.7021546666665,14.56728970917017,121,1.6E-4
9,test_20231101_134451,11079715.png,443815,130027,313788,0.7070243231977288,3,5,124136,18094,106042,0.8542405104079397,16.408837333333334,1978.80552,15.166772476828436,121,1.6E-4
10,test_20231101_134451,11551286.png,271883,1362,270521,0.9949904922337918,1,3,40092,200,39892,0.9950114736106954,15.756325333333333,1488.0124746666668,16.404737887600753,121,1.6E-4
1,test_20231101_134451,10404007.png,502730,26112,476618,0.9480595946134108,2,4,61265,3765,57500,0.9385456622867869,25.063852444444443,3263.948144,12.993371105880328,121,1.7E-4
2,test_20231101_134451,1254659.png,342646,82322,260324,0.7597462103745557,3,4,80080,11414,68666,0.8574675324675325,20.146789333333334,2968.9748,13.404738494515186,121,1.7E-4
3,test_20231101_134451,10188041.png,221231,10747,210484,0.9514218170147944,3,3,41731,1508,40223,0.9638637943015983,10.256744888888889,960.6228746666667,18.30527436879325,121,1.7E-4
4,test_20231101_134451,10287332.png,216980,13429,203551,0.9381095031800166,2,3,22337,1833,20504,0.9179388458611273,9.370778666666666,756.6213706666666,19.342017571499717,121,1.7E-4
5,test_20231101_134451,11610969.png,368720,30472,338248,0.9173573443263181,3,3,84111,4439,79672,0.9472245009570687,19.285690666666667,2490.9437173333336,14.167164460683386,121,1.7E-4
6,test_20231101_134451,10350842.png,212614,7329,205285,0.965529080869557,2,6,42529,1075,41454,0.9747231300994615,16.994460444444446,1865.2112533333334,15.423523338592997,121,1.7E-4
7,test_20231101_134451,10863862.png,317432,14797,302635,0.9533852919680436,2,3,66058,2120,63938,0.9679069908262437,23.245306666666668,3112.5087946666667,13.199697736252237,121,1.7E-4
8,test_20231101_134451,11382381.png,312486,1199,311287,0.9961630281036591,2,3,46745,164,46581,0.9964916033800406,20.298848,2271.7021546666665,14.56728970917017,121,1.7E-4
9,test_20231101_134451,11079715.png,443815,130027,313788,0.7070243231977288,3,5,124136,18094,106042,0.8542405104079397,16.408837333333334,1978.80552,15.166772476828436,121,1.7E-4
10,test_20231101_134451,11551286.png,271883,1362,270521,0.9949904922337918,2,4,40092,200,39892,0.9950114736106954,15.756325333333333,1488.0124746666668,16.404737887600753,121,1.7E-4
1,test_20231101_134452,10404007.png,502730,26112,476618,0.9480595946134108,2,3,61265,3765,57500,0.9385456622867869,25.063852444444443,3263.948144,12.993371105880328,121,1.8E-4
2,test_20231101_134452,1254659.png,342646,82322,260324,0.7597462103745557,3,4,80080,11414,68666,0.8574675324675325,20.146789333333334,2968.9748,13.404738494515186,121,1.8E-4
3,test_20231101_134452,10188041.png,221231,10747,210484,0.9514218170147944,2,4,41731,1508,40223,0.9638637943015983,10.256744888888889,960.6228746666667,18.30527436879325,121,1.8E-4
4,test_20231101_134452,10287332.png,216980,13429,203551,0.9381095031800166,2,4,22337,1833,20504,0.9179388458611273,9.370778666666666,756.6213706666666,19.342017571499717,121,1.8E-4
5,test_20231101_134452,11610969.png,368720,30472,338248,0.9173573443263181,3,4,84111,4439,79672,0.9472245009570687,19.285690666666667,2490.9437173333336,14.167164460683386,121,1.8E-4
6,test_20231101_134452,10350842.png,212614,7329,205285,0.965529080869557,1,4,42529,1075,41454,0.9747231300994615,16.994460444444446,1865.2112533333334,15.423523338592997,121,1.8E-4
7,test_20231101_134452,10863862.png,317432,14797,302635,0.9533852919680436,2,4,66058,2120,63938,0.9679069908262437,23.245306666666668,3112.5087946666667,13.199697736252237,121,1.8E-4
8,test_20231101_134452,11382381.png,312486,1199,311287,0.9961630281036591,1,3,46745,164,46581,0.9964916033800406,20.298848,2271.7021546666665,14.56728970917017,121,1.8E-4
9,test_20231101_134452,11079715.png,443815,130027,313788,0.7070243231977288,4,4,124136,18094,106042,0.8542405104079397,16.408837333333334,1978.80552,15.166772476828436,121,1.8E-4
10,test_20231101_134452,11551286.png,271883,1362,270521,0.9949904922337918,2,3,40092,200,39892,0.9950114736106954,15.756325333333333,1488.0124746666668,16.404737887600753,121,1.8E-4
1,test_20231101_134453,10404007.png,502730,26112,476618,0.9480595946134108,3,9,61265,3765,57500,0.9385456622867869,25.063852444444443,3263.948144,12.993371105880328,121,1.9E-4
2,test_20231101_134453,1254659.png,342646,82322,260324,0.7597462103745557,3,3,80080,11414,68666,0.8574675324675325,20.146789333333334,2968.9748,13.404738494515186,121,1.9E-4
3,test_20231101_134453,10188041.png,221231,10747,210484,0.9514218170147944,2,4,41731,1508,40223,0.9638637943015983,10.256744888888889,960.6228746666667,18.30527436879325,121,1.9E-4
4,test_20231101_134453,10287332.png,216980,13429,203551,0.9381095031800166,1,4,22337,1833,20504,0.9179388458611273,9.370778666666666,756.6213706666666,19.342017571499717,121,1.9E-4
5,test_20231101_134453,11610969.png,368720,30472,338248,0.9173573443263181,3,3,84111,4439,79672,0.9472245009570687,19.285690666666667,2490.9437173333336,14.167164460683386,121,1.9E-4
6,test_20231101_134453,10350842.png,212614,7329,205285,0.965529080869557,2,4,42529,1075,41454,0.9747231300994615,16.994460444444446,1865.2112533333334,15.423523338592997,121,1.9E-4
7,test_20231101_134453,10863862.png,317432,14797,302635,0.9533852919680436,2,4,66058,2120,63938,0.9679069908262437,23.245306666666668,3112.5087946666667,13.199697736252237,121,1.9E-4
8,test_20231101_134453,11382381.png,312486,1199,311287,0.9961630281036591,2,4,46745,164,46581,0.9964916033800406,20.298848,2271.7021546666665,14.56728970917017,121,1.9E-4
9,test_20231101_134453,11079715.png,443815,130027,313788,0.7070243231977288,4,4,124136,18094,106042,0.8542405104079397,16.408837333333334,1978.80552,15.166772476828436,121,1.9E-4
10,test_20231101_134453,11551286.png,271883,1362,270521,0.9949904922337918,1,3,40092,200,39892,0.9950114736106954,15.756325333333333,1488.0124746666668,16.404737887600753,121,1.9E-4
1,test_20231101_134453,10404007.png,502730,26112,476618,0.9480595946134108,2,4,61265,3765,57500,0.9385456622867869,25.063852444444443,3263.948144,12.993371105880328,121,2.0E-4
2,test_20231101_134453,1254659.png,342646,82322,260324,0.7597462103745557,3,4,80080,11414,68666,0.8574675324675325,20.146789333333334,2968.9748,13.404738494515186,121,2.0E-4
3,test_20231101_134453,10188041.png,221231,10747,210484,0.9514218170147944,2,4,41731,1508,40223,0.9638637943015983,10.256744888888889,960.6228746666667,18.30527436879325,121,2.0E-4
4,test_20231101_134453,10287332.png,216980,13429,203551,0.9381095031800166,2,3,22337,1833,20504,0.9179388458611273,9.370778666666666,756.6213706666666,19.342017571499717,121,2.0E-4
5,test_20231101_134453,11610969.png,368720,30472,338248,0.9173573443263181,2,9,84111,4439,79672,0.9472245009570687,19.285690666666667,2490.9437173333336,14.167164460683386,121,2.0E-4
6,test_20231101_134453,10350842.png,212614,7329,205285,0.965529080869557,2,3,42529,1075,41454,0.9747231300994615,16.994460444444446,1865.2112533333334,15.423523338592997,121,2.0E-4
7,test_20231101_134453,10863862.png,317432,14797,302635,0.9533852919680436,1,3,66058,2120,63938,0.9679069908262437,23.245306666666668,3112.5087946666667,13.199697736252237,121,2.0E-4
8,test_20231101_134453,11382381.png,312486,1199,311287,0.9961630281036591,1,3,46745,164,46581,0.9964916033800406,20.298848,2271.7021546666665,14.56728970917017,121,2.0E-4
9,test_20231101_134453,11079715.png,443815,130027,313788,0.7070243231977288,3,5,124136,18094,106042,0.8542405104079397,16.408837333333334,1978.80552,15.166772476828436,121,2.0E-4
10,test_20231101_134453,11551286.png,271883,1362,270521,0.9949904922337918,2,3,40092,200,39892,0.9950114736106954,15.756325333333333,1488.0124746666668,16.404737887600753,121,2.0E-4
1,test_20231101_134454,10404007.png,502730,26112,476618,0.9480595946134108,3,3,61265,3765,57500,0.9385456622867869,25.063852444444443,3263.948144,12.993371105880328,121,2.1E-4
2,test_20231101_134454,1254659.png,342646,82322,260324,0.7597462103745557,3,4,80080,11414,68666,0.8574675324675325,20.146789333333334,2968.9748,13.404738494515186,121,2.1E-4
3,test_20231101_134454,10188041.png,221231,10747,210484,0.9514218170147944,2,4,41731,1508,40223,0.9638637943015983,10.256744888888889,960.6228746666667,18.30527436879325,121,2.1E-4
4,test_20231101_134454,10287332.png,216980,13429,203551,0.9381095031800166,2,3,22337,1833,20504,0.9179388458611273,9.370778666666666,756.6213706666666,19.342017571499717,121,2.1E-4
5,test_20231101_134454,11610969.png,368720,30472,338248,0.9173573443263181,2,3,84111,4439,79672,0.9472245009570687,19.285690666666667,2490.9437173333336,14.167164460683386,121,2.1E-4
6,test_20231101_134454,10350842.png,212614,7329,205285,0.965529080869557,2,3,42529,1075,41454,0.9747231300994615,16.994460444444446,1865.2112533333334,15.423523338592997,121,2.1E-4
7,test_20231101_134454,10863862.png,317432,14797,302635,0.9533852919680436,2,4,66058,2120,63938,0.9679069908262437,23.245306666666668,3112.5087946666667,13.199697736252237,121,2.1E-4
8,test_20231101_134454,11382381.png,312486,1199,311287,0.9961630281036591,1,3,46745,164,46581,0.9964916033800406,20.298848,2271.7021546666665,14.56728970917017,121,2.1E-4
9,test_20231101_134454,11079715.png,443815,130027,313788,0.7070243231977288,3,4,124136,18094,106042,0.8542405104079397,16.408837333333334,1978.80552,15.166772476828436,121,2.1E-4
10,test_20231101_134454,11551286.png,271883,1362,270521,0.9949904922337918,2,4,40092,200,39892,0.9950114736106954,15.756325333333333,1488.0124746666668,16.404737887600753,121,2.1E-4
1,test_20231101_134455,10404007.png,502730,26112,476618,0.9480595946134108,3,4,61265,3765,57500,0.9385456622867869,25.063852444444443,3263.948144,12.993371105880328,121,2.2E-4
2,test_20231101_134455,1254659.png,342646,82322,260324,0.7597462103745557,3,4,80080,11414,68666,0.8574675324675325,20.146789333333334,2968.9748,13.404738494515186,121,2.2E-4
3,test_20231101_134455,10188041.png,221231,10747,210484,0.9514218170147944,2,4,41731,1508,40223,0.9638637943015983,10.256744888888889,960.6228746666667,18.30527436879325,121,2.2E-4
4,test_20231101_134455,10287332.png,216980,13429,203551,0.9381095031800166,1,3,22337,1833,20504,0.9179388458611273,9.370778666666666,756.6213706666666,19.342017571499717,121,2.2E-4
5,test_20231101_134455,11610969.png,368720,30472,338248,0.9173573443263181,2,4,84111,4439,79672,0.9472245009570687,19.285690666666667,2490.9437173333336,14.167164460683386,121,2.2E-4
6,test_20231101_134455,10350842.png,212614,7329,205285,0.965529080869557,2,3,42529,1075,41454,0.9747231300994615,16.994460444444446,1865.2112533333334,15.423523338592997,121,2.2E-4
7,test_20231101_134455,10863862.png,317432,14797,302635,0.9533852919680436,2,4,66058,2120,63938,0.9679069908262437,23.245306666666668,3112.5087946666667,13.199697736252237,121,2.2E-4
8,test_20231101_134455,11382381.png,312486,1199,311287,0.9961630281036591,1,3,46745,164,46581,0.9964916033800406,20.298848,2271.7021546666665,14.56728970917017,121,2.2E-4
9,test_20231101_134455,11079715.png,443815,130027,313788,0.7070243231977288,4,4,124136,18094,106042,0.8542405104079397,16.408837333333334,1978.80552,15.166772476828436,121,2.2E-4
10,test_20231101_134455,11551286.png,271883,1362,270521,0.9949904922337918,1,4,40092,200,39892,0.9950114736106954,15.756325333333333,1488.0124746666668,16.404737887600753,121,2.2E-4
1,test_20231101_134456,10404007.png,502730,26112,476618,0.9480595946134108,2,3,61265,3765,57500,0.9385456622867869,25.063852444444443,3263.948144,12.993371105880328,121,2.3E-4
2,test_20231101_134456,1254659.png,342646,82322,260324,0.7597462103745557,2,4,80080,11414,68666,0.8574675324675325,20.146789333333334,2968.9748,13.404738494515186,121,2.3E-4
3,test_20231101_134456,10188041.png,221231,10747,210484,0.9514218170147944,2,3,41731,1508,40223,0.9638637943015983,10.256744888888889,960.6228746666667,18.30527436879325,121,2.3E-4
4,test_20231101_134456,10287332.png,216980,13429,203551,0.9381095031800166,2,4,22337,1833,20504,0.9179388458611273,9.370778666666666,756.6213706666666,19.342017571499717,121,2.3E-4
5,test_20231101_134456,11610969.png,368720,30472,338248,0.9173573443263181,3,4,84111,4439,79672,0.9472245009570687,19.285690666666667,2490.9437173333336,14.167164460683386,121,2.3E-4
6,test_20231101_134456,10350842.png,212614,7329,205285,0.965529080869557,1,3,42529,1075,41454,0.9747231300994615,16.994460444444446,1865.2112533333334,15.423523338592997,121,2.3E-4
7,test_20231101_134456,10863862.png,317432,14797,302635,0.9533852919680436,2,4,66058,2120,63938,0.9679069908262437,23.245306666666668,3112.5087946666667,13.199697736252237,121,2.3E-4
8,test_20231101_134456,11382381.png,312486,1199,311287,0.9961630281036591,2,4,46745,164,46581,0.9964916033800406,20.298848,2271.7021546666665,14.56728970917017,121,2.3E-4
9,test_20231101_134456,11079715.png,443815,130027,313788,0.7070243231977288,4,4,124136,18094,106042,0.8542405104079397,16.408837333333334,1978.80552,15.166772476828436,121,2.3E-4
10,test_20231101_134456,11551286.png,271883,1362,270521,0.9949904922337918,1,3,40092,200,39892,0.9950114736106954,15.756325333333333,1488.0124746666668,16.404737887600753,121,2.3E-4
1,test_20231101_134456,10404007.png,502730,26112,476618,0.9480595946134108,2,4,61265,3765,57500,0.9385456622867869,25.063852444444443,3263.948144,12.993371105880328,121,2.4E-4
2,test_20231101_134456,1254659.png,342646,82322,260324,0.7597462103745557,2,4,80080,11414,68666,0.8574675324675325,20.146789333333334,2968.9748,13.404738494515186,121,2.4E-4
3,test_20231101_134456,10188041.png,221231,10747,210484,0.9514218170147944,2,4,41731,1508,40223,0.9638637943015983,10.256744888888889,960.6228746666667,18.30527436879325,121,2.4E-4
4,test_20231101_134456,10287332.png,216980,13429,203551,0.9381095031800166,1,4,22337,1833,20504,0.9179388458611273,9.370778666666666,756.6213706666666,19.342017571499717,121,2.4E-4
5,test_20231101_134456,11610969.png,368720,30472,338248,0.9173573443263181,3,3,84111,4439,79672,0.9472245009570687,19.285690666666667,2490.9437173333336,14.167164460683386,121,2.4E-4
6,test_20231101_134456,10350842.png,212614,7329,205285,0.965529080869557,1,4,42529,1075,41454,0.9747231300994615,16.994460444444446,1865.2112533333334,15.423523338592997,121,2.4E-4
7,test_20231101_134456,10863862.png,317432,14797,302635,0.9533852919680436,2,4,66058,2120,63938,0.9679069908262437,23.245306666666668,3112.5087946666667,13.199697736252237,121,2.4E-4
8,test_20231101_134456,11382381.png,312486,1199,311287,0.9961630281036591,1,3,46745,164,46581,0.9964916033800406,20.298848,2271.7021546666665,14.56728970917017,121,2.4E-4
9,test_20231101_134456,11079715.png,443815,130027,313788,0.7070243231977288,3,5,124136,18094,106042,0.8542405104079397,16.408837333333334,1978.80552,15.166772476828436,121,2.4E-4
10,test_20231101_134456,11551286.png,271883,1362,270521,0.9949904922337918,1,3,40092,200,39892,0.9950114736106954,15.756325333333333,1488.0124746666668,16.404737887600753,121,2.4E-4
1,test_20231101_134457,10404007.png,502730,26112,476618,0.9480595946134108,2,4,61265,3765,57500,0.9385456622867869,25.063852444444443,3263.948144,12.993371105880328,121,2.5E-4
2,test_20231101_134457,1254659.png,342646,82322,260324,0.7597462103745557,3,4,80080,11414,68666,0.8574675324675325,20.146789333333334,2968.9748,13.404738494515186,121,2.5E-4
3,test_20231101_134457,10188041.png,221231,10747,210484,0.9514218170147944,2,3,41731,1508,40223,0.9638637943015983,10.256744888888889,960.6228746666667,18.30527436879325,121,2.5E-4
4,test_20231101_134457,10287332.png,216980,13429,203551,0.9381095031800166,1,4,22337,1833,20504,0.9179388458611273,9.370778666666666,756.6213706666666,19.342017571499717,121,2.5E-4
5,test_20231101_134457,11610969.png,368720,30472,338248,0.9173573443263181,2,4,84111,4439,79672,0.9472245009570687,19.285690666666667,2490.9437173333336,14.167164460683386,121,2.5E-4
6,test_20231101_134457,10350842.png,212614,7329,205285,0.965529080869557,1,4,42529,1075,41454,0.9747231300994615,16.994460444444446,1865.2112533333334,15.423523338592997,121,2.5E-4
7,test_20231101_134457,10863862.png,317432,14797,302635,0.9533852919680436,2,4,66058,2120,63938,0.9679069908262437,23.245306666666668,3112.5087946666667,13.199697736252237,121,2.5E-4
8,test_20231101_134457,11382381.png,312486,1199,311287,0.9961630281036591,2,3,46745,164,46581,0.9964916033800406,20.298848,2271.7021546666665,14.56728970917017,121,2.5E-4
9,test_20231101_134457,11079715.png,443815,130027,313788,0.7070243231977288,3,4,124136,18094,106042,0.8542405104079397,16.408837333333334,1978.80552,15.166772476828436,121,2.5E-4
10,test_20231101_134457,11551286.png,271883,1362,270521,0.9949904922337918,1,4,40092,200,39892,0.9950114736106954,15.756325333333333,1488.0124746666668,16.404737887600753,121,2.5E-4
1,test_20231101_134458,10404007.png,502730,25849,476881,0.9485827382491596,2,4,61265,3728,57537,0.9391495960173019,25.087061333333335,3268.065152,12.987896548459542,121,2.6000000000000003E-4
2,test_20231101_134458,1254659.png,342646,82262,260384,0.7599213182117988,4,4,80080,11409,68671,0.85752997002997,20.156343111111113,2970.0569866666665,13.403155786357337,121,2.6000000000000003E-4
3,test_20231101_134458,10188041.png,221231,10667,210564,0.9517834299894681,3,3,41731,1496,40235,0.9641513503151135,10.409946666666666,981.2383306666667,18.21305855911757,121,2.6000000000000003E-4
4,test_20231101_134458,10287332.png,216980,13429,203551,0.9381095031800166,2,4,22337,1833,20504,0.9179388458611273,9.370778666666666,756.6213706666666,19.342017571499717,121,2.6000000000000003E-4
5,test_20231101_134458,11610969.png,368720,30412,338308,0.9175200694293772,3,4,84111,4432,79679,0.9473077243166768,19.617939555555555,2565.311952,14.039401762955164,121,2.6000000000000003E-4
6,test_20231101_134458,10350842.png,212614,7187,205427,0.9661969578673089,2,4,42529,1054,41475,0.9752169108137977,17.523210666666667,1977.5073386666666,15.169622569983105,121,2.6000000000000003E-4
7,test_20231101_134458,10863862.png,317432,14697,302735,0.9537003200685501,2,4,66058,2105,63953,0.9681340640043599,23.275838222222223,3117.6927946666665,13.192470415975402,121,2.6000000000000003E-4
8,test_20231101_134458,11382381.png,312486,967,311519,0.9969054613646692,2,4,46745,130,46615,0.9972189538988127,21.068341333333333,2406.1475626666665,14.317581029153203,121,2.6000000000000003E-4
9,test_20231101_134458,11079715.png,443815,130027,313788,0.7070243231977288,4,4,124136,18094,106042,0.8542405104079397,16.408837333333334,1978.80552,15.166772476828436,121,2.6000000000000003E-4
10,test_20231101_134458,11551286.png,271883,1219,270664,0.9955164537687167,2,4,40092,179,39913,0.9955352688815724,16.076115555555557,1539.5683893333332,16.25681375358216,121,2.6000000000000003E-4
1,test_20231101_134458,10404007.png,502730,25849,476881,0.9485827382491596,4,4,61265,3728,57537,0.9391495960173019,25.087061333333335,3268.065152,12.987896548459542,121,2.7000000000000006E-4
2,test_20231101_134458,1254659.png,342646,82262,260384,0.7599213182117988,5,4,80080,11409,68671,0.85752997002997,20.156343111111113,2970.0569866666665,13.403155786357337,121,2.7000000000000006E-4
3,test_20231101_134458,10188041.png,221231,10667,210564,0.9517834299894681,2,3,41731,1496,40235,0.9641513503151135,10.409946666666666,981.2383306666667,18.21305855911757,121,2.7000000000000006E-4
4,test_20231101_134458,10287332.png,216980,13429,203551,0.9381095031800166,2,4,22337,1833,20504,0.9179388458611273,9.370778666666666,756.6213706666666,19.342017571499717,121,2.7000000000000006E-4
5,test_20231101_134458,11610969.png,368720,30412,338308,0.9175200694293772,3,4,84111,4432,79679,0.9473077243166768,19.617939555555555,2565.311952,14.039401762955164,121,2.7000000000000006E-4
6,test_20231101_134458,10350842.png,212614,7187,205427,0.9661969578673089,2,3,42529,1054,41475,0.9752169108137977,17.523210666666667,1977.5073386666666,15.169622569983105,121,2.7000000000000006E-4
7,test_20231101_134458,10863862.png,317432,14697,302735,0.9537003200685501,2,4,66058,2105,63953,0.9681340640043599,23.275838222222223,3117.6927946666665,13.192470415975402,121,2.7000000000000006E-4
8,test_20231101_134458,11382381.png,312486,967,311519,0.9969054613646692,1,3,46745,130,46615,0.9972189538988127,21.068341333333333,2406.1475626666665,14.317581029153203,121,2.7000000000000006E-4
9,test_20231101_134458,11079715.png,443815,130027,313788,0.7070243231977288,3,5,124136,18094,106042,0.8542405104079397,16.408837333333334,1978.80552,15.166772476828436,121,2.7000000000000006E-4
10,test_20231101_134458,11551286.png,271883,1219,270664,0.9955164537687167,1,4,40092,179,39913,0.9955352688815724,16.076115555555557,1539.5683893333332,16.25681375358216,121,2.7000000000000006E-4
1,test_20231101_134459,10404007.png,502730,25849,476881,0.9485827382491596,2,5,61265,3728,57537,0.9391495960173019,25.087061333333335,3268.065152,12.987896548459542,121,2.800000000000001E-4
2,test_20231101_134459,1254659.png,342646,82262,260384,0.7599213182117988,3,4,80080,11409,68671,0.85752997002997,20.156343111111113,2970.0569866666665,13.403155786357337,121,2.800000000000001E-4
3,test_20231101_134459,10188041.png,221231,10667,210564,0.9517834299894681,2,3,41731,1496,40235,0.9641513503151135,10.409946666666666,981.2383306666667,18.21305855911757,121,2.800000000000001E-4
4,test_20231101_134459,10287332.png,216980,13429,203551,0.9381095031800166,2,3,22337,1833,20504,0.9179388458611273,9.370778666666666,756.6213706666666,19.342017571499717,121,2.800000000000001E-4
5,test_20231101_134459,11610969.png,368720,30412,338308,0.9175200694293772,2,3,84111,4432,79679,0.9473077243166768,19.617939555555555,2565.311952,14.039401762955164,121,2.800000000000001E-4
6,test_20231101_134459,10350842.png,212614,7187,205427,0.9661969578673089,1,4,42529,1054,41475,0.9752169108137977,17.523210666666667,1977.5073386666666,15.169622569983105,121,2.800000000000001E-4
7,test_20231101_134459,10863862.png,317432,14697,302735,0.9537003200685501,2,3,66058,2105,63953,0.9681340640043599,23.275838222222223,3117.6927946666665,13.192470415975402,121,2.800000000000001E-4
8,test_20231101_134459,11382381.png,312486,967,311519,0.9969054613646692,2,4,46745,130,46615,0.9972189538988127,21.068341333333333,2406.1475626666665,14.317581029153203,121,2.800000000000001E-4
9,test_20231101_134459,11079715.png,443815,130027,313788,0.7070243231977288,4,4,124136,18094,106042,0.8542405104079397,16.408837333333334,1978.80552,15.166772476828436,121,2.800000000000001E-4
10,test_20231101_134459,11551286.png,271883,1219,270664,0.9955164537687167,1,3,40092,179,39913,0.9955352688815724,16.076115555555557,1539.5683893333332,16.25681375358216,121,2.800000000000001E-4
1,test_20231101_134500,10404007.png,502730,25849,476881,0.9485827382491596,2,3,61265,3728,57537,0.9391495960173019,25.087061333333335,3268.065152,12.987896548459542,121,2.900000000000001E-4
2,test_20231101_134500,1254659.png,342646,82262,260384,0.7599213182117988,3,5,80080,11409,68671,0.85752997002997,20.156343111111113,2970.0569866666665,13.403155786357337,121,2.900000000000001E-4
3,test_20231101_134500,10188041.png,221231,10667,210564,0.9517834299894681,2,4,41731,1496,40235,0.9641513503151135,10.409946666666666,981.2383306666667,18.21305855911757,121,2.900000000000001E-4
4,test_20231101_134500,10287332.png,216980,13429,203551,0.9381095031800166,2,4,22337,1833,20504,0.9179388458611273,9.370778666666666,756.6213706666666,19.342017571499717,121,2.900000000000001E-4
5,test_20231101_134500,11610969.png,368720,30412,338308,0.9175200694293772,2,4,84111,4432,79679,0.9473077243166768,19.617939555555555,2565.311952,14.039401762955164,121,2.900000000000001E-4
6,test_20231101_134500,10350842.png,212614,7187,205427,0.9661969578673089,2,4,42529,1054,41475,0.9752169108137977,17.523210666666667,1977.5073386666666,15.169622569983105,121,2.900000000000001E-4
7,test_20231101_134500,10863862.png,317432,14697,302735,0.9537003200685501,2,4,66058,2105,63953,0.9681340640043599,23.275838222222223,3117.6927946666665,13.192470415975402,121,2.900000000000001E-4
8,test_20231101_134500,11382381.png,312486,967,311519,0.9969054613646692,1,4,46745,130,46615,0.9972189538988127,21.068341333333333,2406.1475626666665,14.317581029153203,121,2.900000000000001E-4
9,test_20231101_134500,11079715.png,443815,130027,313788,0.7070243231977288,3,5,124136,18094,106042,0.8542405104079397,16.408837333333334,1978.80552,15.166772476828436,121,2.900000000000001E-4
10,test_20231101_134500,11551286.png,271883,1219,270664,0.9955164537687167,2,3,40092,179,39913,0.9955352688815724,16.076115555555557,1539.5683893333332,16.25681375358216,121,2.900000000000001E-4
1,test_20231101_134500,10404007.png,502730,25849,476881,0.9485827382491596,2,4,61265,3728,57537,0.9391495960173019,25.087061333333335,3268.065152,12.987896548459542,121,3.0000000000000014E-4
2,test_20231101_134500,1254659.png,342646,82262,260384,0.7599213182117988,3,3,80080,11409,68671,0.85752997002997,20.156343111111113,2970.0569866666665,13.403155786357337,121,3.0000000000000014E-4
3,test_20231101_134500,10188041.png,221231,10667,210564,0.9517834299894681,2,3,41731,1496,40235,0.9641513503151135,10.409946666666666,981.2383306666667,18.21305855911757,121,3.0000000000000014E-4
4,test_20231101_134500,10287332.png,216980,13429,203551,0.9381095031800166,2,4,22337,1833,20504,0.9179388458611273,9.370778666666666,756.6213706666666,19.342017571499717,121,3.0000000000000014E-4
5,test_20231101_134500,11610969.png,368720,30412,338308,0.9175200694293772,2,4,84111,4432,79679,0.9473077243166768,19.617939555555555,2565.311952,14.039401762955164,121,3.0000000000000014E-4
6,test_20231101_134500,10350842.png,212614,7187,205427,0.9661969578673089,1,3,42529,1054,41475,0.9752169108137977,17.523210666666667,1977.5073386666666,15.169622569983105,121,3.0000000000000014E-4
7,test_20231101_134500,10863862.png,317432,14697,302735,0.9537003200685501,2,4,66058,2105,63953,0.9681340640043599,23.275838222222223,3117.6927946666665,13.192470415975402,121,3.0000000000000014E-4
8,test_20231101_134500,11382381.png,312486,967,311519,0.9969054613646692,2,3,46745,130,46615,0.9972189538988127,21.068341333333333,2406.1475626666665,14.317581029153203,121,3.0000000000000014E-4
9,test_20231101_134500,11079715.png,443815,130027,313788,0.7070243231977288,3,4,124136,18094,106042,0.8542405104079397,16.408837333333334,1978.80552,15.166772476828436,121,3.0000000000000014E-4
10,test_20231101_134500,11551286.png,271883,1219,270664,0.9955164537687167,1,3,40092,179,39913,0.9955352688815724,16.076115555555557,1539.5683893333332,16.25681375358216,121,3.0000000000000014E-4
1,test_20231101_134501,10404007.png,502730,25849,476881,0.9485827382491596,2,4,61265,3728,57537,0.9391495960173019,25.087061333333335,3268.065152,12.987896548459542,121,3.1000000000000016E-4
2,test_20231101_134501,1254659.png,342646,82262,260384,0.7599213182117988,3,4,80080,11409,68671,0.85752997002997,20.156343111111113,2970.0569866666665,13.403155786357337,121,3.1000000000000016E-4
3,test_20231101_134501,10188041.png,221231,10667,210564,0.9517834299894681,2,4,41731,1496,40235,0.9641513503151135,10.409946666666666,981.2383306666667,18.21305855911757,121,3.1000000000000016E-4
4,test_20231101_134501,10287332.png,216980,13429,203551,0.9381095031800166,1,3,22337,1833,20504,0.9179388458611273,9.370778666666666,756.6213706666666,19.342017571499717,121,3.1000000000000016E-4
5,test_20231101_134501,11610969.png,368720,30412,338308,0.9175200694293772,2,4,84111,4432,79679,0.9473077243166768,19.617939555555555,2565.311952,14.039401762955164,121,3.1000000000000016E-4
6,test_20231101_134501,10350842.png,212614,7187,205427,0.9661969578673089,1,3,42529,1054,41475,0.9752169108137977,17.523210666666667,1977.5073386666666,15.169622569983105,121,3.1000000000000016E-4
7,test_20231101_134501,10863862.png,317432,14697,302735,0.9537003200685501,2,4,66058,2105,63953,0.9681340640043599,23.275838222222223,3117.6927946666665,13.192470415975402,121,3.1000000000000016E-4
8,test_20231101_134501,11382381.png,312486,967,311519,0.9969054613646692,1,4,46745,130,46615,0.9972189538988127,21.068341333333333,2406.1475626666665,14.317581029153203,121,3.1000000000000016E-4
9,test_20231101_134501,11079715.png,443815,130027,313788,0.7070243231977288,3,4,124136,18094,106042,0.8542405104079397,16.408837333333334,1978.80552,15.166772476828436,121,3.1000000000000016E-4
10,test_20231101_134501,11551286.png,271883,887,270996,0.9967375672623886,2,3,40092,130,39962,0.996757457846952,16.359790222222223,1584.234912,16.132607812021437,121,3.1000000000000016E-4
1,test_20231101_134502,10404007.png,502730,25849,476881,0.9485827382491596,2,4,61265,3728,57537,0.9391495960173019,25.087061333333335,3268.065152,12.987896548459542,121,3.200000000000002E-4
2,test_20231101_134502,1254659.png,342646,82262,260384,0.7599213182117988,3,4,80080,11409,68671,0.85752997002997,20.156343111111113,2970.0569866666665,13.403155786357337,121,3.200000000000002E-4
3,test_20231101_134502,10188041.png,221231,10667,210564,0.9517834299894681,2,3,41731,1496,40235,0.9641513503151135,10.409946666666666,981.2383306666667,18.21305855911757,121,3.200000000000002E-4
4,test_20231101_134502,10287332.png,216980,13429,203551,0.9381095031800166,1,3,22337,1833,20504,0.9179388458611273,9.370778666666666,756.6213706666666,19.342017571499717,121,3.200000000000002E-4
5,test_20231101_134502,11610969.png,368720,30412,338308,0.9175200694293772,2,4,84111,4432,79679,0.9473077243166768,19.617939555555555,2565.311952,14.039401762955164,121,3.200000000000002E-4
6,test_20231101_134502,10350842.png,212614,7187,205427,0.9661969578673089,2,3,42529,1054,41475,0.9752169108137977,17.523210666666667,1977.5073386666666,15.169622569983105,121,3.200000000000002E-4
7,test_20231101_134502,10863862.png,317432,14697,302735,0.9537003200685501,2,4,66058,2105,63953,0.9681340640043599,23.275838222222223,3117.6927946666665,13.192470415975402,121,3.200000000000002E-4
8,test_20231101_134502,11382381.png,312486,827,311659,0.9973534814359684,1,3,46745,109,46636,0.997668199807466,21.564144,2476.360432,14.192665047538828,121,3.200000000000002E-4
9,test_20231101_134502,11079715.png,443815,130027,313788,0.7070243231977288,3,5,124136,18094,106042,0.8542405104079397,16.408837333333334,1978.80552,15.166772476828436,121,3.200000000000002E-4
10,test_20231101_134502,11551286.png,271883,607,271276,0.9977674220160878,1,3,40092,88,40004,0.997805048388706,17.77655288888889,1839.618896,15.483524990035365,121,3.200000000000002E-4
1,test_20231101_134502,10404007.png,502730,25849,476881,0.9485827382491596,3,3,61265,3728,57537,0.9391495960173019,25.087061333333335,3268.065152,12.987896548459542,121,3.300000000000002E-4
2,test_20231101_134502,1254659.png,342646,82262,260384,0.7599213182117988,3,4,80080,11409,68671,0.85752997002997,20.156343111111113,2970.0569866666665,13.403155786357337,121,3.300000000000002E-4
3,test_20231101_134502,10188041.png,221231,10667,210564,0.9517834299894681,2,4,41731,1496,40235,0.9641513503151135,10.409946666666666,981.2383306666667,18.21305855911757,121,3.300000000000002E-4
4,test_20231101_134502,10287332.png,216980,13429,203551,0.9381095031800166,2,3,22337,1833,20504,0.9179388458611273,9.370778666666666,756.6213706666666,19.342017571499717,121,3.300000000000002E-4
5,test_20231101_134502,11610969.png,368720,30412,338308,0.9175200694293772,3,4,84111,4432,79679,0.9473077243166768,19.617939555555555,2565.311952,14.039401762955164,121,3.300000000000002E-4
6,test_20231101_134502,10350842.png,212614,7187,205427,0.9661969578673089,1,3,42529,1054,41475,0.9752169108137977,17.523210666666667,1977.5073386666666,15.169622569983105,121,3.300000000000002E-4
7,test_20231101_134502,10863862.png,317432,14697,302735,0.9537003200685501,2,3,66058,2105,63953,0.9681340640043599,23.275838222222223,3117.6927946666665,13.192470415975402,121,3.300000000000002E-4
8,test_20231101_134502,11382381.png,312486,827,311659,0.9973534814359684,2,4,46745,109,46636,0.997668199807466,21.564144,2476.360432,14.192665047538828,121,3.300000000000002E-4
9,test_20231101_134502,11079715.png,443815,130027,313788,0.7070243231977288,3,5,124136,18094,106042,0.8542405104079397,16.408837333333334,1978.80552,15.166772476828436,121,3.300000000000002E-4
10,test_20231101_134502,11551286.png,271883,607,271276,0.9977674220160878,1,4,40092,88,40004,0.997805048388706,17.77655288888889,1839.618896,15.483524990035365,121,3.300000000000002E-4
1,test_20231101_134503,10404007.png,502730,25849,476881,0.9485827382491596,2,3,61265,3728,57537,0.9391495960173019,25.087061333333335,3268.065152,12.987896548459542,121,3.4000000000000024E-4
2,test_20231101_134503,1254659.png,342646,82262,260384,0.7599213182117988,3,4,80080,11409,68671,0.85752997002997,20.156343111111113,2970.0569866666665,13.403155786357337,121,3.4000000000000024E-4
3,test_20231101_134503,10188041.png,221231,10667,210564,0.9517834299894681,2,3,41731,1496,40235,0.9641513503151135,10.409946666666666,981.2383306666667,18.21305855911757,121,3.4000000000000024E-4
4,test_20231101_134503,10287332.png,216980,13429,203551,0.9381095031800166,1,3,22337,1833,20504,0.9179388458611273,9.370778666666666,756.6213706666666,19.342017571499717,121,3.4000000000000024E-4
5,test_20231101_134503,11610969.png,368720,30412,338308,0.9175200694293772,2,4,84111,4432,79679,0.9473077243166768,19.617939555555555,2565.311952,14.039401762955164,121,3.4000000000000024E-4
6,test_20231101_134503,10350842.png,212614,7187,205427,0.9661969578673089,2,3,42529,1054,41475,0.9752169108137977,17.523210666666667,1977.5073386666666,15.169622569983105,121,3.4000000000000024E-4
7,test_20231101_134503,10863862.png,317432,14697,302735,0.9537003200685501,2,4,66058,2105,63953,0.9681340640043599,23.275838222222223,3117.6927946666665,13.192470415975402,121,3.4000000000000024E-4
8,test_20231101_134503,11382381.png,312486,827,311659,0.9973534814359684,1,3,46745,109,46636,0.997668199807466,21.564144,2476.360432,14.192665047538828,121,3.4000000000000024E-4
9,test_20231101_134503,11079715.png,443815,130027,313788,0.7070243231977288,3,4,124136,18094,106042,0.8542405104079397,16.408837333333334,1978.80552,15.166772476828436,121,3.4000000000000024E-4
10,test_20231101_134503,11551286.png,271883,607,271276,0.9977674220160878,1,3,40092,88,40004,0.997805048388706,17.77655288888889,1839.618896,15.483524990035365,121,3.4000000000000024E-4
1,test_20231101_134504,10404007.png,502730,25849,476881,0.9485827382491596,2,4,61265,3728,57537,0.9391495960173019,25.087061333333335,3268.065152,12.987896548459542,121,3.5000000000000027E-4
2,test_20231101_134504,1254659.png,342646,82262,260384,0.7599213182117988,3,4,80080,11409,68671,0.85752997002997,20.156343111111113,2970.0569866666665,13.403155786357337,121,3.5000000000000027E-4
3,test_20231101_134504,10188041.png,221231,10667,210564,0.9517834299894681,1,3,41731,1496,40235,0.9641513503151135,10.409946666666666,981.2383306666667,18.21305855911757,121,3.5000000000000027E-4
4,test_20231101_134504,10287332.png,216980,13429,203551,0.9381095031800166,1,4,22337,1833,20504,0.9179388458611273,9.370778666666666,756.6213706666666,19.342017571499717,121,3.5000000000000027E-4
5,test_20231101_134504,11610969.png,368720,30412,338308,0.9175200694293772,3,4,84111,4432,79679,0.9473077243166768,19.617939555555555,2565.311952,14.039401762955164,121,3.5000000000000027E-4
6,test_20231101_134504,10350842.png,212614,7187,205427,0.9661969578673089,2,3,42529,1054,41475,0.9752169108137977,17.523210666666667,1977.5073386666666,15.169622569983105,121,3.5000000000000027E-4
7,test_20231101_134504,10863862.png,317432,14697,302735,0.9537003200685501,2,3,66058,2105,63953,0.9681340640043599,23.275838222222223,3117.6927946666665,13.192470415975402,121,3.5000000000000027E-4
8,test_20231101_134504,11382381.png,312486,827,311659,0.9973534814359684,2,4,46745,109,46636,0.997668199807466,21.564144,2476.360432,14.192665047538828,121,3.5000000000000027E-4
9,test_20231101_134504,11079715.png,443815,130027,313788,0.7070243231977288,3,4,124136,18094,106042,0.8542405104079397,16.408837333333334,1978.80552,15.166772476828436,121,3.5000000000000027E-4
10,test_20231101_134504,11551286.png,271883,607,271276,0.9977674220160878,1,4,40092,88,40004,0.997805048388706,17.77655288888889,1839.618896,15.483524990035365,121,3.5000000000000027E-4
1,test_20231101_134504,10404007.png,502730,25849,476881,0.9485827382491596,2,4,61265,3728,57537,0.9391495960173019,25.087061333333335,3268.065152,12.987896548459542,121,3.600000000000003E-4
2,test_20231101_134504,1254659.png,342646,82262,260384,0.7599213182117988,3,4,80080,11409,68671,0.85752997002997,20.156343111111113,2970.0569866666665,13.403155786357337,121,3.600000000000003E-4
3,test_20231101_134504,10188041.png,221231,10667,210564,0.9517834299894681,2,3,41731,1496,40235,0.9641513503151135,10.409946666666666,981.2383306666667,18.21305855911757,121,3.600000000000003E-4
4,test_20231101_134504,10287332.png,216980,13429,203551,0.9381095031800166,2,4,22337,1833,20504,0.9179388458611273,9.370778666666666,756.6213706666666,19.342017571499717,121,3.600000000000003E-4
5,test_20231101_134504,11610969.png,368720,30412,338308,0.9175200694293772,2,5,84111,4432,79679,0.9473077243166768,19.617939555555555,2565.311952,14.039401762955164,121,3.600000000000003E-4
6,test_20231101_134504,10350842.png,212614,7187,205427,0.9661969578673089,2,3,42529,1054,41475,0.9752169108137977,17.523210666666667,1977.5073386666666,15.169622569983105,121,3.600000000000003E-4
7,test_20231101_134504,10863862.png,317432,14697,302735,0.9537003200685501,2,4,66058,2105,63953,0.9681340640043599,23.275838222222223,3117.6927946666665,13.192470415975402,121,3.600000000000003E-4
8,test_20231101_134504,11382381.png,312486,827,311659,0.9973534814359684,2,3,46745,109,46636,0.997668199807466,21.564144,2476.360432,14.192665047538828,121,3.600000000000003E-4
9,test_20231101_134504,11079715.png,443815,130027,313788,0.7070243231977288,4,4,124136,18094,106042,0.8542405104079397,16.408837333333334,1978.80552,15.166772476828436,121,3.600000000000003E-4
10,test_20231101_134504,11551286.png,271883,607,271276,0.9977674220160878,1,4,40092,88,40004,0.997805048388706,17.77655288888889,1839.618896,15.483524990035365,121,3.600000000000003E-4
1,test_20231101_134505,10404007.png,502730,25849,476881,0.9485827382491596,2,4,61265,3728,57537,0.9391495960173019,25.087061333333335,3268.065152,12.987896548459542,121,3.700000000000003E-4
2,test_20231101_134505,1254659.png,342646,82262,260384,0.7599213182117988,3,4,80080,11409,68671,0.85752997002997,20.156343111111113,2970.0569866666665,13.403155786357337,121,3.700000000000003E-4
3,test_20231101_134505,10188041.png,221231,10667,210564,0.9517834299894681,2,4,41731,1496,40235,0.9641513503151135,10.409946666666666,981.2383306666667,18.21305855911757,121,3.700000000000003E-4
4,test_20231101_134505,10287332.png,216980,13429,203551,0.9381095031800166,2,3,22337,1833,20504,0.9179388458611273,9.370778666666666,756.6213706666666,19.342017571499717,121,3.700000000000003E-4
5,test_20231101_134505,11610969.png,368720,30412,338308,0.9175200694293772,2,3,84111,4432,79679,0.9473077243166768,19.617939555555555,2565.311952,14.039401762955164,121,3.700000000000003E-4
6,test_20231101_134505,10350842.png,212614,7187,205427,0.9661969578673089,1,3,42529,1054,41475,0.9752169108137977,17.523210666666667,1977.5073386666666,15.169622569983105,121,3.700000000000003E-4
7,test_20231101_134505,10863862.png,317432,14697,302735,0.9537003200685501,1,3,66058,2105,63953,0.9681340640043599,23.275838222222223,3117.6927946666665,13.192470415975402,121,3.700000000000003E-4
8,test_20231101_134505,11382381.png,312486,827,311659,0.9973534814359684,2,4,46745,109,46636,0.997668199807466,21.564144,2476.360432,14.192665047538828,121,3.700000000000003E-4
9,test_20231101_134505,11079715.png,443815,130027,313788,0.7070243231977288,3,4,124136,18094,106042,0.8542405104079397,16.408837333333334,1978.80552,15.166772476828436,121,3.700000000000003E-4
10,test_20231101_134505,11551286.png,271883,607,271276,0.9977674220160878,1,4,40092,88,40004,0.997805048388706,17.77655288888889,1839.618896,15.483524990035365,121,3.700000000000003E-4
1,test_20231101_134506,10404007.png,502730,25849,476881,0.9485827382491596,3,3,61265,3728,57537,0.9391495960173019,25.087061333333335,3268.065152,12.987896548459542,121,3.8000000000000035E-4
2,test_20231101_134506,1254659.png,342646,82262,260384,0.7599213182117988,3,4,80080,11409,68671,0.85752997002997,20.156343111111113,2970.0569866666665,13.403155786357337,121,3.8000000000000035E-4
3,test_20231101_134506,10188041.png,221231,10667,210564,0.9517834299894681,2,4,41731,1496,40235,0.9641513503151135,10.409946666666666,981.2383306666667,18.21305855911757,121,3.8000000000000035E-4
4,test_20231101_134506,10287332.png,216980,13429,203551,0.9381095031800166,1,3,22337,1833,20504,0.9179388458611273,9.370778666666666,756.6213706666666,19.342017571499717,121,3.8000000000000035E-4
5,test_20231101_134506,11610969.png,368720,30412,338308,0.9175200694293772,3,4,84111,4432,79679,0.9473077243166768,19.617939555555555,2565.311952,14.039401762955164,121,3.8000000000000035E-4
6,test_20231101_134506,10350842.png,212614,7187,205427,0.9661969578673089,2,3,42529,1054,41475,0.9752169108137977,17.523210666666667,1977.5073386666666,15.169622569983105,121,3.8000000000000035E-4
7,test_20231101_134506,10863862.png,317432,14697,302735,0.9537003200685501,2,4,66058,2105,63953,0.9681340640043599,23.275838222222223,3117.6927946666665,13.192470415975402,121,3.8000000000000035E-4
8,test_20231101_134506,11382381.png,312486,827,311659,0.9973534814359684,1,4,46745,109,46636,0.997668199807466,21.564144,2476.360432,14.192665047538828,121,3.8000000000000035E-4
9,test_20231101_134506,11079715.png,443815,130027,313788,0.7070243231977288,3,4,124136,18094,106042,0.8542405104079397,16.408837333333334,1978.80552,15.166772476828436,121,3.8000000000000035E-4
10,test_20231101_134506,11551286.png,271883,607,271276,0.9977674220160878,1,4,40092,88,40004,0.997805048388706,17.77655288888889,1839.618896,15.483524990035365,121,3.8000000000000035E-4
1,test_20231101_134506,10404007.png,502730,25849,476881,0.9485827382491596,3,4,61265,3728,57537,0.9391495960173019,25.087061333333335,3268.065152,12.987896548459542,121,3.9000000000000037E-4
2,test_20231101_134506,1254659.png,342646,82262,260384,0.7599213182117988,3,4,80080,11409,68671,0.85752997002997,20.156343111111113,2970.0569866666665,13.403155786357337,121,3.9000000000000037E-4
3,test_20231101_134506,10188041.png,221231,10667,210564,0.9517834299894681,2,4,41731,1496,40235,0.9641513503151135,10.409946666666666,981.2383306666667,18.21305855911757,121,3.9000000000000037E-4
4,test_20231101_134506,10287332.png,216980,13429,203551,0.9381095031800166,1,4,22337,1833,20504,0.9179388458611273,9.370778666666666,756.6213706666666,19.342017571499717,121,3.9000000000000037E-4
5,test_20231101_134506,11610969.png,368720,30412,338308,0.9175200694293772,2,4,84111,4432,79679,0.9473077243166768,19.617939555555555,2565.311952,14.039401762955164,121,3.9000000000000037E-4
6,test_20231101_134506,10350842.png,212614,7187,205427,0.9661969578673089,1,3,42529,1054,41475,0.9752169108137977,17.523210666666667,1977.5073386666666,15.169622569983105,121,3.9000000000000037E-4
7,test_20231101_134506,10863862.png,317432,14697,302735,0.9537003200685501,2,3,66058,2105,63953,0.9681340640043599,23.275838222222223,3117.6927946666665,13.192470415975402,121,3.9000000000000037E-4
8,test_20231101_134506,11382381.png,312486,827,311659,0.9973534814359684,1,4,46745,109,46636,0.997668199807466,21.564144,2476.360432,14.192665047538828,121,3.9000000000000037E-4
9,test_20231101_134506,11079715.png,443815,130027,313788,0.7070243231977288,3,4,124136,18094,106042,0.8542405104079397,16.408837333333334,1978.80552,15.166772476828436,121,3.9000000000000037E-4
10,test_20231101_134506,11551286.png,271883,607,271276,0.9977674220160878,1,4,40092,88,40004,0.997805048388706,17.77655288888889,1839.618896,15.483524990035365,121,3.9000000000000037E-4
1,test_20231101_134507,10404007.png,502730,25849,476881,0.9485827382491596,2,4,61265,3728,57537,0.9391495960173019,25.087061333333335,3268.065152,12.987896548459542,121,4.000000000000004E-4
2,test_20231101_134507,1254659.png,342646,82262,260384,0.7599213182117988,3,4,80080,11409,68671,0.85752997002997,20.156343111111113,2970.0569866666665,13.403155786357337,121,4.000000000000004E-4
3,test_20231101_134507,10188041.png,221231,10667,210564,0.9517834299894681,2,4,41731,1496,40235,0.9641513503151135,10.409946666666666,981.2383306666667,18.21305855911757,121,4.000000000000004E-4
4,test_20231101_134507,10287332.png,216980,13429,203551,0.9381095031800166,2,4,22337,1833,20504,0.9179388458611273,9.370778666666666,756.6213706666666,19.342017571499717,121,4.000000000000004E-4
5,test_20231101_134507,11610969.png,368720,30412,338308,0.9175200694293772,3,4,84111,4432,79679,0.9473077243166768,19.617939555555555,2565.311952,14.039401762955164,121,4.000000000000004E-4
6,test_20231101_134507,10350842.png,212614,7187,205427,0.9661969578673089,2,4,42529,1054,41475,0.9752169108137977,17.523210666666667,1977.5073386666666,15.169622569983105,121,4.000000000000004E-4
7,test_20231101_134507,10863862.png,317432,14697,302735,0.9537003200685501,2,4,66058,2105,63953,0.9681340640043599,23.275838222222223,3117.6927946666665,13.192470415975402,121,4.000000000000004E-4
8,test_20231101_134507,11382381.png,312486,827,311659,0.9973534814359684,2,3,46745,109,46636,0.997668199807466,21.564144,2476.360432,14.192665047538828,121,4.000000000000004E-4
9,test_20231101_134507,11079715.png,443815,130027,313788,0.7070243231977288,4,4,124136,18094,106042,0.8542405104079397,16.408837333333334,1978.80552,15.166772476828436,121,4.000000000000004E-4
10,test_20231101_134507,11551286.png,271883,607,271276,0.9977674220160878,1,3,40092,88,40004,0.997805048388706,17.77655288888889,1839.618896,15.483524990035365,121,4.000000000000004E-4
1,test_20231101_134508,10404007.png,502730,25849,476881,0.9485827382491596,3,4,61265,3728,57537,0.9391495960173019,25.087061333333335,3268.065152,12.987896548459542,121,4.100000000000004E-4
2,test_20231101_134508,1254659.png,342646,82262,260384,0.7599213182117988,2,4,80080,11409,68671,0.85752997002997,20.156343111111113,2970.0569866666665,13.403155786357337,121,4.100000000000004E-4
3,test_20231101_134508,10188041.png,221231,10667,210564,0.9517834299894681,2,4,41731,1496,40235,0.9641513503151135,10.409946666666666,981.2383306666667,18.21305855911757,121,4.100000000000004E-4
4,test_20231101_134508,10287332.png,216980,13429,203551,0.9381095031800166,2,3,22337,1833,20504,0.9179388458611273,9.370778666666666,756.6213706666666,19.342017571499717,121,4.100000000000004E-4
5,test_20231101_134508,11610969.png,368720,30412,338308,0.9175200694293772,2,3,84111,4432,79679,0.9473077243166768,19.617939555555555,2565.311952,14.039401762955164,121,4.100000000000004E-4
6,test_20231101_134508,10350842.png,212614,7187,205427,0.9661969578673089,1,3,42529,1054,41475,0.9752169108137977,17.523210666666667,1977.5073386666666,15.169622569983105,121,4.100000000000004E-4
7,test_20231101_134508,10863862.png,317432,14697,302735,0.9537003200685501,4,6,66058,2105,63953,0.9681340640043599,23.275838222222223,3117.6927946666665,13.192470415975402,121,4.100000000000004E-4
8,test_20231101_134508,11382381.png,312486,827,311659,0.9973534814359684,1,3,46745,109,46636,0.997668199807466,21.564144,2476.360432,14.192665047538828,121,4.100000000000004E-4
9,test_20231101_134508,11079715.png,443815,130027,313788,0.7070243231977288,3,4,124136,18094,106042,0.8542405104079397,16.408837333333334,1978.80552,15.166772476828436,121,4.100000000000004E-4
10,test_20231101_134508,11551286.png,271883,607,271276,0.9977674220160878,1,4,40092,88,40004,0.997805048388706,17.77655288888889,1839.618896,15.483524990035365,121,4.100000000000004E-4
1,test_20231101_134508,10404007.png,502730,25849,476881,0.9485827382491596,3,4,61265,3728,57537,0.9391495960173019,25.087061333333335,3268.065152,12.987896548459542,121,4.2000000000000045E-4
2,test_20231101_134508,1254659.png,342646,82262,260384,0.7599213182117988,3,4,80080,11409,68671,0.85752997002997,20.156343111111113,2970.0569866666665,13.403155786357337,121,4.2000000000000045E-4
3,test_20231101_134508,10188041.png,221231,10667,210564,0.9517834299894681,2,3,41731,1496,40235,0.9641513503151135,10.409946666666666,981.2383306666667,18.21305855911757,121,4.2000000000000045E-4
4,test_20231101_134508,10287332.png,216980,13429,203551,0.9381095031800166,2,4,22337,1833,20504,0.9179388458611273,9.370778666666666,756.6213706666666,19.342017571499717,121,4.2000000000000045E-4
5,test_20231101_134508,11610969.png,368720,30412,338308,0.9175200694293772,2,8,84111,4432,79679,0.9473077243166768,19.617939555555555,2565.311952,14.039401762955164,121,4.2000000000000045E-4
6,test_20231101_134508,10350842.png,212614,7187,205427,0.9661969578673089,2,4,42529,1054,41475,0.9752169108137977,17.523210666666667,1977.5073386666666,15.169622569983105,121,4.2000000000000045E-4
7,test_20231101_134508,10863862.png,317432,14697,302735,0.9537003200685501,2,4,66058,2105,63953,0.9681340640043599,23.275838222222223,3117.6927946666665,13.192470415975402,121,4.2000000000000045E-4
8,test_20231101_134508,11382381.png,312486,827,311659,0.9973534814359684,1,4,46745,109,46636,0.997668199807466,21.564144,2476.360432,14.192665047538828,121,4.2000000000000045E-4
9,test_20231101_134508,11079715.png,443815,130027,313788,0.7070243231977288,4,4,124136,18094,106042,0.8542405104079397,16.408837333333334,1978.80552,15.166772476828436,121,4.2000000000000045E-4
10,test_20231101_134508,11551286.png,271883,607,271276,0.9977674220160878,1,3,40092,88,40004,0.997805048388706,17.77655288888889,1839.618896,15.483524990035365,121,4.2000000000000045E-4
1,test_20231101_134509,10404007.png,502730,25849,476881,0.9485827382491596,3,4,61265,3728,57537,0.9391495960173019,25.087061333333335,3268.065152,12.987896548459542,121,4.300000000000005E-4
2,test_20231101_134509,1254659.png,342646,82262,260384,0.7599213182117988,3,8,80080,11409,68671,0.85752997002997,20.156343111111113,2970.0569866666665,13.403155786357337,121,4.300000000000005E-4
3,test_20231101_134509,10188041.png,221231,10667,210564,0.9517834299894681,2,3,41731,1496,40235,0.9641513503151135,10.409946666666666,981.2383306666667,18.21305855911757,121,4.300000000000005E-4
4,test_20231101_134509,10287332.png,216980,13429,203551,0.9381095031800166,2,4,22337,1833,20504,0.9179388458611273,9.370778666666666,756.6213706666666,19.342017571499717,121,4.300000000000005E-4
5,test_20231101_134509,11610969.png,368720,30412,338308,0.9175200694293772,2,4,84111,4432,79679,0.9473077243166768,19.617939555555555,2565.311952,14.039401762955164,121,4.300000000000005E-4
6,test_20231101_134509,10350842.png,212614,7187,205427,0.9661969578673089,1,4,42529,1054,41475,0.9752169108137977,17.523210666666667,1977.5073386666666,15.169622569983105,121,4.300000000000005E-4
7,test_20231101_134509,10863862.png,317432,14697,302735,0.9537003200685501,2,6,66058,2105,63953,0.9681340640043599,23.275838222222223,3117.6927946666665,13.192470415975402,121,4.300000000000005E-4
8,test_20231101_134509,11382381.png,312486,827,311659,0.9973534814359684,1,3,46745,109,46636,0.997668199807466,21.564144,2476.360432,14.192665047538828,121,4.300000000000005E-4
9,test_20231101_134509,11079715.png,443815,130027,313788,0.7070243231977288,3,4,124136,18094,106042,0.8542405104079397,16.408837333333334,1978.80552,15.166772476828436,121,4.300000000000005E-4
10,test_20231101_134509,11551286.png,271883,607,271276,0.9977674220160878,1,3,40092,88,40004,0.997805048388706,17.77655288888889,1839.618896,15.483524990035365,121,4.300000000000005E-4
1,test_20231101_134510,10404007.png,502730,25849,476881,0.9485827382491596,3,4,61265,3728,57537,0.9391495960173019,25.087061333333335,3268.065152,12.987896548459542,121,4.400000000000005E-4
2,test_20231101_134510,1254659.png,342646,82262,260384,0.7599213182117988,3,4,80080,11409,68671,0.85752997002997,20.156343111111113,2970.0569866666665,13.403155786357337,121,4.400000000000005E-4
3,test_20231101_134510,10188041.png,221231,10667,210564,0.9517834299894681,3,3,41731,1496,40235,0.9641513503151135,10.409946666666666,981.2383306666667,18.21305855911757,121,4.400000000000005E-4
4,test_20231101_134510,10287332.png,216980,13429,203551,0.9381095031800166,1,3,22337,1833,20504,0.9179388458611273,9.370778666666666,756.6213706666666,19.342017571499717,121,4.400000000000005E-4
5,test_20231101_134510,11610969.png,368720,30412,338308,0.9175200694293772,2,4,84111,4432,79679,0.9473077243166768,19.617939555555555,2565.311952,14.039401762955164,121,4.400000000000005E-4
6,test_20231101_134510,10350842.png,212614,7187,205427,0.9661969578673089,1,4,42529,1054,41475,0.9752169108137977,17.523210666666667,1977.5073386666666,15.169622569983105,121,4.400000000000005E-4
7,test_20231101_134510,10863862.png,317432,14697,302735,0.9537003200685501,2,4,66058,2105,63953,0.9681340640043599,23.275838222222223,3117.6927946666665,13.192470415975402,121,4.400000000000005E-4
8,test_20231101_134510,11382381.png,312486,827,311659,0.9973534814359684,2,7,46745,109,46636,0.997668199807466,21.564144,2476.360432,14.192665047538828,121,4.400000000000005E-4
9,test_20231101_134510,11079715.png,443815,130027,313788,0.7070243231977288,3,5,124136,18094,106042,0.8542405104079397,16.408837333333334,1978.80552,15.166772476828436,121,4.400000000000005E-4
10,test_20231101_134510,11551286.png,271883,607,271276,0.9977674220160878,1,4,40092,88,40004,0.997805048388706,17.77655288888889,1839.618896,15.483524990035365,121,4.400000000000005E-4
1,test_20231101_134510,10404007.png,502730,25849,476881,0.9485827382491596,3,4,61265,3728,57537,0.9391495960173019,25.087061333333335,3268.065152,12.987896548459542,121,4.5000000000000053E-4
2,test_20231101_134510,1254659.png,342646,82262,260384,0.7599213182117988,3,3,80080,11409,68671,0.85752997002997,20.156343111111113,2970.0569866666665,13.403155786357337,121,4.5000000000000053E-4
3,test_20231101_134510,10188041.png,221231,10667,210564,0.9517834299894681,2,4,41731,1496,40235,0.9641513503151135,10.409946666666666,981.2383306666667,18.21305855911757,121,4.5000000000000053E-4
4,test_20231101_134510,10287332.png,216980,13429,203551,0.9381095031800166,1,4,22337,1833,20504,0.9179388458611273,9.370778666666666,756.6213706666666,19.342017571499717,121,4.5000000000000053E-4
5,test_20231101_134510,11610969.png,368720,30412,338308,0.9175200694293772,3,3,84111,4432,79679,0.9473077243166768,19.617939555555555,2565.311952,14.039401762955164,121,4.5000000000000053E-4
6,test_20231101_134510,10350842.png,212614,7187,205427,0.9661969578673089,2,4,42529,1054,41475,0.9752169108137977,17.523210666666667,1977.5073386666666,15.169622569983105,121,4.5000000000000053E-4
7,test_20231101_134510,10863862.png,317432,14697,302735,0.9537003200685501,3,3,66058,2105,63953,0.9681340640043599,23.275838222222223,3117.6927946666665,13.192470415975402,121,4.5000000000000053E-4
8,test_20231101_134510,11382381.png,312486,827,311659,0.9973534814359684,2,3,46745,109,46636,0.997668199807466,21.564144,2476.360432,14.192665047538828,121,4.5000000000000053E-4
9,test_20231101_134510,11079715.png,443815,130027,313788,0.7070243231977288,3,5,124136,18094,106042,0.8542405104079397,16.408837333333334,1978.80552,15.166772476828436,121,4.5000000000000053E-4
10,test_20231101_134510,11551286.png,271883,607,271276,0.9977674220160878,1,4,40092,88,40004,0.997805048388706,17.77655288888889,1839.618896,15.483524990035365,121,4.5000000000000053E-4
1,test_20231101_134511,10404007.png,502730,25849,476881,0.9485827382491596,2,4,61265,3728,57537,0.9391495960173019,25.087061333333335,3268.065152,12.987896548459542,121,4.6000000000000056E-4
2,test_20231101_134511,1254659.png,342646,82262,260384,0.7599213182117988,4,5,80080,11409,68671,0.85752997002997,20.156343111111113,2970.0569866666665,13.403155786357337,121,4.6000000000000056E-4
3,test_20231101_134511,10188041.png,221231,10667,210564,0.9517834299894681,2,4,41731,1496,40235,0.9641513503151135,10.409946666666666,981.2383306666667,18.21305855911757,121,4.6000000000000056E-4
4,test_20231101_134511,10287332.png,216980,13429,203551,0.9381095031800166,1,4,22337,1833,20504,0.9179388458611273,9.370778666666666,756.6213706666666,19.342017571499717,121,4.6000000000000056E-4
5,test_20231101_134511,11610969.png,368720,30412,338308,0.9175200694293772,2,3,84111,4432,79679,0.9473077243166768,19.617939555555555,2565.311952,14.039401762955164,121,4.6000000000000056E-4
6,test_20231101_134511,10350842.png,212614,7187,205427,0.9661969578673089,4,4,42529,1054,41475,0.9752169108137977,17.523210666666667,1977.5073386666666,15.169622569983105,121,4.6000000000000056E-4
7,test_20231101_134511,10863862.png,317432,14697,302735,0.9537003200685501,2,4,66058,2105,63953,0.9681340640043599,23.275838222222223,3117.6927946666665,13.192470415975402,121,4.6000000000000056E-4
8,test_20231101_134511,11382381.png,312486,827,311659,0.9973534814359684,2,4,46745,109,46636,0.997668199807466,21.564144,2476.360432,14.192665047538828,121,4.6000000000000056E-4
9,test_20231101_134511,11079715.png,443815,130027,313788,0.7070243231977288,4,4,124136,18094,106042,0.8542405104079397,16.408837333333334,1978.80552,15.166772476828436,121,4.6000000000000056E-4
10,test_20231101_134511,11551286.png,271883,607,271276,0.9977674220160878,2,4,40092,88,40004,0.997805048388706,17.77655288888889,1839.618896,15.483524990035365,121,4.6000000000000056E-4
1,test_20231101_134512,10404007.png,502730,25849,476881,0.9485827382491596,2,3,61265,3728,57537,0.9391495960173019,25.087061333333335,3268.065152,12.987896548459542,121,4.700000000000006E-4
2,test_20231101_134512,1254659.png,342646,82262,260384,0.7599213182117988,3,4,80080,11409,68671,0.85752997002997,20.156343111111113,2970.0569866666665,13.403155786357337,121,4.700000000000006E-4
3,test_20231101_134512,10188041.png,221231,10667,210564,0.9517834299894681,2,4,41731,1496,40235,0.9641513503151135,10.409946666666666,981.2383306666667,18.21305855911757,121,4.700000000000006E-4
4,test_20231101_134512,10287332.png,216980,13429,203551,0.9381095031800166,1,4,22337,1833,20504,0.9179388458611273,9.370778666666666,756.6213706666666,19.342017571499717,121,4.700000000000006E-4
5,test_20231101_134512,11610969.png,368720,30412,338308,0.9175200694293772,2,4,84111,4432,79679,0.9473077243166768,19.617939555555555,2565.311952,14.039401762955164,121,4.700000000000006E-4
6,test_20231101_134512,10350842.png,212614,7187,205427,0.9661969578673089,1,4,42529,1054,41475,0.9752169108137977,17.523210666666667,1977.5073386666666,15.169622569983105,121,4.700000000000006E-4
7,test_20231101_134512,10863862.png,317432,14697,302735,0.9537003200685501,2,4,66058,2105,63953,0.9681340640043599,23.275838222222223,3117.6927946666665,13.192470415975402,121,4.700000000000006E-4
8,test_20231101_134512,11382381.png,312486,827,311659,0.9973534814359684,1,4,46745,109,46636,0.997668199807466,21.564144,2476.360432,14.192665047538828,121,4.700000000000006E-4
9,test_20231101_134512,11079715.png,443815,130027,313788,0.7070243231977288,4,4,124136,18094,106042,0.8542405104079397,16.408837333333334,1978.80552,15.166772476828436,121,4.700000000000006E-4
10,test_20231101_134512,11551286.png,271883,607,271276,0.9977674220160878,1,4,40092,88,40004,0.997805048388706,17.77655288888889,1839.618896,15.483524990035365,121,4.700000000000006E-4
1,test_20231101_134512,10404007.png,502730,25849,476881,0.9485827382491596,3,4,61265,3728,57537,0.9391495960173019,25.087061333333335,3268.065152,12.987896548459542,121,4.800000000000006E-4
2,test_20231101_134512,1254659.png,342646,82262,260384,0.7599213182117988,4,4,80080,11409,68671,0.85752997002997,20.156343111111113,2970.0569866666665,13.403155786357337,121,4.800000000000006E-4
3,test_20231101_134512,10188041.png,221231,10667,210564,0.9517834299894681,3,3,41731,1496,40235,0.9641513503151135,10.409946666666666,981.2383306666667,18.21305855911757,121,4.800000000000006E-4
4,test_20231101_134512,10287332.png,216980,13429,203551,0.9381095031800166,1,3,22337,1833,20504,0.9179388458611273,9.370778666666666,756.6213706666666,19.342017571499717,121,4.800000000000006E-4
5,test_20231101_134512,11610969.png,368720,30412,338308,0.9175200694293772,2,4,84111,4432,79679,0.9473077243166768,19.617939555555555,2565.311952,14.039401762955164,121,4.800000000000006E-4
6,test_20231101_134512,10350842.png,212614,7187,205427,0.9661969578673089,1,4,42529,1054,41475,0.9752169108137977,17.523210666666667,1977.5073386666666,15.169622569983105,121,4.800000000000006E-4
7,test_20231101_134512,10863862.png,317432,14697,302735,0.9537003200685501,2,4,66058,2105,63953,0.9681340640043599,23.275838222222223,3117.6927946666665,13.192470415975402,121,4.800000000000006E-4
8,test_20231101_134512,11382381.png,312486,827,311659,0.9973534814359684,2,3,46745,109,46636,0.997668199807466,21.564144,2476.360432,14.192665047538828,121,4.800000000000006E-4
9,test_20231101_134512,11079715.png,443815,130027,313788,0.7070243231977288,3,4,124136,18094,106042,0.8542405104079397,16.408837333333334,1978.80552,15.166772476828436,121,4.800000000000006E-4
10,test_20231101_134512,11551286.png,271883,607,271276,0.9977674220160878,1,4,40092,88,40004,0.997805048388706,17.77655288888889,1839.618896,15.483524990035365,121,4.800000000000006E-4
1,test_20231101_134513,10404007.png,502730,25849,476881,0.9485827382491596,3,4,61265,3728,57537,0.9391495960173019,25.087061333333335,3268.065152,12.987896548459542,121,4.900000000000006E-4
2,test_20231101_134513,1254659.png,342646,82262,260384,0.7599213182117988,3,4,80080,11409,68671,0.85752997002997,20.156343111111113,2970.0569866666665,13.403155786357337,121,4.900000000000006E-4
3,test_20231101_134513,10188041.png,221231,10667,210564,0.9517834299894681,2,4,41731,1496,40235,0.9641513503151135,10.409946666666666,981.2383306666667,18.21305855911757,121,4.900000000000006E-4
4,test_20231101_134513,10287332.png,216980,13429,203551,0.9381095031800166,1,3,22337,1833,20504,0.9179388458611273,9.370778666666666,756.6213706666666,19.342017571499717,121,4.900000000000006E-4
5,test_20231101_134513,11610969.png,368720,30412,338308,0.9175200694293772,3,4,84111,4432,79679,0.9473077243166768,19.617939555555555,2565.311952,14.039401762955164,121,4.900000000000006E-4
6,test_20231101_134513,10350842.png,212614,7187,205427,0.9661969578673089,2,4,42529,1054,41475,0.9752169108137977,17.523210666666667,1977.5073386666666,15.169622569983105,121,4.900000000000006E-4
7,test_20231101_134513,10863862.png,317432,14697,302735,0.9537003200685501,2,3,66058,2105,63953,0.9681340640043599,23.275838222222223,3117.6927946666665,13.192470415975402,121,4.900000000000006E-4
8,test_20231101_134513,11382381.png,312486,827,311659,0.9973534814359684,2,3,46745,109,46636,0.997668199807466,21.564144,2476.360432,14.192665047538828,121,4.900000000000006E-4
9,test_20231101_134513,11079715.png,443815,130027,313788,0.7070243231977288,4,4,124136,18094,106042,0.8542405104079397,16.408837333333334,1978.80552,15.166772476828436,121,4.900000000000006E-4
10,test_20231101_134513,11551286.png,271883,607,271276,0.9977674220160878,1,4,40092,88,40004,0.997805048388706,17.77655288888889,1839.618896,15.483524990035365,121,4.900000000000006E-4
1,test_20231101_134514,10404007.png,502730,25849,476881,0.9485827382491596,2,3,61265,3728,57537,0.9391495960173019,25.087061333333335,3268.065152,12.987896548459542,121,5.000000000000007E-4
2,test_20231101_134514,1254659.png,342646,82262,260384,0.7599213182117988,3,4,80080,11409,68671,0.85752997002997,20.156343111111113,2970.0569866666665,13.403155786357337,121,5.000000000000007E-4
3,test_20231101_134514,10188041.png,221231,10667,210564,0.9517834299894681,2,3,41731,1496,40235,0.9641513503151135,10.409946666666666,981.2383306666667,18.21305855911757,121,5.000000000000007E-4
4,test_20231101_134514,10287332.png,216980,13429,203551,0.9381095031800166,1,3,22337,1833,20504,0.9179388458611273,9.370778666666666,756.6213706666666,19.342017571499717,121,5.000000000000007E-4
5,test_20231101_134514,11610969.png,368720,30412,338308,0.9175200694293772,2,4,84111,4432,79679,0.9473077243166768,19.617939555555555,2565.311952,14.039401762955164,121,5.000000000000007E-4
6,test_20231101_134514,10350842.png,212614,7187,205427,0.9661969578673089,2,4,42529,1054,41475,0.9752169108137977,17.523210666666667,1977.5073386666666,15.169622569983105,121,5.000000000000007E-4
7,test_20231101_134514,10863862.png,317432,14697,302735,0.9537003200685501,2,4,66058,2105,63953,0.9681340640043599,23.275838222222223,3117.6927946666665,13.192470415975402,121,5.000000000000007E-4
8,test_20231101_134514,11382381.png,312486,827,311659,0.9973534814359684,1,4,46745,109,46636,0.997668199807466,21.564144,2476.360432,14.192665047538828,121,5.000000000000007E-4
9,test_20231101_134514,11079715.png,443815,130027,313788,0.7070243231977288,3,5,124136,18094,106042,0.8542405104079397,16.408837333333334,1978.80552,15.166772476828436,121,5.000000000000007E-4
10,test_20231101_134514,11551286.png,271883,607,271276,0.9977674220160878,1,4,40092,88,40004,0.997805048388706,17.77655288888889,1839.618896,15.483524990035365,121,5.000000000000007E-4
1,test_20231101_134515,10404007.png,502730,25727,477003,0.9488254132436894,2,4,61265,3712,57553,0.9394107565494165,25.099845333333334,3270.2719413333334,12.984964927000139,121,5.100000000000007E-4
2,test_20231101_134515,1254659.png,342646,82262,260384,0.7599213182117988,3,4,80080,11409,68671,0.85752997002997,20.156343111111113,2970.0569866666665,13.403155786357337,121,5.100000000000007E-4
3,test_20231101_134515,10188041.png,221231,10567,210664,0.95223544620781,2,3,41731,1482,40249,0.9644868323308811,10.533299555555555,996.9537226666666,18.14405361490014,121,5.100000000000007E-4
4,test_20231101_134515,10287332.png,216980,13429,203551,0.9381095031800166,1,3,22337,1833,20504,0.9179388458611273,9.370778666666666,756.6213706666666,19.342017571499717,121,5.100000000000007E-4
5,test_20231101_134515,11610969.png,368720,30069,338651,0.9184503146018659,2,3,84111,4382,79729,0.9479021768853063,20.036851555555554,2651.808336,13.895382293801273,121,5.100000000000007E-4
6,test_20231101_134515,10350842.png,212614,6967,205647,0.9672316968779102,2,4,42529,1022,41507,0.9759693385689765,18.40685866666667,2182.083690666667,14.742089575588938,121,5.100000000000007E-4
7,test_20231101_134515,10863862.png,317432,14697,302735,0.9537003200685501,2,4,66058,2105,63953,0.9681340640043599,23.275838222222223,3117.6927946666665,13.192470415975402,121,5.100000000000007E-4
8,test_20231101_134515,11382381.png,312486,827,311659,0.9973534814359684,2,4,46745,109,46636,0.997668199807466,21.564144,2476.360432,14.192665047538828,121,5.100000000000007E-4
9,test_20231101_134515,11079715.png,443815,130027,313788,0.7070243231977288,3,4,124136,18094,106042,0.8542405104079397,16.408837333333334,1978.80552,15.166772476828436,121,5.100000000000007E-4
10,test_20231101_134515,11551286.png,271883,527,271356,0.9980616662314304,1,4,40092,76,40016,0.9981043599720643,17.926654222222222,1858.3108106666666,15.43962007470492,121,5.100000000000007E-4
1,test_20231101_134515,10404007.png,502730,25727,477003,0.9488254132436894,2,14,61265,3712,57553,0.9394107565494165,25.099845333333334,3270.2719413333334,12.984964927000139,121,5.200000000000007E-4
2,test_20231101_134515,1254659.png,342646,82262,260384,0.7599213182117988,3,4,80080,11409,68671,0.85752997002997,20.156343111111113,2970.0569866666665,13.403155786357337,121,5.200000000000007E-4
3,test_20231101_134515,10188041.png,221231,10567,210664,0.95223544620781,2,3,41731,1482,40249,0.9644868323308811,10.533299555555555,996.9537226666666,18.14405361490014,121,5.200000000000007E-4
4,test_20231101_134515,10287332.png,216980,13429,203551,0.9381095031800166,1,3,22337,1833,20504,0.9179388458611273,9.370778666666666,756.6213706666666,19.342017571499717,121,5.200000000000007E-4
5,test_20231101_134515,11610969.png,368720,30069,338651,0.9184503146018659,3,4,84111,4382,79729,0.9479021768853063,20.036851555555554,2651.808336,13.895382293801273,121,5.200000000000007E-4
6,test_20231101_134515,10350842.png,212614,6967,205647,0.9672316968779102,2,4,42529,1022,41507,0.9759693385689765,18.40685866666667,2182.083690666667,14.742089575588938,121,5.200000000000007E-4
7,test_20231101_134515,10863862.png,317432,14697,302735,0.9537003200685501,2,3,66058,2105,63953,0.9681340640043599,23.275838222222223,3117.6927946666665,13.192470415975402,121,5.200000000000007E-4
8,test_20231101_134515,11382381.png,312486,827,311659,0.9973534814359684,1,4,46745,109,46636,0.997668199807466,21.564144,2476.360432,14.192665047538828,121,5.200000000000007E-4
9,test_20231101_134515,11079715.png,443815,130027,313788,0.7070243231977288,4,4,124136,18094,106042,0.8542405104079397,16.408837333333334,1978.80552,15.166772476828436,121,5.200000000000007E-4
10,test_20231101_134515,11551286.png,271883,527,271356,0.9980616662314304,1,4,40092,76,40016,0.9981043599720643,17.926654222222222,1858.3108106666666,15.43962007470492,121,5.200000000000007E-4
1,test_20231101_134516,10404007.png,502730,25727,477003,0.9488254132436894,3,3,61265,3712,57553,0.9394107565494165,25.099845333333334,3270.2719413333334,12.984964927000139,121,5.300000000000007E-4
2,test_20231101_134516,1254659.png,342646,82262,260384,0.7599213182117988,3,4,80080,11409,68671,0.85752997002997,20.156343111111113,2970.0569866666665,13.403155786357337,121,5.300000000000007E-4
3,test_20231101_134516,10188041.png,221231,10567,210664,0.95223544620781,2,3,41731,1482,40249,0.9644868323308811,10.533299555555555,996.9537226666666,18.14405361490014,121,5.300000000000007E-4
4,test_20231101_134516,10287332.png,216980,13429,203551,0.9381095031800166,2,4,22337,1833,20504,0.9179388458611273,9.370778666666666,756.6213706666666,19.342017571499717,121,5.300000000000007E-4
5,test_20231101_134516,11610969.png,368720,30069,338651,0.9184503146018659,2,3,84111,4382,79729,0.9479021768853063,20.036851555555554,2651.808336,13.895382293801273,121,5.300000000000007E-4
6,test_20231101_134516,10350842.png,212614,6967,205647,0.9672316968779102,2,4,42529,1022,41507,0.9759693385689765,18.40685866666667,2182.083690666667,14.742089575588938,121,5.300000000000007E-4
7,test_20231101_134516,10863862.png,317432,14697,302735,0.9537003200685501,2,4,66058,2105,63953,0.9681340640043599,23.275838222222223,3117.6927946666665,13.192470415975402,121,5.300000000000007E-4
8,test_20231101_134516,11382381.png,312486,827,311659,0.9973534814359684,2,4,46745,109,46636,0.997668199807466,21.564144,2476.360432,14.192665047538828,121,5.300000000000007E-4
9,test_20231101_134516,11079715.png,443815,130027,313788,0.7070243231977288,4,4,124136,18094,106042,0.8542405104079397,16.408837333333334,1978.80552,15.166772476828436,121,5.300000000000007E-4
10,test_20231101_134516,11551286.png,271883,527,271356,0.9980616662314304,1,4,40092,76,40016,0.9981043599720643,17.926654222222222,1858.3108106666666,15.43962007470492,121,5.300000000000007E-4
1,test_20231101_134517,10404007.png,502730,25727,477003,0.9488254132436894,2,4,61265,3712,57553,0.9394107565494165,25.099845333333334,3270.2719413333334,12.984964927000139,121,5.400000000000008E-4
2,test_20231101_134517,1254659.png,342646,82262,260384,0.7599213182117988,3,4,80080,11409,68671,0.85752997002997,20.156343111111113,2970.0569866666665,13.403155786357337,121,5.400000000000008E-4
3,test_20231101_134517,10188041.png,221231,10567,210664,0.95223544620781,2,4,41731,1482,40249,0.9644868323308811,10.533299555555555,996.9537226666666,18.14405361490014,121,5.400000000000008E-4
4,test_20231101_134517,10287332.png,216980,13429,203551,0.9381095031800166,2,4,22337,1833,20504,0.9179388458611273,9.370778666666666,756.6213706666666,19.342017571499717,121,5.400000000000008E-4
5,test_20231101_134517,11610969.png,368720,30069,338651,0.9184503146018659,2,4,84111,4382,79729,0.9479021768853063,20.036851555555554,2651.808336,13.895382293801273,121,5.400000000000008E-4
6,test_20231101_134517,10350842.png,212614,6967,205647,0.9672316968779102,2,3,42529,1022,41507,0.9759693385689765,18.40685866666667,2182.083690666667,14.742089575588938,121,5.400000000000008E-4
7,test_20231101_134517,10863862.png,317432,14697,302735,0.9537003200685501,2,3,66058,2105,63953,0.9681340640043599,23.275838222222223,3117.6927946666665,13.192470415975402,121,5.400000000000008E-4
8,test_20231101_134517,11382381.png,312486,827,311659,0.9973534814359684,1,4,46745,109,46636,0.997668199807466,21.564144,2476.360432,14.192665047538828,121,5.400000000000008E-4
9,test_20231101_134517,11079715.png,443815,130027,313788,0.7070243231977288,3,5,124136,18094,106042,0.8542405104079397,16.408837333333334,1978.80552,15.166772476828436,121,5.400000000000008E-4
10,test_20231101_134517,11551286.png,271883,527,271356,0.9980616662314304,1,3,40092,76,40016,0.9981043599720643,17.926654222222222,1858.3108106666666,15.43962007470492,121,5.400000000000008E-4
1,test_20231101_134517,10404007.png,502730,25727,477003,0.9488254132436894,2,3,61265,3712,57553,0.9394107565494165,25.099845333333334,3270.2719413333334,12.984964927000139,121,5.500000000000008E-4
2,test_20231101_134517,1254659.png,342646,82262,260384,0.7599213182117988,3,4,80080,11409,68671,0.85752997002997,20.156343111111113,2970.0569866666665,13.403155786357337,121,5.500000000000008E-4
3,test_20231101_134517,10188041.png,221231,10567,210664,0.95223544620781,2,4,41731,1482,40249,0.9644868323308811,10.533299555555555,996.9537226666666,18.14405361490014,121,5.500000000000008E-4
4,test_20231101_134517,10287332.png,216980,13429,203551,0.9381095031800166,3,4,22337,1833,20504,0.9179388458611273,9.370778666666666,756.6213706666666,19.342017571499717,121,5.500000000000008E-4
5,test_20231101_134517,11610969.png,368720,30069,338651,0.9184503146018659,2,4,84111,4382,79729,0.9479021768853063,20.036851555555554,2651.808336,13.895382293801273,121,5.500000000000008E-4
6,test_20231101_134517,10350842.png,212614,6967,205647,0.9672316968779102,2,4,42529,1022,41507,0.9759693385689765,18.40685866666667,2182.083690666667,14.742089575588938,121,5.500000000000008E-4
7,test_20231101_134517,10863862.png,317432,14697,302735,0.9537003200685501,2,4,66058,2105,63953,0.9681340640043599,23.275838222222223,3117.6927946666665,13.192470415975402,121,5.500000000000008E-4
8,test_20231101_134517,11382381.png,312486,827,311659,0.9973534814359684,1,3,46745,109,46636,0.997668199807466,21.564144,2476.360432,14.192665047538828,121,5.500000000000008E-4
9,test_20231101_134517,11079715.png,443815,130027,313788,0.7070243231977288,4,4,124136,18094,106042,0.8542405104079397,16.408837333333334,1978.80552,15.166772476828436,121,5.500000000000008E-4
10,test_20231101_134517,11551286.png,271883,527,271356,0.9980616662314304,1,4,40092,76,40016,0.9981043599720643,17.926654222222222,1858.3108106666666,15.43962007470492,121,5.500000000000008E-4
1,test_20231101_134518,10404007.png,502730,25727,477003,0.9488254132436894,2,4,61265,3712,57553,0.9394107565494165,25.099845333333334,3270.2719413333334,12.984964927000139,121,5.600000000000008E-4
2,test_20231101_134518,1254659.png,342646,82262,260384,0.7599213182117988,3,4,80080,11409,68671,0.85752997002997,20.156343111111113,2970.0569866666665,13.403155786357337,121,5.600000000000008E-4
3,test_20231101_134518,10188041.png,221231,10567,210664,0.95223544620781,1,3,41731,1482,40249,0.9644868323308811,10.533299555555555,996.9537226666666,18.14405361490014,121,5.600000000000008E-4
4,test_20231101_134518,10287332.png,216980,13429,203551,0.9381095031800166,2,3,22337,1833,20504,0.9179388458611273,9.370778666666666,756.6213706666666,19.342017571499717,121,5.600000000000008E-4
5,test_20231101_134518,11610969.png,368720,30069,338651,0.9184503146018659,2,3,84111,4382,79729,0.9479021768853063,20.036851555555554,2651.808336,13.895382293801273,121,5.600000000000008E-4
6,test_20231101_134518,10350842.png,212614,6967,205647,0.9672316968779102,1,3,42529,1022,41507,0.9759693385689765,18.40685866666667,2182.083690666667,14.742089575588938,121,5.600000000000008E-4
7,test_20231101_134518,10863862.png,317432,14697,302735,0.9537003200685501,2,4,66058,2105,63953,0.9681340640043599,23.275838222222223,3117.6927946666665,13.192470415975402,121,5.600000000000008E-4
8,test_20231101_134518,11382381.png,312486,827,311659,0.9973534814359684,2,3,46745,109,46636,0.997668199807466,21.564144,2476.360432,14.192665047538828,121,5.600000000000008E-4
9,test_20231101_134518,11079715.png,443815,130027,313788,0.7070243231977288,3,4,124136,18094,106042,0.8542405104079397,16.408837333333334,1978.80552,15.166772476828436,121,5.600000000000008E-4
10,test_20231101_134518,11551286.png,271883,527,271356,0.9980616662314304,1,4,40092,76,40016,0.9981043599720643,17.926654222222222,1858.3108106666666,15.43962007470492,121,5.600000000000008E-4
1,test_20231101_134519,10404007.png,502730,25727,477003,0.9488254132436894,3,3,61265,3712,57553,0.9394107565494165,25.099845333333334,3270.2719413333334,12.984964927000139,121,5.700000000000008E-4
2,test_20231101_134519,1254659.png,342646,82262,260384,0.7599213182117988,2,4,80080,11409,68671,0.85752997002997,20.156343111111113,2970.0569866666665,13.403155786357337,121,5.700000000000008E-4
3,test_20231101_134519,10188041.png,221231,10567,210664,0.95223544620781,2,4,41731,1482,40249,0.9644868323308811,10.533299555555555,996.9537226666666,18.14405361490014,121,5.700000000000008E-4
4,test_20231101_134519,10287332.png,216980,13429,203551,0.9381095031800166,2,3,22337,1833,20504,0.9179388458611273,9.370778666666666,756.6213706666666,19.342017571499717,121,5.700000000000008E-4
5,test_20231101_134519,11610969.png,368720,30069,338651,0.9184503146018659,3,4,84111,4382,79729,0.9479021768853063,20.036851555555554,2651.808336,13.895382293801273,121,5.700000000000008E-4
6,test_20231101_134519,10350842.png,212614,6967,205647,0.9672316968779102,2,4,42529,1022,41507,0.9759693385689765,18.40685866666667,2182.083690666667,14.742089575588938,121,5.700000000000008E-4
7,test_20231101_134519,10863862.png,317432,14697,302735,0.9537003200685501,2,4,66058,2105,63953,0.9681340640043599,23.275838222222223,3117.6927946666665,13.192470415975402,121,5.700000000000008E-4
8,test_20231101_134519,11382381.png,312486,827,311659,0.9973534814359684,2,4,46745,109,46636,0.997668199807466,21.564144,2476.360432,14.192665047538828,121,5.700000000000008E-4
9,test_20231101_134519,11079715.png,443815,130027,313788,0.7070243231977288,3,5,124136,18094,106042,0.8542405104079397,16.408837333333334,1978.80552,15.166772476828436,121,5.700000000000008E-4
10,test_20231101_134519,11551286.png,271883,527,271356,0.9980616662314304,1,4,40092,76,40016,0.9981043599720643,17.926654222222222,1858.3108106666666,15.43962007470492,121,5.700000000000008E-4
1,test_20231101_134519,10404007.png,502730,25407,477323,0.9494619378195055,3,3,61265,3666,57599,0.9401615930792458,25.18988977777778,3290.26648,12.958492878094653,121,5.800000000000009E-4
2,test_20231101_134519,1254659.png,342646,82262,260384,0.7599213182117988,3,4,80080,11409,68671,0.85752997002997,20.156343111111113,2970.0569866666665,13.403155786357337,121,5.800000000000009E-4
3,test_20231101_134519,10188041.png,221231,10567,210664,0.95223544620781,2,3,41731,1482,40249,0.9644868323308811,10.533299555555555,996.9537226666666,18.14405361490014,121,5.800000000000009E-4
4,test_20231101_134519,10287332.png,216980,13429,203551,0.9381095031800166,2,3,22337,1833,20504,0.9179388458611273,9.370778666666666,756.6213706666666,19.342017571499717,121,5.800000000000009E-4
5,test_20231101_134519,11610969.png,368720,30069,338651,0.9184503146018659,3,3,84111,4382,79729,0.9479021768853063,20.036851555555554,2651.808336,13.895382293801273,121,5.800000000000009E-4
6,test_20231101_134519,10350842.png,212614,6967,205647,0.9672316968779102,2,3,42529,1022,41507,0.9759693385689765,18.40685866666667,2182.083690666667,14.742089575588938,121,5.800000000000009E-4
7,test_20231101_134519,10863862.png,317432,14697,302735,0.9537003200685501,2,4,66058,2105,63953,0.9681340640043599,23.275838222222223,3117.6927946666665,13.192470415975402,121,5.800000000000009E-4
8,test_20231101_134519,11382381.png,312486,827,311659,0.9973534814359684,1,4,46745,109,46636,0.997668199807466,21.564144,2476.360432,14.192665047538828,121,5.800000000000009E-4
9,test_20231101_134519,11079715.png,443815,130027,313788,0.7070243231977288,4,4,124136,18094,106042,0.8542405104079397,16.408837333333334,1978.80552,15.166772476828436,121,5.800000000000009E-4
10,test_20231101_134519,11551286.png,271883,527,271356,0.9980616662314304,2,3,40092,76,40016,0.9981043599720643,17.926654222222222,1858.3108106666666,15.43962007470492,121,5.800000000000009E-4
1,test_20231101_134520,10404007.png,502730,25407,477323,0.9494619378195055,3,4,61265,3666,57599,0.9401615930792458,25.18988977777778,3290.26648,12.958492878094653,121,5.900000000000009E-4
2,test_20231101_134520,1254659.png,342646,82262,260384,0.7599213182117988,3,4,80080,11409,68671,0.85752997002997,20.156343111111113,2970.0569866666665,13.403155786357337,121,5.900000000000009E-4
3,test_20231101_134520,10188041.png,221231,10567,210664,0.95223544620781,2,4,41731,1482,40249,0.9644868323308811,10.533299555555555,996.9537226666666,18.14405361490014,121,5.900000000000009E-4
4,test_20231101_134520,10287332.png,216980,13429,203551,0.9381095031800166,1,4,22337,1833,20504,0.9179388458611273,9.370778666666666,756.6213706666666,19.342017571499717,121,5.900000000000009E-4
5,test_20231101_134520,11610969.png,368720,30069,338651,0.9184503146018659,3,3,84111,4382,79729,0.9479021768853063,20.036851555555554,2651.808336,13.895382293801273,121,5.900000000000009E-4
6,test_20231101_134520,10350842.png,212614,6967,205647,0.9672316968779102,2,3,42529,1022,41507,0.9759693385689765,18.40685866666667,2182.083690666667,14.742089575588938,121,5.900000000000009E-4
7,test_20231101_134520,10863862.png,317432,14697,302735,0.9537003200685501,2,3,66058,2105,63953,0.9681340640043599,23.275838222222223,3117.6927946666665,13.192470415975402,121,5.900000000000009E-4
8,test_20231101_134520,11382381.png,312486,827,311659,0.9973534814359684,1,3,46745,109,46636,0.997668199807466,21.564144,2476.360432,14.192665047538828,121,5.900000000000009E-4
9,test_20231101_134520,11079715.png,443815,130027,313788,0.7070243231977288,4,4,124136,18094,106042,0.8542405104079397,16.408837333333334,1978.80552,15.166772476828436,121,5.900000000000009E-4
10,test_20231101_134520,11551286.png,271883,527,271356,0.9980616662314304,2,3,40092,76,40016,0.9981043599720643,17.926654222222222,1858.3108106666666,15.43962007470492,121,5.900000000000009E-4
1,test_20231101_134521,10404007.png,502730,25407,477323,0.9494619378195055,2,3,61265,3666,57599,0.9401615930792458,25.18988977777778,3290.26648,12.958492878094653,121,6.000000000000009E-4
2,test_20231101_134521,1254659.png,342646,82262,260384,0.7599213182117988,3,4,80080,11409,68671,0.85752997002997,20.156343111111113,2970.0569866666665,13.403155786357337,121,6.000000000000009E-4
3,test_20231101_134521,10188041.png,221231,10567,210664,0.95223544620781,2,4,41731,1482,40249,0.9644868323308811,10.533299555555555,996.9537226666666,18.14405361490014,121,6.000000000000009E-4
4,test_20231101_134521,10287332.png,216980,13429,203551,0.9381095031800166,1,4,22337,1833,20504,0.9179388458611273,9.370778666666666,756.6213706666666,19.342017571499717,121,6.000000000000009E-4
5,test_20231101_134521,11610969.png,368720,30069,338651,0.9184503146018659,3,3,84111,4382,79729,0.9479021768853063,20.036851555555554,2651.808336,13.895382293801273,121,6.000000000000009E-4
6,test_20231101_134521,10350842.png,212614,6967,205647,0.9672316968779102,2,4,42529,1022,41507,0.9759693385689765,18.40685866666667,2182.083690666667,14.742089575588938,121,6.000000000000009E-4
7,test_20231101_134521,10863862.png,317432,14697,302735,0.9537003200685501,2,3,66058,2105,63953,0.9681340640043599,23.275838222222223,3117.6927946666665,13.192470415975402,121,6.000000000000009E-4
8,test_20231101_134521,11382381.png,312486,827,311659,0.9973534814359684,2,3,46745,109,46636,0.997668199807466,21.564144,2476.360432,14.192665047538828,121,6.000000000000009E-4
9,test_20231101_134521,11079715.png,443815,130027,313788,0.7070243231977288,4,4,124136,18094,106042,0.8542405104079397,16.408837333333334,1978.80552,15.166772476828436,121,6.000000000000009E-4
10,test_20231101_134521,11551286.png,271883,527,271356,0.9980616662314304,1,4,40092,76,40016,0.9981043599720643,17.926654222222222,1858.3108106666666,15.43962007470492,121,6.000000000000009E-4
1,test_20231101_134521,10404007.png,502730,25407,477323,0.9494619378195055,2,13,61265,3666,57599,0.9401615930792458,25.18988977777778,3290.26648,12.958492878094653,121,6.10000000000001E-4
2,test_20231101_134521,1254659.png,342646,82262,260384,0.7599213182117988,3,4,80080,11409,68671,0.85752997002997,20.156343111111113,2970.0569866666665,13.403155786357337,121,6.10000000000001E-4
3,test_20231101_134521,10188041.png,221231,10567,210664,0.95223544620781,2,4,41731,1482,40249,0.9644868323308811,10.533299555555555,996.9537226666666,18.14405361490014,121,6.10000000000001E-4
4,test_20231101_134521,10287332.png,216980,13429,203551,0.9381095031800166,1,3,22337,1833,20504,0.9179388458611273,9.370778666666666,756.6213706666666,19.342017571499717,121,6.10000000000001E-4
5,test_20231101_134521,11610969.png,368720,30069,338651,0.9184503146018659,3,4,84111,4382,79729,0.9479021768853063,20.036851555555554,2651.808336,13.895382293801273,121,6.10000000000001E-4
6,test_20231101_134521,10350842.png,212614,6967,205647,0.9672316968779102,2,4,42529,1022,41507,0.9759693385689765,18.40685866666667,2182.083690666667,14.742089575588938,121,6.10000000000001E-4
7,test_20231101_134521,10863862.png,317432,14697,302735,0.9537003200685501,2,4,66058,2105,63953,0.9681340640043599,23.275838222222223,3117.6927946666665,13.192470415975402,121,6.10000000000001E-4
8,test_20231101_134521,11382381.png,312486,827,311659,0.9973534814359684,1,4,46745,109,46636,0.997668199807466,21.564144,2476.360432,14.192665047538828,121,6.10000000000001E-4
9,test_20231101_134521,11079715.png,443815,130027,313788,0.7070243231977288,3,4,124136,18094,106042,0.8542405104079397,16.408837333333334,1978.80552,15.166772476828436,121,6.10000000000001E-4
10,test_20231101_134521,11551286.png,271883,527,271356,0.9980616662314304,1,4,40092,76,40016,0.9981043599720643,17.926654222222222,1858.3108106666666,15.43962007470492,121,6.10000000000001E-4
1,test_20231101_134522,10404007.png,502730,25407,477323,0.9494619378195055,2,4,61265,3666,57599,0.9401615930792458,25.18988977777778,3290.26648,12.958492878094653,121,6.20000000000001E-4
2,test_20231101_134522,1254659.png,342646,82262,260384,0.7599213182117988,3,4,80080,11409,68671,0.85752997002997,20.156343111111113,2970.0569866666665,13.403155786357337,121,6.20000000000001E-4
3,test_20231101_134522,10188041.png,221231,10567,210664,0.95223544620781,3,3,41731,1482,40249,0.9644868323308811,10.533299555555555,996.9537226666666,18.14405361490014,121,6.20000000000001E-4
4,test_20231101_134522,10287332.png,216980,13429,203551,0.9381095031800166,2,4,22337,1833,20504,0.9179388458611273,9.370778666666666,756.6213706666666,19.342017571499717,121,6.20000000000001E-4
5,test_20231101_134522,11610969.png,368720,30069,338651,0.9184503146018659,2,4,84111,4382,79729,0.9479021768853063,20.036851555555554,2651.808336,13.895382293801273,121,6.20000000000001E-4
6,test_20231101_134522,10350842.png,212614,6967,205647,0.9672316968779102,2,6,42529,1022,41507,0.9759693385689765,18.40685866666667,2182.083690666667,14.742089575588938,121,6.20000000000001E-4
7,test_20231101_134522,10863862.png,317432,14697,302735,0.9537003200685501,2,3,66058,2105,63953,0.9681340640043599,23.275838222222223,3117.6927946666665,13.192470415975402,121,6.20000000000001E-4
8,test_20231101_134522,11382381.png,312486,827,311659,0.9973534814359684,1,3,46745,109,46636,0.997668199807466,21.564144,2476.360432,14.192665047538828,121,6.20000000000001E-4
9,test_20231101_134522,11079715.png,443815,130027,313788,0.7070243231977288,4,4,124136,18094,106042,0.8542405104079397,16.408837333333334,1978.80552,15.166772476828436,121,6.20000000000001E-4
10,test_20231101_134522,11551286.png,271883,527,271356,0.9980616662314304,1,3,40092,76,40016,0.9981043599720643,17.926654222222222,1858.3108106666666,15.43962007470492,121,6.20000000000001E-4
1,test_20231101_134523,10404007.png,502730,25407,477323,0.9494619378195055,2,9,61265,3666,57599,0.9401615930792458,25.18988977777778,3290.26648,12.958492878094653,121,6.30000000000001E-4
2,test_20231101_134523,1254659.png,342646,82262,260384,0.7599213182117988,3,4,80080,11409,68671,0.85752997002997,20.156343111111113,2970.0569866666665,13.403155786357337,121,6.30000000000001E-4
3,test_20231101_134523,10188041.png,221231,10567,210664,0.95223544620781,2,4,41731,1482,40249,0.9644868323308811,10.533299555555555,996.9537226666666,18.14405361490014,121,6.30000000000001E-4
4,test_20231101_134523,10287332.png,216980,13429,203551,0.9381095031800166,2,4,22337,1833,20504,0.9179388458611273,9.370778666666666,756.6213706666666,19.342017571499717,121,6.30000000000001E-4
5,test_20231101_134523,11610969.png,368720,30069,338651,0.9184503146018659,2,4,84111,4382,79729,0.9479021768853063,20.036851555555554,2651.808336,13.895382293801273,121,6.30000000000001E-4
6,test_20231101_134523,10350842.png,212614,6967,205647,0.9672316968779102,1,4,42529,1022,41507,0.9759693385689765,18.40685866666667,2182.083690666667,14.742089575588938,121,6.30000000000001E-4
7,test_20231101_134523,10863862.png,317432,14697,302735,0.9537003200685501,2,3,66058,2105,63953,0.9681340640043599,23.275838222222223,3117.6927946666665,13.192470415975402,121,6.30000000000001E-4
8,test_20231101_134523,11382381.png,312486,827,311659,0.9973534814359684,1,3,46745,109,46636,0.997668199807466,21.564144,2476.360432,14.192665047538828,121,6.30000000000001E-4
9,test_20231101_134523,11079715.png,443815,130027,313788,0.7070243231977288,3,5,124136,18094,106042,0.8542405104079397,16.408837333333334,1978.80552,15.166772476828436,121,6.30000000000001E-4
10,test_20231101_134523,11551286.png,271883,527,271356,0.9980616662314304,1,3,40092,76,40016,0.9981043599720643,17.926654222222222,1858.3108106666666,15.43962007470492,121,6.30000000000001E-4
1,test_20231101_134523,10404007.png,502730,25407,477323,0.9494619378195055,2,3,61265,3666,57599,0.9401615930792458,25.18988977777778,3290.26648,12.958492878094653,121,6.40000000000001E-4
2,test_20231101_134523,1254659.png,342646,82262,260384,0.7599213182117988,3,4,80080,11409,68671,0.85752997002997,20.156343111111113,2970.0569866666665,13.403155786357337,121,6.40000000000001E-4
3,test_20231101_134523,10188041.png,221231,10567,210664,0.95223544620781,2,4,41731,1482,40249,0.9644868323308811,10.533299555555555,996.9537226666666,18.14405361490014,121,6.40000000000001E-4
4,test_20231101_134523,10287332.png,216980,13429,203551,0.9381095031800166,2,4,22337,1833,20504,0.9179388458611273,9.370778666666666,756.6213706666666,19.342017571499717,121,6.40000000000001E-4
5,test_20231101_134523,11610969.png,368720,30069,338651,0.9184503146018659,2,4,84111,4382,79729,0.9479021768853063,20.036851555555554,2651.808336,13.895382293801273,121,6.40000000000001E-4
6,test_20231101_134523,10350842.png,212614,6967,205647,0.9672316968779102,1,4,42529,1022,41507,0.9759693385689765,18.40685866666667,2182.083690666667,14.742089575588938,121,6.40000000000001E-4
7,test_20231101_134523,10863862.png,317432,14697,302735,0.9537003200685501,2,4,66058,2105,63953,0.9681340640043599,23.275838222222223,3117.6927946666665,13.192470415975402,121,6.40000000000001E-4
8,test_20231101_134523,11382381.png,312486,827,311659,0.9973534814359684,2,3,46745,109,46636,0.997668199807466,21.564144,2476.360432,14.192665047538828,121,6.40000000000001E-4
9,test_20231101_134523,11079715.png,443815,130027,313788,0.7070243231977288,4,5,124136,18094,106042,0.8542405104079397,16.408837333333334,1978.80552,15.166772476828436,121,6.40000000000001E-4
10,test_20231101_134523,11551286.png,271883,527,271356,0.9980616662314304,1,3,40092,76,40016,0.9981043599720643,17.926654222222222,1858.3108106666666,15.43962007470492,121,6.40000000000001E-4
1,test_20231101_134524,10404007.png,502730,25407,477323,0.9494619378195055,2,3,61265,3666,57599,0.9401615930792458,25.18988977777778,3290.26648,12.958492878094653,121,6.500000000000011E-4
2,test_20231101_134524,1254659.png,342646,82262,260384,0.7599213182117988,3,4,80080,11409,68671,0.85752997002997,20.156343111111113,2970.0569866666665,13.403155786357337,121,6.500000000000011E-4
3,test_20231101_134524,10188041.png,221231,10567,210664,0.95223544620781,2,4,41731,1482,40249,0.9644868323308811,10.533299555555555,996.9537226666666,18.14405361490014,121,6.500000000000011E-4
4,test_20231101_134524,10287332.png,216980,13429,203551,0.9381095031800166,2,3,22337,1833,20504,0.9179388458611273,9.370778666666666,756.6213706666666,19.342017571499717,121,6.500000000000011E-4
5,test_20231101_134524,11610969.png,368720,30069,338651,0.9184503146018659,2,4,84111,4382,79729,0.9479021768853063,20.036851555555554,2651.808336,13.895382293801273,121,6.500000000000011E-4
6,test_20231101_134524,10350842.png,212614,6967,205647,0.9672316968779102,2,3,42529,1022,41507,0.9759693385689765,18.40685866666667,2182.083690666667,14.742089575588938,121,6.500000000000011E-4
7,test_20231101_134524,10863862.png,317432,14697,302735,0.9537003200685501,2,3,66058,2105,63953,0.9681340640043599,23.275838222222223,3117.6927946666665,13.192470415975402,121,6.500000000000011E-4
8,test_20231101_134524,11382381.png,312486,827,311659,0.9973534814359684,2,3,46745,109,46636,0.997668199807466,21.564144,2476.360432,14.192665047538828,121,6.500000000000011E-4
9,test_20231101_134524,11079715.png,443815,130027,313788,0.7070243231977288,3,5,124136,18094,106042,0.8542405104079397,16.408837333333334,1978.80552,15.166772476828436,121,6.500000000000011E-4
10,test_20231101_134524,11551286.png,271883,527,271356,0.9980616662314304,1,3,40092,76,40016,0.9981043599720643,17.926654222222222,1858.3108106666666,15.43962007470492,121,6.500000000000011E-4
1,test_20231101_134525,10404007.png,502730,25407,477323,0.9494619378195055,3,3,61265,3666,57599,0.9401615930792458,25.18988977777778,3290.26648,12.958492878094653,121,6.600000000000011E-4
2,test_20231101_134525,1254659.png,342646,82262,260384,0.7599213182117988,3,4,80080,11409,68671,0.85752997002997,20.156343111111113,2970.0569866666665,13.403155786357337,121,6.600000000000011E-4
3,test_20231101_134525,10188041.png,221231,10567,210664,0.95223544620781,2,4,41731,1482,40249,0.9644868323308811,10.533299555555555,996.9537226666666,18.14405361490014,121,6.600000000000011E-4
4,test_20231101_134525,10287332.png,216980,13429,203551,0.9381095031800166,2,4,22337,1833,20504,0.9179388458611273,9.370778666666666,756.6213706666666,19.342017571499717,121,6.600000000000011E-4
5,test_20231101_134525,11610969.png,368720,30069,338651,0.9184503146018659,3,7,84111,4382,79729,0.9479021768853063,20.036851555555554,2651.808336,13.895382293801273,121,6.600000000000011E-4
6,test_20231101_134525,10350842.png,212614,6967,205647,0.9672316968779102,2,3,42529,1022,41507,0.9759693385689765,18.40685866666667,2182.083690666667,14.742089575588938,121,6.600000000000011E-4
7,test_20231101_134525,10863862.png,317432,14697,302735,0.9537003200685501,2,4,66058,2105,63953,0.9681340640043599,23.275838222222223,3117.6927946666665,13.192470415975402,121,6.600000000000011E-4
8,test_20231101_134525,11382381.png,312486,827,311659,0.9973534814359684,2,3,46745,109,46636,0.997668199807466,21.564144,2476.360432,14.192665047538828,121,6.600000000000011E-4
9,test_20231101_134525,11079715.png,443815,130027,313788,0.7070243231977288,3,5,124136,18094,106042,0.8542405104079397,16.408837333333334,1978.80552,15.166772476828436,121,6.600000000000011E-4
10,test_20231101_134525,11551286.png,271883,527,271356,0.9980616662314304,1,4,40092,76,40016,0.9981043599720643,17.926654222222222,1858.3108106666666,15.43962007470492,121,6.600000000000011E-4
1,test_20231101_134525,10404007.png,502730,25407,477323,0.9494619378195055,2,3,61265,3666,57599,0.9401615930792458,25.18988977777778,3290.26648,12.958492878094653,121,6.700000000000011E-4
2,test_20231101_134525,1254659.png,342646,82262,260384,0.7599213182117988,3,4,80080,11409,68671,0.85752997002997,20.156343111111113,2970.0569866666665,13.403155786357337,121,6.700000000000011E-4
3,test_20231101_134525,10188041.png,221231,10567,210664,0.95223544620781,3,4,41731,1482,40249,0.9644868323308811,10.533299555555555,996.9537226666666,18.14405361490014,121,6.700000000000011E-4
4,test_20231101_134525,10287332.png,216980,13429,203551,0.9381095031800166,1,3,22337,1833,20504,0.9179388458611273,9.370778666666666,756.6213706666666,19.342017571499717,121,6.700000000000011E-4
5,test_20231101_134525,11610969.png,368720,30069,338651,0.9184503146018659,2,4,84111,4382,79729,0.9479021768853063,20.036851555555554,2651.808336,13.895382293801273,121,6.700000000000011E-4
6,test_20231101_134525,10350842.png,212614,6967,205647,0.9672316968779102,1,5,42529,1022,41507,0.9759693385689765,18.40685866666667,2182.083690666667,14.742089575588938,121,6.700000000000011E-4
7,test_20231101_134525,10863862.png,317432,14697,302735,0.9537003200685501,2,4,66058,2105,63953,0.9681340640043599,23.275838222222223,3117.6927946666665,13.192470415975402,121,6.700000000000011E-4
8,test_20231101_134525,11382381.png,312486,827,311659,0.9973534814359684,1,3,46745,109,46636,0.997668199807466,21.564144,2476.360432,14.192665047538828,121,6.700000000000011E-4
9,test_20231101_134525,11079715.png,443815,130027,313788,0.7070243231977288,4,4,124136,18094,106042,0.8542405104079397,16.408837333333334,1978.80552,15.166772476828436,121,6.700000000000011E-4
10,test_20231101_134525,11551286.png,271883,527,271356,0.9980616662314304,2,3,40092,76,40016,0.9981043599720643,17.926654222222222,1858.3108106666666,15.43962007470492,121,6.700000000000011E-4
1,test_20231101_134526,10404007.png,502730,25407,477323,0.9494619378195055,3,4,61265,3666,57599,0.9401615930792458,25.18988977777778,3290.26648,12.958492878094653,121,6.800000000000011E-4
2,test_20231101_134526,1254659.png,342646,82262,260384,0.7599213182117988,3,4,80080,11409,68671,0.85752997002997,20.156343111111113,2970.0569866666665,13.403155786357337,121,6.800000000000011E-4
3,test_20231101_134526,10188041.png,221231,10567,210664,0.95223544620781,2,3,41731,1482,40249,0.9644868323308811,10.533299555555555,996.9537226666666,18.14405361490014,121,6.800000000000011E-4
4,test_20231101_134526,10287332.png,216980,13429,203551,0.9381095031800166,1,4,22337,1833,20504,0.9179388458611273,9.370778666666666,756.6213706666666,19.342017571499717,121,6.800000000000011E-4
5,test_20231101_134526,11610969.png,368720,30069,338651,0.9184503146018659,3,3,84111,4382,79729,0.9479021768853063,20.036851555555554,2651.808336,13.895382293801273,121,6.800000000000011E-4
6,test_20231101_134526,10350842.png,212614,6967,205647,0.9672316968779102,2,10,42529,1022,41507,0.9759693385689765,18.40685866666667,2182.083690666667,14.742089575588938,121,6.800000000000011E-4
7,test_20231101_134526,10863862.png,317432,14697,302735,0.9537003200685501,2,4,66058,2105,63953,0.9681340640043599,23.275838222222223,3117.6927946666665,13.192470415975402,121,6.800000000000011E-4
8,test_20231101_134526,11382381.png,312486,827,311659,0.9973534814359684,1,3,46745,109,46636,0.997668199807466,21.564144,2476.360432,14.192665047538828,121,6.800000000000011E-4
9,test_20231101_134526,11079715.png,443815,130027,313788,0.7070243231977288,3,5,124136,18094,106042,0.8542405104079397,16.408837333333334,1978.80552,15.166772476828436,121,6.800000000000011E-4
10,test_20231101_134526,11551286.png,271883,527,271356,0.9980616662314304,1,4,40092,76,40016,0.9981043599720643,17.926654222222222,1858.3108106666666,15.43962007470492,121,6.800000000000011E-4
1,test_20231101_134527,10404007.png,502730,25407,477323,0.9494619378195055,2,4,61265,3666,57599,0.9401615930792458,25.18988977777778,3290.26648,12.958492878094653,121,6.900000000000012E-4
2,test_20231101_134527,1254659.png,342646,82262,260384,0.7599213182117988,3,4,80080,11409,68671,0.85752997002997,20.156343111111113,2970.0569866666665,13.403155786357337,121,6.900000000000012E-4
3,test_20231101_134527,10188041.png,221231,10567,210664,0.95223544620781,2,4,41731,1482,40249,0.9644868323308811,10.533299555555555,996.9537226666666,18.14405361490014,121,6.900000000000012E-4
4,test_20231101_134527,10287332.png,216980,13429,203551,0.9381095031800166,2,4,22337,1833,20504,0.9179388458611273,9.370778666666666,756.6213706666666,19.342017571499717,121,6.900000000000012E-4
5,test_20231101_134527,11610969.png,368720,30069,338651,0.9184503146018659,2,4,84111,4382,79729,0.9479021768853063,20.036851555555554,2651.808336,13.895382293801273,121,6.900000000000012E-4
6,test_20231101_134527,10350842.png,212614,6967,205647,0.9672316968779102,2,3,42529,1022,41507,0.9759693385689765,18.40685866666667,2182.083690666667,14.742089575588938,121,6.900000000000012E-4
7,test_20231101_134527,10863862.png,317432,14697,302735,0.9537003200685501,3,3,66058,2105,63953,0.9681340640043599,23.275838222222223,3117.6927946666665,13.192470415975402,121,6.900000000000012E-4
8,test_20231101_134527,11382381.png,312486,827,311659,0.9973534814359684,1,4,46745,109,46636,0.997668199807466,21.564144,2476.360432,14.192665047538828,121,6.900000000000012E-4
9,test_20231101_134527,11079715.png,443815,130027,313788,0.7070243231977288,3,4,124136,18094,106042,0.8542405104079397,16.408837333333334,1978.80552,15.166772476828436,121,6.900000000000012E-4
10,test_20231101_134527,11551286.png,271883,527,271356,0.9980616662314304,2,4,40092,76,40016,0.9981043599720643,17.926654222222222,1858.3108106666666,15.43962007470492,121,6.900000000000012E-4
1,test_20231101_134527,10404007.png,502730,25407,477323,0.9494619378195055,3,4,61265,3666,57599,0.9401615930792458,25.18988977777778,3290.26648,12.958492878094653,121,7.000000000000012E-4
2,test_20231101_134527,1254659.png,342646,82262,260384,0.7599213182117988,3,4,80080,11409,68671,0.85752997002997,20.156343111111113,2970.0569866666665,13.403155786357337,121,7.000000000000012E-4
3,test_20231101_134527,10188041.png,221231,10567,210664,0.95223544620781,2,4,41731,1482,40249,0.9644868323308811,10.533299555555555,996.9537226666666,18.14405361490014,121,7.000000000000012E-4
4,test_20231101_134527,10287332.png,216980,13429,203551,0.9381095031800166,2,4,22337,1833,20504,0.9179388458611273,9.370778666666666,756.6213706666666,19.342017571499717,121,7.000000000000012E-4
5,test_20231101_134527,11610969.png,368720,30069,338651,0.9184503146018659,2,4,84111,4382,79729,0.9479021768853063,20.036851555555554,2651.808336,13.895382293801273,121,7.000000000000012E-4
6,test_20231101_134527,10350842.png,212614,6967,205647,0.9672316968779102,1,3,42529,1022,41507,0.9759693385689765,18.40685866666667,2182.083690666667,14.742089575588938,121,7.000000000000012E-4
7,test_20231101_134527,10863862.png,317432,14697,302735,0.9537003200685501,2,4,66058,2105,63953,0.9681340640043599,23.275838222222223,3117.6927946666665,13.192470415975402,121,7.000000000000012E-4
8,test_20231101_134527,11382381.png,312486,827,311659,0.9973534814359684,1,3,46745,109,46636,0.997668199807466,21.564144,2476.360432,14.192665047538828,121,7.000000000000012E-4
9,test_20231101_134527,11079715.png,443815,130027,313788,0.7070243231977288,4,4,124136,18094,106042,0.8542405104079397,16.408837333333334,1978.80552,15.166772476828436,121,7.000000000000012E-4
10,test_20231101_134527,11551286.png,271883,527,271356,0.9980616662314304,2,3,40092,76,40016,0.9981043599720643,17.926654222222222,1858.3108106666666,15.43962007470492,121,7.000000000000012E-4
1,test_20231101_134528,10404007.png,502730,25407,477323,0.9494619378195055,2,4,61265,3666,57599,0.9401615930792458,25.18988977777778,3290.26648,12.958492878094653,121,7.100000000000012E-4
2,test_20231101_134528,1254659.png,342646,82262,260384,0.7599213182117988,4,4,80080,11409,68671,0.85752997002997,20.156343111111113,2970.0569866666665,13.403155786357337,121,7.100000000000012E-4
3,test_20231101_134528,10188041.png,221231,10567,210664,0.95223544620781,2,4,41731,1482,40249,0.9644868323308811,10.533299555555555,996.9537226666666,18.14405361490014,121,7.100000000000012E-4
4,test_20231101_134528,10287332.png,216980,13429,203551,0.9381095031800166,2,4,22337,1833,20504,0.9179388458611273,9.370778666666666,756.6213706666666,19.342017571499717,121,7.100000000000012E-4
5,test_20231101_134528,11610969.png,368720,30069,338651,0.9184503146018659,2,4,84111,4382,79729,0.9479021768853063,20.036851555555554,2651.808336,13.895382293801273,121,7.100000000000012E-4
6,test_20231101_134528,10350842.png,212614,6967,205647,0.9672316968779102,2,4,42529,1022,41507,0.9759693385689765,18.40685866666667,2182.083690666667,14.742089575588938,121,7.100000000000012E-4
7,test_20231101_134528,10863862.png,317432,14697,302735,0.9537003200685501,2,4,66058,2105,63953,0.9681340640043599,23.275838222222223,3117.6927946666665,13.192470415975402,121,7.100000000000012E-4
8,test_20231101_134528,11382381.png,312486,827,311659,0.9973534814359684,1,4,46745,109,46636,0.997668199807466,21.564144,2476.360432,14.192665047538828,121,7.100000000000012E-4
9,test_20231101_134528,11079715.png,443815,130027,313788,0.7070243231977288,3,5,124136,18094,106042,0.8542405104079397,16.408837333333334,1978.80552,15.166772476828436,121,7.100000000000012E-4
10,test_20231101_134528,11551286.png,271883,527,271356,0.9980616662314304,1,4,40092,76,40016,0.9981043599720643,17.926654222222222,1858.3108106666666,15.43962007470492,121,7.100000000000012E-4
1,test_20231101_134529,10404007.png,502730,25407,477323,0.9494619378195055,2,4,61265,3666,57599,0.9401615930792458,25.18988977777778,3290.26648,12.958492878094653,121,7.200000000000012E-4
2,test_20231101_134529,1254659.png,342646,82262,260384,0.7599213182117988,4,4,80080,11409,68671,0.85752997002997,20.156343111111113,2970.0569866666665,13.403155786357337,121,7.200000000000012E-4
3,test_20231101_134529,10188041.png,221231,10567,210664,0.95223544620781,2,3,41731,1482,40249,0.9644868323308811,10.533299555555555,996.9537226666666,18.14405361490014,121,7.200000000000012E-4
4,test_20231101_134529,10287332.png,216980,13429,203551,0.9381095031800166,2,4,22337,1833,20504,0.9179388458611273,9.370778666666666,756.6213706666666,19.342017571499717,121,7.200000000000012E-4
5,test_20231101_134529,11610969.png,368720,30069,338651,0.9184503146018659,2,4,84111,4382,79729,0.9479021768853063,20.036851555555554,2651.808336,13.895382293801273,121,7.200000000000012E-4
6,test_20231101_134529,10350842.png,212614,6967,205647,0.9672316968779102,2,4,42529,1022,41507,0.9759693385689765,18.40685866666667,2182.083690666667,14.742089575588938,121,7.200000000000012E-4
7,test_20231101_134529,10863862.png,317432,14697,302735,0.9537003200685501,2,4,66058,2105,63953,0.9681340640043599,23.275838222222223,3117.6927946666665,13.192470415975402,121,7.200000000000012E-4
8,test_20231101_134529,11382381.png,312486,827,311659,0.9973534814359684,1,3,46745,109,46636,0.997668199807466,21.564144,2476.360432,14.192665047538828,121,7.200000000000012E-4
9,test_20231101_134529,11079715.png,443815,130027,313788,0.7070243231977288,3,5,124136,18094,106042,0.8542405104079397,16.408837333333334,1978.80552,15.166772476828436,121,7.200000000000012E-4
10,test_20231101_134529,11551286.png,271883,527,271356,0.9980616662314304,1,4,40092,76,40016,0.9981043599720643,17.926654222222222,1858.3108106666666,15.43962007470492,121,7.200000000000012E-4
1,test_20231101_134529,10404007.png,502730,25407,477323,0.9494619378195055,2,3,61265,3666,57599,0.9401615930792458,25.18988977777778,3290.26648,12.958492878094653,121,7.300000000000013E-4
2,test_20231101_134529,1254659.png,342646,82262,260384,0.7599213182117988,3,4,80080,11409,68671,0.85752997002997,20.156343111111113,2970.0569866666665,13.403155786357337,121,7.300000000000013E-4
3,test_20231101_134529,10188041.png,221231,10567,210664,0.95223544620781,2,4,41731,1482,40249,0.9644868323308811,10.533299555555555,996.9537226666666,18.14405361490014,121,7.300000000000013E-4
4,test_20231101_134529,10287332.png,216980,13429,203551,0.9381095031800166,2,4,22337,1833,20504,0.9179388458611273,9.370778666666666,756.6213706666666,19.342017571499717,121,7.300000000000013E-4
5,test_20231101_134529,11610969.png,368720,30069,338651,0.9184503146018659,2,4,84111,4382,79729,0.9479021768853063,20.036851555555554,2651.808336,13.895382293801273,121,7.300000000000013E-4
6,test_20231101_134529,10350842.png,212614,6967,205647,0.9672316968779102,2,3,42529,1022,41507,0.9759693385689765,18.40685866666667,2182.083690666667,14.742089575588938,121,7.300000000000013E-4
7,test_20231101_134529,10863862.png,317432,14697,302735,0.9537003200685501,2,4,66058,2105,63953,0.9681340640043599,23.275838222222223,3117.6927946666665,13.192470415975402,121,7.300000000000013E-4
8,test_20231101_134529,11382381.png,312486,827,311659,0.9973534814359684,2,4,46745,109,46636,0.997668199807466,21.564144,2476.360432,14.192665047538828,121,7.300000000000013E-4
9,test_20231101_134529,11079715.png,443815,130027,313788,0.7070243231977288,4,4,124136,18094,106042,0.8542405104079397,16.408837333333334,1978.80552,15.166772476828436,121,7.300000000000013E-4
10,test_20231101_134529,11551286.png,271883,527,271356,0.9980616662314304,1,4,40092,76,40016,0.9981043599720643,17.926654222222222,1858.3108106666666,15.43962007470492,121,7.300000000000013E-4
1,test_20231101_134530,10404007.png,502730,25407,477323,0.9494619378195055,2,3,61265,3666,57599,0.9401615930792458,25.18988977777778,3290.26648,12.958492878094653,121,7.400000000000013E-4
2,test_20231101_134530,1254659.png,342646,82262,260384,0.7599213182117988,3,4,80080,11409,68671,0.85752997002997,20.156343111111113,2970.0569866666665,13.403155786357337,121,7.400000000000013E-4
3,test_20231101_134530,10188041.png,221231,10567,210664,0.95223544620781,2,3,41731,1482,40249,0.9644868323308811,10.533299555555555,996.9537226666666,18.14405361490014,121,7.400000000000013E-4
4,test_20231101_134530,10287332.png,216980,13429,203551,0.9381095031800166,2,4,22337,1833,20504,0.9179388458611273,9.370778666666666,756.6213706666666,19.342017571499717,121,7.400000000000013E-4
5,test_20231101_134530,11610969.png,368720,30069,338651,0.9184503146018659,2,3,84111,4382,79729,0.9479021768853063,20.036851555555554,2651.808336,13.895382293801273,121,7.400000000000013E-4
6,test_20231101_134530,10350842.png,212614,6967,205647,0.9672316968779102,2,3,42529,1022,41507,0.9759693385689765,18.40685866666667,2182.083690666667,14.742089575588938,121,7.400000000000013E-4
7,test_20231101_134530,10863862.png,317432,14697,302735,0.9537003200685501,2,4,66058,2105,63953,0.9681340640043599,23.275838222222223,3117.6927946666665,13.192470415975402,121,7.400000000000013E-4
8,test_20231101_134530,11382381.png,312486,827,311659,0.9973534814359684,2,4,46745,109,46636,0.997668199807466,21.564144,2476.360432,14.192665047538828,121,7.400000000000013E-4
9,test_20231101_134530,11079715.png,443815,130027,313788,0.7070243231977288,3,4,124136,18094,106042,0.8542405104079397,16.408837333333334,1978.80552,15.166772476828436,121,7.400000000000013E-4
10,test_20231101_134530,11551286.png,271883,527,271356,0.9980616662314304,1,4,40092,76,40016,0.9981043599720643,17.926654222222222,1858.3108106666666,15.43962007470492,121,7.400000000000013E-4
1,test_20231101_134531,10404007.png,502730,25407,477323,0.9494619378195055,3,4,61265,3666,57599,0.9401615930792458,25.18988977777778,3290.26648,12.958492878094653,121,7.500000000000013E-4
2,test_20231101_134531,1254659.png,342646,82262,260384,0.7599213182117988,3,4,80080,11409,68671,0.85752997002997,20.156343111111113,2970.0569866666665,13.403155786357337,121,7.500000000000013E-4
3,test_20231101_134531,10188041.png,221231,10567,210664,0.95223544620781,2,5,41731,1482,40249,0.9644868323308811,10.533299555555555,996.9537226666666,18.14405361490014,121,7.500000000000013E-4
4,test_20231101_134531,10287332.png,216980,13429,203551,0.9381095031800166,1,4,22337,1833,20504,0.9179388458611273,9.370778666666666,756.6213706666666,19.342017571499717,121,7.500000000000013E-4
5,test_20231101_134531,11610969.png,368720,30069,338651,0.9184503146018659,2,4,84111,4382,79729,0.9479021768853063,20.036851555555554,2651.808336,13.895382293801273,121,7.500000000000013E-4
6,test_20231101_134531,10350842.png,212614,6967,205647,0.9672316968779102,2,3,42529,1022,41507,0.9759693385689765,18.40685866666667,2182.083690666667,14.742089575588938,121,7.500000000000013E-4
7,test_20231101_134531,10863862.png,317432,14697,302735,0.9537003200685501,2,4,66058,2105,63953,0.9681340640043599,23.275838222222223,3117.6927946666665,13.192470415975402,121,7.500000000000013E-4
8,test_20231101_134531,11382381.png,312486,827,311659,0.9973534814359684,2,3,46745,109,46636,0.997668199807466,21.564144,2476.360432,14.192665047538828,121,7.500000000000013E-4
9,test_20231101_134531,11079715.png,443815,130027,313788,0.7070243231977288,4,4,124136,18094,106042,0.8542405104079397,16.408837333333334,1978.80552,15.166772476828436,121,7.500000000000013E-4
10,test_20231101_134531,11551286.png,271883,527,271356,0.9980616662314304,1,4,40092,76,40016,0.9981043599720643,17.926654222222222,1858.3108106666666,15.43962007470492,121,7.500000000000013E-4
1,test_20231101_134531,10404007.png,502730,25107,477623,0.950058679609333,3,4,61265,3624,57641,0.9408471394760467,25.206074666666666,3294.1665333333335,12.953348101508894,121,7.600000000000013E-4
2,test_20231101_134531,1254659.png,342646,82262,260384,0.7599213182117988,2,4,80080,11409,68671,0.85752997002997,20.156343111111113,2970.0569866666665,13.403155786357337,121,7.600000000000013E-4
3,test_20231101_134531,10188041.png,221231,10484,210747,0.9526106196690337,2,3,41731,1472,40259,0.9647264623421438,10.660069333333333,1007.872112,18.09674932504763,121,7.600000000000013E-4
4,test_20231101_134531,10287332.png,216980,13429,203551,0.9381095031800166,2,4,22337,1833,20504,0.9179388458611273,9.370778666666666,756.6213706666666,19.342017571499717,121,7.600000000000013E-4
5,test_20231101_134531,11610969.png,368720,30069,338651,0.9184503146018659,2,3,84111,4382,79729,0.9479021768853063,20.036851555555554,2651.808336,13.895382293801273,121,7.600000000000013E-4
6,test_20231101_134531,10350842.png,212614,6847,205767,0.9677960999746018,2,4,42529,1004,41525,0.9763925791812645,18.767114666666668,2248.3353386666668,14.612192742239138,121,7.600000000000013E-4
7,test_20231101_134531,10863862.png,317432,14634,302798,0.9538987877718692,2,3,66058,2096,63962,0.9682703079112295,23.317687111111113,3119.559728,13.189870556931647,121,7.600000000000013E-4
8,test_20231101_134531,11382381.png,312486,827,311659,0.9973534814359684,1,3,46745,109,46636,0.997668199807466,21.564144,2476.360432,14.192665047538828,121,7.600000000000013E-4
9,test_20231101_134531,11079715.png,443815,130027,313788,0.7070243231977288,4,4,124136,18094,106042,0.8542405104079397,16.408837333333334,1978.80552,15.166772476828436,121,7.600000000000013E-4
10,test_20231101_134531,11551286.png,271883,527,271356,0.9980616662314304,1,3,40092,76,40016,0.9981043599720643,17.926654222222222,1858.3108106666666,15.43962007470492,121,7.600000000000013E-4
1,test_20231101_134532,10404007.png,502730,25107,477623,0.950058679609333,2,3,61265,3624,57641,0.9408471394760467,25.206074666666666,3294.1665333333335,12.953348101508894,121,7.700000000000014E-4
2,test_20231101_134532,1254659.png,342646,82262,260384,0.7599213182117988,3,4,80080,11409,68671,0.85752997002997,20.156343111111113,2970.0569866666665,13.403155786357337,121,7.700000000000014E-4
3,test_20231101_134532,10188041.png,221231,10484,210747,0.9526106196690337,2,3,41731,1472,40259,0.9647264623421438,10.660069333333333,1007.872112,18.09674932504763,121,7.700000000000014E-4
4,test_20231101_134532,10287332.png,216980,13429,203551,0.9381095031800166,2,3,22337,1833,20504,0.9179388458611273,9.370778666666666,756.6213706666666,19.342017571499717,121,7.700000000000014E-4
5,test_20231101_134532,11610969.png,368720,30069,338651,0.9184503146018659,2,3,84111,4382,79729,0.9479021768853063,20.036851555555554,2651.808336,13.895382293801273,121,7.700000000000014E-4
6,test_20231101_134532,10350842.png,212614,6847,205767,0.9677960999746018,2,4,42529,1004,41525,0.9763925791812645,18.767114666666668,2248.3353386666668,14.612192742239138,121,7.700000000000014E-4
7,test_20231101_134532,10863862.png,317432,14634,302798,0.9538987877718692,2,4,66058,2096,63962,0.9682703079112295,23.317687111111113,3119.559728,13.189870556931647,121,7.700000000000014E-4
8,test_20231101_134532,11382381.png,312486,827,311659,0.9973534814359684,1,3,46745,109,46636,0.997668199807466,21.564144,2476.360432,14.192665047538828,121,7.700000000000014E-4
9,test_20231101_134532,11079715.png,443815,130027,313788,0.7070243231977288,4,4,124136,18094,106042,0.8542405104079397,16.408837333333334,1978.80552,15.166772476828436,121,7.700000000000014E-4
10,test_20231101_134532,11551286.png,271883,527,271356,0.9980616662314304,1,4,40092,76,40016,0.9981043599720643,17.926654222222222,1858.3108106666666,15.43962007470492,121,7.700000000000014E-4
1,test_20231101_134533,10404007.png,502730,25107,477623,0.950058679609333,2,4,61265,3624,57641,0.9408471394760467,25.206074666666666,3294.1665333333335,12.953348101508894,121,7.800000000000014E-4
2,test_20231101_134533,1254659.png,342646,82262,260384,0.7599213182117988,3,4,80080,11409,68671,0.85752997002997,20.156343111111113,2970.0569866666665,13.403155786357337,121,7.800000000000014E-4
3,test_20231101_134533,10188041.png,221231,10484,210747,0.9526106196690337,2,4,41731,1472,40259,0.9647264623421438,10.660069333333333,1007.872112,18.09674932504763,121,7.800000000000014E-4
4,test_20231101_134533,10287332.png,216980,13429,203551,0.9381095031800166,2,4,22337,1833,20504,0.9179388458611273,9.370778666666666,756.6213706666666,19.342017571499717,121,7.800000000000014E-4
5,test_20231101_134533,11610969.png,368720,30069,338651,0.9184503146018659,2,3,84111,4382,79729,0.9479021768853063,20.036851555555554,2651.808336,13.895382293801273,121,7.800000000000014E-4
6,test_20231101_134533,10350842.png,212614,6847,205767,0.9677960999746018,1,3,42529,1004,41525,0.9763925791812645,18.767114666666668,2248.3353386666668,14.612192742239138,121,7.800000000000014E-4
7,test_20231101_134533,10863862.png,317432,14634,302798,0.9538987877718692,2,4,66058,2096,63962,0.9682703079112295,23.317687111111113,3119.559728,13.189870556931647,121,7.800000000000014E-4
8,test_20231101_134533,11382381.png,312486,827,311659,0.9973534814359684,1,4,46745,109,46636,0.997668199807466,21.564144,2476.360432,14.192665047538828,121,7.800000000000014E-4
9,test_20231101_134533,11079715.png,443815,130027,313788,0.7070243231977288,4,5,124136,18094,106042,0.8542405104079397,16.408837333333334,1978.80552,15.166772476828436,121,7.800000000000014E-4
10,test_20231101_134533,11551286.png,271883,527,271356,0.9980616662314304,1,3,40092,76,40016,0.9981043599720643,17.926654222222222,1858.3108106666666,15.43962007470492,121,7.800000000000014E-4
1,test_20231101_134533,10404007.png,502730,25107,477623,0.950058679609333,2,4,61265,3624,57641,0.9408471394760467,25.206074666666666,3294.1665333333335,12.953348101508894,121,7.900000000000014E-4
2,test_20231101_134533,1254659.png,342646,82262,260384,0.7599213182117988,3,4,80080,11409,68671,0.85752997002997,20.156343111111113,2970.0569866666665,13.403155786357337,121,7.900000000000014E-4
3,test_20231101_134533,10188041.png,221231,10484,210747,0.9526106196690337,1,3,41731,1472,40259,0.9647264623421438,10.660069333333333,1007.872112,18.09674932504763,121,7.900000000000014E-4
4,test_20231101_134533,10287332.png,216980,13429,203551,0.9381095031800166,2,4,22337,1833,20504,0.9179388458611273,9.370778666666666,756.6213706666666,19.342017571499717,121,7.900000000000014E-4
5,test_20231101_134533,11610969.png,368720,30069,338651,0.9184503146018659,3,4,84111,4382,79729,0.9479021768853063,20.036851555555554,2651.808336,13.895382293801273,121,7.900000000000014E-4
6,test_20231101_134533,10350842.png,212614,6847,205767,0.9677960999746018,1,4,42529,1004,41525,0.9763925791812645,18.767114666666668,2248.3353386666668,14.612192742239138,121,7.900000000000014E-4
7,test_20231101_134533,10863862.png,317432,14634,302798,0.9538987877718692,2,4,66058,2096,63962,0.9682703079112295,23.317687111111113,3119.559728,13.189870556931647,121,7.900000000000014E-4
8,test_20231101_134533,11382381.png,312486,827,311659,0.9973534814359684,2,3,46745,109,46636,0.997668199807466,21.564144,2476.360432,14.192665047538828,121,7.900000000000014E-4
9,test_20231101_134533,11079715.png,443815,130027,313788,0.7070243231977288,3,4,124136,18094,106042,0.8542405104079397,16.408837333333334,1978.80552,15.166772476828436,121,7.900000000000014E-4
10,test_20231101_134533,11551286.png,271883,527,271356,0.9980616662314304,1,3,40092,76,40016,0.9981043599720643,17.926654222222222,1858.3108106666666,15.43962007470492,121,7.900000000000014E-4
1,test_20231101_134534,10404007.png,502730,25107,477623,0.950058679609333,2,4,61265,3624,57641,0.9408471394760467,25.206074666666666,3294.1665333333335,12.953348101508894,121,8.000000000000014E-4
2,test_20231101_134534,1254659.png,342646,82262,260384,0.7599213182117988,3,4,80080,11409,68671,0.85752997002997,20.156343111111113,2970.0569866666665,13.403155786357337,121,8.000000000000014E-4
3,test_20231101_134534,10188041.png,221231,10484,210747,0.9526106196690337,2,4,41731,1472,40259,0.9647264623421438,10.660069333333333,1007.872112,18.09674932504763,121,8.000000000000014E-4
4,test_20231101_134534,10287332.png,216980,13429,203551,0.9381095031800166,1,3,22337,1833,20504,0.9179388458611273,9.370778666666666,756.6213706666666,19.342017571499717,121,8.000000000000014E-4
5,test_20231101_134534,11610969.png,368720,30069,338651,0.9184503146018659,2,4,84111,4382,79729,0.9479021768853063,20.036851555555554,2651.808336,13.895382293801273,121,8.000000000000014E-4
6,test_20231101_134534,10350842.png,212614,6847,205767,0.9677960999746018,2,3,42529,1004,41525,0.9763925791812645,18.767114666666668,2248.3353386666668,14.612192742239138,121,8.000000000000014E-4
7,test_20231101_134534,10863862.png,317432,14634,302798,0.9538987877718692,2,3,66058,2096,63962,0.9682703079112295,23.317687111111113,3119.559728,13.189870556931647,121,8.000000000000014E-4
8,test_20231101_134534,11382381.png,312486,827,311659,0.9973534814359684,1,3,46745,109,46636,0.997668199807466,21.564144,2476.360432,14.192665047538828,121,8.000000000000014E-4
9,test_20231101_134534,11079715.png,443815,130027,313788,0.7070243231977288,5,4,124136,18094,106042,0.8542405104079397,16.408837333333334,1978.80552,15.166772476828436,121,8.000000000000014E-4
10,test_20231101_134534,11551286.png,271883,527,271356,0.9980616662314304,1,4,40092,76,40016,0.9981043599720643,17.926654222222222,1858.3108106666666,15.43962007470492,121,8.000000000000014E-4
1,test_20231101_134535,10404007.png,502730,25107,477623,0.950058679609333,3,4,61265,3624,57641,0.9408471394760467,25.206074666666666,3294.1665333333335,12.953348101508894,121,8.100000000000015E-4
2,test_20231101_134535,1254659.png,342646,82262,260384,0.7599213182117988,3,4,80080,11409,68671,0.85752997002997,20.156343111111113,2970.0569866666665,13.403155786357337,121,8.100000000000015E-4
3,test_20231101_134535,10188041.png,221231,10484,210747,0.9526106196690337,2,3,41731,1472,40259,0.9647264623421438,10.660069333333333,1007.872112,18.09674932504763,121,8.100000000000015E-4
4,test_20231101_134535,10287332.png,216980,13429,203551,0.9381095031800166,2,4,22337,1833,20504,0.9179388458611273,9.370778666666666,756.6213706666666,19.342017571499717,121,8.100000000000015E-4
5,test_20231101_134535,11610969.png,368720,30069,338651,0.9184503146018659,2,4,84111,4382,79729,0.9479021768853063,20.036851555555554,2651.808336,13.895382293801273,121,8.100000000000015E-4
6,test_20231101_134535,10350842.png,212614,6847,205767,0.9677960999746018,1,4,42529,1004,41525,0.9763925791812645,18.767114666666668,2248.3353386666668,14.612192742239138,121,8.100000000000015E-4
7,test_20231101_134535,10863862.png,317432,14634,302798,0.9538987877718692,2,4,66058,2096,63962,0.9682703079112295,23.317687111111113,3119.559728,13.189870556931647,121,8.100000000000015E-4
8,test_20231101_134535,11382381.png,312486,827,311659,0.9973534814359684,1,4,46745,109,46636,0.997668199807466,21.564144,2476.360432,14.192665047538828,121,8.100000000000015E-4
9,test_20231101_134535,11079715.png,443815,130027,313788,0.7070243231977288,4,4,124136,18094,106042,0.8542405104079397,16.408837333333334,1978.80552,15.166772476828436,121,8.100000000000015E-4
10,test_20231101_134535,11551286.png,271883,527,271356,0.9980616662314304,2,3,40092,76,40016,0.9981043599720643,17.926654222222222,1858.3108106666666,15.43962007470492,121,8.100000000000015E-4
1,test_20231101_134536,10404007.png,502730,25107,477623,0.950058679609333,2,4,61265,3624,57641,0.9408471394760467,25.206074666666666,3294.1665333333335,12.953348101508894,121,8.200000000000015E-4
2,test_20231101_134536,1254659.png,342646,82262,260384,0.7599213182117988,3,4,80080,11409,68671,0.85752997002997,20.156343111111113,2970.0569866666665,13.403155786357337,121,8.200000000000015E-4
3,test_20231101_134536,10188041.png,221231,10484,210747,0.9526106196690337,2,4,41731,1472,40259,0.9647264623421438,10.660069333333333,1007.872112,18.09674932504763,121,8.200000000000015E-4
4,test_20231101_134536,10287332.png,216980,13429,203551,0.9381095031800166,2,4,22337,1833,20504,0.9179388458611273,9.370778666666666,756.6213706666666,19.342017571499717,121,8.200000000000015E-4
5,test_20231101_134536,11610969.png,368720,30069,338651,0.9184503146018659,3,4,84111,4382,79729,0.9479021768853063,20.036851555555554,2651.808336,13.895382293801273,121,8.200000000000015E-4
6,test_20231101_134536,10350842.png,212614,6847,205767,0.9677960999746018,1,3,42529,1004,41525,0.9763925791812645,18.767114666666668,2248.3353386666668,14.612192742239138,121,8.200000000000015E-4
7,test_20231101_134536,10863862.png,317432,14634,302798,0.9538987877718692,2,3,66058,2096,63962,0.9682703079112295,23.317687111111113,3119.559728,13.189870556931647,121,8.200000000000015E-4
8,test_20231101_134536,11382381.png,312486,827,311659,0.9973534814359684,1,4,46745,109,46636,0.997668199807466,21.564144,2476.360432,14.192665047538828,121,8.200000000000015E-4
9,test_20231101_134536,11079715.png,443815,130027,313788,0.7070243231977288,4,4,124136,18094,106042,0.8542405104079397,16.408837333333334,1978.80552,15.166772476828436,121,8.200000000000015E-4
10,test_20231101_134536,11551286.png,271883,527,271356,0.9980616662314304,2,4,40092,76,40016,0.9981043599720643,17.926654222222222,1858.3108106666666,15.43962007470492,121,8.200000000000015E-4
1,test_20231101_134536,10404007.png,502730,25107,477623,0.950058679609333,3,4,61265,3624,57641,0.9408471394760467,25.206074666666666,3294.1665333333335,12.953348101508894,121,8.300000000000015E-4
2,test_20231101_134536,1254659.png,342646,82262,260384,0.7599213182117988,3,4,80080,11409,68671,0.85752997002997,20.156343111111113,2970.0569866666665,13.403155786357337,121,8.300000000000015E-4
3,test_20231101_134536,10188041.png,221231,10484,210747,0.9526106196690337,2,3,41731,1472,40259,0.9647264623421438,10.660069333333333,1007.872112,18.09674932504763,121,8.300000000000015E-4
4,test_20231101_134536,10287332.png,216980,13429,203551,0.9381095031800166,2,3,22337,1833,20504,0.9179388458611273,9.370778666666666,756.6213706666666,19.342017571499717,121,8.300000000000015E-4
5,test_20231101_134536,11610969.png,368720,30069,338651,0.9184503146018659,2,3,84111,4382,79729,0.9479021768853063,20.036851555555554,2651.808336,13.895382293801273,121,8.300000000000015E-4
6,test_20231101_134536,10350842.png,212614,6847,205767,0.9677960999746018,1,3,42529,1004,41525,0.9763925791812645,18.767114666666668,2248.3353386666668,14.612192742239138,121,8.300000000000015E-4
7,test_20231101_134536,10863862.png,317432,14634,302798,0.9538987877718692,2,3,66058,2096,63962,0.9682703079112295,23.317687111111113,3119.559728,13.189870556931647,121,8.300000000000015E-4
8,test_20231101_134536,11382381.png,312486,827,311659,0.9973534814359684,2,3,46745,109,46636,0.997668199807466,21.564144,2476.360432,14.192665047538828,121,8.300000000000015E-4
9,test_20231101_134536,11079715.png,443815,130027,313788,0.7070243231977288,3,4,124136,18094,106042,0.8542405104079397,16.408837333333334,1978.80552,15.166772476828436,121,8.300000000000015E-4
10,test_20231101_134536,11551286.png,271883,527,271356,0.9980616662314304,1,3,40092,76,40016,0.9981043599720643,17.926654222222222,1858.3108106666666,15.43962007470492,121,8.300000000000015E-4
1,test_20231101_134537,10404007.png,502730,25107,477623,0.950058679609333,2,4,61265,3624,57641,0.9408471394760467,25.206074666666666,3294.1665333333335,12.953348101508894,121,8.400000000000016E-4
2,test_20231101_134537,1254659.png,342646,82262,260384,0.7599213182117988,3,4,80080,11409,68671,0.85752997002997,20.156343111111113,2970.0569866666665,13.403155786357337,121,8.400000000000016E-4
3,test_20231101_134537,10188041.png,221231,10484,210747,0.9526106196690337,2,3,41731,1472,40259,0.9647264623421438,10.660069333333333,1007.872112,18.09674932504763,121,8.400000000000016E-4
4,test_20231101_134537,10287332.png,216980,13429,203551,0.9381095031800166,2,4,22337,1833,20504,0.9179388458611273,9.370778666666666,756.6213706666666,19.342017571499717,121,8.400000000000016E-4
5,test_20231101_134537,11610969.png,368720,30069,338651,0.9184503146018659,2,4,84111,4382,79729,0.9479021768853063,20.036851555555554,2651.808336,13.895382293801273,121,8.400000000000016E-4
6,test_20231101_134537,10350842.png,212614,6847,205767,0.9677960999746018,1,4,42529,1004,41525,0.9763925791812645,18.767114666666668,2248.3353386666668,14.612192742239138,121,8.400000000000016E-4
7,test_20231101_134537,10863862.png,317432,14634,302798,0.9538987877718692,2,4,66058,2096,63962,0.9682703079112295,23.317687111111113,3119.559728,13.189870556931647,121,8.400000000000016E-4
8,test_20231101_134537,11382381.png,312486,827,311659,0.9973534814359684,1,4,46745,109,46636,0.997668199807466,21.564144,2476.360432,14.192665047538828,121,8.400000000000016E-4
9,test_20231101_134537,11079715.png,443815,130027,313788,0.7070243231977288,3,5,124136,18094,106042,0.8542405104079397,16.408837333333334,1978.80552,15.166772476828436,121,8.400000000000016E-4
10,test_20231101_134537,11551286.png,271883,527,271356,0.9980616662314304,2,3,40092,76,40016,0.9981043599720643,17.926654222222222,1858.3108106666666,15.43962007470492,121,8.400000000000016E-4
1,test_20231101_134538,10404007.png,502730,25107,477623,0.950058679609333,2,4,61265,3624,57641,0.9408471394760467,25.206074666666666,3294.1665333333335,12.953348101508894,121,8.500000000000016E-4
2,test_20231101_134538,1254659.png,342646,82262,260384,0.7599213182117988,3,4,80080,11409,68671,0.85752997002997,20.156343111111113,2970.0569866666665,13.403155786357337,121,8.500000000000016E-4
3,test_20231101_134538,10188041.png,221231,10484,210747,0.9526106196690337,3,3,41731,1472,40259,0.9647264623421438,10.660069333333333,1007.872112,18.09674932504763,121,8.500000000000016E-4
4,test_20231101_134538,10287332.png,216980,13429,203551,0.9381095031800166,1,3,22337,1833,20504,0.9179388458611273,9.370778666666666,756.6213706666666,19.342017571499717,121,8.500000000000016E-4
5,test_20231101_134538,11610969.png,368720,30069,338651,0.9184503146018659,3,4,84111,4382,79729,0.9479021768853063,20.036851555555554,2651.808336,13.895382293801273,121,8.500000000000016E-4
6,test_20231101_134538,10350842.png,212614,6847,205767,0.9677960999746018,1,3,42529,1004,41525,0.9763925791812645,18.767114666666668,2248.3353386666668,14.612192742239138,121,8.500000000000016E-4
7,test_20231101_134538,10863862.png,317432,14634,302798,0.9538987877718692,2,3,66058,2096,63962,0.9682703079112295,23.317687111111113,3119.559728,13.189870556931647,121,8.500000000000016E-4
8,test_20231101_134538,11382381.png,312486,827,311659,0.9973534814359684,2,3,46745,109,46636,0.997668199807466,21.564144,2476.360432,14.192665047538828,121,8.500000000000016E-4
9,test_20231101_134538,11079715.png,443815,130027,313788,0.7070243231977288,3,4,124136,18094,106042,0.8542405104079397,16.408837333333334,1978.80552,15.166772476828436,121,8.500000000000016E-4
10,test_20231101_134538,11551286.png,271883,527,271356,0.9980616662314304,1,4,40092,76,40016,0.9981043599720643,17.926654222222222,1858.3108106666666,15.43962007470492,121,8.500000000000016E-4
1,test_20231101_134538,10404007.png,502730,25107,477623,0.950058679609333,3,4,61265,3624,57641,0.9408471394760467,25.206074666666666,3294.1665333333335,12.953348101508894,121,8.600000000000016E-4
2,test_20231101_134538,1254659.png,342646,82262,260384,0.7599213182117988,3,4,80080,11409,68671,0.85752997002997,20.156343111111113,2970.0569866666665,13.403155786357337,121,8.600000000000016E-4
3,test_20231101_134538,10188041.png,221231,10484,210747,0.9526106196690337,2,4,41731,1472,40259,0.9647264623421438,10.660069333333333,1007.872112,18.09674932504763,121,8.600000000000016E-4
4,test_20231101_134538,10287332.png,216980,13429,203551,0.9381095031800166,2,4,22337,1833,20504,0.9179388458611273,9.370778666666666,756.6213706666666,19.342017571499717,121,8.600000000000016E-4
5,test_20231101_134538,11610969.png,368720,30069,338651,0.9184503146018659,3,3,84111,4382,79729,0.9479021768853063,20.036851555555554,2651.808336,13.895382293801273,121,8.600000000000016E-4
6,test_20231101_134538,10350842.png,212614,6847,205767,0.9677960999746018,2,4,42529,1004,41525,0.9763925791812645,18.767114666666668,2248.3353386666668,14.612192742239138,121,8.600000000000016E-4
7,test_20231101_134538,10863862.png,317432,14634,302798,0.9538987877718692,2,4,66058,2096,63962,0.9682703079112295,23.317687111111113,3119.559728,13.189870556931647,121,8.600000000000016E-4
8,test_20231101_134538,11382381.png,312486,827,311659,0.9973534814359684,1,3,46745,109,46636,0.997668199807466,21.564144,2476.360432,14.192665047538828,121,8.600000000000016E-4
9,test_20231101_134538,11079715.png,443815,130027,313788,0.7070243231977288,4,4,124136,18094,106042,0.8542405104079397,16.408837333333334,1978.80552,15.166772476828436,121,8.600000000000016E-4
10,test_20231101_134538,11551286.png,271883,527,271356,0.9980616662314304,1,4,40092,76,40016,0.9981043599720643,17.926654222222222,1858.3108106666666,15.43962007470492,121,8.600000000000016E-4
1,test_20231101_134539,10404007.png,502730,25107,477623,0.950058679609333,3,3,61265,3624,57641,0.9408471394760467,25.206074666666666,3294.1665333333335,12.953348101508894,121,8.700000000000016E-4
2,test_20231101_134539,1254659.png,342646,82262,260384,0.7599213182117988,3,4,80080,11409,68671,0.85752997002997,20.156343111111113,2970.0569866666665,13.403155786357337,121,8.700000000000016E-4
3,test_20231101_134539,10188041.png,221231,10484,210747,0.9526106196690337,1,3,41731,1472,40259,0.9647264623421438,10.660069333333333,1007.872112,18.09674932504763,121,8.700000000000016E-4
4,test_20231101_134539,10287332.png,216980,13429,203551,0.9381095031800166,2,3,22337,1833,20504,0.9179388458611273,9.370778666666666,756.6213706666666,19.342017571499717,121,8.700000000000016E-4
5,test_20231101_134539,11610969.png,368720,30069,338651,0.9184503146018659,2,4,84111,4382,79729,0.9479021768853063,20.036851555555554,2651.808336,13.895382293801273,121,8.700000000000016E-4
6,test_20231101_134539,10350842.png,212614,6847,205767,0.9677960999746018,2,4,42529,1004,41525,0.9763925791812645,18.767114666666668,2248.3353386666668,14.612192742239138,121,8.700000000000016E-4
7,test_20231101_134539,10863862.png,317432,14634,302798,0.9538987877718692,2,4,66058,2096,63962,0.9682703079112295,23.317687111111113,3119.559728,13.189870556931647,121,8.700000000000016E-4
8,test_20231101_134539,11382381.png,312486,827,311659,0.9973534814359684,2,3,46745,109,46636,0.997668199807466,21.564144,2476.360432,14.192665047538828,121,8.700000000000016E-4
9,test_20231101_134539,11079715.png,443815,130027,313788,0.7070243231977288,3,4,124136,18094,106042,0.8542405104079397,16.408837333333334,1978.80552,15.166772476828436,121,8.700000000000016E-4
10,test_20231101_134539,11551286.png,271883,527,271356,0.9980616662314304,2,3,40092,76,40016,0.9981043599720643,17.926654222222222,1858.3108106666666,15.43962007470492,121,8.700000000000016E-4
1,test_20231101_134540,10404007.png,502730,25107,477623,0.950058679609333,2,4,61265,3624,57641,0.9408471394760467,25.206074666666666,3294.1665333333335,12.953348101508894,121,8.800000000000017E-4
2,test_20231101_134540,1254659.png,342646,82262,260384,0.7599213182117988,3,4,80080,11409,68671,0.85752997002997,20.156343111111113,2970.0569866666665,13.403155786357337,121,8.800000000000017E-4
3,test_20231101_134540,10188041.png,221231,10484,210747,0.9526106196690337,3,4,41731,1472,40259,0.9647264623421438,10.660069333333333,1007.872112,18.09674932504763,121,8.800000000000017E-4
4,test_20231101_134540,10287332.png,216980,13429,203551,0.9381095031800166,1,3,22337,1833,20504,0.9179388458611273,9.370778666666666,756.6213706666666,19.342017571499717,121,8.800000000000017E-4
5,test_20231101_134540,11610969.png,368720,30069,338651,0.9184503146018659,3,4,84111,4382,79729,0.9479021768853063,20.036851555555554,2651.808336,13.895382293801273,121,8.800000000000017E-4
6,test_20231101_134540,10350842.png,212614,6847,205767,0.9677960999746018,1,3,42529,1004,41525,0.9763925791812645,18.767114666666668,2248.3353386666668,14.612192742239138,121,8.800000000000017E-4
7,test_20231101_134540,10863862.png,317432,14634,302798,0.9538987877718692,2,4,66058,2096,63962,0.9682703079112295,23.317687111111113,3119.559728,13.189870556931647,121,8.800000000000017E-4
8,test_20231101_134540,11382381.png,312486,827,311659,0.9973534814359684,2,3,46745,109,46636,0.997668199807466,21.564144,2476.360432,14.192665047538828,121,8.800000000000017E-4
9,test_20231101_134540,11079715.png,443815,130027,313788,0.7070243231977288,3,4,124136,18094,106042,0.8542405104079397,16.408837333333334,1978.80552,15.166772476828436,121,8.800000000000017E-4
10,test_20231101_134540,11551286.png,271883,527,271356,0.9980616662314304,1,3,40092,76,40016,0.9981043599720643,17.926654222222222,1858.3108106666666,15.43962007470492,121,8.800000000000017E-4
1,test_20231101_134540,10404007.png,502730,25107,477623,0.950058679609333,2,3,61265,3624,57641,0.9408471394760467,25.206074666666666,3294.1665333333335,12.953348101508894,121,8.900000000000017E-4
2,test_20231101_134540,1254659.png,342646,82262,260384,0.7599213182117988,3,4,80080,11409,68671,0.85752997002997,20.156343111111113,2970.0569866666665,13.403155786357337,121,8.900000000000017E-4
3,test_20231101_134540,10188041.png,221231,10484,210747,0.9526106196690337,2,4,41731,1472,40259,0.9647264623421438,10.660069333333333,1007.872112,18.09674932504763,121,8.900000000000017E-4
4,test_20231101_134540,10287332.png,216980,13429,203551,0.9381095031800166,1,3,22337,1833,20504,0.9179388458611273,9.370778666666666,756.6213706666666,19.342017571499717,121,8.900000000000017E-4
5,test_20231101_134540,11610969.png,368720,30069,338651,0.9184503146018659,3,3,84111,4382,79729,0.9479021768853063,20.036851555555554,2651.808336,13.895382293801273,121,8.900000000000017E-4
6,test_20231101_134540,10350842.png,212614,6847,205767,0.9677960999746018,1,4,42529,1004,41525,0.9763925791812645,18.767114666666668,2248.3353386666668,14.612192742239138,121,8.900000000000017E-4
7,test_20231101_134540,10863862.png,317432,14634,302798,0.9538987877718692,2,3,66058,2096,63962,0.9682703079112295,23.317687111111113,3119.559728,13.189870556931647,121,8.900000000000017E-4
8,test_20231101_134540,11382381.png,312486,827,311659,0.9973534814359684,2,4,46745,109,46636,0.997668199807466,21.564144,2476.360432,14.192665047538828,121,8.900000000000017E-4
9,test_20231101_134540,11079715.png,443815,130027,313788,0.7070243231977288,3,4,124136,18094,106042,0.8542405104079397,16.408837333333334,1978.80552,15.166772476828436,121,8.900000000000017E-4
10,test_20231101_134540,11551286.png,271883,527,271356,0.9980616662314304,1,3,40092,76,40016,0.9981043599720643,17.926654222222222,1858.3108106666666,15.43962007470492,121,8.900000000000017E-4
1,test_20231101_134541,10404007.png,502730,25107,477623,0.950058679609333,3,4,61265,3624,57641,0.9408471394760467,25.206074666666666,3294.1665333333335,12.953348101508894,121,9.000000000000017E-4
2,test_20231101_134541,1254659.png,342646,82262,260384,0.7599213182117988,3,4,80080,11409,68671,0.85752997002997,20.156343111111113,2970.0569866666665,13.403155786357337,121,9.000000000000017E-4
3,test_20231101_134541,10188041.png,221231,10484,210747,0.9526106196690337,2,4,41731,1472,40259,0.9647264623421438,10.660069333333333,1007.872112,18.09674932504763,121,9.000000000000017E-4
4,test_20231101_134541,10287332.png,216980,13429,203551,0.9381095031800166,2,4,22337,1833,20504,0.9179388458611273,9.370778666666666,756.6213706666666,19.342017571499717,121,9.000000000000017E-4
5,test_20231101_134541,11610969.png,368720,30069,338651,0.9184503146018659,3,4,84111,4382,79729,0.9479021768853063,20.036851555555554,2651.808336,13.895382293801273,121,9.000000000000017E-4
6,test_20231101_134541,10350842.png,212614,6847,205767,0.9677960999746018,2,3,42529,1004,41525,0.9763925791812645,18.767114666666668,2248.3353386666668,14.612192742239138,121,9.000000000000017E-4
7,test_20231101_134541,10863862.png,317432,14634,302798,0.9538987877718692,2,11,66058,2096,63962,0.9682703079112295,23.317687111111113,3119.559728,13.189870556931647,121,9.000000000000017E-4
8,test_20231101_134541,11382381.png,312486,827,311659,0.9973534814359684,2,3,46745,109,46636,0.997668199807466,21.564144,2476.360432,14.192665047538828,121,9.000000000000017E-4
9,test_20231101_134541,11079715.png,443815,130027,313788,0.7070243231977288,4,5,124136,18094,106042,0.8542405104079397,16.408837333333334,1978.80552,15.166772476828436,121,9.000000000000017E-4
10,test_20231101_134541,11551286.png,271883,527,271356,0.9980616662314304,2,3,40092,76,40016,0.9981043599720643,17.926654222222222,1858.3108106666666,15.43962007470492,121,9.000000000000017E-4
1,test_20231101_134542,10404007.png,502730,25107,477623,0.950058679609333,2,13,61265,3624,57641,0.9408471394760467,25.206074666666666,3294.1665333333335,12.953348101508894,121,9.100000000000017E-4
2,test_20231101_134542,1254659.png,342646,82262,260384,0.7599213182117988,3,4,80080,11409,68671,0.85752997002997,20.156343111111113,2970.0569866666665,13.403155786357337,121,9.100000000000017E-4
3,test_20231101_134542,10188041.png,221231,10484,210747,0.9526106196690337,2,4,41731,1472,40259,0.9647264623421438,10.660069333333333,1007.872112,18.09674932504763,121,9.100000000000017E-4
4,test_20231101_134542,10287332.png,216980,13429,203551,0.9381095031800166,1,4,22337,1833,20504,0.9179388458611273,9.370778666666666,756.6213706666666,19.342017571499717,121,9.100000000000017E-4
5,test_20231101_134542,11610969.png,368720,30069,338651,0.9184503146018659,2,3,84111,4382,79729,0.9479021768853063,20.036851555555554,2651.808336,13.895382293801273,121,9.100000000000017E-4
6,test_20231101_134542,10350842.png,212614,6847,205767,0.9677960999746018,1,3,42529,1004,41525,0.9763925791812645,18.767114666666668,2248.3353386666668,14.612192742239138,121,9.100000000000017E-4
7,test_20231101_134542,10863862.png,317432,14634,302798,0.9538987877718692,2,3,66058,2096,63962,0.9682703079112295,23.317687111111113,3119.559728,13.189870556931647,121,9.100000000000017E-4
8,test_20231101_134542,11382381.png,312486,827,311659,0.9973534814359684,2,3,46745,109,46636,0.997668199807466,21.564144,2476.360432,14.192665047538828,121,9.100000000000017E-4
9,test_20231101_134542,11079715.png,443815,130027,313788,0.7070243231977288,4,4,124136,18094,106042,0.8542405104079397,16.408837333333334,1978.80552,15.166772476828436,121,9.100000000000017E-4
10,test_20231101_134542,11551286.png,271883,527,271356,0.9980616662314304,2,3,40092,76,40016,0.9981043599720643,17.926654222222222,1858.3108106666666,15.43962007470492,121,9.100000000000017E-4
1,test_20231101_134542,10404007.png,502730,25107,477623,0.950058679609333,2,4,61265,3624,57641,0.9408471394760467,25.206074666666666,3294.1665333333335,12.953348101508894,121,9.200000000000018E-4
2,test_20231101_134542,1254659.png,342646,82262,260384,0.7599213182117988,3,4,80080,11409,68671,0.85752997002997,20.156343111111113,2970.0569866666665,13.403155786357337,121,9.200000000000018E-4
3,test_20231101_134542,10188041.png,221231,10484,210747,0.9526106196690337,2,3,41731,1472,40259,0.9647264623421438,10.660069333333333,1007.872112,18.09674932504763,121,9.200000000000018E-4
4,test_20231101_134542,10287332.png,216980,13429,203551,0.9381095031800166,2,4,22337,1833,20504,0.9179388458611273,9.370778666666666,756.6213706666666,19.342017571499717,121,9.200000000000018E-4
5,test_20231101_134542,11610969.png,368720,30069,338651,0.9184503146018659,2,3,84111,4382,79729,0.9479021768853063,20.036851555555554,2651.808336,13.895382293801273,121,9.200000000000018E-4
6,test_20231101_134542,10350842.png,212614,6847,205767,0.9677960999746018,2,3,42529,1004,41525,0.9763925791812645,18.767114666666668,2248.3353386666668,14.612192742239138,121,9.200000000000018E-4
7,test_20231101_134542,10863862.png,317432,14634,302798,0.9538987877718692,2,4,66058,2096,63962,0.9682703079112295,23.317687111111113,3119.559728,13.189870556931647,121,9.200000000000018E-4
8,test_20231101_134542,11382381.png,312486,827,311659,0.9973534814359684,2,4,46745,109,46636,0.997668199807466,21.564144,2476.360432,14.192665047538828,121,9.200000000000018E-4
9,test_20231101_134542,11079715.png,443815,130027,313788,0.7070243231977288,4,5,124136,18094,106042,0.8542405104079397,16.408837333333334,1978.80552,15.166772476828436,121,9.200000000000018E-4
10,test_20231101_134542,11551286.png,271883,527,271356,0.9980616662314304,2,3,40092,76,40016,0.9981043599720643,17.926654222222222,1858.3108106666666,15.43962007470492,121,9.200000000000018E-4
1,test_20231101_134543,10404007.png,502730,25107,477623,0.950058679609333,3,4,61265,3624,57641,0.9408471394760467,25.206074666666666,3294.1665333333335,12.953348101508894,121,9.300000000000018E-4
2,test_20231101_134543,1254659.png,342646,82262,260384,0.7599213182117988,3,11,80080,11409,68671,0.85752997002997,20.156343111111113,2970.0569866666665,13.403155786357337,121,9.300000000000018E-4
3,test_20231101_134543,10188041.png,221231,10484,210747,0.9526106196690337,2,4,41731,1472,40259,0.9647264623421438,10.660069333333333,1007.872112,18.09674932504763,121,9.300000000000018E-4
4,test_20231101_134543,10287332.png,216980,13429,203551,0.9381095031800166,2,3,22337,1833,20504,0.9179388458611273,9.370778666666666,756.6213706666666,19.342017571499717,121,9.300000000000018E-4
5,test_20231101_134543,11610969.png,368720,30069,338651,0.9184503146018659,2,4,84111,4382,79729,0.9479021768853063,20.036851555555554,2651.808336,13.895382293801273,121,9.300000000000018E-4
6,test_20231101_134543,10350842.png,212614,6847,205767,0.9677960999746018,2,4,42529,1004,41525,0.9763925791812645,18.767114666666668,2248.3353386666668,14.612192742239138,121,9.300000000000018E-4
7,test_20231101_134543,10863862.png,317432,14634,302798,0.9538987877718692,5,4,66058,2096,63962,0.9682703079112295,23.317687111111113,3119.559728,13.189870556931647,121,9.300000000000018E-4
8,test_20231101_134543,11382381.png,312486,827,311659,0.9973534814359684,2,4,46745,109,46636,0.997668199807466,21.564144,2476.360432,14.192665047538828,121,9.300000000000018E-4
9,test_20231101_134543,11079715.png,443815,130027,313788,0.7070243231977288,4,5,124136,18094,106042,0.8542405104079397,16.408837333333334,1978.80552,15.166772476828436,121,9.300000000000018E-4
10,test_20231101_134543,11551286.png,271883,527,271356,0.9980616662314304,1,3,40092,76,40016,0.9981043599720643,17.926654222222222,1858.3108106666666,15.43962007470492,121,9.300000000000018E-4
1,test_20231101_134544,10404007.png,502730,25107,477623,0.950058679609333,2,3,61265,3624,57641,0.9408471394760467,25.206074666666666,3294.1665333333335,12.953348101508894,121,9.400000000000018E-4
2,test_20231101_134544,1254659.png,342646,82262,260384,0.7599213182117988,4,5,80080,11409,68671,0.85752997002997,20.156343111111113,2970.0569866666665,13.403155786357337,121,9.400000000000018E-4
3,test_20231101_134544,10188041.png,221231,10484,210747,0.9526106196690337,2,4,41731,1472,40259,0.9647264623421438,10.660069333333333,1007.872112,18.09674932504763,121,9.400000000000018E-4
4,test_20231101_134544,10287332.png,216980,13429,203551,0.9381095031800166,2,4,22337,1833,20504,0.9179388458611273,9.370778666666666,756.6213706666666,19.342017571499717,121,9.400000000000018E-4
5,test_20231101_134544,11610969.png,368720,30069,338651,0.9184503146018659,3,3,84111,4382,79729,0.9479021768853063,20.036851555555554,2651.808336,13.895382293801273,121,9.400000000000018E-4
6,test_20231101_134544,10350842.png,212614,6847,205767,0.9677960999746018,2,4,42529,1004,41525,0.9763925791812645,18.767114666666668,2248.3353386666668,14.612192742239138,121,9.400000000000018E-4
7,test_20231101_134544,10863862.png,317432,14634,302798,0.9538987877718692,2,4,66058,2096,63962,0.9682703079112295,23.317687111111113,3119.559728,13.189870556931647,121,9.400000000000018E-4
8,test_20231101_134544,11382381.png,312486,827,311659,0.9973534814359684,1,3,46745,109,46636,0.997668199807466,21.564144,2476.360432,14.192665047538828,121,9.400000000000018E-4
9,test_20231101_134544,11079715.png,443815,130027,313788,0.7070243231977288,3,5,124136,18094,106042,0.8542405104079397,16.408837333333334,1978.80552,15.166772476828436,121,9.400000000000018E-4
10,test_20231101_134544,11551286.png,271883,527,271356,0.9980616662314304,1,3,40092,76,40016,0.9981043599720643,17.926654222222222,1858.3108106666666,15.43962007470492,121,9.400000000000018E-4
1,test_20231101_134545,10404007.png,502730,25107,477623,0.950058679609333,2,3,61265,3624,57641,0.9408471394760467,25.206074666666666,3294.1665333333335,12.953348101508894,121,9.500000000000018E-4
2,test_20231101_134545,1254659.png,342646,82262,260384,0.7599213182117988,3,5,80080,11409,68671,0.85752997002997,20.156343111111113,2970.0569866666665,13.403155786357337,121,9.500000000000018E-4
3,test_20231101_134545,10188041.png,221231,10484,210747,0.9526106196690337,2,4,41731,1472,40259,0.9647264623421438,10.660069333333333,1007.872112,18.09674932504763,121,9.500000000000018E-4
4,test_20231101_134545,10287332.png,216980,13429,203551,0.9381095031800166,1,3,22337,1833,20504,0.9179388458611273,9.370778666666666,756.6213706666666,19.342017571499717,121,9.500000000000018E-4
5,test_20231101_134545,11610969.png,368720,30069,338651,0.9184503146018659,3,4,84111,4382,79729,0.9479021768853063,20.036851555555554,2651.808336,13.895382293801273,121,9.500000000000018E-4
6,test_20231101_134545,10350842.png,212614,6847,205767,0.9677960999746018,2,3,42529,1004,41525,0.9763925791812645,18.767114666666668,2248.3353386666668,14.612192742239138,121,9.500000000000018E-4
7,test_20231101_134545,10863862.png,317432,14634,302798,0.9538987877718692,2,4,66058,2096,63962,0.9682703079112295,23.317687111111113,3119.559728,13.189870556931647,121,9.500000000000018E-4
8,test_20231101_134545,11382381.png,312486,827,311659,0.9973534814359684,1,3,46745,109,46636,0.997668199807466,21.564144,2476.360432,14.192665047538828,121,9.500000000000018E-4
9,test_20231101_134545,11079715.png,443815,130027,313788,0.7070243231977288,4,5,124136,18094,106042,0.8542405104079397,16.408837333333334,1978.80552,15.166772476828436,121,9.500000000000018E-4
10,test_20231101_134545,11551286.png,271883,527,271356,0.9980616662314304,1,3,40092,76,40016,0.9981043599720643,17.926654222222222,1858.3108106666666,15.43962007470492,121,9.500000000000018E-4
1,test_20231101_134545,10404007.png,502730,25107,477623,0.950058679609333,3,4,61265,3624,57641,0.9408471394760467,25.206074666666666,3294.1665333333335,12.953348101508894,121,9.600000000000019E-4
2,test_20231101_134545,1254659.png,342646,82262,260384,0.7599213182117988,3,4,80080,11409,68671,0.85752997002997,20.156343111111113,2970.0569866666665,13.403155786357337,121,9.600000000000019E-4
3,test_20231101_134545,10188041.png,221231,10364,210867,0.953153039131044,2,3,41731,1459,40272,0.9650379813567851,10.707653333333333,1013.100976,18.074276271225393,121,9.600000000000019E-4
4,test_20231101_134545,10287332.png,216980,13429,203551,0.9381095031800166,2,4,22337,1833,20504,0.9179388458611273,9.370778666666666,756.6213706666666,19.342017571499717,121,9.600000000000019E-4
5,test_20231101_134545,11610969.png,368720,30069,338651,0.9184503146018659,3,5,84111,4382,79729,0.9479021768853063,20.036851555555554,2651.808336,13.895382293801273,121,9.600000000000019E-4
6,test_20231101_134545,10350842.png,212614,6847,205767,0.9677960999746018,2,4,42529,1004,41525,0.9763925791812645,18.767114666666668,2248.3353386666668,14.612192742239138,121,9.600000000000019E-4
7,test_20231101_134545,10863862.png,317432,14634,302798,0.9538987877718692,2,3,66058,2096,63962,0.9682703079112295,23.317687111111113,3119.559728,13.189870556931647,121,9.600000000000019E-4
8,test_20231101_134545,11382381.png,312486,827,311659,0.9973534814359684,2,4,46745,109,46636,0.997668199807466,21.564144,2476.360432,14.192665047538828,121,9.600000000000019E-4
9,test_20231101_134545,11079715.png,443815,130027,313788,0.7070243231977288,5,5,124136,18094,106042,0.8542405104079397,16.408837333333334,1978.80552,15.166772476828436,121,9.600000000000019E-4
10,test_20231101_134545,11551286.png,271883,527,271356,0.9980616662314304,2,4,40092,76,40016,0.9981043599720643,17.926654222222222,1858.3108106666666,15.43962007470492,121,9.600000000000019E-4
1,test_20231101_134546,10404007.png,502730,25107,477623,0.950058679609333,2,4,61265,3624,57641,0.9408471394760467,25.206074666666666,3294.1665333333335,12.953348101508894,121,9.700000000000019E-4
2,test_20231101_134546,1254659.png,342646,82262,260384,0.7599213182117988,6,5,80080,11409,68671,0.85752997002997,20.156343111111113,2970.0569866666665,13.403155786357337,121,9.700000000000019E-4
3,test_20231101_134546,10188041.png,221231,10364,210867,0.953153039131044,2,3,41731,1459,40272,0.9650379813567851,10.707653333333333,1013.100976,18.074276271225393,121,9.700000000000019E-4
4,test_20231101_134546,10287332.png,216980,13429,203551,0.9381095031800166,2,3,22337,1833,20504,0.9179388458611273,9.370778666666666,756.6213706666666,19.342017571499717,121,9.700000000000019E-4
5,test_20231101_134546,11610969.png,368720,30069,338651,0.9184503146018659,3,3,84111,4382,79729,0.9479021768853063,20.036851555555554,2651.808336,13.895382293801273,121,9.700000000000019E-4
6,test_20231101_134546,10350842.png,212614,6847,205767,0.9677960999746018,2,3,42529,1004,41525,0.9763925791812645,18.767114666666668,2248.3353386666668,14.612192742239138,121,9.700000000000019E-4
7,test_20231101_134546,10863862.png,317432,14634,302798,0.9538987877718692,3,4,66058,2096,63962,0.9682703079112295,23.317687111111113,3119.559728,13.189870556931647,121,9.700000000000019E-4
8,test_20231101_134546,11382381.png,312486,827,311659,0.9973534814359684,2,3,46745,109,46636,0.997668199807466,21.564144,2476.360432,14.192665047538828,121,9.700000000000019E-4
9,test_20231101_134546,11079715.png,443815,130027,313788,0.7070243231977288,4,5,124136,18094,106042,0.8542405104079397,16.408837333333334,1978.80552,15.166772476828436,121,9.700000000000019E-4
10,test_20231101_134546,11551286.png,271883,527,271356,0.9980616662314304,1,4,40092,76,40016,0.9981043599720643,17.926654222222222,1858.3108106666666,15.43962007470492,121,9.700000000000019E-4
1,test_20231101_134547,10404007.png,502730,24642,478088,0.9509836293835657,2,4,61265,3562,57703,0.9418591365379907,25.378030222222222,3330.4072,12.905830240878892,121,9.80000000000002E-4
2,test_20231101_134547,1254659.png,342646,82102,260544,0.7603882724444471,4,4,80080,11395,68685,0.8577047952047951,20.226067555555556,2984.737445333333,13.381742267619789,121,9.80000000000002E-4
3,test_20231101_134547,10188041.png,221231,10222,211009,0.9537949021610895,2,4,41731,1444,40287,0.9653974263736791,10.79159288888889,1027.7822453333333,18.011792497763565,121,9.80000000000002E-4
4,test_20231101_134547,10287332.png,216980,13347,203633,0.9384874181952254,1,3,22337,1822,20515,0.9184313023234991,9.405495111111112,763.2239093333334,19.304283939191368,121,9.80000000000002E-4
5,test_20231101_134547,11610969.png,368720,29647,339073,0.9195948144933825,3,4,84111,4330,79781,0.9485204075566811,20.305616,2703.970181333333,13.810784628563725,121,9.80000000000002E-4
6,test_20231101_134547,10350842.png,212614,6727,205887,0.9683605030712935,2,4,42529,986,41543,0.9768158197935526,18.92183111111111,2276.9942186666667,14.557184329336422,121,9.80000000000002E-4
7,test_20231101_134547,10863862.png,317432,14132,303300,0.9554802288364123,2,3,66058,2027,64031,0.969314844530564,23.496147555555556,3160.1726346666665,13.133695528586127,121,9.80000000000002E-4
8,test_20231101_134547,11382381.png,312486,767,311719,0.9975454900379537,1,3,46745,101,46644,0.9978393411060006,21.620851555555557,2482.477712,14.181950028339719,121,9.80000000000002E-4
9,test_20231101_134547,11079715.png,443815,129947,313868,0.7072045784842784,4,5,124136,18088,106048,0.8542888444931366,16.427568,1981.6711093333333,15.160487829961314,121,9.80000000000002E-4
10,test_20231101_134547,11551286.png,271883,487,271396,0.9982087883391018,1,4,40092,70,40022,0.9982540157637434,17.985697777777776,1870.2736906666667,15.411751962304145,121,9.80000000000002E-4
1,test_20231101_134547,10404007.png,502730,24642,478088,0.9509836293835657,3,4,61265,3562,57703,0.9418591365379907,25.378030222222222,3330.4072,12.905830240878892,121,9.90000000000002E-4
2,test_20231101_134547,1254659.png,342646,82102,260544,0.7603882724444471,3,4,80080,11395,68685,0.8577047952047951,20.226067555555556,2984.737445333333,13.381742267619789,121,9.90000000000002E-4
3,test_20231101_134547,10188041.png,221231,10222,211009,0.9537949021610895,2,4,41731,1444,40287,0.9653974263736791,10.79159288888889,1027.7822453333333,18.011792497763565,121,9.90000000000002E-4
4,test_20231101_134547,10287332.png,216980,13347,203633,0.9384874181952254,1,3,22337,1822,20515,0.9184313023234991,9.405495111111112,763.2239093333334,19.304283939191368,121,9.90000000000002E-4
5,test_20231101_134547,11610969.png,368720,29647,339073,0.9195948144933825,3,4,84111,4330,79781,0.9485204075566811,20.305616,2703.970181333333,13.810784628563725,121,9.90000000000002E-4
6,test_20231101_134547,10350842.png,212614,6727,205887,0.9683605030712935,2,4,42529,986,41543,0.9768158197935526,18.92183111111111,2276.9942186666667,14.557184329336422,121,9.90000000000002E-4
7,test_20231101_134547,10863862.png,317432,14132,303300,0.9554802288364123,3,5,66058,2027,64031,0.969314844530564,23.496147555555556,3160.1726346666665,13.133695528586127,121,9.90000000000002E-4
8,test_20231101_134547,11382381.png,312486,767,311719,0.9975454900379537,1,4,46745,101,46644,0.9978393411060006,21.620851555555557,2482.477712,14.181950028339719,121,9.90000000000002E-4
9,test_20231101_134547,11079715.png,443815,129947,313868,0.7072045784842784,4,4,124136,18088,106048,0.8542888444931366,16.427568,1981.6711093333333,15.160487829961314,121,9.90000000000002E-4
10,test_20231101_134547,11551286.png,271883,487,271396,0.9982087883391018,1,3,40092,70,40022,0.9982540157637434,17.985697777777776,1870.2736906666667,15.411751962304145,121,9.90000000000002E-4
1,test_20231101_134548,10404007.png,502730,25187,477543,0.949899548465379,2,3,61265,3630,57635,0.9407492042765038,25.12879288888889,3282.03776,12.969367875434926,122,0.0
2,test_20231101_134548,1254659.png,342646,79962,262684,0.7666337853061177,2,4,80080,11106,68974,0.8613136863136863,20.326528,3020.2829653333333,13.330327276703748,122,0.0
3,test_20231101_134548,10188041.png,221231,10484,210747,0.9526106196690337,3,3,41731,1476,40255,0.9646306103376386,10.29104711111111,967.4823253333333,18.274373211101064,122,0.0
4,test_20231101_134548,10287332.png,216980,13317,203663,0.9386256797861554,2,4,22337,1816,20521,0.9186999149393383,9.276503111111111,739.8157706666667,19.43956775926238,122,0.0
5,test_20231101_134548,11610969.png,368720,29517,339203,0.9199473855500109,2,4,84111,4304,79807,0.9488295228923684,19.500469333333335,2542.365472,14.078423791408932,122,0.0
6,test_20231101_134548,10350842.png,212614,7067,205547,0.9667613609640004,2,4,42529,1036,41493,0.9756401514260857,17.272896,1936.234528,15.261224004330279,122,0.0
7,test_20231101_134548,10863862.png,317432,14152,303280,0.955417223216311,2,4,66058,2034,64024,0.9692088770474432,23.416272,3158.1188533333334,13.136518905548746,122,0.0
8,test_20231101_134548,11382381.png,312486,1229,311257,0.9960670238026663,1,3,46745,168,46577,0.9964060327307733,19.73855111111111,2216.4945546666668,14.67413692176443,122,0.0
9,test_20231101_134548,11079715.png,443815,127382,316433,0.7129840136092742,3,4,124136,17736,106400,0.8571244441580202,16.53779911111111,2010.815104,15.097082221479486,122,0.0
10,test_20231101_134548,11551286.png,271883,1442,270441,0.9946962480184491,2,3,40092,212,39880,0.9947121620273371,15.670912,1482.1901333333333,16.421764429459,122,0.0
1,test_20231101_134549,10404007.png,502730,25187,477543,0.949899548465379,3,3,61265,3630,57635,0.9407492042765038,25.12879288888889,3282.03776,12.969367875434926,122,1.0E-5
2,test_20231101_134549,1254659.png,342646,79962,262684,0.7666337853061177,2,6,80080,11106,68974,0.8613136863136863,20.326528,3020.2829653333333,13.330327276703748,122,1.0E-5
3,test_20231101_134549,10188041.png,221231,10484,210747,0.9526106196690337,3,3,41731,1476,40255,0.9646306103376386,10.29104711111111,967.4823253333333,18.274373211101064,122,1.0E-5
4,test_20231101_134549,10287332.png,216980,13317,203663,0.9386256797861554,2,4,22337,1816,20521,0.9186999149393383,9.276503111111111,739.8157706666667,19.43956775926238,122,1.0E-5
5,test_20231101_134549,11610969.png,368720,29517,339203,0.9199473855500109,2,4,84111,4304,79807,0.9488295228923684,19.500469333333335,2542.365472,14.078423791408932,122,1.0E-5
6,test_20231101_134549,10350842.png,212614,7067,205547,0.9667613609640004,2,3,42529,1036,41493,0.9756401514260857,17.272896,1936.234528,15.261224004330279,122,1.0E-5
7,test_20231101_134549,10863862.png,317432,14152,303280,0.955417223216311,2,3,66058,2034,64024,0.9692088770474432,23.416272,3158.1188533333334,13.136518905548746,122,1.0E-5
8,test_20231101_134549,11382381.png,312486,1229,311257,0.9960670238026663,1,7,46745,168,46577,0.9964060327307733,19.73855111111111,2216.4945546666668,14.67413692176443,122,1.0E-5
9,test_20231101_134549,11079715.png,443815,127382,316433,0.7129840136092742,4,5,124136,17736,106400,0.8571244441580202,16.53779911111111,2010.815104,15.097082221479486,122,1.0E-5
10,test_20231101_134549,11551286.png,271883,1442,270441,0.9946962480184491,2,3,40092,212,39880,0.9947121620273371,15.670912,1482.1901333333333,16.421764429459,122,1.0E-5
1,test_20231101_134550,10404007.png,502730,25187,477543,0.949899548465379,2,4,61265,3630,57635,0.9407492042765038,25.12879288888889,3282.03776,12.969367875434926,122,2.0E-5
2,test_20231101_134550,1254659.png,342646,79962,262684,0.7666337853061177,3,9,80080,11106,68974,0.8613136863136863,20.326528,3020.2829653333333,13.330327276703748,122,2.0E-5
3,test_20231101_134550,10188041.png,221231,10484,210747,0.9526106196690337,2,4,41731,1476,40255,0.9646306103376386,10.29104711111111,967.4823253333333,18.274373211101064,122,2.0E-5
4,test_20231101_134550,10287332.png,216980,13317,203663,0.9386256797861554,2,3,22337,1816,20521,0.9186999149393383,9.276503111111111,739.8157706666667,19.43956775926238,122,2.0E-5
5,test_20231101_134550,11610969.png,368720,29517,339203,0.9199473855500109,3,5,84111,4304,79807,0.9488295228923684,19.500469333333335,2542.365472,14.078423791408932,122,2.0E-5
6,test_20231101_134550,10350842.png,212614,7067,205547,0.9667613609640004,4,4,42529,1036,41493,0.9756401514260857,17.272896,1936.234528,15.261224004330279,122,2.0E-5
7,test_20231101_134550,10863862.png,317432,14152,303280,0.955417223216311,2,4,66058,2034,64024,0.9692088770474432,23.416272,3158.1188533333334,13.136518905548746,122,2.0E-5
8,test_20231101_134550,11382381.png,312486,1229,311257,0.9960670238026663,2,4,46745,168,46577,0.9964060327307733,19.73855111111111,2216.4945546666668,14.67413692176443,122,2.0E-5
9,test_20231101_134550,11079715.png,443815,127382,316433,0.7129840136092742,4,4,124136,17736,106400,0.8571244441580202,16.53779911111111,2010.815104,15.097082221479486,122,2.0E-5
10,test_20231101_134550,11551286.png,271883,1442,270441,0.9946962480184491,2,4,40092,212,39880,0.9947121620273371,15.670912,1482.1901333333333,16.421764429459,122,2.0E-5
1,test_20231101_134550,10404007.png,502730,25187,477543,0.949899548465379,3,4,61265,3630,57635,0.9407492042765038,25.12879288888889,3282.03776,12.969367875434926,122,3.0000000000000004E-5
2,test_20231101_134550,1254659.png,342646,79962,262684,0.7666337853061177,3,8,80080,11106,68974,0.8613136863136863,20.326528,3020.2829653333333,13.330327276703748,122,3.0000000000000004E-5
3,test_20231101_134550,10188041.png,221231,10484,210747,0.9526106196690337,2,4,41731,1476,40255,0.9646306103376386,10.29104711111111,967.4823253333333,18.274373211101064,122,3.0000000000000004E-5
4,test_20231101_134550,10287332.png,216980,13317,203663,0.9386256797861554,2,4,22337,1816,20521,0.9186999149393383,9.276503111111111,739.8157706666667,19.43956775926238,122,3.0000000000000004E-5
5,test_20231101_134550,11610969.png,368720,29517,339203,0.9199473855500109,2,4,84111,4304,79807,0.9488295228923684,19.500469333333335,2542.365472,14.078423791408932,122,3.0000000000000004E-5
6,test_20231101_134550,10350842.png,212614,7067,205547,0.9667613609640004,1,4,42529,1036,41493,0.9756401514260857,17.272896,1936.234528,15.261224004330279,122,3.0000000000000004E-5
7,test_20231101_134550,10863862.png,317432,14152,303280,0.955417223216311,2,4,66058,2034,64024,0.9692088770474432,23.416272,3158.1188533333334,13.136518905548746,122,3.0000000000000004E-5
8,test_20231101_134550,11382381.png,312486,1229,311257,0.9960670238026663,2,4,46745,168,46577,0.9964060327307733,19.73855111111111,2216.4945546666668,14.67413692176443,122,3.0000000000000004E-5
9,test_20231101_134550,11079715.png,443815,127382,316433,0.7129840136092742,4,4,124136,17736,106400,0.8571244441580202,16.53779911111111,2010.815104,15.097082221479486,122,3.0000000000000004E-5
10,test_20231101_134550,11551286.png,271883,1442,270441,0.9946962480184491,2,4,40092,212,39880,0.9947121620273371,15.670912,1482.1901333333333,16.421764429459,122,3.0000000000000004E-5
1,test_20231101_134551,10404007.png,502730,25187,477543,0.949899548465379,3,4,61265,3630,57635,0.9407492042765038,25.12879288888889,3282.03776,12.969367875434926,122,4.0E-5
2,test_20231101_134551,1254659.png,342646,79962,262684,0.7666337853061177,3,5,80080,11106,68974,0.8613136863136863,20.326528,3020.2829653333333,13.330327276703748,122,4.0E-5
3,test_20231101_134551,10188041.png,221231,10484,210747,0.9526106196690337,2,4,41731,1476,40255,0.9646306103376386,10.29104711111111,967.4823253333333,18.274373211101064,122,4.0E-5
4,test_20231101_134551,10287332.png,216980,13317,203663,0.9386256797861554,2,3,22337,1816,20521,0.9186999149393383,9.276503111111111,739.8157706666667,19.43956775926238,122,4.0E-5
5,test_20231101_134551,11610969.png,368720,29517,339203,0.9199473855500109,3,4,84111,4304,79807,0.9488295228923684,19.500469333333335,2542.365472,14.078423791408932,122,4.0E-5
6,test_20231101_134551,10350842.png,212614,7067,205547,0.9667613609640004,2,4,42529,1036,41493,0.9756401514260857,17.272896,1936.234528,15.261224004330279,122,4.0E-5
7,test_20231101_134551,10863862.png,317432,14152,303280,0.955417223216311,2,4,66058,2034,64024,0.9692088770474432,23.416272,3158.1188533333334,13.136518905548746,122,4.0E-5
8,test_20231101_134551,11382381.png,312486,1229,311257,0.9960670238026663,2,4,46745,168,46577,0.9964060327307733,19.73855111111111,2216.4945546666668,14.67413692176443,122,4.0E-5
9,test_20231101_134551,11079715.png,443815,127382,316433,0.7129840136092742,4,4,124136,17736,106400,0.8571244441580202,16.53779911111111,2010.815104,15.097082221479486,122,4.0E-5
10,test_20231101_134551,11551286.png,271883,1442,270441,0.9946962480184491,5,3,40092,212,39880,0.9947121620273371,15.670912,1482.1901333333333,16.421764429459,122,4.0E-5
1,test_20231101_134552,10404007.png,502730,25187,477543,0.949899548465379,3,4,61265,3630,57635,0.9407492042765038,25.12879288888889,3282.03776,12.969367875434926,122,5.0E-5
2,test_20231101_134552,1254659.png,342646,79962,262684,0.7666337853061177,3,4,80080,11106,68974,0.8613136863136863,20.326528,3020.2829653333333,13.330327276703748,122,5.0E-5
3,test_20231101_134552,10188041.png,221231,10484,210747,0.9526106196690337,2,20,41731,1476,40255,0.9646306103376386,10.29104711111111,967.4823253333333,18.274373211101064,122,5.0E-5
4,test_20231101_134552,10287332.png,216980,13317,203663,0.9386256797861554,2,4,22337,1816,20521,0.9186999149393383,9.276503111111111,739.8157706666667,19.43956775926238,122,5.0E-5
5,test_20231101_134552,11610969.png,368720,29517,339203,0.9199473855500109,3,4,84111,4304,79807,0.9488295228923684,19.500469333333335,2542.365472,14.078423791408932,122,5.0E-5
6,test_20231101_134552,10350842.png,212614,7067,205547,0.9667613609640004,2,4,42529,1036,41493,0.9756401514260857,17.272896,1936.234528,15.261224004330279,122,5.0E-5
7,test_20231101_134552,10863862.png,317432,14152,303280,0.955417223216311,2,4,66058,2034,64024,0.9692088770474432,23.416272,3158.1188533333334,13.136518905548746,122,5.0E-5
8,test_20231101_134552,11382381.png,312486,1229,311257,0.9960670238026663,2,4,46745,168,46577,0.9964060327307733,19.73855111111111,2216.4945546666668,14.67413692176443,122,5.0E-5
9,test_20231101_134552,11079715.png,443815,127382,316433,0.7129840136092742,4,4,124136,17736,106400,0.8571244441580202,16.53779911111111,2010.815104,15.097082221479486,122,5.0E-5
10,test_20231101_134552,11551286.png,271883,1442,270441,0.9946962480184491,1,3,40092,212,39880,0.9947121620273371,15.670912,1482.1901333333333,16.421764429459,122,5.0E-5
1,test_20231101_134553,10404007.png,502730,25187,477543,0.949899548465379,2,4,61265,3630,57635,0.9407492042765038,25.12879288888889,3282.03776,12.969367875434926,122,6.0E-5
2,test_20231101_134553,1254659.png,342646,79962,262684,0.7666337853061177,3,4,80080,11106,68974,0.8613136863136863,20.326528,3020.2829653333333,13.330327276703748,122,6.0E-5
3,test_20231101_134553,10188041.png,221231,10484,210747,0.9526106196690337,2,3,41731,1476,40255,0.9646306103376386,10.29104711111111,967.4823253333333,18.274373211101064,122,6.0E-5
4,test_20231101_134553,10287332.png,216980,13317,203663,0.9386256797861554,2,3,22337,1816,20521,0.9186999149393383,9.276503111111111,739.8157706666667,19.43956775926238,122,6.0E-5
5,test_20231101_134553,11610969.png,368720,29517,339203,0.9199473855500109,2,3,84111,4304,79807,0.9488295228923684,19.500469333333335,2542.365472,14.078423791408932,122,6.0E-5
6,test_20231101_134553,10350842.png,212614,7067,205547,0.9667613609640004,1,3,42529,1036,41493,0.9756401514260857,17.272896,1936.234528,15.261224004330279,122,6.0E-5
7,test_20231101_134553,10863862.png,317432,14152,303280,0.955417223216311,2,4,66058,2034,64024,0.9692088770474432,23.416272,3158.1188533333334,13.136518905548746,122,6.0E-5
8,test_20231101_134553,11382381.png,312486,1229,311257,0.9960670238026663,2,4,46745,168,46577,0.9964060327307733,19.73855111111111,2216.4945546666668,14.67413692176443,122,6.0E-5
9,test_20231101_134553,11079715.png,443815,127382,316433,0.7129840136092742,3,10,124136,17736,106400,0.8571244441580202,16.53779911111111,2010.815104,15.097082221479486,122,6.0E-5
10,test_20231101_134553,11551286.png,271883,1442,270441,0.9946962480184491,1,4,40092,212,39880,0.9947121620273371,15.670912,1482.1901333333333,16.421764429459,122,6.0E-5
1,test_20231101_134553,10404007.png,502730,25187,477543,0.949899548465379,3,4,61265,3630,57635,0.9407492042765038,25.12879288888889,3282.03776,12.969367875434926,122,7.000000000000001E-5
2,test_20231101_134553,1254659.png,342646,79962,262684,0.7666337853061177,3,4,80080,11106,68974,0.8613136863136863,20.326528,3020.2829653333333,13.330327276703748,122,7.000000000000001E-5
3,test_20231101_134553,10188041.png,221231,10484,210747,0.9526106196690337,2,4,41731,1476,40255,0.9646306103376386,10.29104711111111,967.4823253333333,18.274373211101064,122,7.000000000000001E-5
4,test_20231101_134553,10287332.png,216980,13317,203663,0.9386256797861554,1,3,22337,1816,20521,0.9186999149393383,9.276503111111111,739.8157706666667,19.43956775926238,122,7.000000000000001E-5
5,test_20231101_134553,11610969.png,368720,29517,339203,0.9199473855500109,3,4,84111,4304,79807,0.9488295228923684,19.500469333333335,2542.365472,14.078423791408932,122,7.000000000000001E-5
6,test_20231101_134553,10350842.png,212614,7067,205547,0.9667613609640004,2,3,42529,1036,41493,0.9756401514260857,17.272896,1936.234528,15.261224004330279,122,7.000000000000001E-5
7,test_20231101_134553,10863862.png,317432,14152,303280,0.955417223216311,2,4,66058,2034,64024,0.9692088770474432,23.416272,3158.1188533333334,13.136518905548746,122,7.000000000000001E-5
8,test_20231101_134553,11382381.png,312486,1159,311327,0.996291033838316,2,3,46745,158,46587,0.9966199593539415,20.606709333333335,2334.900224,14.448120340351833,122,7.000000000000001E-5
9,test_20231101_134553,11079715.png,443815,127382,316433,0.7129840136092742,3,4,124136,17736,106400,0.8571244441580202,16.53779911111111,2010.815104,15.097082221479486,122,7.000000000000001E-5
10,test_20231101_134553,11551286.png,271883,1322,270561,0.9951376143414631,2,3,40092,194,39898,0.9951611294023746,15.757246222222221,1488.3021066666668,16.40389264375073,122,7.000000000000001E-5
1,test_20231101_134554,10404007.png,502730,25187,477543,0.949899548465379,2,3,61265,3630,57635,0.9407492042765038,25.12879288888889,3282.03776,12.969367875434926,122,8.0E-5
2,test_20231101_134554,1254659.png,342646,79962,262684,0.7666337853061177,3,4,80080,11106,68974,0.8613136863136863,20.326528,3020.2829653333333,13.330327276703748,122,8.0E-5
3,test_20231101_134554,10188041.png,221231,10484,210747,0.9526106196690337,1,3,41731,1476,40255,0.9646306103376386,10.29104711111111,967.4823253333333,18.274373211101064,122,8.0E-5
4,test_20231101_134554,10287332.png,216980,13317,203663,0.9386256797861554,1,3,22337,1816,20521,0.9186999149393383,9.276503111111111,739.8157706666667,19.43956775926238,122,8.0E-5
5,test_20231101_134554,11610969.png,368720,29517,339203,0.9199473855500109,3,3,84111,4304,79807,0.9488295228923684,19.500469333333335,2542.365472,14.078423791408932,122,8.0E-5
6,test_20231101_134554,10350842.png,212614,7067,205547,0.9667613609640004,2,4,42529,1036,41493,0.9756401514260857,17.272896,1936.234528,15.261224004330279,122,8.0E-5
7,test_20231101_134554,10863862.png,317432,14152,303280,0.955417223216311,2,4,66058,2034,64024,0.9692088770474432,23.416272,3158.1188533333334,13.136518905548746,122,8.0E-5
8,test_20231101_134554,11382381.png,312486,1159,311327,0.996291033838316,1,3,46745,158,46587,0.9966199593539415,20.606709333333335,2334.900224,14.448120340351833,122,8.0E-5
9,test_20231101_134554,11079715.png,443815,127382,316433,0.7129840136092742,5,4,124136,17736,106400,0.8571244441580202,16.53779911111111,2010.815104,15.097082221479486,122,8.0E-5
10,test_20231101_134554,11551286.png,271883,1322,270561,0.9951376143414631,1,3,40092,194,39898,0.9951611294023746,15.757246222222221,1488.3021066666668,16.40389264375073,122,8.0E-5
1,test_20231101_134555,10404007.png,502730,25187,477543,0.949899548465379,2,4,61265,3630,57635,0.9407492042765038,25.12879288888889,3282.03776,12.969367875434926,122,9.0E-5
2,test_20231101_134555,1254659.png,342646,79962,262684,0.7666337853061177,3,5,80080,11106,68974,0.8613136863136863,20.326528,3020.2829653333333,13.330327276703748,122,9.0E-5
3,test_20231101_134555,10188041.png,221231,10484,210747,0.9526106196690337,2,3,41731,1476,40255,0.9646306103376386,10.29104711111111,967.4823253333333,18.274373211101064,122,9.0E-5
4,test_20231101_134555,10287332.png,216980,13317,203663,0.9386256797861554,2,4,22337,1816,20521,0.9186999149393383,9.276503111111111,739.8157706666667,19.43956775926238,122,9.0E-5
5,test_20231101_134555,11610969.png,368720,29517,339203,0.9199473855500109,2,4,84111,4304,79807,0.9488295228923684,19.500469333333335,2542.365472,14.078423791408932,122,9.0E-5
6,test_20231101_134555,10350842.png,212614,7067,205547,0.9667613609640004,1,4,42529,1036,41493,0.9756401514260857,17.272896,1936.234528,15.261224004330279,122,9.0E-5
7,test_20231101_134555,10863862.png,317432,14152,303280,0.955417223216311,2,4,66058,2034,64024,0.9692088770474432,23.416272,3158.1188533333334,13.136518905548746,122,9.0E-5
8,test_20231101_134555,11382381.png,312486,1159,311327,0.996291033838316,1,3,46745,158,46587,0.9966199593539415,20.606709333333335,2334.900224,14.448120340351833,122,9.0E-5
9,test_20231101_134555,11079715.png,443815,127382,316433,0.7129840136092742,4,4,124136,17736,106400,0.8571244441580202,16.53779911111111,2010.815104,15.097082221479486,122,9.0E-5
10,test_20231101_134555,11551286.png,271883,1322,270561,0.9951376143414631,1,4,40092,194,39898,0.9951611294023746,15.757246222222221,1488.3021066666668,16.40389264375073,122,9.0E-5
1,test_20231101_134556,10404007.png,502730,25187,477543,0.949899548465379,2,3,61265,3630,57635,0.9407492042765038,25.12879288888889,3282.03776,12.969367875434926,122,1.0E-4
2,test_20231101_134556,1254659.png,342646,79962,262684,0.7666337853061177,3,4,80080,11106,68974,0.8613136863136863,20.326528,3020.2829653333333,13.330327276703748,122,1.0E-4
3,test_20231101_134556,10188041.png,221231,10484,210747,0.9526106196690337,2,4,41731,1476,40255,0.9646306103376386,10.29104711111111,967.4823253333333,18.274373211101064,122,1.0E-4
4,test_20231101_134556,10287332.png,216980,13317,203663,0.9386256797861554,2,3,22337,1816,20521,0.9186999149393383,9.276503111111111,739.8157706666667,19.43956775926238,122,1.0E-4
5,test_20231101_134556,11610969.png,368720,29517,339203,0.9199473855500109,2,4,84111,4304,79807,0.9488295228923684,19.500469333333335,2542.365472,14.078423791408932,122,1.0E-4
6,test_20231101_134556,10350842.png,212614,7067,205547,0.9667613609640004,2,3,42529,1036,41493,0.9756401514260857,17.272896,1936.234528,15.261224004330279,122,1.0E-4
7,test_20231101_134556,10863862.png,317432,14152,303280,0.955417223216311,2,4,66058,2034,64024,0.9692088770474432,23.416272,3158.1188533333334,13.136518905548746,122,1.0E-4
8,test_20231101_134556,11382381.png,312486,1159,311327,0.996291033838316,1,3,46745,158,46587,0.9966199593539415,20.606709333333335,2334.900224,14.448120340351833,122,1.0E-4
9,test_20231101_134556,11079715.png,443815,127382,316433,0.7129840136092742,3,4,124136,17736,106400,0.8571244441580202,16.53779911111111,2010.815104,15.097082221479486,122,1.0E-4
10,test_20231101_134556,11551286.png,271883,1322,270561,0.9951376143414631,1,4,40092,194,39898,0.9951611294023746,15.757246222222221,1488.3021066666668,16.40389264375073,122,1.0E-4
1,test_20231101_134556,10404007.png,502730,25187,477543,0.949899548465379,2,3,61265,3630,57635,0.9407492042765038,25.12879288888889,3282.03776,12.969367875434926,122,1.1E-4
2,test_20231101_134556,1254659.png,342646,79962,262684,0.7666337853061177,3,4,80080,11106,68974,0.8613136863136863,20.326528,3020.2829653333333,13.330327276703748,122,1.1E-4
3,test_20231101_134556,10188041.png,221231,10484,210747,0.9526106196690337,1,3,41731,1476,40255,0.9646306103376386,10.29104711111111,967.4823253333333,18.274373211101064,122,1.1E-4
4,test_20231101_134556,10287332.png,216980,13317,203663,0.9386256797861554,2,4,22337,1816,20521,0.9186999149393383,9.276503111111111,739.8157706666667,19.43956775926238,122,1.1E-4
5,test_20231101_134556,11610969.png,368720,29517,339203,0.9199473855500109,2,4,84111,4304,79807,0.9488295228923684,19.500469333333335,2542.365472,14.078423791408932,122,1.1E-4
6,test_20231101_134556,10350842.png,212614,7067,205547,0.9667613609640004,1,3,42529,1036,41493,0.9756401514260857,17.272896,1936.234528,15.261224004330279,122,1.1E-4
7,test_20231101_134556,10863862.png,317432,14152,303280,0.955417223216311,2,4,66058,2034,64024,0.9692088770474432,23.416272,3158.1188533333334,13.136518905548746,122,1.1E-4
8,test_20231101_134556,11382381.png,312486,1159,311327,0.996291033838316,2,4,46745,158,46587,0.9966199593539415,20.606709333333335,2334.900224,14.448120340351833,122,1.1E-4
9,test_20231101_134556,11079715.png,443815,127382,316433,0.7129840136092742,3,4,124136,17736,106400,0.8571244441580202,16.53779911111111,2010.815104,15.097082221479486,122,1.1E-4
10,test_20231101_134556,11551286.png,271883,1322,270561,0.9951376143414631,2,4,40092,194,39898,0.9951611294023746,15.757246222222221,1488.3021066666668,16.40389264375073,122,1.1E-4
1,test_20231101_134557,10404007.png,502730,25187,477543,0.949899548465379,2,4,61265,3630,57635,0.9407492042765038,25.12879288888889,3282.03776,12.969367875434926,122,1.2E-4
2,test_20231101_134557,1254659.png,342646,79962,262684,0.7666337853061177,3,5,80080,11106,68974,0.8613136863136863,20.326528,3020.2829653333333,13.330327276703748,122,1.2E-4
3,test_20231101_134557,10188041.png,221231,10484,210747,0.9526106196690337,2,3,41731,1476,40255,0.9646306103376386,10.29104711111111,967.4823253333333,18.274373211101064,122,1.2E-4
4,test_20231101_134557,10287332.png,216980,13317,203663,0.9386256797861554,2,3,22337,1816,20521,0.9186999149393383,9.276503111111111,739.8157706666667,19.43956775926238,122,1.2E-4
5,test_20231101_134557,11610969.png,368720,29517,339203,0.9199473855500109,2,4,84111,4304,79807,0.9488295228923684,19.500469333333335,2542.365472,14.078423791408932,122,1.2E-4
6,test_20231101_134557,10350842.png,212614,7067,205547,0.9667613609640004,2,4,42529,1036,41493,0.9756401514260857,17.272896,1936.234528,15.261224004330279,122,1.2E-4
7,test_20231101_134557,10863862.png,317432,14152,303280,0.955417223216311,2,10,66058,2034,64024,0.9692088770474432,23.416272,3158.1188533333334,13.136518905548746,122,1.2E-4
8,test_20231101_134557,11382381.png,312486,1159,311327,0.996291033838316,1,4,46745,158,46587,0.9966199593539415,20.606709333333335,2334.900224,14.448120340351833,122,1.2E-4
9,test_20231101_134557,11079715.png,443815,127382,316433,0.7129840136092742,4,4,124136,17736,106400,0.8571244441580202,16.53779911111111,2010.815104,15.097082221479486,122,1.2E-4
10,test_20231101_134557,11551286.png,271883,1322,270561,0.9951376143414631,2,4,40092,194,39898,0.9951611294023746,15.757246222222221,1488.3021066666668,16.40389264375073,122,1.2E-4
1,test_20231101_134558,10404007.png,502730,25187,477543,0.949899548465379,2,4,61265,3630,57635,0.9407492042765038,25.12879288888889,3282.03776,12.969367875434926,122,1.3000000000000002E-4
2,test_20231101_134558,1254659.png,342646,79962,262684,0.7666337853061177,4,4,80080,11106,68974,0.8613136863136863,20.326528,3020.2829653333333,13.330327276703748,122,1.3000000000000002E-4
3,test_20231101_134558,10188041.png,221231,10484,210747,0.9526106196690337,2,4,41731,1476,40255,0.9646306103376386,10.29104711111111,967.4823253333333,18.274373211101064,122,1.3000000000000002E-4
4,test_20231101_134558,10287332.png,216980,13317,203663,0.9386256797861554,2,4,22337,1816,20521,0.9186999149393383,9.276503111111111,739.8157706666667,19.43956775926238,122,1.3000000000000002E-4
5,test_20231101_134558,11610969.png,368720,29517,339203,0.9199473855500109,2,4,84111,4304,79807,0.9488295228923684,19.500469333333335,2542.365472,14.078423791408932,122,1.3000000000000002E-4
6,test_20231101_134558,10350842.png,212614,7067,205547,0.9667613609640004,2,3,42529,1036,41493,0.9756401514260857,17.272896,1936.234528,15.261224004330279,122,1.3000000000000002E-4
7,test_20231101_134558,10863862.png,317432,14152,303280,0.955417223216311,2,3,66058,2034,64024,0.9692088770474432,23.416272,3158.1188533333334,13.136518905548746,122,1.3000000000000002E-4
8,test_20231101_134558,11382381.png,312486,1159,311327,0.996291033838316,2,4,46745,158,46587,0.9966199593539415,20.606709333333335,2334.900224,14.448120340351833,122,1.3000000000000002E-4
9,test_20231101_134558,11079715.png,443815,127382,316433,0.7129840136092742,4,4,124136,17736,106400,0.8571244441580202,16.53779911111111,2010.815104,15.097082221479486,122,1.3000000000000002E-4
10,test_20231101_134558,11551286.png,271883,1322,270561,0.9951376143414631,2,3,40092,194,39898,0.9951611294023746,15.757246222222221,1488.3021066666668,16.40389264375073,122,1.3000000000000002E-4
1,test_20231101_134558,10404007.png,502730,25187,477543,0.949899548465379,3,4,61265,3630,57635,0.9407492042765038,25.12879288888889,3282.03776,12.969367875434926,122,1.4000000000000001E-4
2,test_20231101_134558,1254659.png,342646,79962,262684,0.7666337853061177,5,4,80080,11106,68974,0.8613136863136863,20.326528,3020.2829653333333,13.330327276703748,122,1.4000000000000001E-4
3,test_20231101_134558,10188041.png,221231,10484,210747,0.9526106196690337,2,3,41731,1476,40255,0.9646306103376386,10.29104711111111,967.4823253333333,18.274373211101064,122,1.4000000000000001E-4
4,test_20231101_134558,10287332.png,216980,13317,203663,0.9386256797861554,2,4,22337,1816,20521,0.9186999149393383,9.276503111111111,739.8157706666667,19.43956775926238,122,1.4000000000000001E-4
5,test_20231101_134558,11610969.png,368720,29517,339203,0.9199473855500109,3,6,84111,4304,79807,0.9488295228923684,19.500469333333335,2542.365472,14.078423791408932,122,1.4000000000000001E-4
6,test_20231101_134558,10350842.png,212614,7067,205547,0.9667613609640004,1,3,42529,1036,41493,0.9756401514260857,17.272896,1936.234528,15.261224004330279,122,1.4000000000000001E-4
7,test_20231101_134558,10863862.png,317432,14152,303280,0.955417223216311,2,4,66058,2034,64024,0.9692088770474432,23.416272,3158.1188533333334,13.136518905548746,122,1.4000000000000001E-4
8,test_20231101_134558,11382381.png,312486,1159,311327,0.996291033838316,1,4,46745,158,46587,0.9966199593539415,20.606709333333335,2334.900224,14.448120340351833,122,1.4000000000000001E-4
9,test_20231101_134558,11079715.png,443815,127382,316433,0.7129840136092742,4,4,124136,17736,106400,0.8571244441580202,16.53779911111111,2010.815104,15.097082221479486,122,1.4000000000000001E-4
10,test_20231101_134558,11551286.png,271883,1322,270561,0.9951376143414631,2,3,40092,194,39898,0.9951611294023746,15.757246222222221,1488.3021066666668,16.40389264375073,122,1.4000000000000001E-4
1,test_20231101_134559,10404007.png,502730,25187,477543,0.949899548465379,2,4,61265,3630,57635,0.9407492042765038,25.12879288888889,3282.03776,12.969367875434926,122,1.5000000000000001E-4
2,test_20231101_134559,1254659.png,342646,79962,262684,0.7666337853061177,3,4,80080,11106,68974,0.8613136863136863,20.326528,3020.2829653333333,13.330327276703748,122,1.5000000000000001E-4
3,test_20231101_134559,10188041.png,221231,10484,210747,0.9526106196690337,3,3,41731,1476,40255,0.9646306103376386,10.29104711111111,967.4823253333333,18.274373211101064,122,1.5000000000000001E-4
4,test_20231101_134559,10287332.png,216980,13317,203663,0.9386256797861554,1,3,22337,1816,20521,0.9186999149393383,9.276503111111111,739.8157706666667,19.43956775926238,122,1.5000000000000001E-4
5,test_20231101_134559,11610969.png,368720,29517,339203,0.9199473855500109,2,4,84111,4304,79807,0.9488295228923684,19.500469333333335,2542.365472,14.078423791408932,122,1.5000000000000001E-4
6,test_20231101_134559,10350842.png,212614,7067,205547,0.9667613609640004,2,4,42529,1036,41493,0.9756401514260857,17.272896,1936.234528,15.261224004330279,122,1.5000000000000001E-4
7,test_20231101_134559,10863862.png,317432,14152,303280,0.955417223216311,2,3,66058,2034,64024,0.9692088770474432,23.416272,3158.1188533333334,13.136518905548746,122,1.5000000000000001E-4
8,test_20231101_134559,11382381.png,312486,1159,311327,0.996291033838316,2,4,46745,158,46587,0.9966199593539415,20.606709333333335,2334.900224,14.448120340351833,122,1.5000000000000001E-4
9,test_20231101_134559,11079715.png,443815,127382,316433,0.7129840136092742,4,5,124136,17736,106400,0.8571244441580202,16.53779911111111,2010.815104,15.097082221479486,122,1.5000000000000001E-4
10,test_20231101_134559,11551286.png,271883,1322,270561,0.9951376143414631,2,4,40092,194,39898,0.9951611294023746,15.757246222222221,1488.3021066666668,16.40389264375073,122,1.5000000000000001E-4
1,test_20231101_134600,10404007.png,502730,25187,477543,0.949899548465379,3,4,61265,3630,57635,0.9407492042765038,25.12879288888889,3282.03776,12.969367875434926,122,1.6E-4
2,test_20231101_134600,1254659.png,342646,79962,262684,0.7666337853061177,3,4,80080,11106,68974,0.8613136863136863,20.326528,3020.2829653333333,13.330327276703748,122,1.6E-4
3,test_20231101_134600,10188041.png,221231,10484,210747,0.9526106196690337,2,4,41731,1476,40255,0.9646306103376386,10.29104711111111,967.4823253333333,18.274373211101064,122,1.6E-4
4,test_20231101_134600,10287332.png,216980,13087,203893,0.939685685316619,2,4,22337,1789,20548,0.9199086717106146,9.406264888888888,766.5465173333333,19.285418460243026,122,1.6E-4
5,test_20231101_134600,11610969.png,368720,29517,339203,0.9199473855500109,3,4,84111,4304,79807,0.9488295228923684,19.500469333333335,2542.365472,14.078423791408932,122,1.6E-4
6,test_20231101_134600,10350842.png,212614,7067,205547,0.9667613609640004,2,3,42529,1036,41493,0.9756401514260857,17.272896,1936.234528,15.261224004330279,122,1.6E-4
7,test_20231101_134600,10863862.png,317432,14152,303280,0.955417223216311,2,3,66058,2034,64024,0.9692088770474432,23.416272,3158.1188533333334,13.136518905548746,122,1.6E-4
8,test_20231101_134600,11382381.png,312486,1159,311327,0.996291033838316,2,4,46745,158,46587,0.9966199593539415,20.606709333333335,2334.900224,14.448120340351833,122,1.6E-4
9,test_20231101_134600,11079715.png,443815,127382,316433,0.7129840136092742,4,4,124136,17736,106400,0.8571244441580202,16.53779911111111,2010.815104,15.097082221479486,122,1.6E-4
10,test_20231101_134600,11551286.png,271883,1322,270561,0.9951376143414631,2,3,40092,194,39898,0.9951611294023746,15.757246222222221,1488.3021066666668,16.40389264375073,122,1.6E-4
1,test_20231101_134600,10404007.png,502730,25187,477543,0.949899548465379,2,4,61265,3630,57635,0.9407492042765038,25.12879288888889,3282.03776,12.969367875434926,122,1.7E-4
2,test_20231101_134600,1254659.png,342646,79962,262684,0.7666337853061177,3,4,80080,11106,68974,0.8613136863136863,20.326528,3020.2829653333333,13.330327276703748,122,1.7E-4
3,test_20231101_134600,10188041.png,221231,10484,210747,0.9526106196690337,2,4,41731,1476,40255,0.9646306103376386,10.29104711111111,967.4823253333333,18.274373211101064,122,1.7E-4
4,test_20231101_134600,10287332.png,216980,13087,203893,0.939685685316619,2,3,22337,1789,20548,0.9199086717106146,9.406264888888888,766.5465173333333,19.285418460243026,122,1.7E-4
5,test_20231101_134600,11610969.png,368720,29517,339203,0.9199473855500109,3,4,84111,4304,79807,0.9488295228923684,19.500469333333335,2542.365472,14.078423791408932,122,1.7E-4
6,test_20231101_134600,10350842.png,212614,7067,205547,0.9667613609640004,2,4,42529,1036,41493,0.9756401514260857,17.272896,1936.234528,15.261224004330279,122,1.7E-4
7,test_20231101_134600,10863862.png,317432,14152,303280,0.955417223216311,2,4,66058,2034,64024,0.9692088770474432,23.416272,3158.1188533333334,13.136518905548746,122,1.7E-4
8,test_20231101_134600,11382381.png,312486,1159,311327,0.996291033838316,2,3,46745,158,46587,0.9966199593539415,20.606709333333335,2334.900224,14.448120340351833,122,1.7E-4
9,test_20231101_134600,11079715.png,443815,127382,316433,0.7129840136092742,3,4,124136,17736,106400,0.8571244441580202,16.53779911111111,2010.815104,15.097082221479486,122,1.7E-4
10,test_20231101_134600,11551286.png,271883,1322,270561,0.9951376143414631,1,4,40092,194,39898,0.9951611294023746,15.757246222222221,1488.3021066666668,16.40389264375073,122,1.7E-4
1,test_20231101_134601,10404007.png,502730,25187,477543,0.949899548465379,3,4,61265,3630,57635,0.9407492042765038,25.12879288888889,3282.03776,12.969367875434926,122,1.8E-4
2,test_20231101_134601,1254659.png,342646,79962,262684,0.7666337853061177,3,4,80080,11106,68974,0.8613136863136863,20.326528,3020.2829653333333,13.330327276703748,122,1.8E-4
3,test_20231101_134601,10188041.png,221231,10484,210747,0.9526106196690337,2,3,41731,1476,40255,0.9646306103376386,10.29104711111111,967.4823253333333,18.274373211101064,122,1.8E-4
4,test_20231101_134601,10287332.png,216980,13087,203893,0.939685685316619,2,4,22337,1789,20548,0.9199086717106146,9.406264888888888,766.5465173333333,19.285418460243026,122,1.8E-4
5,test_20231101_134601,11610969.png,368720,29517,339203,0.9199473855500109,2,4,84111,4304,79807,0.9488295228923684,19.500469333333335,2542.365472,14.078423791408932,122,1.8E-4
6,test_20231101_134601,10350842.png,212614,7067,205547,0.9667613609640004,1,3,42529,1036,41493,0.9756401514260857,17.272896,1936.234528,15.261224004330279,122,1.8E-4
7,test_20231101_134601,10863862.png,317432,14152,303280,0.955417223216311,2,4,66058,2034,64024,0.9692088770474432,23.416272,3158.1188533333334,13.136518905548746,122,1.8E-4
8,test_20231101_134601,11382381.png,312486,1159,311327,0.996291033838316,1,3,46745,158,46587,0.9966199593539415,20.606709333333335,2334.900224,14.448120340351833,122,1.8E-4
9,test_20231101_134601,11079715.png,443815,127382,316433,0.7129840136092742,4,5,124136,17736,106400,0.8571244441580202,16.53779911111111,2010.815104,15.097082221479486,122,1.8E-4
10,test_20231101_134601,11551286.png,271883,1322,270561,0.9951376143414631,1,3,40092,194,39898,0.9951611294023746,15.757246222222221,1488.3021066666668,16.40389264375073,122,1.8E-4
1,test_20231101_134602,10404007.png,502730,25187,477543,0.949899548465379,2,4,61265,3630,57635,0.9407492042765038,25.12879288888889,3282.03776,12.969367875434926,122,1.9E-4
2,test_20231101_134602,1254659.png,342646,79962,262684,0.7666337853061177,2,4,80080,11106,68974,0.8613136863136863,20.326528,3020.2829653333333,13.330327276703748,122,1.9E-4
3,test_20231101_134602,10188041.png,221231,10484,210747,0.9526106196690337,2,4,41731,1476,40255,0.9646306103376386,10.29104711111111,967.4823253333333,18.274373211101064,122,1.9E-4
4,test_20231101_134602,10287332.png,216980,13087,203893,0.939685685316619,2,3,22337,1789,20548,0.9199086717106146,9.406264888888888,766.5465173333333,19.285418460243026,122,1.9E-4
5,test_20231101_134602,11610969.png,368720,29517,339203,0.9199473855500109,2,3,84111,4304,79807,0.9488295228923684,19.500469333333335,2542.365472,14.078423791408932,122,1.9E-4
6,test_20231101_134602,10350842.png,212614,7067,205547,0.9667613609640004,1,4,42529,1036,41493,0.9756401514260857,17.272896,1936.234528,15.261224004330279,122,1.9E-4
7,test_20231101_134602,10863862.png,317432,14152,303280,0.955417223216311,2,3,66058,2034,64024,0.9692088770474432,23.416272,3158.1188533333334,13.136518905548746,122,1.9E-4
8,test_20231101_134602,11382381.png,312486,1159,311327,0.996291033838316,1,3,46745,158,46587,0.9966199593539415,20.606709333333335,2334.900224,14.448120340351833,122,1.9E-4
9,test_20231101_134602,11079715.png,443815,127382,316433,0.7129840136092742,4,4,124136,17736,106400,0.8571244441580202,16.53779911111111,2010.815104,15.097082221479486,122,1.9E-4
10,test_20231101_134602,11551286.png,271883,1322,270561,0.9951376143414631,2,4,40092,194,39898,0.9951611294023746,15.757246222222221,1488.3021066666668,16.40389264375073,122,1.9E-4
1,test_20231101_134603,10404007.png,502730,25187,477543,0.949899548465379,2,4,61265,3630,57635,0.9407492042765038,25.12879288888889,3282.03776,12.969367875434926,122,2.0E-4
2,test_20231101_134603,1254659.png,342646,79962,262684,0.7666337853061177,3,4,80080,11106,68974,0.8613136863136863,20.326528,3020.2829653333333,13.330327276703748,122,2.0E-4
3,test_20231101_134603,10188041.png,221231,10484,210747,0.9526106196690337,2,3,41731,1476,40255,0.9646306103376386,10.29104711111111,967.4823253333333,18.274373211101064,122,2.0E-4
4,test_20231101_134603,10287332.png,216980,13087,203893,0.939685685316619,2,4,22337,1789,20548,0.9199086717106146,9.406264888888888,766.5465173333333,19.285418460243026,122,2.0E-4
5,test_20231101_134603,11610969.png,368720,29517,339203,0.9199473855500109,2,4,84111,4304,79807,0.9488295228923684,19.500469333333335,2542.365472,14.078423791408932,122,2.0E-4
6,test_20231101_134603,10350842.png,212614,7067,205547,0.9667613609640004,2,4,42529,1036,41493,0.9756401514260857,17.272896,1936.234528,15.261224004330279,122,2.0E-4
7,test_20231101_134603,10863862.png,317432,14152,303280,0.955417223216311,3,4,66058,2034,64024,0.9692088770474432,23.416272,3158.1188533333334,13.136518905548746,122,2.0E-4
8,test_20231101_134603,11382381.png,312486,1159,311327,0.996291033838316,2,4,46745,158,46587,0.9966199593539415,20.606709333333335,2334.900224,14.448120340351833,122,2.0E-4
9,test_20231101_134603,11079715.png,443815,127382,316433,0.7129840136092742,4,4,124136,17736,106400,0.8571244441580202,16.53779911111111,2010.815104,15.097082221479486,122,2.0E-4
10,test_20231101_134603,11551286.png,271883,1322,270561,0.9951376143414631,2,4,40092,194,39898,0.9951611294023746,15.757246222222221,1488.3021066666668,16.40389264375073,122,2.0E-4
1,test_20231101_134603,10404007.png,502730,25187,477543,0.949899548465379,2,4,61265,3630,57635,0.9407492042765038,25.12879288888889,3282.03776,12.969367875434926,122,2.1E-4
2,test_20231101_134603,1254659.png,342646,79962,262684,0.7666337853061177,4,4,80080,11106,68974,0.8613136863136863,20.326528,3020.2829653333333,13.330327276703748,122,2.1E-4
3,test_20231101_134603,10188041.png,221231,10484,210747,0.9526106196690337,2,3,41731,1476,40255,0.9646306103376386,10.29104711111111,967.4823253333333,18.274373211101064,122,2.1E-4
4,test_20231101_134603,10287332.png,216980,13087,203893,0.939685685316619,2,13,22337,1789,20548,0.9199086717106146,9.406264888888888,766.5465173333333,19.285418460243026,122,2.1E-4
5,test_20231101_134603,11610969.png,368720,29517,339203,0.9199473855500109,2,4,84111,4304,79807,0.9488295228923684,19.500469333333335,2542.365472,14.078423791408932,122,2.1E-4
6,test_20231101_134603,10350842.png,212614,7067,205547,0.9667613609640004,2,4,42529,1036,41493,0.9756401514260857,17.272896,1936.234528,15.261224004330279,122,2.1E-4
7,test_20231101_134603,10863862.png,317432,14152,303280,0.955417223216311,2,4,66058,2034,64024,0.9692088770474432,23.416272,3158.1188533333334,13.136518905548746,122,2.1E-4
8,test_20231101_134603,11382381.png,312486,1159,311327,0.996291033838316,2,3,46745,158,46587,0.9966199593539415,20.606709333333335,2334.900224,14.448120340351833,122,2.1E-4
9,test_20231101_134603,11079715.png,443815,127382,316433,0.7129840136092742,4,10,124136,17736,106400,0.8571244441580202,16.53779911111111,2010.815104,15.097082221479486,122,2.1E-4
10,test_20231101_134603,11551286.png,271883,1322,270561,0.9951376143414631,1,8,40092,194,39898,0.9951611294023746,15.757246222222221,1488.3021066666668,16.40389264375073,122,2.1E-4
1,test_20231101_134604,10404007.png,502730,25187,477543,0.949899548465379,3,3,61265,3630,57635,0.9407492042765038,25.12879288888889,3282.03776,12.969367875434926,122,2.2E-4
2,test_20231101_134604,1254659.png,342646,79962,262684,0.7666337853061177,3,4,80080,11106,68974,0.8613136863136863,20.326528,3020.2829653333333,13.330327276703748,122,2.2E-4
3,test_20231101_134604,10188041.png,221231,10484,210747,0.9526106196690337,2,4,41731,1476,40255,0.9646306103376386,10.29104711111111,967.4823253333333,18.274373211101064,122,2.2E-4
4,test_20231101_134604,10287332.png,216980,13087,203893,0.939685685316619,2,5,22337,1789,20548,0.9199086717106146,9.406264888888888,766.5465173333333,19.285418460243026,122,2.2E-4
5,test_20231101_134604,11610969.png,368720,29517,339203,0.9199473855500109,3,4,84111,4304,79807,0.9488295228923684,19.500469333333335,2542.365472,14.078423791408932,122,2.2E-4
6,test_20231101_134604,10350842.png,212614,7067,205547,0.9667613609640004,1,3,42529,1036,41493,0.9756401514260857,17.272896,1936.234528,15.261224004330279,122,2.2E-4
7,test_20231101_134604,10863862.png,317432,14152,303280,0.955417223216311,2,4,66058,2034,64024,0.9692088770474432,23.416272,3158.1188533333334,13.136518905548746,122,2.2E-4
8,test_20231101_134604,11382381.png,312486,1159,311327,0.996291033838316,1,3,46745,158,46587,0.9966199593539415,20.606709333333335,2334.900224,14.448120340351833,122,2.2E-4
9,test_20231101_134604,11079715.png,443815,127382,316433,0.7129840136092742,3,4,124136,17736,106400,0.8571244441580202,16.53779911111111,2010.815104,15.097082221479486,122,2.2E-4
10,test_20231101_134604,11551286.png,271883,1322,270561,0.9951376143414631,1,9,40092,194,39898,0.9951611294023746,15.757246222222221,1488.3021066666668,16.40389264375073,122,2.2E-4
1,test_20231101_134605,10404007.png,502730,25187,477543,0.949899548465379,2,4,61265,3630,57635,0.9407492042765038,25.12879288888889,3282.03776,12.969367875434926,122,2.3E-4
2,test_20231101_134605,1254659.png,342646,79962,262684,0.7666337853061177,3,10,80080,11106,68974,0.8613136863136863,20.326528,3020.2829653333333,13.330327276703748,122,2.3E-4
3,test_20231101_134605,10188041.png,221231,10484,210747,0.9526106196690337,2,3,41731,1476,40255,0.9646306103376386,10.29104711111111,967.4823253333333,18.274373211101064,122,2.3E-4
4,test_20231101_134605,10287332.png,216980,13087,203893,0.939685685316619,1,3,22337,1789,20548,0.9199086717106146,9.406264888888888,766.5465173333333,19.285418460243026,122,2.3E-4
5,test_20231101_134605,11610969.png,368720,29517,339203,0.9199473855500109,2,3,84111,4304,79807,0.9488295228923684,19.500469333333335,2542.365472,14.078423791408932,122,2.3E-4
6,test_20231101_134605,10350842.png,212614,7067,205547,0.9667613609640004,2,4,42529,1036,41493,0.9756401514260857,17.272896,1936.234528,15.261224004330279,122,2.3E-4
7,test_20231101_134605,10863862.png,317432,14152,303280,0.955417223216311,3,4,66058,2034,64024,0.9692088770474432,23.416272,3158.1188533333334,13.136518905548746,122,2.3E-4
8,test_20231101_134605,11382381.png,312486,1159,311327,0.996291033838316,1,4,46745,158,46587,0.9966199593539415,20.606709333333335,2334.900224,14.448120340351833,122,2.3E-4
9,test_20231101_134605,11079715.png,443815,127382,316433,0.7129840136092742,4,4,124136,17736,106400,0.8571244441580202,16.53779911111111,2010.815104,15.097082221479486,122,2.3E-4
10,test_20231101_134605,11551286.png,271883,1322,270561,0.9951376143414631,2,3,40092,194,39898,0.9951611294023746,15.757246222222221,1488.3021066666668,16.40389264375073,122,2.3E-4
1,test_20231101_134605,10404007.png,502730,25187,477543,0.949899548465379,2,9,61265,3630,57635,0.9407492042765038,25.12879288888889,3282.03776,12.969367875434926,122,2.4E-4
2,test_20231101_134605,1254659.png,342646,79962,262684,0.7666337853061177,3,3,80080,11106,68974,0.8613136863136863,20.326528,3020.2829653333333,13.330327276703748,122,2.4E-4
3,test_20231101_134605,10188041.png,221231,10484,210747,0.9526106196690337,2,8,41731,1476,40255,0.9646306103376386,10.29104711111111,967.4823253333333,18.274373211101064,122,2.4E-4
4,test_20231101_134605,10287332.png,216980,13087,203893,0.939685685316619,2,4,22337,1789,20548,0.9199086717106146,9.406264888888888,766.5465173333333,19.285418460243026,122,2.4E-4
5,test_20231101_134605,11610969.png,368720,29517,339203,0.9199473855500109,3,3,84111,4304,79807,0.9488295228923684,19.500469333333335,2542.365472,14.078423791408932,122,2.4E-4
6,test_20231101_134605,10350842.png,212614,7067,205547,0.9667613609640004,1,4,42529,1036,41493,0.9756401514260857,17.272896,1936.234528,15.261224004330279,122,2.4E-4
7,test_20231101_134605,10863862.png,317432,14152,303280,0.955417223216311,2,4,66058,2034,64024,0.9692088770474432,23.416272,3158.1188533333334,13.136518905548746,122,2.4E-4
8,test_20231101_134605,11382381.png,312486,967,311519,0.9969054613646692,2,4,46745,130,46615,0.9972189538988127,21.068341333333333,2406.1475626666665,14.317581029153203,122,2.4E-4
9,test_20231101_134605,11079715.png,443815,127382,316433,0.7129840136092742,4,4,124136,17736,106400,0.8571244441580202,16.53779911111111,2010.815104,15.097082221479486,122,2.4E-4
10,test_20231101_134605,11551286.png,271883,1322,270561,0.9951376143414631,1,4,40092,194,39898,0.9951611294023746,15.757246222222221,1488.3021066666668,16.40389264375073,122,2.4E-4
1,test_20231101_134606,10404007.png,502730,25187,477543,0.949899548465379,2,4,61265,3630,57635,0.9407492042765038,25.12879288888889,3282.03776,12.969367875434926,122,2.5E-4
2,test_20231101_134606,1254659.png,342646,79962,262684,0.7666337853061177,3,4,80080,11106,68974,0.8613136863136863,20.326528,3020.2829653333333,13.330327276703748,122,2.5E-4
3,test_20231101_134606,10188041.png,221231,10484,210747,0.9526106196690337,3,3,41731,1476,40255,0.9646306103376386,10.29104711111111,967.4823253333333,18.274373211101064,122,2.5E-4
4,test_20231101_134606,10287332.png,216980,13087,203893,0.939685685316619,6,3,22337,1789,20548,0.9199086717106146,9.406264888888888,766.5465173333333,19.285418460243026,122,2.5E-4
5,test_20231101_134606,11610969.png,368720,29517,339203,0.9199473855500109,2,4,84111,4304,79807,0.9488295228923684,19.500469333333335,2542.365472,14.078423791408932,122,2.5E-4
6,test_20231101_134606,10350842.png,212614,7067,205547,0.9667613609640004,2,4,42529,1036,41493,0.9756401514260857,17.272896,1936.234528,15.261224004330279,122,2.5E-4
7,test_20231101_134606,10863862.png,317432,14152,303280,0.955417223216311,2,3,66058,2034,64024,0.9692088770474432,23.416272,3158.1188533333334,13.136518905548746,122,2.5E-4
8,test_20231101_134606,11382381.png,312486,967,311519,0.9969054613646692,1,3,46745,130,46615,0.9972189538988127,21.068341333333333,2406.1475626666665,14.317581029153203,122,2.5E-4
9,test_20231101_134606,11079715.png,443815,127382,316433,0.7129840136092742,3,4,124136,17736,106400,0.8571244441580202,16.53779911111111,2010.815104,15.097082221479486,122,2.5E-4
10,test_20231101_134606,11551286.png,271883,1322,270561,0.9951376143414631,2,4,40092,194,39898,0.9951611294023746,15.757246222222221,1488.3021066666668,16.40389264375073,122,2.5E-4
1,test_20231101_134607,10404007.png,502730,24924,477806,0.9504226921011278,2,4,61265,3592,57673,0.9413694605402758,25.162432,3287.893781333333,12.961625820868626,122,2.6000000000000003E-4
2,test_20231101_134607,1254659.png,342646,79902,262744,0.7668088931433608,3,4,80080,11101,68979,0.861376123876124,20.33608177777778,3021.365152,13.328771450566173,122,2.6000000000000003E-4
3,test_20231101_134607,10188041.png,221231,10304,210927,0.9534242488620491,2,4,41731,1450,40281,0.9652536483669215,10.567601777777778,1003.8131733333333,18.114274701111977,122,2.6000000000000003E-4
4,test_20231101_134607,10287332.png,216980,13087,203893,0.939685685316619,1,3,22337,1789,20548,0.9199086717106146,9.406264888888888,766.5465173333333,19.285418460243026,122,2.6000000000000003E-4
5,test_20231101_134607,11610969.png,368720,29457,339263,0.92011011065307,2,3,84111,4297,79814,0.9489127462519765,19.832718222222223,2616.733706666667,13.953208321942551,122,2.6000000000000003E-4
6,test_20231101_134607,10350842.png,212614,6727,205887,0.9683605030712935,2,3,42529,986,41543,0.9768158197935526,18.680309333333334,2252.1961813333332,14.604741430901797,122,2.6000000000000003E-4
7,test_20231101_134607,10863862.png,317432,14072,303360,0.9556692456967162,2,3,66058,2022,64036,0.9693905355899362,23.44550577777778,3163.1715893333335,13.129576095846978,122,2.6000000000000003E-4
8,test_20231101_134607,11382381.png,312486,967,311519,0.9969054613646692,1,3,46745,130,46615,0.9972189538988127,21.068341333333333,2406.1475626666665,14.317581029153203,122,2.6000000000000003E-4
9,test_20231101_134607,11079715.png,443815,127382,316433,0.7129840136092742,4,9,124136,17736,106400,0.8571244441580202,16.53779911111111,2010.815104,15.097082221479486,122,2.6000000000000003E-4
10,test_20231101_134607,11551286.png,271883,1159,270724,0.9957371369302237,1,3,40092,170,39922,0.9957597525690911,16.782250666666666,1659.7933333333333,15.930263449847823,122,2.6000000000000003E-4
1,test_20231101_134607,10404007.png,502730,24924,477806,0.9504226921011278,2,3,61265,3592,57673,0.9413694605402758,25.162432,3287.893781333333,12.961625820868626,122,2.7000000000000006E-4
2,test_20231101_134607,1254659.png,342646,79902,262744,0.7668088931433608,3,11,80080,11101,68979,0.861376123876124,20.33608177777778,3021.365152,13.328771450566173,122,2.7000000000000006E-4
3,test_20231101_134607,10188041.png,221231,10304,210927,0.9534242488620491,2,4,41731,1450,40281,0.9652536483669215,10.567601777777778,1003.8131733333333,18.114274701111977,122,2.7000000000000006E-4
4,test_20231101_134607,10287332.png,216980,13087,203893,0.939685685316619,2,3,22337,1789,20548,0.9199086717106146,9.406264888888888,766.5465173333333,19.285418460243026,122,2.7000000000000006E-4
5,test_20231101_134607,11610969.png,368720,29457,339263,0.92011011065307,2,3,84111,4297,79814,0.9489127462519765,19.832718222222223,2616.733706666667,13.953208321942551,122,2.7000000000000006E-4
6,test_20231101_134607,10350842.png,212614,6727,205887,0.9683605030712935,1,4,42529,986,41543,0.9768158197935526,18.680309333333334,2252.1961813333332,14.604741430901797,122,2.7000000000000006E-4
7,test_20231101_134607,10863862.png,317432,14072,303360,0.9556692456967162,2,4,66058,2022,64036,0.9693905355899362,23.44550577777778,3163.1715893333335,13.129576095846978,122,2.7000000000000006E-4
8,test_20231101_134607,11382381.png,312486,967,311519,0.9969054613646692,1,3,46745,130,46615,0.9972189538988127,21.068341333333333,2406.1475626666665,14.317581029153203,122,2.7000000000000006E-4
9,test_20231101_134607,11079715.png,443815,127382,316433,0.7129840136092742,4,5,124136,17736,106400,0.8571244441580202,16.53779911111111,2010.815104,15.097082221479486,122,2.7000000000000006E-4
10,test_20231101_134607,11551286.png,271883,1159,270724,0.9957371369302237,1,4,40092,170,39922,0.9957597525690911,16.782250666666666,1659.7933333333333,15.930263449847823,122,2.7000000000000006E-4
1,test_20231101_134608,10404007.png,502730,24924,477806,0.9504226921011278,3,3,61265,3592,57673,0.9413694605402758,25.162432,3287.893781333333,12.961625820868626,122,2.800000000000001E-4
2,test_20231101_134608,1254659.png,342646,79902,262744,0.7668088931433608,3,4,80080,11101,68979,0.861376123876124,20.33608177777778,3021.365152,13.328771450566173,122,2.800000000000001E-4
3,test_20231101_134608,10188041.png,221231,10304,210927,0.9534242488620491,2,3,41731,1450,40281,0.9652536483669215,10.567601777777778,1003.8131733333333,18.114274701111977,122,2.800000000000001E-4
4,test_20231101_134608,10287332.png,216980,13087,203893,0.939685685316619,2,4,22337,1789,20548,0.9199086717106146,9.406264888888888,766.5465173333333,19.285418460243026,122,2.800000000000001E-4
5,test_20231101_134608,11610969.png,368720,29457,339263,0.92011011065307,2,3,84111,4297,79814,0.9489127462519765,19.832718222222223,2616.733706666667,13.953208321942551,122,2.800000000000001E-4
6,test_20231101_134608,10350842.png,212614,6727,205887,0.9683605030712935,2,3,42529,986,41543,0.9768158197935526,18.680309333333334,2252.1961813333332,14.604741430901797,122,2.800000000000001E-4
7,test_20231101_134608,10863862.png,317432,14072,303360,0.9556692456967162,2,3,66058,2022,64036,0.9693905355899362,23.44550577777778,3163.1715893333335,13.129576095846978,122,2.800000000000001E-4
8,test_20231101_134608,11382381.png,312486,967,311519,0.9969054613646692,1,3,46745,130,46615,0.9972189538988127,21.068341333333333,2406.1475626666665,14.317581029153203,122,2.800000000000001E-4
9,test_20231101_134608,11079715.png,443815,127382,316433,0.7129840136092742,3,4,124136,17736,106400,0.8571244441580202,16.53779911111111,2010.815104,15.097082221479486,122,2.800000000000001E-4
10,test_20231101_134608,11551286.png,271883,1159,270724,0.9957371369302237,2,3,40092,170,39922,0.9957597525690911,16.782250666666666,1659.7933333333333,15.930263449847823,122,2.800000000000001E-4
1,test_20231101_134609,10404007.png,502730,24924,477806,0.9504226921011278,2,3,61265,3592,57673,0.9413694605402758,25.162432,3287.893781333333,12.961625820868626,122,2.900000000000001E-4
2,test_20231101_134609,1254659.png,342646,79902,262744,0.7668088931433608,4,4,80080,11101,68979,0.861376123876124,20.33608177777778,3021.365152,13.328771450566173,122,2.900000000000001E-4
3,test_20231101_134609,10188041.png,221231,10304,210927,0.9534242488620491,2,3,41731,1450,40281,0.9652536483669215,10.567601777777778,1003.8131733333333,18.114274701111977,122,2.900000000000001E-4
4,test_20231101_134609,10287332.png,216980,13087,203893,0.939685685316619,1,4,22337,1789,20548,0.9199086717106146,9.406264888888888,766.5465173333333,19.285418460243026,122,2.900000000000001E-4
5,test_20231101_134609,11610969.png,368720,29457,339263,0.92011011065307,2,4,84111,4297,79814,0.9489127462519765,19.832718222222223,2616.733706666667,13.953208321942551,122,2.900000000000001E-4
6,test_20231101_134609,10350842.png,212614,6727,205887,0.9683605030712935,1,4,42529,986,41543,0.9768158197935526,18.680309333333334,2252.1961813333332,14.604741430901797,122,2.900000000000001E-4
7,test_20231101_134609,10863862.png,317432,14072,303360,0.9556692456967162,2,4,66058,2022,64036,0.9693905355899362,23.44550577777778,3163.1715893333335,13.129576095846978,122,2.900000000000001E-4
8,test_20231101_134609,11382381.png,312486,967,311519,0.9969054613646692,2,4,46745,130,46615,0.9972189538988127,21.068341333333333,2406.1475626666665,14.317581029153203,122,2.900000000000001E-4
9,test_20231101_134609,11079715.png,443815,127382,316433,0.7129840136092742,3,4,124136,17736,106400,0.8571244441580202,16.53779911111111,2010.815104,15.097082221479486,122,2.900000000000001E-4
10,test_20231101_134609,11551286.png,271883,847,271036,0.9968846893700599,2,4,40092,124,39968,0.9969071136386312,17.065274666666667,1704.2078666666666,15.81557795178707,122,2.900000000000001E-4
1,test_20231101_134609,10404007.png,502730,24924,477806,0.9504226921011278,2,3,61265,3592,57673,0.9413694605402758,25.162432,3287.893781333333,12.961625820868626,122,3.0000000000000014E-4
2,test_20231101_134609,1254659.png,342646,79902,262744,0.7668088931433608,3,4,80080,11101,68979,0.861376123876124,20.33608177777778,3021.365152,13.328771450566173,122,3.0000000000000014E-4
3,test_20231101_134609,10188041.png,221231,10304,210927,0.9534242488620491,2,3,41731,1450,40281,0.9652536483669215,10.567601777777778,1003.8131733333333,18.114274701111977,122,3.0000000000000014E-4
4,test_20231101_134609,10287332.png,216980,13087,203893,0.939685685316619,2,4,22337,1789,20548,0.9199086717106146,9.406264888888888,766.5465173333333,19.285418460243026,122,3.0000000000000014E-4
5,test_20231101_134609,11610969.png,368720,29457,339263,0.92011011065307,2,4,84111,4297,79814,0.9489127462519765,19.832718222222223,2616.733706666667,13.953208321942551,122,3.0000000000000014E-4
6,test_20231101_134609,10350842.png,212614,6727,205887,0.9683605030712935,1,3,42529,986,41543,0.9768158197935526,18.680309333333334,2252.1961813333332,14.604741430901797,122,3.0000000000000014E-4
7,test_20231101_134609,10863862.png,317432,14072,303360,0.9556692456967162,2,3,66058,2022,64036,0.9693905355899362,23.44550577777778,3163.1715893333335,13.129576095846978,122,3.0000000000000014E-4
8,test_20231101_134609,11382381.png,312486,967,311519,0.9969054613646692,2,4,46745,130,46615,0.9972189538988127,21.068341333333333,2406.1475626666665,14.317581029153203,122,3.0000000000000014E-4
9,test_20231101_134609,11079715.png,443815,127382,316433,0.7129840136092742,3,4,124136,17736,106400,0.8571244441580202,16.53779911111111,2010.815104,15.097082221479486,122,3.0000000000000014E-4
10,test_20231101_134609,11551286.png,271883,847,271036,0.9968846893700599,1,4,40092,124,39968,0.9969071136386312,17.065274666666667,1704.2078666666666,15.81557795178707,122,3.0000000000000014E-4
1,test_20231101_134610,10404007.png,502730,24924,477806,0.9504226921011278,2,4,61265,3592,57673,0.9413694605402758,25.162432,3287.893781333333,12.961625820868626,122,3.1000000000000016E-4
2,test_20231101_134610,1254659.png,342646,79902,262744,0.7668088931433608,4,4,80080,11101,68979,0.861376123876124,20.33608177777778,3021.365152,13.328771450566173,122,3.1000000000000016E-4
3,test_20231101_134610,10188041.png,221231,10304,210927,0.9534242488620491,2,3,41731,1450,40281,0.9652536483669215,10.567601777777778,1003.8131733333333,18.114274701111977,122,3.1000000000000016E-4
4,test_20231101_134610,10287332.png,216980,13087,203893,0.939685685316619,1,4,22337,1789,20548,0.9199086717106146,9.406264888888888,766.5465173333333,19.285418460243026,122,3.1000000000000016E-4
5,test_20231101_134610,11610969.png,368720,29457,339263,0.92011011065307,2,4,84111,4297,79814,0.9489127462519765,19.832718222222223,2616.733706666667,13.953208321942551,122,3.1000000000000016E-4
6,test_20231101_134610,10350842.png,212614,6727,205887,0.9683605030712935,2,4,42529,986,41543,0.9768158197935526,18.680309333333334,2252.1961813333332,14.604741430901797,122,3.1000000000000016E-4
7,test_20231101_134610,10863862.png,317432,14072,303360,0.9556692456967162,2,3,66058,2022,64036,0.9693905355899362,23.44550577777778,3163.1715893333335,13.129576095846978,122,3.1000000000000016E-4
8,test_20231101_134610,11382381.png,312486,967,311519,0.9969054613646692,2,3,46745,130,46615,0.9972189538988127,21.068341333333333,2406.1475626666665,14.317581029153203,122,3.1000000000000016E-4
9,test_20231101_134610,11079715.png,443815,127382,316433,0.7129840136092742,3,5,124136,17736,106400,0.8571244441580202,16.53779911111111,2010.815104,15.097082221479486,122,3.1000000000000016E-4
10,test_20231101_134610,11551286.png,271883,847,271036,0.9968846893700599,1,3,40092,124,39968,0.9969071136386312,17.065274666666667,1704.2078666666666,15.81557795178707,122,3.1000000000000016E-4
1,test_20231101_134611,10404007.png,502730,24924,477806,0.9504226921011278,3,3,61265,3592,57673,0.9413694605402758,25.162432,3287.893781333333,12.961625820868626,122,3.200000000000002E-4
2,test_20231101_134611,1254659.png,342646,79902,262744,0.7668088931433608,3,4,80080,11101,68979,0.861376123876124,20.33608177777778,3021.365152,13.328771450566173,122,3.200000000000002E-4
3,test_20231101_134611,10188041.png,221231,10304,210927,0.9534242488620491,2,4,41731,1450,40281,0.9652536483669215,10.567601777777778,1003.8131733333333,18.114274701111977,122,3.200000000000002E-4
4,test_20231101_134611,10287332.png,216980,13087,203893,0.939685685316619,2,3,22337,1789,20548,0.9199086717106146,9.406264888888888,766.5465173333333,19.285418460243026,122,3.200000000000002E-4
5,test_20231101_134611,11610969.png,368720,29457,339263,0.92011011065307,3,4,84111,4297,79814,0.9489127462519765,19.832718222222223,2616.733706666667,13.953208321942551,122,3.200000000000002E-4
6,test_20231101_134611,10350842.png,212614,6727,205887,0.9683605030712935,3,4,42529,986,41543,0.9768158197935526,18.680309333333334,2252.1961813333332,14.604741430901797,122,3.200000000000002E-4
7,test_20231101_134611,10863862.png,317432,14072,303360,0.9556692456967162,2,4,66058,2022,64036,0.9693905355899362,23.44550577777778,3163.1715893333335,13.129576095846978,122,3.200000000000002E-4
8,test_20231101_134611,11382381.png,312486,827,311659,0.9973534814359684,2,4,46745,109,46636,0.997668199807466,21.564144,2476.360432,14.192665047538828,122,3.200000000000002E-4
9,test_20231101_134611,11079715.png,443815,127382,316433,0.7129840136092742,4,5,124136,17736,106400,0.8571244441580202,16.53779911111111,2010.815104,15.097082221479486,122,3.200000000000002E-4
10,test_20231101_134611,11551286.png,271883,607,271276,0.9977674220160878,2,3,40092,88,40004,0.997805048388706,17.77655288888889,1839.618896,15.483524990035365,122,3.200000000000002E-4
1,test_20231101_134612,10404007.png,502730,24924,477806,0.9504226921011278,3,4,61265,3592,57673,0.9413694605402758,25.162432,3287.893781333333,12.961625820868626,122,3.300000000000002E-4
2,test_20231101_134612,1254659.png,342646,79902,262744,0.7668088931433608,2,4,80080,11101,68979,0.861376123876124,20.33608177777778,3021.365152,13.328771450566173,122,3.300000000000002E-4
3,test_20231101_134612,10188041.png,221231,10304,210927,0.9534242488620491,2,4,41731,1450,40281,0.9652536483669215,10.567601777777778,1003.8131733333333,18.114274701111977,122,3.300000000000002E-4
4,test_20231101_134612,10287332.png,216980,13087,203893,0.939685685316619,2,4,22337,1789,20548,0.9199086717106146,9.406264888888888,766.5465173333333,19.285418460243026,122,3.300000000000002E-4
5,test_20231101_134612,11610969.png,368720,29457,339263,0.92011011065307,3,3,84111,4297,79814,0.9489127462519765,19.832718222222223,2616.733706666667,13.953208321942551,122,3.300000000000002E-4
6,test_20231101_134612,10350842.png,212614,6727,205887,0.9683605030712935,2,4,42529,986,41543,0.9768158197935526,18.680309333333334,2252.1961813333332,14.604741430901797,122,3.300000000000002E-4
7,test_20231101_134612,10863862.png,317432,14072,303360,0.9556692456967162,2,4,66058,2022,64036,0.9693905355899362,23.44550577777778,3163.1715893333335,13.129576095846978,122,3.300000000000002E-4
8,test_20231101_134612,11382381.png,312486,827,311659,0.9973534814359684,2,3,46745,109,46636,0.997668199807466,21.564144,2476.360432,14.192665047538828,122,3.300000000000002E-4
9,test_20231101_134612,11079715.png,443815,127382,316433,0.7129840136092742,3,4,124136,17736,106400,0.8571244441580202,16.53779911111111,2010.815104,15.097082221479486,122,3.300000000000002E-4
10,test_20231101_134612,11551286.png,271883,607,271276,0.9977674220160878,2,3,40092,88,40004,0.997805048388706,17.77655288888889,1839.618896,15.483524990035365,122,3.300000000000002E-4
1,test_20231101_134612,10404007.png,502730,24924,477806,0.9504226921011278,4,4,61265,3592,57673,0.9413694605402758,25.162432,3287.893781333333,12.961625820868626,122,3.4000000000000024E-4
2,test_20231101_134612,1254659.png,342646,79902,262744,0.7668088931433608,3,4,80080,11101,68979,0.861376123876124,20.33608177777778,3021.365152,13.328771450566173,122,3.4000000000000024E-4
3,test_20231101_134612,10188041.png,221231,10304,210927,0.9534242488620491,2,4,41731,1450,40281,0.9652536483669215,10.567601777777778,1003.8131733333333,18.114274701111977,122,3.4000000000000024E-4
4,test_20231101_134612,10287332.png,216980,13087,203893,0.939685685316619,2,3,22337,1789,20548,0.9199086717106146,9.406264888888888,766.5465173333333,19.285418460243026,122,3.4000000000000024E-4
5,test_20231101_134612,11610969.png,368720,29457,339263,0.92011011065307,2,4,84111,4297,79814,0.9489127462519765,19.832718222222223,2616.733706666667,13.953208321942551,122,3.4000000000000024E-4
6,test_20231101_134612,10350842.png,212614,6727,205887,0.9683605030712935,1,3,42529,986,41543,0.9768158197935526,18.680309333333334,2252.1961813333332,14.604741430901797,122,3.4000000000000024E-4
7,test_20231101_134612,10863862.png,317432,14072,303360,0.9556692456967162,2,4,66058,2022,64036,0.9693905355899362,23.44550577777778,3163.1715893333335,13.129576095846978,122,3.4000000000000024E-4
8,test_20231101_134612,11382381.png,312486,827,311659,0.9973534814359684,1,3,46745,109,46636,0.997668199807466,21.564144,2476.360432,14.192665047538828,122,3.4000000000000024E-4
9,test_20231101_134612,11079715.png,443815,127382,316433,0.7129840136092742,4,4,124136,17736,106400,0.8571244441580202,16.53779911111111,2010.815104,15.097082221479486,122,3.4000000000000024E-4
10,test_20231101_134612,11551286.png,271883,607,271276,0.9977674220160878,2,3,40092,88,40004,0.997805048388706,17.77655288888889,1839.618896,15.483524990035365,122,3.4000000000000024E-4
1,test_20231101_134613,10404007.png,502730,24924,477806,0.9504226921011278,3,4,61265,3592,57673,0.9413694605402758,25.162432,3287.893781333333,12.961625820868626,122,3.5000000000000027E-4
2,test_20231101_134613,1254659.png,342646,79902,262744,0.7668088931433608,2,4,80080,11101,68979,0.861376123876124,20.33608177777778,3021.365152,13.328771450566173,122,3.5000000000000027E-4
3,test_20231101_134613,10188041.png,221231,10304,210927,0.9534242488620491,2,4,41731,1450,40281,0.9652536483669215,10.567601777777778,1003.8131733333333,18.114274701111977,122,3.5000000000000027E-4
4,test_20231101_134613,10287332.png,216980,13087,203893,0.939685685316619,2,4,22337,1789,20548,0.9199086717106146,9.406264888888888,766.5465173333333,19.285418460243026,122,3.5000000000000027E-4
5,test_20231101_134613,11610969.png,368720,29457,339263,0.92011011065307,2,10,84111,4297,79814,0.9489127462519765,19.832718222222223,2616.733706666667,13.953208321942551,122,3.5000000000000027E-4
6,test_20231101_134613,10350842.png,212614,6727,205887,0.9683605030712935,1,4,42529,986,41543,0.9768158197935526,18.680309333333334,2252.1961813333332,14.604741430901797,122,3.5000000000000027E-4
7,test_20231101_134613,10863862.png,317432,14072,303360,0.9556692456967162,2,4,66058,2022,64036,0.9693905355899362,23.44550577777778,3163.1715893333335,13.129576095846978,122,3.5000000000000027E-4
8,test_20231101_134613,11382381.png,312486,827,311659,0.9973534814359684,1,4,46745,109,46636,0.997668199807466,21.564144,2476.360432,14.192665047538828,122,3.5000000000000027E-4
9,test_20231101_134613,11079715.png,443815,127382,316433,0.7129840136092742,5,4,124136,17736,106400,0.8571244441580202,16.53779911111111,2010.815104,15.097082221479486,122,3.5000000000000027E-4
10,test_20231101_134613,11551286.png,271883,607,271276,0.9977674220160878,1,3,40092,88,40004,0.997805048388706,17.77655288888889,1839.618896,15.483524990035365,122,3.5000000000000027E-4
1,test_20231101_134614,10404007.png,502730,24924,477806,0.9504226921011278,2,3,61265,3592,57673,0.9413694605402758,25.162432,3287.893781333333,12.961625820868626,122,3.600000000000003E-4
2,test_20231101_134614,1254659.png,342646,79902,262744,0.7668088931433608,3,4,80080,11101,68979,0.861376123876124,20.33608177777778,3021.365152,13.328771450566173,122,3.600000000000003E-4
3,test_20231101_134614,10188041.png,221231,10304,210927,0.9534242488620491,2,4,41731,1450,40281,0.9652536483669215,10.567601777777778,1003.8131733333333,18.114274701111977,122,3.600000000000003E-4
4,test_20231101_134614,10287332.png,216980,13087,203893,0.939685685316619,2,4,22337,1789,20548,0.9199086717106146,9.406264888888888,766.5465173333333,19.285418460243026,122,3.600000000000003E-4
5,test_20231101_134614,11610969.png,368720,29457,339263,0.92011011065307,2,4,84111,4297,79814,0.9489127462519765,19.832718222222223,2616.733706666667,13.953208321942551,122,3.600000000000003E-4
6,test_20231101_134614,10350842.png,212614,6727,205887,0.9683605030712935,1,3,42529,986,41543,0.9768158197935526,18.680309333333334,2252.1961813333332,14.604741430901797,122,3.600000000000003E-4
7,test_20231101_134614,10863862.png,317432,14072,303360,0.9556692456967162,2,3,66058,2022,64036,0.9693905355899362,23.44550577777778,3163.1715893333335,13.129576095846978,122,3.600000000000003E-4
8,test_20231101_134614,11382381.png,312486,827,311659,0.9973534814359684,2,3,46745,109,46636,0.997668199807466,21.564144,2476.360432,14.192665047538828,122,3.600000000000003E-4
9,test_20231101_134614,11079715.png,443815,127382,316433,0.7129840136092742,4,4,124136,17736,106400,0.8571244441580202,16.53779911111111,2010.815104,15.097082221479486,122,3.600000000000003E-4
10,test_20231101_134614,11551286.png,271883,607,271276,0.9977674220160878,2,3,40092,88,40004,0.997805048388706,17.77655288888889,1839.618896,15.483524990035365,122,3.600000000000003E-4
1,test_20231101_134614,10404007.png,502730,24924,477806,0.9504226921011278,2,3,61265,3592,57673,0.9413694605402758,25.162432,3287.893781333333,12.961625820868626,122,3.700000000000003E-4
2,test_20231101_134614,1254659.png,342646,79902,262744,0.7668088931433608,3,4,80080,11101,68979,0.861376123876124,20.33608177777778,3021.365152,13.328771450566173,122,3.700000000000003E-4
3,test_20231101_134614,10188041.png,221231,10304,210927,0.9534242488620491,2,4,41731,1450,40281,0.9652536483669215,10.567601777777778,1003.8131733333333,18.114274701111977,122,3.700000000000003E-4
4,test_20231101_134614,10287332.png,216980,13087,203893,0.939685685316619,1,3,22337,1789,20548,0.9199086717106146,9.406264888888888,766.5465173333333,19.285418460243026,122,3.700000000000003E-4
5,test_20231101_134614,11610969.png,368720,29457,339263,0.92011011065307,3,4,84111,4297,79814,0.9489127462519765,19.832718222222223,2616.733706666667,13.953208321942551,122,3.700000000000003E-4
6,test_20231101_134614,10350842.png,212614,6727,205887,0.9683605030712935,1,4,42529,986,41543,0.9768158197935526,18.680309333333334,2252.1961813333332,14.604741430901797,122,3.700000000000003E-4
7,test_20231101_134614,10863862.png,317432,14072,303360,0.9556692456967162,2,4,66058,2022,64036,0.9693905355899362,23.44550577777778,3163.1715893333335,13.129576095846978,122,3.700000000000003E-4
8,test_20231101_134614,11382381.png,312486,827,311659,0.9973534814359684,1,3,46745,109,46636,0.997668199807466,21.564144,2476.360432,14.192665047538828,122,3.700000000000003E-4
9,test_20231101_134614,11079715.png,443815,127382,316433,0.7129840136092742,4,4,124136,17736,106400,0.8571244441580202,16.53779911111111,2010.815104,15.097082221479486,122,3.700000000000003E-4
10,test_20231101_134614,11551286.png,271883,607,271276,0.9977674220160878,1,3,40092,88,40004,0.997805048388706,17.77655288888889,1839.618896,15.483524990035365,122,3.700000000000003E-4
1,test_20231101_134615,10404007.png,502730,24924,477806,0.9504226921011278,2,3,61265,3592,57673,0.9413694605402758,25.162432,3287.893781333333,12.961625820868626,122,3.8000000000000035E-4
2,test_20231101_134615,1254659.png,342646,79902,262744,0.7668088931433608,3,4,80080,11101,68979,0.861376123876124,20.33608177777778,3021.365152,13.328771450566173,122,3.8000000000000035E-4
3,test_20231101_134615,10188041.png,221231,10304,210927,0.9534242488620491,2,4,41731,1450,40281,0.9652536483669215,10.567601777777778,1003.8131733333333,18.114274701111977,122,3.8000000000000035E-4
4,test_20231101_134615,10287332.png,216980,13087,203893,0.939685685316619,1,3,22337,1789,20548,0.9199086717106146,9.406264888888888,766.5465173333333,19.285418460243026,122,3.8000000000000035E-4
5,test_20231101_134615,11610969.png,368720,29457,339263,0.92011011065307,2,4,84111,4297,79814,0.9489127462519765,19.832718222222223,2616.733706666667,13.953208321942551,122,3.8000000000000035E-4
6,test_20231101_134615,10350842.png,212614,6727,205887,0.9683605030712935,1,3,42529,986,41543,0.9768158197935526,18.680309333333334,2252.1961813333332,14.604741430901797,122,3.8000000000000035E-4
7,test_20231101_134615,10863862.png,317432,14072,303360,0.9556692456967162,2,4,66058,2022,64036,0.9693905355899362,23.44550577777778,3163.1715893333335,13.129576095846978,122,3.8000000000000035E-4
8,test_20231101_134615,11382381.png,312486,827,311659,0.9973534814359684,2,4,46745,109,46636,0.997668199807466,21.564144,2476.360432,14.192665047538828,122,3.8000000000000035E-4
9,test_20231101_134615,11079715.png,443815,127382,316433,0.7129840136092742,4,4,124136,17736,106400,0.8571244441580202,16.53779911111111,2010.815104,15.097082221479486,122,3.8000000000000035E-4
10,test_20231101_134615,11551286.png,271883,607,271276,0.9977674220160878,1,4,40092,88,40004,0.997805048388706,17.77655288888889,1839.618896,15.483524990035365,122,3.8000000000000035E-4
1,test_20231101_134616,10404007.png,502730,24924,477806,0.9504226921011278,3,3,61265,3592,57673,0.9413694605402758,25.162432,3287.893781333333,12.961625820868626,122,3.9000000000000037E-4
2,test_20231101_134616,1254659.png,342646,79902,262744,0.7668088931433608,4,4,80080,11101,68979,0.861376123876124,20.33608177777778,3021.365152,13.328771450566173,122,3.9000000000000037E-4
3,test_20231101_134616,10188041.png,221231,10304,210927,0.9534242488620491,2,4,41731,1450,40281,0.9652536483669215,10.567601777777778,1003.8131733333333,18.114274701111977,122,3.9000000000000037E-4
4,test_20231101_134616,10287332.png,216980,13087,203893,0.939685685316619,1,3,22337,1789,20548,0.9199086717106146,9.406264888888888,766.5465173333333,19.285418460243026,122,3.9000000000000037E-4
5,test_20231101_134616,11610969.png,368720,29457,339263,0.92011011065307,2,4,84111,4297,79814,0.9489127462519765,19.832718222222223,2616.733706666667,13.953208321942551,122,3.9000000000000037E-4
6,test_20231101_134616,10350842.png,212614,6727,205887,0.9683605030712935,1,3,42529,986,41543,0.9768158197935526,18.680309333333334,2252.1961813333332,14.604741430901797,122,3.9000000000000037E-4
7,test_20231101_134616,10863862.png,317432,14072,303360,0.9556692456967162,2,4,66058,2022,64036,0.9693905355899362,23.44550577777778,3163.1715893333335,13.129576095846978,122,3.9000000000000037E-4
8,test_20231101_134616,11382381.png,312486,827,311659,0.9973534814359684,1,3,46745,109,46636,0.997668199807466,21.564144,2476.360432,14.192665047538828,122,3.9000000000000037E-4
9,test_20231101_134616,11079715.png,443815,127382,316433,0.7129840136092742,3,4,124136,17736,106400,0.8571244441580202,16.53779911111111,2010.815104,15.097082221479486,122,3.9000000000000037E-4
10,test_20231101_134616,11551286.png,271883,607,271276,0.9977674220160878,2,3,40092,88,40004,0.997805048388706,17.77655288888889,1839.618896,15.483524990035365,122,3.9000000000000037E-4
1,test_20231101_134616,10404007.png,502730,24924,477806,0.9504226921011278,3,3,61265,3592,57673,0.9413694605402758,25.162432,3287.893781333333,12.961625820868626,122,4.000000000000004E-4
2,test_20231101_134616,1254659.png,342646,79902,262744,0.7668088931433608,3,4,80080,11101,68979,0.861376123876124,20.33608177777778,3021.365152,13.328771450566173,122,4.000000000000004E-4
3,test_20231101_134616,10188041.png,221231,10304,210927,0.9534242488620491,2,3,41731,1450,40281,0.9652536483669215,10.567601777777778,1003.8131733333333,18.114274701111977,122,4.000000000000004E-4
4,test_20231101_134616,10287332.png,216980,13087,203893,0.939685685316619,2,4,22337,1789,20548,0.9199086717106146,9.406264888888888,766.5465173333333,19.285418460243026,122,4.000000000000004E-4
5,test_20231101_134616,11610969.png,368720,29457,339263,0.92011011065307,2,4,84111,4297,79814,0.9489127462519765,19.832718222222223,2616.733706666667,13.953208321942551,122,4.000000000000004E-4
6,test_20231101_134616,10350842.png,212614,6727,205887,0.9683605030712935,1,3,42529,986,41543,0.9768158197935526,18.680309333333334,2252.1961813333332,14.604741430901797,122,4.000000000000004E-4
7,test_20231101_134616,10863862.png,317432,14072,303360,0.9556692456967162,2,4,66058,2022,64036,0.9693905355899362,23.44550577777778,3163.1715893333335,13.129576095846978,122,4.000000000000004E-4
8,test_20231101_134616,11382381.png,312486,827,311659,0.9973534814359684,1,3,46745,109,46636,0.997668199807466,21.564144,2476.360432,14.192665047538828,122,4.000000000000004E-4
9,test_20231101_134616,11079715.png,443815,127382,316433,0.7129840136092742,3,4,124136,17736,106400,0.8571244441580202,16.53779911111111,2010.815104,15.097082221479486,122,4.000000000000004E-4
10,test_20231101_134616,11551286.png,271883,607,271276,0.9977674220160878,1,4,40092,88,40004,0.997805048388706,17.77655288888889,1839.618896,15.483524990035365,122,4.000000000000004E-4
1,test_20231101_134617,10404007.png,502730,24924,477806,0.9504226921011278,2,4,61265,3592,57673,0.9413694605402758,25.162432,3287.893781333333,12.961625820868626,122,4.100000000000004E-4
2,test_20231101_134617,1254659.png,342646,79902,262744,0.7668088931433608,3,4,80080,11101,68979,0.861376123876124,20.33608177777778,3021.365152,13.328771450566173,122,4.100000000000004E-4
3,test_20231101_134617,10188041.png,221231,10304,210927,0.9534242488620491,2,3,41731,1450,40281,0.9652536483669215,10.567601777777778,1003.8131733333333,18.114274701111977,122,4.100000000000004E-4
4,test_20231101_134617,10287332.png,216980,13087,203893,0.939685685316619,2,4,22337,1789,20548,0.9199086717106146,9.406264888888888,766.5465173333333,19.285418460243026,122,4.100000000000004E-4
5,test_20231101_134617,11610969.png,368720,29457,339263,0.92011011065307,2,4,84111,4297,79814,0.9489127462519765,19.832718222222223,2616.733706666667,13.953208321942551,122,4.100000000000004E-4
6,test_20231101_134617,10350842.png,212614,6727,205887,0.9683605030712935,1,4,42529,986,41543,0.9768158197935526,18.680309333333334,2252.1961813333332,14.604741430901797,122,4.100000000000004E-4
7,test_20231101_134617,10863862.png,317432,14072,303360,0.9556692456967162,2,4,66058,2022,64036,0.9693905355899362,23.44550577777778,3163.1715893333335,13.129576095846978,122,4.100000000000004E-4
8,test_20231101_134617,11382381.png,312486,827,311659,0.9973534814359684,1,4,46745,109,46636,0.997668199807466,21.564144,2476.360432,14.192665047538828,122,4.100000000000004E-4
9,test_20231101_134617,11079715.png,443815,127382,316433,0.7129840136092742,4,4,124136,17736,106400,0.8571244441580202,16.53779911111111,2010.815104,15.097082221479486,122,4.100000000000004E-4
10,test_20231101_134617,11551286.png,271883,607,271276,0.9977674220160878,1,3,40092,88,40004,0.997805048388706,17.77655288888889,1839.618896,15.483524990035365,122,4.100000000000004E-4
1,test_20231101_134618,10404007.png,502730,24924,477806,0.9504226921011278,2,4,61265,3592,57673,0.9413694605402758,25.162432,3287.893781333333,12.961625820868626,122,4.2000000000000045E-4
2,test_20231101_134618,1254659.png,342646,79902,262744,0.7668088931433608,3,4,80080,11101,68979,0.861376123876124,20.33608177777778,3021.365152,13.328771450566173,122,4.2000000000000045E-4
3,test_20231101_134618,10188041.png,221231,10304,210927,0.9534242488620491,2,5,41731,1450,40281,0.9652536483669215,10.567601777777778,1003.8131733333333,18.114274701111977,122,4.2000000000000045E-4
4,test_20231101_134618,10287332.png,216980,13087,203893,0.939685685316619,2,4,22337,1789,20548,0.9199086717106146,9.406264888888888,766.5465173333333,19.285418460243026,122,4.2000000000000045E-4
5,test_20231101_134618,11610969.png,368720,29457,339263,0.92011011065307,3,3,84111,4297,79814,0.9489127462519765,19.832718222222223,2616.733706666667,13.953208321942551,122,4.2000000000000045E-4
6,test_20231101_134618,10350842.png,212614,6727,205887,0.9683605030712935,2,3,42529,986,41543,0.9768158197935526,18.680309333333334,2252.1961813333332,14.604741430901797,122,4.2000000000000045E-4
7,test_20231101_134618,10863862.png,317432,14072,303360,0.9556692456967162,2,4,66058,2022,64036,0.9693905355899362,23.44550577777778,3163.1715893333335,13.129576095846978,122,4.2000000000000045E-4
8,test_20231101_134618,11382381.png,312486,827,311659,0.9973534814359684,1,3,46745,109,46636,0.997668199807466,21.564144,2476.360432,14.192665047538828,122,4.2000000000000045E-4
9,test_20231101_134618,11079715.png,443815,127382,316433,0.7129840136092742,3,4,124136,17736,106400,0.8571244441580202,16.53779911111111,2010.815104,15.097082221479486,122,4.2000000000000045E-4
10,test_20231101_134618,11551286.png,271883,607,271276,0.9977674220160878,1,4,40092,88,40004,0.997805048388706,17.77655288888889,1839.618896,15.483524990035365,122,4.2000000000000045E-4
1,test_20231101_134618,10404007.png,502730,24924,477806,0.9504226921011278,2,4,61265,3592,57673,0.9413694605402758,25.162432,3287.893781333333,12.961625820868626,122,4.300000000000005E-4
2,test_20231101_134618,1254659.png,342646,79902,262744,0.7668088931433608,3,4,80080,11101,68979,0.861376123876124,20.33608177777778,3021.365152,13.328771450566173,122,4.300000000000005E-4
3,test_20231101_134618,10188041.png,221231,10304,210927,0.9534242488620491,2,4,41731,1450,40281,0.9652536483669215,10.567601777777778,1003.8131733333333,18.114274701111977,122,4.300000000000005E-4
4,test_20231101_134618,10287332.png,216980,13087,203893,0.939685685316619,2,3,22337,1789,20548,0.9199086717106146,9.406264888888888,766.5465173333333,19.285418460243026,122,4.300000000000005E-4
5,test_20231101_134618,11610969.png,368720,29457,339263,0.92011011065307,3,3,84111,4297,79814,0.9489127462519765,19.832718222222223,2616.733706666667,13.953208321942551,122,4.300000000000005E-4
6,test_20231101_134618,10350842.png,212614,6727,205887,0.9683605030712935,2,3,42529,986,41543,0.9768158197935526,18.680309333333334,2252.1961813333332,14.604741430901797,122,4.300000000000005E-4
7,test_20231101_134618,10863862.png,317432,14072,303360,0.9556692456967162,2,3,66058,2022,64036,0.9693905355899362,23.44550577777778,3163.1715893333335,13.129576095846978,122,4.300000000000005E-4
8,test_20231101_134618,11382381.png,312486,827,311659,0.9973534814359684,1,4,46745,109,46636,0.997668199807466,21.564144,2476.360432,14.192665047538828,122,4.300000000000005E-4
9,test_20231101_134618,11079715.png,443815,127382,316433,0.7129840136092742,3,5,124136,17736,106400,0.8571244441580202,16.53779911111111,2010.815104,15.097082221479486,122,4.300000000000005E-4
10,test_20231101_134618,11551286.png,271883,607,271276,0.9977674220160878,1,3,40092,88,40004,0.997805048388706,17.77655288888889,1839.618896,15.483524990035365,122,4.300000000000005E-4
1,test_20231101_134619,10404007.png,502730,24924,477806,0.9504226921011278,3,4,61265,3592,57673,0.9413694605402758,25.162432,3287.893781333333,12.961625820868626,122,4.400000000000005E-4
2,test_20231101_134619,1254659.png,342646,79902,262744,0.7668088931433608,3,4,80080,11101,68979,0.861376123876124,20.33608177777778,3021.365152,13.328771450566173,122,4.400000000000005E-4
3,test_20231101_134619,10188041.png,221231,10304,210927,0.9534242488620491,2,3,41731,1450,40281,0.9652536483669215,10.567601777777778,1003.8131733333333,18.114274701111977,122,4.400000000000005E-4
4,test_20231101_134619,10287332.png,216980,13087,203893,0.939685685316619,2,3,22337,1789,20548,0.9199086717106146,9.406264888888888,766.5465173333333,19.285418460243026,122,4.400000000000005E-4
5,test_20231101_134619,11610969.png,368720,29457,339263,0.92011011065307,2,3,84111,4297,79814,0.9489127462519765,19.832718222222223,2616.733706666667,13.953208321942551,122,4.400000000000005E-4
6,test_20231101_134619,10350842.png,212614,6727,205887,0.9683605030712935,1,3,42529,986,41543,0.9768158197935526,18.680309333333334,2252.1961813333332,14.604741430901797,122,4.400000000000005E-4
7,test_20231101_134619,10863862.png,317432,14072,303360,0.9556692456967162,2,3,66058,2022,64036,0.9693905355899362,23.44550577777778,3163.1715893333335,13.129576095846978,122,4.400000000000005E-4
8,test_20231101_134619,11382381.png,312486,827,311659,0.9973534814359684,1,6,46745,109,46636,0.997668199807466,21.564144,2476.360432,14.192665047538828,122,4.400000000000005E-4
9,test_20231101_134619,11079715.png,443815,127382,316433,0.7129840136092742,3,4,124136,17736,106400,0.8571244441580202,16.53779911111111,2010.815104,15.097082221479486,122,4.400000000000005E-4
10,test_20231101_134619,11551286.png,271883,607,271276,0.9977674220160878,1,8,40092,88,40004,0.997805048388706,17.77655288888889,1839.618896,15.483524990035365,122,4.400000000000005E-4
1,test_20231101_134620,10404007.png,502730,24924,477806,0.9504226921011278,3,4,61265,3592,57673,0.9413694605402758,25.162432,3287.893781333333,12.961625820868626,122,4.5000000000000053E-4
2,test_20231101_134620,1254659.png,342646,79902,262744,0.7668088931433608,3,4,80080,11101,68979,0.861376123876124,20.33608177777778,3021.365152,13.328771450566173,122,4.5000000000000053E-4
3,test_20231101_134620,10188041.png,221231,10304,210927,0.9534242488620491,2,4,41731,1450,40281,0.9652536483669215,10.567601777777778,1003.8131733333333,18.114274701111977,122,4.5000000000000053E-4
4,test_20231101_134620,10287332.png,216980,13087,203893,0.939685685316619,2,4,22337,1789,20548,0.9199086717106146,9.406264888888888,766.5465173333333,19.285418460243026,122,4.5000000000000053E-4
5,test_20231101_134620,11610969.png,368720,29457,339263,0.92011011065307,4,4,84111,4297,79814,0.9489127462519765,19.832718222222223,2616.733706666667,13.953208321942551,122,4.5000000000000053E-4
6,test_20231101_134620,10350842.png,212614,6727,205887,0.9683605030712935,1,4,42529,986,41543,0.9768158197935526,18.680309333333334,2252.1961813333332,14.604741430901797,122,4.5000000000000053E-4
7,test_20231101_134620,10863862.png,317432,14072,303360,0.9556692456967162,2,4,66058,2022,64036,0.9693905355899362,23.44550577777778,3163.1715893333335,13.129576095846978,122,4.5000000000000053E-4
8,test_20231101_134620,11382381.png,312486,827,311659,0.9973534814359684,2,3,46745,109,46636,0.997668199807466,21.564144,2476.360432,14.192665047538828,122,4.5000000000000053E-4
9,test_20231101_134620,11079715.png,443815,127382,316433,0.7129840136092742,4,4,124136,17736,106400,0.8571244441580202,16.53779911111111,2010.815104,15.097082221479486,122,4.5000000000000053E-4
10,test_20231101_134620,11551286.png,271883,607,271276,0.9977674220160878,1,4,40092,88,40004,0.997805048388706,17.77655288888889,1839.618896,15.483524990035365,122,4.5000000000000053E-4
1,test_20231101_134620,10404007.png,502730,24924,477806,0.9504226921011278,3,4,61265,3592,57673,0.9413694605402758,25.162432,3287.893781333333,12.961625820868626,122,4.6000000000000056E-4
2,test_20231101_134620,1254659.png,342646,79902,262744,0.7668088931433608,4,4,80080,11101,68979,0.861376123876124,20.33608177777778,3021.365152,13.328771450566173,122,4.6000000000000056E-4
3,test_20231101_134620,10188041.png,221231,10304,210927,0.9534242488620491,2,4,41731,1450,40281,0.9652536483669215,10.567601777777778,1003.8131733333333,18.114274701111977,122,4.6000000000000056E-4
4,test_20231101_134620,10287332.png,216980,13087,203893,0.939685685316619,1,3,22337,1789,20548,0.9199086717106146,9.406264888888888,766.5465173333333,19.285418460243026,122,4.6000000000000056E-4
5,test_20231101_134620,11610969.png,368720,29457,339263,0.92011011065307,3,4,84111,4297,79814,0.9489127462519765,19.832718222222223,2616.733706666667,13.953208321942551,122,4.6000000000000056E-4
6,test_20231101_134620,10350842.png,212614,6727,205887,0.9683605030712935,1,4,42529,986,41543,0.9768158197935526,18.680309333333334,2252.1961813333332,14.604741430901797,122,4.6000000000000056E-4
7,test_20231101_134620,10863862.png,317432,14072,303360,0.9556692456967162,2,3,66058,2022,64036,0.9693905355899362,23.44550577777778,3163.1715893333335,13.129576095846978,122,4.6000000000000056E-4
8,test_20231101_134620,11382381.png,312486,827,311659,0.9973534814359684,1,3,46745,109,46636,0.997668199807466,21.564144,2476.360432,14.192665047538828,122,4.6000000000000056E-4
9,test_20231101_134620,11079715.png,443815,127382,316433,0.7129840136092742,3,4,124136,17736,106400,0.8571244441580202,16.53779911111111,2010.815104,15.097082221479486,122,4.6000000000000056E-4
10,test_20231101_134620,11551286.png,271883,607,271276,0.9977674220160878,1,3,40092,88,40004,0.997805048388706,17.77655288888889,1839.618896,15.483524990035365,122,4.6000000000000056E-4
1,test_20231101_134621,10404007.png,502730,24924,477806,0.9504226921011278,3,3,61265,3592,57673,0.9413694605402758,25.162432,3287.893781333333,12.961625820868626,122,4.700000000000006E-4
2,test_20231101_134621,1254659.png,342646,79902,262744,0.7668088931433608,3,4,80080,11101,68979,0.861376123876124,20.33608177777778,3021.365152,13.328771450566173,122,4.700000000000006E-4
3,test_20231101_134621,10188041.png,221231,10304,210927,0.9534242488620491,2,3,41731,1450,40281,0.9652536483669215,10.567601777777778,1003.8131733333333,18.114274701111977,122,4.700000000000006E-4
4,test_20231101_134621,10287332.png,216980,13087,203893,0.939685685316619,2,4,22337,1789,20548,0.9199086717106146,9.406264888888888,766.5465173333333,19.285418460243026,122,4.700000000000006E-4
5,test_20231101_134621,11610969.png,368720,29457,339263,0.92011011065307,2,4,84111,4297,79814,0.9489127462519765,19.832718222222223,2616.733706666667,13.953208321942551,122,4.700000000000006E-4
6,test_20231101_134621,10350842.png,212614,6727,205887,0.9683605030712935,1,3,42529,986,41543,0.9768158197935526,18.680309333333334,2252.1961813333332,14.604741430901797,122,4.700000000000006E-4
7,test_20231101_134621,10863862.png,317432,14072,303360,0.9556692456967162,2,3,66058,2022,64036,0.9693905355899362,23.44550577777778,3163.1715893333335,13.129576095846978,122,4.700000000000006E-4
8,test_20231101_134621,11382381.png,312486,827,311659,0.9973534814359684,2,4,46745,109,46636,0.997668199807466,21.564144,2476.360432,14.192665047538828,122,4.700000000000006E-4
9,test_20231101_134621,11079715.png,443815,127382,316433,0.7129840136092742,3,4,124136,17736,106400,0.8571244441580202,16.53779911111111,2010.815104,15.097082221479486,122,4.700000000000006E-4
10,test_20231101_134621,11551286.png,271883,607,271276,0.9977674220160878,1,3,40092,88,40004,0.997805048388706,17.77655288888889,1839.618896,15.483524990035365,122,4.700000000000006E-4
1,test_20231101_134622,10404007.png,502730,24924,477806,0.9504226921011278,3,4,61265,3592,57673,0.9413694605402758,25.162432,3287.893781333333,12.961625820868626,122,4.800000000000006E-4
2,test_20231101_134622,1254659.png,342646,79902,262744,0.7668088931433608,3,4,80080,11101,68979,0.861376123876124,20.33608177777778,3021.365152,13.328771450566173,122,4.800000000000006E-4
3,test_20231101_134622,10188041.png,221231,10304,210927,0.9534242488620491,2,4,41731,1450,40281,0.9652536483669215,10.567601777777778,1003.8131733333333,18.114274701111977,122,4.800000000000006E-4
4,test_20231101_134622,10287332.png,216980,13087,203893,0.939685685316619,1,4,22337,1789,20548,0.9199086717106146,9.406264888888888,766.5465173333333,19.285418460243026,122,4.800000000000006E-4
5,test_20231101_134622,11610969.png,368720,29457,339263,0.92011011065307,3,3,84111,4297,79814,0.9489127462519765,19.832718222222223,2616.733706666667,13.953208321942551,122,4.800000000000006E-4
6,test_20231101_134622,10350842.png,212614,6727,205887,0.9683605030712935,2,4,42529,986,41543,0.9768158197935526,18.680309333333334,2252.1961813333332,14.604741430901797,122,4.800000000000006E-4
7,test_20231101_134622,10863862.png,317432,14072,303360,0.9556692456967162,2,3,66058,2022,64036,0.9693905355899362,23.44550577777778,3163.1715893333335,13.129576095846978,122,4.800000000000006E-4
8,test_20231101_134622,11382381.png,312486,827,311659,0.9973534814359684,2,3,46745,109,46636,0.997668199807466,21.564144,2476.360432,14.192665047538828,122,4.800000000000006E-4
9,test_20231101_134622,11079715.png,443815,127382,316433,0.7129840136092742,4,5,124136,17736,106400,0.8571244441580202,16.53779911111111,2010.815104,15.097082221479486,122,4.800000000000006E-4
10,test_20231101_134622,11551286.png,271883,607,271276,0.9977674220160878,2,3,40092,88,40004,0.997805048388706,17.77655288888889,1839.618896,15.483524990035365,122,4.800000000000006E-4
1,test_20231101_134622,10404007.png,502730,24924,477806,0.9504226921011278,3,3,61265,3592,57673,0.9413694605402758,25.162432,3287.893781333333,12.961625820868626,122,4.900000000000006E-4
2,test_20231101_134622,1254659.png,342646,79902,262744,0.7668088931433608,3,4,80080,11101,68979,0.861376123876124,20.33608177777778,3021.365152,13.328771450566173,122,4.900000000000006E-4
3,test_20231101_134622,10188041.png,221231,10304,210927,0.9534242488620491,2,4,41731,1450,40281,0.9652536483669215,10.567601777777778,1003.8131733333333,18.114274701111977,122,4.900000000000006E-4
4,test_20231101_134622,10287332.png,216980,13087,203893,0.939685685316619,1,3,22337,1789,20548,0.9199086717106146,9.406264888888888,766.5465173333333,19.285418460243026,122,4.900000000000006E-4
5,test_20231101_134622,11610969.png,368720,29457,339263,0.92011011065307,2,3,84111,4297,79814,0.9489127462519765,19.832718222222223,2616.733706666667,13.953208321942551,122,4.900000000000006E-4
6,test_20231101_134622,10350842.png,212614,6727,205887,0.9683605030712935,2,4,42529,986,41543,0.9768158197935526,18.680309333333334,2252.1961813333332,14.604741430901797,122,4.900000000000006E-4
7,test_20231101_134622,10863862.png,317432,14072,303360,0.9556692456967162,2,3,66058,2022,64036,0.9693905355899362,23.44550577777778,3163.1715893333335,13.129576095846978,122,4.900000000000006E-4
8,test_20231101_134622,11382381.png,312486,827,311659,0.9973534814359684,1,4,46745,109,46636,0.997668199807466,21.564144,2476.360432,14.192665047538828,122,4.900000000000006E-4
9,test_20231101_134622,11079715.png,443815,127382,316433,0.7129840136092742,3,4,124136,17736,106400,0.8571244441580202,16.53779911111111,2010.815104,15.097082221479486,122,4.900000000000006E-4
10,test_20231101_134622,11551286.png,271883,607,271276,0.9977674220160878,1,4,40092,88,40004,0.997805048388706,17.77655288888889,1839.618896,15.483524990035365,122,4.900000000000006E-4
1,test_20231101_134623,10404007.png,502730,24924,477806,0.9504226921011278,2,3,61265,3592,57673,0.9413694605402758,25.162432,3287.893781333333,12.961625820868626,122,5.000000000000007E-4
2,test_20231101_134623,1254659.png,342646,79902,262744,0.7668088931433608,3,4,80080,11101,68979,0.861376123876124,20.33608177777778,3021.365152,13.328771450566173,122,5.000000000000007E-4
3,test_20231101_134623,10188041.png,221231,10304,210927,0.9534242488620491,2,4,41731,1450,40281,0.9652536483669215,10.567601777777778,1003.8131733333333,18.114274701111977,122,5.000000000000007E-4
4,test_20231101_134623,10287332.png,216980,13087,203893,0.939685685316619,2,3,22337,1789,20548,0.9199086717106146,9.406264888888888,766.5465173333333,19.285418460243026,122,5.000000000000007E-4
5,test_20231101_134623,11610969.png,368720,29457,339263,0.92011011065307,3,4,84111,4297,79814,0.9489127462519765,19.832718222222223,2616.733706666667,13.953208321942551,122,5.000000000000007E-4
6,test_20231101_134623,10350842.png,212614,6727,205887,0.9683605030712935,1,3,42529,986,41543,0.9768158197935526,18.680309333333334,2252.1961813333332,14.604741430901797,122,5.000000000000007E-4
7,test_20231101_134623,10863862.png,317432,14072,303360,0.9556692456967162,2,4,66058,2022,64036,0.9693905355899362,23.44550577777778,3163.1715893333335,13.129576095846978,122,5.000000000000007E-4
8,test_20231101_134623,11382381.png,312486,827,311659,0.9973534814359684,2,3,46745,109,46636,0.997668199807466,21.564144,2476.360432,14.192665047538828,122,5.000000000000007E-4
9,test_20231101_134623,11079715.png,443815,127382,316433,0.7129840136092742,4,5,124136,17736,106400,0.8571244441580202,16.53779911111111,2010.815104,15.097082221479486,122,5.000000000000007E-4
10,test_20231101_134623,11551286.png,271883,607,271276,0.9977674220160878,1,4,40092,88,40004,0.997805048388706,17.77655288888889,1839.618896,15.483524990035365,122,5.000000000000007E-4
1,test_20231101_134624,10404007.png,502730,24824,477906,0.9506216060310704,3,3,61265,3579,57686,0.9415816534726189,25.164672,3288.327072,12.961053529426284,122,5.100000000000007E-4
2,test_20231101_134624,1254659.png,342646,79902,262744,0.7668088931433608,3,4,80080,11101,68979,0.861376123876124,20.33608177777778,3021.365152,13.328771450566173,122,5.100000000000007E-4
3,test_20231101_134624,10188041.png,221231,10304,210927,0.9534242488620491,2,3,41731,1450,40281,0.9652536483669215,10.567601777777778,1003.8131733333333,18.114274701111977,122,5.100000000000007E-4
4,test_20231101_134624,10287332.png,216980,13087,203893,0.939685685316619,1,4,22337,1789,20548,0.9199086717106146,9.406264888888888,766.5465173333333,19.285418460243026,122,5.100000000000007E-4
5,test_20231101_134624,11610969.png,368720,29117,339603,0.9210322195704057,2,4,84111,4247,79864,0.9495071988206061,20.25163022222222,2703.2300906666665,13.811973477796158,122,5.100000000000007E-4
6,test_20231101_134624,10350842.png,212614,6607,206007,0.9689249061679852,2,3,42529,968,41561,0.9772390604058407,19.040565333333333,2318.447829333333,14.478830331991979,122,5.100000000000007E-4
7,test_20231101_134624,10863862.png,317432,14012,303420,0.9558582625570201,3,6,66058,2013,64045,0.9695267794968059,23.48735466666667,3165.0385226666667,13.127013605493714,122,5.100000000000007E-4
8,test_20231101_134624,11382381.png,312486,827,311659,0.9973534814359684,2,4,46745,109,46636,0.997668199807466,21.564144,2476.360432,14.192665047538828,122,5.100000000000007E-4
9,test_20231101_134624,11079715.png,443815,127382,316433,0.7129840136092742,5,5,124136,17736,106400,0.8571244441580202,16.53779911111111,2010.815104,15.097082221479486,122,5.100000000000007E-4
10,test_20231101_134624,11551286.png,271883,527,271356,0.9980616662314304,2,4,40092,76,40016,0.9981043599720643,17.926654222222222,1858.3108106666666,15.43962007470492,122,5.100000000000007E-4
1,test_20231101_134625,10404007.png,502730,24502,478228,0.9512621088854852,3,4,61265,3533,57732,0.9423324900024483,25.254716444444444,3308.321610666667,12.934726390234932,122,5.200000000000007E-4
2,test_20231101_134625,1254659.png,342646,79902,262744,0.7668088931433608,6,4,80080,11101,68979,0.861376123876124,20.33608177777778,3021.365152,13.328771450566173,122,5.200000000000007E-4
3,test_20231101_134625,10188041.png,221231,10304,210927,0.9534242488620491,2,3,41731,1450,40281,0.9652536483669215,10.567601777777778,1003.8131733333333,18.114274701111977,122,5.200000000000007E-4
4,test_20231101_134625,10287332.png,216980,13087,203893,0.939685685316619,2,4,22337,1789,20548,0.9199086717106146,9.406264888888888,766.5465173333333,19.285418460243026,122,5.200000000000007E-4
5,test_20231101_134625,11610969.png,368720,29117,339603,0.9210322195704057,3,4,84111,4247,79864,0.9495071988206061,20.25163022222222,2703.2300906666665,13.811973477796158,122,5.200000000000007E-4
6,test_20231101_134625,10350842.png,212614,6607,206007,0.9689249061679852,2,4,42529,968,41561,0.9772390604058407,19.040565333333333,2318.447829333333,14.478830331991979,122,5.200000000000007E-4
7,test_20231101_134625,10863862.png,317432,14012,303420,0.9558582625570201,2,4,66058,2013,64045,0.9695267794968059,23.48735466666667,3165.0385226666667,13.127013605493714,122,5.200000000000007E-4
8,test_20231101_134625,11382381.png,312486,827,311659,0.9973534814359684,1,3,46745,109,46636,0.997668199807466,21.564144,2476.360432,14.192665047538828,122,5.200000000000007E-4
9,test_20231101_134625,11079715.png,443815,127382,316433,0.7129840136092742,4,4,124136,17736,106400,0.8571244441580202,16.53779911111111,2010.815104,15.097082221479486,122,5.200000000000007E-4
10,test_20231101_134625,11551286.png,271883,527,271356,0.9980616662314304,1,4,40092,76,40016,0.9981043599720643,17.926654222222222,1858.3108106666666,15.43962007470492,122,5.200000000000007E-4
1,test_20231101_134625,10404007.png,502730,24502,478228,0.9512621088854852,3,4,61265,3533,57732,0.9423324900024483,25.254716444444444,3308.321610666667,12.934726390234932,122,5.300000000000007E-4
2,test_20231101_134625,1254659.png,342646,79902,262744,0.7668088931433608,3,4,80080,11101,68979,0.861376123876124,20.33608177777778,3021.365152,13.328771450566173,122,5.300000000000007E-4
3,test_20231101_134625,10188041.png,221231,10304,210927,0.9534242488620491,2,4,41731,1450,40281,0.9652536483669215,10.567601777777778,1003.8131733333333,18.114274701111977,122,5.300000000000007E-4
4,test_20231101_134625,10287332.png,216980,13087,203893,0.939685685316619,2,3,22337,1789,20548,0.9199086717106146,9.406264888888888,766.5465173333333,19.285418460243026,122,5.300000000000007E-4
5,test_20231101_134625,11610969.png,368720,29117,339603,0.9210322195704057,3,3,84111,4247,79864,0.9495071988206061,20.25163022222222,2703.2300906666665,13.811973477796158,122,5.300000000000007E-4
6,test_20231101_134625,10350842.png,212614,6607,206007,0.9689249061679852,1,4,42529,968,41561,0.9772390604058407,19.040565333333333,2318.447829333333,14.478830331991979,122,5.300000000000007E-4
7,test_20231101_134625,10863862.png,317432,14012,303420,0.9558582625570201,2,3,66058,2013,64045,0.9695267794968059,23.48735466666667,3165.0385226666667,13.127013605493714,122,5.300000000000007E-4
8,test_20231101_134625,11382381.png,312486,827,311659,0.9973534814359684,2,4,46745,109,46636,0.997668199807466,21.564144,2476.360432,14.192665047538828,122,5.300000000000007E-4
9,test_20231101_134625,11079715.png,443815,127382,316433,0.7129840136092742,9,4,124136,17736,106400,0.8571244441580202,16.53779911111111,2010.815104,15.097082221479486,122,5.300000000000007E-4
10,test_20231101_134625,11551286.png,271883,527,271356,0.9980616662314304,2,3,40092,76,40016,0.9981043599720643,17.926654222222222,1858.3108106666666,15.43962007470492,122,5.300000000000007E-4
1,test_20231101_134626,10404007.png,502730,24502,478228,0.9512621088854852,2,4,61265,3533,57732,0.9423324900024483,25.254716444444444,3308.321610666667,12.934726390234932,122,5.400000000000008E-4
2,test_20231101_134626,1254659.png,342646,79902,262744,0.7668088931433608,3,4,80080,11101,68979,0.861376123876124,20.33608177777778,3021.365152,13.328771450566173,122,5.400000000000008E-4
3,test_20231101_134626,10188041.png,221231,10304,210927,0.9534242488620491,2,13,41731,1450,40281,0.9652536483669215,10.567601777777778,1003.8131733333333,18.114274701111977,122,5.400000000000008E-4
4,test_20231101_134626,10287332.png,216980,13087,203893,0.939685685316619,1,4,22337,1789,20548,0.9199086717106146,9.406264888888888,766.5465173333333,19.285418460243026,122,5.400000000000008E-4
5,test_20231101_134626,11610969.png,368720,29117,339603,0.9210322195704057,2,4,84111,4247,79864,0.9495071988206061,20.25163022222222,2703.2300906666665,13.811973477796158,122,5.400000000000008E-4
6,test_20231101_134626,10350842.png,212614,6607,206007,0.9689249061679852,2,4,42529,968,41561,0.9772390604058407,19.040565333333333,2318.447829333333,14.478830331991979,122,5.400000000000008E-4
7,test_20231101_134626,10863862.png,317432,14012,303420,0.9558582625570201,2,4,66058,2013,64045,0.9695267794968059,23.48735466666667,3165.0385226666667,13.127013605493714,122,5.400000000000008E-4
8,test_20231101_134626,11382381.png,312486,827,311659,0.9973534814359684,1,3,46745,109,46636,0.997668199807466,21.564144,2476.360432,14.192665047538828,122,5.400000000000008E-4
9,test_20231101_134626,11079715.png,443815,127382,316433,0.7129840136092742,4,4,124136,17736,106400,0.8571244441580202,16.53779911111111,2010.815104,15.097082221479486,122,5.400000000000008E-4
10,test_20231101_134626,11551286.png,271883,527,271356,0.9980616662314304,1,4,40092,76,40016,0.9981043599720643,17.926654222222222,1858.3108106666666,15.43962007470492,122,5.400000000000008E-4
1,test_20231101_134627,10404007.png,502730,24502,478228,0.9512621088854852,3,3,61265,3533,57732,0.9423324900024483,25.254716444444444,3308.321610666667,12.934726390234932,122,5.500000000000008E-4
2,test_20231101_134627,1254659.png,342646,79902,262744,0.7668088931433608,3,5,80080,11101,68979,0.861376123876124,20.33608177777778,3021.365152,13.328771450566173,122,5.500000000000008E-4
3,test_20231101_134627,10188041.png,221231,10304,210927,0.9534242488620491,2,4,41731,1450,40281,0.9652536483669215,10.567601777777778,1003.8131733333333,18.114274701111977,122,5.500000000000008E-4
4,test_20231101_134627,10287332.png,216980,13087,203893,0.939685685316619,1,3,22337,1789,20548,0.9199086717106146,9.406264888888888,766.5465173333333,19.285418460243026,122,5.500000000000008E-4
5,test_20231101_134627,11610969.png,368720,29117,339603,0.9210322195704057,3,4,84111,4247,79864,0.9495071988206061,20.25163022222222,2703.2300906666665,13.811973477796158,122,5.500000000000008E-4
6,test_20231101_134627,10350842.png,212614,6607,206007,0.9689249061679852,1,3,42529,968,41561,0.9772390604058407,19.040565333333333,2318.447829333333,14.478830331991979,122,5.500000000000008E-4
7,test_20231101_134627,10863862.png,317432,14012,303420,0.9558582625570201,2,3,66058,2013,64045,0.9695267794968059,23.48735466666667,3165.0385226666667,13.127013605493714,122,5.500000000000008E-4
8,test_20231101_134627,11382381.png,312486,827,311659,0.9973534814359684,1,3,46745,109,46636,0.997668199807466,21.564144,2476.360432,14.192665047538828,122,5.500000000000008E-4
9,test_20231101_134627,11079715.png,443815,127382,316433,0.7129840136092742,5,4,124136,17736,106400,0.8571244441580202,16.53779911111111,2010.815104,15.097082221479486,122,5.500000000000008E-4
10,test_20231101_134627,11551286.png,271883,527,271356,0.9980616662314304,1,4,40092,76,40016,0.9981043599720643,17.926654222222222,1858.3108106666666,15.43962007470492,122,5.500000000000008E-4
1,test_20231101_134627,10404007.png,502730,24502,478228,0.9512621088854852,2,4,61265,3533,57732,0.9423324900024483,25.254716444444444,3308.321610666667,12.934726390234932,122,5.600000000000008E-4
2,test_20231101_134627,1254659.png,342646,79902,262744,0.7668088931433608,3,4,80080,11101,68979,0.861376123876124,20.33608177777778,3021.365152,13.328771450566173,122,5.600000000000008E-4
3,test_20231101_134627,10188041.png,221231,10304,210927,0.9534242488620491,2,3,41731,1450,40281,0.9652536483669215,10.567601777777778,1003.8131733333333,18.114274701111977,122,5.600000000000008E-4
4,test_20231101_134627,10287332.png,216980,13087,203893,0.939685685316619,2,4,22337,1789,20548,0.9199086717106146,9.406264888888888,766.5465173333333,19.285418460243026,122,5.600000000000008E-4
5,test_20231101_134627,11610969.png,368720,29117,339603,0.9210322195704057,3,3,84111,4247,79864,0.9495071988206061,20.25163022222222,2703.2300906666665,13.811973477796158,122,5.600000000000008E-4
6,test_20231101_134627,10350842.png,212614,6607,206007,0.9689249061679852,2,3,42529,968,41561,0.9772390604058407,19.040565333333333,2318.447829333333,14.478830331991979,122,5.600000000000008E-4
7,test_20231101_134627,10863862.png,317432,14012,303420,0.9558582625570201,2,3,66058,2013,64045,0.9695267794968059,23.48735466666667,3165.0385226666667,13.127013605493714,122,5.600000000000008E-4
8,test_20231101_134627,11382381.png,312486,827,311659,0.9973534814359684,1,4,46745,109,46636,0.997668199807466,21.564144,2476.360432,14.192665047538828,122,5.600000000000008E-4
9,test_20231101_134627,11079715.png,443815,127382,316433,0.7129840136092742,3,5,124136,17736,106400,0.8571244441580202,16.53779911111111,2010.815104,15.097082221479486,122,5.600000000000008E-4
10,test_20231101_134627,11551286.png,271883,527,271356,0.9980616662314304,1,4,40092,76,40016,0.9981043599720643,17.926654222222222,1858.3108106666666,15.43962007470492,122,5.600000000000008E-4
1,test_20231101_134628,10404007.png,502730,24502,478228,0.9512621088854852,2,4,61265,3533,57732,0.9423324900024483,25.254716444444444,3308.321610666667,12.934726390234932,122,5.700000000000008E-4
2,test_20231101_134628,1254659.png,342646,79902,262744,0.7668088931433608,3,4,80080,11101,68979,0.861376123876124,20.33608177777778,3021.365152,13.328771450566173,122,5.700000000000008E-4
3,test_20231101_134628,10188041.png,221231,10304,210927,0.9534242488620491,7,4,41731,1450,40281,0.9652536483669215,10.567601777777778,1003.8131733333333,18.114274701111977,122,5.700000000000008E-4
4,test_20231101_134628,10287332.png,216980,13087,203893,0.939685685316619,2,4,22337,1789,20548,0.9199086717106146,9.406264888888888,766.5465173333333,19.285418460243026,122,5.700000000000008E-4
5,test_20231101_134628,11610969.png,368720,29117,339603,0.9210322195704057,3,4,84111,4247,79864,0.9495071988206061,20.25163022222222,2703.2300906666665,13.811973477796158,122,5.700000000000008E-4
6,test_20231101_134628,10350842.png,212614,6607,206007,0.9689249061679852,5,4,42529,968,41561,0.9772390604058407,19.040565333333333,2318.447829333333,14.478830331991979,122,5.700000000000008E-4
7,test_20231101_134628,10863862.png,317432,14012,303420,0.9558582625570201,2,3,66058,2013,64045,0.9695267794968059,23.48735466666667,3165.0385226666667,13.127013605493714,122,5.700000000000008E-4
8,test_20231101_134628,11382381.png,312486,827,311659,0.9973534814359684,2,3,46745,109,46636,0.997668199807466,21.564144,2476.360432,14.192665047538828,122,5.700000000000008E-4
9,test_20231101_134628,11079715.png,443815,127382,316433,0.7129840136092742,4,5,124136,17736,106400,0.8571244441580202,16.53779911111111,2010.815104,15.097082221479486,122,5.700000000000008E-4
10,test_20231101_134628,11551286.png,271883,527,271356,0.9980616662314304,1,4,40092,76,40016,0.9981043599720643,17.926654222222222,1858.3108106666666,15.43962007470492,122,5.700000000000008E-4
1,test_20231101_134629,10404007.png,502730,24502,478228,0.9512621088854852,2,3,61265,3533,57732,0.9423324900024483,25.254716444444444,3308.321610666667,12.934726390234932,122,5.800000000000009E-4
2,test_20231101_134629,1254659.png,342646,79902,262744,0.7668088931433608,3,4,80080,11101,68979,0.861376123876124,20.33608177777778,3021.365152,13.328771450566173,122,5.800000000000009E-4
3,test_20231101_134629,10188041.png,221231,10304,210927,0.9534242488620491,3,4,41731,1450,40281,0.9652536483669215,10.567601777777778,1003.8131733333333,18.114274701111977,122,5.800000000000009E-4
4,test_20231101_134629,10287332.png,216980,13087,203893,0.939685685316619,1,3,22337,1789,20548,0.9199086717106146,9.406264888888888,766.5465173333333,19.285418460243026,122,5.800000000000009E-4
5,test_20231101_134629,11610969.png,368720,29117,339603,0.9210322195704057,2,3,84111,4247,79864,0.9495071988206061,20.25163022222222,2703.2300906666665,13.811973477796158,122,5.800000000000009E-4
6,test_20231101_134629,10350842.png,212614,6607,206007,0.9689249061679852,1,3,42529,968,41561,0.9772390604058407,19.040565333333333,2318.447829333333,14.478830331991979,122,5.800000000000009E-4
7,test_20231101_134629,10863862.png,317432,14012,303420,0.9558582625570201,2,4,66058,2013,64045,0.9695267794968059,23.48735466666667,3165.0385226666667,13.127013605493714,122,5.800000000000009E-4
8,test_20231101_134629,11382381.png,312486,827,311659,0.9973534814359684,1,3,46745,109,46636,0.997668199807466,21.564144,2476.360432,14.192665047538828,122,5.800000000000009E-4
9,test_20231101_134629,11079715.png,443815,127382,316433,0.7129840136092742,4,4,124136,17736,106400,0.8571244441580202,16.53779911111111,2010.815104,15.097082221479486,122,5.800000000000009E-4
10,test_20231101_134629,11551286.png,271883,527,271356,0.9980616662314304,1,3,40092,76,40016,0.9981043599720643,17.926654222222222,1858.3108106666666,15.43962007470492,122,5.800000000000009E-4
1,test_20231101_134629,10404007.png,502730,24502,478228,0.9512621088854852,2,3,61265,3533,57732,0.9423324900024483,25.254716444444444,3308.321610666667,12.934726390234932,122,5.900000000000009E-4
2,test_20231101_134629,1254659.png,342646,79902,262744,0.7668088931433608,3,3,80080,11101,68979,0.861376123876124,20.33608177777778,3021.365152,13.328771450566173,122,5.900000000000009E-4
3,test_20231101_134629,10188041.png,221231,10304,210927,0.9534242488620491,2,3,41731,1450,40281,0.9652536483669215,10.567601777777778,1003.8131733333333,18.114274701111977,122,5.900000000000009E-4
4,test_20231101_134629,10287332.png,216980,13087,203893,0.939685685316619,2,3,22337,1789,20548,0.9199086717106146,9.406264888888888,766.5465173333333,19.285418460243026,122,5.900000000000009E-4
5,test_20231101_134629,11610969.png,368720,29117,339603,0.9210322195704057,2,3,84111,4247,79864,0.9495071988206061,20.25163022222222,2703.2300906666665,13.811973477796158,122,5.900000000000009E-4
6,test_20231101_134629,10350842.png,212614,6607,206007,0.9689249061679852,2,4,42529,968,41561,0.9772390604058407,19.040565333333333,2318.447829333333,14.478830331991979,122,5.900000000000009E-4
7,test_20231101_134629,10863862.png,317432,14012,303420,0.9558582625570201,2,4,66058,2013,64045,0.9695267794968059,23.48735466666667,3165.0385226666667,13.127013605493714,122,5.900000000000009E-4
8,test_20231101_134629,11382381.png,312486,827,311659,0.9973534814359684,2,3,46745,109,46636,0.997668199807466,21.564144,2476.360432,14.192665047538828,122,5.900000000000009E-4
9,test_20231101_134629,11079715.png,443815,127382,316433,0.7129840136092742,3,4,124136,17736,106400,0.8571244441580202,16.53779911111111,2010.815104,15.097082221479486,122,5.900000000000009E-4
10,test_20231101_134629,11551286.png,271883,527,271356,0.9980616662314304,1,4,40092,76,40016,0.9981043599720643,17.926654222222222,1858.3108106666666,15.43962007470492,122,5.900000000000009E-4
1,test_20231101_134630,10404007.png,502730,24502,478228,0.9512621088854852,2,3,61265,3533,57732,0.9423324900024483,25.254716444444444,3308.321610666667,12.934726390234932,122,6.000000000000009E-4
2,test_20231101_134630,1254659.png,342646,79902,262744,0.7668088931433608,3,4,80080,11101,68979,0.861376123876124,20.33608177777778,3021.365152,13.328771450566173,122,6.000000000000009E-4
3,test_20231101_134630,10188041.png,221231,10304,210927,0.9534242488620491,2,4,41731,1450,40281,0.9652536483669215,10.567601777777778,1003.8131733333333,18.114274701111977,122,6.000000000000009E-4
4,test_20231101_134630,10287332.png,216980,13087,203893,0.939685685316619,1,4,22337,1789,20548,0.9199086717106146,9.406264888888888,766.5465173333333,19.285418460243026,122,6.000000000000009E-4
5,test_20231101_134630,11610969.png,368720,29117,339603,0.9210322195704057,3,4,84111,4247,79864,0.9495071988206061,20.25163022222222,2703.2300906666665,13.811973477796158,122,6.000000000000009E-4
6,test_20231101_134630,10350842.png,212614,6607,206007,0.9689249061679852,1,3,42529,968,41561,0.9772390604058407,19.040565333333333,2318.447829333333,14.478830331991979,122,6.000000000000009E-4
7,test_20231101_134630,10863862.png,317432,14012,303420,0.9558582625570201,2,3,66058,2013,64045,0.9695267794968059,23.48735466666667,3165.0385226666667,13.127013605493714,122,6.000000000000009E-4
8,test_20231101_134630,11382381.png,312486,827,311659,0.9973534814359684,1,4,46745,109,46636,0.997668199807466,21.564144,2476.360432,14.192665047538828,122,6.000000000000009E-4
9,test_20231101_134630,11079715.png,443815,127382,316433,0.7129840136092742,6,4,124136,17736,106400,0.8571244441580202,16.53779911111111,2010.815104,15.097082221479486,122,6.000000000000009E-4
10,test_20231101_134630,11551286.png,271883,527,271356,0.9980616662314304,1,4,40092,76,40016,0.9981043599720643,17.926654222222222,1858.3108106666666,15.43962007470492,122,6.000000000000009E-4
1,test_20231101_134631,10404007.png,502730,24502,478228,0.9512621088854852,2,4,61265,3533,57732,0.9423324900024483,25.254716444444444,3308.321610666667,12.934726390234932,122,6.10000000000001E-4
2,test_20231101_134631,1254659.png,342646,79902,262744,0.7668088931433608,3,8,80080,11101,68979,0.861376123876124,20.33608177777778,3021.365152,13.328771450566173,122,6.10000000000001E-4
3,test_20231101_134631,10188041.png,221231,10304,210927,0.9534242488620491,2,4,41731,1450,40281,0.9652536483669215,10.567601777777778,1003.8131733333333,18.114274701111977,122,6.10000000000001E-4
4,test_20231101_134631,10287332.png,216980,13087,203893,0.939685685316619,1,3,22337,1789,20548,0.9199086717106146,9.406264888888888,766.5465173333333,19.285418460243026,122,6.10000000000001E-4
5,test_20231101_134631,11610969.png,368720,29117,339603,0.9210322195704057,3,4,84111,4247,79864,0.9495071988206061,20.25163022222222,2703.2300906666665,13.811973477796158,122,6.10000000000001E-4
6,test_20231101_134631,10350842.png,212614,6607,206007,0.9689249061679852,2,4,42529,968,41561,0.9772390604058407,19.040565333333333,2318.447829333333,14.478830331991979,122,6.10000000000001E-4
7,test_20231101_134631,10863862.png,317432,14012,303420,0.9558582625570201,2,3,66058,2013,64045,0.9695267794968059,23.48735466666667,3165.0385226666667,13.127013605493714,122,6.10000000000001E-4
8,test_20231101_134631,11382381.png,312486,827,311659,0.9973534814359684,2,4,46745,109,46636,0.997668199807466,21.564144,2476.360432,14.192665047538828,122,6.10000000000001E-4
9,test_20231101_134631,11079715.png,443815,127382,316433,0.7129840136092742,4,4,124136,17736,106400,0.8571244441580202,16.53779911111111,2010.815104,15.097082221479486,122,6.10000000000001E-4
10,test_20231101_134631,11551286.png,271883,527,271356,0.9980616662314304,1,3,40092,76,40016,0.9981043599720643,17.926654222222222,1858.3108106666666,15.43962007470492,122,6.10000000000001E-4
1,test_20231101_134631,10404007.png,502730,24502,478228,0.9512621088854852,2,3,61265,3533,57732,0.9423324900024483,25.254716444444444,3308.321610666667,12.934726390234932,122,6.20000000000001E-4
2,test_20231101_134631,1254659.png,342646,79902,262744,0.7668088931433608,3,3,80080,11101,68979,0.861376123876124,20.33608177777778,3021.365152,13.328771450566173,122,6.20000000000001E-4
3,test_20231101_134631,10188041.png,221231,10304,210927,0.9534242488620491,2,3,41731,1450,40281,0.9652536483669215,10.567601777777778,1003.8131733333333,18.114274701111977,122,6.20000000000001E-4
4,test_20231101_134631,10287332.png,216980,13087,203893,0.939685685316619,1,4,22337,1789,20548,0.9199086717106146,9.406264888888888,766.5465173333333,19.285418460243026,122,6.20000000000001E-4
5,test_20231101_134631,11610969.png,368720,29117,339603,0.9210322195704057,2,3,84111,4247,79864,0.9495071988206061,20.25163022222222,2703.2300906666665,13.811973477796158,122,6.20000000000001E-4
6,test_20231101_134631,10350842.png,212614,6607,206007,0.9689249061679852,1,3,42529,968,41561,0.9772390604058407,19.040565333333333,2318.447829333333,14.478830331991979,122,6.20000000000001E-4
7,test_20231101_134631,10863862.png,317432,14012,303420,0.9558582625570201,2,3,66058,2013,64045,0.9695267794968059,23.48735466666667,3165.0385226666667,13.127013605493714,122,6.20000000000001E-4
8,test_20231101_134631,11382381.png,312486,827,311659,0.9973534814359684,2,4,46745,109,46636,0.997668199807466,21.564144,2476.360432,14.192665047538828,122,6.20000000000001E-4
9,test_20231101_134631,11079715.png,443815,127382,316433,0.7129840136092742,3,4,124136,17736,106400,0.8571244441580202,16.53779911111111,2010.815104,15.097082221479486,122,6.20000000000001E-4
10,test_20231101_134631,11551286.png,271883,527,271356,0.9980616662314304,1,4,40092,76,40016,0.9981043599720643,17.926654222222222,1858.3108106666666,15.43962007470492,122,6.20000000000001E-4
1,test_20231101_134632,10404007.png,502730,24502,478228,0.9512621088854852,2,3,61265,3533,57732,0.9423324900024483,25.254716444444444,3308.321610666667,12.934726390234932,122,6.30000000000001E-4
2,test_20231101_134632,1254659.png,342646,79902,262744,0.7668088931433608,3,4,80080,11101,68979,0.861376123876124,20.33608177777778,3021.365152,13.328771450566173,122,6.30000000000001E-4
3,test_20231101_134632,10188041.png,221231,10304,210927,0.9534242488620491,2,3,41731,1450,40281,0.9652536483669215,10.567601777777778,1003.8131733333333,18.114274701111977,122,6.30000000000001E-4
4,test_20231101_134632,10287332.png,216980,13087,203893,0.939685685316619,2,4,22337,1789,20548,0.9199086717106146,9.406264888888888,766.5465173333333,19.285418460243026,122,6.30000000000001E-4
5,test_20231101_134632,11610969.png,368720,29117,339603,0.9210322195704057,2,4,84111,4247,79864,0.9495071988206061,20.25163022222222,2703.2300906666665,13.811973477796158,122,6.30000000000001E-4
6,test_20231101_134632,10350842.png,212614,6607,206007,0.9689249061679852,2,4,42529,968,41561,0.9772390604058407,19.040565333333333,2318.447829333333,14.478830331991979,122,6.30000000000001E-4
7,test_20231101_134632,10863862.png,317432,14012,303420,0.9558582625570201,1,3,66058,2013,64045,0.9695267794968059,23.48735466666667,3165.0385226666667,13.127013605493714,122,6.30000000000001E-4
8,test_20231101_134632,11382381.png,312486,827,311659,0.9973534814359684,1,4,46745,109,46636,0.997668199807466,21.564144,2476.360432,14.192665047538828,122,6.30000000000001E-4
9,test_20231101_134632,11079715.png,443815,127382,316433,0.7129840136092742,3,6,124136,17736,106400,0.8571244441580202,16.53779911111111,2010.815104,15.097082221479486,122,6.30000000000001E-4
10,test_20231101_134632,11551286.png,271883,527,271356,0.9980616662314304,1,4,40092,76,40016,0.9981043599720643,17.926654222222222,1858.3108106666666,15.43962007470492,122,6.30000000000001E-4
1,test_20231101_134633,10404007.png,502730,24502,478228,0.9512621088854852,2,3,61265,3533,57732,0.9423324900024483,25.254716444444444,3308.321610666667,12.934726390234932,122,6.40000000000001E-4
2,test_20231101_134633,1254659.png,342646,79902,262744,0.7668088931433608,4,4,80080,11101,68979,0.861376123876124,20.33608177777778,3021.365152,13.328771450566173,122,6.40000000000001E-4
3,test_20231101_134633,10188041.png,221231,10304,210927,0.9534242488620491,2,3,41731,1450,40281,0.9652536483669215,10.567601777777778,1003.8131733333333,18.114274701111977,122,6.40000000000001E-4
4,test_20231101_134633,10287332.png,216980,13087,203893,0.939685685316619,2,4,22337,1789,20548,0.9199086717106146,9.406264888888888,766.5465173333333,19.285418460243026,122,6.40000000000001E-4
5,test_20231101_134633,11610969.png,368720,29117,339603,0.9210322195704057,3,4,84111,4247,79864,0.9495071988206061,20.25163022222222,2703.2300906666665,13.811973477796158,122,6.40000000000001E-4
6,test_20231101_134633,10350842.png,212614,6607,206007,0.9689249061679852,2,3,42529,968,41561,0.9772390604058407,19.040565333333333,2318.447829333333,14.478830331991979,122,6.40000000000001E-4
7,test_20231101_134633,10863862.png,317432,14012,303420,0.9558582625570201,2,3,66058,2013,64045,0.9695267794968059,23.48735466666667,3165.0385226666667,13.127013605493714,122,6.40000000000001E-4
8,test_20231101_134633,11382381.png,312486,827,311659,0.9973534814359684,2,3,46745,109,46636,0.997668199807466,21.564144,2476.360432,14.192665047538828,122,6.40000000000001E-4
9,test_20231101_134633,11079715.png,443815,127382,316433,0.7129840136092742,4,4,124136,17736,106400,0.8571244441580202,16.53779911111111,2010.815104,15.097082221479486,122,6.40000000000001E-4
10,test_20231101_134633,11551286.png,271883,527,271356,0.9980616662314304,1,4,40092,76,40016,0.9981043599720643,17.926654222222222,1858.3108106666666,15.43962007470492,122,6.40000000000001E-4
1,test_20231101_134633,10404007.png,502730,24502,478228,0.9512621088854852,2,4,61265,3533,57732,0.9423324900024483,25.254716444444444,3308.321610666667,12.934726390234932,122,6.500000000000011E-4
2,test_20231101_134633,1254659.png,342646,79902,262744,0.7668088931433608,3,4,80080,11101,68979,0.861376123876124,20.33608177777778,3021.365152,13.328771450566173,122,6.500000000000011E-4
3,test_20231101_134633,10188041.png,221231,10304,210927,0.9534242488620491,2,3,41731,1450,40281,0.9652536483669215,10.567601777777778,1003.8131733333333,18.114274701111977,122,6.500000000000011E-4
4,test_20231101_134633,10287332.png,216980,13087,203893,0.939685685316619,2,3,22337,1789,20548,0.9199086717106146,9.406264888888888,766.5465173333333,19.285418460243026,122,6.500000000000011E-4
5,test_20231101_134633,11610969.png,368720,29117,339603,0.9210322195704057,3,3,84111,4247,79864,0.9495071988206061,20.25163022222222,2703.2300906666665,13.811973477796158,122,6.500000000000011E-4
6,test_20231101_134633,10350842.png,212614,6607,206007,0.9689249061679852,2,3,42529,968,41561,0.9772390604058407,19.040565333333333,2318.447829333333,14.478830331991979,122,6.500000000000011E-4
7,test_20231101_134633,10863862.png,317432,14012,303420,0.9558582625570201,2,4,66058,2013,64045,0.9695267794968059,23.48735466666667,3165.0385226666667,13.127013605493714,122,6.500000000000011E-4
8,test_20231101_134633,11382381.png,312486,827,311659,0.9973534814359684,1,3,46745,109,46636,0.997668199807466,21.564144,2476.360432,14.192665047538828,122,6.500000000000011E-4
9,test_20231101_134633,11079715.png,443815,127382,316433,0.7129840136092742,4,4,124136,17736,106400,0.8571244441580202,16.53779911111111,2010.815104,15.097082221479486,122,6.500000000000011E-4
10,test_20231101_134633,11551286.png,271883,527,271356,0.9980616662314304,3,3,40092,76,40016,0.9981043599720643,17.926654222222222,1858.3108106666666,15.43962007470492,122,6.500000000000011E-4
1,test_20231101_134634,10404007.png,502730,24502,478228,0.9512621088854852,3,4,61265,3533,57732,0.9423324900024483,25.254716444444444,3308.321610666667,12.934726390234932,122,6.600000000000011E-4
2,test_20231101_134634,1254659.png,342646,79902,262744,0.7668088931433608,3,4,80080,11101,68979,0.861376123876124,20.33608177777778,3021.365152,13.328771450566173,122,6.600000000000011E-4
3,test_20231101_134634,10188041.png,221231,10304,210927,0.9534242488620491,2,3,41731,1450,40281,0.9652536483669215,10.567601777777778,1003.8131733333333,18.114274701111977,122,6.600000000000011E-4
4,test_20231101_134634,10287332.png,216980,13087,203893,0.939685685316619,2,4,22337,1789,20548,0.9199086717106146,9.406264888888888,766.5465173333333,19.285418460243026,122,6.600000000000011E-4
5,test_20231101_134634,11610969.png,368720,29117,339603,0.9210322195704057,2,4,84111,4247,79864,0.9495071988206061,20.25163022222222,2703.2300906666665,13.811973477796158,122,6.600000000000011E-4
6,test_20231101_134634,10350842.png,212614,6607,206007,0.9689249061679852,2,3,42529,968,41561,0.9772390604058407,19.040565333333333,2318.447829333333,14.478830331991979,122,6.600000000000011E-4
7,test_20231101_134634,10863862.png,317432,14012,303420,0.9558582625570201,2,7,66058,2013,64045,0.9695267794968059,23.48735466666667,3165.0385226666667,13.127013605493714,122,6.600000000000011E-4
8,test_20231101_134634,11382381.png,312486,827,311659,0.9973534814359684,2,4,46745,109,46636,0.997668199807466,21.564144,2476.360432,14.192665047538828,122,6.600000000000011E-4
9,test_20231101_134634,11079715.png,443815,127382,316433,0.7129840136092742,3,4,124136,17736,106400,0.8571244441580202,16.53779911111111,2010.815104,15.097082221479486,122,6.600000000000011E-4
10,test_20231101_134634,11551286.png,271883,527,271356,0.9980616662314304,1,4,40092,76,40016,0.9981043599720643,17.926654222222222,1858.3108106666666,15.43962007470492,122,6.600000000000011E-4
1,test_20231101_134635,10404007.png,502730,24502,478228,0.9512621088854852,2,4,61265,3533,57732,0.9423324900024483,25.254716444444444,3308.321610666667,12.934726390234932,122,6.700000000000011E-4
2,test_20231101_134635,1254659.png,342646,79902,262744,0.7668088931433608,4,4,80080,11101,68979,0.861376123876124,20.33608177777778,3021.365152,13.328771450566173,122,6.700000000000011E-4
3,test_20231101_134635,10188041.png,221231,10304,210927,0.9534242488620491,2,4,41731,1450,40281,0.9652536483669215,10.567601777777778,1003.8131733333333,18.114274701111977,122,6.700000000000011E-4
4,test_20231101_134635,10287332.png,216980,13087,203893,0.939685685316619,1,3,22337,1789,20548,0.9199086717106146,9.406264888888888,766.5465173333333,19.285418460243026,122,6.700000000000011E-4
5,test_20231101_134635,11610969.png,368720,29117,339603,0.9210322195704057,2,4,84111,4247,79864,0.9495071988206061,20.25163022222222,2703.2300906666665,13.811973477796158,122,6.700000000000011E-4
6,test_20231101_134635,10350842.png,212614,6607,206007,0.9689249061679852,1,3,42529,968,41561,0.9772390604058407,19.040565333333333,2318.447829333333,14.478830331991979,122,6.700000000000011E-4
7,test_20231101_134635,10863862.png,317432,14012,303420,0.9558582625570201,2,3,66058,2013,64045,0.9695267794968059,23.48735466666667,3165.0385226666667,13.127013605493714,122,6.700000000000011E-4
8,test_20231101_134635,11382381.png,312486,827,311659,0.9973534814359684,2,3,46745,109,46636,0.997668199807466,21.564144,2476.360432,14.192665047538828,122,6.700000000000011E-4
9,test_20231101_134635,11079715.png,443815,127382,316433,0.7129840136092742,3,5,124136,17736,106400,0.8571244441580202,16.53779911111111,2010.815104,15.097082221479486,122,6.700000000000011E-4
10,test_20231101_134635,11551286.png,271883,527,271356,0.9980616662314304,2,3,40092,76,40016,0.9981043599720643,17.926654222222222,1858.3108106666666,15.43962007470492,122,6.700000000000011E-4
1,test_20231101_134635,10404007.png,502730,24502,478228,0.9512621088854852,2,3,61265,3533,57732,0.9423324900024483,25.254716444444444,3308.321610666667,12.934726390234932,122,6.800000000000011E-4
2,test_20231101_134635,1254659.png,342646,79902,262744,0.7668088931433608,2,4,80080,11101,68979,0.861376123876124,20.33608177777778,3021.365152,13.328771450566173,122,6.800000000000011E-4
3,test_20231101_134635,10188041.png,221231,10304,210927,0.9534242488620491,2,3,41731,1450,40281,0.9652536483669215,10.567601777777778,1003.8131733333333,18.114274701111977,122,6.800000000000011E-4
4,test_20231101_134635,10287332.png,216980,13087,203893,0.939685685316619,2,3,22337,1789,20548,0.9199086717106146,9.406264888888888,766.5465173333333,19.285418460243026,122,6.800000000000011E-4
5,test_20231101_134635,11610969.png,368720,29117,339603,0.9210322195704057,2,5,84111,4247,79864,0.9495071988206061,20.25163022222222,2703.2300906666665,13.811973477796158,122,6.800000000000011E-4
6,test_20231101_134635,10350842.png,212614,6607,206007,0.9689249061679852,2,3,42529,968,41561,0.9772390604058407,19.040565333333333,2318.447829333333,14.478830331991979,122,6.800000000000011E-4
7,test_20231101_134635,10863862.png,317432,14012,303420,0.9558582625570201,2,4,66058,2013,64045,0.9695267794968059,23.48735466666667,3165.0385226666667,13.127013605493714,122,6.800000000000011E-4
8,test_20231101_134635,11382381.png,312486,827,311659,0.9973534814359684,1,4,46745,109,46636,0.997668199807466,21.564144,2476.360432,14.192665047538828,122,6.800000000000011E-4
9,test_20231101_134635,11079715.png,443815,127382,316433,0.7129840136092742,3,4,124136,17736,106400,0.8571244441580202,16.53779911111111,2010.815104,15.097082221479486,122,6.800000000000011E-4
10,test_20231101_134635,11551286.png,271883,527,271356,0.9980616662314304,1,4,40092,76,40016,0.9981043599720643,17.926654222222222,1858.3108106666666,15.43962007470492,122,6.800000000000011E-4
1,test_20231101_134636,10404007.png,502730,24502,478228,0.9512621088854852,2,4,61265,3533,57732,0.9423324900024483,25.254716444444444,3308.321610666667,12.934726390234932,122,6.900000000000012E-4
2,test_20231101_134636,1254659.png,342646,79902,262744,0.7668088931433608,3,4,80080,11101,68979,0.861376123876124,20.33608177777778,3021.365152,13.328771450566173,122,6.900000000000012E-4
3,test_20231101_134636,10188041.png,221231,10304,210927,0.9534242488620491,3,3,41731,1450,40281,0.9652536483669215,10.567601777777778,1003.8131733333333,18.114274701111977,122,6.900000000000012E-4
4,test_20231101_134636,10287332.png,216980,13087,203893,0.939685685316619,2,4,22337,1789,20548,0.9199086717106146,9.406264888888888,766.5465173333333,19.285418460243026,122,6.900000000000012E-4
5,test_20231101_134636,11610969.png,368720,29117,339603,0.9210322195704057,2,4,84111,4247,79864,0.9495071988206061,20.25163022222222,2703.2300906666665,13.811973477796158,122,6.900000000000012E-4
6,test_20231101_134636,10350842.png,212614,6607,206007,0.9689249061679852,2,3,42529,968,41561,0.9772390604058407,19.040565333333333,2318.447829333333,14.478830331991979,122,6.900000000000012E-4
7,test_20231101_134636,10863862.png,317432,14012,303420,0.9558582625570201,2,3,66058,2013,64045,0.9695267794968059,23.48735466666667,3165.0385226666667,13.127013605493714,122,6.900000000000012E-4
8,test_20231101_134636,11382381.png,312486,827,311659,0.9973534814359684,1,4,46745,109,46636,0.997668199807466,21.564144,2476.360432,14.192665047538828,122,6.900000000000012E-4
9,test_20231101_134636,11079715.png,443815,127382,316433,0.7129840136092742,4,4,124136,17736,106400,0.8571244441580202,16.53779911111111,2010.815104,15.097082221479486,122,6.900000000000012E-4
10,test_20231101_134636,11551286.png,271883,527,271356,0.9980616662314304,1,3,40092,76,40016,0.9981043599720643,17.926654222222222,1858.3108106666666,15.43962007470492,122,6.900000000000012E-4
1,test_20231101_134637,10404007.png,502730,24502,478228,0.9512621088854852,2,3,61265,3533,57732,0.9423324900024483,25.254716444444444,3308.321610666667,12.934726390234932,122,7.000000000000012E-4
2,test_20231101_134637,1254659.png,342646,79902,262744,0.7668088931433608,3,4,80080,11101,68979,0.861376123876124,20.33608177777778,3021.365152,13.328771450566173,122,7.000000000000012E-4
3,test_20231101_134637,10188041.png,221231,10304,210927,0.9534242488620491,2,3,41731,1450,40281,0.9652536483669215,10.567601777777778,1003.8131733333333,18.114274701111977,122,7.000000000000012E-4
4,test_20231101_134637,10287332.png,216980,13087,203893,0.939685685316619,2,4,22337,1789,20548,0.9199086717106146,9.406264888888888,766.5465173333333,19.285418460243026,122,7.000000000000012E-4
5,test_20231101_134637,11610969.png,368720,29117,339603,0.9210322195704057,3,4,84111,4247,79864,0.9495071988206061,20.25163022222222,2703.2300906666665,13.811973477796158,122,7.000000000000012E-4
6,test_20231101_134637,10350842.png,212614,6607,206007,0.9689249061679852,1,3,42529,968,41561,0.9772390604058407,19.040565333333333,2318.447829333333,14.478830331991979,122,7.000000000000012E-4
7,test_20231101_134637,10863862.png,317432,14012,303420,0.9558582625570201,2,3,66058,2013,64045,0.9695267794968059,23.48735466666667,3165.0385226666667,13.127013605493714,122,7.000000000000012E-4
8,test_20231101_134637,11382381.png,312486,827,311659,0.9973534814359684,1,4,46745,109,46636,0.997668199807466,21.564144,2476.360432,14.192665047538828,122,7.000000000000012E-4
9,test_20231101_134637,11079715.png,443815,127382,316433,0.7129840136092742,3,4,124136,17736,106400,0.8571244441580202,16.53779911111111,2010.815104,15.097082221479486,122,7.000000000000012E-4
10,test_20231101_134637,11551286.png,271883,527,271356,0.9980616662314304,2,3,40092,76,40016,0.9981043599720643,17.926654222222222,1858.3108106666666,15.43962007470492,122,7.000000000000012E-4
1,test_20231101_134638,10404007.png,502730,24502,478228,0.9512621088854852,3,3,61265,3533,57732,0.9423324900024483,25.254716444444444,3308.321610666667,12.934726390234932,122,7.100000000000012E-4
2,test_20231101_134638,1254659.png,342646,79902,262744,0.7668088931433608,3,4,80080,11101,68979,0.861376123876124,20.33608177777778,3021.365152,13.328771450566173,122,7.100000000000012E-4
3,test_20231101_134638,10188041.png,221231,10304,210927,0.9534242488620491,2,4,41731,1450,40281,0.9652536483669215,10.567601777777778,1003.8131733333333,18.114274701111977,122,7.100000000000012E-4
4,test_20231101_134638,10287332.png,216980,13087,203893,0.939685685316619,1,3,22337,1789,20548,0.9199086717106146,9.406264888888888,766.5465173333333,19.285418460243026,122,7.100000000000012E-4
5,test_20231101_134638,11610969.png,368720,29117,339603,0.9210322195704057,2,4,84111,4247,79864,0.9495071988206061,20.25163022222222,2703.2300906666665,13.811973477796158,122,7.100000000000012E-4
6,test_20231101_134638,10350842.png,212614,6607,206007,0.9689249061679852,1,4,42529,968,41561,0.9772390604058407,19.040565333333333,2318.447829333333,14.478830331991979,122,7.100000000000012E-4
7,test_20231101_134638,10863862.png,317432,14012,303420,0.9558582625570201,2,4,66058,2013,64045,0.9695267794968059,23.48735466666667,3165.0385226666667,13.127013605493714,122,7.100000000000012E-4
8,test_20231101_134638,11382381.png,312486,827,311659,0.9973534814359684,2,4,46745,109,46636,0.997668199807466,21.564144,2476.360432,14.192665047538828,122,7.100000000000012E-4
9,test_20231101_134638,11079715.png,443815,127382,316433,0.7129840136092742,3,5,124136,17736,106400,0.8571244441580202,16.53779911111111,2010.815104,15.097082221479486,122,7.100000000000012E-4
10,test_20231101_134638,11551286.png,271883,527,271356,0.9980616662314304,1,4,40092,76,40016,0.9981043599720643,17.926654222222222,1858.3108106666666,15.43962007470492,122,7.100000000000012E-4
1,test_20231101_134638,10404007.png,502730,24502,478228,0.9512621088854852,2,4,61265,3533,57732,0.9423324900024483,25.254716444444444,3308.321610666667,12.934726390234932,122,7.200000000000012E-4
2,test_20231101_134638,1254659.png,342646,79902,262744,0.7668088931433608,3,4,80080,11101,68979,0.861376123876124,20.33608177777778,3021.365152,13.328771450566173,122,7.200000000000012E-4
3,test_20231101_134638,10188041.png,221231,10304,210927,0.9534242488620491,2,4,41731,1450,40281,0.9652536483669215,10.567601777777778,1003.8131733333333,18.114274701111977,122,7.200000000000012E-4
4,test_20231101_134638,10287332.png,216980,13087,203893,0.939685685316619,2,4,22337,1789,20548,0.9199086717106146,9.406264888888888,766.5465173333333,19.285418460243026,122,7.200000000000012E-4
5,test_20231101_134638,11610969.png,368720,29117,339603,0.9210322195704057,3,4,84111,4247,79864,0.9495071988206061,20.25163022222222,2703.2300906666665,13.811973477796158,122,7.200000000000012E-4
6,test_20231101_134638,10350842.png,212614,6607,206007,0.9689249061679852,1,3,42529,968,41561,0.9772390604058407,19.040565333333333,2318.447829333333,14.478830331991979,122,7.200000000000012E-4
7,test_20231101_134638,10863862.png,317432,14012,303420,0.9558582625570201,2,4,66058,2013,64045,0.9695267794968059,23.48735466666667,3165.0385226666667,13.127013605493714,122,7.200000000000012E-4
8,test_20231101_134638,11382381.png,312486,827,311659,0.9973534814359684,1,9,46745,109,46636,0.997668199807466,21.564144,2476.360432,14.192665047538828,122,7.200000000000012E-4
9,test_20231101_134638,11079715.png,443815,127382,316433,0.7129840136092742,4,4,124136,17736,106400,0.8571244441580202,16.53779911111111,2010.815104,15.097082221479486,122,7.200000000000012E-4
10,test_20231101_134638,11551286.png,271883,527,271356,0.9980616662314304,2,3,40092,76,40016,0.9981043599720643,17.926654222222222,1858.3108106666666,15.43962007470492,122,7.200000000000012E-4
1,test_20231101_134639,10404007.png,502730,24502,478228,0.9512621088854852,2,4,61265,3533,57732,0.9423324900024483,25.254716444444444,3308.321610666667,12.934726390234932,122,7.300000000000013E-4
2,test_20231101_134639,1254659.png,342646,79902,262744,0.7668088931433608,2,4,80080,11101,68979,0.861376123876124,20.33608177777778,3021.365152,13.328771450566173,122,7.300000000000013E-4
3,test_20231101_134639,10188041.png,221231,10304,210927,0.9534242488620491,2,4,41731,1450,40281,0.9652536483669215,10.567601777777778,1003.8131733333333,18.114274701111977,122,7.300000000000013E-4
4,test_20231101_134639,10287332.png,216980,13087,203893,0.939685685316619,1,3,22337,1789,20548,0.9199086717106146,9.406264888888888,766.5465173333333,19.285418460243026,122,7.300000000000013E-4
5,test_20231101_134639,11610969.png,368720,29117,339603,0.9210322195704057,2,4,84111,4247,79864,0.9495071988206061,20.25163022222222,2703.2300906666665,13.811973477796158,122,7.300000000000013E-4
6,test_20231101_134639,10350842.png,212614,6607,206007,0.9689249061679852,1,3,42529,968,41561,0.9772390604058407,19.040565333333333,2318.447829333333,14.478830331991979,122,7.300000000000013E-4
7,test_20231101_134639,10863862.png,317432,14012,303420,0.9558582625570201,2,4,66058,2013,64045,0.9695267794968059,23.48735466666667,3165.0385226666667,13.127013605493714,122,7.300000000000013E-4
8,test_20231101_134639,11382381.png,312486,827,311659,0.9973534814359684,1,10,46745,109,46636,0.997668199807466,21.564144,2476.360432,14.192665047538828,122,7.300000000000013E-4
9,test_20231101_134639,11079715.png,443815,127382,316433,0.7129840136092742,4,4,124136,17736,106400,0.8571244441580202,16.53779911111111,2010.815104,15.097082221479486,122,7.300000000000013E-4
10,test_20231101_134639,11551286.png,271883,527,271356,0.9980616662314304,1,3,40092,76,40016,0.9981043599720643,17.926654222222222,1858.3108106666666,15.43962007470492,122,7.300000000000013E-4
1,test_20231101_134640,10404007.png,502730,24502,478228,0.9512621088854852,2,4,61265,3533,57732,0.9423324900024483,25.254716444444444,3308.321610666667,12.934726390234932,122,7.400000000000013E-4
2,test_20231101_134640,1254659.png,342646,79902,262744,0.7668088931433608,3,4,80080,11101,68979,0.861376123876124,20.33608177777778,3021.365152,13.328771450566173,122,7.400000000000013E-4
3,test_20231101_134640,10188041.png,221231,10304,210927,0.9534242488620491,2,3,41731,1450,40281,0.9652536483669215,10.567601777777778,1003.8131733333333,18.114274701111977,122,7.400000000000013E-4
4,test_20231101_134640,10287332.png,216980,13087,203893,0.939685685316619,2,3,22337,1789,20548,0.9199086717106146,9.406264888888888,766.5465173333333,19.285418460243026,122,7.400000000000013E-4
5,test_20231101_134640,11610969.png,368720,29117,339603,0.9210322195704057,3,3,84111,4247,79864,0.9495071988206061,20.25163022222222,2703.2300906666665,13.811973477796158,122,7.400000000000013E-4
6,test_20231101_134640,10350842.png,212614,6607,206007,0.9689249061679852,1,3,42529,968,41561,0.9772390604058407,19.040565333333333,2318.447829333333,14.478830331991979,122,7.400000000000013E-4
7,test_20231101_134640,10863862.png,317432,14012,303420,0.9558582625570201,2,3,66058,2013,64045,0.9695267794968059,23.48735466666667,3165.0385226666667,13.127013605493714,122,7.400000000000013E-4
8,test_20231101_134640,11382381.png,312486,827,311659,0.9973534814359684,1,3,46745,109,46636,0.997668199807466,21.564144,2476.360432,14.192665047538828,122,7.400000000000013E-4
9,test_20231101_134640,11079715.png,443815,127382,316433,0.7129840136092742,4,4,124136,17736,106400,0.8571244441580202,16.53779911111111,2010.815104,15.097082221479486,122,7.400000000000013E-4
10,test_20231101_134640,11551286.png,271883,527,271356,0.9980616662314304,2,3,40092,76,40016,0.9981043599720643,17.926654222222222,1858.3108106666666,15.43962007470492,122,7.400000000000013E-4
1,test_20231101_134640,10404007.png,502730,24502,478228,0.9512621088854852,3,4,61265,3533,57732,0.9423324900024483,25.254716444444444,3308.321610666667,12.934726390234932,122,7.500000000000013E-4
2,test_20231101_134640,1254659.png,342646,79902,262744,0.7668088931433608,3,4,80080,11101,68979,0.861376123876124,20.33608177777778,3021.365152,13.328771450566173,122,7.500000000000013E-4
3,test_20231101_134640,10188041.png,221231,10304,210927,0.9534242488620491,2,3,41731,1450,40281,0.9652536483669215,10.567601777777778,1003.8131733333333,18.114274701111977,122,7.500000000000013E-4
4,test_20231101_134640,10287332.png,216980,13087,203893,0.939685685316619,2,4,22337,1789,20548,0.9199086717106146,9.406264888888888,766.5465173333333,19.285418460243026,122,7.500000000000013E-4
5,test_20231101_134640,11610969.png,368720,29117,339603,0.9210322195704057,3,3,84111,4247,79864,0.9495071988206061,20.25163022222222,2703.2300906666665,13.811973477796158,122,7.500000000000013E-4
6,test_20231101_134640,10350842.png,212614,6607,206007,0.9689249061679852,1,3,42529,968,41561,0.9772390604058407,19.040565333333333,2318.447829333333,14.478830331991979,122,7.500000000000013E-4
7,test_20231101_134640,10863862.png,317432,14012,303420,0.9558582625570201,2,3,66058,2013,64045,0.9695267794968059,23.48735466666667,3165.0385226666667,13.127013605493714,122,7.500000000000013E-4
8,test_20231101_134640,11382381.png,312486,827,311659,0.9973534814359684,1,3,46745,109,46636,0.997668199807466,21.564144,2476.360432,14.192665047538828,122,7.500000000000013E-4
9,test_20231101_134640,11079715.png,443815,127382,316433,0.7129840136092742,4,4,124136,17736,106400,0.8571244441580202,16.53779911111111,2010.815104,15.097082221479486,122,7.500000000000013E-4
10,test_20231101_134640,11551286.png,271883,527,271356,0.9980616662314304,2,3,40092,76,40016,0.9981043599720643,17.926654222222222,1858.3108106666666,15.43962007470492,122,7.500000000000013E-4
1,test_20231101_134641,10404007.png,502730,24202,478528,0.9518588506753128,2,3,61265,3491,57774,0.9430180363992492,25.270901333333335,3312.221664,12.92960967468018,122,7.600000000000013E-4
2,test_20231101_134641,1254659.png,342646,79902,262744,0.7668088931433608,3,4,80080,11101,68979,0.861376123876124,20.33608177777778,3021.365152,13.328771450566173,122,7.600000000000013E-4
3,test_20231101_134641,10188041.png,221231,10222,211009,0.9537949021610895,2,3,41731,1440,40291,0.9654932783781841,10.694371555555556,1014.7315626666667,18.06729191792479,122,7.600000000000013E-4
4,test_20231101_134641,10287332.png,216980,13087,203893,0.939685685316619,2,4,22337,1789,20548,0.9199086717106146,9.406264888888888,766.5465173333333,19.285418460243026,122,7.600000000000013E-4
5,test_20231101_134641,11610969.png,368720,29117,339603,0.9210322195704057,3,4,84111,4247,79864,0.9495071988206061,20.25163022222222,2703.2300906666665,13.811973477796158,122,7.600000000000013E-4
6,test_20231101_134641,10350842.png,212614,6607,206007,0.9689249061679852,2,4,42529,968,41561,0.9772390604058407,19.040565333333333,2318.447829333333,14.478830331991979,122,7.600000000000013E-4
7,test_20231101_134641,10863862.png,317432,14012,303420,0.9558582625570201,3,4,66058,2013,64045,0.9695267794968059,23.48735466666667,3165.0385226666667,13.127013605493714,122,7.600000000000013E-4
8,test_20231101_134641,11382381.png,312486,827,311659,0.9973534814359684,2,4,46745,109,46636,0.997668199807466,21.564144,2476.360432,14.192665047538828,122,7.600000000000013E-4
9,test_20231101_134641,11079715.png,443815,127382,316433,0.7129840136092742,4,4,124136,17736,106400,0.8571244441580202,16.53779911111111,2010.815104,15.097082221479486,122,7.600000000000013E-4
10,test_20231101_134641,11551286.png,271883,527,271356,0.9980616662314304,3,6,40092,76,40016,0.9981043599720643,17.926654222222222,1858.3108106666666,15.43962007470492,122,7.600000000000013E-4
1,test_20231101_134642,10404007.png,502730,24202,478528,0.9518588506753128,3,4,61265,3491,57774,0.9430180363992492,25.270901333333335,3312.221664,12.92960967468018,122,7.700000000000014E-4
2,test_20231101_134642,1254659.png,342646,79902,262744,0.7668088931433608,3,4,80080,11101,68979,0.861376123876124,20.33608177777778,3021.365152,13.328771450566173,122,7.700000000000014E-4
3,test_20231101_134642,10188041.png,221231,10222,211009,0.9537949021610895,2,4,41731,1440,40291,0.9654932783781841,10.694371555555556,1014.7315626666667,18.06729191792479,122,7.700000000000014E-4
4,test_20231101_134642,10287332.png,216980,13087,203893,0.939685685316619,2,4,22337,1789,20548,0.9199086717106146,9.406264888888888,766.5465173333333,19.285418460243026,122,7.700000000000014E-4
5,test_20231101_134642,11610969.png,368720,29117,339603,0.9210322195704057,2,4,84111,4247,79864,0.9495071988206061,20.25163022222222,2703.2300906666665,13.811973477796158,122,7.700000000000014E-4
6,test_20231101_134642,10350842.png,212614,6607,206007,0.9689249061679852,1,4,42529,968,41561,0.9772390604058407,19.040565333333333,2318.447829333333,14.478830331991979,122,7.700000000000014E-4
7,test_20231101_134642,10863862.png,317432,14012,303420,0.9558582625570201,2,4,66058,2013,64045,0.9695267794968059,23.48735466666667,3165.0385226666667,13.127013605493714,122,7.700000000000014E-4
8,test_20231101_134642,11382381.png,312486,827,311659,0.9973534814359684,2,3,46745,109,46636,0.997668199807466,21.564144,2476.360432,14.192665047538828,122,7.700000000000014E-4
9,test_20231101_134642,11079715.png,443815,127382,316433,0.7129840136092742,3,4,124136,17736,106400,0.8571244441580202,16.53779911111111,2010.815104,15.097082221479486,122,7.700000000000014E-4
10,test_20231101_134642,11551286.png,271883,527,271356,0.9980616662314304,1,4,40092,76,40016,0.9981043599720643,17.926654222222222,1858.3108106666666,15.43962007470492,122,7.700000000000014E-4
1,test_20231101_134642,10404007.png,502730,24202,478528,0.9518588506753128,2,4,61265,3491,57774,0.9430180363992492,25.270901333333335,3312.221664,12.92960967468018,122,7.800000000000014E-4
2,test_20231101_134642,1254659.png,342646,79902,262744,0.7668088931433608,3,4,80080,11101,68979,0.861376123876124,20.33608177777778,3021.365152,13.328771450566173,122,7.800000000000014E-4
3,test_20231101_134642,10188041.png,221231,10222,211009,0.9537949021610895,2,3,41731,1440,40291,0.9654932783781841,10.694371555555556,1014.7315626666667,18.06729191792479,122,7.800000000000014E-4
4,test_20231101_134642,10287332.png,216980,13087,203893,0.939685685316619,2,4,22337,1789,20548,0.9199086717106146,9.406264888888888,766.5465173333333,19.285418460243026,122,7.800000000000014E-4
5,test_20231101_134642,11610969.png,368720,29117,339603,0.9210322195704057,2,3,84111,4247,79864,0.9495071988206061,20.25163022222222,2703.2300906666665,13.811973477796158,122,7.800000000000014E-4
6,test_20231101_134642,10350842.png,212614,6607,206007,0.9689249061679852,1,4,42529,968,41561,0.9772390604058407,19.040565333333333,2318.447829333333,14.478830331991979,122,7.800000000000014E-4
7,test_20231101_134642,10863862.png,317432,14012,303420,0.9558582625570201,2,3,66058,2013,64045,0.9695267794968059,23.48735466666667,3165.0385226666667,13.127013605493714,122,7.800000000000014E-4
8,test_20231101_134642,11382381.png,312486,827,311659,0.9973534814359684,1,3,46745,109,46636,0.997668199807466,21.564144,2476.360432,14.192665047538828,122,7.800000000000014E-4
9,test_20231101_134642,11079715.png,443815,127382,316433,0.7129840136092742,4,4,124136,17736,106400,0.8571244441580202,16.53779911111111,2010.815104,15.097082221479486,122,7.800000000000014E-4
10,test_20231101_134642,11551286.png,271883,527,271356,0.9980616662314304,1,3,40092,76,40016,0.9981043599720643,17.926654222222222,1858.3108106666666,15.43962007470492,122,7.800000000000014E-4
1,test_20231101_134643,10404007.png,502730,24202,478528,0.9518588506753128,3,4,61265,3491,57774,0.9430180363992492,25.270901333333335,3312.221664,12.92960967468018,122,7.900000000000014E-4
2,test_20231101_134643,1254659.png,342646,79902,262744,0.7668088931433608,3,4,80080,11101,68979,0.861376123876124,20.33608177777778,3021.365152,13.328771450566173,122,7.900000000000014E-4
3,test_20231101_134643,10188041.png,221231,10222,211009,0.9537949021610895,2,3,41731,1440,40291,0.9654932783781841,10.694371555555556,1014.7315626666667,18.06729191792479,122,7.900000000000014E-4
4,test_20231101_134643,10287332.png,216980,13087,203893,0.939685685316619,2,4,22337,1789,20548,0.9199086717106146,9.406264888888888,766.5465173333333,19.285418460243026,122,7.900000000000014E-4
5,test_20231101_134643,11610969.png,368720,29117,339603,0.9210322195704057,3,4,84111,4247,79864,0.9495071988206061,20.25163022222222,2703.2300906666665,13.811973477796158,122,7.900000000000014E-4
6,test_20231101_134643,10350842.png,212614,6607,206007,0.9689249061679852,1,3,42529,968,41561,0.9772390604058407,19.040565333333333,2318.447829333333,14.478830331991979,122,7.900000000000014E-4
7,test_20231101_134643,10863862.png,317432,14012,303420,0.9558582625570201,2,4,66058,2013,64045,0.9695267794968059,23.48735466666667,3165.0385226666667,13.127013605493714,122,7.900000000000014E-4
8,test_20231101_134643,11382381.png,312486,827,311659,0.9973534814359684,1,4,46745,109,46636,0.997668199807466,21.564144,2476.360432,14.192665047538828,122,7.900000000000014E-4
9,test_20231101_134643,11079715.png,443815,127382,316433,0.7129840136092742,4,4,124136,17736,106400,0.8571244441580202,16.53779911111111,2010.815104,15.097082221479486,122,7.900000000000014E-4
10,test_20231101_134643,11551286.png,271883,527,271356,0.9980616662314304,1,3,40092,76,40016,0.9981043599720643,17.926654222222222,1858.3108106666666,15.43962007470492,122,7.900000000000014E-4
1,test_20231101_134644,10404007.png,502730,24202,478528,0.9518588506753128,2,4,61265,3491,57774,0.9430180363992492,25.270901333333335,3312.221664,12.92960967468018,122,8.000000000000014E-4
2,test_20231101_134644,1254659.png,342646,79902,262744,0.7668088931433608,3,7,80080,11101,68979,0.861376123876124,20.33608177777778,3021.365152,13.328771450566173,122,8.000000000000014E-4
3,test_20231101_134644,10188041.png,221231,10222,211009,0.9537949021610895,2,4,41731,1440,40291,0.9654932783781841,10.694371555555556,1014.7315626666667,18.06729191792479,122,8.000000000000014E-4
4,test_20231101_134644,10287332.png,216980,13087,203893,0.939685685316619,2,3,22337,1789,20548,0.9199086717106146,9.406264888888888,766.5465173333333,19.285418460243026,122,8.000000000000014E-4
5,test_20231101_134644,11610969.png,368720,29117,339603,0.9210322195704057,2,4,84111,4247,79864,0.9495071988206061,20.25163022222222,2703.2300906666665,13.811973477796158,122,8.000000000000014E-4
6,test_20231101_134644,10350842.png,212614,6607,206007,0.9689249061679852,1,3,42529,968,41561,0.9772390604058407,19.040565333333333,2318.447829333333,14.478830331991979,122,8.000000000000014E-4
7,test_20231101_134644,10863862.png,317432,14012,303420,0.9558582625570201,2,4,66058,2013,64045,0.9695267794968059,23.48735466666667,3165.0385226666667,13.127013605493714,122,8.000000000000014E-4
8,test_20231101_134644,11382381.png,312486,827,311659,0.9973534814359684,1,7,46745,109,46636,0.997668199807466,21.564144,2476.360432,14.192665047538828,122,8.000000000000014E-4
9,test_20231101_134644,11079715.png,443815,127382,316433,0.7129840136092742,3,4,124136,17736,106400,0.8571244441580202,16.53779911111111,2010.815104,15.097082221479486,122,8.000000000000014E-4
10,test_20231101_134644,11551286.png,271883,527,271356,0.9980616662314304,1,4,40092,76,40016,0.9981043599720643,17.926654222222222,1858.3108106666666,15.43962007470492,122,8.000000000000014E-4
1,test_20231101_134644,10404007.png,502730,24202,478528,0.9518588506753128,2,3,61265,3491,57774,0.9430180363992492,25.270901333333335,3312.221664,12.92960967468018,122,8.100000000000015E-4
2,test_20231101_134644,1254659.png,342646,79902,262744,0.7668088931433608,3,9,80080,11101,68979,0.861376123876124,20.33608177777778,3021.365152,13.328771450566173,122,8.100000000000015E-4
3,test_20231101_134644,10188041.png,221231,10222,211009,0.9537949021610895,2,3,41731,1440,40291,0.9654932783781841,10.694371555555556,1014.7315626666667,18.06729191792479,122,8.100000000000015E-4
4,test_20231101_134644,10287332.png,216980,13087,203893,0.939685685316619,1,4,22337,1789,20548,0.9199086717106146,9.406264888888888,766.5465173333333,19.285418460243026,122,8.100000000000015E-4
5,test_20231101_134644,11610969.png,368720,29117,339603,0.9210322195704057,3,4,84111,4247,79864,0.9495071988206061,20.25163022222222,2703.2300906666665,13.811973477796158,122,8.100000000000015E-4
6,test_20231101_134644,10350842.png,212614,6607,206007,0.9689249061679852,1,3,42529,968,41561,0.9772390604058407,19.040565333333333,2318.447829333333,14.478830331991979,122,8.100000000000015E-4
7,test_20231101_134644,10863862.png,317432,14012,303420,0.9558582625570201,2,3,66058,2013,64045,0.9695267794968059,23.48735466666667,3165.0385226666667,13.127013605493714,122,8.100000000000015E-4
8,test_20231101_134644,11382381.png,312486,827,311659,0.9973534814359684,1,4,46745,109,46636,0.997668199807466,21.564144,2476.360432,14.192665047538828,122,8.100000000000015E-4
9,test_20231101_134644,11079715.png,443815,127382,316433,0.7129840136092742,3,4,124136,17736,106400,0.8571244441580202,16.53779911111111,2010.815104,15.097082221479486,122,8.100000000000015E-4
10,test_20231101_134644,11551286.png,271883,527,271356,0.9980616662314304,1,3,40092,76,40016,0.9981043599720643,17.926654222222222,1858.3108106666666,15.43962007470492,122,8.100000000000015E-4
1,test_20231101_134645,10404007.png,502730,24202,478528,0.9518588506753128,2,3,61265,3491,57774,0.9430180363992492,25.270901333333335,3312.221664,12.92960967468018,122,8.200000000000015E-4
2,test_20231101_134645,1254659.png,342646,79902,262744,0.7668088931433608,4,4,80080,11101,68979,0.861376123876124,20.33608177777778,3021.365152,13.328771450566173,122,8.200000000000015E-4
3,test_20231101_134645,10188041.png,221231,10222,211009,0.9537949021610895,2,3,41731,1440,40291,0.9654932783781841,10.694371555555556,1014.7315626666667,18.06729191792479,122,8.200000000000015E-4
4,test_20231101_134645,10287332.png,216980,13087,203893,0.939685685316619,2,4,22337,1789,20548,0.9199086717106146,9.406264888888888,766.5465173333333,19.285418460243026,122,8.200000000000015E-4
5,test_20231101_134645,11610969.png,368720,29117,339603,0.9210322195704057,2,4,84111,4247,79864,0.9495071988206061,20.25163022222222,2703.2300906666665,13.811973477796158,122,8.200000000000015E-4
6,test_20231101_134645,10350842.png,212614,6607,206007,0.9689249061679852,2,3,42529,968,41561,0.9772390604058407,19.040565333333333,2318.447829333333,14.478830331991979,122,8.200000000000015E-4
7,test_20231101_134645,10863862.png,317432,14012,303420,0.9558582625570201,2,4,66058,2013,64045,0.9695267794968059,23.48735466666667,3165.0385226666667,13.127013605493714,122,8.200000000000015E-4
8,test_20231101_134645,11382381.png,312486,827,311659,0.9973534814359684,2,7,46745,109,46636,0.997668199807466,21.564144,2476.360432,14.192665047538828,122,8.200000000000015E-4
9,test_20231101_134645,11079715.png,443815,127382,316433,0.7129840136092742,4,4,124136,17736,106400,0.8571244441580202,16.53779911111111,2010.815104,15.097082221479486,122,8.200000000000015E-4
10,test_20231101_134645,11551286.png,271883,527,271356,0.9980616662314304,2,3,40092,76,40016,0.9981043599720643,17.926654222222222,1858.3108106666666,15.43962007470492,122,8.200000000000015E-4
1,test_20231101_134646,10404007.png,502730,24202,478528,0.9518588506753128,2,3,61265,3491,57774,0.9430180363992492,25.270901333333335,3312.221664,12.92960967468018,122,8.300000000000015E-4
2,test_20231101_134646,1254659.png,342646,79902,262744,0.7668088931433608,3,4,80080,11101,68979,0.861376123876124,20.33608177777778,3021.365152,13.328771450566173,122,8.300000000000015E-4
3,test_20231101_134646,10188041.png,221231,10222,211009,0.9537949021610895,2,3,41731,1440,40291,0.9654932783781841,10.694371555555556,1014.7315626666667,18.06729191792479,122,8.300000000000015E-4
4,test_20231101_134646,10287332.png,216980,13087,203893,0.939685685316619,2,3,22337,1789,20548,0.9199086717106146,9.406264888888888,766.5465173333333,19.285418460243026,122,8.300000000000015E-4
5,test_20231101_134646,11610969.png,368720,29117,339603,0.9210322195704057,2,4,84111,4247,79864,0.9495071988206061,20.25163022222222,2703.2300906666665,13.811973477796158,122,8.300000000000015E-4
6,test_20231101_134646,10350842.png,212614,6607,206007,0.9689249061679852,1,4,42529,968,41561,0.9772390604058407,19.040565333333333,2318.447829333333,14.478830331991979,122,8.300000000000015E-4
7,test_20231101_134646,10863862.png,317432,14012,303420,0.9558582625570201,2,4,66058,2013,64045,0.9695267794968059,23.48735466666667,3165.0385226666667,13.127013605493714,122,8.300000000000015E-4
8,test_20231101_134646,11382381.png,312486,827,311659,0.9973534814359684,1,4,46745,109,46636,0.997668199807466,21.564144,2476.360432,14.192665047538828,122,8.300000000000015E-4
9,test_20231101_134646,11079715.png,443815,127382,316433,0.7129840136092742,3,5,124136,17736,106400,0.8571244441580202,16.53779911111111,2010.815104,15.097082221479486,122,8.300000000000015E-4
10,test_20231101_134646,11551286.png,271883,527,271356,0.9980616662314304,1,4,40092,76,40016,0.9981043599720643,17.926654222222222,1858.3108106666666,15.43962007470492,122,8.300000000000015E-4
1,test_20231101_134646,10404007.png,502730,24202,478528,0.9518588506753128,2,3,61265,3491,57774,0.9430180363992492,25.270901333333335,3312.221664,12.92960967468018,122,8.400000000000016E-4
2,test_20231101_134646,1254659.png,342646,79902,262744,0.7668088931433608,3,4,80080,11101,68979,0.861376123876124,20.33608177777778,3021.365152,13.328771450566173,122,8.400000000000016E-4
3,test_20231101_134646,10188041.png,221231,10222,211009,0.9537949021610895,2,4,41731,1440,40291,0.9654932783781841,10.694371555555556,1014.7315626666667,18.06729191792479,122,8.400000000000016E-4
4,test_20231101_134646,10287332.png,216980,13087,203893,0.939685685316619,1,3,22337,1789,20548,0.9199086717106146,9.406264888888888,766.5465173333333,19.285418460243026,122,8.400000000000016E-4
5,test_20231101_134646,11610969.png,368720,29117,339603,0.9210322195704057,2,4,84111,4247,79864,0.9495071988206061,20.25163022222222,2703.2300906666665,13.811973477796158,122,8.400000000000016E-4
6,test_20231101_134646,10350842.png,212614,6607,206007,0.9689249061679852,1,4,42529,968,41561,0.9772390604058407,19.040565333333333,2318.447829333333,14.478830331991979,122,8.400000000000016E-4
7,test_20231101_134646,10863862.png,317432,14012,303420,0.9558582625570201,2,4,66058,2013,64045,0.9695267794968059,23.48735466666667,3165.0385226666667,13.127013605493714,122,8.400000000000016E-4
8,test_20231101_134646,11382381.png,312486,827,311659,0.9973534814359684,2,3,46745,109,46636,0.997668199807466,21.564144,2476.360432,14.192665047538828,122,8.400000000000016E-4
9,test_20231101_134646,11079715.png,443815,127382,316433,0.7129840136092742,3,5,124136,17736,106400,0.8571244441580202,16.53779911111111,2010.815104,15.097082221479486,122,8.400000000000016E-4
10,test_20231101_134646,11551286.png,271883,527,271356,0.9980616662314304,1,3,40092,76,40016,0.9981043599720643,17.926654222222222,1858.3108106666666,15.43962007470492,122,8.400000000000016E-4
1,test_20231101_134647,10404007.png,502730,24202,478528,0.9518588506753128,3,3,61265,3491,57774,0.9430180363992492,25.270901333333335,3312.221664,12.92960967468018,122,8.500000000000016E-4
2,test_20231101_134647,1254659.png,342646,79902,262744,0.7668088931433608,3,4,80080,11101,68979,0.861376123876124,20.33608177777778,3021.365152,13.328771450566173,122,8.500000000000016E-4
3,test_20231101_134647,10188041.png,221231,10222,211009,0.9537949021610895,2,4,41731,1440,40291,0.9654932783781841,10.694371555555556,1014.7315626666667,18.06729191792479,122,8.500000000000016E-4
4,test_20231101_134647,10287332.png,216980,13087,203893,0.939685685316619,2,4,22337,1789,20548,0.9199086717106146,9.406264888888888,766.5465173333333,19.285418460243026,122,8.500000000000016E-4
5,test_20231101_134647,11610969.png,368720,29117,339603,0.9210322195704057,2,4,84111,4247,79864,0.9495071988206061,20.25163022222222,2703.2300906666665,13.811973477796158,122,8.500000000000016E-4
6,test_20231101_134647,10350842.png,212614,6607,206007,0.9689249061679852,1,3,42529,968,41561,0.9772390604058407,19.040565333333333,2318.447829333333,14.478830331991979,122,8.500000000000016E-4
7,test_20231101_134647,10863862.png,317432,14012,303420,0.9558582625570201,2,4,66058,2013,64045,0.9695267794968059,23.48735466666667,3165.0385226666667,13.127013605493714,122,8.500000000000016E-4
8,test_20231101_134647,11382381.png,312486,827,311659,0.9973534814359684,2,4,46745,109,46636,0.997668199807466,21.564144,2476.360432,14.192665047538828,122,8.500000000000016E-4
9,test_20231101_134647,11079715.png,443815,127382,316433,0.7129840136092742,3,4,124136,17736,106400,0.8571244441580202,16.53779911111111,2010.815104,15.097082221479486,122,8.500000000000016E-4
10,test_20231101_134647,11551286.png,271883,527,271356,0.9980616662314304,1,4,40092,76,40016,0.9981043599720643,17.926654222222222,1858.3108106666666,15.43962007470492,122,8.500000000000016E-4
1,test_20231101_134648,10404007.png,502730,24202,478528,0.9518588506753128,2,3,61265,3491,57774,0.9430180363992492,25.270901333333335,3312.221664,12.92960967468018,122,8.600000000000016E-4
2,test_20231101_134648,1254659.png,342646,79902,262744,0.7668088931433608,3,5,80080,11101,68979,0.861376123876124,20.33608177777778,3021.365152,13.328771450566173,122,8.600000000000016E-4
3,test_20231101_134648,10188041.png,221231,10222,211009,0.9537949021610895,2,3,41731,1440,40291,0.9654932783781841,10.694371555555556,1014.7315626666667,18.06729191792479,122,8.600000000000016E-4
4,test_20231101_134648,10287332.png,216980,13087,203893,0.939685685316619,1,3,22337,1789,20548,0.9199086717106146,9.406264888888888,766.5465173333333,19.285418460243026,122,8.600000000000016E-4
5,test_20231101_134648,11610969.png,368720,29117,339603,0.9210322195704057,2,4,84111,4247,79864,0.9495071988206061,20.25163022222222,2703.2300906666665,13.811973477796158,122,8.600000000000016E-4
6,test_20231101_134648,10350842.png,212614,6607,206007,0.9689249061679852,2,4,42529,968,41561,0.9772390604058407,19.040565333333333,2318.447829333333,14.478830331991979,122,8.600000000000016E-4
7,test_20231101_134648,10863862.png,317432,14012,303420,0.9558582625570201,2,4,66058,2013,64045,0.9695267794968059,23.48735466666667,3165.0385226666667,13.127013605493714,122,8.600000000000016E-4
8,test_20231101_134648,11382381.png,312486,827,311659,0.9973534814359684,1,3,46745,109,46636,0.997668199807466,21.564144,2476.360432,14.192665047538828,122,8.600000000000016E-4
9,test_20231101_134648,11079715.png,443815,127382,316433,0.7129840136092742,3,4,124136,17736,106400,0.8571244441580202,16.53779911111111,2010.815104,15.097082221479486,122,8.600000000000016E-4
10,test_20231101_134648,11551286.png,271883,527,271356,0.9980616662314304,1,3,40092,76,40016,0.9981043599720643,17.926654222222222,1858.3108106666666,15.43962007470492,122,8.600000000000016E-4
1,test_20231101_134648,10404007.png,502730,24202,478528,0.9518588506753128,3,4,61265,3491,57774,0.9430180363992492,25.270901333333335,3312.221664,12.92960967468018,122,8.700000000000016E-4
2,test_20231101_134648,1254659.png,342646,79902,262744,0.7668088931433608,3,4,80080,11101,68979,0.861376123876124,20.33608177777778,3021.365152,13.328771450566173,122,8.700000000000016E-4
3,test_20231101_134648,10188041.png,221231,10222,211009,0.9537949021610895,3,4,41731,1440,40291,0.9654932783781841,10.694371555555556,1014.7315626666667,18.06729191792479,122,8.700000000000016E-4
4,test_20231101_134648,10287332.png,216980,13087,203893,0.939685685316619,2,3,22337,1789,20548,0.9199086717106146,9.406264888888888,766.5465173333333,19.285418460243026,122,8.700000000000016E-4
5,test_20231101_134648,11610969.png,368720,29117,339603,0.9210322195704057,2,4,84111,4247,79864,0.9495071988206061,20.25163022222222,2703.2300906666665,13.811973477796158,122,8.700000000000016E-4
6,test_20231101_134648,10350842.png,212614,6607,206007,0.9689249061679852,2,3,42529,968,41561,0.9772390604058407,19.040565333333333,2318.447829333333,14.478830331991979,122,8.700000000000016E-4
7,test_20231101_134648,10863862.png,317432,14012,303420,0.9558582625570201,2,3,66058,2013,64045,0.9695267794968059,23.48735466666667,3165.0385226666667,13.127013605493714,122,8.700000000000016E-4
8,test_20231101_134648,11382381.png,312486,827,311659,0.9973534814359684,2,3,46745,109,46636,0.997668199807466,21.564144,2476.360432,14.192665047538828,122,8.700000000000016E-4
9,test_20231101_134648,11079715.png,443815,127382,316433,0.7129840136092742,4,4,124136,17736,106400,0.8571244441580202,16.53779911111111,2010.815104,15.097082221479486,122,8.700000000000016E-4
10,test_20231101_134648,11551286.png,271883,527,271356,0.9980616662314304,2,4,40092,76,40016,0.9981043599720643,17.926654222222222,1858.3108106666666,15.43962007470492,122,8.700000000000016E-4
1,test_20231101_134649,10404007.png,502730,24202,478528,0.9518588506753128,2,4,61265,3491,57774,0.9430180363992492,25.270901333333335,3312.221664,12.92960967468018,122,8.800000000000017E-4
2,test_20231101_134649,1254659.png,342646,79902,262744,0.7668088931433608,2,4,80080,11101,68979,0.861376123876124,20.33608177777778,3021.365152,13.328771450566173,122,8.800000000000017E-4
3,test_20231101_134649,10188041.png,221231,10222,211009,0.9537949021610895,2,3,41731,1440,40291,0.9654932783781841,10.694371555555556,1014.7315626666667,18.06729191792479,122,8.800000000000017E-4
4,test_20231101_134649,10287332.png,216980,13087,203893,0.939685685316619,1,3,22337,1789,20548,0.9199086717106146,9.406264888888888,766.5465173333333,19.285418460243026,122,8.800000000000017E-4
5,test_20231101_134649,11610969.png,368720,29117,339603,0.9210322195704057,2,4,84111,4247,79864,0.9495071988206061,20.25163022222222,2703.2300906666665,13.811973477796158,122,8.800000000000017E-4
6,test_20231101_134649,10350842.png,212614,6607,206007,0.9689249061679852,1,3,42529,968,41561,0.9772390604058407,19.040565333333333,2318.447829333333,14.478830331991979,122,8.800000000000017E-4
7,test_20231101_134649,10863862.png,317432,14012,303420,0.9558582625570201,2,4,66058,2013,64045,0.9695267794968059,23.48735466666667,3165.0385226666667,13.127013605493714,122,8.800000000000017E-4
8,test_20231101_134649,11382381.png,312486,827,311659,0.9973534814359684,1,3,46745,109,46636,0.997668199807466,21.564144,2476.360432,14.192665047538828,122,8.800000000000017E-4
9,test_20231101_134649,11079715.png,443815,127382,316433,0.7129840136092742,5,4,124136,17736,106400,0.8571244441580202,16.53779911111111,2010.815104,15.097082221479486,122,8.800000000000017E-4
10,test_20231101_134649,11551286.png,271883,527,271356,0.9980616662314304,1,3,40092,76,40016,0.9981043599720643,17.926654222222222,1858.3108106666666,15.43962007470492,122,8.800000000000017E-4
1,test_20231101_134650,10404007.png,502730,24202,478528,0.9518588506753128,2,3,61265,3491,57774,0.9430180363992492,25.270901333333335,3312.221664,12.92960967468018,122,8.900000000000017E-4
2,test_20231101_134650,1254659.png,342646,79902,262744,0.7668088931433608,4,4,80080,11101,68979,0.861376123876124,20.33608177777778,3021.365152,13.328771450566173,122,8.900000000000017E-4
3,test_20231101_134650,10188041.png,221231,10222,211009,0.9537949021610895,2,4,41731,1440,40291,0.9654932783781841,10.694371555555556,1014.7315626666667,18.06729191792479,122,8.900000000000017E-4
4,test_20231101_134650,10287332.png,216980,13087,203893,0.939685685316619,2,4,22337,1789,20548,0.9199086717106146,9.406264888888888,766.5465173333333,19.285418460243026,122,8.900000000000017E-4
5,test_20231101_134650,11610969.png,368720,29117,339603,0.9210322195704057,2,4,84111,4247,79864,0.9495071988206061,20.25163022222222,2703.2300906666665,13.811973477796158,122,8.900000000000017E-4
6,test_20231101_134650,10350842.png,212614,6607,206007,0.9689249061679852,2,4,42529,968,41561,0.9772390604058407,19.040565333333333,2318.447829333333,14.478830331991979,122,8.900000000000017E-4
7,test_20231101_134650,10863862.png,317432,14012,303420,0.9558582625570201,2,4,66058,2013,64045,0.9695267794968059,23.48735466666667,3165.0385226666667,13.127013605493714,122,8.900000000000017E-4
8,test_20231101_134650,11382381.png,312486,827,311659,0.9973534814359684,1,4,46745,109,46636,0.997668199807466,21.564144,2476.360432,14.192665047538828,122,8.900000000000017E-4
9,test_20231101_134650,11079715.png,443815,127382,316433,0.7129840136092742,4,4,124136,17736,106400,0.8571244441580202,16.53779911111111,2010.815104,15.097082221479486,122,8.900000000000017E-4
10,test_20231101_134650,11551286.png,271883,527,271356,0.9980616662314304,2,4,40092,76,40016,0.9981043599720643,17.926654222222222,1858.3108106666666,15.43962007470492,122,8.900000000000017E-4
1,test_20231101_134651,10404007.png,502730,24202,478528,0.9518588506753128,3,3,61265,3491,57774,0.9430180363992492,25.270901333333335,3312.221664,12.92960967468018,122,9.000000000000017E-4
2,test_20231101_134651,1254659.png,342646,79902,262744,0.7668088931433608,3,3,80080,11101,68979,0.861376123876124,20.33608177777778,3021.365152,13.328771450566173,122,9.000000000000017E-4
3,test_20231101_134651,10188041.png,221231,10222,211009,0.9537949021610895,2,3,41731,1440,40291,0.9654932783781841,10.694371555555556,1014.7315626666667,18.06729191792479,122,9.000000000000017E-4
4,test_20231101_134651,10287332.png,216980,13087,203893,0.939685685316619,1,3,22337,1789,20548,0.9199086717106146,9.406264888888888,766.5465173333333,19.285418460243026,122,9.000000000000017E-4
5,test_20231101_134651,11610969.png,368720,29117,339603,0.9210322195704057,3,4,84111,4247,79864,0.9495071988206061,20.25163022222222,2703.2300906666665,13.811973477796158,122,9.000000000000017E-4
6,test_20231101_134651,10350842.png,212614,6607,206007,0.9689249061679852,2,3,42529,968,41561,0.9772390604058407,19.040565333333333,2318.447829333333,14.478830331991979,122,9.000000000000017E-4
7,test_20231101_134651,10863862.png,317432,14012,303420,0.9558582625570201,2,3,66058,2013,64045,0.9695267794968059,23.48735466666667,3165.0385226666667,13.127013605493714,122,9.000000000000017E-4
8,test_20231101_134651,11382381.png,312486,827,311659,0.9973534814359684,2,3,46745,109,46636,0.997668199807466,21.564144,2476.360432,14.192665047538828,122,9.000000000000017E-4
9,test_20231101_134651,11079715.png,443815,127382,316433,0.7129840136092742,3,4,124136,17736,106400,0.8571244441580202,16.53779911111111,2010.815104,15.097082221479486,122,9.000000000000017E-4
10,test_20231101_134651,11551286.png,271883,527,271356,0.9980616662314304,1,4,40092,76,40016,0.9981043599720643,17.926654222222222,1858.3108106666666,15.43962007470492,122,9.000000000000017E-4
1,test_20231101_134651,10404007.png,502730,24202,478528,0.9518588506753128,2,3,61265,3491,57774,0.9430180363992492,25.270901333333335,3312.221664,12.92960967468018,122,9.100000000000017E-4
2,test_20231101_134651,1254659.png,342646,79902,262744,0.7668088931433608,3,4,80080,11101,68979,0.861376123876124,20.33608177777778,3021.365152,13.328771450566173,122,9.100000000000017E-4
3,test_20231101_134651,10188041.png,221231,10222,211009,0.9537949021610895,2,4,41731,1440,40291,0.9654932783781841,10.694371555555556,1014.7315626666667,18.06729191792479,122,9.100000000000017E-4
4,test_20231101_134651,10287332.png,216980,13087,203893,0.939685685316619,1,4,22337,1789,20548,0.9199086717106146,9.406264888888888,766.5465173333333,19.285418460243026,122,9.100000000000017E-4
5,test_20231101_134651,11610969.png,368720,29117,339603,0.9210322195704057,2,4,84111,4247,79864,0.9495071988206061,20.25163022222222,2703.2300906666665,13.811973477796158,122,9.100000000000017E-4
6,test_20231101_134651,10350842.png,212614,6607,206007,0.9689249061679852,1,3,42529,968,41561,0.9772390604058407,19.040565333333333,2318.447829333333,14.478830331991979,122,9.100000000000017E-4
7,test_20231101_134651,10863862.png,317432,14012,303420,0.9558582625570201,2,4,66058,2013,64045,0.9695267794968059,23.48735466666667,3165.0385226666667,13.127013605493714,122,9.100000000000017E-4
8,test_20231101_134651,11382381.png,312486,827,311659,0.9973534814359684,1,3,46745,109,46636,0.997668199807466,21.564144,2476.360432,14.192665047538828,122,9.100000000000017E-4
9,test_20231101_134651,11079715.png,443815,127382,316433,0.7129840136092742,10,4,124136,17736,106400,0.8571244441580202,16.53779911111111,2010.815104,15.097082221479486,122,9.100000000000017E-4
10,test_20231101_134651,11551286.png,271883,527,271356,0.9980616662314304,1,4,40092,76,40016,0.9981043599720643,17.926654222222222,1858.3108106666666,15.43962007470492,122,9.100000000000017E-4
1,test_20231101_134652,10404007.png,502730,24202,478528,0.9518588506753128,2,4,61265,3491,57774,0.9430180363992492,25.270901333333335,3312.221664,12.92960967468018,122,9.200000000000018E-4
2,test_20231101_134652,1254659.png,342646,79902,262744,0.7668088931433608,5,4,80080,11101,68979,0.861376123876124,20.33608177777778,3021.365152,13.328771450566173,122,9.200000000000018E-4
3,test_20231101_134652,10188041.png,221231,10222,211009,0.9537949021610895,2,4,41731,1440,40291,0.9654932783781841,10.694371555555556,1014.7315626666667,18.06729191792479,122,9.200000000000018E-4
4,test_20231101_134652,10287332.png,216980,13087,203893,0.939685685316619,2,4,22337,1789,20548,0.9199086717106146,9.406264888888888,766.5465173333333,19.285418460243026,122,9.200000000000018E-4
5,test_20231101_134652,11610969.png,368720,29117,339603,0.9210322195704057,3,4,84111,4247,79864,0.9495071988206061,20.25163022222222,2703.2300906666665,13.811973477796158,122,9.200000000000018E-4
6,test_20231101_134652,10350842.png,212614,6607,206007,0.9689249061679852,1,3,42529,968,41561,0.9772390604058407,19.040565333333333,2318.447829333333,14.478830331991979,122,9.200000000000018E-4
7,test_20231101_134652,10863862.png,317432,14012,303420,0.9558582625570201,2,3,66058,2013,64045,0.9695267794968059,23.48735466666667,3165.0385226666667,13.127013605493714,122,9.200000000000018E-4
8,test_20231101_134652,11382381.png,312486,827,311659,0.9973534814359684,2,4,46745,109,46636,0.997668199807466,21.564144,2476.360432,14.192665047538828,122,9.200000000000018E-4
9,test_20231101_134652,11079715.png,443815,127382,316433,0.7129840136092742,4,5,124136,17736,106400,0.8571244441580202,16.53779911111111,2010.815104,15.097082221479486,122,9.200000000000018E-4
10,test_20231101_134652,11551286.png,271883,527,271356,0.9980616662314304,1,3,40092,76,40016,0.9981043599720643,17.926654222222222,1858.3108106666666,15.43962007470492,122,9.200000000000018E-4
1,test_20231101_134653,10404007.png,502730,24202,478528,0.9518588506753128,2,16,61265,3491,57774,0.9430180363992492,25.270901333333335,3312.221664,12.92960967468018,122,9.300000000000018E-4
2,test_20231101_134653,1254659.png,342646,79902,262744,0.7668088931433608,3,4,80080,11101,68979,0.861376123876124,20.33608177777778,3021.365152,13.328771450566173,122,9.300000000000018E-4
3,test_20231101_134653,10188041.png,221231,10222,211009,0.9537949021610895,2,4,41731,1440,40291,0.9654932783781841,10.694371555555556,1014.7315626666667,18.06729191792479,122,9.300000000000018E-4
4,test_20231101_134653,10287332.png,216980,13087,203893,0.939685685316619,2,4,22337,1789,20548,0.9199086717106146,9.406264888888888,766.5465173333333,19.285418460243026,122,9.300000000000018E-4
5,test_20231101_134653,11610969.png,368720,29117,339603,0.9210322195704057,2,3,84111,4247,79864,0.9495071988206061,20.25163022222222,2703.2300906666665,13.811973477796158,122,9.300000000000018E-4
6,test_20231101_134653,10350842.png,212614,6607,206007,0.9689249061679852,1,3,42529,968,41561,0.9772390604058407,19.040565333333333,2318.447829333333,14.478830331991979,122,9.300000000000018E-4
7,test_20231101_134653,10863862.png,317432,14012,303420,0.9558582625570201,3,4,66058,2013,64045,0.9695267794968059,23.48735466666667,3165.0385226666667,13.127013605493714,122,9.300000000000018E-4
8,test_20231101_134653,11382381.png,312486,827,311659,0.9973534814359684,2,4,46745,109,46636,0.997668199807466,21.564144,2476.360432,14.192665047538828,122,9.300000000000018E-4
9,test_20231101_134653,11079715.png,443815,127382,316433,0.7129840136092742,4,4,124136,17736,106400,0.8571244441580202,16.53779911111111,2010.815104,15.097082221479486,122,9.300000000000018E-4
10,test_20231101_134653,11551286.png,271883,527,271356,0.9980616662314304,1,4,40092,76,40016,0.9981043599720643,17.926654222222222,1858.3108106666666,15.43962007470492,122,9.300000000000018E-4
1,test_20231101_134653,10404007.png,502730,24202,478528,0.9518588506753128,3,4,61265,3491,57774,0.9430180363992492,25.270901333333335,3312.221664,12.92960967468018,122,9.400000000000018E-4
2,test_20231101_134653,1254659.png,342646,79902,262744,0.7668088931433608,3,4,80080,11101,68979,0.861376123876124,20.33608177777778,3021.365152,13.328771450566173,122,9.400000000000018E-4
3,test_20231101_134653,10188041.png,221231,10222,211009,0.9537949021610895,2,4,41731,1440,40291,0.9654932783781841,10.694371555555556,1014.7315626666667,18.06729191792479,122,9.400000000000018E-4
4,test_20231101_134653,10287332.png,216980,13087,203893,0.939685685316619,2,4,22337,1789,20548,0.9199086717106146,9.406264888888888,766.5465173333333,19.285418460243026,122,9.400000000000018E-4
5,test_20231101_134653,11610969.png,368720,29117,339603,0.9210322195704057,3,4,84111,4247,79864,0.9495071988206061,20.25163022222222,2703.2300906666665,13.811973477796158,122,9.400000000000018E-4
6,test_20231101_134653,10350842.png,212614,6607,206007,0.9689249061679852,1,4,42529,968,41561,0.9772390604058407,19.040565333333333,2318.447829333333,14.478830331991979,122,9.400000000000018E-4
7,test_20231101_134653,10863862.png,317432,14012,303420,0.9558582625570201,2,4,66058,2013,64045,0.9695267794968059,23.48735466666667,3165.0385226666667,13.127013605493714,122,9.400000000000018E-4
8,test_20231101_134653,11382381.png,312486,827,311659,0.9973534814359684,2,3,46745,109,46636,0.997668199807466,21.564144,2476.360432,14.192665047538828,122,9.400000000000018E-4
9,test_20231101_134653,11079715.png,443815,127382,316433,0.7129840136092742,3,4,124136,17736,106400,0.8571244441580202,16.53779911111111,2010.815104,15.097082221479486,122,9.400000000000018E-4
10,test_20231101_134653,11551286.png,271883,527,271356,0.9980616662314304,1,4,40092,76,40016,0.9981043599720643,17.926654222222222,1858.3108106666666,15.43962007470492,122,9.400000000000018E-4
1,test_20231101_134654,10404007.png,502730,24202,478528,0.9518588506753128,3,3,61265,3491,57774,0.9430180363992492,25.270901333333335,3312.221664,12.92960967468018,122,9.500000000000018E-4
2,test_20231101_134654,1254659.png,342646,79902,262744,0.7668088931433608,3,4,80080,11101,68979,0.861376123876124,20.33608177777778,3021.365152,13.328771450566173,122,9.500000000000018E-4
3,test_20231101_134654,10188041.png,221231,10222,211009,0.9537949021610895,2,4,41731,1440,40291,0.9654932783781841,10.694371555555556,1014.7315626666667,18.06729191792479,122,9.500000000000018E-4
4,test_20231101_134654,10287332.png,216980,13087,203893,0.939685685316619,3,4,22337,1789,20548,0.9199086717106146,9.406264888888888,766.5465173333333,19.285418460243026,122,9.500000000000018E-4
5,test_20231101_134654,11610969.png,368720,29117,339603,0.9210322195704057,3,4,84111,4247,79864,0.9495071988206061,20.25163022222222,2703.2300906666665,13.811973477796158,122,9.500000000000018E-4
6,test_20231101_134654,10350842.png,212614,6607,206007,0.9689249061679852,2,3,42529,968,41561,0.9772390604058407,19.040565333333333,2318.447829333333,14.478830331991979,122,9.500000000000018E-4
7,test_20231101_134654,10863862.png,317432,14012,303420,0.9558582625570201,2,4,66058,2013,64045,0.9695267794968059,23.48735466666667,3165.0385226666667,13.127013605493714,122,9.500000000000018E-4
8,test_20231101_134654,11382381.png,312486,827,311659,0.9973534814359684,2,4,46745,109,46636,0.997668199807466,21.564144,2476.360432,14.192665047538828,122,9.500000000000018E-4
9,test_20231101_134654,11079715.png,443815,127382,316433,0.7129840136092742,3,5,124136,17736,106400,0.8571244441580202,16.53779911111111,2010.815104,15.097082221479486,122,9.500000000000018E-4
10,test_20231101_134654,11551286.png,271883,527,271356,0.9980616662314304,1,3,40092,76,40016,0.9981043599720643,17.926654222222222,1858.3108106666666,15.43962007470492,122,9.500000000000018E-4
1,test_20231101_134655,10404007.png,502730,23879,478851,0.9525013426690271,2,4,61265,3446,57819,0.9437525503958214,25.318259555555557,3321.57464,12.917363448322012,122,9.600000000000019E-4
2,test_20231101_134655,1254659.png,342646,79902,262744,0.7668088931433608,3,4,80080,11101,68979,0.861376123876124,20.33608177777778,3021.365152,13.328771450566173,122,9.600000000000019E-4
3,test_20231101_134655,10188041.png,221231,10122,211109,0.9542469183794314,1,3,41731,1429,40302,0.965756871390573,10.741859555555555,1019.938592,18.045063361240036,122,9.600000000000019E-4
4,test_20231101_134655,10287332.png,216980,13087,203893,0.939685685316619,3,4,22337,1789,20548,0.9199086717106146,9.406264888888888,766.5465173333333,19.285418460243026,122,9.600000000000019E-4
5,test_20231101_134655,11610969.png,368720,29117,339603,0.9210322195704057,2,4,84111,4247,79864,0.9495071988206061,20.25163022222222,2703.2300906666665,13.811973477796158,122,9.600000000000019E-4
6,test_20231101_134655,10350842.png,212614,6607,206007,0.9689249061679852,1,10,42529,968,41561,0.9772390604058407,19.040565333333333,2318.447829333333,14.478830331991979,122,9.600000000000019E-4
7,test_20231101_134655,10863862.png,317432,14012,303420,0.9558582625570201,2,3,66058,2013,64045,0.9695267794968059,23.48735466666667,3165.0385226666667,13.127013605493714,122,9.600000000000019E-4
8,test_20231101_134655,11382381.png,312486,827,311659,0.9973534814359684,1,4,46745,109,46636,0.997668199807466,21.564144,2476.360432,14.192665047538828,122,9.600000000000019E-4
9,test_20231101_134655,11079715.png,443815,127382,316433,0.7129840136092742,3,4,124136,17736,106400,0.8571244441580202,16.53779911111111,2010.815104,15.097082221479486,122,9.600000000000019E-4
10,test_20231101_134655,11551286.png,271883,527,271356,0.9980616662314304,1,4,40092,76,40016,0.9981043599720643,17.926654222222222,1858.3108106666666,15.43962007470492,122,9.600000000000019E-4
1,test_20231101_134655,10404007.png,502730,23879,478851,0.9525013426690271,2,3,61265,3446,57819,0.9437525503958214,25.318259555555557,3321.57464,12.917363448322012,122,9.700000000000019E-4
2,test_20231101_134655,1254659.png,342646,79902,262744,0.7668088931433608,3,4,80080,11101,68979,0.861376123876124,20.33608177777778,3021.365152,13.328771450566173,122,9.700000000000019E-4
3,test_20231101_134655,10188041.png,221231,10122,211109,0.9542469183794314,1,3,41731,1429,40302,0.965756871390573,10.741859555555555,1019.938592,18.045063361240036,122,9.700000000000019E-4
4,test_20231101_134655,10287332.png,216980,13087,203893,0.939685685316619,2,4,22337,1789,20548,0.9199086717106146,9.406264888888888,766.5465173333333,19.285418460243026,122,9.700000000000019E-4
5,test_20231101_134655,11610969.png,368720,29117,339603,0.9210322195704057,2,4,84111,4247,79864,0.9495071988206061,20.25163022222222,2703.2300906666665,13.811973477796158,122,9.700000000000019E-4
6,test_20231101_134655,10350842.png,212614,6607,206007,0.9689249061679852,2,4,42529,968,41561,0.9772390604058407,19.040565333333333,2318.447829333333,14.478830331991979,122,9.700000000000019E-4
7,test_20231101_134655,10863862.png,317432,14012,303420,0.9558582625570201,2,4,66058,2013,64045,0.9695267794968059,23.48735466666667,3165.0385226666667,13.127013605493714,122,9.700000000000019E-4
8,test_20231101_134655,11382381.png,312486,827,311659,0.9973534814359684,1,4,46745,109,46636,0.997668199807466,21.564144,2476.360432,14.192665047538828,122,9.700000000000019E-4
9,test_20231101_134655,11079715.png,443815,127382,316433,0.7129840136092742,4,4,124136,17736,106400,0.8571244441580202,16.53779911111111,2010.815104,15.097082221479486,122,9.700000000000019E-4
10,test_20231101_134655,11551286.png,271883,527,271356,0.9980616662314304,1,4,40092,76,40016,0.9981043599720643,17.926654222222222,1858.3108106666666,15.43962007470492,122,9.700000000000019E-4
1,test_20231101_134656,10404007.png,502730,23397,479333,0.95346010781135,2,3,61265,3384,57881,0.9447645474577655,25.510517333333333,3363.304448,12.86314179220259,122,9.80000000000002E-4
2,test_20231101_134656,1254659.png,342646,79682,262964,0.7674509552132521,3,3,80080,11078,69002,0.8616633366633366,20.429603555555556,3038.799296,13.303783437488493,122,9.80000000000002E-4
3,test_20231101_134656,10188041.png,221231,10002,211229,0.9547893378414417,2,4,41731,1414,40317,0.9661163164074669,10.823772444444444,1034.4124266666668,17.983866316711868,122,9.80000000000002E-4
4,test_20231101_134656,10287332.png,216980,13067,203913,0.9397778597105724,2,4,22337,1786,20551,0.9200429780185343,9.432291555555556,770.9674026666667,19.260443448678878,122,9.80000000000002E-4
5,test_20231101_134656,11610969.png,368720,28812,339908,0.9218594055109568,4,3,84111,4210,79901,0.949947093721392,20.388913777777777,2726.347488,13.774991526182546,122,9.80000000000002E-4
6,test_20231101_134656,10350842.png,212614,6487,206127,0.9694893092646768,1,3,42529,950,41579,0.9776623010181288,19.19528177777778,2347.106709333333,14.425475259684495,122,9.80000000000002E-4
7,test_20231101_134656,10863862.png,317432,13429,304003,0.9576948763829733,2,3,66058,1933,64125,0.9707378364467589,23.766021333333335,3231.9151413333334,13.036204116535098,122,9.80000000000002E-4
8,test_20231101_134656,11382381.png,312486,767,311719,0.9975454900379537,2,3,46745,101,46644,0.9978393411060006,21.620851555555557,2482.477712,14.181950028339719,122,9.80000000000002E-4
9,test_20231101_134656,11079715.png,443815,127302,316513,0.7131642688958237,4,4,124136,17730,106406,0.8571727782432171,16.55652977777778,2013.6806933333332,15.090897546887387,122,9.80000000000002E-4
10,test_20231101_134656,11551286.png,271883,487,271396,0.9982087883391018,1,3,40092,70,40022,0.9982540157637434,17.985697777777776,1870.2736906666667,15.411751962304145,122,9.80000000000002E-4
1,test_20231101_134657,10404007.png,502730,23397,479333,0.95346010781135,2,4,61265,3384,57881,0.9447645474577655,25.510517333333333,3363.304448,12.86314179220259,122,9.90000000000002E-4
2,test_20231101_134657,1254659.png,342646,79682,262964,0.7674509552132521,3,4,80080,11078,69002,0.8616633366633366,20.429603555555556,3038.799296,13.303783437488493,122,9.90000000000002E-4
3,test_20231101_134657,10188041.png,221231,10002,211229,0.9547893378414417,2,4,41731,1414,40317,0.9661163164074669,10.823772444444444,1034.4124266666668,17.983866316711868,122,9.90000000000002E-4
4,test_20231101_134657,10287332.png,216980,13067,203913,0.9397778597105724,1,4,22337,1786,20551,0.9200429780185343,9.432291555555556,770.9674026666667,19.260443448678878,122,9.90000000000002E-4
5,test_20231101_134657,11610969.png,368720,28812,339908,0.9218594055109568,3,3,84111,4210,79901,0.949947093721392,20.388913777777777,2726.347488,13.774991526182546,122,9.90000000000002E-4
6,test_20231101_134657,10350842.png,212614,6487,206127,0.9694893092646768,2,4,42529,950,41579,0.9776623010181288,19.19528177777778,2347.106709333333,14.425475259684495,122,9.90000000000002E-4
7,test_20231101_134657,10863862.png,317432,13429,304003,0.9576948763829733,2,4,66058,1933,64125,0.9707378364467589,23.766021333333335,3231.9151413333334,13.036204116535098,122,9.90000000000002E-4
8,test_20231101_134657,11382381.png,312486,767,311719,0.9975454900379537,1,3,46745,101,46644,0.9978393411060006,21.620851555555557,2482.477712,14.181950028339719,122,9.90000000000002E-4
9,test_20231101_134657,11079715.png,443815,127302,316513,0.7131642688958237,4,4,124136,17730,106406,0.8571727782432171,16.55652977777778,2013.6806933333332,15.090897546887387,122,9.90000000000002E-4
10,test_20231101_134657,11551286.png,271883,487,271396,0.9982087883391018,1,3,40092,70,40022,0.9982540157637434,17.985697777777776,1870.2736906666667,15.411751962304145,122,9.90000000000002E-4
1,test_20231101_134657,10404007.png,502730,24182,478548,0.9518986334613013,2,4,61265,3483,57782,0.9431486166653065,25.191109333333333,3298.676826666667,12.947405913275208,123,0.0
2,test_20231101_134657,1254659.png,342646,78072,264574,0.7721496821792754,3,4,80080,10861,69219,0.8643731268731268,20.51848177777778,3069.789525333333,13.259717609997972,123,0.0
3,test_20231101_134657,10188041.png,221231,10202,211029,0.9538853054047579,2,4,41731,1437,40294,0.9655651673815628,10.472250666666667,996.2625973333334,18.147065349528113,123,0.0
4,test_20231101_134657,10287332.png,216980,12977,204003,0.9401926444833625,2,3,22337,1774,20563,0.9205802032502126,9.307064888888888,748.7130986666666,19.387649297314677,123,0.0
5,test_20231101_134657,11610969.png,368720,28492,340228,0.9227272727272727,2,4,84111,4156,79955,0.9505891024955119,19.969996444444444,2649.321978666667,13.899456184782972,123,0.0
6,test_20231101_134657,10350842.png,212614,6887,205727,0.967607965609038,2,4,42529,1009,41520,0.9762750123445179,17.477884444444445,1977.0087253333334,15.170717748340774,123,0.0
7,test_20231101_134657,10863862.png,317432,13337,304095,0.9579847022354394,2,4,66058,1928,64130,0.9708135275061309,23.652634666666668,3218.7282186666666,13.053960533703744,123,0.0
8,test_20231101_134657,11382381.png,312486,1229,311257,0.9960670238026663,1,4,46745,168,46577,0.9964060327307733,19.73855111111111,2216.4945546666668,14.67413692176443,123,0.0
9,test_20231101_134657,11079715.png,443815,125192,318623,0.7179185020785688,3,4,124136,17444,106692,0.8594767029709351,16.64877511111111,2039.7730453333334,15.034985123844537,123,0.0
10,test_20231101_134657,11551286.png,271883,1322,270561,0.9951376143414631,1,4,40092,194,39898,0.9951611294023746,15.753514666666666,1496.8890666666666,16.378907445727467,123,0.0
1,test_20231101_134658,10404007.png,502730,24182,478548,0.9518986334613013,2,4,61265,3483,57782,0.9431486166653065,25.191109333333333,3298.676826666667,12.947405913275208,123,1.0E-5
2,test_20231101_134658,1254659.png,342646,78072,264574,0.7721496821792754,3,4,80080,10861,69219,0.8643731268731268,20.51848177777778,3069.789525333333,13.259717609997972,123,1.0E-5
3,test_20231101_134658,10188041.png,221231,10202,211029,0.9538853054047579,2,4,41731,1437,40294,0.9655651673815628,10.472250666666667,996.2625973333334,18.147065349528113,123,1.0E-5
4,test_20231101_134658,10287332.png,216980,12977,204003,0.9401926444833625,2,3,22337,1774,20563,0.9205802032502126,9.307064888888888,748.7130986666666,19.387649297314677,123,1.0E-5
5,test_20231101_134658,11610969.png,368720,28492,340228,0.9227272727272727,3,4,84111,4156,79955,0.9505891024955119,19.969996444444444,2649.321978666667,13.899456184782972,123,1.0E-5
6,test_20231101_134658,10350842.png,212614,6887,205727,0.967607965609038,1,9,42529,1009,41520,0.9762750123445179,17.477884444444445,1977.0087253333334,15.170717748340774,123,1.0E-5
7,test_20231101_134658,10863862.png,317432,13337,304095,0.9579847022354394,2,4,66058,1928,64130,0.9708135275061309,23.652634666666668,3218.7282186666666,13.053960533703744,123,1.0E-5
8,test_20231101_134658,11382381.png,312486,1229,311257,0.9960670238026663,2,3,46745,168,46577,0.9964060327307733,19.73855111111111,2216.4945546666668,14.67413692176443,123,1.0E-5
9,test_20231101_134658,11079715.png,443815,125192,318623,0.7179185020785688,4,5,124136,17444,106692,0.8594767029709351,16.64877511111111,2039.7730453333334,15.034985123844537,123,1.0E-5
10,test_20231101_134658,11551286.png,271883,1322,270561,0.9951376143414631,1,4,40092,194,39898,0.9951611294023746,15.753514666666666,1496.8890666666666,16.378907445727467,123,1.0E-5
1,test_20231101_134659,10404007.png,502730,24182,478548,0.9518986334613013,3,4,61265,3483,57782,0.9431486166653065,25.191109333333333,3298.676826666667,12.947405913275208,123,2.0E-5
2,test_20231101_134659,1254659.png,342646,78072,264574,0.7721496821792754,3,4,80080,10861,69219,0.8643731268731268,20.51848177777778,3069.789525333333,13.259717609997972,123,2.0E-5
3,test_20231101_134659,10188041.png,221231,10202,211029,0.9538853054047579,2,3,41731,1437,40294,0.9655651673815628,10.472250666666667,996.2625973333334,18.147065349528113,123,2.0E-5
4,test_20231101_134659,10287332.png,216980,12977,204003,0.9401926444833625,1,3,22337,1774,20563,0.9205802032502126,9.307064888888888,748.7130986666666,19.387649297314677,123,2.0E-5
5,test_20231101_134659,11610969.png,368720,28492,340228,0.9227272727272727,2,4,84111,4156,79955,0.9505891024955119,19.969996444444444,2649.321978666667,13.899456184782972,123,2.0E-5
6,test_20231101_134659,10350842.png,212614,6887,205727,0.967607965609038,2,3,42529,1009,41520,0.9762750123445179,17.477884444444445,1977.0087253333334,15.170717748340774,123,2.0E-5
7,test_20231101_134659,10863862.png,317432,13337,304095,0.9579847022354394,1,3,66058,1928,64130,0.9708135275061309,23.652634666666668,3218.7282186666666,13.053960533703744,123,2.0E-5
8,test_20231101_134659,11382381.png,312486,1229,311257,0.9960670238026663,1,3,46745,168,46577,0.9964060327307733,19.73855111111111,2216.4945546666668,14.67413692176443,123,2.0E-5
9,test_20231101_134659,11079715.png,443815,125192,318623,0.7179185020785688,4,4,124136,17444,106692,0.8594767029709351,16.64877511111111,2039.7730453333334,15.034985123844537,123,2.0E-5
10,test_20231101_134659,11551286.png,271883,1322,270561,0.9951376143414631,2,4,40092,194,39898,0.9951611294023746,15.753514666666666,1496.8890666666666,16.378907445727467,123,2.0E-5
1,test_20231101_134659,10404007.png,502730,24182,478548,0.9518986334613013,2,4,61265,3483,57782,0.9431486166653065,25.191109333333333,3298.676826666667,12.947405913275208,123,3.0000000000000004E-5
2,test_20231101_134659,1254659.png,342646,78072,264574,0.7721496821792754,3,4,80080,10861,69219,0.8643731268731268,20.51848177777778,3069.789525333333,13.259717609997972,123,3.0000000000000004E-5
3,test_20231101_134659,10188041.png,221231,10202,211029,0.9538853054047579,2,4,41731,1437,40294,0.9655651673815628,10.472250666666667,996.2625973333334,18.147065349528113,123,3.0000000000000004E-5
4,test_20231101_134659,10287332.png,216980,12977,204003,0.9401926444833625,2,3,22337,1774,20563,0.9205802032502126,9.307064888888888,748.7130986666666,19.387649297314677,123,3.0000000000000004E-5
5,test_20231101_134659,11610969.png,368720,28492,340228,0.9227272727272727,2,3,84111,4156,79955,0.9505891024955119,19.969996444444444,2649.321978666667,13.899456184782972,123,3.0000000000000004E-5
6,test_20231101_134659,10350842.png,212614,6887,205727,0.967607965609038,1,3,42529,1009,41520,0.9762750123445179,17.477884444444445,1977.0087253333334,15.170717748340774,123,3.0000000000000004E-5
7,test_20231101_134659,10863862.png,317432,13337,304095,0.9579847022354394,2,4,66058,1928,64130,0.9708135275061309,23.652634666666668,3218.7282186666666,13.053960533703744,123,3.0000000000000004E-5
8,test_20231101_134659,11382381.png,312486,1229,311257,0.9960670238026663,2,3,46745,168,46577,0.9964060327307733,19.73855111111111,2216.4945546666668,14.67413692176443,123,3.0000000000000004E-5
9,test_20231101_134659,11079715.png,443815,125192,318623,0.7179185020785688,4,4,124136,17444,106692,0.8594767029709351,16.64877511111111,2039.7730453333334,15.034985123844537,123,3.0000000000000004E-5
10,test_20231101_134659,11551286.png,271883,1322,270561,0.9951376143414631,2,4,40092,194,39898,0.9951611294023746,15.753514666666666,1496.8890666666666,16.378907445727467,123,3.0000000000000004E-5
1,test_20231101_134700,10404007.png,502730,24182,478548,0.9518986334613013,2,3,61265,3483,57782,0.9431486166653065,25.191109333333333,3298.676826666667,12.947405913275208,123,4.0E-5
2,test_20231101_134700,1254659.png,342646,78072,264574,0.7721496821792754,3,4,80080,10861,69219,0.8643731268731268,20.51848177777778,3069.789525333333,13.259717609997972,123,4.0E-5
3,test_20231101_134700,10188041.png,221231,10202,211029,0.9538853054047579,2,4,41731,1437,40294,0.9655651673815628,10.472250666666667,996.2625973333334,18.147065349528113,123,4.0E-5
4,test_20231101_134700,10287332.png,216980,12977,204003,0.9401926444833625,2,4,22337,1774,20563,0.9205802032502126,9.307064888888888,748.7130986666666,19.387649297314677,123,4.0E-5
5,test_20231101_134700,11610969.png,368720,28492,340228,0.9227272727272727,2,3,84111,4156,79955,0.9505891024955119,19.969996444444444,2649.321978666667,13.899456184782972,123,4.0E-5
6,test_20231101_134700,10350842.png,212614,6887,205727,0.967607965609038,1,4,42529,1009,41520,0.9762750123445179,17.477884444444445,1977.0087253333334,15.170717748340774,123,4.0E-5
7,test_20231101_134700,10863862.png,317432,13337,304095,0.9579847022354394,2,3,66058,1928,64130,0.9708135275061309,23.652634666666668,3218.7282186666666,13.053960533703744,123,4.0E-5
8,test_20231101_134700,11382381.png,312486,1229,311257,0.9960670238026663,2,4,46745,168,46577,0.9964060327307733,19.73855111111111,2216.4945546666668,14.67413692176443,123,4.0E-5
9,test_20231101_134700,11079715.png,443815,125192,318623,0.7179185020785688,3,4,124136,17444,106692,0.8594767029709351,16.64877511111111,2039.7730453333334,15.034985123844537,123,4.0E-5
10,test_20231101_134700,11551286.png,271883,1322,270561,0.9951376143414631,1,3,40092,194,39898,0.9951611294023746,15.753514666666666,1496.8890666666666,16.378907445727467,123,4.0E-5
1,test_20231101_134701,10404007.png,502730,24182,478548,0.9518986334613013,2,4,61265,3483,57782,0.9431486166653065,25.191109333333333,3298.676826666667,12.947405913275208,123,5.0E-5
2,test_20231101_134701,1254659.png,342646,78072,264574,0.7721496821792754,3,4,80080,10861,69219,0.8643731268731268,20.51848177777778,3069.789525333333,13.259717609997972,123,5.0E-5
3,test_20231101_134701,10188041.png,221231,10202,211029,0.9538853054047579,2,3,41731,1437,40294,0.9655651673815628,10.472250666666667,996.2625973333334,18.147065349528113,123,5.0E-5
4,test_20231101_134701,10287332.png,216980,12977,204003,0.9401926444833625,1,4,22337,1774,20563,0.9205802032502126,9.307064888888888,748.7130986666666,19.387649297314677,123,5.0E-5
5,test_20231101_134701,11610969.png,368720,28492,340228,0.9227272727272727,2,4,84111,4156,79955,0.9505891024955119,19.969996444444444,2649.321978666667,13.899456184782972,123,5.0E-5
6,test_20231101_134701,10350842.png,212614,6887,205727,0.967607965609038,2,4,42529,1009,41520,0.9762750123445179,17.477884444444445,1977.0087253333334,15.170717748340774,123,5.0E-5
7,test_20231101_134701,10863862.png,317432,13337,304095,0.9579847022354394,2,3,66058,1928,64130,0.9708135275061309,23.652634666666668,3218.7282186666666,13.053960533703744,123,5.0E-5
8,test_20231101_134701,11382381.png,312486,1159,311327,0.996291033838316,2,4,46745,158,46587,0.9966199593539415,20.606709333333335,2334.900224,14.448120340351833,123,5.0E-5
9,test_20231101_134701,11079715.png,443815,125192,318623,0.7179185020785688,4,4,124136,17444,106692,0.8594767029709351,16.64877511111111,2039.7730453333334,15.034985123844537,123,5.0E-5
10,test_20231101_134701,11551286.png,271883,1322,270561,0.9951376143414631,1,3,40092,194,39898,0.9951611294023746,15.753514666666666,1496.8890666666666,16.378907445727467,123,5.0E-5
1,test_20231101_134702,10404007.png,502730,24182,478548,0.9518986334613013,2,4,61265,3483,57782,0.9431486166653065,25.191109333333333,3298.676826666667,12.947405913275208,123,6.0E-5
2,test_20231101_134702,1254659.png,342646,78072,264574,0.7721496821792754,2,4,80080,10861,69219,0.8643731268731268,20.51848177777778,3069.789525333333,13.259717609997972,123,6.0E-5
3,test_20231101_134702,10188041.png,221231,10202,211029,0.9538853054047579,2,3,41731,1437,40294,0.9655651673815628,10.472250666666667,996.2625973333334,18.147065349528113,123,6.0E-5
4,test_20231101_134702,10287332.png,216980,12977,204003,0.9401926444833625,2,3,22337,1774,20563,0.9205802032502126,9.307064888888888,748.7130986666666,19.387649297314677,123,6.0E-5
5,test_20231101_134702,11610969.png,368720,28492,340228,0.9227272727272727,2,3,84111,4156,79955,0.9505891024955119,19.969996444444444,2649.321978666667,13.899456184782972,123,6.0E-5
6,test_20231101_134702,10350842.png,212614,6887,205727,0.967607965609038,1,4,42529,1009,41520,0.9762750123445179,17.477884444444445,1977.0087253333334,15.170717748340774,123,6.0E-5
7,test_20231101_134702,10863862.png,317432,13337,304095,0.9579847022354394,2,3,66058,1928,64130,0.9708135275061309,23.652634666666668,3218.7282186666666,13.053960533703744,123,6.0E-5
8,test_20231101_134702,11382381.png,312486,1159,311327,0.996291033838316,1,3,46745,158,46587,0.9966199593539415,20.606709333333335,2334.900224,14.448120340351833,123,6.0E-5
9,test_20231101_134702,11079715.png,443815,125192,318623,0.7179185020785688,3,4,124136,17444,106692,0.8594767029709351,16.64877511111111,2039.7730453333334,15.034985123844537,123,6.0E-5
10,test_20231101_134702,11551286.png,271883,1322,270561,0.9951376143414631,2,4,40092,194,39898,0.9951611294023746,15.753514666666666,1496.8890666666666,16.378907445727467,123,6.0E-5
1,test_20231101_134702,10404007.png,502730,24182,478548,0.9518986334613013,2,4,61265,3483,57782,0.9431486166653065,25.191109333333333,3298.676826666667,12.947405913275208,123,7.000000000000001E-5
2,test_20231101_134702,1254659.png,342646,78072,264574,0.7721496821792754,3,4,80080,10861,69219,0.8643731268731268,20.51848177777778,3069.789525333333,13.259717609997972,123,7.000000000000001E-5
3,test_20231101_134702,10188041.png,221231,10202,211029,0.9538853054047579,1,3,41731,1437,40294,0.9655651673815628,10.472250666666667,996.2625973333334,18.147065349528113,123,7.000000000000001E-5
4,test_20231101_134702,10287332.png,216980,12977,204003,0.9401926444833625,2,4,22337,1774,20563,0.9205802032502126,9.307064888888888,748.7130986666666,19.387649297314677,123,7.000000000000001E-5
5,test_20231101_134702,11610969.png,368720,28492,340228,0.9227272727272727,2,4,84111,4156,79955,0.9505891024955119,19.969996444444444,2649.321978666667,13.899456184782972,123,7.000000000000001E-5
6,test_20231101_134702,10350842.png,212614,6887,205727,0.967607965609038,2,4,42529,1009,41520,0.9762750123445179,17.477884444444445,1977.0087253333334,15.170717748340774,123,7.000000000000001E-5
7,test_20231101_134702,10863862.png,317432,13337,304095,0.9579847022354394,2,4,66058,1928,64130,0.9708135275061309,23.652634666666668,3218.7282186666666,13.053960533703744,123,7.000000000000001E-5
8,test_20231101_134702,11382381.png,312486,1159,311327,0.996291033838316,2,4,46745,158,46587,0.9966199593539415,20.606709333333335,2334.900224,14.448120340351833,123,7.000000000000001E-5
9,test_20231101_134702,11079715.png,443815,125192,318623,0.7179185020785688,4,5,124136,17444,106692,0.8594767029709351,16.64877511111111,2039.7730453333334,15.034985123844537,123,7.000000000000001E-5
10,test_20231101_134702,11551286.png,271883,1199,270684,0.9955900148225524,2,3,40092,176,39916,0.995610096777412,15.83984888888889,1503.00104,16.36121079771285,123,7.000000000000001E-5
1,test_20231101_134703,10404007.png,502730,24182,478548,0.9518986334613013,3,3,61265,3483,57782,0.9431486166653065,25.191109333333333,3298.676826666667,12.947405913275208,123,8.0E-5
2,test_20231101_134703,1254659.png,342646,78072,264574,0.7721496821792754,3,4,80080,10861,69219,0.8643731268731268,20.51848177777778,3069.789525333333,13.259717609997972,123,8.0E-5
3,test_20231101_134703,10188041.png,221231,10202,211029,0.9538853054047579,2,4,41731,1437,40294,0.9655651673815628,10.472250666666667,996.2625973333334,18.147065349528113,123,8.0E-5
4,test_20231101_134703,10287332.png,216980,12977,204003,0.9401926444833625,2,4,22337,1774,20563,0.9205802032502126,9.307064888888888,748.7130986666666,19.387649297314677,123,8.0E-5
5,test_20231101_134703,11610969.png,368720,28492,340228,0.9227272727272727,2,3,84111,4156,79955,0.9505891024955119,19.969996444444444,2649.321978666667,13.899456184782972,123,8.0E-5
6,test_20231101_134703,10350842.png,212614,6887,205727,0.967607965609038,2,3,42529,1009,41520,0.9762750123445179,17.477884444444445,1977.0087253333334,15.170717748340774,123,8.0E-5
7,test_20231101_134703,10863862.png,317432,13337,304095,0.9579847022354394,2,4,66058,1928,64130,0.9708135275061309,23.652634666666668,3218.7282186666666,13.053960533703744,123,8.0E-5
8,test_20231101_134703,11382381.png,312486,1159,311327,0.996291033838316,1,3,46745,158,46587,0.9966199593539415,20.606709333333335,2334.900224,14.448120340351833,123,8.0E-5
9,test_20231101_134703,11079715.png,443815,125192,318623,0.7179185020785688,4,4,124136,17444,106692,0.8594767029709351,16.64877511111111,2039.7730453333334,15.034985123844537,123,8.0E-5
10,test_20231101_134703,11551286.png,271883,1199,270684,0.9955900148225524,2,4,40092,176,39916,0.995610096777412,15.83984888888889,1503.00104,16.36121079771285,123,8.0E-5
1,test_20231101_134704,10404007.png,502730,24182,478548,0.9518986334613013,2,4,61265,3483,57782,0.9431486166653065,25.191109333333333,3298.676826666667,12.947405913275208,123,9.0E-5
2,test_20231101_134704,1254659.png,342646,78072,264574,0.7721496821792754,2,4,80080,10861,69219,0.8643731268731268,20.51848177777778,3069.789525333333,13.259717609997972,123,9.0E-5
3,test_20231101_134704,10188041.png,221231,10202,211029,0.9538853054047579,2,3,41731,1437,40294,0.9655651673815628,10.472250666666667,996.2625973333334,18.147065349528113,123,9.0E-5
4,test_20231101_134704,10287332.png,216980,12977,204003,0.9401926444833625,2,4,22337,1774,20563,0.9205802032502126,9.307064888888888,748.7130986666666,19.387649297314677,123,9.0E-5
5,test_20231101_134704,11610969.png,368720,28492,340228,0.9227272727272727,2,4,84111,4156,79955,0.9505891024955119,19.969996444444444,2649.321978666667,13.899456184782972,123,9.0E-5
6,test_20231101_134704,10350842.png,212614,6887,205727,0.967607965609038,1,3,42529,1009,41520,0.9762750123445179,17.477884444444445,1977.0087253333334,15.170717748340774,123,9.0E-5
7,test_20231101_134704,10863862.png,317432,13337,304095,0.9579847022354394,1,4,66058,1928,64130,0.9708135275061309,23.652634666666668,3218.7282186666666,13.053960533703744,123,9.0E-5
8,test_20231101_134704,11382381.png,312486,1159,311327,0.996291033838316,2,5,46745,158,46587,0.9966199593539415,20.606709333333335,2334.900224,14.448120340351833,123,9.0E-5
9,test_20231101_134704,11079715.png,443815,125192,318623,0.7179185020785688,4,4,124136,17444,106692,0.8594767029709351,16.64877511111111,2039.7730453333334,15.034985123844537,123,9.0E-5
10,test_20231101_134704,11551286.png,271883,1199,270684,0.9955900148225524,2,4,40092,176,39916,0.995610096777412,15.83984888888889,1503.00104,16.36121079771285,123,9.0E-5
1,test_20231101_134704,10404007.png,502730,24182,478548,0.9518986334613013,2,4,61265,3483,57782,0.9431486166653065,25.191109333333333,3298.676826666667,12.947405913275208,123,1.0E-4
2,test_20231101_134704,1254659.png,342646,78072,264574,0.7721496821792754,3,4,80080,10861,69219,0.8643731268731268,20.51848177777778,3069.789525333333,13.259717609997972,123,1.0E-4
3,test_20231101_134704,10188041.png,221231,10202,211029,0.9538853054047579,2,4,41731,1437,40294,0.9655651673815628,10.472250666666667,996.2625973333334,18.147065349528113,123,1.0E-4
4,test_20231101_134704,10287332.png,216980,12977,204003,0.9401926444833625,2,3,22337,1774,20563,0.9205802032502126,9.307064888888888,748.7130986666666,19.387649297314677,123,1.0E-4
5,test_20231101_134704,11610969.png,368720,28492,340228,0.9227272727272727,2,4,84111,4156,79955,0.9505891024955119,19.969996444444444,2649.321978666667,13.899456184782972,123,1.0E-4
6,test_20231101_134704,10350842.png,212614,6887,205727,0.967607965609038,1,4,42529,1009,41520,0.9762750123445179,17.477884444444445,1977.0087253333334,15.170717748340774,123,1.0E-4
7,test_20231101_134704,10863862.png,317432,13337,304095,0.9579847022354394,1,3,66058,1928,64130,0.9708135275061309,23.652634666666668,3218.7282186666666,13.053960533703744,123,1.0E-4
8,test_20231101_134704,11382381.png,312486,1159,311327,0.996291033838316,1,4,46745,158,46587,0.9966199593539415,20.606709333333335,2334.900224,14.448120340351833,123,1.0E-4
9,test_20231101_134704,11079715.png,443815,125192,318623,0.7179185020785688,4,5,124136,17444,106692,0.8594767029709351,16.64877511111111,2039.7730453333334,15.034985123844537,123,1.0E-4
10,test_20231101_134704,11551286.png,271883,1199,270684,0.9955900148225524,2,4,40092,176,39916,0.995610096777412,15.83984888888889,1503.00104,16.36121079771285,123,1.0E-4
1,test_20231101_134705,10404007.png,502730,24182,478548,0.9518986334613013,2,4,61265,3483,57782,0.9431486166653065,25.191109333333333,3298.676826666667,12.947405913275208,123,1.1E-4
2,test_20231101_134705,1254659.png,342646,78072,264574,0.7721496821792754,3,4,80080,10861,69219,0.8643731268731268,20.51848177777778,3069.789525333333,13.259717609997972,123,1.1E-4
3,test_20231101_134705,10188041.png,221231,10202,211029,0.9538853054047579,2,3,41731,1437,40294,0.9655651673815628,10.472250666666667,996.2625973333334,18.147065349528113,123,1.1E-4
4,test_20231101_134705,10287332.png,216980,12977,204003,0.9401926444833625,1,4,22337,1774,20563,0.9205802032502126,9.307064888888888,748.7130986666666,19.387649297314677,123,1.1E-4
5,test_20231101_134705,11610969.png,368720,28492,340228,0.9227272727272727,2,4,84111,4156,79955,0.9505891024955119,19.969996444444444,2649.321978666667,13.899456184782972,123,1.1E-4
6,test_20231101_134705,10350842.png,212614,6887,205727,0.967607965609038,1,4,42529,1009,41520,0.9762750123445179,17.477884444444445,1977.0087253333334,15.170717748340774,123,1.1E-4
7,test_20231101_134705,10863862.png,317432,13337,304095,0.9579847022354394,2,3,66058,1928,64130,0.9708135275061309,23.652634666666668,3218.7282186666666,13.053960533703744,123,1.1E-4
8,test_20231101_134705,11382381.png,312486,1159,311327,0.996291033838316,2,3,46745,158,46587,0.9966199593539415,20.606709333333335,2334.900224,14.448120340351833,123,1.1E-4
9,test_20231101_134705,11079715.png,443815,125192,318623,0.7179185020785688,3,5,124136,17444,106692,0.8594767029709351,16.64877511111111,2039.7730453333334,15.034985123844537,123,1.1E-4
10,test_20231101_134705,11551286.png,271883,1199,270684,0.9955900148225524,2,4,40092,176,39916,0.995610096777412,15.83984888888889,1503.00104,16.36121079771285,123,1.1E-4
1,test_20231101_134706,10404007.png,502730,24182,478548,0.9518986334613013,2,3,61265,3483,57782,0.9431486166653065,25.191109333333333,3298.676826666667,12.947405913275208,123,1.2E-4
2,test_20231101_134706,1254659.png,342646,78072,264574,0.7721496821792754,3,4,80080,10861,69219,0.8643731268731268,20.51848177777778,3069.789525333333,13.259717609997972,123,1.2E-4
3,test_20231101_134706,10188041.png,221231,10202,211029,0.9538853054047579,2,4,41731,1437,40294,0.9655651673815628,10.472250666666667,996.2625973333334,18.147065349528113,123,1.2E-4
4,test_20231101_134706,10287332.png,216980,12977,204003,0.9401926444833625,2,4,22337,1774,20563,0.9205802032502126,9.307064888888888,748.7130986666666,19.387649297314677,123,1.2E-4
5,test_20231101_134706,11610969.png,368720,28492,340228,0.9227272727272727,3,4,84111,4156,79955,0.9505891024955119,19.969996444444444,2649.321978666667,13.899456184782972,123,1.2E-4
6,test_20231101_134706,10350842.png,212614,6887,205727,0.967607965609038,2,4,42529,1009,41520,0.9762750123445179,17.477884444444445,1977.0087253333334,15.170717748340774,123,1.2E-4
7,test_20231101_134706,10863862.png,317432,13337,304095,0.9579847022354394,2,3,66058,1928,64130,0.9708135275061309,23.652634666666668,3218.7282186666666,13.053960533703744,123,1.2E-4
8,test_20231101_134706,11382381.png,312486,1159,311327,0.996291033838316,2,3,46745,158,46587,0.9966199593539415,20.606709333333335,2334.900224,14.448120340351833,123,1.2E-4
9,test_20231101_134706,11079715.png,443815,125192,318623,0.7179185020785688,3,4,124136,17444,106692,0.8594767029709351,16.64877511111111,2039.7730453333334,15.034985123844537,123,1.2E-4
10,test_20231101_134706,11551286.png,271883,1199,270684,0.9955900148225524,1,4,40092,176,39916,0.995610096777412,15.83984888888889,1503.00104,16.36121079771285,123,1.2E-4
1,test_20231101_134706,10404007.png,502730,24182,478548,0.9518986334613013,3,4,61265,3483,57782,0.9431486166653065,25.191109333333333,3298.676826666667,12.947405913275208,123,1.3000000000000002E-4
2,test_20231101_134706,1254659.png,342646,78072,264574,0.7721496821792754,3,4,80080,10861,69219,0.8643731268731268,20.51848177777778,3069.789525333333,13.259717609997972,123,1.3000000000000002E-4
3,test_20231101_134706,10188041.png,221231,10202,211029,0.9538853054047579,2,3,41731,1437,40294,0.9655651673815628,10.472250666666667,996.2625973333334,18.147065349528113,123,1.3000000000000002E-4
4,test_20231101_134706,10287332.png,216980,12977,204003,0.9401926444833625,2,3,22337,1774,20563,0.9205802032502126,9.307064888888888,748.7130986666666,19.387649297314677,123,1.3000000000000002E-4
5,test_20231101_134706,11610969.png,368720,28492,340228,0.9227272727272727,2,4,84111,4156,79955,0.9505891024955119,19.969996444444444,2649.321978666667,13.899456184782972,123,1.3000000000000002E-4
6,test_20231101_134706,10350842.png,212614,6887,205727,0.967607965609038,1,3,42529,1009,41520,0.9762750123445179,17.477884444444445,1977.0087253333334,15.170717748340774,123,1.3000000000000002E-4
7,test_20231101_134706,10863862.png,317432,13337,304095,0.9579847022354394,2,4,66058,1928,64130,0.9708135275061309,23.652634666666668,3218.7282186666666,13.053960533703744,123,1.3000000000000002E-4
8,test_20231101_134706,11382381.png,312486,1159,311327,0.996291033838316,1,4,46745,158,46587,0.9966199593539415,20.606709333333335,2334.900224,14.448120340351833,123,1.3000000000000002E-4
9,test_20231101_134706,11079715.png,443815,125192,318623,0.7179185020785688,3,4,124136,17444,106692,0.8594767029709351,16.64877511111111,2039.7730453333334,15.034985123844537,123,1.3000000000000002E-4
10,test_20231101_134706,11551286.png,271883,1199,270684,0.9955900148225524,1,3,40092,176,39916,0.995610096777412,15.83984888888889,1503.00104,16.36121079771285,123,1.3000000000000002E-4
1,test_20231101_134707,10404007.png,502730,24182,478548,0.9518986334613013,3,4,61265,3483,57782,0.9431486166653065,25.191109333333333,3298.676826666667,12.947405913275208,123,1.4000000000000001E-4
2,test_20231101_134707,1254659.png,342646,78072,264574,0.7721496821792754,3,4,80080,10861,69219,0.8643731268731268,20.51848177777778,3069.789525333333,13.259717609997972,123,1.4000000000000001E-4
3,test_20231101_134707,10188041.png,221231,10202,211029,0.9538853054047579,1,3,41731,1437,40294,0.9655651673815628,10.472250666666667,996.2625973333334,18.147065349528113,123,1.4000000000000001E-4
4,test_20231101_134707,10287332.png,216980,12977,204003,0.9401926444833625,2,3,22337,1774,20563,0.9205802032502126,9.307064888888888,748.7130986666666,19.387649297314677,123,1.4000000000000001E-4
5,test_20231101_134707,11610969.png,368720,28492,340228,0.9227272727272727,3,4,84111,4156,79955,0.9505891024955119,19.969996444444444,2649.321978666667,13.899456184782972,123,1.4000000000000001E-4
6,test_20231101_134707,10350842.png,212614,6887,205727,0.967607965609038,1,4,42529,1009,41520,0.9762750123445179,17.477884444444445,1977.0087253333334,15.170717748340774,123,1.4000000000000001E-4
7,test_20231101_134707,10863862.png,317432,13337,304095,0.9579847022354394,2,3,66058,1928,64130,0.9708135275061309,23.652634666666668,3218.7282186666666,13.053960533703744,123,1.4000000000000001E-4
8,test_20231101_134707,11382381.png,312486,1159,311327,0.996291033838316,2,4,46745,158,46587,0.9966199593539415,20.606709333333335,2334.900224,14.448120340351833,123,1.4000000000000001E-4
9,test_20231101_134707,11079715.png,443815,125192,318623,0.7179185020785688,3,4,124136,17444,106692,0.8594767029709351,16.64877511111111,2039.7730453333334,15.034985123844537,123,1.4000000000000001E-4
10,test_20231101_134707,11551286.png,271883,1199,270684,0.9955900148225524,1,4,40092,176,39916,0.995610096777412,15.83984888888889,1503.00104,16.36121079771285,123,1.4000000000000001E-4
1,test_20231101_134708,10404007.png,502730,24182,478548,0.9518986334613013,2,4,61265,3483,57782,0.9431486166653065,25.191109333333333,3298.676826666667,12.947405913275208,123,1.5000000000000001E-4
2,test_20231101_134708,1254659.png,342646,78072,264574,0.7721496821792754,3,4,80080,10861,69219,0.8643731268731268,20.51848177777778,3069.789525333333,13.259717609997972,123,1.5000000000000001E-4
3,test_20231101_134708,10188041.png,221231,10202,211029,0.9538853054047579,2,4,41731,1437,40294,0.9655651673815628,10.472250666666667,996.2625973333334,18.147065349528113,123,1.5000000000000001E-4
4,test_20231101_134708,10287332.png,216980,12977,204003,0.9401926444833625,2,4,22337,1774,20563,0.9205802032502126,9.307064888888888,748.7130986666666,19.387649297314677,123,1.5000000000000001E-4
5,test_20231101_134708,11610969.png,368720,28492,340228,0.9227272727272727,3,4,84111,4156,79955,0.9505891024955119,19.969996444444444,2649.321978666667,13.899456184782972,123,1.5000000000000001E-4
6,test_20231101_134708,10350842.png,212614,6887,205727,0.967607965609038,2,4,42529,1009,41520,0.9762750123445179,17.477884444444445,1977.0087253333334,15.170717748340774,123,1.5000000000000001E-4
7,test_20231101_134708,10863862.png,317432,13337,304095,0.9579847022354394,2,3,66058,1928,64130,0.9708135275061309,23.652634666666668,3218.7282186666666,13.053960533703744,123,1.5000000000000001E-4
8,test_20231101_134708,11382381.png,312486,1159,311327,0.996291033838316,2,4,46745,158,46587,0.9966199593539415,20.606709333333335,2334.900224,14.448120340351833,123,1.5000000000000001E-4
9,test_20231101_134708,11079715.png,443815,125192,318623,0.7179185020785688,3,5,124136,17444,106692,0.8594767029709351,16.64877511111111,2039.7730453333334,15.034985123844537,123,1.5000000000000001E-4
10,test_20231101_134708,11551286.png,271883,1199,270684,0.9955900148225524,2,4,40092,176,39916,0.995610096777412,15.83984888888889,1503.00104,16.36121079771285,123,1.5000000000000001E-4
1,test_20231101_134708,10404007.png,502730,24182,478548,0.9518986334613013,3,3,61265,3483,57782,0.9431486166653065,25.191109333333333,3298.676826666667,12.947405913275208,123,1.6E-4
2,test_20231101_134708,1254659.png,342646,78072,264574,0.7721496821792754,3,4,80080,10861,69219,0.8643731268731268,20.51848177777778,3069.789525333333,13.259717609997972,123,1.6E-4
3,test_20231101_134708,10188041.png,221231,10202,211029,0.9538853054047579,2,3,41731,1437,40294,0.9655651673815628,10.472250666666667,996.2625973333334,18.147065349528113,123,1.6E-4
4,test_20231101_134708,10287332.png,216980,12767,204213,0.9411604756198728,2,4,22337,1747,20590,0.921788960021489,9.436826666666667,775.4438453333333,19.235300075188995,123,1.6E-4
5,test_20231101_134708,11610969.png,368720,28492,340228,0.9227272727272727,2,3,84111,4156,79955,0.9505891024955119,19.969996444444444,2649.321978666667,13.899456184782972,123,1.6E-4
6,test_20231101_134708,10350842.png,212614,6887,205727,0.967607965609038,2,4,42529,1009,41520,0.9762750123445179,17.477884444444445,1977.0087253333334,15.170717748340774,123,1.6E-4
7,test_20231101_134708,10863862.png,317432,13337,304095,0.9579847022354394,2,3,66058,1928,64130,0.9708135275061309,23.652634666666668,3218.7282186666666,13.053960533703744,123,1.6E-4
8,test_20231101_134708,11382381.png,312486,1159,311327,0.996291033838316,1,4,46745,158,46587,0.9966199593539415,20.606709333333335,2334.900224,14.448120340351833,123,1.6E-4
9,test_20231101_134708,11079715.png,443815,125192,318623,0.7179185020785688,4,4,124136,17444,106692,0.8594767029709351,16.64877511111111,2039.7730453333334,15.034985123844537,123,1.6E-4
10,test_20231101_134708,11551286.png,271883,1199,270684,0.9955900148225524,1,4,40092,176,39916,0.995610096777412,15.83984888888889,1503.00104,16.36121079771285,123,1.6E-4
1,test_20231101_134709,10404007.png,502730,24182,478548,0.9518986334613013,2,4,61265,3483,57782,0.9431486166653065,25.191109333333333,3298.676826666667,12.947405913275208,123,1.7E-4
2,test_20231101_134709,1254659.png,342646,78072,264574,0.7721496821792754,3,4,80080,10861,69219,0.8643731268731268,20.51848177777778,3069.789525333333,13.259717609997972,123,1.7E-4
3,test_20231101_134709,10188041.png,221231,10202,211029,0.9538853054047579,2,3,41731,1437,40294,0.9655651673815628,10.472250666666667,996.2625973333334,18.147065349528113,123,1.7E-4
4,test_20231101_134709,10287332.png,216980,12767,204213,0.9411604756198728,2,4,22337,1747,20590,0.921788960021489,9.436826666666667,775.4438453333333,19.235300075188995,123,1.7E-4
5,test_20231101_134709,11610969.png,368720,28492,340228,0.9227272727272727,2,4,84111,4156,79955,0.9505891024955119,19.969996444444444,2649.321978666667,13.899456184782972,123,1.7E-4
6,test_20231101_134709,10350842.png,212614,6887,205727,0.967607965609038,2,3,42529,1009,41520,0.9762750123445179,17.477884444444445,1977.0087253333334,15.170717748340774,123,1.7E-4
7,test_20231101_134709,10863862.png,317432,13337,304095,0.9579847022354394,2,4,66058,1928,64130,0.9708135275061309,23.652634666666668,3218.7282186666666,13.053960533703744,123,1.7E-4
8,test_20231101_134709,11382381.png,312486,1159,311327,0.996291033838316,2,3,46745,158,46587,0.9966199593539415,20.606709333333335,2334.900224,14.448120340351833,123,1.7E-4
9,test_20231101_134709,11079715.png,443815,125192,318623,0.7179185020785688,3,4,124136,17444,106692,0.8594767029709351,16.64877511111111,2039.7730453333334,15.034985123844537,123,1.7E-4
10,test_20231101_134709,11551286.png,271883,1199,270684,0.9955900148225524,1,3,40092,176,39916,0.995610096777412,15.83984888888889,1503.00104,16.36121079771285,123,1.7E-4
1,test_20231101_134710,10404007.png,502730,24182,478548,0.9518986334613013,2,4,61265,3483,57782,0.9431486166653065,25.191109333333333,3298.676826666667,12.947405913275208,123,1.8E-4
2,test_20231101_134710,1254659.png,342646,78072,264574,0.7721496821792754,2,3,80080,10861,69219,0.8643731268731268,20.51848177777778,3069.789525333333,13.259717609997972,123,1.8E-4
3,test_20231101_134710,10188041.png,221231,10202,211029,0.9538853054047579,1,3,41731,1437,40294,0.9655651673815628,10.472250666666667,996.2625973333334,18.147065349528113,123,1.8E-4
4,test_20231101_134710,10287332.png,216980,12767,204213,0.9411604756198728,1,3,22337,1747,20590,0.921788960021489,9.436826666666667,775.4438453333333,19.235300075188995,123,1.8E-4
5,test_20231101_134710,11610969.png,368720,28492,340228,0.9227272727272727,2,4,84111,4156,79955,0.9505891024955119,19.969996444444444,2649.321978666667,13.899456184782972,123,1.8E-4
6,test_20231101_134710,10350842.png,212614,6887,205727,0.967607965609038,2,4,42529,1009,41520,0.9762750123445179,17.477884444444445,1977.0087253333334,15.170717748340774,123,1.8E-4
7,test_20231101_134710,10863862.png,317432,13337,304095,0.9579847022354394,2,4,66058,1928,64130,0.9708135275061309,23.652634666666668,3218.7282186666666,13.053960533703744,123,1.8E-4
8,test_20231101_134710,11382381.png,312486,1159,311327,0.996291033838316,1,3,46745,158,46587,0.9966199593539415,20.606709333333335,2334.900224,14.448120340351833,123,1.8E-4
9,test_20231101_134710,11079715.png,443815,125192,318623,0.7179185020785688,3,5,124136,17444,106692,0.8594767029709351,16.64877511111111,2039.7730453333334,15.034985123844537,123,1.8E-4
10,test_20231101_134710,11551286.png,271883,1199,270684,0.9955900148225524,1,4,40092,176,39916,0.995610096777412,15.83984888888889,1503.00104,16.36121079771285,123,1.8E-4
1,test_20231101_134710,10404007.png,502730,24182,478548,0.9518986334613013,2,3,61265,3483,57782,0.9431486166653065,25.191109333333333,3298.676826666667,12.947405913275208,123,1.9E-4
2,test_20231101_134710,1254659.png,342646,78072,264574,0.7721496821792754,3,4,80080,10861,69219,0.8643731268731268,20.51848177777778,3069.789525333333,13.259717609997972,123,1.9E-4
3,test_20231101_134710,10188041.png,221231,10202,211029,0.9538853054047579,1,3,41731,1437,40294,0.9655651673815628,10.472250666666667,996.2625973333334,18.147065349528113,123,1.9E-4
4,test_20231101_134710,10287332.png,216980,12767,204213,0.9411604756198728,1,3,22337,1747,20590,0.921788960021489,9.436826666666667,775.4438453333333,19.235300075188995,123,1.9E-4
5,test_20231101_134710,11610969.png,368720,28492,340228,0.9227272727272727,3,3,84111,4156,79955,0.9505891024955119,19.969996444444444,2649.321978666667,13.899456184782972,123,1.9E-4
6,test_20231101_134710,10350842.png,212614,6887,205727,0.967607965609038,2,3,42529,1009,41520,0.9762750123445179,17.477884444444445,1977.0087253333334,15.170717748340774,123,1.9E-4
7,test_20231101_134710,10863862.png,317432,13337,304095,0.9579847022354394,2,4,66058,1928,64130,0.9708135275061309,23.652634666666668,3218.7282186666666,13.053960533703744,123,1.9E-4
8,test_20231101_134710,11382381.png,312486,1159,311327,0.996291033838316,2,3,46745,158,46587,0.9966199593539415,20.606709333333335,2334.900224,14.448120340351833,123,1.9E-4
9,test_20231101_134710,11079715.png,443815,125192,318623,0.7179185020785688,3,5,124136,17444,106692,0.8594767029709351,16.64877511111111,2039.7730453333334,15.034985123844537,123,1.9E-4
10,test_20231101_134710,11551286.png,271883,1199,270684,0.9955900148225524,1,4,40092,176,39916,0.995610096777412,15.83984888888889,1503.00104,16.36121079771285,123,1.9E-4
1,test_20231101_134711,10404007.png,502730,24182,478548,0.9518986334613013,2,4,61265,3483,57782,0.9431486166653065,25.191109333333333,3298.676826666667,12.947405913275208,123,2.0E-4
2,test_20231101_134711,1254659.png,342646,78072,264574,0.7721496821792754,3,4,80080,10861,69219,0.8643731268731268,20.51848177777778,3069.789525333333,13.259717609997972,123,2.0E-4
3,test_20231101_134711,10188041.png,221231,10202,211029,0.9538853054047579,2,4,41731,1437,40294,0.9655651673815628,10.472250666666667,996.2625973333334,18.147065349528113,123,2.0E-4
4,test_20231101_134711,10287332.png,216980,12767,204213,0.9411604756198728,4,3,22337,1747,20590,0.921788960021489,9.436826666666667,775.4438453333333,19.235300075188995,123,2.0E-4
5,test_20231101_134711,11610969.png,368720,28492,340228,0.9227272727272727,3,4,84111,4156,79955,0.9505891024955119,19.969996444444444,2649.321978666667,13.899456184782972,123,2.0E-4
6,test_20231101_134711,10350842.png,212614,6887,205727,0.967607965609038,2,3,42529,1009,41520,0.9762750123445179,17.477884444444445,1977.0087253333334,15.170717748340774,123,2.0E-4
7,test_20231101_134711,10863862.png,317432,13337,304095,0.9579847022354394,2,4,66058,1928,64130,0.9708135275061309,23.652634666666668,3218.7282186666666,13.053960533703744,123,2.0E-4
8,test_20231101_134711,11382381.png,312486,1159,311327,0.996291033838316,2,4,46745,158,46587,0.9966199593539415,20.606709333333335,2334.900224,14.448120340351833,123,2.0E-4
9,test_20231101_134711,11079715.png,443815,125192,318623,0.7179185020785688,3,4,124136,17444,106692,0.8594767029709351,16.64877511111111,2039.7730453333334,15.034985123844537,123,2.0E-4
10,test_20231101_134711,11551286.png,271883,1179,270704,0.995663575876388,2,3,40092,173,39919,0.9956849246732515,16.545063111111112,1622.936352,16.027788727836416,123,2.0E-4
1,test_20231101_134712,10404007.png,502730,24182,478548,0.9518986334613013,2,3,61265,3483,57782,0.9431486166653065,25.191109333333333,3298.676826666667,12.947405913275208,123,2.1E-4
2,test_20231101_134712,1254659.png,342646,78072,264574,0.7721496821792754,3,4,80080,10861,69219,0.8643731268731268,20.51848177777778,3069.789525333333,13.259717609997972,123,2.1E-4
3,test_20231101_134712,10188041.png,221231,10202,211029,0.9538853054047579,2,4,41731,1437,40294,0.9655651673815628,10.472250666666667,996.2625973333334,18.147065349528113,123,2.1E-4
4,test_20231101_134712,10287332.png,216980,12767,204213,0.9411604756198728,2,4,22337,1747,20590,0.921788960021489,9.436826666666667,775.4438453333333,19.235300075188995,123,2.1E-4
5,test_20231101_134712,11610969.png,368720,28492,340228,0.9227272727272727,3,4,84111,4156,79955,0.9505891024955119,19.969996444444444,2649.321978666667,13.899456184782972,123,2.1E-4
6,test_20231101_134712,10350842.png,212614,6887,205727,0.967607965609038,1,4,42529,1009,41520,0.9762750123445179,17.477884444444445,1977.0087253333334,15.170717748340774,123,2.1E-4
7,test_20231101_134712,10863862.png,317432,13337,304095,0.9579847022354394,2,4,66058,1928,64130,0.9708135275061309,23.652634666666668,3218.7282186666666,13.053960533703744,123,2.1E-4
8,test_20231101_134712,11382381.png,312486,1159,311327,0.996291033838316,2,4,46745,158,46587,0.9966199593539415,20.606709333333335,2334.900224,14.448120340351833,123,2.1E-4
9,test_20231101_134712,11079715.png,443815,125192,318623,0.7179185020785688,3,4,124136,17444,106692,0.8594767029709351,16.64877511111111,2039.7730453333334,15.034985123844537,123,2.1E-4
10,test_20231101_134712,11551286.png,271883,1179,270704,0.995663575876388,1,4,40092,173,39919,0.9956849246732515,16.545063111111112,1622.936352,16.027788727836416,123,2.1E-4
1,test_20231101_134712,10404007.png,502730,24182,478548,0.9518986334613013,3,3,61265,3483,57782,0.9431486166653065,25.191109333333333,3298.676826666667,12.947405913275208,123,2.2E-4
2,test_20231101_134712,1254659.png,342646,78072,264574,0.7721496821792754,3,3,80080,10861,69219,0.8643731268731268,20.51848177777778,3069.789525333333,13.259717609997972,123,2.2E-4
3,test_20231101_134712,10188041.png,221231,10202,211029,0.9538853054047579,3,3,41731,1437,40294,0.9655651673815628,10.472250666666667,996.2625973333334,18.147065349528113,123,2.2E-4
4,test_20231101_134712,10287332.png,216980,12767,204213,0.9411604756198728,2,4,22337,1747,20590,0.921788960021489,9.436826666666667,775.4438453333333,19.235300075188995,123,2.2E-4
5,test_20231101_134712,11610969.png,368720,28492,340228,0.9227272727272727,2,4,84111,4156,79955,0.9505891024955119,19.969996444444444,2649.321978666667,13.899456184782972,123,2.2E-4
6,test_20231101_134712,10350842.png,212614,6887,205727,0.967607965609038,1,4,42529,1009,41520,0.9762750123445179,17.477884444444445,1977.0087253333334,15.170717748340774,123,2.2E-4
7,test_20231101_134712,10863862.png,317432,13337,304095,0.9579847022354394,2,4,66058,1928,64130,0.9708135275061309,23.652634666666668,3218.7282186666666,13.053960533703744,123,2.2E-4
8,test_20231101_134712,11382381.png,312486,1159,311327,0.996291033838316,2,3,46745,158,46587,0.9966199593539415,20.606709333333335,2334.900224,14.448120340351833,123,2.2E-4
9,test_20231101_134712,11079715.png,443815,125192,318623,0.7179185020785688,3,4,124136,17444,106692,0.8594767029709351,16.64877511111111,2039.7730453333334,15.034985123844537,123,2.2E-4
10,test_20231101_134712,11551286.png,271883,1179,270704,0.995663575876388,2,3,40092,173,39919,0.9956849246732515,16.545063111111112,1622.936352,16.027788727836416,123,2.2E-4
1,test_20231101_134713,10404007.png,502730,24182,478548,0.9518986334613013,3,9,61265,3483,57782,0.9431486166653065,25.191109333333333,3298.676826666667,12.947405913275208,123,2.3E-4
2,test_20231101_134713,1254659.png,342646,78072,264574,0.7721496821792754,3,4,80080,10861,69219,0.8643731268731268,20.51848177777778,3069.789525333333,13.259717609997972,123,2.3E-4
3,test_20231101_134713,10188041.png,221231,10202,211029,0.9538853054047579,2,4,41731,1437,40294,0.9655651673815628,10.472250666666667,996.2625973333334,18.147065349528113,123,2.3E-4
4,test_20231101_134713,10287332.png,216980,12767,204213,0.9411604756198728,2,4,22337,1747,20590,0.921788960021489,9.436826666666667,775.4438453333333,19.235300075188995,123,2.3E-4
5,test_20231101_134713,11610969.png,368720,28492,340228,0.9227272727272727,2,4,84111,4156,79955,0.9505891024955119,19.969996444444444,2649.321978666667,13.899456184782972,123,2.3E-4
6,test_20231101_134713,10350842.png,212614,6887,205727,0.967607965609038,1,3,42529,1009,41520,0.9762750123445179,17.477884444444445,1977.0087253333334,15.170717748340774,123,2.3E-4
7,test_20231101_134713,10863862.png,317432,13337,304095,0.9579847022354394,2,4,66058,1928,64130,0.9708135275061309,23.652634666666668,3218.7282186666666,13.053960533703744,123,2.3E-4
8,test_20231101_134713,11382381.png,312486,967,311519,0.9969054613646692,2,3,46745,130,46615,0.9972189538988127,21.068341333333333,2406.1475626666665,14.317581029153203,123,2.3E-4
9,test_20231101_134713,11079715.png,443815,125192,318623,0.7179185020785688,4,4,124136,17444,106692,0.8594767029709351,16.64877511111111,2039.7730453333334,15.034985123844537,123,2.3E-4
10,test_20231101_134713,11551286.png,271883,1179,270704,0.995663575876388,1,4,40092,173,39919,0.9956849246732515,16.545063111111112,1622.936352,16.027788727836416,123,2.3E-4
1,test_20231101_134714,10404007.png,502730,24182,478548,0.9518986334613013,3,4,61265,3483,57782,0.9431486166653065,25.191109333333333,3298.676826666667,12.947405913275208,123,2.4E-4
2,test_20231101_134714,1254659.png,342646,78072,264574,0.7721496821792754,4,4,80080,10861,69219,0.8643731268731268,20.51848177777778,3069.789525333333,13.259717609997972,123,2.4E-4
3,test_20231101_134714,10188041.png,221231,10202,211029,0.9538853054047579,1,3,41731,1437,40294,0.9655651673815628,10.472250666666667,996.2625973333334,18.147065349528113,123,2.4E-4
4,test_20231101_134714,10287332.png,216980,12767,204213,0.9411604756198728,1,3,22337,1747,20590,0.921788960021489,9.436826666666667,775.4438453333333,19.235300075188995,123,2.4E-4
5,test_20231101_134714,11610969.png,368720,28492,340228,0.9227272727272727,2,4,84111,4156,79955,0.9505891024955119,19.969996444444444,2649.321978666667,13.899456184782972,123,2.4E-4
6,test_20231101_134714,10350842.png,212614,6887,205727,0.967607965609038,2,3,42529,1009,41520,0.9762750123445179,17.477884444444445,1977.0087253333334,15.170717748340774,123,2.4E-4
7,test_20231101_134714,10863862.png,317432,13337,304095,0.9579847022354394,2,3,66058,1928,64130,0.9708135275061309,23.652634666666668,3218.7282186666666,13.053960533703744,123,2.4E-4
8,test_20231101_134714,11382381.png,312486,967,311519,0.9969054613646692,2,3,46745,130,46615,0.9972189538988127,21.068341333333333,2406.1475626666665,14.317581029153203,123,2.4E-4
9,test_20231101_134714,11079715.png,443815,125192,318623,0.7179185020785688,4,5,124136,17444,106692,0.8594767029709351,16.64877511111111,2039.7730453333334,15.034985123844537,123,2.4E-4
10,test_20231101_134714,11551286.png,271883,1179,270704,0.995663575876388,1,3,40092,173,39919,0.9956849246732515,16.545063111111112,1622.936352,16.027788727836416,123,2.4E-4
1,test_20231101_134714,10404007.png,502730,24182,478548,0.9518986334613013,2,4,61265,3483,57782,0.9431486166653065,25.191109333333333,3298.676826666667,12.947405913275208,123,2.5E-4
2,test_20231101_134714,1254659.png,342646,78072,264574,0.7721496821792754,3,4,80080,10861,69219,0.8643731268731268,20.51848177777778,3069.789525333333,13.259717609997972,123,2.5E-4
3,test_20231101_134714,10188041.png,221231,10202,211029,0.9538853054047579,2,4,41731,1437,40294,0.9655651673815628,10.472250666666667,996.2625973333334,18.147065349528113,123,2.5E-4
4,test_20231101_134714,10287332.png,216980,12767,204213,0.9411604756198728,1,4,22337,1747,20590,0.921788960021489,9.436826666666667,775.4438453333333,19.235300075188995,123,2.5E-4
5,test_20231101_134714,11610969.png,368720,28492,340228,0.9227272727272727,3,4,84111,4156,79955,0.9505891024955119,19.969996444444444,2649.321978666667,13.899456184782972,123,2.5E-4
6,test_20231101_134714,10350842.png,212614,6887,205727,0.967607965609038,2,3,42529,1009,41520,0.9762750123445179,17.477884444444445,1977.0087253333334,15.170717748340774,123,2.5E-4
7,test_20231101_134714,10863862.png,317432,13337,304095,0.9579847022354394,2,3,66058,1928,64130,0.9708135275061309,23.652634666666668,3218.7282186666666,13.053960533703744,123,2.5E-4
8,test_20231101_134714,11382381.png,312486,967,311519,0.9969054613646692,1,4,46745,130,46615,0.9972189538988127,21.068341333333333,2406.1475626666665,14.317581029153203,123,2.5E-4
9,test_20231101_134714,11079715.png,443815,125192,318623,0.7179185020785688,3,4,124136,17444,106692,0.8594767029709351,16.64877511111111,2039.7730453333334,15.034985123844537,123,2.5E-4
10,test_20231101_134714,11551286.png,271883,1179,270704,0.995663575876388,1,4,40092,173,39919,0.9956849246732515,16.545063111111112,1622.936352,16.027788727836416,123,2.5E-4
1,test_20231101_134715,10404007.png,502730,24062,478668,0.9521373301772323,3,4,61265,3466,57799,0.9434260997306783,25.205253333333335,3301.279184,12.943981073817032,123,2.6000000000000003E-4
2,test_20231101_134715,1254659.png,342646,78012,264634,0.7723247900165185,3,4,80080,10856,69224,0.8644355644355645,20.528035555555554,3070.871712,13.258186870279811,123,2.6000000000000003E-4
3,test_20231101_134715,10188041.png,221231,10102,211129,0.9543373216230998,1,3,41731,1423,40308,0.9659006493973306,10.595603555555556,1011.9779893333333,18.079092942287858,123,2.6000000000000003E-4
4,test_20231101_134715,10287332.png,216980,12767,204213,0.9411604756198728,1,4,22337,1747,20590,0.921788960021489,9.436826666666667,775.4438453333333,19.235300075188995,123,2.6000000000000003E-4
5,test_20231101_134715,11610969.png,368720,28252,340468,0.9233781731395097,3,4,84111,4121,79990,0.9510052192935525,20.351372444444443,2731.876538666667,13.766192924277291,123,2.6000000000000003E-4
6,test_20231101_134715,10350842.png,212614,6467,206147,0.9695833764474587,2,4,42529,947,41582,0.9777328411201768,19.205194666666667,2350.2698026666667,14.419626402627658,123,2.6000000000000003E-4
7,test_20231101_134715,10863862.png,317432,13257,304175,0.9582367247158446,2,3,66058,1916,64142,0.9709951860486239,23.681868444444444,3223.7809546666667,13.047148356167963,123,2.6000000000000003E-4
8,test_20231101_134715,11382381.png,312486,967,311519,0.9969054613646692,2,3,46745,130,46615,0.9972189538988127,21.068341333333333,2406.1475626666665,14.317581029153203,123,2.6000000000000003E-4
9,test_20231101_134715,11079715.png,443815,125192,318623,0.7179185020785688,3,5,124136,17444,106692,0.8594767029709351,16.64877511111111,2039.7730453333334,15.034985123844537,123,2.6000000000000003E-4
10,test_20231101_134715,11551286.png,271883,857,271026,0.9968479088431421,1,3,40092,125,39967,0.9968821710066846,17.555712,1807.787776,15.559329154375803,123,2.6000000000000003E-4
1,test_20231101_134716,10404007.png,502730,24062,478668,0.9521373301772323,2,4,61265,3466,57799,0.9434260997306783,25.205253333333335,3301.279184,12.943981073817032,123,2.7000000000000006E-4
2,test_20231101_134716,1254659.png,342646,78012,264634,0.7723247900165185,3,4,80080,10856,69224,0.8644355644355645,20.528035555555554,3070.871712,13.258186870279811,123,2.7000000000000006E-4
3,test_20231101_134716,10188041.png,221231,10102,211129,0.9543373216230998,2,4,41731,1423,40308,0.9659006493973306,10.595603555555556,1011.9779893333333,18.079092942287858,123,2.7000000000000006E-4
4,test_20231101_134716,10287332.png,216980,12767,204213,0.9411604756198728,1,3,22337,1747,20590,0.921788960021489,9.436826666666667,775.4438453333333,19.235300075188995,123,2.7000000000000006E-4
5,test_20231101_134716,11610969.png,368720,28252,340468,0.9233781731395097,2,4,84111,4121,79990,0.9510052192935525,20.351372444444443,2731.876538666667,13.766192924277291,123,2.7000000000000006E-4
6,test_20231101_134716,10350842.png,212614,6467,206147,0.9695833764474587,2,4,42529,947,41582,0.9777328411201768,19.205194666666667,2350.2698026666667,14.419626402627658,123,2.7000000000000006E-4
7,test_20231101_134716,10863862.png,317432,13257,304175,0.9582367247158446,2,5,66058,1916,64142,0.9709951860486239,23.681868444444444,3223.7809546666667,13.047148356167963,123,2.7000000000000006E-4
8,test_20231101_134716,11382381.png,312486,967,311519,0.9969054613646692,2,4,46745,130,46615,0.9972189538988127,21.068341333333333,2406.1475626666665,14.317581029153203,123,2.7000000000000006E-4
9,test_20231101_134716,11079715.png,443815,125192,318623,0.7179185020785688,4,4,124136,17444,106692,0.8594767029709351,16.64877511111111,2039.7730453333334,15.034985123844537,123,2.7000000000000006E-4
10,test_20231101_134716,11551286.png,271883,857,271026,0.9968479088431421,2,4,40092,125,39967,0.9968821710066846,17.555712,1807.787776,15.559329154375803,123,2.7000000000000006E-4
1,test_20231101_134717,10404007.png,502730,24062,478668,0.9521373301772323,2,4,61265,3466,57799,0.9434260997306783,25.205253333333335,3301.279184,12.943981073817032,123,2.800000000000001E-4
2,test_20231101_134717,1254659.png,342646,78012,264634,0.7723247900165185,3,4,80080,10856,69224,0.8644355644355645,20.528035555555554,3070.871712,13.258186870279811,123,2.800000000000001E-4
3,test_20231101_134717,10188041.png,221231,10102,211129,0.9543373216230998,2,3,41731,1423,40308,0.9659006493973306,10.595603555555556,1011.9779893333333,18.079092942287858,123,2.800000000000001E-4
4,test_20231101_134717,10287332.png,216980,12767,204213,0.9411604756198728,2,3,22337,1747,20590,0.921788960021489,9.436826666666667,775.4438453333333,19.235300075188995,123,2.800000000000001E-4
5,test_20231101_134717,11610969.png,368720,28252,340468,0.9233781731395097,2,4,84111,4121,79990,0.9510052192935525,20.351372444444443,2731.876538666667,13.766192924277291,123,2.800000000000001E-4
6,test_20231101_134717,10350842.png,212614,6467,206147,0.9695833764474587,2,4,42529,947,41582,0.9777328411201768,19.205194666666667,2350.2698026666667,14.419626402627658,123,2.800000000000001E-4
7,test_20231101_134717,10863862.png,317432,13257,304175,0.9582367247158446,2,3,66058,1916,64142,0.9709951860486239,23.681868444444444,3223.7809546666667,13.047148356167963,123,2.800000000000001E-4
8,test_20231101_134717,11382381.png,312486,967,311519,0.9969054613646692,1,4,46745,130,46615,0.9972189538988127,21.068341333333333,2406.1475626666665,14.317581029153203,123,2.800000000000001E-4
9,test_20231101_134717,11079715.png,443815,125192,318623,0.7179185020785688,4,4,124136,17444,106692,0.8594767029709351,16.64877511111111,2039.7730453333334,15.034985123844537,123,2.800000000000001E-4
10,test_20231101_134717,11551286.png,271883,857,271026,0.9968479088431421,2,3,40092,125,39967,0.9968821710066846,17.555712,1807.787776,15.559329154375803,123,2.800000000000001E-4
1,test_20231101_134717,10404007.png,502730,24062,478668,0.9521373301772323,3,4,61265,3466,57799,0.9434260997306783,25.205253333333335,3301.279184,12.943981073817032,123,2.900000000000001E-4
2,test_20231101_134717,1254659.png,342646,78012,264634,0.7723247900165185,3,4,80080,10856,69224,0.8644355644355645,20.528035555555554,3070.871712,13.258186870279811,123,2.900000000000001E-4
3,test_20231101_134717,10188041.png,221231,10102,211129,0.9543373216230998,2,4,41731,1423,40308,0.9659006493973306,10.595603555555556,1011.9779893333333,18.079092942287858,123,2.900000000000001E-4
4,test_20231101_134717,10287332.png,216980,12767,204213,0.9411604756198728,1,4,22337,1747,20590,0.921788960021489,9.436826666666667,775.4438453333333,19.235300075188995,123,2.900000000000001E-4
5,test_20231101_134717,11610969.png,368720,28252,340468,0.9233781731395097,2,4,84111,4121,79990,0.9510052192935525,20.351372444444443,2731.876538666667,13.766192924277291,123,2.900000000000001E-4
6,test_20231101_134717,10350842.png,212614,6467,206147,0.9695833764474587,2,3,42529,947,41582,0.9777328411201768,19.205194666666667,2350.2698026666667,14.419626402627658,123,2.900000000000001E-4
7,test_20231101_134717,10863862.png,317432,13257,304175,0.9582367247158446,2,4,66058,1916,64142,0.9709951860486239,23.681868444444444,3223.7809546666667,13.047148356167963,123,2.900000000000001E-4
8,test_20231101_134717,11382381.png,312486,967,311519,0.9969054613646692,1,11,46745,130,46615,0.9972189538988127,21.068341333333333,2406.1475626666665,14.317581029153203,123,2.900000000000001E-4
9,test_20231101_134717,11079715.png,443815,125192,318623,0.7179185020785688,4,4,124136,17444,106692,0.8594767029709351,16.64877511111111,2039.7730453333334,15.034985123844537,123,2.900000000000001E-4
10,test_20231101_134717,11551286.png,271883,547,271336,0.9979881051775947,1,3,40092,79,40013,0.9980295320762247,17.838736,1852.2023093333332,15.453919395217167,123,2.900000000000001E-4
1,test_20231101_134718,10404007.png,502730,24062,478668,0.9521373301772323,2,4,61265,3466,57799,0.9434260997306783,25.205253333333335,3301.279184,12.943981073817032,123,3.0000000000000014E-4
2,test_20231101_134718,1254659.png,342646,78012,264634,0.7723247900165185,3,4,80080,10856,69224,0.8644355644355645,20.528035555555554,3070.871712,13.258186870279811,123,3.0000000000000014E-4
3,test_20231101_134718,10188041.png,221231,10102,211129,0.9543373216230998,2,4,41731,1423,40308,0.9659006493973306,10.595603555555556,1011.9779893333333,18.079092942287858,123,3.0000000000000014E-4
4,test_20231101_134718,10287332.png,216980,12767,204213,0.9411604756198728,2,4,22337,1747,20590,0.921788960021489,9.436826666666667,775.4438453333333,19.235300075188995,123,3.0000000000000014E-4
5,test_20231101_134718,11610969.png,368720,28252,340468,0.9233781731395097,2,3,84111,4121,79990,0.9510052192935525,20.351372444444443,2731.876538666667,13.766192924277291,123,3.0000000000000014E-4
6,test_20231101_134718,10350842.png,212614,6467,206147,0.9695833764474587,2,4,42529,947,41582,0.9777328411201768,19.205194666666667,2350.2698026666667,14.419626402627658,123,3.0000000000000014E-4
7,test_20231101_134718,10863862.png,317432,13257,304175,0.9582367247158446,2,3,66058,1916,64142,0.9709951860486239,23.681868444444444,3223.7809546666667,13.047148356167963,123,3.0000000000000014E-4
8,test_20231101_134718,11382381.png,312486,967,311519,0.9969054613646692,1,4,46745,130,46615,0.9972189538988127,21.068341333333333,2406.1475626666665,14.317581029153203,123,3.0000000000000014E-4
9,test_20231101_134718,11079715.png,443815,125192,318623,0.7179185020785688,4,4,124136,17444,106692,0.8594767029709351,16.64877511111111,2039.7730453333334,15.034985123844537,123,3.0000000000000014E-4
10,test_20231101_134718,11551286.png,271883,547,271336,0.9979881051775947,2,3,40092,79,40013,0.9980295320762247,17.838736,1852.2023093333332,15.453919395217167,123,3.0000000000000014E-4
1,test_20231101_134719,10404007.png,502730,24062,478668,0.9521373301772323,2,4,61265,3466,57799,0.9434260997306783,25.205253333333335,3301.279184,12.943981073817032,123,3.1000000000000016E-4
2,test_20231101_134719,1254659.png,342646,78012,264634,0.7723247900165185,3,4,80080,10856,69224,0.8644355644355645,20.528035555555554,3070.871712,13.258186870279811,123,3.1000000000000016E-4
3,test_20231101_134719,10188041.png,221231,10102,211129,0.9543373216230998,2,3,41731,1423,40308,0.9659006493973306,10.595603555555556,1011.9779893333333,18.079092942287858,123,3.1000000000000016E-4
4,test_20231101_134719,10287332.png,216980,12767,204213,0.9411604756198728,2,4,22337,1747,20590,0.921788960021489,9.436826666666667,775.4438453333333,19.235300075188995,123,3.1000000000000016E-4
5,test_20231101_134719,11610969.png,368720,28252,340468,0.9233781731395097,2,4,84111,4121,79990,0.9510052192935525,20.351372444444443,2731.876538666667,13.766192924277291,123,3.1000000000000016E-4
6,test_20231101_134719,10350842.png,212614,6467,206147,0.9695833764474587,1,4,42529,947,41582,0.9777328411201768,19.205194666666667,2350.2698026666667,14.419626402627658,123,3.1000000000000016E-4
7,test_20231101_134719,10863862.png,317432,13257,304175,0.9582367247158446,2,4,66058,1916,64142,0.9709951860486239,23.681868444444444,3223.7809546666667,13.047148356167963,123,3.1000000000000016E-4
8,test_20231101_134719,11382381.png,312486,967,311519,0.9969054613646692,2,3,46745,130,46615,0.9972189538988127,21.068341333333333,2406.1475626666665,14.317581029153203,123,3.1000000000000016E-4
9,test_20231101_134719,11079715.png,443815,125192,318623,0.7179185020785688,4,10,124136,17444,106692,0.8594767029709351,16.64877511111111,2039.7730453333334,15.034985123844537,123,3.1000000000000016E-4
10,test_20231101_134719,11551286.png,271883,547,271336,0.9979881051775947,2,3,40092,79,40013,0.9980295320762247,17.838736,1852.2023093333332,15.453919395217167,123,3.1000000000000016E-4
1,test_20231101_134719,10404007.png,502730,24062,478668,0.9521373301772323,3,4,61265,3466,57799,0.9434260997306783,25.205253333333335,3301.279184,12.943981073817032,123,3.200000000000002E-4
2,test_20231101_134719,1254659.png,342646,78012,264634,0.7723247900165185,3,4,80080,10856,69224,0.8644355644355645,20.528035555555554,3070.871712,13.258186870279811,123,3.200000000000002E-4
3,test_20231101_134719,10188041.png,221231,10102,211129,0.9543373216230998,1,3,41731,1423,40308,0.9659006493973306,10.595603555555556,1011.9779893333333,18.079092942287858,123,3.200000000000002E-4
4,test_20231101_134719,10287332.png,216980,12767,204213,0.9411604756198728,2,4,22337,1747,20590,0.921788960021489,9.436826666666667,775.4438453333333,19.235300075188995,123,3.200000000000002E-4
5,test_20231101_134719,11610969.png,368720,28252,340468,0.9233781731395097,2,5,84111,4121,79990,0.9510052192935525,20.351372444444443,2731.876538666667,13.766192924277291,123,3.200000000000002E-4
6,test_20231101_134719,10350842.png,212614,6467,206147,0.9695833764474587,2,3,42529,947,41582,0.9777328411201768,19.205194666666667,2350.2698026666667,14.419626402627658,123,3.200000000000002E-4
7,test_20231101_134719,10863862.png,317432,13257,304175,0.9582367247158446,2,4,66058,1916,64142,0.9709951860486239,23.681868444444444,3223.7809546666667,13.047148356167963,123,3.200000000000002E-4
8,test_20231101_134719,11382381.png,312486,827,311659,0.9973534814359684,1,4,46745,109,46636,0.997668199807466,21.564144,2476.360432,14.192665047538828,123,3.200000000000002E-4
9,test_20231101_134719,11079715.png,443815,125192,318623,0.7179185020785688,4,4,124136,17444,106692,0.8594767029709351,16.64877511111111,2039.7730453333334,15.034985123844537,123,3.200000000000002E-4
10,test_20231101_134719,11551286.png,271883,547,271336,0.9979881051775947,2,4,40092,79,40013,0.9980295320762247,17.838736,1852.2023093333332,15.453919395217167,123,3.200000000000002E-4
1,test_20231101_134720,10404007.png,502730,24062,478668,0.9521373301772323,2,4,61265,3466,57799,0.9434260997306783,25.205253333333335,3301.279184,12.943981073817032,123,3.300000000000002E-4
2,test_20231101_134720,1254659.png,342646,78012,264634,0.7723247900165185,3,4,80080,10856,69224,0.8644355644355645,20.528035555555554,3070.871712,13.258186870279811,123,3.300000000000002E-4
3,test_20231101_134720,10188041.png,221231,10102,211129,0.9543373216230998,2,4,41731,1423,40308,0.9659006493973306,10.595603555555556,1011.9779893333333,18.079092942287858,123,3.300000000000002E-4
4,test_20231101_134720,10287332.png,216980,12767,204213,0.9411604756198728,1,4,22337,1747,20590,0.921788960021489,9.436826666666667,775.4438453333333,19.235300075188995,123,3.300000000000002E-4
5,test_20231101_134720,11610969.png,368720,28252,340468,0.9233781731395097,2,4,84111,4121,79990,0.9510052192935525,20.351372444444443,2731.876538666667,13.766192924277291,123,3.300000000000002E-4
6,test_20231101_134720,10350842.png,212614,6467,206147,0.9695833764474587,2,4,42529,947,41582,0.9777328411201768,19.205194666666667,2350.2698026666667,14.419626402627658,123,3.300000000000002E-4
7,test_20231101_134720,10863862.png,317432,13257,304175,0.9582367247158446,2,3,66058,1916,64142,0.9709951860486239,23.681868444444444,3223.7809546666667,13.047148356167963,123,3.300000000000002E-4
8,test_20231101_134720,11382381.png,312486,827,311659,0.9973534814359684,1,3,46745,109,46636,0.997668199807466,21.564144,2476.360432,14.192665047538828,123,3.300000000000002E-4
9,test_20231101_134720,11079715.png,443815,125192,318623,0.7179185020785688,3,4,124136,17444,106692,0.8594767029709351,16.64877511111111,2039.7730453333334,15.034985123844537,123,3.300000000000002E-4
10,test_20231101_134720,11551286.png,271883,547,271336,0.9979881051775947,1,4,40092,79,40013,0.9980295320762247,17.838736,1852.2023093333332,15.453919395217167,123,3.300000000000002E-4
1,test_20231101_134721,10404007.png,502730,24062,478668,0.9521373301772323,2,3,61265,3466,57799,0.9434260997306783,25.205253333333335,3301.279184,12.943981073817032,123,3.4000000000000024E-4
2,test_20231101_134721,1254659.png,342646,78012,264634,0.7723247900165185,2,3,80080,10856,69224,0.8644355644355645,20.528035555555554,3070.871712,13.258186870279811,123,3.4000000000000024E-4
3,test_20231101_134721,10188041.png,221231,10102,211129,0.9543373216230998,2,4,41731,1423,40308,0.9659006493973306,10.595603555555556,1011.9779893333333,18.079092942287858,123,3.4000000000000024E-4
4,test_20231101_134721,10287332.png,216980,12767,204213,0.9411604756198728,2,4,22337,1747,20590,0.921788960021489,9.436826666666667,775.4438453333333,19.235300075188995,123,3.4000000000000024E-4
5,test_20231101_134721,11610969.png,368720,28252,340468,0.9233781731395097,3,4,84111,4121,79990,0.9510052192935525,20.351372444444443,2731.876538666667,13.766192924277291,123,3.4000000000000024E-4
6,test_20231101_134721,10350842.png,212614,6467,206147,0.9695833764474587,1,3,42529,947,41582,0.9777328411201768,19.205194666666667,2350.2698026666667,14.419626402627658,123,3.4000000000000024E-4
7,test_20231101_134721,10863862.png,317432,13257,304175,0.9582367247158446,2,3,66058,1916,64142,0.9709951860486239,23.681868444444444,3223.7809546666667,13.047148356167963,123,3.4000000000000024E-4
8,test_20231101_134721,11382381.png,312486,827,311659,0.9973534814359684,1,3,46745,109,46636,0.997668199807466,21.564144,2476.360432,14.192665047538828,123,3.4000000000000024E-4
9,test_20231101_134721,11079715.png,443815,125192,318623,0.7179185020785688,3,4,124136,17444,106692,0.8594767029709351,16.64877511111111,2039.7730453333334,15.034985123844537,123,3.4000000000000024E-4
10,test_20231101_134721,11551286.png,271883,547,271336,0.9979881051775947,1,4,40092,79,40013,0.9980295320762247,17.838736,1852.2023093333332,15.453919395217167,123,3.4000000000000024E-4
1,test_20231101_134721,10404007.png,502730,24062,478668,0.9521373301772323,2,4,61265,3466,57799,0.9434260997306783,25.205253333333335,3301.279184,12.943981073817032,123,3.5000000000000027E-4
2,test_20231101_134721,1254659.png,342646,78012,264634,0.7723247900165185,2,4,80080,10856,69224,0.8644355644355645,20.528035555555554,3070.871712,13.258186870279811,123,3.5000000000000027E-4
3,test_20231101_134721,10188041.png,221231,10102,211129,0.9543373216230998,2,3,41731,1423,40308,0.9659006493973306,10.595603555555556,1011.9779893333333,18.079092942287858,123,3.5000000000000027E-4
4,test_20231101_134721,10287332.png,216980,12767,204213,0.9411604756198728,1,4,22337,1747,20590,0.921788960021489,9.436826666666667,775.4438453333333,19.235300075188995,123,3.5000000000000027E-4
5,test_20231101_134721,11610969.png,368720,28252,340468,0.9233781731395097,2,3,84111,4121,79990,0.9510052192935525,20.351372444444443,2731.876538666667,13.766192924277291,123,3.5000000000000027E-4
6,test_20231101_134721,10350842.png,212614,6467,206147,0.9695833764474587,2,3,42529,947,41582,0.9777328411201768,19.205194666666667,2350.2698026666667,14.419626402627658,123,3.5000000000000027E-4
7,test_20231101_134721,10863862.png,317432,13257,304175,0.9582367247158446,2,3,66058,1916,64142,0.9709951860486239,23.681868444444444,3223.7809546666667,13.047148356167963,123,3.5000000000000027E-4
8,test_20231101_134721,11382381.png,312486,827,311659,0.9973534814359684,1,4,46745,109,46636,0.997668199807466,21.564144,2476.360432,14.192665047538828,123,3.5000000000000027E-4
9,test_20231101_134721,11079715.png,443815,125192,318623,0.7179185020785688,5,5,124136,17444,106692,0.8594767029709351,16.64877511111111,2039.7730453333334,15.034985123844537,123,3.5000000000000027E-4
10,test_20231101_134721,11551286.png,271883,547,271336,0.9979881051775947,2,3,40092,79,40013,0.9980295320762247,17.838736,1852.2023093333332,15.453919395217167,123,3.5000000000000027E-4
1,test_20231101_134722,10404007.png,502730,24062,478668,0.9521373301772323,6,4,61265,3466,57799,0.9434260997306783,25.205253333333335,3301.279184,12.943981073817032,123,3.600000000000003E-4
2,test_20231101_134722,1254659.png,342646,78012,264634,0.7723247900165185,2,4,80080,10856,69224,0.8644355644355645,20.528035555555554,3070.871712,13.258186870279811,123,3.600000000000003E-4
3,test_20231101_134722,10188041.png,221231,10102,211129,0.9543373216230998,2,4,41731,1423,40308,0.9659006493973306,10.595603555555556,1011.9779893333333,18.079092942287858,123,3.600000000000003E-4
4,test_20231101_134722,10287332.png,216980,12767,204213,0.9411604756198728,1,4,22337,1747,20590,0.921788960021489,9.436826666666667,775.4438453333333,19.235300075188995,123,3.600000000000003E-4
5,test_20231101_134722,11610969.png,368720,28252,340468,0.9233781731395097,2,4,84111,4121,79990,0.9510052192935525,20.351372444444443,2731.876538666667,13.766192924277291,123,3.600000000000003E-4
6,test_20231101_134722,10350842.png,212614,6467,206147,0.9695833764474587,2,4,42529,947,41582,0.9777328411201768,19.205194666666667,2350.2698026666667,14.419626402627658,123,3.600000000000003E-4
7,test_20231101_134722,10863862.png,317432,13257,304175,0.9582367247158446,1,3,66058,1916,64142,0.9709951860486239,23.681868444444444,3223.7809546666667,13.047148356167963,123,3.600000000000003E-4
8,test_20231101_134722,11382381.png,312486,827,311659,0.9973534814359684,1,4,46745,109,46636,0.997668199807466,21.564144,2476.360432,14.192665047538828,123,3.600000000000003E-4
9,test_20231101_134722,11079715.png,443815,125192,318623,0.7179185020785688,4,4,124136,17444,106692,0.8594767029709351,16.64877511111111,2039.7730453333334,15.034985123844537,123,3.600000000000003E-4
10,test_20231101_134722,11551286.png,271883,547,271336,0.9979881051775947,1,3,40092,79,40013,0.9980295320762247,17.838736,1852.2023093333332,15.453919395217167,123,3.600000000000003E-4
1,test_20231101_134723,10404007.png,502730,24062,478668,0.9521373301772323,2,3,61265,3466,57799,0.9434260997306783,25.205253333333335,3301.279184,12.943981073817032,123,3.700000000000003E-4
2,test_20231101_134723,1254659.png,342646,78012,264634,0.7723247900165185,2,4,80080,10856,69224,0.8644355644355645,20.528035555555554,3070.871712,13.258186870279811,123,3.700000000000003E-4
3,test_20231101_134723,10188041.png,221231,10102,211129,0.9543373216230998,2,4,41731,1423,40308,0.9659006493973306,10.595603555555556,1011.9779893333333,18.079092942287858,123,3.700000000000003E-4
4,test_20231101_134723,10287332.png,216980,12767,204213,0.9411604756198728,2,4,22337,1747,20590,0.921788960021489,9.436826666666667,775.4438453333333,19.235300075188995,123,3.700000000000003E-4
5,test_20231101_134723,11610969.png,368720,28252,340468,0.9233781731395097,3,3,84111,4121,79990,0.9510052192935525,20.351372444444443,2731.876538666667,13.766192924277291,123,3.700000000000003E-4
6,test_20231101_134723,10350842.png,212614,6467,206147,0.9695833764474587,2,4,42529,947,41582,0.9777328411201768,19.205194666666667,2350.2698026666667,14.419626402627658,123,3.700000000000003E-4
7,test_20231101_134723,10863862.png,317432,13257,304175,0.9582367247158446,2,3,66058,1916,64142,0.9709951860486239,23.681868444444444,3223.7809546666667,13.047148356167963,123,3.700000000000003E-4
8,test_20231101_134723,11382381.png,312486,827,311659,0.9973534814359684,1,3,46745,109,46636,0.997668199807466,21.564144,2476.360432,14.192665047538828,123,3.700000000000003E-4
9,test_20231101_134723,11079715.png,443815,125192,318623,0.7179185020785688,4,4,124136,17444,106692,0.8594767029709351,16.64877511111111,2039.7730453333334,15.034985123844537,123,3.700000000000003E-4
10,test_20231101_134723,11551286.png,271883,547,271336,0.9979881051775947,1,3,40092,79,40013,0.9980295320762247,17.838736,1852.2023093333332,15.453919395217167,123,3.700000000000003E-4
1,test_20231101_134723,10404007.png,502730,24062,478668,0.9521373301772323,2,4,61265,3466,57799,0.9434260997306783,25.205253333333335,3301.279184,12.943981073817032,123,3.8000000000000035E-4
2,test_20231101_134723,1254659.png,342646,78012,264634,0.7723247900165185,3,4,80080,10856,69224,0.8644355644355645,20.528035555555554,3070.871712,13.258186870279811,123,3.8000000000000035E-4
3,test_20231101_134723,10188041.png,221231,10102,211129,0.9543373216230998,2,4,41731,1423,40308,0.9659006493973306,10.595603555555556,1011.9779893333333,18.079092942287858,123,3.8000000000000035E-4
4,test_20231101_134723,10287332.png,216980,12767,204213,0.9411604756198728,2,3,22337,1747,20590,0.921788960021489,9.436826666666667,775.4438453333333,19.235300075188995,123,3.8000000000000035E-4
5,test_20231101_134723,11610969.png,368720,28252,340468,0.9233781731395097,3,3,84111,4121,79990,0.9510052192935525,20.351372444444443,2731.876538666667,13.766192924277291,123,3.8000000000000035E-4
6,test_20231101_134723,10350842.png,212614,6467,206147,0.9695833764474587,2,3,42529,947,41582,0.9777328411201768,19.205194666666667,2350.2698026666667,14.419626402627658,123,3.8000000000000035E-4
7,test_20231101_134723,10863862.png,317432,13257,304175,0.9582367247158446,2,4,66058,1916,64142,0.9709951860486239,23.681868444444444,3223.7809546666667,13.047148356167963,123,3.8000000000000035E-4
8,test_20231101_134723,11382381.png,312486,827,311659,0.9973534814359684,1,3,46745,109,46636,0.997668199807466,21.564144,2476.360432,14.192665047538828,123,3.8000000000000035E-4
9,test_20231101_134723,11079715.png,443815,125192,318623,0.7179185020785688,4,4,124136,17444,106692,0.8594767029709351,16.64877511111111,2039.7730453333334,15.034985123844537,123,3.8000000000000035E-4
10,test_20231101_134723,11551286.png,271883,547,271336,0.9979881051775947,1,3,40092,79,40013,0.9980295320762247,17.838736,1852.2023093333332,15.453919395217167,123,3.8000000000000035E-4
1,test_20231101_134724,10404007.png,502730,24062,478668,0.9521373301772323,2,4,61265,3466,57799,0.9434260997306783,25.205253333333335,3301.279184,12.943981073817032,123,3.9000000000000037E-4
2,test_20231101_134724,1254659.png,342646,78012,264634,0.7723247900165185,3,4,80080,10856,69224,0.8644355644355645,20.528035555555554,3070.871712,13.258186870279811,123,3.9000000000000037E-4
3,test_20231101_134724,10188041.png,221231,10102,211129,0.9543373216230998,2,4,41731,1423,40308,0.9659006493973306,10.595603555555556,1011.9779893333333,18.079092942287858,123,3.9000000000000037E-4
4,test_20231101_134724,10287332.png,216980,12767,204213,0.9411604756198728,1,4,22337,1747,20590,0.921788960021489,9.436826666666667,775.4438453333333,19.235300075188995,123,3.9000000000000037E-4
5,test_20231101_134724,11610969.png,368720,28252,340468,0.9233781731395097,2,4,84111,4121,79990,0.9510052192935525,20.351372444444443,2731.876538666667,13.766192924277291,123,3.9000000000000037E-4
6,test_20231101_134724,10350842.png,212614,6467,206147,0.9695833764474587,2,4,42529,947,41582,0.9777328411201768,19.205194666666667,2350.2698026666667,14.419626402627658,123,3.9000000000000037E-4
7,test_20231101_134724,10863862.png,317432,13257,304175,0.9582367247158446,2,3,66058,1916,64142,0.9709951860486239,23.681868444444444,3223.7809546666667,13.047148356167963,123,3.9000000000000037E-4
8,test_20231101_134724,11382381.png,312486,827,311659,0.9973534814359684,2,3,46745,109,46636,0.997668199807466,21.564144,2476.360432,14.192665047538828,123,3.9000000000000037E-4
9,test_20231101_134724,11079715.png,443815,125192,318623,0.7179185020785688,3,4,124136,17444,106692,0.8594767029709351,16.64877511111111,2039.7730453333334,15.034985123844537,123,3.9000000000000037E-4
10,test_20231101_134724,11551286.png,271883,547,271336,0.9979881051775947,1,4,40092,79,40013,0.9980295320762247,17.838736,1852.2023093333332,15.453919395217167,123,3.9000000000000037E-4
1,test_20231101_134725,10404007.png,502730,24062,478668,0.9521373301772323,2,4,61265,3466,57799,0.9434260997306783,25.205253333333335,3301.279184,12.943981073817032,123,4.000000000000004E-4
2,test_20231101_134725,1254659.png,342646,78012,264634,0.7723247900165185,2,3,80080,10856,69224,0.8644355644355645,20.528035555555554,3070.871712,13.258186870279811,123,4.000000000000004E-4
3,test_20231101_134725,10188041.png,221231,10102,211129,0.9543373216230998,2,4,41731,1423,40308,0.9659006493973306,10.595603555555556,1011.9779893333333,18.079092942287858,123,4.000000000000004E-4
4,test_20231101_134725,10287332.png,216980,12767,204213,0.9411604756198728,2,5,22337,1747,20590,0.921788960021489,9.436826666666667,775.4438453333333,19.235300075188995,123,4.000000000000004E-4
5,test_20231101_134725,11610969.png,368720,28252,340468,0.9233781731395097,2,3,84111,4121,79990,0.9510052192935525,20.351372444444443,2731.876538666667,13.766192924277291,123,4.000000000000004E-4
6,test_20231101_134725,10350842.png,212614,6467,206147,0.9695833764474587,1,4,42529,947,41582,0.9777328411201768,19.205194666666667,2350.2698026666667,14.419626402627658,123,4.000000000000004E-4
7,test_20231101_134725,10863862.png,317432,13257,304175,0.9582367247158446,2,3,66058,1916,64142,0.9709951860486239,23.681868444444444,3223.7809546666667,13.047148356167963,123,4.000000000000004E-4
8,test_20231101_134725,11382381.png,312486,827,311659,0.9973534814359684,1,4,46745,109,46636,0.997668199807466,21.564144,2476.360432,14.192665047538828,123,4.000000000000004E-4
9,test_20231101_134725,11079715.png,443815,125192,318623,0.7179185020785688,3,4,124136,17444,106692,0.8594767029709351,16.64877511111111,2039.7730453333334,15.034985123844537,123,4.000000000000004E-4
10,test_20231101_134725,11551286.png,271883,547,271336,0.9979881051775947,1,4,40092,79,40013,0.9980295320762247,17.838736,1852.2023093333332,15.453919395217167,123,4.000000000000004E-4
1,test_20231101_134725,10404007.png,502730,24062,478668,0.9521373301772323,3,3,61265,3466,57799,0.9434260997306783,25.205253333333335,3301.279184,12.943981073817032,123,4.100000000000004E-4
2,test_20231101_134725,1254659.png,342646,78012,264634,0.7723247900165185,3,8,80080,10856,69224,0.8644355644355645,20.528035555555554,3070.871712,13.258186870279811,123,4.100000000000004E-4
3,test_20231101_134725,10188041.png,221231,10102,211129,0.9543373216230998,2,3,41731,1423,40308,0.9659006493973306,10.595603555555556,1011.9779893333333,18.079092942287858,123,4.100000000000004E-4
4,test_20231101_134725,10287332.png,216980,12767,204213,0.9411604756198728,2,4,22337,1747,20590,0.921788960021489,9.436826666666667,775.4438453333333,19.235300075188995,123,4.100000000000004E-4
5,test_20231101_134725,11610969.png,368720,28252,340468,0.9233781731395097,2,3,84111,4121,79990,0.9510052192935525,20.351372444444443,2731.876538666667,13.766192924277291,123,4.100000000000004E-4
6,test_20231101_134725,10350842.png,212614,6467,206147,0.9695833764474587,2,3,42529,947,41582,0.9777328411201768,19.205194666666667,2350.2698026666667,14.419626402627658,123,4.100000000000004E-4
7,test_20231101_134725,10863862.png,317432,13257,304175,0.9582367247158446,3,3,66058,1916,64142,0.9709951860486239,23.681868444444444,3223.7809546666667,13.047148356167963,123,4.100000000000004E-4
8,test_20231101_134725,11382381.png,312486,827,311659,0.9973534814359684,2,4,46745,109,46636,0.997668199807466,21.564144,2476.360432,14.192665047538828,123,4.100000000000004E-4
9,test_20231101_134725,11079715.png,443815,125192,318623,0.7179185020785688,3,4,124136,17444,106692,0.8594767029709351,16.64877511111111,2039.7730453333334,15.034985123844537,123,4.100000000000004E-4
10,test_20231101_134725,11551286.png,271883,547,271336,0.9979881051775947,2,3,40092,79,40013,0.9980295320762247,17.838736,1852.2023093333332,15.453919395217167,123,4.100000000000004E-4
1,test_20231101_134726,10404007.png,502730,24062,478668,0.9521373301772323,2,3,61265,3466,57799,0.9434260997306783,25.205253333333335,3301.279184,12.943981073817032,123,4.2000000000000045E-4
2,test_20231101_134726,1254659.png,342646,78012,264634,0.7723247900165185,3,4,80080,10856,69224,0.8644355644355645,20.528035555555554,3070.871712,13.258186870279811,123,4.2000000000000045E-4
3,test_20231101_134726,10188041.png,221231,10102,211129,0.9543373216230998,2,3,41731,1423,40308,0.9659006493973306,10.595603555555556,1011.9779893333333,18.079092942287858,123,4.2000000000000045E-4
4,test_20231101_134726,10287332.png,216980,12767,204213,0.9411604756198728,2,3,22337,1747,20590,0.921788960021489,9.436826666666667,775.4438453333333,19.235300075188995,123,4.2000000000000045E-4
5,test_20231101_134726,11610969.png,368720,28252,340468,0.9233781731395097,3,4,84111,4121,79990,0.9510052192935525,20.351372444444443,2731.876538666667,13.766192924277291,123,4.2000000000000045E-4
6,test_20231101_134726,10350842.png,212614,6467,206147,0.9695833764474587,2,4,42529,947,41582,0.9777328411201768,19.205194666666667,2350.2698026666667,14.419626402627658,123,4.2000000000000045E-4
7,test_20231101_134726,10863862.png,317432,13257,304175,0.9582367247158446,2,4,66058,1916,64142,0.9709951860486239,23.681868444444444,3223.7809546666667,13.047148356167963,123,4.2000000000000045E-4
8,test_20231101_134726,11382381.png,312486,827,311659,0.9973534814359684,2,4,46745,109,46636,0.997668199807466,21.564144,2476.360432,14.192665047538828,123,4.2000000000000045E-4
9,test_20231101_134726,11079715.png,443815,125192,318623,0.7179185020785688,3,4,124136,17444,106692,0.8594767029709351,16.64877511111111,2039.7730453333334,15.034985123844537,123,4.2000000000000045E-4
10,test_20231101_134726,11551286.png,271883,547,271336,0.9979881051775947,1,4,40092,79,40013,0.9980295320762247,17.838736,1852.2023093333332,15.453919395217167,123,4.2000000000000045E-4
1,test_20231101_134727,10404007.png,502730,24062,478668,0.9521373301772323,3,4,61265,3466,57799,0.9434260997306783,25.205253333333335,3301.279184,12.943981073817032,123,4.300000000000005E-4
2,test_20231101_134727,1254659.png,342646,78012,264634,0.7723247900165185,3,5,80080,10856,69224,0.8644355644355645,20.528035555555554,3070.871712,13.258186870279811,123,4.300000000000005E-4
3,test_20231101_134727,10188041.png,221231,10102,211129,0.9543373216230998,2,4,41731,1423,40308,0.9659006493973306,10.595603555555556,1011.9779893333333,18.079092942287858,123,4.300000000000005E-4
4,test_20231101_134727,10287332.png,216980,12767,204213,0.9411604756198728,2,6,22337,1747,20590,0.921788960021489,9.436826666666667,775.4438453333333,19.235300075188995,123,4.300000000000005E-4
5,test_20231101_134727,11610969.png,368720,28252,340468,0.9233781731395097,3,4,84111,4121,79990,0.9510052192935525,20.351372444444443,2731.876538666667,13.766192924277291,123,4.300000000000005E-4
6,test_20231101_134727,10350842.png,212614,6467,206147,0.9695833764474587,1,3,42529,947,41582,0.9777328411201768,19.205194666666667,2350.2698026666667,14.419626402627658,123,4.300000000000005E-4
7,test_20231101_134727,10863862.png,317432,13257,304175,0.9582367247158446,3,3,66058,1916,64142,0.9709951860486239,23.681868444444444,3223.7809546666667,13.047148356167963,123,4.300000000000005E-4
8,test_20231101_134727,11382381.png,312486,827,311659,0.9973534814359684,1,3,46745,109,46636,0.997668199807466,21.564144,2476.360432,14.192665047538828,123,4.300000000000005E-4
9,test_20231101_134727,11079715.png,443815,125192,318623,0.7179185020785688,4,4,124136,17444,106692,0.8594767029709351,16.64877511111111,2039.7730453333334,15.034985123844537,123,4.300000000000005E-4
10,test_20231101_134727,11551286.png,271883,547,271336,0.9979881051775947,1,3,40092,79,40013,0.9980295320762247,17.838736,1852.2023093333332,15.453919395217167,123,4.300000000000005E-4
1,test_20231101_134727,10404007.png,502730,24062,478668,0.9521373301772323,2,3,61265,3466,57799,0.9434260997306783,25.205253333333335,3301.279184,12.943981073817032,123,4.400000000000005E-4
2,test_20231101_134727,1254659.png,342646,78012,264634,0.7723247900165185,3,4,80080,10856,69224,0.8644355644355645,20.528035555555554,3070.871712,13.258186870279811,123,4.400000000000005E-4
3,test_20231101_134727,10188041.png,221231,10102,211129,0.9543373216230998,2,3,41731,1423,40308,0.9659006493973306,10.595603555555556,1011.9779893333333,18.079092942287858,123,4.400000000000005E-4
4,test_20231101_134727,10287332.png,216980,12767,204213,0.9411604756198728,2,3,22337,1747,20590,0.921788960021489,9.436826666666667,775.4438453333333,19.235300075188995,123,4.400000000000005E-4
5,test_20231101_134727,11610969.png,368720,28252,340468,0.9233781731395097,2,3,84111,4121,79990,0.9510052192935525,20.351372444444443,2731.876538666667,13.766192924277291,123,4.400000000000005E-4
6,test_20231101_134727,10350842.png,212614,6467,206147,0.9695833764474587,2,7,42529,947,41582,0.9777328411201768,19.205194666666667,2350.2698026666667,14.419626402627658,123,4.400000000000005E-4
7,test_20231101_134727,10863862.png,317432,13257,304175,0.9582367247158446,2,4,66058,1916,64142,0.9709951860486239,23.681868444444444,3223.7809546666667,13.047148356167963,123,4.400000000000005E-4
8,test_20231101_134727,11382381.png,312486,827,311659,0.9973534814359684,1,4,46745,109,46636,0.997668199807466,21.564144,2476.360432,14.192665047538828,123,4.400000000000005E-4
9,test_20231101_134727,11079715.png,443815,125192,318623,0.7179185020785688,3,5,124136,17444,106692,0.8594767029709351,16.64877511111111,2039.7730453333334,15.034985123844537,123,4.400000000000005E-4
10,test_20231101_134727,11551286.png,271883,547,271336,0.9979881051775947,1,3,40092,79,40013,0.9980295320762247,17.838736,1852.2023093333332,15.453919395217167,123,4.400000000000005E-4
1,test_20231101_134728,10404007.png,502730,23739,478991,0.9527798221709466,2,4,61265,3420,57845,0.9441769362605076,25.295297777777776,3321.273722666667,12.917756914288205,123,4.5000000000000053E-4
2,test_20231101_134728,1254659.png,342646,78012,264634,0.7723247900165185,3,5,80080,10856,69224,0.8644355644355645,20.528035555555554,3070.871712,13.258186870279811,123,4.5000000000000053E-4
3,test_20231101_134728,10188041.png,221231,10102,211129,0.9543373216230998,2,4,41731,1423,40308,0.9659006493973306,10.595603555555556,1011.9779893333333,18.079092942287858,123,4.5000000000000053E-4
4,test_20231101_134728,10287332.png,216980,12767,204213,0.9411604756198728,2,4,22337,1747,20590,0.921788960021489,9.436826666666667,775.4438453333333,19.235300075188995,123,4.5000000000000053E-4
5,test_20231101_134728,11610969.png,368720,28252,340468,0.9233781731395097,3,4,84111,4121,79990,0.9510052192935525,20.351372444444443,2731.876538666667,13.766192924277291,123,4.5000000000000053E-4
6,test_20231101_134728,10350842.png,212614,6467,206147,0.9695833764474587,2,3,42529,947,41582,0.9777328411201768,19.205194666666667,2350.2698026666667,14.419626402627658,123,4.5000000000000053E-4
7,test_20231101_134728,10863862.png,317432,13257,304175,0.9582367247158446,2,4,66058,1916,64142,0.9709951860486239,23.681868444444444,3223.7809546666667,13.047148356167963,123,4.5000000000000053E-4
8,test_20231101_134728,11382381.png,312486,827,311659,0.9973534814359684,2,4,46745,109,46636,0.997668199807466,21.564144,2476.360432,14.192665047538828,123,4.5000000000000053E-4
9,test_20231101_134728,11079715.png,443815,125192,318623,0.7179185020785688,4,4,124136,17444,106692,0.8594767029709351,16.64877511111111,2039.7730453333334,15.034985123844537,123,4.5000000000000053E-4
10,test_20231101_134728,11551286.png,271883,547,271336,0.9979881051775947,2,3,40092,79,40013,0.9980295320762247,17.838736,1852.2023093333332,15.453919395217167,123,4.5000000000000053E-4
1,test_20231101_134729,10404007.png,502730,23739,478991,0.9527798221709466,2,4,61265,3420,57845,0.9441769362605076,25.295297777777776,3321.273722666667,12.917756914288205,123,4.6000000000000056E-4
2,test_20231101_134729,1254659.png,342646,78012,264634,0.7723247900165185,3,4,80080,10856,69224,0.8644355644355645,20.528035555555554,3070.871712,13.258186870279811,123,4.6000000000000056E-4
3,test_20231101_134729,10188041.png,221231,10102,211129,0.9543373216230998,2,4,41731,1423,40308,0.9659006493973306,10.595603555555556,1011.9779893333333,18.079092942287858,123,4.6000000000000056E-4
4,test_20231101_134729,10287332.png,216980,12767,204213,0.9411604756198728,2,4,22337,1747,20590,0.921788960021489,9.436826666666667,775.4438453333333,19.235300075188995,123,4.6000000000000056E-4
5,test_20231101_134729,11610969.png,368720,28252,340468,0.9233781731395097,3,3,84111,4121,79990,0.9510052192935525,20.351372444444443,2731.876538666667,13.766192924277291,123,4.6000000000000056E-4
6,test_20231101_134729,10350842.png,212614,6467,206147,0.9695833764474587,1,3,42529,947,41582,0.9777328411201768,19.205194666666667,2350.2698026666667,14.419626402627658,123,4.6000000000000056E-4
7,test_20231101_134729,10863862.png,317432,13257,304175,0.9582367247158446,2,4,66058,1916,64142,0.9709951860486239,23.681868444444444,3223.7809546666667,13.047148356167963,123,4.6000000000000056E-4
8,test_20231101_134729,11382381.png,312486,827,311659,0.9973534814359684,1,3,46745,109,46636,0.997668199807466,21.564144,2476.360432,14.192665047538828,123,4.6000000000000056E-4
9,test_20231101_134729,11079715.png,443815,125192,318623,0.7179185020785688,4,5,124136,17444,106692,0.8594767029709351,16.64877511111111,2039.7730453333334,15.034985123844537,123,4.6000000000000056E-4
10,test_20231101_134729,11551286.png,271883,547,271336,0.9979881051775947,1,4,40092,79,40013,0.9980295320762247,17.838736,1852.2023093333332,15.453919395217167,123,4.6000000000000056E-4
1,test_20231101_134729,10404007.png,502730,23739,478991,0.9527798221709466,3,4,61265,3420,57845,0.9441769362605076,25.295297777777776,3321.273722666667,12.917756914288205,123,4.700000000000006E-4
2,test_20231101_134729,1254659.png,342646,78012,264634,0.7723247900165185,4,3,80080,10856,69224,0.8644355644355645,20.528035555555554,3070.871712,13.258186870279811,123,4.700000000000006E-4
3,test_20231101_134729,10188041.png,221231,10102,211129,0.9543373216230998,2,3,41731,1423,40308,0.9659006493973306,10.595603555555556,1011.9779893333333,18.079092942287858,123,4.700000000000006E-4
4,test_20231101_134729,10287332.png,216980,12767,204213,0.9411604756198728,1,4,22337,1747,20590,0.921788960021489,9.436826666666667,775.4438453333333,19.235300075188995,123,4.700000000000006E-4
5,test_20231101_134729,11610969.png,368720,28252,340468,0.9233781731395097,2,4,84111,4121,79990,0.9510052192935525,20.351372444444443,2731.876538666667,13.766192924277291,123,4.700000000000006E-4
6,test_20231101_134729,10350842.png,212614,6467,206147,0.9695833764474587,2,4,42529,947,41582,0.9777328411201768,19.205194666666667,2350.2698026666667,14.419626402627658,123,4.700000000000006E-4
7,test_20231101_134729,10863862.png,317432,13257,304175,0.9582367247158446,2,3,66058,1916,64142,0.9709951860486239,23.681868444444444,3223.7809546666667,13.047148356167963,123,4.700000000000006E-4
8,test_20231101_134729,11382381.png,312486,827,311659,0.9973534814359684,2,3,46745,109,46636,0.997668199807466,21.564144,2476.360432,14.192665047538828,123,4.700000000000006E-4
9,test_20231101_134729,11079715.png,443815,125192,318623,0.7179185020785688,3,4,124136,17444,106692,0.8594767029709351,16.64877511111111,2039.7730453333334,15.034985123844537,123,4.700000000000006E-4
10,test_20231101_134729,11551286.png,271883,547,271336,0.9979881051775947,1,3,40092,79,40013,0.9980295320762247,17.838736,1852.2023093333332,15.453919395217167,123,4.700000000000006E-4
1,test_20231101_134730,10404007.png,502730,23739,478991,0.9527798221709466,3,4,61265,3420,57845,0.9441769362605076,25.295297777777776,3321.273722666667,12.917756914288205,123,4.800000000000006E-4
2,test_20231101_134730,1254659.png,342646,78012,264634,0.7723247900165185,3,4,80080,10856,69224,0.8644355644355645,20.528035555555554,3070.871712,13.258186870279811,123,4.800000000000006E-4
3,test_20231101_134730,10188041.png,221231,10102,211129,0.9543373216230998,2,4,41731,1423,40308,0.9659006493973306,10.595603555555556,1011.9779893333333,18.079092942287858,123,4.800000000000006E-4
4,test_20231101_134730,10287332.png,216980,12767,204213,0.9411604756198728,1,4,22337,1747,20590,0.921788960021489,9.436826666666667,775.4438453333333,19.235300075188995,123,4.800000000000006E-4
5,test_20231101_134730,11610969.png,368720,28252,340468,0.9233781731395097,2,3,84111,4121,79990,0.9510052192935525,20.351372444444443,2731.876538666667,13.766192924277291,123,4.800000000000006E-4
6,test_20231101_134730,10350842.png,212614,6467,206147,0.9695833764474587,2,5,42529,947,41582,0.9777328411201768,19.205194666666667,2350.2698026666667,14.419626402627658,123,4.800000000000006E-4
7,test_20231101_134730,10863862.png,317432,13257,304175,0.9582367247158446,2,4,66058,1916,64142,0.9709951860486239,23.681868444444444,3223.7809546666667,13.047148356167963,123,4.800000000000006E-4
8,test_20231101_134730,11382381.png,312486,827,311659,0.9973534814359684,2,3,46745,109,46636,0.997668199807466,21.564144,2476.360432,14.192665047538828,123,4.800000000000006E-4
9,test_20231101_134730,11079715.png,443815,125192,318623,0.7179185020785688,3,4,124136,17444,106692,0.8594767029709351,16.64877511111111,2039.7730453333334,15.034985123844537,123,4.800000000000006E-4
10,test_20231101_134730,11551286.png,271883,547,271336,0.9979881051775947,1,4,40092,79,40013,0.9980295320762247,17.838736,1852.2023093333332,15.453919395217167,123,4.800000000000006E-4
1,test_20231101_134731,10404007.png,502730,23739,478991,0.9527798221709466,2,4,61265,3420,57845,0.9441769362605076,25.295297777777776,3321.273722666667,12.917756914288205,123,4.900000000000006E-4
2,test_20231101_134731,1254659.png,342646,78012,264634,0.7723247900165185,3,4,80080,10856,69224,0.8644355644355645,20.528035555555554,3070.871712,13.258186870279811,123,4.900000000000006E-4
3,test_20231101_134731,10188041.png,221231,10102,211129,0.9543373216230998,2,4,41731,1423,40308,0.9659006493973306,10.595603555555556,1011.9779893333333,18.079092942287858,123,4.900000000000006E-4
4,test_20231101_134731,10287332.png,216980,12767,204213,0.9411604756198728,1,4,22337,1747,20590,0.921788960021489,9.436826666666667,775.4438453333333,19.235300075188995,123,4.900000000000006E-4
5,test_20231101_134731,11610969.png,368720,28252,340468,0.9233781731395097,3,3,84111,4121,79990,0.9510052192935525,20.351372444444443,2731.876538666667,13.766192924277291,123,4.900000000000006E-4
6,test_20231101_134731,10350842.png,212614,6467,206147,0.9695833764474587,2,3,42529,947,41582,0.9777328411201768,19.205194666666667,2350.2698026666667,14.419626402627658,123,4.900000000000006E-4
7,test_20231101_134731,10863862.png,317432,13257,304175,0.9582367247158446,2,3,66058,1916,64142,0.9709951860486239,23.681868444444444,3223.7809546666667,13.047148356167963,123,4.900000000000006E-4
8,test_20231101_134731,11382381.png,312486,827,311659,0.9973534814359684,2,3,46745,109,46636,0.997668199807466,21.564144,2476.360432,14.192665047538828,123,4.900000000000006E-4
9,test_20231101_134731,11079715.png,443815,125192,318623,0.7179185020785688,4,4,124136,17444,106692,0.8594767029709351,16.64877511111111,2039.7730453333334,15.034985123844537,123,4.900000000000006E-4
10,test_20231101_134731,11551286.png,271883,547,271336,0.9979881051775947,1,4,40092,79,40013,0.9980295320762247,17.838736,1852.2023093333332,15.453919395217167,123,4.900000000000006E-4
1,test_20231101_134732,10404007.png,502730,23739,478991,0.9527798221709466,2,4,61265,3420,57845,0.9441769362605076,25.295297777777776,3321.273722666667,12.917756914288205,123,5.000000000000007E-4
2,test_20231101_134732,1254659.png,342646,78012,264634,0.7723247900165185,3,5,80080,10856,69224,0.8644355644355645,20.528035555555554,3070.871712,13.258186870279811,123,5.000000000000007E-4
3,test_20231101_134732,10188041.png,221231,10102,211129,0.9543373216230998,2,4,41731,1423,40308,0.9659006493973306,10.595603555555556,1011.9779893333333,18.079092942287858,123,5.000000000000007E-4
4,test_20231101_134732,10287332.png,216980,12767,204213,0.9411604756198728,1,3,22337,1747,20590,0.921788960021489,9.436826666666667,775.4438453333333,19.235300075188995,123,5.000000000000007E-4
5,test_20231101_134732,11610969.png,368720,28252,340468,0.9233781731395097,3,4,84111,4121,79990,0.9510052192935525,20.351372444444443,2731.876538666667,13.766192924277291,123,5.000000000000007E-4
6,test_20231101_134732,10350842.png,212614,6467,206147,0.9695833764474587,1,4,42529,947,41582,0.9777328411201768,19.205194666666667,2350.2698026666667,14.419626402627658,123,5.000000000000007E-4
7,test_20231101_134732,10863862.png,317432,13257,304175,0.9582367247158446,2,4,66058,1916,64142,0.9709951860486239,23.681868444444444,3223.7809546666667,13.047148356167963,123,5.000000000000007E-4
8,test_20231101_134732,11382381.png,312486,827,311659,0.9973534814359684,1,4,46745,109,46636,0.997668199807466,21.564144,2476.360432,14.192665047538828,123,5.000000000000007E-4
9,test_20231101_134732,11079715.png,443815,125192,318623,0.7179185020785688,3,9,124136,17444,106692,0.8594767029709351,16.64877511111111,2039.7730453333334,15.034985123844537,123,5.000000000000007E-4
10,test_20231101_134732,11551286.png,271883,547,271336,0.9979881051775947,1,4,40092,79,40013,0.9980295320762247,17.838736,1852.2023093333332,15.453919395217167,123,5.000000000000007E-4
1,test_20231101_134732,10404007.png,502730,23337,479393,0.9535794561693155,2,3,61265,3365,57900,0.9450746755896515,25.313722666666667,3325.6070666666665,12.912094265254296,123,5.100000000000007E-4
2,test_20231101_134732,1254659.png,342646,78012,264634,0.7723247900165185,3,4,80080,10856,69224,0.8644355644355645,20.528035555555554,3070.871712,13.258186870279811,123,5.100000000000007E-4
3,test_20231101_134732,10188041.png,221231,10082,211149,0.9544277248667682,2,11,41731,1420,40311,0.9659725384007093,10.853313777777778,1051.0199413333332,17.91469404755111,123,5.100000000000007E-4
4,test_20231101_134732,10287332.png,216980,12767,204213,0.9411604756198728,2,3,22337,1747,20590,0.921788960021489,9.436826666666667,775.4438453333333,19.235300075188995,123,5.100000000000007E-4
5,test_20231101_134732,11610969.png,368720,28152,340568,0.9236493816446084,3,4,84111,4106,80005,0.9511835550641414,20.388908444444443,2735.818362666667,13.759931006817341,123,5.100000000000007E-4
6,test_20231101_134732,10350842.png,212614,6467,206147,0.9695833764474587,2,3,42529,947,41582,0.9777328411201768,19.205194666666667,2350.2698026666667,14.419626402627658,123,5.100000000000007E-4
7,test_20231101_134732,10863862.png,317432,13197,304235,0.9584257415761486,2,4,66058,1907,64151,0.9711314299554936,23.723717333333333,3225.647888,13.044634028505238,123,5.100000000000007E-4
8,test_20231101_134732,11382381.png,312486,827,311659,0.9973534814359684,2,4,46745,109,46636,0.997668199807466,21.564144,2476.360432,14.192665047538828,123,5.100000000000007E-4
9,test_20231101_134732,11079715.png,443815,125192,318623,0.7179185020785688,3,5,124136,17444,106692,0.8594767029709351,16.64877511111111,2039.7730453333334,15.034985123844537,123,5.100000000000007E-4
10,test_20231101_134732,11551286.png,271883,467,271416,0.9982823493929374,1,4,40092,67,40025,0.998328843659583,17.988837333333333,1870.894224,15.410311266718583,123,5.100000000000007E-4
1,test_20231101_134733,10404007.png,502730,23337,479393,0.9535794561693155,2,3,61265,3365,57900,0.9450746755896515,25.313722666666667,3325.6070666666665,12.912094265254296,123,5.200000000000007E-4
2,test_20231101_134733,1254659.png,342646,78012,264634,0.7723247900165185,3,4,80080,10856,69224,0.8644355644355645,20.528035555555554,3070.871712,13.258186870279811,123,5.200000000000007E-4
3,test_20231101_134733,10188041.png,221231,10082,211149,0.9544277248667682,2,4,41731,1420,40311,0.9659725384007093,10.853313777777778,1051.0199413333332,17.91469404755111,123,5.200000000000007E-4
4,test_20231101_134733,10287332.png,216980,12767,204213,0.9411604756198728,1,3,22337,1747,20590,0.921788960021489,9.436826666666667,775.4438453333333,19.235300075188995,123,5.200000000000007E-4
5,test_20231101_134733,11610969.png,368720,28152,340568,0.9236493816446084,2,3,84111,4106,80005,0.9511835550641414,20.388908444444443,2735.818362666667,13.759931006817341,123,5.200000000000007E-4
6,test_20231101_134733,10350842.png,212614,6467,206147,0.9695833764474587,1,4,42529,947,41582,0.9777328411201768,19.205194666666667,2350.2698026666667,14.419626402627658,123,5.200000000000007E-4
7,test_20231101_134733,10863862.png,317432,13197,304235,0.9584257415761486,2,4,66058,1907,64151,0.9711314299554936,23.723717333333333,3225.647888,13.044634028505238,123,5.200000000000007E-4
8,test_20231101_134733,11382381.png,312486,827,311659,0.9973534814359684,2,3,46745,109,46636,0.997668199807466,21.564144,2476.360432,14.192665047538828,123,5.200000000000007E-4
9,test_20231101_134733,11079715.png,443815,125192,318623,0.7179185020785688,3,4,124136,17444,106692,0.8594767029709351,16.64877511111111,2039.7730453333334,15.034985123844537,123,5.200000000000007E-4
10,test_20231101_134733,11551286.png,271883,467,271416,0.9982823493929374,1,3,40092,67,40025,0.998328843659583,17.988837333333333,1870.894224,15.410311266718583,123,5.200000000000007E-4
1,test_20231101_134734,10404007.png,502730,23337,479393,0.9535794561693155,3,3,61265,3365,57900,0.9450746755896515,25.313722666666667,3325.6070666666665,12.912094265254296,123,5.300000000000007E-4
2,test_20231101_134734,1254659.png,342646,78012,264634,0.7723247900165185,3,4,80080,10856,69224,0.8644355644355645,20.528035555555554,3070.871712,13.258186870279811,123,5.300000000000007E-4
3,test_20231101_134734,10188041.png,221231,10082,211149,0.9544277248667682,3,3,41731,1420,40311,0.9659725384007093,10.853313777777778,1051.0199413333332,17.91469404755111,123,5.300000000000007E-4
4,test_20231101_134734,10287332.png,216980,12767,204213,0.9411604756198728,2,4,22337,1747,20590,0.921788960021489,9.436826666666667,775.4438453333333,19.235300075188995,123,5.300000000000007E-4
5,test_20231101_134734,11610969.png,368720,28152,340568,0.9236493816446084,2,4,84111,4106,80005,0.9511835550641414,20.388908444444443,2735.818362666667,13.759931006817341,123,5.300000000000007E-4
6,test_20231101_134734,10350842.png,212614,6467,206147,0.9695833764474587,2,4,42529,947,41582,0.9777328411201768,19.205194666666667,2350.2698026666667,14.419626402627658,123,5.300000000000007E-4
7,test_20231101_134734,10863862.png,317432,13197,304235,0.9584257415761486,2,3,66058,1907,64151,0.9711314299554936,23.723717333333333,3225.647888,13.044634028505238,123,5.300000000000007E-4
8,test_20231101_134734,11382381.png,312486,827,311659,0.9973534814359684,2,4,46745,109,46636,0.997668199807466,21.564144,2476.360432,14.192665047538828,123,5.300000000000007E-4
9,test_20231101_134734,11079715.png,443815,125192,318623,0.7179185020785688,4,4,124136,17444,106692,0.8594767029709351,16.64877511111111,2039.7730453333334,15.034985123844537,123,5.300000000000007E-4
10,test_20231101_134734,11551286.png,271883,467,271416,0.9982823493929374,1,4,40092,67,40025,0.998328843659583,17.988837333333333,1870.894224,15.410311266718583,123,5.300000000000007E-4
1,test_20231101_134734,10404007.png,502730,23337,479393,0.9535794561693155,3,3,61265,3365,57900,0.9450746755896515,25.313722666666667,3325.6070666666665,12.912094265254296,123,5.400000000000008E-4
2,test_20231101_134734,1254659.png,342646,78012,264634,0.7723247900165185,3,4,80080,10856,69224,0.8644355644355645,20.528035555555554,3070.871712,13.258186870279811,123,5.400000000000008E-4
3,test_20231101_134734,10188041.png,221231,10082,211149,0.9544277248667682,2,4,41731,1420,40311,0.9659725384007093,10.853313777777778,1051.0199413333332,17.91469404755111,123,5.400000000000008E-4
4,test_20231101_134734,10287332.png,216980,12767,204213,0.9411604756198728,1,3,22337,1747,20590,0.921788960021489,9.436826666666667,775.4438453333333,19.235300075188995,123,5.400000000000008E-4
5,test_20231101_134734,11610969.png,368720,28152,340568,0.9236493816446084,2,4,84111,4106,80005,0.9511835550641414,20.388908444444443,2735.818362666667,13.759931006817341,123,5.400000000000008E-4
6,test_20231101_134734,10350842.png,212614,6467,206147,0.9695833764474587,2,3,42529,947,41582,0.9777328411201768,19.205194666666667,2350.2698026666667,14.419626402627658,123,5.400000000000008E-4
7,test_20231101_134734,10863862.png,317432,13197,304235,0.9584257415761486,2,4,66058,1907,64151,0.9711314299554936,23.723717333333333,3225.647888,13.044634028505238,123,5.400000000000008E-4
8,test_20231101_134734,11382381.png,312486,827,311659,0.9973534814359684,2,4,46745,109,46636,0.997668199807466,21.564144,2476.360432,14.192665047538828,123,5.400000000000008E-4
9,test_20231101_134734,11079715.png,443815,125192,318623,0.7179185020785688,4,4,124136,17444,106692,0.8594767029709351,16.64877511111111,2039.7730453333334,15.034985123844537,123,5.400000000000008E-4
10,test_20231101_134734,11551286.png,271883,467,271416,0.9982823493929374,1,3,40092,67,40025,0.998328843659583,17.988837333333333,1870.894224,15.410311266718583,123,5.400000000000008E-4
1,test_20231101_134735,10404007.png,502730,23337,479393,0.9535794561693155,3,4,61265,3365,57900,0.9450746755896515,25.313722666666667,3325.6070666666665,12.912094265254296,123,5.500000000000008E-4
2,test_20231101_134735,1254659.png,342646,78012,264634,0.7723247900165185,3,3,80080,10856,69224,0.8644355644355645,20.528035555555554,3070.871712,13.258186870279811,123,5.500000000000008E-4
3,test_20231101_134735,10188041.png,221231,10082,211149,0.9544277248667682,2,4,41731,1420,40311,0.9659725384007093,10.853313777777778,1051.0199413333332,17.91469404755111,123,5.500000000000008E-4
4,test_20231101_134735,10287332.png,216980,12767,204213,0.9411604756198728,2,4,22337,1747,20590,0.921788960021489,9.436826666666667,775.4438453333333,19.235300075188995,123,5.500000000000008E-4
5,test_20231101_134735,11610969.png,368720,28152,340568,0.9236493816446084,2,4,84111,4106,80005,0.9511835550641414,20.388908444444443,2735.818362666667,13.759931006817341,123,5.500000000000008E-4
6,test_20231101_134735,10350842.png,212614,6467,206147,0.9695833764474587,2,4,42529,947,41582,0.9777328411201768,19.205194666666667,2350.2698026666667,14.419626402627658,123,5.500000000000008E-4
7,test_20231101_134735,10863862.png,317432,13197,304235,0.9584257415761486,2,4,66058,1907,64151,0.9711314299554936,23.723717333333333,3225.647888,13.044634028505238,123,5.500000000000008E-4
8,test_20231101_134735,11382381.png,312486,827,311659,0.9973534814359684,1,3,46745,109,46636,0.997668199807466,21.564144,2476.360432,14.192665047538828,123,5.500000000000008E-4
9,test_20231101_134735,11079715.png,443815,125192,318623,0.7179185020785688,4,4,124136,17444,106692,0.8594767029709351,16.64877511111111,2039.7730453333334,15.034985123844537,123,5.500000000000008E-4
10,test_20231101_134735,11551286.png,271883,467,271416,0.9982823493929374,1,3,40092,67,40025,0.998328843659583,17.988837333333333,1870.894224,15.410311266718583,123,5.500000000000008E-4
1,test_20231101_134736,10404007.png,502730,23337,479393,0.9535794561693155,2,3,61265,3365,57900,0.9450746755896515,25.313722666666667,3325.6070666666665,12.912094265254296,123,5.600000000000008E-4
2,test_20231101_134736,1254659.png,342646,78012,264634,0.7723247900165185,2,4,80080,10856,69224,0.8644355644355645,20.528035555555554,3070.871712,13.258186870279811,123,5.600000000000008E-4
3,test_20231101_134736,10188041.png,221231,10082,211149,0.9544277248667682,2,3,41731,1420,40311,0.9659725384007093,10.853313777777778,1051.0199413333332,17.91469404755111,123,5.600000000000008E-4
4,test_20231101_134736,10287332.png,216980,12767,204213,0.9411604756198728,2,4,22337,1747,20590,0.921788960021489,9.436826666666667,775.4438453333333,19.235300075188995,123,5.600000000000008E-4
5,test_20231101_134736,11610969.png,368720,28152,340568,0.9236493816446084,3,4,84111,4106,80005,0.9511835550641414,20.388908444444443,2735.818362666667,13.759931006817341,123,5.600000000000008E-4
6,test_20231101_134736,10350842.png,212614,6467,206147,0.9695833764474587,1,3,42529,947,41582,0.9777328411201768,19.205194666666667,2350.2698026666667,14.419626402627658,123,5.600000000000008E-4
7,test_20231101_134736,10863862.png,317432,13197,304235,0.9584257415761486,2,3,66058,1907,64151,0.9711314299554936,23.723717333333333,3225.647888,13.044634028505238,123,5.600000000000008E-4
8,test_20231101_134736,11382381.png,312486,827,311659,0.9973534814359684,2,4,46745,109,46636,0.997668199807466,21.564144,2476.360432,14.192665047538828,123,5.600000000000008E-4
9,test_20231101_134736,11079715.png,443815,125192,318623,0.7179185020785688,3,4,124136,17444,106692,0.8594767029709351,16.64877511111111,2039.7730453333334,15.034985123844537,123,5.600000000000008E-4
10,test_20231101_134736,11551286.png,271883,467,271416,0.9982823493929374,1,4,40092,67,40025,0.998328843659583,17.988837333333333,1870.894224,15.410311266718583,123,5.600000000000008E-4
1,test_20231101_134736,10404007.png,502730,23337,479393,0.9535794561693155,2,4,61265,3365,57900,0.9450746755896515,25.313722666666667,3325.6070666666665,12.912094265254296,123,5.700000000000008E-4
2,test_20231101_134736,1254659.png,342646,78012,264634,0.7723247900165185,3,4,80080,10856,69224,0.8644355644355645,20.528035555555554,3070.871712,13.258186870279811,123,5.700000000000008E-4
3,test_20231101_134736,10188041.png,221231,10082,211149,0.9544277248667682,2,3,41731,1420,40311,0.9659725384007093,10.853313777777778,1051.0199413333332,17.91469404755111,123,5.700000000000008E-4
4,test_20231101_134736,10287332.png,216980,12767,204213,0.9411604756198728,1,4,22337,1747,20590,0.921788960021489,9.436826666666667,775.4438453333333,19.235300075188995,123,5.700000000000008E-4
5,test_20231101_134736,11610969.png,368720,28152,340568,0.9236493816446084,3,4,84111,4106,80005,0.9511835550641414,20.388908444444443,2735.818362666667,13.759931006817341,123,5.700000000000008E-4
6,test_20231101_134736,10350842.png,212614,6467,206147,0.9695833764474587,1,4,42529,947,41582,0.9777328411201768,19.205194666666667,2350.2698026666667,14.419626402627658,123,5.700000000000008E-4
7,test_20231101_134736,10863862.png,317432,13197,304235,0.9584257415761486,2,4,66058,1907,64151,0.9711314299554936,23.723717333333333,3225.647888,13.044634028505238,123,5.700000000000008E-4
8,test_20231101_134736,11382381.png,312486,827,311659,0.9973534814359684,2,3,46745,109,46636,0.997668199807466,21.564144,2476.360432,14.192665047538828,123,5.700000000000008E-4
9,test_20231101_134736,11079715.png,443815,125192,318623,0.7179185020785688,3,5,124136,17444,106692,0.8594767029709351,16.64877511111111,2039.7730453333334,15.034985123844537,123,5.700000000000008E-4
10,test_20231101_134736,11551286.png,271883,467,271416,0.9982823493929374,2,4,40092,67,40025,0.998328843659583,17.988837333333333,1870.894224,15.410311266718583,123,5.700000000000008E-4
1,test_20231101_134737,10404007.png,502730,23337,479393,0.9535794561693155,3,3,61265,3365,57900,0.9450746755896515,25.313722666666667,3325.6070666666665,12.912094265254296,123,5.800000000000009E-4
2,test_20231101_134737,1254659.png,342646,78012,264634,0.7723247900165185,3,4,80080,10856,69224,0.8644355644355645,20.528035555555554,3070.871712,13.258186870279811,123,5.800000000000009E-4
3,test_20231101_134737,10188041.png,221231,10082,211149,0.9544277248667682,2,4,41731,1420,40311,0.9659725384007093,10.853313777777778,1051.0199413333332,17.91469404755111,123,5.800000000000009E-4
4,test_20231101_134737,10287332.png,216980,12767,204213,0.9411604756198728,2,4,22337,1747,20590,0.921788960021489,9.436826666666667,775.4438453333333,19.235300075188995,123,5.800000000000009E-4
5,test_20231101_134737,11610969.png,368720,28152,340568,0.9236493816446084,2,3,84111,4106,80005,0.9511835550641414,20.388908444444443,2735.818362666667,13.759931006817341,123,5.800000000000009E-4
6,test_20231101_134737,10350842.png,212614,6467,206147,0.9695833764474587,2,4,42529,947,41582,0.9777328411201768,19.205194666666667,2350.2698026666667,14.419626402627658,123,5.800000000000009E-4
7,test_20231101_134737,10863862.png,317432,13197,304235,0.9584257415761486,2,3,66058,1907,64151,0.9711314299554936,23.723717333333333,3225.647888,13.044634028505238,123,5.800000000000009E-4
8,test_20231101_134737,11382381.png,312486,827,311659,0.9973534814359684,2,3,46745,109,46636,0.997668199807466,21.564144,2476.360432,14.192665047538828,123,5.800000000000009E-4
9,test_20231101_134737,11079715.png,443815,125192,318623,0.7179185020785688,3,5,124136,17444,106692,0.8594767029709351,16.64877511111111,2039.7730453333334,15.034985123844537,123,5.800000000000009E-4
10,test_20231101_134737,11551286.png,271883,467,271416,0.9982823493929374,1,4,40092,67,40025,0.998328843659583,17.988837333333333,1870.894224,15.410311266718583,123,5.800000000000009E-4
1,test_20231101_134738,10404007.png,502730,23337,479393,0.9535794561693155,2,4,61265,3365,57900,0.9450746755896515,25.313722666666667,3325.6070666666665,12.912094265254296,123,5.900000000000009E-4
2,test_20231101_134738,1254659.png,342646,78012,264634,0.7723247900165185,3,4,80080,10856,69224,0.8644355644355645,20.528035555555554,3070.871712,13.258186870279811,123,5.900000000000009E-4
3,test_20231101_134738,10188041.png,221231,10082,211149,0.9544277248667682,2,3,41731,1420,40311,0.9659725384007093,10.853313777777778,1051.0199413333332,17.91469404755111,123,5.900000000000009E-4
4,test_20231101_134738,10287332.png,216980,12767,204213,0.9411604756198728,2,4,22337,1747,20590,0.921788960021489,9.436826666666667,775.4438453333333,19.235300075188995,123,5.900000000000009E-4
5,test_20231101_134738,11610969.png,368720,28152,340568,0.9236493816446084,2,3,84111,4106,80005,0.9511835550641414,20.388908444444443,2735.818362666667,13.759931006817341,123,5.900000000000009E-4
6,test_20231101_134738,10350842.png,212614,6467,206147,0.9695833764474587,2,4,42529,947,41582,0.9777328411201768,19.205194666666667,2350.2698026666667,14.419626402627658,123,5.900000000000009E-4
7,test_20231101_134738,10863862.png,317432,13197,304235,0.9584257415761486,2,3,66058,1907,64151,0.9711314299554936,23.723717333333333,3225.647888,13.044634028505238,123,5.900000000000009E-4
8,test_20231101_134738,11382381.png,312486,827,311659,0.9973534814359684,1,4,46745,109,46636,0.997668199807466,21.564144,2476.360432,14.192665047538828,123,5.900000000000009E-4
9,test_20231101_134738,11079715.png,443815,125192,318623,0.7179185020785688,3,4,124136,17444,106692,0.8594767029709351,16.64877511111111,2039.7730453333334,15.034985123844537,123,5.900000000000009E-4
10,test_20231101_134738,11551286.png,271883,467,271416,0.9982823493929374,1,4,40092,67,40025,0.998328843659583,17.988837333333333,1870.894224,15.410311266718583,123,5.900000000000009E-4
1,test_20231101_134738,10404007.png,502730,23337,479393,0.9535794561693155,2,3,61265,3365,57900,0.9450746755896515,25.313722666666667,3325.6070666666665,12.912094265254296,123,6.000000000000009E-4
2,test_20231101_134738,1254659.png,342646,78012,264634,0.7723247900165185,3,4,80080,10856,69224,0.8644355644355645,20.528035555555554,3070.871712,13.258186870279811,123,6.000000000000009E-4
3,test_20231101_134738,10188041.png,221231,10082,211149,0.9544277248667682,2,3,41731,1420,40311,0.9659725384007093,10.853313777777778,1051.0199413333332,17.91469404755111,123,6.000000000000009E-4
4,test_20231101_134738,10287332.png,216980,12767,204213,0.9411604756198728,1,3,22337,1747,20590,0.921788960021489,9.436826666666667,775.4438453333333,19.235300075188995,123,6.000000000000009E-4
5,test_20231101_134738,11610969.png,368720,28152,340568,0.9236493816446084,3,4,84111,4106,80005,0.9511835550641414,20.388908444444443,2735.818362666667,13.759931006817341,123,6.000000000000009E-4
6,test_20231101_134738,10350842.png,212614,6467,206147,0.9695833764474587,1,4,42529,947,41582,0.9777328411201768,19.205194666666667,2350.2698026666667,14.419626402627658,123,6.000000000000009E-4
7,test_20231101_134738,10863862.png,317432,13197,304235,0.9584257415761486,1,3,66058,1907,64151,0.9711314299554936,23.723717333333333,3225.647888,13.044634028505238,123,6.000000000000009E-4
8,test_20231101_134738,11382381.png,312486,827,311659,0.9973534814359684,2,4,46745,109,46636,0.997668199807466,21.564144,2476.360432,14.192665047538828,123,6.000000000000009E-4
9,test_20231101_134738,11079715.png,443815,125192,318623,0.7179185020785688,4,5,124136,17444,106692,0.8594767029709351,16.64877511111111,2039.7730453333334,15.034985123844537,123,6.000000000000009E-4
10,test_20231101_134738,11551286.png,271883,467,271416,0.9982823493929374,1,3,40092,67,40025,0.998328843659583,17.988837333333333,1870.894224,15.410311266718583,123,6.000000000000009E-4
1,test_20231101_134739,10404007.png,502730,23337,479393,0.9535794561693155,2,4,61265,3365,57900,0.9450746755896515,25.313722666666667,3325.6070666666665,12.912094265254296,123,6.10000000000001E-4
2,test_20231101_134739,1254659.png,342646,78012,264634,0.7723247900165185,3,4,80080,10856,69224,0.8644355644355645,20.528035555555554,3070.871712,13.258186870279811,123,6.10000000000001E-4
3,test_20231101_134739,10188041.png,221231,10082,211149,0.9544277248667682,2,4,41731,1420,40311,0.9659725384007093,10.853313777777778,1051.0199413333332,17.91469404755111,123,6.10000000000001E-4
4,test_20231101_134739,10287332.png,216980,12767,204213,0.9411604756198728,2,4,22337,1747,20590,0.921788960021489,9.436826666666667,775.4438453333333,19.235300075188995,123,6.10000000000001E-4
5,test_20231101_134739,11610969.png,368720,28152,340568,0.9236493816446084,3,3,84111,4106,80005,0.9511835550641414,20.388908444444443,2735.818362666667,13.759931006817341,123,6.10000000000001E-4
6,test_20231101_134739,10350842.png,212614,6467,206147,0.9695833764474587,2,4,42529,947,41582,0.9777328411201768,19.205194666666667,2350.2698026666667,14.419626402627658,123,6.10000000000001E-4
7,test_20231101_134739,10863862.png,317432,13197,304235,0.9584257415761486,2,4,66058,1907,64151,0.9711314299554936,23.723717333333333,3225.647888,13.044634028505238,123,6.10000000000001E-4
8,test_20231101_134739,11382381.png,312486,827,311659,0.9973534814359684,2,4,46745,109,46636,0.997668199807466,21.564144,2476.360432,14.192665047538828,123,6.10000000000001E-4
9,test_20231101_134739,11079715.png,443815,125192,318623,0.7179185020785688,3,4,124136,17444,106692,0.8594767029709351,16.64877511111111,2039.7730453333334,15.034985123844537,123,6.10000000000001E-4
10,test_20231101_134739,11551286.png,271883,467,271416,0.9982823493929374,1,4,40092,67,40025,0.998328843659583,17.988837333333333,1870.894224,15.410311266718583,123,6.10000000000001E-4
1,test_20231101_134740,10404007.png,502730,23337,479393,0.9535794561693155,3,4,61265,3365,57900,0.9450746755896515,25.313722666666667,3325.6070666666665,12.912094265254296,123,6.20000000000001E-4
2,test_20231101_134740,1254659.png,342646,78012,264634,0.7723247900165185,3,4,80080,10856,69224,0.8644355644355645,20.528035555555554,3070.871712,13.258186870279811,123,6.20000000000001E-4
3,test_20231101_134740,10188041.png,221231,10082,211149,0.9544277248667682,1,3,41731,1420,40311,0.9659725384007093,10.853313777777778,1051.0199413333332,17.91469404755111,123,6.20000000000001E-4
4,test_20231101_134740,10287332.png,216980,12767,204213,0.9411604756198728,1,3,22337,1747,20590,0.921788960021489,9.436826666666667,775.4438453333333,19.235300075188995,123,6.20000000000001E-4
5,test_20231101_134740,11610969.png,368720,28152,340568,0.9236493816446084,3,4,84111,4106,80005,0.9511835550641414,20.388908444444443,2735.818362666667,13.759931006817341,123,6.20000000000001E-4
6,test_20231101_134740,10350842.png,212614,6467,206147,0.9695833764474587,2,3,42529,947,41582,0.9777328411201768,19.205194666666667,2350.2698026666667,14.419626402627658,123,6.20000000000001E-4
7,test_20231101_134740,10863862.png,317432,13197,304235,0.9584257415761486,2,3,66058,1907,64151,0.9711314299554936,23.723717333333333,3225.647888,13.044634028505238,123,6.20000000000001E-4
8,test_20231101_134740,11382381.png,312486,827,311659,0.9973534814359684,1,4,46745,109,46636,0.997668199807466,21.564144,2476.360432,14.192665047538828,123,6.20000000000001E-4
9,test_20231101_134740,11079715.png,443815,125192,318623,0.7179185020785688,4,4,124136,17444,106692,0.8594767029709351,16.64877511111111,2039.7730453333334,15.034985123844537,123,6.20000000000001E-4
10,test_20231101_134740,11551286.png,271883,467,271416,0.9982823493929374,2,9,40092,67,40025,0.998328843659583,17.988837333333333,1870.894224,15.410311266718583,123,6.20000000000001E-4
1,test_20231101_134740,10404007.png,502730,23337,479393,0.9535794561693155,3,3,61265,3365,57900,0.9450746755896515,25.313722666666667,3325.6070666666665,12.912094265254296,123,6.30000000000001E-4
2,test_20231101_134740,1254659.png,342646,78012,264634,0.7723247900165185,3,4,80080,10856,69224,0.8644355644355645,20.528035555555554,3070.871712,13.258186870279811,123,6.30000000000001E-4
3,test_20231101_134740,10188041.png,221231,10082,211149,0.9544277248667682,3,4,41731,1420,40311,0.9659725384007093,10.853313777777778,1051.0199413333332,17.91469404755111,123,6.30000000000001E-4
4,test_20231101_134740,10287332.png,216980,12767,204213,0.9411604756198728,2,4,22337,1747,20590,0.921788960021489,9.436826666666667,775.4438453333333,19.235300075188995,123,6.30000000000001E-4
5,test_20231101_134740,11610969.png,368720,28152,340568,0.9236493816446084,3,4,84111,4106,80005,0.9511835550641414,20.388908444444443,2735.818362666667,13.759931006817341,123,6.30000000000001E-4
6,test_20231101_134740,10350842.png,212614,6467,206147,0.9695833764474587,1,4,42529,947,41582,0.9777328411201768,19.205194666666667,2350.2698026666667,14.419626402627658,123,6.30000000000001E-4
7,test_20231101_134740,10863862.png,317432,13197,304235,0.9584257415761486,2,4,66058,1907,64151,0.9711314299554936,23.723717333333333,3225.647888,13.044634028505238,123,6.30000000000001E-4
8,test_20231101_134740,11382381.png,312486,827,311659,0.9973534814359684,1,3,46745,109,46636,0.997668199807466,21.564144,2476.360432,14.192665047538828,123,6.30000000000001E-4
9,test_20231101_134740,11079715.png,443815,125192,318623,0.7179185020785688,3,5,124136,17444,106692,0.8594767029709351,16.64877511111111,2039.7730453333334,15.034985123844537,123,6.30000000000001E-4
10,test_20231101_134740,11551286.png,271883,467,271416,0.9982823493929374,1,4,40092,67,40025,0.998328843659583,17.988837333333333,1870.894224,15.410311266718583,123,6.30000000000001E-4
1,test_20231101_134741,10404007.png,502730,23337,479393,0.9535794561693155,2,4,61265,3365,57900,0.9450746755896515,25.313722666666667,3325.6070666666665,12.912094265254296,123,6.40000000000001E-4
2,test_20231101_134741,1254659.png,342646,78012,264634,0.7723247900165185,3,4,80080,10856,69224,0.8644355644355645,20.528035555555554,3070.871712,13.258186870279811,123,6.40000000000001E-4
3,test_20231101_134741,10188041.png,221231,10082,211149,0.9544277248667682,2,3,41731,1420,40311,0.9659725384007093,10.853313777777778,1051.0199413333332,17.91469404755111,123,6.40000000000001E-4
4,test_20231101_134741,10287332.png,216980,12767,204213,0.9411604756198728,2,3,22337,1747,20590,0.921788960021489,9.436826666666667,775.4438453333333,19.235300075188995,123,6.40000000000001E-4
5,test_20231101_134741,11610969.png,368720,28152,340568,0.9236493816446084,2,4,84111,4106,80005,0.9511835550641414,20.388908444444443,2735.818362666667,13.759931006817341,123,6.40000000000001E-4
6,test_20231101_134741,10350842.png,212614,6467,206147,0.9695833764474587,1,3,42529,947,41582,0.9777328411201768,19.205194666666667,2350.2698026666667,14.419626402627658,123,6.40000000000001E-4
7,test_20231101_134741,10863862.png,317432,13197,304235,0.9584257415761486,2,4,66058,1907,64151,0.9711314299554936,23.723717333333333,3225.647888,13.044634028505238,123,6.40000000000001E-4
8,test_20231101_134741,11382381.png,312486,827,311659,0.9973534814359684,1,4,46745,109,46636,0.997668199807466,21.564144,2476.360432,14.192665047538828,123,6.40000000000001E-4
9,test_20231101_134741,11079715.png,443815,125192,318623,0.7179185020785688,3,4,124136,17444,106692,0.8594767029709351,16.64877511111111,2039.7730453333334,15.034985123844537,123,6.40000000000001E-4
10,test_20231101_134741,11551286.png,271883,467,271416,0.9982823493929374,1,7,40092,67,40025,0.998328843659583,17.988837333333333,1870.894224,15.410311266718583,123,6.40000000000001E-4
1,test_20231101_134742,10404007.png,502730,23337,479393,0.9535794561693155,2,3,61265,3365,57900,0.9450746755896515,25.313722666666667,3325.6070666666665,12.912094265254296,123,6.500000000000011E-4
2,test_20231101_134742,1254659.png,342646,78012,264634,0.7723247900165185,3,4,80080,10856,69224,0.8644355644355645,20.528035555555554,3070.871712,13.258186870279811,123,6.500000000000011E-4
3,test_20231101_134742,10188041.png,221231,10082,211149,0.9544277248667682,2,4,41731,1420,40311,0.9659725384007093,10.853313777777778,1051.0199413333332,17.91469404755111,123,6.500000000000011E-4
4,test_20231101_134742,10287332.png,216980,12767,204213,0.9411604756198728,2,3,22337,1747,20590,0.921788960021489,9.436826666666667,775.4438453333333,19.235300075188995,123,6.500000000000011E-4
5,test_20231101_134742,11610969.png,368720,28152,340568,0.9236493816446084,2,4,84111,4106,80005,0.9511835550641414,20.388908444444443,2735.818362666667,13.759931006817341,123,6.500000000000011E-4
6,test_20231101_134742,10350842.png,212614,6467,206147,0.9695833764474587,1,4,42529,947,41582,0.9777328411201768,19.205194666666667,2350.2698026666667,14.419626402627658,123,6.500000000000011E-4
7,test_20231101_134742,10863862.png,317432,13197,304235,0.9584257415761486,3,4,66058,1907,64151,0.9711314299554936,23.723717333333333,3225.647888,13.044634028505238,123,6.500000000000011E-4
8,test_20231101_134742,11382381.png,312486,827,311659,0.9973534814359684,1,4,46745,109,46636,0.997668199807466,21.564144,2476.360432,14.192665047538828,123,6.500000000000011E-4
9,test_20231101_134742,11079715.png,443815,125192,318623,0.7179185020785688,3,4,124136,17444,106692,0.8594767029709351,16.64877511111111,2039.7730453333334,15.034985123844537,123,6.500000000000011E-4
10,test_20231101_134742,11551286.png,271883,467,271416,0.9982823493929374,1,3,40092,67,40025,0.998328843659583,17.988837333333333,1870.894224,15.410311266718583,123,6.500000000000011E-4
1,test_20231101_134742,10404007.png,502730,23337,479393,0.9535794561693155,2,3,61265,3365,57900,0.9450746755896515,25.313722666666667,3325.6070666666665,12.912094265254296,123,6.600000000000011E-4
2,test_20231101_134742,1254659.png,342646,78012,264634,0.7723247900165185,3,4,80080,10856,69224,0.8644355644355645,20.528035555555554,3070.871712,13.258186870279811,123,6.600000000000011E-4
3,test_20231101_134742,10188041.png,221231,10082,211149,0.9544277248667682,2,4,41731,1420,40311,0.9659725384007093,10.853313777777778,1051.0199413333332,17.91469404755111,123,6.600000000000011E-4
4,test_20231101_134742,10287332.png,216980,12767,204213,0.9411604756198728,2,4,22337,1747,20590,0.921788960021489,9.436826666666667,775.4438453333333,19.235300075188995,123,6.600000000000011E-4
5,test_20231101_134742,11610969.png,368720,28152,340568,0.9236493816446084,2,4,84111,4106,80005,0.9511835550641414,20.388908444444443,2735.818362666667,13.759931006817341,123,6.600000000000011E-4
6,test_20231101_134742,10350842.png,212614,6467,206147,0.9695833764474587,2,4,42529,947,41582,0.9777328411201768,19.205194666666667,2350.2698026666667,14.419626402627658,123,6.600000000000011E-4
7,test_20231101_134742,10863862.png,317432,13197,304235,0.9584257415761486,2,4,66058,1907,64151,0.9711314299554936,23.723717333333333,3225.647888,13.044634028505238,123,6.600000000000011E-4
8,test_20231101_134742,11382381.png,312486,827,311659,0.9973534814359684,1,4,46745,109,46636,0.997668199807466,21.564144,2476.360432,14.192665047538828,123,6.600000000000011E-4
9,test_20231101_134742,11079715.png,443815,125192,318623,0.7179185020785688,3,4,124136,17444,106692,0.8594767029709351,16.64877511111111,2039.7730453333334,15.034985123844537,123,6.600000000000011E-4
10,test_20231101_134742,11551286.png,271883,467,271416,0.9982823493929374,1,3,40092,67,40025,0.998328843659583,17.988837333333333,1870.894224,15.410311266718583,123,6.600000000000011E-4
1,test_20231101_134743,10404007.png,502730,23337,479393,0.9535794561693155,2,4,61265,3365,57900,0.9450746755896515,25.313722666666667,3325.6070666666665,12.912094265254296,123,6.700000000000011E-4
2,test_20231101_134743,1254659.png,342646,78012,264634,0.7723247900165185,3,5,80080,10856,69224,0.8644355644355645,20.528035555555554,3070.871712,13.258186870279811,123,6.700000000000011E-4
3,test_20231101_134743,10188041.png,221231,10082,211149,0.9544277248667682,2,3,41731,1420,40311,0.9659725384007093,10.853313777777778,1051.0199413333332,17.91469404755111,123,6.700000000000011E-4
4,test_20231101_134743,10287332.png,216980,12767,204213,0.9411604756198728,2,3,22337,1747,20590,0.921788960021489,9.436826666666667,775.4438453333333,19.235300075188995,123,6.700000000000011E-4
5,test_20231101_134743,11610969.png,368720,28152,340568,0.9236493816446084,3,4,84111,4106,80005,0.9511835550641414,20.388908444444443,2735.818362666667,13.759931006817341,123,6.700000000000011E-4
6,test_20231101_134743,10350842.png,212614,6467,206147,0.9695833764474587,1,4,42529,947,41582,0.9777328411201768,19.205194666666667,2350.2698026666667,14.419626402627658,123,6.700000000000011E-4
7,test_20231101_134743,10863862.png,317432,13197,304235,0.9584257415761486,2,4,66058,1907,64151,0.9711314299554936,23.723717333333333,3225.647888,13.044634028505238,123,6.700000000000011E-4
8,test_20231101_134743,11382381.png,312486,827,311659,0.9973534814359684,2,4,46745,109,46636,0.997668199807466,21.564144,2476.360432,14.192665047538828,123,6.700000000000011E-4
9,test_20231101_134743,11079715.png,443815,125192,318623,0.7179185020785688,3,4,124136,17444,106692,0.8594767029709351,16.64877511111111,2039.7730453333334,15.034985123844537,123,6.700000000000011E-4
10,test_20231101_134743,11551286.png,271883,467,271416,0.9982823493929374,1,3,40092,67,40025,0.998328843659583,17.988837333333333,1870.894224,15.410311266718583,123,6.700000000000011E-4
1,test_20231101_134744,10404007.png,502730,23337,479393,0.9535794561693155,2,4,61265,3365,57900,0.9450746755896515,25.313722666666667,3325.6070666666665,12.912094265254296,123,6.800000000000011E-4
2,test_20231101_134744,1254659.png,342646,78012,264634,0.7723247900165185,3,4,80080,10856,69224,0.8644355644355645,20.528035555555554,3070.871712,13.258186870279811,123,6.800000000000011E-4
3,test_20231101_134744,10188041.png,221231,10082,211149,0.9544277248667682,2,4,41731,1420,40311,0.9659725384007093,10.853313777777778,1051.0199413333332,17.91469404755111,123,6.800000000000011E-4
4,test_20231101_134744,10287332.png,216980,12767,204213,0.9411604756198728,2,4,22337,1747,20590,0.921788960021489,9.436826666666667,775.4438453333333,19.235300075188995,123,6.800000000000011E-4
5,test_20231101_134744,11610969.png,368720,28152,340568,0.9236493816446084,3,3,84111,4106,80005,0.9511835550641414,20.388908444444443,2735.818362666667,13.759931006817341,123,6.800000000000011E-4
6,test_20231101_134744,10350842.png,212614,6467,206147,0.9695833764474587,2,4,42529,947,41582,0.9777328411201768,19.205194666666667,2350.2698026666667,14.419626402627658,123,6.800000000000011E-4
7,test_20231101_134744,10863862.png,317432,13197,304235,0.9584257415761486,4,4,66058,1907,64151,0.9711314299554936,23.723717333333333,3225.647888,13.044634028505238,123,6.800000000000011E-4
8,test_20231101_134744,11382381.png,312486,827,311659,0.9973534814359684,1,3,46745,109,46636,0.997668199807466,21.564144,2476.360432,14.192665047538828,123,6.800000000000011E-4
9,test_20231101_134744,11079715.png,443815,125192,318623,0.7179185020785688,4,4,124136,17444,106692,0.8594767029709351,16.64877511111111,2039.7730453333334,15.034985123844537,123,6.800000000000011E-4
10,test_20231101_134744,11551286.png,271883,467,271416,0.9982823493929374,1,3,40092,67,40025,0.998328843659583,17.988837333333333,1870.894224,15.410311266718583,123,6.800000000000011E-4
1,test_20231101_134745,10404007.png,502730,23337,479393,0.9535794561693155,2,4,61265,3365,57900,0.9450746755896515,25.313722666666667,3325.6070666666665,12.912094265254296,123,6.900000000000012E-4
2,test_20231101_134745,1254659.png,342646,78012,264634,0.7723247900165185,3,4,80080,10856,69224,0.8644355644355645,20.528035555555554,3070.871712,13.258186870279811,123,6.900000000000012E-4
3,test_20231101_134745,10188041.png,221231,10082,211149,0.9544277248667682,2,3,41731,1420,40311,0.9659725384007093,10.853313777777778,1051.0199413333332,17.91469404755111,123,6.900000000000012E-4
4,test_20231101_134745,10287332.png,216980,12767,204213,0.9411604756198728,2,4,22337,1747,20590,0.921788960021489,9.436826666666667,775.4438453333333,19.235300075188995,123,6.900000000000012E-4
5,test_20231101_134745,11610969.png,368720,28152,340568,0.9236493816446084,2,4,84111,4106,80005,0.9511835550641414,20.388908444444443,2735.818362666667,13.759931006817341,123,6.900000000000012E-4
6,test_20231101_134745,10350842.png,212614,6467,206147,0.9695833764474587,2,3,42529,947,41582,0.9777328411201768,19.205194666666667,2350.2698026666667,14.419626402627658,123,6.900000000000012E-4
7,test_20231101_134745,10863862.png,317432,13197,304235,0.9584257415761486,2,4,66058,1907,64151,0.9711314299554936,23.723717333333333,3225.647888,13.044634028505238,123,6.900000000000012E-4
8,test_20231101_134745,11382381.png,312486,827,311659,0.9973534814359684,1,3,46745,109,46636,0.997668199807466,21.564144,2476.360432,14.192665047538828,123,6.900000000000012E-4
9,test_20231101_134745,11079715.png,443815,125192,318623,0.7179185020785688,4,4,124136,17444,106692,0.8594767029709351,16.64877511111111,2039.7730453333334,15.034985123844537,123,6.900000000000012E-4
10,test_20231101_134745,11551286.png,271883,467,271416,0.9982823493929374,1,3,40092,67,40025,0.998328843659583,17.988837333333333,1870.894224,15.410311266718583,123,6.900000000000012E-4
1,test_20231101_134745,10404007.png,502730,23337,479393,0.9535794561693155,2,3,61265,3365,57900,0.9450746755896515,25.313722666666667,3325.6070666666665,12.912094265254296,123,7.000000000000012E-4
2,test_20231101_134745,1254659.png,342646,78012,264634,0.7723247900165185,4,4,80080,10856,69224,0.8644355644355645,20.528035555555554,3070.871712,13.258186870279811,123,7.000000000000012E-4
3,test_20231101_134745,10188041.png,221231,10082,211149,0.9544277248667682,2,4,41731,1420,40311,0.9659725384007093,10.853313777777778,1051.0199413333332,17.91469404755111,123,7.000000000000012E-4
4,test_20231101_134745,10287332.png,216980,12767,204213,0.9411604756198728,2,4,22337,1747,20590,0.921788960021489,9.436826666666667,775.4438453333333,19.235300075188995,123,7.000000000000012E-4
5,test_20231101_134745,11610969.png,368720,28152,340568,0.9236493816446084,2,4,84111,4106,80005,0.9511835550641414,20.388908444444443,2735.818362666667,13.759931006817341,123,7.000000000000012E-4
6,test_20231101_134745,10350842.png,212614,6467,206147,0.9695833764474587,1,4,42529,947,41582,0.9777328411201768,19.205194666666667,2350.2698026666667,14.419626402627658,123,7.000000000000012E-4
7,test_20231101_134745,10863862.png,317432,13197,304235,0.9584257415761486,2,4,66058,1907,64151,0.9711314299554936,23.723717333333333,3225.647888,13.044634028505238,123,7.000000000000012E-4
8,test_20231101_134745,11382381.png,312486,827,311659,0.9973534814359684,1,4,46745,109,46636,0.997668199807466,21.564144,2476.360432,14.192665047538828,123,7.000000000000012E-4
9,test_20231101_134745,11079715.png,443815,125192,318623,0.7179185020785688,4,6,124136,17444,106692,0.8594767029709351,16.64877511111111,2039.7730453333334,15.034985123844537,123,7.000000000000012E-4
10,test_20231101_134745,11551286.png,271883,467,271416,0.9982823493929374,1,4,40092,67,40025,0.998328843659583,17.988837333333333,1870.894224,15.410311266718583,123,7.000000000000012E-4
1,test_20231101_134746,10404007.png,502730,23337,479393,0.9535794561693155,2,4,61265,3365,57900,0.9450746755896515,25.313722666666667,3325.6070666666665,12.912094265254296,123,7.100000000000012E-4
2,test_20231101_134746,1254659.png,342646,78012,264634,0.7723247900165185,3,4,80080,10856,69224,0.8644355644355645,20.528035555555554,3070.871712,13.258186870279811,123,7.100000000000012E-4
3,test_20231101_134746,10188041.png,221231,10082,211149,0.9544277248667682,2,9,41731,1420,40311,0.9659725384007093,10.853313777777778,1051.0199413333332,17.91469404755111,123,7.100000000000012E-4
4,test_20231101_134746,10287332.png,216980,12767,204213,0.9411604756198728,1,3,22337,1747,20590,0.921788960021489,9.436826666666667,775.4438453333333,19.235300075188995,123,7.100000000000012E-4
5,test_20231101_134746,11610969.png,368720,28152,340568,0.9236493816446084,3,3,84111,4106,80005,0.9511835550641414,20.388908444444443,2735.818362666667,13.759931006817341,123,7.100000000000012E-4
6,test_20231101_134746,10350842.png,212614,6467,206147,0.9695833764474587,2,4,42529,947,41582,0.9777328411201768,19.205194666666667,2350.2698026666667,14.419626402627658,123,7.100000000000012E-4
7,test_20231101_134746,10863862.png,317432,13197,304235,0.9584257415761486,2,3,66058,1907,64151,0.9711314299554936,23.723717333333333,3225.647888,13.044634028505238,123,7.100000000000012E-4
8,test_20231101_134746,11382381.png,312486,827,311659,0.9973534814359684,1,3,46745,109,46636,0.997668199807466,21.564144,2476.360432,14.192665047538828,123,7.100000000000012E-4
9,test_20231101_134746,11079715.png,443815,125192,318623,0.7179185020785688,3,5,124136,17444,106692,0.8594767029709351,16.64877511111111,2039.7730453333334,15.034985123844537,123,7.100000000000012E-4
10,test_20231101_134746,11551286.png,271883,467,271416,0.9982823493929374,1,4,40092,67,40025,0.998328843659583,17.988837333333333,1870.894224,15.410311266718583,123,7.100000000000012E-4
1,test_20231101_134747,10404007.png,502730,23337,479393,0.9535794561693155,2,4,61265,3365,57900,0.9450746755896515,25.313722666666667,3325.6070666666665,12.912094265254296,123,7.200000000000012E-4
2,test_20231101_134747,1254659.png,342646,78012,264634,0.7723247900165185,3,4,80080,10856,69224,0.8644355644355645,20.528035555555554,3070.871712,13.258186870279811,123,7.200000000000012E-4
3,test_20231101_134747,10188041.png,221231,10082,211149,0.9544277248667682,2,3,41731,1420,40311,0.9659725384007093,10.853313777777778,1051.0199413333332,17.91469404755111,123,7.200000000000012E-4
4,test_20231101_134747,10287332.png,216980,12767,204213,0.9411604756198728,1,5,22337,1747,20590,0.921788960021489,9.436826666666667,775.4438453333333,19.235300075188995,123,7.200000000000012E-4
5,test_20231101_134747,11610969.png,368720,28152,340568,0.9236493816446084,3,4,84111,4106,80005,0.9511835550641414,20.388908444444443,2735.818362666667,13.759931006817341,123,7.200000000000012E-4
6,test_20231101_134747,10350842.png,212614,6467,206147,0.9695833764474587,1,3,42529,947,41582,0.9777328411201768,19.205194666666667,2350.2698026666667,14.419626402627658,123,7.200000000000012E-4
7,test_20231101_134747,10863862.png,317432,13197,304235,0.9584257415761486,2,3,66058,1907,64151,0.9711314299554936,23.723717333333333,3225.647888,13.044634028505238,123,7.200000000000012E-4
8,test_20231101_134747,11382381.png,312486,827,311659,0.9973534814359684,1,3,46745,109,46636,0.997668199807466,21.564144,2476.360432,14.192665047538828,123,7.200000000000012E-4
9,test_20231101_134747,11079715.png,443815,125192,318623,0.7179185020785688,3,5,124136,17444,106692,0.8594767029709351,16.64877511111111,2039.7730453333334,15.034985123844537,123,7.200000000000012E-4
10,test_20231101_134747,11551286.png,271883,467,271416,0.9982823493929374,1,3,40092,67,40025,0.998328843659583,17.988837333333333,1870.894224,15.410311266718583,123,7.200000000000012E-4
1,test_20231101_134747,10404007.png,502730,23337,479393,0.9535794561693155,3,4,61265,3365,57900,0.9450746755896515,25.313722666666667,3325.6070666666665,12.912094265254296,123,7.300000000000013E-4
2,test_20231101_134747,1254659.png,342646,78012,264634,0.7723247900165185,3,4,80080,10856,69224,0.8644355644355645,20.528035555555554,3070.871712,13.258186870279811,123,7.300000000000013E-4
3,test_20231101_134747,10188041.png,221231,10082,211149,0.9544277248667682,2,3,41731,1420,40311,0.9659725384007093,10.853313777777778,1051.0199413333332,17.91469404755111,123,7.300000000000013E-4
4,test_20231101_134747,10287332.png,216980,12767,204213,0.9411604756198728,1,4,22337,1747,20590,0.921788960021489,9.436826666666667,775.4438453333333,19.235300075188995,123,7.300000000000013E-4
5,test_20231101_134747,11610969.png,368720,28152,340568,0.9236493816446084,2,4,84111,4106,80005,0.9511835550641414,20.388908444444443,2735.818362666667,13.759931006817341,123,7.300000000000013E-4
6,test_20231101_134747,10350842.png,212614,6467,206147,0.9695833764474587,2,3,42529,947,41582,0.9777328411201768,19.205194666666667,2350.2698026666667,14.419626402627658,123,7.300000000000013E-4
7,test_20231101_134747,10863862.png,317432,13197,304235,0.9584257415761486,2,4,66058,1907,64151,0.9711314299554936,23.723717333333333,3225.647888,13.044634028505238,123,7.300000000000013E-4
8,test_20231101_134747,11382381.png,312486,827,311659,0.9973534814359684,1,4,46745,109,46636,0.997668199807466,21.564144,2476.360432,14.192665047538828,123,7.300000000000013E-4
9,test_20231101_134747,11079715.png,443815,125192,318623,0.7179185020785688,4,12,124136,17444,106692,0.8594767029709351,16.64877511111111,2039.7730453333334,15.034985123844537,123,7.300000000000013E-4
10,test_20231101_134747,11551286.png,271883,467,271416,0.9982823493929374,1,4,40092,67,40025,0.998328843659583,17.988837333333333,1870.894224,15.410311266718583,123,7.300000000000013E-4
1,test_20231101_134748,10404007.png,502730,23337,479393,0.9535794561693155,3,4,61265,3365,57900,0.9450746755896515,25.313722666666667,3325.6070666666665,12.912094265254296,123,7.400000000000013E-4
2,test_20231101_134748,1254659.png,342646,78012,264634,0.7723247900165185,3,4,80080,10856,69224,0.8644355644355645,20.528035555555554,3070.871712,13.258186870279811,123,7.400000000000013E-4
3,test_20231101_134748,10188041.png,221231,10082,211149,0.9544277248667682,2,4,41731,1420,40311,0.9659725384007093,10.853313777777778,1051.0199413333332,17.91469404755111,123,7.400000000000013E-4
4,test_20231101_134748,10287332.png,216980,12767,204213,0.9411604756198728,2,4,22337,1747,20590,0.921788960021489,9.436826666666667,775.4438453333333,19.235300075188995,123,7.400000000000013E-4
5,test_20231101_134748,11610969.png,368720,28152,340568,0.9236493816446084,3,4,84111,4106,80005,0.9511835550641414,20.388908444444443,2735.818362666667,13.759931006817341,123,7.400000000000013E-4
6,test_20231101_134748,10350842.png,212614,6467,206147,0.9695833764474587,1,4,42529,947,41582,0.9777328411201768,19.205194666666667,2350.2698026666667,14.419626402627658,123,7.400000000000013E-4
7,test_20231101_134748,10863862.png,317432,13197,304235,0.9584257415761486,2,4,66058,1907,64151,0.9711314299554936,23.723717333333333,3225.647888,13.044634028505238,123,7.400000000000013E-4
8,test_20231101_134748,11382381.png,312486,827,311659,0.9973534814359684,1,4,46745,109,46636,0.997668199807466,21.564144,2476.360432,14.192665047538828,123,7.400000000000013E-4
9,test_20231101_134748,11079715.png,443815,125192,318623,0.7179185020785688,3,5,124136,17444,106692,0.8594767029709351,16.64877511111111,2039.7730453333334,15.034985123844537,123,7.400000000000013E-4
10,test_20231101_134748,11551286.png,271883,467,271416,0.9982823493929374,1,4,40092,67,40025,0.998328843659583,17.988837333333333,1870.894224,15.410311266718583,123,7.400000000000013E-4
1,test_20231101_134749,10404007.png,502730,23337,479393,0.9535794561693155,2,3,61265,3365,57900,0.9450746755896515,25.313722666666667,3325.6070666666665,12.912094265254296,123,7.500000000000013E-4
2,test_20231101_134749,1254659.png,342646,78012,264634,0.7723247900165185,3,3,80080,10856,69224,0.8644355644355645,20.528035555555554,3070.871712,13.258186870279811,123,7.500000000000013E-4
3,test_20231101_134749,10188041.png,221231,10082,211149,0.9544277248667682,2,3,41731,1420,40311,0.9659725384007093,10.853313777777778,1051.0199413333332,17.91469404755111,123,7.500000000000013E-4
4,test_20231101_134749,10287332.png,216980,12767,204213,0.9411604756198728,1,3,22337,1747,20590,0.921788960021489,9.436826666666667,775.4438453333333,19.235300075188995,123,7.500000000000013E-4
5,test_20231101_134749,11610969.png,368720,28152,340568,0.9236493816446084,2,3,84111,4106,80005,0.9511835550641414,20.388908444444443,2735.818362666667,13.759931006817341,123,7.500000000000013E-4
6,test_20231101_134749,10350842.png,212614,6467,206147,0.9695833764474587,1,3,42529,947,41582,0.9777328411201768,19.205194666666667,2350.2698026666667,14.419626402627658,123,7.500000000000013E-4
7,test_20231101_134749,10863862.png,317432,13197,304235,0.9584257415761486,2,4,66058,1907,64151,0.9711314299554936,23.723717333333333,3225.647888,13.044634028505238,123,7.500000000000013E-4
8,test_20231101_134749,11382381.png,312486,827,311659,0.9973534814359684,1,3,46745,109,46636,0.997668199807466,21.564144,2476.360432,14.192665047538828,123,7.500000000000013E-4
9,test_20231101_134749,11079715.png,443815,125192,318623,0.7179185020785688,3,4,124136,17444,106692,0.8594767029709351,16.64877511111111,2039.7730453333334,15.034985123844537,123,7.500000000000013E-4
10,test_20231101_134749,11551286.png,271883,467,271416,0.9982823493929374,1,3,40092,67,40025,0.998328843659583,17.988837333333333,1870.894224,15.410311266718583,123,7.500000000000013E-4
1,test_20231101_134749,10404007.png,502730,23337,479393,0.9535794561693155,2,3,61265,3365,57900,0.9450746755896515,25.313722666666667,3325.6070666666665,12.912094265254296,123,7.600000000000013E-4
2,test_20231101_134749,1254659.png,342646,78012,264634,0.7723247900165185,3,4,80080,10856,69224,0.8644355644355645,20.528035555555554,3070.871712,13.258186870279811,123,7.600000000000013E-4
3,test_20231101_134749,10188041.png,221231,10002,211229,0.9547893378414417,2,4,41731,1410,40321,0.9662121684119719,10.980083555555556,1061.9383306666666,17.8698106392361,123,7.600000000000013E-4
4,test_20231101_134749,10287332.png,216980,12767,204213,0.9411604756198728,2,3,22337,1747,20590,0.921788960021489,9.436826666666667,775.4438453333333,19.235300075188995,123,7.600000000000013E-4
5,test_20231101_134749,11610969.png,368720,27849,340871,0.9244711434150575,2,4,84111,4062,80049,0.9517066733245354,21.206458666666666,2901.9369866666666,13.503923830349978,123,7.600000000000013E-4
6,test_20231101_134749,10350842.png,212614,6467,206147,0.9695833764474587,2,3,42529,947,41582,0.9777328411201768,19.205194666666667,2350.2698026666667,14.419626402627658,123,7.600000000000013E-4
7,test_20231101_134749,10863862.png,317432,13197,304235,0.9584257415761486,2,4,66058,1907,64151,0.9711314299554936,23.723717333333333,3225.647888,13.044634028505238,123,7.600000000000013E-4
8,test_20231101_134749,11382381.png,312486,827,311659,0.9973534814359684,1,3,46745,109,46636,0.997668199807466,21.564144,2476.360432,14.192665047538828,123,7.600000000000013E-4
9,test_20231101_134749,11079715.png,443815,125192,318623,0.7179185020785688,4,4,124136,17444,106692,0.8594767029709351,16.64877511111111,2039.7730453333334,15.034985123844537,123,7.600000000000013E-4
10,test_20231101_134749,11551286.png,271883,467,271416,0.9982823493929374,1,3,40092,67,40025,0.998328843659583,17.988837333333333,1870.894224,15.410311266718583,123,7.600000000000013E-4
1,test_20231101_134750,10404007.png,502730,23337,479393,0.9535794561693155,2,4,61265,3365,57900,0.9450746755896515,25.313722666666667,3325.6070666666665,12.912094265254296,123,7.700000000000014E-4
2,test_20231101_134750,1254659.png,342646,78012,264634,0.7723247900165185,3,4,80080,10856,69224,0.8644355644355645,20.528035555555554,3070.871712,13.258186870279811,123,7.700000000000014E-4
3,test_20231101_134750,10188041.png,221231,10002,211229,0.9547893378414417,2,3,41731,1410,40321,0.9662121684119719,10.980083555555556,1061.9383306666666,17.8698106392361,123,7.700000000000014E-4
4,test_20231101_134750,10287332.png,216980,12767,204213,0.9411604756198728,2,4,22337,1747,20590,0.921788960021489,9.436826666666667,775.4438453333333,19.235300075188995,123,7.700000000000014E-4
5,test_20231101_134750,11610969.png,368720,27849,340871,0.9244711434150575,3,4,84111,4062,80049,0.9517066733245354,21.206458666666666,2901.9369866666666,13.503923830349978,123,7.700000000000014E-4
6,test_20231101_134750,10350842.png,212614,6467,206147,0.9695833764474587,1,4,42529,947,41582,0.9777328411201768,19.205194666666667,2350.2698026666667,14.419626402627658,123,7.700000000000014E-4
7,test_20231101_134750,10863862.png,317432,13197,304235,0.9584257415761486,2,4,66058,1907,64151,0.9711314299554936,23.723717333333333,3225.647888,13.044634028505238,123,7.700000000000014E-4
8,test_20231101_134750,11382381.png,312486,827,311659,0.9973534814359684,2,3,46745,109,46636,0.997668199807466,21.564144,2476.360432,14.192665047538828,123,7.700000000000014E-4
9,test_20231101_134750,11079715.png,443815,125192,318623,0.7179185020785688,3,10,124136,17444,106692,0.8594767029709351,16.64877511111111,2039.7730453333334,15.034985123844537,123,7.700000000000014E-4
10,test_20231101_134750,11551286.png,271883,467,271416,0.9982823493929374,1,4,40092,67,40025,0.998328843659583,17.988837333333333,1870.894224,15.410311266718583,123,7.700000000000014E-4
1,test_20231101_134751,10404007.png,502730,23337,479393,0.9535794561693155,2,3,61265,3365,57900,0.9450746755896515,25.313722666666667,3325.6070666666665,12.912094265254296,123,7.800000000000014E-4
2,test_20231101_134751,1254659.png,342646,78012,264634,0.7723247900165185,4,4,80080,10856,69224,0.8644355644355645,20.528035555555554,3070.871712,13.258186870279811,123,7.800000000000014E-4
3,test_20231101_134751,10188041.png,221231,10002,211229,0.9547893378414417,2,4,41731,1410,40321,0.9662121684119719,10.980083555555556,1061.9383306666666,17.8698106392361,123,7.800000000000014E-4
4,test_20231101_134751,10287332.png,216980,12767,204213,0.9411604756198728,2,4,22337,1747,20590,0.921788960021489,9.436826666666667,775.4438453333333,19.235300075188995,123,7.800000000000014E-4
5,test_20231101_134751,11610969.png,368720,27849,340871,0.9244711434150575,3,3,84111,4062,80049,0.9517066733245354,21.206458666666666,2901.9369866666666,13.503923830349978,123,7.800000000000014E-4
6,test_20231101_134751,10350842.png,212614,6467,206147,0.9695833764474587,2,4,42529,947,41582,0.9777328411201768,19.205194666666667,2350.2698026666667,14.419626402627658,123,7.800000000000014E-4
7,test_20231101_134751,10863862.png,317432,13197,304235,0.9584257415761486,2,4,66058,1907,64151,0.9711314299554936,23.723717333333333,3225.647888,13.044634028505238,123,7.800000000000014E-4
8,test_20231101_134751,11382381.png,312486,827,311659,0.9973534814359684,2,4,46745,109,46636,0.997668199807466,21.564144,2476.360432,14.192665047538828,123,7.800000000000014E-4
9,test_20231101_134751,11079715.png,443815,125192,318623,0.7179185020785688,3,4,124136,17444,106692,0.8594767029709351,16.64877511111111,2039.7730453333334,15.034985123844537,123,7.800000000000014E-4
10,test_20231101_134751,11551286.png,271883,467,271416,0.9982823493929374,1,4,40092,67,40025,0.998328843659583,17.988837333333333,1870.894224,15.410311266718583,123,7.800000000000014E-4
1,test_20231101_134751,10404007.png,502730,23337,479393,0.9535794561693155,2,3,61265,3365,57900,0.9450746755896515,25.313722666666667,3325.6070666666665,12.912094265254296,123,7.900000000000014E-4
2,test_20231101_134751,1254659.png,342646,78012,264634,0.7723247900165185,3,4,80080,10856,69224,0.8644355644355645,20.528035555555554,3070.871712,13.258186870279811,123,7.900000000000014E-4
3,test_20231101_134751,10188041.png,221231,10002,211229,0.9547893378414417,2,4,41731,1410,40321,0.9662121684119719,10.980083555555556,1061.9383306666666,17.8698106392361,123,7.900000000000014E-4
4,test_20231101_134751,10287332.png,216980,12767,204213,0.9411604756198728,1,3,22337,1747,20590,0.921788960021489,9.436826666666667,775.4438453333333,19.235300075188995,123,7.900000000000014E-4
5,test_20231101_134751,11610969.png,368720,27849,340871,0.9244711434150575,3,4,84111,4062,80049,0.9517066733245354,21.206458666666666,2901.9369866666666,13.503923830349978,123,7.900000000000014E-4
6,test_20231101_134751,10350842.png,212614,6467,206147,0.9695833764474587,2,4,42529,947,41582,0.9777328411201768,19.205194666666667,2350.2698026666667,14.419626402627658,123,7.900000000000014E-4
7,test_20231101_134751,10863862.png,317432,13197,304235,0.9584257415761486,2,4,66058,1907,64151,0.9711314299554936,23.723717333333333,3225.647888,13.044634028505238,123,7.900000000000014E-4
8,test_20231101_134751,11382381.png,312486,827,311659,0.9973534814359684,1,3,46745,109,46636,0.997668199807466,21.564144,2476.360432,14.192665047538828,123,7.900000000000014E-4
9,test_20231101_134751,11079715.png,443815,125192,318623,0.7179185020785688,3,4,124136,17444,106692,0.8594767029709351,16.64877511111111,2039.7730453333334,15.034985123844537,123,7.900000000000014E-4
10,test_20231101_134751,11551286.png,271883,467,271416,0.9982823493929374,2,4,40092,67,40025,0.998328843659583,17.988837333333333,1870.894224,15.410311266718583,123,7.900000000000014E-4
1,test_20231101_134752,10404007.png,502730,23337,479393,0.9535794561693155,2,4,61265,3365,57900,0.9450746755896515,25.313722666666667,3325.6070666666665,12.912094265254296,123,8.000000000000014E-4
2,test_20231101_134752,1254659.png,342646,78012,264634,0.7723247900165185,3,4,80080,10856,69224,0.8644355644355645,20.528035555555554,3070.871712,13.258186870279811,123,8.000000000000014E-4
3,test_20231101_134752,10188041.png,221231,10002,211229,0.9547893378414417,2,3,41731,1410,40321,0.9662121684119719,10.980083555555556,1061.9383306666666,17.8698106392361,123,8.000000000000014E-4
4,test_20231101_134752,10287332.png,216980,12767,204213,0.9411604756198728,2,4,22337,1747,20590,0.921788960021489,9.436826666666667,775.4438453333333,19.235300075188995,123,8.000000000000014E-4
5,test_20231101_134752,11610969.png,368720,27849,340871,0.9244711434150575,2,4,84111,4062,80049,0.9517066733245354,21.206458666666666,2901.9369866666666,13.503923830349978,123,8.000000000000014E-4
6,test_20231101_134752,10350842.png,212614,6467,206147,0.9695833764474587,1,3,42529,947,41582,0.9777328411201768,19.205194666666667,2350.2698026666667,14.419626402627658,123,8.000000000000014E-4
7,test_20231101_134752,10863862.png,317432,13197,304235,0.9584257415761486,2,4,66058,1907,64151,0.9711314299554936,23.723717333333333,3225.647888,13.044634028505238,123,8.000000000000014E-4
8,test_20231101_134752,11382381.png,312486,827,311659,0.9973534814359684,2,3,46745,109,46636,0.997668199807466,21.564144,2476.360432,14.192665047538828,123,8.000000000000014E-4
9,test_20231101_134752,11079715.png,443815,125192,318623,0.7179185020785688,3,5,124136,17444,106692,0.8594767029709351,16.64877511111111,2039.7730453333334,15.034985123844537,123,8.000000000000014E-4
10,test_20231101_134752,11551286.png,271883,467,271416,0.9982823493929374,1,4,40092,67,40025,0.998328843659583,17.988837333333333,1870.894224,15.410311266718583,123,8.000000000000014E-4
1,test_20231101_134753,10404007.png,502730,23337,479393,0.9535794561693155,3,3,61265,3365,57900,0.9450746755896515,25.313722666666667,3325.6070666666665,12.912094265254296,123,8.100000000000015E-4
2,test_20231101_134753,1254659.png,342646,78012,264634,0.7723247900165185,2,3,80080,10856,69224,0.8644355644355645,20.528035555555554,3070.871712,13.258186870279811,123,8.100000000000015E-4
3,test_20231101_134753,10188041.png,221231,10002,211229,0.9547893378414417,2,3,41731,1410,40321,0.9662121684119719,10.980083555555556,1061.9383306666666,17.8698106392361,123,8.100000000000015E-4
4,test_20231101_134753,10287332.png,216980,12767,204213,0.9411604756198728,2,4,22337,1747,20590,0.921788960021489,9.436826666666667,775.4438453333333,19.235300075188995,123,8.100000000000015E-4
5,test_20231101_134753,11610969.png,368720,27849,340871,0.9244711434150575,2,4,84111,4062,80049,0.9517066733245354,21.206458666666666,2901.9369866666666,13.503923830349978,123,8.100000000000015E-4
6,test_20231101_134753,10350842.png,212614,6467,206147,0.9695833764474587,2,4,42529,947,41582,0.9777328411201768,19.205194666666667,2350.2698026666667,14.419626402627658,123,8.100000000000015E-4
7,test_20231101_134753,10863862.png,317432,13197,304235,0.9584257415761486,2,3,66058,1907,64151,0.9711314299554936,23.723717333333333,3225.647888,13.044634028505238,123,8.100000000000015E-4
8,test_20231101_134753,11382381.png,312486,827,311659,0.9973534814359684,1,3,46745,109,46636,0.997668199807466,21.564144,2476.360432,14.192665047538828,123,8.100000000000015E-4
9,test_20231101_134753,11079715.png,443815,125192,318623,0.7179185020785688,4,4,124136,17444,106692,0.8594767029709351,16.64877511111111,2039.7730453333334,15.034985123844537,123,8.100000000000015E-4
10,test_20231101_134753,11551286.png,271883,467,271416,0.9982823493929374,1,3,40092,67,40025,0.998328843659583,17.988837333333333,1870.894224,15.410311266718583,123,8.100000000000015E-4
1,test_20231101_134753,10404007.png,502730,23337,479393,0.9535794561693155,2,4,61265,3365,57900,0.9450746755896515,25.313722666666667,3325.6070666666665,12.912094265254296,123,8.200000000000015E-4
2,test_20231101_134753,1254659.png,342646,78012,264634,0.7723247900165185,3,4,80080,10856,69224,0.8644355644355645,20.528035555555554,3070.871712,13.258186870279811,123,8.200000000000015E-4
3,test_20231101_134753,10188041.png,221231,10002,211229,0.9547893378414417,2,4,41731,1410,40321,0.9662121684119719,10.980083555555556,1061.9383306666666,17.8698106392361,123,8.200000000000015E-4
4,test_20231101_134753,10287332.png,216980,12767,204213,0.9411604756198728,1,4,22337,1747,20590,0.921788960021489,9.436826666666667,775.4438453333333,19.235300075188995,123,8.200000000000015E-4
5,test_20231101_134753,11610969.png,368720,27849,340871,0.9244711434150575,3,3,84111,4062,80049,0.9517066733245354,21.206458666666666,2901.9369866666666,13.503923830349978,123,8.200000000000015E-4
6,test_20231101_134753,10350842.png,212614,6467,206147,0.9695833764474587,1,4,42529,947,41582,0.9777328411201768,19.205194666666667,2350.2698026666667,14.419626402627658,123,8.200000000000015E-4
7,test_20231101_134753,10863862.png,317432,13197,304235,0.9584257415761486,2,7,66058,1907,64151,0.9711314299554936,23.723717333333333,3225.647888,13.044634028505238,123,8.200000000000015E-4
8,test_20231101_134753,11382381.png,312486,827,311659,0.9973534814359684,3,4,46745,109,46636,0.997668199807466,21.564144,2476.360432,14.192665047538828,123,8.200000000000015E-4
9,test_20231101_134753,11079715.png,443815,125192,318623,0.7179185020785688,4,4,124136,17444,106692,0.8594767029709351,16.64877511111111,2039.7730453333334,15.034985123844537,123,8.200000000000015E-4
10,test_20231101_134753,11551286.png,271883,467,271416,0.9982823493929374,1,3,40092,67,40025,0.998328843659583,17.988837333333333,1870.894224,15.410311266718583,123,8.200000000000015E-4
1,test_20231101_134754,10404007.png,502730,23337,479393,0.9535794561693155,2,4,61265,3365,57900,0.9450746755896515,25.313722666666667,3325.6070666666665,12.912094265254296,123,8.300000000000015E-4
2,test_20231101_134754,1254659.png,342646,78012,264634,0.7723247900165185,3,4,80080,10856,69224,0.8644355644355645,20.528035555555554,3070.871712,13.258186870279811,123,8.300000000000015E-4
3,test_20231101_134754,10188041.png,221231,10002,211229,0.9547893378414417,2,4,41731,1410,40321,0.9662121684119719,10.980083555555556,1061.9383306666666,17.8698106392361,123,8.300000000000015E-4
4,test_20231101_134754,10287332.png,216980,12767,204213,0.9411604756198728,2,4,22337,1747,20590,0.921788960021489,9.436826666666667,775.4438453333333,19.235300075188995,123,8.300000000000015E-4
5,test_20231101_134754,11610969.png,368720,27849,340871,0.9244711434150575,2,4,84111,4062,80049,0.9517066733245354,21.206458666666666,2901.9369866666666,13.503923830349978,123,8.300000000000015E-4
6,test_20231101_134754,10350842.png,212614,6467,206147,0.9695833764474587,2,3,42529,947,41582,0.9777328411201768,19.205194666666667,2350.2698026666667,14.419626402627658,123,8.300000000000015E-4
7,test_20231101_134754,10863862.png,317432,13197,304235,0.9584257415761486,2,4,66058,1907,64151,0.9711314299554936,23.723717333333333,3225.647888,13.044634028505238,123,8.300000000000015E-4
8,test_20231101_134754,11382381.png,312486,827,311659,0.9973534814359684,1,3,46745,109,46636,0.997668199807466,21.564144,2476.360432,14.192665047538828,123,8.300000000000015E-4
9,test_20231101_134754,11079715.png,443815,125192,318623,0.7179185020785688,3,4,124136,17444,106692,0.8594767029709351,16.64877511111111,2039.7730453333334,15.034985123844537,123,8.300000000000015E-4
10,test_20231101_134754,11551286.png,271883,467,271416,0.9982823493929374,1,3,40092,67,40025,0.998328843659583,17.988837333333333,1870.894224,15.410311266718583,123,8.300000000000015E-4
1,test_20231101_134755,10404007.png,502730,23337,479393,0.9535794561693155,3,4,61265,3365,57900,0.9450746755896515,25.313722666666667,3325.6070666666665,12.912094265254296,123,8.400000000000016E-4
2,test_20231101_134755,1254659.png,342646,78012,264634,0.7723247900165185,3,4,80080,10856,69224,0.8644355644355645,20.528035555555554,3070.871712,13.258186870279811,123,8.400000000000016E-4
3,test_20231101_134755,10188041.png,221231,10002,211229,0.9547893378414417,2,3,41731,1410,40321,0.9662121684119719,10.980083555555556,1061.9383306666666,17.8698106392361,123,8.400000000000016E-4
4,test_20231101_134755,10287332.png,216980,12767,204213,0.9411604756198728,2,4,22337,1747,20590,0.921788960021489,9.436826666666667,775.4438453333333,19.235300075188995,123,8.400000000000016E-4
5,test_20231101_134755,11610969.png,368720,27849,340871,0.9244711434150575,2,4,84111,4062,80049,0.9517066733245354,21.206458666666666,2901.9369866666666,13.503923830349978,123,8.400000000000016E-4
6,test_20231101_134755,10350842.png,212614,6467,206147,0.9695833764474587,1,4,42529,947,41582,0.9777328411201768,19.205194666666667,2350.2698026666667,14.419626402627658,123,8.400000000000016E-4
7,test_20231101_134755,10863862.png,317432,13197,304235,0.9584257415761486,3,4,66058,1907,64151,0.9711314299554936,23.723717333333333,3225.647888,13.044634028505238,123,8.400000000000016E-4
8,test_20231101_134755,11382381.png,312486,827,311659,0.9973534814359684,2,3,46745,109,46636,0.997668199807466,21.564144,2476.360432,14.192665047538828,123,8.400000000000016E-4
9,test_20231101_134755,11079715.png,443815,125192,318623,0.7179185020785688,3,4,124136,17444,106692,0.8594767029709351,16.64877511111111,2039.7730453333334,15.034985123844537,123,8.400000000000016E-4
10,test_20231101_134755,11551286.png,271883,467,271416,0.9982823493929374,1,4,40092,67,40025,0.998328843659583,17.988837333333333,1870.894224,15.410311266718583,123,8.400000000000016E-4
1,test_20231101_134755,10404007.png,502730,23337,479393,0.9535794561693155,3,4,61265,3365,57900,0.9450746755896515,25.313722666666667,3325.6070666666665,12.912094265254296,123,8.500000000000016E-4
2,test_20231101_134755,1254659.png,342646,78012,264634,0.7723247900165185,3,4,80080,10856,69224,0.8644355644355645,20.528035555555554,3070.871712,13.258186870279811,123,8.500000000000016E-4
3,test_20231101_134755,10188041.png,221231,10002,211229,0.9547893378414417,2,4,41731,1410,40321,0.9662121684119719,10.980083555555556,1061.9383306666666,17.8698106392361,123,8.500000000000016E-4
4,test_20231101_134755,10287332.png,216980,12767,204213,0.9411604756198728,2,4,22337,1747,20590,0.921788960021489,9.436826666666667,775.4438453333333,19.235300075188995,123,8.500000000000016E-4
5,test_20231101_134755,11610969.png,368720,27849,340871,0.9244711434150575,3,4,84111,4062,80049,0.9517066733245354,21.206458666666666,2901.9369866666666,13.503923830349978,123,8.500000000000016E-4
6,test_20231101_134755,10350842.png,212614,6467,206147,0.9695833764474587,2,3,42529,947,41582,0.9777328411201768,19.205194666666667,2350.2698026666667,14.419626402627658,123,8.500000000000016E-4
7,test_20231101_134755,10863862.png,317432,13197,304235,0.9584257415761486,2,4,66058,1907,64151,0.9711314299554936,23.723717333333333,3225.647888,13.044634028505238,123,8.500000000000016E-4
8,test_20231101_134755,11382381.png,312486,827,311659,0.9973534814359684,1,4,46745,109,46636,0.997668199807466,21.564144,2476.360432,14.192665047538828,123,8.500000000000016E-4
9,test_20231101_134755,11079715.png,443815,125192,318623,0.7179185020785688,3,4,124136,17444,106692,0.8594767029709351,16.64877511111111,2039.7730453333334,15.034985123844537,123,8.500000000000016E-4
10,test_20231101_134755,11551286.png,271883,467,271416,0.9982823493929374,2,3,40092,67,40025,0.998328843659583,17.988837333333333,1870.894224,15.410311266718583,123,8.500000000000016E-4
1,test_20231101_134756,10404007.png,502730,23337,479393,0.9535794561693155,2,3,61265,3365,57900,0.9450746755896515,25.313722666666667,3325.6070666666665,12.912094265254296,123,8.600000000000016E-4
2,test_20231101_134756,1254659.png,342646,78012,264634,0.7723247900165185,3,4,80080,10856,69224,0.8644355644355645,20.528035555555554,3070.871712,13.258186870279811,123,8.600000000000016E-4
3,test_20231101_134756,10188041.png,221231,10002,211229,0.9547893378414417,2,4,41731,1410,40321,0.9662121684119719,10.980083555555556,1061.9383306666666,17.8698106392361,123,8.600000000000016E-4
4,test_20231101_134756,10287332.png,216980,12767,204213,0.9411604756198728,1,3,22337,1747,20590,0.921788960021489,9.436826666666667,775.4438453333333,19.235300075188995,123,8.600000000000016E-4
5,test_20231101_134756,11610969.png,368720,27849,340871,0.9244711434150575,2,4,84111,4062,80049,0.9517066733245354,21.206458666666666,2901.9369866666666,13.503923830349978,123,8.600000000000016E-4
6,test_20231101_134756,10350842.png,212614,6467,206147,0.9695833764474587,1,3,42529,947,41582,0.9777328411201768,19.205194666666667,2350.2698026666667,14.419626402627658,123,8.600000000000016E-4
7,test_20231101_134756,10863862.png,317432,13197,304235,0.9584257415761486,2,3,66058,1907,64151,0.9711314299554936,23.723717333333333,3225.647888,13.044634028505238,123,8.600000000000016E-4
8,test_20231101_134756,11382381.png,312486,827,311659,0.9973534814359684,1,3,46745,109,46636,0.997668199807466,21.564144,2476.360432,14.192665047538828,123,8.600000000000016E-4
9,test_20231101_134756,11079715.png,443815,125192,318623,0.7179185020785688,3,5,124136,17444,106692,0.8594767029709351,16.64877511111111,2039.7730453333334,15.034985123844537,123,8.600000000000016E-4
10,test_20231101_134756,11551286.png,271883,467,271416,0.9982823493929374,1,4,40092,67,40025,0.998328843659583,17.988837333333333,1870.894224,15.410311266718583,123,8.600000000000016E-4
1,test_20231101_134757,10404007.png,502730,23337,479393,0.9535794561693155,2,4,61265,3365,57900,0.9450746755896515,25.313722666666667,3325.6070666666665,12.912094265254296,123,8.700000000000016E-4
2,test_20231101_134757,1254659.png,342646,78012,264634,0.7723247900165185,3,4,80080,10856,69224,0.8644355644355645,20.528035555555554,3070.871712,13.258186870279811,123,8.700000000000016E-4
3,test_20231101_134757,10188041.png,221231,10002,211229,0.9547893378414417,3,4,41731,1410,40321,0.9662121684119719,10.980083555555556,1061.9383306666666,17.8698106392361,123,8.700000000000016E-4
4,test_20231101_134757,10287332.png,216980,12767,204213,0.9411604756198728,1,3,22337,1747,20590,0.921788960021489,9.436826666666667,775.4438453333333,19.235300075188995,123,8.700000000000016E-4
5,test_20231101_134757,11610969.png,368720,27849,340871,0.9244711434150575,2,4,84111,4062,80049,0.9517066733245354,21.206458666666666,2901.9369866666666,13.503923830349978,123,8.700000000000016E-4
6,test_20231101_134757,10350842.png,212614,6467,206147,0.9695833764474587,2,3,42529,947,41582,0.9777328411201768,19.205194666666667,2350.2698026666667,14.419626402627658,123,8.700000000000016E-4
7,test_20231101_134757,10863862.png,317432,13197,304235,0.9584257415761486,2,4,66058,1907,64151,0.9711314299554936,23.723717333333333,3225.647888,13.044634028505238,123,8.700000000000016E-4
8,test_20231101_134757,11382381.png,312486,827,311659,0.9973534814359684,2,4,46745,109,46636,0.997668199807466,21.564144,2476.360432,14.192665047538828,123,8.700000000000016E-4
9,test_20231101_134757,11079715.png,443815,125192,318623,0.7179185020785688,3,5,124136,17444,106692,0.8594767029709351,16.64877511111111,2039.7730453333334,15.034985123844537,123,8.700000000000016E-4
10,test_20231101_134757,11551286.png,271883,467,271416,0.9982823493929374,1,3,40092,67,40025,0.998328843659583,17.988837333333333,1870.894224,15.410311266718583,123,8.700000000000016E-4
1,test_20231101_134757,10404007.png,502730,23337,479393,0.9535794561693155,2,4,61265,3365,57900,0.9450746755896515,25.313722666666667,3325.6070666666665,12.912094265254296,123,8.800000000000017E-4
2,test_20231101_134757,1254659.png,342646,78012,264634,0.7723247900165185,3,4,80080,10856,69224,0.8644355644355645,20.528035555555554,3070.871712,13.258186870279811,123,8.800000000000017E-4
3,test_20231101_134757,10188041.png,221231,10002,211229,0.9547893378414417,2,4,41731,1410,40321,0.9662121684119719,10.980083555555556,1061.9383306666666,17.8698106392361,123,8.800000000000017E-4
4,test_20231101_134757,10287332.png,216980,12767,204213,0.9411604756198728,2,4,22337,1747,20590,0.921788960021489,9.436826666666667,775.4438453333333,19.235300075188995,123,8.800000000000017E-4
5,test_20231101_134757,11610969.png,368720,27849,340871,0.9244711434150575,3,4,84111,4062,80049,0.9517066733245354,21.206458666666666,2901.9369866666666,13.503923830349978,123,8.800000000000017E-4
6,test_20231101_134757,10350842.png,212614,6467,206147,0.9695833764474587,2,4,42529,947,41582,0.9777328411201768,19.205194666666667,2350.2698026666667,14.419626402627658,123,8.800000000000017E-4
7,test_20231101_134757,10863862.png,317432,13197,304235,0.9584257415761486,1,3,66058,1907,64151,0.9711314299554936,23.723717333333333,3225.647888,13.044634028505238,123,8.800000000000017E-4
8,test_20231101_134757,11382381.png,312486,827,311659,0.9973534814359684,1,3,46745,109,46636,0.997668199807466,21.564144,2476.360432,14.192665047538828,123,8.800000000000017E-4
9,test_20231101_134757,11079715.png,443815,125192,318623,0.7179185020785688,4,4,124136,17444,106692,0.8594767029709351,16.64877511111111,2039.7730453333334,15.034985123844537,123,8.800000000000017E-4
10,test_20231101_134757,11551286.png,271883,467,271416,0.9982823493929374,1,3,40092,67,40025,0.998328843659583,17.988837333333333,1870.894224,15.410311266718583,123,8.800000000000017E-4
1,test_20231101_134758,10404007.png,502730,23337,479393,0.9535794561693155,2,4,61265,3365,57900,0.9450746755896515,25.313722666666667,3325.6070666666665,12.912094265254296,123,8.900000000000017E-4
2,test_20231101_134758,1254659.png,342646,78012,264634,0.7723247900165185,3,4,80080,10856,69224,0.8644355644355645,20.528035555555554,3070.871712,13.258186870279811,123,8.900000000000017E-4
3,test_20231101_134758,10188041.png,221231,10002,211229,0.9547893378414417,2,4,41731,1410,40321,0.9662121684119719,10.980083555555556,1061.9383306666666,17.8698106392361,123,8.900000000000017E-4
4,test_20231101_134758,10287332.png,216980,12767,204213,0.9411604756198728,2,4,22337,1747,20590,0.921788960021489,9.436826666666667,775.4438453333333,19.235300075188995,123,8.900000000000017E-4
5,test_20231101_134758,11610969.png,368720,27849,340871,0.9244711434150575,2,3,84111,4062,80049,0.9517066733245354,21.206458666666666,2901.9369866666666,13.503923830349978,123,8.900000000000017E-4
6,test_20231101_134758,10350842.png,212614,6467,206147,0.9695833764474587,2,4,42529,947,41582,0.9777328411201768,19.205194666666667,2350.2698026666667,14.419626402627658,123,8.900000000000017E-4
7,test_20231101_134758,10863862.png,317432,13197,304235,0.9584257415761486,2,9,66058,1907,64151,0.9711314299554936,23.723717333333333,3225.647888,13.044634028505238,123,8.900000000000017E-4
8,test_20231101_134758,11382381.png,312486,827,311659,0.9973534814359684,2,4,46745,109,46636,0.997668199807466,21.564144,2476.360432,14.192665047538828,123,8.900000000000017E-4
9,test_20231101_134758,11079715.png,443815,125192,318623,0.7179185020785688,4,4,124136,17444,106692,0.8594767029709351,16.64877511111111,2039.7730453333334,15.034985123844537,123,8.900000000000017E-4
10,test_20231101_134758,11551286.png,271883,467,271416,0.9982823493929374,1,4,40092,67,40025,0.998328843659583,17.988837333333333,1870.894224,15.410311266718583,123,8.900000000000017E-4
1,test_20231101_134759,10404007.png,502730,23077,479653,0.954096632387166,3,11,61265,3328,57937,0.9456786093201665,25.358901333333332,3334.2294613333333,12.90084876245235,123,9.000000000000017E-4
2,test_20231101_134759,1254659.png,342646,78012,264634,0.7723247900165185,4,4,80080,10856,69224,0.8644355644355645,20.528035555555554,3070.871712,13.258186870279811,123,9.000000000000017E-4
3,test_20231101_134759,10188041.png,221231,10002,211229,0.9547893378414417,2,4,41731,1410,40321,0.9662121684119719,10.980083555555556,1061.9383306666666,17.8698106392361,123,9.000000000000017E-4
4,test_20231101_134759,10287332.png,216980,12767,204213,0.9411604756198728,2,3,22337,1747,20590,0.921788960021489,9.436826666666667,775.4438453333333,19.235300075188995,123,9.000000000000017E-4
5,test_20231101_134759,11610969.png,368720,27849,340871,0.9244711434150575,3,4,84111,4062,80049,0.9517066733245354,21.206458666666666,2901.9369866666666,13.503923830349978,123,9.000000000000017E-4
6,test_20231101_134759,10350842.png,212614,6467,206147,0.9695833764474587,1,3,42529,947,41582,0.9777328411201768,19.205194666666667,2350.2698026666667,14.419626402627658,123,9.000000000000017E-4
7,test_20231101_134759,10863862.png,317432,13197,304235,0.9584257415761486,2,4,66058,1907,64151,0.9711314299554936,23.723717333333333,3225.647888,13.044634028505238,123,9.000000000000017E-4
8,test_20231101_134759,11382381.png,312486,827,311659,0.9973534814359684,1,4,46745,109,46636,0.997668199807466,21.564144,2476.360432,14.192665047538828,123,9.000000000000017E-4
9,test_20231101_134759,11079715.png,443815,125192,318623,0.7179185020785688,4,9,124136,17444,106692,0.8594767029709351,16.64877511111111,2039.7730453333334,15.034985123844537,123,9.000000000000017E-4
10,test_20231101_134759,11551286.png,271883,467,271416,0.9982823493929374,1,4,40092,67,40025,0.998328843659583,17.988837333333333,1870.894224,15.410311266718583,123,9.000000000000017E-4
1,test_20231101_134800,10404007.png,502730,23077,479653,0.954096632387166,2,4,61265,3328,57937,0.9456786093201665,25.358901333333332,3334.2294613333333,12.90084876245235,123,9.100000000000017E-4
2,test_20231101_134800,1254659.png,342646,78012,264634,0.7723247900165185,4,4,80080,10856,69224,0.8644355644355645,20.528035555555554,3070.871712,13.258186870279811,123,9.100000000000017E-4
3,test_20231101_134800,10188041.png,221231,10002,211229,0.9547893378414417,2,4,41731,1410,40321,0.9662121684119719,10.980083555555556,1061.9383306666666,17.8698106392361,123,9.100000000000017E-4
4,test_20231101_134800,10287332.png,216980,12767,204213,0.9411604756198728,2,4,22337,1747,20590,0.921788960021489,9.436826666666667,775.4438453333333,19.235300075188995,123,9.100000000000017E-4
5,test_20231101_134800,11610969.png,368720,27849,340871,0.9244711434150575,2,3,84111,4062,80049,0.9517066733245354,21.206458666666666,2901.9369866666666,13.503923830349978,123,9.100000000000017E-4
6,test_20231101_134800,10350842.png,212614,6467,206147,0.9695833764474587,1,4,42529,947,41582,0.9777328411201768,19.205194666666667,2350.2698026666667,14.419626402627658,123,9.100000000000017E-4
7,test_20231101_134800,10863862.png,317432,13197,304235,0.9584257415761486,2,3,66058,1907,64151,0.9711314299554936,23.723717333333333,3225.647888,13.044634028505238,123,9.100000000000017E-4
8,test_20231101_134800,11382381.png,312486,827,311659,0.9973534814359684,1,3,46745,109,46636,0.997668199807466,21.564144,2476.360432,14.192665047538828,123,9.100000000000017E-4
9,test_20231101_134800,11079715.png,443815,125192,318623,0.7179185020785688,4,5,124136,17444,106692,0.8594767029709351,16.64877511111111,2039.7730453333334,15.034985123844537,123,9.100000000000017E-4
10,test_20231101_134800,11551286.png,271883,467,271416,0.9982823493929374,1,3,40092,67,40025,0.998328843659583,17.988837333333333,1870.894224,15.410311266718583,123,9.100000000000017E-4
1,test_20231101_134800,10404007.png,502730,23077,479653,0.954096632387166,9,4,61265,3328,57937,0.9456786093201665,25.358901333333332,3334.2294613333333,12.90084876245235,123,9.200000000000018E-4
2,test_20231101_134800,1254659.png,342646,78012,264634,0.7723247900165185,3,5,80080,10856,69224,0.8644355644355645,20.528035555555554,3070.871712,13.258186870279811,123,9.200000000000018E-4
3,test_20231101_134800,10188041.png,221231,10002,211229,0.9547893378414417,2,4,41731,1410,40321,0.9662121684119719,10.980083555555556,1061.9383306666666,17.8698106392361,123,9.200000000000018E-4
4,test_20231101_134800,10287332.png,216980,12767,204213,0.9411604756198728,2,4,22337,1747,20590,0.921788960021489,9.436826666666667,775.4438453333333,19.235300075188995,123,9.200000000000018E-4
5,test_20231101_134800,11610969.png,368720,27849,340871,0.9244711434150575,3,4,84111,4062,80049,0.9517066733245354,21.206458666666666,2901.9369866666666,13.503923830349978,123,9.200000000000018E-4
6,test_20231101_134800,10350842.png,212614,6467,206147,0.9695833764474587,1,3,42529,947,41582,0.9777328411201768,19.205194666666667,2350.2698026666667,14.419626402627658,123,9.200000000000018E-4
7,test_20231101_134800,10863862.png,317432,13197,304235,0.9584257415761486,2,4,66058,1907,64151,0.9711314299554936,23.723717333333333,3225.647888,13.044634028505238,123,9.200000000000018E-4
8,test_20231101_134800,11382381.png,312486,827,311659,0.9973534814359684,1,3,46745,109,46636,0.997668199807466,21.564144,2476.360432,14.192665047538828,123,9.200000000000018E-4
9,test_20231101_134800,11079715.png,443815,125192,318623,0.7179185020785688,3,4,124136,17444,106692,0.8594767029709351,16.64877511111111,2039.7730453333334,15.034985123844537,123,9.200000000000018E-4
10,test_20231101_134800,11551286.png,271883,467,271416,0.9982823493929374,1,4,40092,67,40025,0.998328843659583,17.988837333333333,1870.894224,15.410311266718583,123,9.200000000000018E-4
1,test_20231101_134801,10404007.png,502730,23077,479653,0.954096632387166,2,3,61265,3328,57937,0.9456786093201665,25.358901333333332,3334.2294613333333,12.90084876245235,123,9.300000000000018E-4
2,test_20231101_134801,1254659.png,342646,78012,264634,0.7723247900165185,3,4,80080,10856,69224,0.8644355644355645,20.528035555555554,3070.871712,13.258186870279811,123,9.300000000000018E-4
3,test_20231101_134801,10188041.png,221231,10002,211229,0.9547893378414417,3,3,41731,1410,40321,0.9662121684119719,10.980083555555556,1061.9383306666666,17.8698106392361,123,9.300000000000018E-4
4,test_20231101_134801,10287332.png,216980,12767,204213,0.9411604756198728,1,3,22337,1747,20590,0.921788960021489,9.436826666666667,775.4438453333333,19.235300075188995,123,9.300000000000018E-4
5,test_20231101_134801,11610969.png,368720,27849,340871,0.9244711434150575,2,3,84111,4062,80049,0.9517066733245354,21.206458666666666,2901.9369866666666,13.503923830349978,123,9.300000000000018E-4
6,test_20231101_134801,10350842.png,212614,6467,206147,0.9695833764474587,2,3,42529,947,41582,0.9777328411201768,19.205194666666667,2350.2698026666667,14.419626402627658,123,9.300000000000018E-4
7,test_20231101_134801,10863862.png,317432,13197,304235,0.9584257415761486,2,4,66058,1907,64151,0.9711314299554936,23.723717333333333,3225.647888,13.044634028505238,123,9.300000000000018E-4
8,test_20231101_134801,11382381.png,312486,827,311659,0.9973534814359684,1,4,46745,109,46636,0.997668199807466,21.564144,2476.360432,14.192665047538828,123,9.300000000000018E-4
9,test_20231101_134801,11079715.png,443815,125192,318623,0.7179185020785688,3,4,124136,17444,106692,0.8594767029709351,16.64877511111111,2039.7730453333334,15.034985123844537,123,9.300000000000018E-4
10,test_20231101_134801,11551286.png,271883,467,271416,0.9982823493929374,2,4,40092,67,40025,0.998328843659583,17.988837333333333,1870.894224,15.410311266718583,123,9.300000000000018E-4
1,test_20231101_134802,10404007.png,502730,23077,479653,0.954096632387166,2,3,61265,3328,57937,0.9456786093201665,25.358901333333332,3334.2294613333333,12.90084876245235,123,9.400000000000018E-4
2,test_20231101_134802,1254659.png,342646,78012,264634,0.7723247900165185,3,4,80080,10856,69224,0.8644355644355645,20.528035555555554,3070.871712,13.258186870279811,123,9.400000000000018E-4
3,test_20231101_134802,10188041.png,221231,10002,211229,0.9547893378414417,2,4,41731,1410,40321,0.9662121684119719,10.980083555555556,1061.9383306666666,17.8698106392361,123,9.400000000000018E-4
4,test_20231101_134802,10287332.png,216980,12767,204213,0.9411604756198728,2,4,22337,1747,20590,0.921788960021489,9.436826666666667,775.4438453333333,19.235300075188995,123,9.400000000000018E-4
5,test_20231101_134802,11610969.png,368720,27849,340871,0.9244711434150575,2,3,84111,4062,80049,0.9517066733245354,21.206458666666666,2901.9369866666666,13.503923830349978,123,9.400000000000018E-4
6,test_20231101_134802,10350842.png,212614,6467,206147,0.9695833764474587,1,3,42529,947,41582,0.9777328411201768,19.205194666666667,2350.2698026666667,14.419626402627658,123,9.400000000000018E-4
7,test_20231101_134802,10863862.png,317432,13197,304235,0.9584257415761486,2,4,66058,1907,64151,0.9711314299554936,23.723717333333333,3225.647888,13.044634028505238,123,9.400000000000018E-4
8,test_20231101_134802,11382381.png,312486,827,311659,0.9973534814359684,1,3,46745,109,46636,0.997668199807466,21.564144,2476.360432,14.192665047538828,123,9.400000000000018E-4
9,test_20231101_134802,11079715.png,443815,125192,318623,0.7179185020785688,3,4,124136,17444,106692,0.8594767029709351,16.64877511111111,2039.7730453333334,15.034985123844537,123,9.400000000000018E-4
10,test_20231101_134802,11551286.png,271883,467,271416,0.9982823493929374,1,4,40092,67,40025,0.998328843659583,17.988837333333333,1870.894224,15.410311266718583,123,9.400000000000018E-4
1,test_20231101_134802,10404007.png,502730,23077,479653,0.954096632387166,2,4,61265,3328,57937,0.9456786093201665,25.358901333333332,3334.2294613333333,12.90084876245235,123,9.500000000000018E-4
2,test_20231101_134802,1254659.png,342646,78012,264634,0.7723247900165185,2,4,80080,10856,69224,0.8644355644355645,20.528035555555554,3070.871712,13.258186870279811,123,9.500000000000018E-4
3,test_20231101_134802,10188041.png,221231,10002,211229,0.9547893378414417,2,4,41731,1410,40321,0.9662121684119719,10.980083555555556,1061.9383306666666,17.8698106392361,123,9.500000000000018E-4
4,test_20231101_134802,10287332.png,216980,12767,204213,0.9411604756198728,2,4,22337,1747,20590,0.921788960021489,9.436826666666667,775.4438453333333,19.235300075188995,123,9.500000000000018E-4
5,test_20231101_134802,11610969.png,368720,27849,340871,0.9244711434150575,3,4,84111,4062,80049,0.9517066733245354,21.206458666666666,2901.9369866666666,13.503923830349978,123,9.500000000000018E-4
6,test_20231101_134802,10350842.png,212614,6467,206147,0.9695833764474587,2,3,42529,947,41582,0.9777328411201768,19.205194666666667,2350.2698026666667,14.419626402627658,123,9.500000000000018E-4
7,test_20231101_134802,10863862.png,317432,13197,304235,0.9584257415761486,2,4,66058,1907,64151,0.9711314299554936,23.723717333333333,3225.647888,13.044634028505238,123,9.500000000000018E-4
8,test_20231101_134802,11382381.png,312486,827,311659,0.9973534814359684,1,4,46745,109,46636,0.997668199807466,21.564144,2476.360432,14.192665047538828,123,9.500000000000018E-4
9,test_20231101_134802,11079715.png,443815,125192,318623,0.7179185020785688,3,4,124136,17444,106692,0.8594767029709351,16.64877511111111,2039.7730453333334,15.034985123844537,123,9.500000000000018E-4
10,test_20231101_134802,11551286.png,271883,467,271416,0.9982823493929374,1,3,40092,67,40025,0.998328843659583,17.988837333333333,1870.894224,15.410311266718583,123,9.500000000000018E-4
1,test_20231101_134803,10404007.png,502730,23077,479653,0.954096632387166,2,3,61265,3328,57937,0.9456786093201665,25.358901333333332,3334.2294613333333,12.90084876245235,123,9.600000000000019E-4
2,test_20231101_134803,1254659.png,342646,78012,264634,0.7723247900165185,3,4,80080,10856,69224,0.8644355644355645,20.528035555555554,3070.871712,13.258186870279811,123,9.600000000000019E-4
3,test_20231101_134803,10188041.png,221231,9902,211329,0.9552413540597837,2,3,41731,1399,40332,0.9664757614243608,11.027571555555555,1067.14536,17.84856780481708,123,9.600000000000019E-4
4,test_20231101_134803,10287332.png,216980,12767,204213,0.9411604756198728,2,4,22337,1747,20590,0.921788960021489,9.436826666666667,775.4438453333333,19.235300075188995,123,9.600000000000019E-4
5,test_20231101_134803,11610969.png,368720,27849,340871,0.9244711434150575,2,4,84111,4062,80049,0.9517066733245354,21.206458666666666,2901.9369866666666,13.503923830349978,123,9.600000000000019E-4
6,test_20231101_134803,10350842.png,212614,6467,206147,0.9695833764474587,2,4,42529,947,41582,0.9777328411201768,19.205194666666667,2350.2698026666667,14.419626402627658,123,9.600000000000019E-4
7,test_20231101_134803,10863862.png,317432,13197,304235,0.9584257415761486,2,4,66058,1907,64151,0.9711314299554936,23.723717333333333,3225.647888,13.044634028505238,123,9.600000000000019E-4
8,test_20231101_134803,11382381.png,312486,827,311659,0.9973534814359684,2,3,46745,109,46636,0.997668199807466,21.564144,2476.360432,14.192665047538828,123,9.600000000000019E-4
9,test_20231101_134803,11079715.png,443815,125192,318623,0.7179185020785688,3,4,124136,17444,106692,0.8594767029709351,16.64877511111111,2039.7730453333334,15.034985123844537,123,9.600000000000019E-4
10,test_20231101_134803,11551286.png,271883,467,271416,0.9982823493929374,1,3,40092,67,40025,0.998328843659583,17.988837333333333,1870.894224,15.410311266718583,123,9.600000000000019E-4
1,test_20231101_134804,10404007.png,502730,23077,479653,0.954096632387166,3,3,61265,3328,57937,0.9456786093201665,25.358901333333332,3334.2294613333333,12.90084876245235,123,9.700000000000019E-4
2,test_20231101_134804,1254659.png,342646,78012,264634,0.7723247900165185,3,4,80080,10856,69224,0.8644355644355645,20.528035555555554,3070.871712,13.258186870279811,123,9.700000000000019E-4
3,test_20231101_134804,10188041.png,221231,9902,211329,0.9552413540597837,2,4,41731,1399,40332,0.9664757614243608,11.027571555555555,1067.14536,17.84856780481708,123,9.700000000000019E-4
4,test_20231101_134804,10287332.png,216980,12767,204213,0.9411604756198728,1,3,22337,1747,20590,0.921788960021489,9.436826666666667,775.4438453333333,19.235300075188995,123,9.700000000000019E-4
5,test_20231101_134804,11610969.png,368720,27849,340871,0.9244711434150575,2,4,84111,4062,80049,0.9517066733245354,21.206458666666666,2901.9369866666666,13.503923830349978,123,9.700000000000019E-4
6,test_20231101_134804,10350842.png,212614,6467,206147,0.9695833764474587,1,3,42529,947,41582,0.9777328411201768,19.205194666666667,2350.2698026666667,14.419626402627658,123,9.700000000000019E-4
7,test_20231101_134804,10863862.png,317432,13197,304235,0.9584257415761486,2,4,66058,1907,64151,0.9711314299554936,23.723717333333333,3225.647888,13.044634028505238,123,9.700000000000019E-4
8,test_20231101_134804,11382381.png,312486,827,311659,0.9973534814359684,1,3,46745,109,46636,0.997668199807466,21.564144,2476.360432,14.192665047538828,123,9.700000000000019E-4
9,test_20231101_134804,11079715.png,443815,125192,318623,0.7179185020785688,3,4,124136,17444,106692,0.8594767029709351,16.64877511111111,2039.7730453333334,15.034985123844537,123,9.700000000000019E-4
10,test_20231101_134804,11551286.png,271883,467,271416,0.9982823493929374,1,4,40092,67,40025,0.998328843659583,17.988837333333333,1870.894224,15.410311266718583,123,9.700000000000019E-4
1,test_20231101_134804,10404007.png,502730,22452,480278,0.9553398444493068,3,4,61265,3246,58019,0.9470170570472537,25.653054222222224,3401.166714666667,12.814524406419615,123,9.80000000000002E-4
2,test_20231101_134804,1254659.png,342646,77812,264834,0.7729084828073288,3,4,80080,10838,69242,0.8646603396603396,20.601813333333332,3087.073888,13.235333365796425,123,9.80000000000002E-4
3,test_20231101_134804,10188041.png,221231,9782,211449,0.955783773521794,2,4,41731,1384,40347,0.9668352064412546,11.109484444444444,1081.6191946666668,17.790059751107275,123,9.80000000000002E-4
4,test_20231101_134804,10287332.png,216980,12747,204233,0.9412526500138262,2,3,22337,1744,20593,0.9219232663294086,9.462853333333333,779.8647306666667,19.21061081023097,123,9.80000000000002E-4
5,test_20231101_134804,11610969.png,368720,27547,341173,0.9252901931004556,3,5,84111,4025,80086,0.9521465682253213,21.362599111111113,2927.6268906666664,13.465646333072625,123,9.80000000000002E-4
6,test_20231101_134804,10350842.png,212614,6344,206270,0.9701618896215677,1,3,42529,929,41600,0.9781560817324649,19.35991111111111,2378.9286826666666,14.366989382457716,123,9.80000000000002E-4
7,test_20231101_134804,10863862.png,317432,12817,304615,0.9596228483580735,2,4,66058,1853,64205,0.971948893396712,23.90223111111111,3267.265936,12.988958759679466,123,9.80000000000002E-4
8,test_20231101_134804,11382381.png,312486,767,311719,0.9975454900379537,2,3,46745,101,46644,0.9978393411060006,21.620851555555557,2482.477712,14.181950028339719,123,9.80000000000002E-4
9,test_20231101_134804,11079715.png,443815,125112,318703,0.7180987573651183,3,4,124136,17438,106698,0.859525037056132,16.667505777777777,2042.6386346666666,15.02888818930283,123,9.80000000000002E-4
10,test_20231101_134804,11551286.png,271883,467,271416,0.9982823493929374,1,4,40092,67,40025,0.998328843659583,17.988837333333333,1870.894224,15.410311266718583,123,9.80000000000002E-4
1,test_20231101_134805,10404007.png,502730,22452,480278,0.9553398444493068,2,4,61265,3246,58019,0.9470170570472537,25.653054222222224,3401.166714666667,12.814524406419615,123,9.90000000000002E-4
2,test_20231101_134805,1254659.png,342646,77812,264834,0.7729084828073288,3,4,80080,10838,69242,0.8646603396603396,20.601813333333332,3087.073888,13.235333365796425,123,9.90000000000002E-4
3,test_20231101_134805,10188041.png,221231,9782,211449,0.955783773521794,2,4,41731,1384,40347,0.9668352064412546,11.109484444444444,1081.6191946666668,17.790059751107275,123,9.90000000000002E-4
4,test_20231101_134805,10287332.png,216980,12747,204233,0.9412526500138262,2,4,22337,1744,20593,0.9219232663294086,9.462853333333333,779.8647306666667,19.21061081023097,123,9.90000000000002E-4
5,test_20231101_134805,11610969.png,368720,27547,341173,0.9252901931004556,2,4,84111,4025,80086,0.9521465682253213,21.362599111111113,2927.6268906666664,13.465646333072625,123,9.90000000000002E-4
6,test_20231101_134805,10350842.png,212614,6344,206270,0.9701618896215677,2,4,42529,929,41600,0.9781560817324649,19.35991111111111,2378.9286826666666,14.366989382457716,123,9.90000000000002E-4
7,test_20231101_134805,10863862.png,317432,12817,304615,0.9596228483580735,2,4,66058,1853,64205,0.971948893396712,23.90223111111111,3267.265936,12.988958759679466,123,9.90000000000002E-4
8,test_20231101_134805,11382381.png,312486,767,311719,0.9975454900379537,1,4,46745,101,46644,0.9978393411060006,21.620851555555557,2482.477712,14.181950028339719,123,9.90000000000002E-4
9,test_20231101_134805,11079715.png,443815,125112,318703,0.7180987573651183,4,4,124136,17438,106698,0.859525037056132,16.667505777777777,2042.6386346666666,15.02888818930283,123,9.90000000000002E-4
10,test_20231101_134805,11551286.png,271883,467,271416,0.9982823493929374,1,4,40092,67,40025,0.998328843659583,17.988837333333333,1870.894224,15.410311266718583,123,9.90000000000002E-4
1,test_20231101_134806,10404007.png,502730,22884,479846,0.9544805362719552,2,4,61265,3295,57970,0.9462172529176528,25.586942222222223,3400.765381333333,12.815036898605106,124,0.0
2,test_20231101_134806,1254659.png,342646,76264,266382,0.7774262650082009,3,4,80080,10638,69442,0.8671578421578422,20.667370666666667,3113.3477866666667,13.198527231942004,124,0.0
3,test_20231101_134806,10188041.png,221231,10142,211089,0.954156515135763,2,3,41731,1428,40303,0.9657808343916993,10.476305777777778,997.11648,18.1433446668218,124,0.0
4,test_20231101_134806,10287332.png,216980,12897,204083,0.940561342059176,1,3,22337,1766,20571,0.9209383534046649,9.311077333333333,749.8733493333333,19.38092441916683,124,0.0
5,test_20231101_134806,11610969.png,368720,27227,341493,0.9261580603167715,3,3,84111,3970,80141,0.9528004660508138,20.228828444444446,2711.644832,13.798475553202607,124,0.0
6,test_20231101_134806,10350842.png,212614,6344,206270,0.9701618896215677,2,3,42529,929,41600,0.9781560817324649,19.196949333333333,2355.988128,14.409072631896374,124,0.0
7,test_20231101_134806,10863862.png,317432,12977,304455,0.9591188033972631,2,4,66058,1885,64173,0.9714644706167308,23.722218666666667,3236.9452053333334,13.029450130942488,124,0.0
8,test_20231101_134806,11382381.png,312486,1169,311317,0.9962590324046517,2,3,46745,159,46586,0.9965985666916247,19.758430222222223,2219.8571466666667,14.667553334490613,124,0.0
9,test_20231101_134806,11079715.png,443815,122782,321033,0.7233486925858748,4,4,124136,17120,107016,0.8620867435715667,16.763402666666668,2067.635402666667,14.97606401189655,124,0.0
10,test_20231101_134806,11551286.png,271883,1322,270561,0.9951376143414631,2,4,40092,194,39898,0.9951611294023746,15.753514666666666,1496.8890666666666,16.378907445727467,124,0.0
1,test_20231101_134806,10404007.png,502730,22884,479846,0.9544805362719552,2,4,61265,3295,57970,0.9462172529176528,25.586942222222223,3400.765381333333,12.815036898605106,124,1.0E-5
2,test_20231101_134806,1254659.png,342646,76264,266382,0.7774262650082009,3,4,80080,10638,69442,0.8671578421578422,20.667370666666667,3113.3477866666667,13.198527231942004,124,1.0E-5
3,test_20231101_134806,10188041.png,221231,10142,211089,0.954156515135763,2,3,41731,1428,40303,0.9657808343916993,10.476305777777778,997.11648,18.1433446668218,124,1.0E-5
4,test_20231101_134806,10287332.png,216980,12897,204083,0.940561342059176,2,3,22337,1766,20571,0.9209383534046649,9.311077333333333,749.8733493333333,19.38092441916683,124,1.0E-5
5,test_20231101_134806,11610969.png,368720,27227,341493,0.9261580603167715,3,4,84111,3970,80141,0.9528004660508138,20.228828444444446,2711.644832,13.798475553202607,124,1.0E-5
6,test_20231101_134806,10350842.png,212614,6344,206270,0.9701618896215677,2,4,42529,929,41600,0.9781560817324649,19.196949333333333,2355.988128,14.409072631896374,124,1.0E-5
7,test_20231101_134806,10863862.png,317432,12977,304455,0.9591188033972631,2,4,66058,1885,64173,0.9714644706167308,23.722218666666667,3236.9452053333334,13.029450130942488,124,1.0E-5
8,test_20231101_134806,11382381.png,312486,1169,311317,0.9962590324046517,2,4,46745,159,46586,0.9965985666916247,19.758430222222223,2219.8571466666667,14.667553334490613,124,1.0E-5
9,test_20231101_134806,11079715.png,443815,122782,321033,0.7233486925858748,4,4,124136,17120,107016,0.8620867435715667,16.763402666666668,2067.635402666667,14.97606401189655,124,1.0E-5
10,test_20231101_134806,11551286.png,271883,1322,270561,0.9951376143414631,2,3,40092,194,39898,0.9951611294023746,15.753514666666666,1496.8890666666666,16.378907445727467,124,1.0E-5
1,test_20231101_134807,10404007.png,502730,22884,479846,0.9544805362719552,2,3,61265,3295,57970,0.9462172529176528,25.586942222222223,3400.765381333333,12.815036898605106,124,2.0E-5
2,test_20231101_134807,1254659.png,342646,76264,266382,0.7774262650082009,3,4,80080,10638,69442,0.8671578421578422,20.667370666666667,3113.3477866666667,13.198527231942004,124,2.0E-5
3,test_20231101_134807,10188041.png,221231,10142,211089,0.954156515135763,2,4,41731,1428,40303,0.9657808343916993,10.476305777777778,997.11648,18.1433446668218,124,2.0E-5
4,test_20231101_134807,10287332.png,216980,12897,204083,0.940561342059176,2,4,22337,1766,20571,0.9209383534046649,9.311077333333333,749.8733493333333,19.38092441916683,124,2.0E-5
5,test_20231101_134807,11610969.png,368720,27227,341493,0.9261580603167715,2,4,84111,3970,80141,0.9528004660508138,20.228828444444446,2711.644832,13.798475553202607,124,2.0E-5
6,test_20231101_134807,10350842.png,212614,6344,206270,0.9701618896215677,1,4,42529,929,41600,0.9781560817324649,19.196949333333333,2355.988128,14.409072631896374,124,2.0E-5
7,test_20231101_134807,10863862.png,317432,12977,304455,0.9591188033972631,2,3,66058,1885,64173,0.9714644706167308,23.722218666666667,3236.9452053333334,13.029450130942488,124,2.0E-5
8,test_20231101_134807,11382381.png,312486,1169,311317,0.9962590324046517,2,3,46745,159,46586,0.9965985666916247,19.758430222222223,2219.8571466666667,14.667553334490613,124,2.0E-5
9,test_20231101_134807,11079715.png,443815,122782,321033,0.7233486925858748,3,4,124136,17120,107016,0.8620867435715667,16.763402666666668,2067.635402666667,14.97606401189655,124,2.0E-5
10,test_20231101_134807,11551286.png,271883,1322,270561,0.9951376143414631,1,5,40092,194,39898,0.9951611294023746,15.753514666666666,1496.8890666666666,16.378907445727467,124,2.0E-5
1,test_20231101_134808,10404007.png,502730,22884,479846,0.9544805362719552,3,3,61265,3295,57970,0.9462172529176528,25.586942222222223,3400.765381333333,12.815036898605106,124,3.0000000000000004E-5
2,test_20231101_134808,1254659.png,342646,76264,266382,0.7774262650082009,3,4,80080,10638,69442,0.8671578421578422,20.667370666666667,3113.3477866666667,13.198527231942004,124,3.0000000000000004E-5
3,test_20231101_134808,10188041.png,221231,10142,211089,0.954156515135763,2,3,41731,1428,40303,0.9657808343916993,10.476305777777778,997.11648,18.1433446668218,124,3.0000000000000004E-5
4,test_20231101_134808,10287332.png,216980,12897,204083,0.940561342059176,1,4,22337,1766,20571,0.9209383534046649,9.311077333333333,749.8733493333333,19.38092441916683,124,3.0000000000000004E-5
5,test_20231101_134808,11610969.png,368720,27227,341493,0.9261580603167715,2,4,84111,3970,80141,0.9528004660508138,20.228828444444446,2711.644832,13.798475553202607,124,3.0000000000000004E-5
6,test_20231101_134808,10350842.png,212614,6344,206270,0.9701618896215677,1,4,42529,929,41600,0.9781560817324649,19.196949333333333,2355.988128,14.409072631896374,124,3.0000000000000004E-5
7,test_20231101_134808,10863862.png,317432,12977,304455,0.9591188033972631,1,4,66058,1885,64173,0.9714644706167308,23.722218666666667,3236.9452053333334,13.029450130942488,124,3.0000000000000004E-5
8,test_20231101_134808,11382381.png,312486,1169,311317,0.9962590324046517,1,3,46745,159,46586,0.9965985666916247,19.758430222222223,2219.8571466666667,14.667553334490613,124,3.0000000000000004E-5
9,test_20231101_134808,11079715.png,443815,122782,321033,0.7233486925858748,3,4,124136,17120,107016,0.8620867435715667,16.763402666666668,2067.635402666667,14.97606401189655,124,3.0000000000000004E-5
10,test_20231101_134808,11551286.png,271883,1322,270561,0.9951376143414631,2,4,40092,194,39898,0.9951611294023746,15.753514666666666,1496.8890666666666,16.378907445727467,124,3.0000000000000004E-5
1,test_20231101_134808,10404007.png,502730,22884,479846,0.9544805362719552,2,4,61265,3295,57970,0.9462172529176528,25.586942222222223,3400.765381333333,12.815036898605106,124,4.0E-5
2,test_20231101_134808,1254659.png,342646,76264,266382,0.7774262650082009,2,4,80080,10638,69442,0.8671578421578422,20.667370666666667,3113.3477866666667,13.198527231942004,124,4.0E-5
3,test_20231101_134808,10188041.png,221231,10142,211089,0.954156515135763,2,4,41731,1428,40303,0.9657808343916993,10.476305777777778,997.11648,18.1433446668218,124,4.0E-5
4,test_20231101_134808,10287332.png,216980,12897,204083,0.940561342059176,1,4,22337,1766,20571,0.9209383534046649,9.311077333333333,749.8733493333333,19.38092441916683,124,4.0E-5
5,test_20231101_134808,11610969.png,368720,27227,341493,0.9261580603167715,3,4,84111,3970,80141,0.9528004660508138,20.228828444444446,2711.644832,13.798475553202607,124,4.0E-5
6,test_20231101_134808,10350842.png,212614,6344,206270,0.9701618896215677,1,4,42529,929,41600,0.9781560817324649,19.196949333333333,2355.988128,14.409072631896374,124,4.0E-5
7,test_20231101_134808,10863862.png,317432,12977,304455,0.9591188033972631,2,4,66058,1885,64173,0.9714644706167308,23.722218666666667,3236.9452053333334,13.029450130942488,124,4.0E-5
8,test_20231101_134808,11382381.png,312486,1169,311317,0.9962590324046517,2,3,46745,159,46586,0.9965985666916247,19.758430222222223,2219.8571466666667,14.667553334490613,124,4.0E-5
9,test_20231101_134808,11079715.png,443815,122782,321033,0.7233486925858748,3,5,124136,17120,107016,0.8620867435715667,16.763402666666668,2067.635402666667,14.97606401189655,124,4.0E-5
10,test_20231101_134808,11551286.png,271883,1322,270561,0.9951376143414631,1,4,40092,194,39898,0.9951611294023746,15.753514666666666,1496.8890666666666,16.378907445727467,124,4.0E-5
1,test_20231101_134809,10404007.png,502730,22884,479846,0.9544805362719552,2,4,61265,3295,57970,0.9462172529176528,25.586942222222223,3400.765381333333,12.815036898605106,124,5.0E-5
2,test_20231101_134809,1254659.png,342646,76264,266382,0.7774262650082009,5,4,80080,10638,69442,0.8671578421578422,20.667370666666667,3113.3477866666667,13.198527231942004,124,5.0E-5
3,test_20231101_134809,10188041.png,221231,10142,211089,0.954156515135763,2,4,41731,1428,40303,0.9657808343916993,10.476305777777778,997.11648,18.1433446668218,124,5.0E-5
4,test_20231101_134809,10287332.png,216980,12897,204083,0.940561342059176,2,4,22337,1766,20571,0.9209383534046649,9.311077333333333,749.8733493333333,19.38092441916683,124,5.0E-5
5,test_20231101_134809,11610969.png,368720,27227,341493,0.9261580603167715,2,4,84111,3970,80141,0.9528004660508138,20.228828444444446,2711.644832,13.798475553202607,124,5.0E-5
6,test_20231101_134809,10350842.png,212614,6344,206270,0.9701618896215677,2,4,42529,929,41600,0.9781560817324649,19.196949333333333,2355.988128,14.409072631896374,124,5.0E-5
7,test_20231101_134809,10863862.png,317432,12977,304455,0.9591188033972631,2,4,66058,1885,64173,0.9714644706167308,23.722218666666667,3236.9452053333334,13.029450130942488,124,5.0E-5
8,test_20231101_134809,11382381.png,312486,1099,311387,0.9964830424403013,2,3,46745,149,46596,0.996812493314793,20.626588444444444,2338.262816,14.441870374793048,124,5.0E-5
9,test_20231101_134809,11079715.png,443815,122782,321033,0.7233486925858748,4,4,124136,17120,107016,0.8620867435715667,16.763402666666668,2067.635402666667,14.97606401189655,124,5.0E-5
10,test_20231101_134809,11551286.png,271883,1322,270561,0.9951376143414631,2,3,40092,194,39898,0.9951611294023746,15.753514666666666,1496.8890666666666,16.378907445727467,124,5.0E-5
1,test_20231101_134810,10404007.png,502730,22884,479846,0.9544805362719552,3,4,61265,3295,57970,0.9462172529176528,25.586942222222223,3400.765381333333,12.815036898605106,124,6.0E-5
2,test_20231101_134810,1254659.png,342646,76264,266382,0.7774262650082009,3,4,80080,10638,69442,0.8671578421578422,20.667370666666667,3113.3477866666667,13.198527231942004,124,6.0E-5
3,test_20231101_134810,10188041.png,221231,10142,211089,0.954156515135763,1,3,41731,1428,40303,0.9657808343916993,10.476305777777778,997.11648,18.1433446668218,124,6.0E-5
4,test_20231101_134810,10287332.png,216980,12897,204083,0.940561342059176,2,4,22337,1766,20571,0.9209383534046649,9.311077333333333,749.8733493333333,19.38092441916683,124,6.0E-5
5,test_20231101_134810,11610969.png,368720,27227,341493,0.9261580603167715,2,4,84111,3970,80141,0.9528004660508138,20.228828444444446,2711.644832,13.798475553202607,124,6.0E-5
6,test_20231101_134810,10350842.png,212614,6344,206270,0.9701618896215677,1,4,42529,929,41600,0.9781560817324649,19.196949333333333,2355.988128,14.409072631896374,124,6.0E-5
7,test_20231101_134810,10863862.png,317432,12977,304455,0.9591188033972631,2,5,66058,1885,64173,0.9714644706167308,23.722218666666667,3236.9452053333334,13.029450130942488,124,6.0E-5
8,test_20231101_134810,11382381.png,312486,1099,311387,0.9964830424403013,2,4,46745,149,46596,0.996812493314793,20.626588444444444,2338.262816,14.441870374793048,124,6.0E-5
9,test_20231101_134810,11079715.png,443815,122782,321033,0.7233486925858748,3,4,124136,17120,107016,0.8620867435715667,16.763402666666668,2067.635402666667,14.97606401189655,124,6.0E-5
10,test_20231101_134810,11551286.png,271883,1322,270561,0.9951376143414631,2,3,40092,194,39898,0.9951611294023746,15.753514666666666,1496.8890666666666,16.378907445727467,124,6.0E-5
1,test_20231101_134810,10404007.png,502730,22884,479846,0.9544805362719552,2,4,61265,3295,57970,0.9462172529176528,25.586942222222223,3400.765381333333,12.815036898605106,124,7.000000000000001E-5
2,test_20231101_134810,1254659.png,342646,76264,266382,0.7774262650082009,2,3,80080,10638,69442,0.8671578421578422,20.667370666666667,3113.3477866666667,13.198527231942004,124,7.000000000000001E-5
3,test_20231101_134810,10188041.png,221231,10142,211089,0.954156515135763,1,3,41731,1428,40303,0.9657808343916993,10.476305777777778,997.11648,18.1433446668218,124,7.000000000000001E-5
4,test_20231101_134810,10287332.png,216980,12897,204083,0.940561342059176,2,4,22337,1766,20571,0.9209383534046649,9.311077333333333,749.8733493333333,19.38092441916683,124,7.000000000000001E-5
5,test_20231101_134810,11610969.png,368720,27227,341493,0.9261580603167715,2,4,84111,3970,80141,0.9528004660508138,20.228828444444446,2711.644832,13.798475553202607,124,7.000000000000001E-5
6,test_20231101_134810,10350842.png,212614,6344,206270,0.9701618896215677,1,3,42529,929,41600,0.9781560817324649,19.196949333333333,2355.988128,14.409072631896374,124,7.000000000000001E-5
7,test_20231101_134810,10863862.png,317432,12977,304455,0.9591188033972631,2,4,66058,1885,64173,0.9714644706167308,23.722218666666667,3236.9452053333334,13.029450130942488,124,7.000000000000001E-5
8,test_20231101_134810,11382381.png,312486,1099,311387,0.9964830424403013,2,3,46745,149,46596,0.996812493314793,20.626588444444444,2338.262816,14.441870374793048,124,7.000000000000001E-5
9,test_20231101_134810,11079715.png,443815,122782,321033,0.7233486925858748,4,5,124136,17120,107016,0.8620867435715667,16.763402666666668,2067.635402666667,14.97606401189655,124,7.000000000000001E-5
10,test_20231101_134810,11551286.png,271883,1199,270684,0.9955900148225524,1,4,40092,176,39916,0.995610096777412,15.83984888888889,1503.00104,16.36121079771285,124,7.000000000000001E-5
1,test_20231101_134811,10404007.png,502730,22884,479846,0.9544805362719552,3,3,61265,3295,57970,0.9462172529176528,25.586942222222223,3400.765381333333,12.815036898605106,124,8.0E-5
2,test_20231101_134811,1254659.png,342646,76264,266382,0.7774262650082009,2,8,80080,10638,69442,0.8671578421578422,20.667370666666667,3113.3477866666667,13.198527231942004,124,8.0E-5
3,test_20231101_134811,10188041.png,221231,10142,211089,0.954156515135763,2,4,41731,1428,40303,0.9657808343916993,10.476305777777778,997.11648,18.1433446668218,124,8.0E-5
4,test_20231101_134811,10287332.png,216980,12897,204083,0.940561342059176,2,3,22337,1766,20571,0.9209383534046649,9.311077333333333,749.8733493333333,19.38092441916683,124,8.0E-5
5,test_20231101_134811,11610969.png,368720,27227,341493,0.9261580603167715,2,4,84111,3970,80141,0.9528004660508138,20.228828444444446,2711.644832,13.798475553202607,124,8.0E-5
6,test_20231101_134811,10350842.png,212614,6344,206270,0.9701618896215677,1,4,42529,929,41600,0.9781560817324649,19.196949333333333,2355.988128,14.409072631896374,124,8.0E-5
7,test_20231101_134811,10863862.png,317432,12977,304455,0.9591188033972631,2,4,66058,1885,64173,0.9714644706167308,23.722218666666667,3236.9452053333334,13.029450130942488,124,8.0E-5
8,test_20231101_134811,11382381.png,312486,1099,311387,0.9964830424403013,2,4,46745,149,46596,0.996812493314793,20.626588444444444,2338.262816,14.441870374793048,124,8.0E-5
9,test_20231101_134811,11079715.png,443815,122782,321033,0.7233486925858748,3,5,124136,17120,107016,0.8620867435715667,16.763402666666668,2067.635402666667,14.97606401189655,124,8.0E-5
10,test_20231101_134811,11551286.png,271883,1199,270684,0.9955900148225524,2,3,40092,176,39916,0.995610096777412,15.83984888888889,1503.00104,16.36121079771285,124,8.0E-5
1,test_20231101_134812,10404007.png,502730,22884,479846,0.9544805362719552,2,4,61265,3295,57970,0.9462172529176528,25.586942222222223,3400.765381333333,12.815036898605106,124,9.0E-5
2,test_20231101_134812,1254659.png,342646,76264,266382,0.7774262650082009,3,4,80080,10638,69442,0.8671578421578422,20.667370666666667,3113.3477866666667,13.198527231942004,124,9.0E-5
3,test_20231101_134812,10188041.png,221231,10142,211089,0.954156515135763,2,3,41731,1428,40303,0.9657808343916993,10.476305777777778,997.11648,18.1433446668218,124,9.0E-5
4,test_20231101_134812,10287332.png,216980,12897,204083,0.940561342059176,2,3,22337,1766,20571,0.9209383534046649,9.311077333333333,749.8733493333333,19.38092441916683,124,9.0E-5
5,test_20231101_134812,11610969.png,368720,27227,341493,0.9261580603167715,2,4,84111,3970,80141,0.9528004660508138,20.228828444444446,2711.644832,13.798475553202607,124,9.0E-5
6,test_20231101_134812,10350842.png,212614,6344,206270,0.9701618896215677,2,4,42529,929,41600,0.9781560817324649,19.196949333333333,2355.988128,14.409072631896374,124,9.0E-5
7,test_20231101_134812,10863862.png,317432,12977,304455,0.9591188033972631,3,3,66058,1885,64173,0.9714644706167308,23.722218666666667,3236.9452053333334,13.029450130942488,124,9.0E-5
8,test_20231101_134812,11382381.png,312486,1099,311387,0.9964830424403013,1,4,46745,149,46596,0.996812493314793,20.626588444444444,2338.262816,14.441870374793048,124,9.0E-5
9,test_20231101_134812,11079715.png,443815,122782,321033,0.7233486925858748,3,5,124136,17120,107016,0.8620867435715667,16.763402666666668,2067.635402666667,14.97606401189655,124,9.0E-5
10,test_20231101_134812,11551286.png,271883,1199,270684,0.9955900148225524,1,4,40092,176,39916,0.995610096777412,15.83984888888889,1503.00104,16.36121079771285,124,9.0E-5
1,test_20231101_134813,10404007.png,502730,22884,479846,0.9544805362719552,2,4,61265,3295,57970,0.9462172529176528,25.586942222222223,3400.765381333333,12.815036898605106,124,1.0E-4
2,test_20231101_134813,1254659.png,342646,76264,266382,0.7774262650082009,3,4,80080,10638,69442,0.8671578421578422,20.667370666666667,3113.3477866666667,13.198527231942004,124,1.0E-4
3,test_20231101_134813,10188041.png,221231,10142,211089,0.954156515135763,2,3,41731,1428,40303,0.9657808343916993,10.476305777777778,997.11648,18.1433446668218,124,1.0E-4
4,test_20231101_134813,10287332.png,216980,12897,204083,0.940561342059176,3,4,22337,1766,20571,0.9209383534046649,9.311077333333333,749.8733493333333,19.38092441916683,124,1.0E-4
5,test_20231101_134813,11610969.png,368720,27227,341493,0.9261580603167715,2,3,84111,3970,80141,0.9528004660508138,20.228828444444446,2711.644832,13.798475553202607,124,1.0E-4
6,test_20231101_134813,10350842.png,212614,6344,206270,0.9701618896215677,2,3,42529,929,41600,0.9781560817324649,19.196949333333333,2355.988128,14.409072631896374,124,1.0E-4
7,test_20231101_134813,10863862.png,317432,12977,304455,0.9591188033972631,2,3,66058,1885,64173,0.9714644706167308,23.722218666666667,3236.9452053333334,13.029450130942488,124,1.0E-4
8,test_20231101_134813,11382381.png,312486,1099,311387,0.9964830424403013,1,3,46745,149,46596,0.996812493314793,20.626588444444444,2338.262816,14.441870374793048,124,1.0E-4
9,test_20231101_134813,11079715.png,443815,122782,321033,0.7233486925858748,3,4,124136,17120,107016,0.8620867435715667,16.763402666666668,2067.635402666667,14.97606401189655,124,1.0E-4
10,test_20231101_134813,11551286.png,271883,1199,270684,0.9955900148225524,2,3,40092,176,39916,0.995610096777412,15.83984888888889,1503.00104,16.36121079771285,124,1.0E-4
1,test_20231101_134813,10404007.png,502730,22884,479846,0.9544805362719552,3,4,61265,3295,57970,0.9462172529176528,25.586942222222223,3400.765381333333,12.815036898605106,124,1.1E-4
2,test_20231101_134813,1254659.png,342646,76264,266382,0.7774262650082009,3,4,80080,10638,69442,0.8671578421578422,20.667370666666667,3113.3477866666667,13.198527231942004,124,1.1E-4
3,test_20231101_134813,10188041.png,221231,10142,211089,0.954156515135763,1,3,41731,1428,40303,0.9657808343916993,10.476305777777778,997.11648,18.1433446668218,124,1.1E-4
4,test_20231101_134813,10287332.png,216980,12897,204083,0.940561342059176,2,4,22337,1766,20571,0.9209383534046649,9.311077333333333,749.8733493333333,19.38092441916683,124,1.1E-4
5,test_20231101_134813,11610969.png,368720,27227,341493,0.9261580603167715,2,4,84111,3970,80141,0.9528004660508138,20.228828444444446,2711.644832,13.798475553202607,124,1.1E-4
6,test_20231101_134813,10350842.png,212614,6344,206270,0.9701618896215677,1,4,42529,929,41600,0.9781560817324649,19.196949333333333,2355.988128,14.409072631896374,124,1.1E-4
7,test_20231101_134813,10863862.png,317432,12977,304455,0.9591188033972631,2,3,66058,1885,64173,0.9714644706167308,23.722218666666667,3236.9452053333334,13.029450130942488,124,1.1E-4
8,test_20231101_134813,11382381.png,312486,1099,311387,0.9964830424403013,1,3,46745,149,46596,0.996812493314793,20.626588444444444,2338.262816,14.441870374793048,124,1.1E-4
9,test_20231101_134813,11079715.png,443815,122782,321033,0.7233486925858748,4,4,124136,17120,107016,0.8620867435715667,16.763402666666668,2067.635402666667,14.97606401189655,124,1.1E-4
10,test_20231101_134813,11551286.png,271883,1199,270684,0.9955900148225524,2,3,40092,176,39916,0.995610096777412,15.83984888888889,1503.00104,16.36121079771285,124,1.1E-4
1,test_20231101_134814,10404007.png,502730,22884,479846,0.9544805362719552,3,3,61265,3295,57970,0.9462172529176528,25.586942222222223,3400.765381333333,12.815036898605106,124,1.2E-4
2,test_20231101_134814,1254659.png,342646,76264,266382,0.7774262650082009,3,4,80080,10638,69442,0.8671578421578422,20.667370666666667,3113.3477866666667,13.198527231942004,124,1.2E-4
3,test_20231101_134814,10188041.png,221231,10142,211089,0.954156515135763,2,4,41731,1428,40303,0.9657808343916993,10.476305777777778,997.11648,18.1433446668218,124,1.2E-4
4,test_20231101_134814,10287332.png,216980,12897,204083,0.940561342059176,1,3,22337,1766,20571,0.9209383534046649,9.311077333333333,749.8733493333333,19.38092441916683,124,1.2E-4
5,test_20231101_134814,11610969.png,368720,27227,341493,0.9261580603167715,3,4,84111,3970,80141,0.9528004660508138,20.228828444444446,2711.644832,13.798475553202607,124,1.2E-4
6,test_20231101_134814,10350842.png,212614,6344,206270,0.9701618896215677,2,4,42529,929,41600,0.9781560817324649,19.196949333333333,2355.988128,14.409072631896374,124,1.2E-4
7,test_20231101_134814,10863862.png,317432,12977,304455,0.9591188033972631,2,4,66058,1885,64173,0.9714644706167308,23.722218666666667,3236.9452053333334,13.029450130942488,124,1.2E-4
8,test_20231101_134814,11382381.png,312486,1099,311387,0.9964830424403013,2,3,46745,149,46596,0.996812493314793,20.626588444444444,2338.262816,14.441870374793048,124,1.2E-4
9,test_20231101_134814,11079715.png,443815,122782,321033,0.7233486925858748,3,4,124136,17120,107016,0.8620867435715667,16.763402666666668,2067.635402666667,14.97606401189655,124,1.2E-4
10,test_20231101_134814,11551286.png,271883,1199,270684,0.9955900148225524,1,3,40092,176,39916,0.995610096777412,15.83984888888889,1503.00104,16.36121079771285,124,1.2E-4
1,test_20231101_134815,10404007.png,502730,22884,479846,0.9544805362719552,2,3,61265,3295,57970,0.9462172529176528,25.586942222222223,3400.765381333333,12.815036898605106,124,1.3000000000000002E-4
2,test_20231101_134815,1254659.png,342646,76264,266382,0.7774262650082009,3,4,80080,10638,69442,0.8671578421578422,20.667370666666667,3113.3477866666667,13.198527231942004,124,1.3000000000000002E-4
3,test_20231101_134815,10188041.png,221231,10142,211089,0.954156515135763,2,3,41731,1428,40303,0.9657808343916993,10.476305777777778,997.11648,18.1433446668218,124,1.3000000000000002E-4
4,test_20231101_134815,10287332.png,216980,12897,204083,0.940561342059176,1,3,22337,1766,20571,0.9209383534046649,9.311077333333333,749.8733493333333,19.38092441916683,124,1.3000000000000002E-4
5,test_20231101_134815,11610969.png,368720,27227,341493,0.9261580603167715,2,4,84111,3970,80141,0.9528004660508138,20.228828444444446,2711.644832,13.798475553202607,124,1.3000000000000002E-4
6,test_20231101_134815,10350842.png,212614,6344,206270,0.9701618896215677,1,3,42529,929,41600,0.9781560817324649,19.196949333333333,2355.988128,14.409072631896374,124,1.3000000000000002E-4
7,test_20231101_134815,10863862.png,317432,12977,304455,0.9591188033972631,2,3,66058,1885,64173,0.9714644706167308,23.722218666666667,3236.9452053333334,13.029450130942488,124,1.3000000000000002E-4
8,test_20231101_134815,11382381.png,312486,1099,311387,0.9964830424403013,2,4,46745,149,46596,0.996812493314793,20.626588444444444,2338.262816,14.441870374793048,124,1.3000000000000002E-4
9,test_20231101_134815,11079715.png,443815,122782,321033,0.7233486925858748,4,4,124136,17120,107016,0.8620867435715667,16.763402666666668,2067.635402666667,14.97606401189655,124,1.3000000000000002E-4
10,test_20231101_134815,11551286.png,271883,997,270886,0.9963329814662925,1,3,40092,146,39946,0.9963583757358077,16.30040888888889,1591.9994026666666,16.11137460417654,124,1.3000000000000002E-4
1,test_20231101_134815,10404007.png,502730,22884,479846,0.9544805362719552,2,4,61265,3295,57970,0.9462172529176528,25.586942222222223,3400.765381333333,12.815036898605106,124,1.4000000000000001E-4
2,test_20231101_134815,1254659.png,342646,76264,266382,0.7774262650082009,3,4,80080,10638,69442,0.8671578421578422,20.667370666666667,3113.3477866666667,13.198527231942004,124,1.4000000000000001E-4
3,test_20231101_134815,10188041.png,221231,10142,211089,0.954156515135763,2,4,41731,1428,40303,0.9657808343916993,10.476305777777778,997.11648,18.1433446668218,124,1.4000000000000001E-4
4,test_20231101_134815,10287332.png,216980,12897,204083,0.940561342059176,2,4,22337,1766,20571,0.9209383534046649,9.311077333333333,749.8733493333333,19.38092441916683,124,1.4000000000000001E-4
5,test_20231101_134815,11610969.png,368720,27227,341493,0.9261580603167715,2,4,84111,3970,80141,0.9528004660508138,20.228828444444446,2711.644832,13.798475553202607,124,1.4000000000000001E-4
6,test_20231101_134815,10350842.png,212614,6344,206270,0.9701618896215677,2,4,42529,929,41600,0.9781560817324649,19.196949333333333,2355.988128,14.409072631896374,124,1.4000000000000001E-4
7,test_20231101_134815,10863862.png,317432,12977,304455,0.9591188033972631,2,3,66058,1885,64173,0.9714644706167308,23.722218666666667,3236.9452053333334,13.029450130942488,124,1.4000000000000001E-4
8,test_20231101_134815,11382381.png,312486,1099,311387,0.9964830424403013,1,3,46745,149,46596,0.996812493314793,20.626588444444444,2338.262816,14.441870374793048,124,1.4000000000000001E-4
9,test_20231101_134815,11079715.png,443815,122782,321033,0.7233486925858748,3,25,124136,17120,107016,0.8620867435715667,16.763402666666668,2067.635402666667,14.97606401189655,124,1.4000000000000001E-4
10,test_20231101_134815,11551286.png,271883,997,270886,0.9963329814662925,2,4,40092,146,39946,0.9963583757358077,16.30040888888889,1591.9994026666666,16.11137460417654,124,1.4000000000000001E-4
1,test_20231101_134816,10404007.png,502730,22884,479846,0.9544805362719552,2,4,61265,3295,57970,0.9462172529176528,25.586942222222223,3400.765381333333,12.815036898605106,124,1.5000000000000001E-4
2,test_20231101_134816,1254659.png,342646,76264,266382,0.7774262650082009,3,4,80080,10638,69442,0.8671578421578422,20.667370666666667,3113.3477866666667,13.198527231942004,124,1.5000000000000001E-4
3,test_20231101_134816,10188041.png,221231,10142,211089,0.954156515135763,2,4,41731,1428,40303,0.9657808343916993,10.476305777777778,997.11648,18.1433446668218,124,1.5000000000000001E-4
4,test_20231101_134816,10287332.png,216980,12897,204083,0.940561342059176,2,3,22337,1766,20571,0.9209383534046649,9.311077333333333,749.8733493333333,19.38092441916683,124,1.5000000000000001E-4
5,test_20231101_134816,11610969.png,368720,27227,341493,0.9261580603167715,2,4,84111,3970,80141,0.9528004660508138,20.228828444444446,2711.644832,13.798475553202607,124,1.5000000000000001E-4
6,test_20231101_134816,10350842.png,212614,6344,206270,0.9701618896215677,1,4,42529,929,41600,0.9781560817324649,19.196949333333333,2355.988128,14.409072631896374,124,1.5000000000000001E-4
7,test_20231101_134816,10863862.png,317432,12977,304455,0.9591188033972631,1,3,66058,1885,64173,0.9714644706167308,23.722218666666667,3236.9452053333334,13.029450130942488,124,1.5000000000000001E-4
8,test_20231101_134816,11382381.png,312486,1099,311387,0.9964830424403013,2,3,46745,149,46596,0.996812493314793,20.626588444444444,2338.262816,14.441870374793048,124,1.5000000000000001E-4
9,test_20231101_134816,11079715.png,443815,122782,321033,0.7233486925858748,3,4,124136,17120,107016,0.8620867435715667,16.763402666666668,2067.635402666667,14.97606401189655,124,1.5000000000000001E-4
10,test_20231101_134816,11551286.png,271883,997,270886,0.9963329814662925,2,3,40092,146,39946,0.9963583757358077,16.30040888888889,1591.9994026666666,16.11137460417654,124,1.5000000000000001E-4
1,test_20231101_134817,10404007.png,502730,22884,479846,0.9544805362719552,2,3,61265,3295,57970,0.9462172529176528,25.586942222222223,3400.765381333333,12.815036898605106,124,1.6E-4
2,test_20231101_134817,1254659.png,342646,76264,266382,0.7774262650082009,3,4,80080,10638,69442,0.8671578421578422,20.667370666666667,3113.3477866666667,13.198527231942004,124,1.6E-4
3,test_20231101_134817,10188041.png,221231,10142,211089,0.954156515135763,2,4,41731,1428,40303,0.9657808343916993,10.476305777777778,997.11648,18.1433446668218,124,1.6E-4
4,test_20231101_134817,10287332.png,216980,12687,204293,0.9415291731956862,2,3,22337,1739,20598,0.9221471101759413,9.440839111111112,776.604096,19.22880684076492,124,1.6E-4
5,test_20231101_134817,11610969.png,368720,27227,341493,0.9261580603167715,2,4,84111,3970,80141,0.9528004660508138,20.228828444444446,2711.644832,13.798475553202607,124,1.6E-4
6,test_20231101_134817,10350842.png,212614,6344,206270,0.9701618896215677,1,3,42529,929,41600,0.9781560817324649,19.196949333333333,2355.988128,14.409072631896374,124,1.6E-4
7,test_20231101_134817,10863862.png,317432,12977,304455,0.9591188033972631,2,4,66058,1885,64173,0.9714644706167308,23.722218666666667,3236.9452053333334,13.029450130942488,124,1.6E-4
8,test_20231101_134817,11382381.png,312486,1099,311387,0.9964830424403013,2,3,46745,149,46596,0.996812493314793,20.626588444444444,2338.262816,14.441870374793048,124,1.6E-4
9,test_20231101_134817,11079715.png,443815,122782,321033,0.7233486925858748,3,5,124136,17120,107016,0.8620867435715667,16.763402666666668,2067.635402666667,14.97606401189655,124,1.6E-4
10,test_20231101_134817,11551286.png,271883,997,270886,0.9963329814662925,1,4,40092,146,39946,0.9963583757358077,16.30040888888889,1591.9994026666666,16.11137460417654,124,1.6E-4
1,test_20231101_134817,10404007.png,502730,22884,479846,0.9544805362719552,3,4,61265,3295,57970,0.9462172529176528,25.586942222222223,3400.765381333333,12.815036898605106,124,1.7E-4
2,test_20231101_134817,1254659.png,342646,76264,266382,0.7774262650082009,3,4,80080,10638,69442,0.8671578421578422,20.667370666666667,3113.3477866666667,13.198527231942004,124,1.7E-4
3,test_20231101_134817,10188041.png,221231,10142,211089,0.954156515135763,2,4,41731,1428,40303,0.9657808343916993,10.476305777777778,997.11648,18.1433446668218,124,1.7E-4
4,test_20231101_134817,10287332.png,216980,12687,204293,0.9415291731956862,2,4,22337,1739,20598,0.9221471101759413,9.440839111111112,776.604096,19.22880684076492,124,1.7E-4
5,test_20231101_134817,11610969.png,368720,27227,341493,0.9261580603167715,2,4,84111,3970,80141,0.9528004660508138,20.228828444444446,2711.644832,13.798475553202607,124,1.7E-4
6,test_20231101_134817,10350842.png,212614,6344,206270,0.9701618896215677,1,4,42529,929,41600,0.9781560817324649,19.196949333333333,2355.988128,14.409072631896374,124,1.7E-4
7,test_20231101_134817,10863862.png,317432,12977,304455,0.9591188033972631,2,4,66058,1885,64173,0.9714644706167308,23.722218666666667,3236.9452053333334,13.029450130942488,124,1.7E-4
8,test_20231101_134817,11382381.png,312486,1099,311387,0.9964830424403013,2,4,46745,149,46596,0.996812493314793,20.626588444444444,2338.262816,14.441870374793048,124,1.7E-4
9,test_20231101_134817,11079715.png,443815,122782,321033,0.7233486925858748,4,4,124136,17120,107016,0.8620867435715667,16.763402666666668,2067.635402666667,14.97606401189655,124,1.7E-4
10,test_20231101_134817,11551286.png,271883,997,270886,0.9963329814662925,1,4,40092,146,39946,0.9963583757358077,16.30040888888889,1591.9994026666666,16.11137460417654,124,1.7E-4
1,test_20231101_134818,10404007.png,502730,22884,479846,0.9544805362719552,2,3,61265,3295,57970,0.9462172529176528,25.586942222222223,3400.765381333333,12.815036898605106,124,1.8E-4
2,test_20231101_134818,1254659.png,342646,76264,266382,0.7774262650082009,3,13,80080,10638,69442,0.8671578421578422,20.667370666666667,3113.3477866666667,13.198527231942004,124,1.8E-4
3,test_20231101_134818,10188041.png,221231,10142,211089,0.954156515135763,2,3,41731,1428,40303,0.9657808343916993,10.476305777777778,997.11648,18.1433446668218,124,1.8E-4
4,test_20231101_134818,10287332.png,216980,12687,204293,0.9415291731956862,2,4,22337,1739,20598,0.9221471101759413,9.440839111111112,776.604096,19.22880684076492,124,1.8E-4
5,test_20231101_134818,11610969.png,368720,27227,341493,0.9261580603167715,2,3,84111,3970,80141,0.9528004660508138,20.228828444444446,2711.644832,13.798475553202607,124,1.8E-4
6,test_20231101_134818,10350842.png,212614,6344,206270,0.9701618896215677,2,4,42529,929,41600,0.9781560817324649,19.196949333333333,2355.988128,14.409072631896374,124,1.8E-4
7,test_20231101_134818,10863862.png,317432,12977,304455,0.9591188033972631,2,4,66058,1885,64173,0.9714644706167308,23.722218666666667,3236.9452053333334,13.029450130942488,124,1.8E-4
8,test_20231101_134818,11382381.png,312486,1099,311387,0.9964830424403013,1,4,46745,149,46596,0.996812493314793,20.626588444444444,2338.262816,14.441870374793048,124,1.8E-4
9,test_20231101_134818,11079715.png,443815,122782,321033,0.7233486925858748,4,4,124136,17120,107016,0.8620867435715667,16.763402666666668,2067.635402666667,14.97606401189655,124,1.8E-4
10,test_20231101_134818,11551286.png,271883,997,270886,0.9963329814662925,1,3,40092,146,39946,0.9963583757358077,16.30040888888889,1591.9994026666666,16.11137460417654,124,1.8E-4
1,test_20231101_134819,10404007.png,502730,22884,479846,0.9544805362719552,3,3,61265,3295,57970,0.9462172529176528,25.586942222222223,3400.765381333333,12.815036898605106,124,1.9E-4
2,test_20231101_134819,1254659.png,342646,76264,266382,0.7774262650082009,3,4,80080,10638,69442,0.8671578421578422,20.667370666666667,3113.3477866666667,13.198527231942004,124,1.9E-4
3,test_20231101_134819,10188041.png,221231,10142,211089,0.954156515135763,2,4,41731,1428,40303,0.9657808343916993,10.476305777777778,997.11648,18.1433446668218,124,1.9E-4
4,test_20231101_134819,10287332.png,216980,12687,204293,0.9415291731956862,2,4,22337,1739,20598,0.9221471101759413,9.440839111111112,776.604096,19.22880684076492,124,1.9E-4
5,test_20231101_134819,11610969.png,368720,27227,341493,0.9261580603167715,2,4,84111,3970,80141,0.9528004660508138,20.228828444444446,2711.644832,13.798475553202607,124,1.9E-4
6,test_20231101_134819,10350842.png,212614,6344,206270,0.9701618896215677,1,4,42529,929,41600,0.9781560817324649,19.196949333333333,2355.988128,14.409072631896374,124,1.9E-4
7,test_20231101_134819,10863862.png,317432,12977,304455,0.9591188033972631,2,3,66058,1885,64173,0.9714644706167308,23.722218666666667,3236.9452053333334,13.029450130942488,124,1.9E-4
8,test_20231101_134819,11382381.png,312486,1099,311387,0.9964830424403013,2,4,46745,149,46596,0.996812493314793,20.626588444444444,2338.262816,14.441870374793048,124,1.9E-4
9,test_20231101_134819,11079715.png,443815,122782,321033,0.7233486925858748,3,4,124136,17120,107016,0.8620867435715667,16.763402666666668,2067.635402666667,14.97606401189655,124,1.9E-4
10,test_20231101_134819,11551286.png,271883,997,270886,0.9963329814662925,1,3,40092,146,39946,0.9963583757358077,16.30040888888889,1591.9994026666666,16.11137460417654,124,1.9E-4
1,test_20231101_134819,10404007.png,502730,22884,479846,0.9544805362719552,2,3,61265,3295,57970,0.9462172529176528,25.586942222222223,3400.765381333333,12.815036898605106,124,2.0E-4
2,test_20231101_134819,1254659.png,342646,76264,266382,0.7774262650082009,3,4,80080,10638,69442,0.8671578421578422,20.667370666666667,3113.3477866666667,13.198527231942004,124,2.0E-4
3,test_20231101_134819,10188041.png,221231,10142,211089,0.954156515135763,3,4,41731,1428,40303,0.9657808343916993,10.476305777777778,997.11648,18.1433446668218,124,2.0E-4
4,test_20231101_134819,10287332.png,216980,12687,204293,0.9415291731956862,1,12,22337,1739,20598,0.9221471101759413,9.440839111111112,776.604096,19.22880684076492,124,2.0E-4
5,test_20231101_134819,11610969.png,368720,27227,341493,0.9261580603167715,2,3,84111,3970,80141,0.9528004660508138,20.228828444444446,2711.644832,13.798475553202607,124,2.0E-4
6,test_20231101_134819,10350842.png,212614,6344,206270,0.9701618896215677,2,3,42529,929,41600,0.9781560817324649,19.196949333333333,2355.988128,14.409072631896374,124,2.0E-4
7,test_20231101_134819,10863862.png,317432,12977,304455,0.9591188033972631,2,3,66058,1885,64173,0.9714644706167308,23.722218666666667,3236.9452053333334,13.029450130942488,124,2.0E-4
8,test_20231101_134819,11382381.png,312486,907,311579,0.9970974699666545,2,4,46745,121,46624,0.9974114878596642,21.088220444444445,2409.5101546666665,14.311515999312824,124,2.0E-4
9,test_20231101_134819,11079715.png,443815,122782,321033,0.7233486925858748,4,4,124136,17120,107016,0.8620867435715667,16.763402666666668,2067.635402666667,14.97606401189655,124,2.0E-4
10,test_20231101_134819,11551286.png,271883,977,270906,0.9964065425201282,1,4,40092,143,39949,0.9964332036316472,17.00562311111111,1711.9347146666667,15.795931622093908,124,2.0E-4
1,test_20231101_134820,10404007.png,502730,22884,479846,0.9544805362719552,2,3,61265,3295,57970,0.9462172529176528,25.586942222222223,3400.765381333333,12.815036898605106,124,2.1E-4
2,test_20231101_134820,1254659.png,342646,76264,266382,0.7774262650082009,2,4,80080,10638,69442,0.8671578421578422,20.667370666666667,3113.3477866666667,13.198527231942004,124,2.1E-4
3,test_20231101_134820,10188041.png,221231,10142,211089,0.954156515135763,2,4,41731,1428,40303,0.9657808343916993,10.476305777777778,997.11648,18.1433446668218,124,2.1E-4
4,test_20231101_134820,10287332.png,216980,12687,204293,0.9415291731956862,2,3,22337,1739,20598,0.9221471101759413,9.440839111111112,776.604096,19.22880684076492,124,2.1E-4
5,test_20231101_134820,11610969.png,368720,27227,341493,0.9261580603167715,2,4,84111,3970,80141,0.9528004660508138,20.228828444444446,2711.644832,13.798475553202607,124,2.1E-4
6,test_20231101_134820,10350842.png,212614,6344,206270,0.9701618896215677,2,3,42529,929,41600,0.9781560817324649,19.196949333333333,2355.988128,14.409072631896374,124,2.1E-4
7,test_20231101_134820,10863862.png,317432,12977,304455,0.9591188033972631,1,3,66058,1885,64173,0.9714644706167308,23.722218666666667,3236.9452053333334,13.029450130942488,124,2.1E-4
8,test_20231101_134820,11382381.png,312486,907,311579,0.9970974699666545,1,3,46745,121,46624,0.9974114878596642,21.088220444444445,2409.5101546666665,14.311515999312824,124,2.1E-4
9,test_20231101_134820,11079715.png,443815,122782,321033,0.7233486925858748,3,4,124136,17120,107016,0.8620867435715667,16.763402666666668,2067.635402666667,14.97606401189655,124,2.1E-4
10,test_20231101_134820,11551286.png,271883,977,270906,0.9964065425201282,1,4,40092,143,39949,0.9964332036316472,17.00562311111111,1711.9347146666667,15.795931622093908,124,2.1E-4
1,test_20231101_134821,10404007.png,502730,22884,479846,0.9544805362719552,3,4,61265,3295,57970,0.9462172529176528,25.586942222222223,3400.765381333333,12.815036898605106,124,2.2E-4
2,test_20231101_134821,1254659.png,342646,76264,266382,0.7774262650082009,3,4,80080,10638,69442,0.8671578421578422,20.667370666666667,3113.3477866666667,13.198527231942004,124,2.2E-4
3,test_20231101_134821,10188041.png,221231,10142,211089,0.954156515135763,2,3,41731,1428,40303,0.9657808343916993,10.476305777777778,997.11648,18.1433446668218,124,2.2E-4
4,test_20231101_134821,10287332.png,216980,12687,204293,0.9415291731956862,2,4,22337,1739,20598,0.9221471101759413,9.440839111111112,776.604096,19.22880684076492,124,2.2E-4
5,test_20231101_134821,11610969.png,368720,27227,341493,0.9261580603167715,3,4,84111,3970,80141,0.9528004660508138,20.228828444444446,2711.644832,13.798475553202607,124,2.2E-4
6,test_20231101_134821,10350842.png,212614,6344,206270,0.9701618896215677,1,4,42529,929,41600,0.9781560817324649,19.196949333333333,2355.988128,14.409072631896374,124,2.2E-4
7,test_20231101_134821,10863862.png,317432,12977,304455,0.9591188033972631,2,3,66058,1885,64173,0.9714644706167308,23.722218666666667,3236.9452053333334,13.029450130942488,124,2.2E-4
8,test_20231101_134821,11382381.png,312486,907,311579,0.9970974699666545,2,3,46745,121,46624,0.9974114878596642,21.088220444444445,2409.5101546666665,14.311515999312824,124,2.2E-4
9,test_20231101_134821,11079715.png,443815,122782,321033,0.7233486925858748,4,4,124136,17120,107016,0.8620867435715667,16.763402666666668,2067.635402666667,14.97606401189655,124,2.2E-4
10,test_20231101_134821,11551286.png,271883,977,270906,0.9964065425201282,1,4,40092,143,39949,0.9964332036316472,17.00562311111111,1711.9347146666667,15.795931622093908,124,2.2E-4
1,test_20231101_134821,10404007.png,502730,22884,479846,0.9544805362719552,2,3,61265,3295,57970,0.9462172529176528,25.586942222222223,3400.765381333333,12.815036898605106,124,2.3E-4
2,test_20231101_134821,1254659.png,342646,76264,266382,0.7774262650082009,2,4,80080,10638,69442,0.8671578421578422,20.667370666666667,3113.3477866666667,13.198527231942004,124,2.3E-4
3,test_20231101_134821,10188041.png,221231,10142,211089,0.954156515135763,2,4,41731,1428,40303,0.9657808343916993,10.476305777777778,997.11648,18.1433446668218,124,2.3E-4
4,test_20231101_134821,10287332.png,216980,12687,204293,0.9415291731956862,2,4,22337,1739,20598,0.9221471101759413,9.440839111111112,776.604096,19.22880684076492,124,2.3E-4
5,test_20231101_134821,11610969.png,368720,27227,341493,0.9261580603167715,2,3,84111,3970,80141,0.9528004660508138,20.228828444444446,2711.644832,13.798475553202607,124,2.3E-4
6,test_20231101_134821,10350842.png,212614,6344,206270,0.9701618896215677,1,3,42529,929,41600,0.9781560817324649,19.196949333333333,2355.988128,14.409072631896374,124,2.3E-4
7,test_20231101_134821,10863862.png,317432,12977,304455,0.9591188033972631,2,4,66058,1885,64173,0.9714644706167308,23.722218666666667,3236.9452053333334,13.029450130942488,124,2.3E-4
8,test_20231101_134821,11382381.png,312486,907,311579,0.9970974699666545,2,4,46745,121,46624,0.9974114878596642,21.088220444444445,2409.5101546666665,14.311515999312824,124,2.3E-4
9,test_20231101_134821,11079715.png,443815,122782,321033,0.7233486925858748,3,4,124136,17120,107016,0.8620867435715667,16.763402666666668,2067.635402666667,14.97606401189655,124,2.3E-4
10,test_20231101_134821,11551286.png,271883,977,270906,0.9964065425201282,1,3,40092,143,39949,0.9964332036316472,17.00562311111111,1711.9347146666667,15.795931622093908,124,2.3E-4
1,test_20231101_134822,10404007.png,502730,22884,479846,0.9544805362719552,2,3,61265,3295,57970,0.9462172529176528,25.586942222222223,3400.765381333333,12.815036898605106,124,2.4E-4
2,test_20231101_134822,1254659.png,342646,76264,266382,0.7774262650082009,2,4,80080,10638,69442,0.8671578421578422,20.667370666666667,3113.3477866666667,13.198527231942004,124,2.4E-4
3,test_20231101_134822,10188041.png,221231,10142,211089,0.954156515135763,1,3,41731,1428,40303,0.9657808343916993,10.476305777777778,997.11648,18.1433446668218,124,2.4E-4
4,test_20231101_134822,10287332.png,216980,12687,204293,0.9415291731956862,1,4,22337,1739,20598,0.9221471101759413,9.440839111111112,776.604096,19.22880684076492,124,2.4E-4
5,test_20231101_134822,11610969.png,368720,27227,341493,0.9261580603167715,2,4,84111,3970,80141,0.9528004660508138,20.228828444444446,2711.644832,13.798475553202607,124,2.4E-4
6,test_20231101_134822,10350842.png,212614,6344,206270,0.9701618896215677,2,4,42529,929,41600,0.9781560817324649,19.196949333333333,2355.988128,14.409072631896374,124,2.4E-4
7,test_20231101_134822,10863862.png,317432,12977,304455,0.9591188033972631,2,4,66058,1885,64173,0.9714644706167308,23.722218666666667,3236.9452053333334,13.029450130942488,124,2.4E-4
8,test_20231101_134822,11382381.png,312486,907,311579,0.9970974699666545,1,4,46745,121,46624,0.9974114878596642,21.088220444444445,2409.5101546666665,14.311515999312824,124,2.4E-4
9,test_20231101_134822,11079715.png,443815,122782,321033,0.7233486925858748,4,4,124136,17120,107016,0.8620867435715667,16.763402666666668,2067.635402666667,14.97606401189655,124,2.4E-4
10,test_20231101_134822,11551286.png,271883,977,270906,0.9964065425201282,1,3,40092,143,39949,0.9964332036316472,17.00562311111111,1711.9347146666667,15.795931622093908,124,2.4E-4
1,test_20231101_134823,10404007.png,502730,22884,479846,0.9544805362719552,2,4,61265,3295,57970,0.9462172529176528,25.586942222222223,3400.765381333333,12.815036898605106,124,2.5E-4
2,test_20231101_134823,1254659.png,342646,76264,266382,0.7774262650082009,3,4,80080,10638,69442,0.8671578421578422,20.667370666666667,3113.3477866666667,13.198527231942004,124,2.5E-4
3,test_20231101_134823,10188041.png,221231,10142,211089,0.954156515135763,1,3,41731,1428,40303,0.9657808343916993,10.476305777777778,997.11648,18.1433446668218,124,2.5E-4
4,test_20231101_134823,10287332.png,216980,12687,204293,0.9415291731956862,2,4,22337,1739,20598,0.9221471101759413,9.440839111111112,776.604096,19.22880684076492,124,2.5E-4
5,test_20231101_134823,11610969.png,368720,27227,341493,0.9261580603167715,3,4,84111,3970,80141,0.9528004660508138,20.228828444444446,2711.644832,13.798475553202607,124,2.5E-4
6,test_20231101_134823,10350842.png,212614,6344,206270,0.9701618896215677,2,4,42529,929,41600,0.9781560817324649,19.196949333333333,2355.988128,14.409072631896374,124,2.5E-4
7,test_20231101_134823,10863862.png,317432,12977,304455,0.9591188033972631,2,4,66058,1885,64173,0.9714644706167308,23.722218666666667,3236.9452053333334,13.029450130942488,124,2.5E-4
8,test_20231101_134823,11382381.png,312486,907,311579,0.9970974699666545,1,3,46745,121,46624,0.9974114878596642,21.088220444444445,2409.5101546666665,14.311515999312824,124,2.5E-4
9,test_20231101_134823,11079715.png,443815,122782,321033,0.7233486925858748,4,4,124136,17120,107016,0.8620867435715667,16.763402666666668,2067.635402666667,14.97606401189655,124,2.5E-4
10,test_20231101_134823,11551286.png,271883,977,270906,0.9964065425201282,1,4,40092,143,39949,0.9964332036316472,17.00562311111111,1711.9347146666667,15.795931622093908,124,2.5E-4
1,test_20231101_134823,10404007.png,502730,22704,480026,0.9548385813458516,2,4,61265,3271,57994,0.9466089937158247,25.603198222222222,3403.693370666667,12.811299320833328,124,2.6000000000000003E-4
2,test_20231101_134823,1254659.png,342646,76204,266442,0.777601372845444,2,4,80080,10632,69448,0.8672327672327672,20.676924444444445,3114.4299733333332,13.197017904793334,124,2.6000000000000003E-4
3,test_20231101_134823,10188041.png,221231,10042,211189,0.954608531354105,2,4,41731,1414,40317,0.9661163164074669,10.599658666666667,1012.831872,18.07543001512229,124,2.6000000000000003E-4
4,test_20231101_134823,10287332.png,216980,12687,204293,0.9415291731956862,2,4,22337,1739,20598,0.9221471101759413,9.440839111111112,776.604096,19.22880684076492,124,2.6000000000000003E-4
5,test_20231101_134823,11610969.png,368720,26582,342138,0.9279073551746583,3,4,84111,3877,80234,0.9539061478284647,21.465290666666668,2964.25984,13.411640906658562,124,2.6000000000000003E-4
6,test_20231101_134823,10350842.png,212614,6264,206350,0.9705381583526955,1,4,42529,917,41612,0.978438242140657,19.265742222222222,2361.7458346666667,14.398472027898631,124,2.6000000000000003E-4
7,test_20231101_134823,10863862.png,317432,12917,304515,0.959307820257567,2,6,66058,1876,64182,0.9716007145236005,23.73152711111111,3238.389536,13.027512733498073,124,2.6000000000000003E-4
8,test_20231101_134823,11382381.png,312486,767,311719,0.9975454900379537,1,3,46745,100,46645,0.9978607337683175,21.58402311111111,2479.723024,14.186771864393144,124,2.6000000000000003E-4
9,test_20231101_134823,11079715.png,443815,122782,321033,0.7233486925858748,4,4,124136,17120,107016,0.8620867435715667,16.763402666666668,2067.635402666667,14.97606401189655,124,2.6000000000000003E-4
10,test_20231101_134823,11551286.png,271883,857,271026,0.9968479088431421,1,3,40092,125,39967,0.9968821710066846,17.555712,1807.787776,15.559329154375803,124,2.6000000000000003E-4
1,test_20231101_134824,10404007.png,502730,22704,480026,0.9548385813458516,3,4,61265,3271,57994,0.9466089937158247,25.603198222222222,3403.693370666667,12.811299320833328,124,2.7000000000000006E-4
2,test_20231101_134824,1254659.png,342646,76204,266442,0.777601372845444,3,4,80080,10632,69448,0.8672327672327672,20.676924444444445,3114.4299733333332,13.197017904793334,124,2.7000000000000006E-4
3,test_20231101_134824,10188041.png,221231,10042,211189,0.954608531354105,2,4,41731,1414,40317,0.9661163164074669,10.599658666666667,1012.831872,18.07543001512229,124,2.7000000000000006E-4
4,test_20231101_134824,10287332.png,216980,12687,204293,0.9415291731956862,2,3,22337,1739,20598,0.9221471101759413,9.440839111111112,776.604096,19.22880684076492,124,2.7000000000000006E-4
5,test_20231101_134824,11610969.png,368720,26582,342138,0.9279073551746583,2,3,84111,3877,80234,0.9539061478284647,21.465290666666668,2964.25984,13.411640906658562,124,2.7000000000000006E-4
6,test_20231101_134824,10350842.png,212614,6264,206350,0.9705381583526955,2,3,42529,917,41612,0.978438242140657,19.265742222222222,2361.7458346666667,14.398472027898631,124,2.7000000000000006E-4
7,test_20231101_134824,10863862.png,317432,12917,304515,0.959307820257567,4,4,66058,1876,64182,0.9716007145236005,23.73152711111111,3238.389536,13.027512733498073,124,2.7000000000000006E-4
8,test_20231101_134824,11382381.png,312486,767,311719,0.9975454900379537,1,3,46745,100,46645,0.9978607337683175,21.58402311111111,2479.723024,14.186771864393144,124,2.7000000000000006E-4
9,test_20231101_134824,11079715.png,443815,122782,321033,0.7233486925858748,3,8,124136,17120,107016,0.8620867435715667,16.763402666666668,2067.635402666667,14.97606401189655,124,2.7000000000000006E-4
10,test_20231101_134824,11551286.png,271883,857,271026,0.9968479088431421,1,4,40092,125,39967,0.9968821710066846,17.555712,1807.787776,15.559329154375803,124,2.7000000000000006E-4
1,test_20231101_134825,10404007.png,502730,22704,480026,0.9548385813458516,2,3,61265,3271,57994,0.9466089937158247,25.603198222222222,3403.693370666667,12.811299320833328,124,2.800000000000001E-4
2,test_20231101_134825,1254659.png,342646,76204,266442,0.777601372845444,3,4,80080,10632,69448,0.8672327672327672,20.676924444444445,3114.4299733333332,13.197017904793334,124,2.800000000000001E-4
3,test_20231101_134825,10188041.png,221231,10042,211189,0.954608531354105,1,3,41731,1414,40317,0.9661163164074669,10.599658666666667,1012.831872,18.07543001512229,124,2.800000000000001E-4
4,test_20231101_134825,10287332.png,216980,12687,204293,0.9415291731956862,2,3,22337,1739,20598,0.9221471101759413,9.440839111111112,776.604096,19.22880684076492,124,2.800000000000001E-4
5,test_20231101_134825,11610969.png,368720,26582,342138,0.9279073551746583,3,4,84111,3877,80234,0.9539061478284647,21.465290666666668,2964.25984,13.411640906658562,124,2.800000000000001E-4
6,test_20231101_134825,10350842.png,212614,6264,206350,0.9705381583526955,2,4,42529,917,41612,0.978438242140657,19.265742222222222,2361.7458346666667,14.398472027898631,124,2.800000000000001E-4
7,test_20231101_134825,10863862.png,317432,12917,304515,0.959307820257567,2,4,66058,1876,64182,0.9716007145236005,23.73152711111111,3238.389536,13.027512733498073,124,2.800000000000001E-4
8,test_20231101_134825,11382381.png,312486,767,311719,0.9975454900379537,1,4,46745,100,46645,0.9978607337683175,21.58402311111111,2479.723024,14.186771864393144,124,2.800000000000001E-4
9,test_20231101_134825,11079715.png,443815,122782,321033,0.7233486925858748,4,4,124136,17120,107016,0.8620867435715667,16.763402666666668,2067.635402666667,14.97606401189655,124,2.800000000000001E-4
10,test_20231101_134825,11551286.png,271883,857,271026,0.9968479088431421,2,3,40092,125,39967,0.9968821710066846,17.555712,1807.787776,15.559329154375803,124,2.800000000000001E-4
1,test_20231101_134825,10404007.png,502730,22704,480026,0.9548385813458516,2,3,61265,3271,57994,0.9466089937158247,25.603198222222222,3403.693370666667,12.811299320833328,124,2.900000000000001E-4
2,test_20231101_134825,1254659.png,342646,76204,266442,0.777601372845444,3,3,80080,10632,69448,0.8672327672327672,20.676924444444445,3114.4299733333332,13.197017904793334,124,2.900000000000001E-4
3,test_20231101_134825,10188041.png,221231,10042,211189,0.954608531354105,2,4,41731,1414,40317,0.9661163164074669,10.599658666666667,1012.831872,18.07543001512229,124,2.900000000000001E-4
4,test_20231101_134825,10287332.png,216980,12687,204293,0.9415291731956862,2,4,22337,1739,20598,0.9221471101759413,9.440839111111112,776.604096,19.22880684076492,124,2.900000000000001E-4
5,test_20231101_134825,11610969.png,368720,26582,342138,0.9279073551746583,2,4,84111,3877,80234,0.9539061478284647,21.465290666666668,2964.25984,13.411640906658562,124,2.900000000000001E-4
6,test_20231101_134825,10350842.png,212614,6264,206350,0.9705381583526955,1,3,42529,917,41612,0.978438242140657,19.265742222222222,2361.7458346666667,14.398472027898631,124,2.900000000000001E-4
7,test_20231101_134825,10863862.png,317432,12917,304515,0.959307820257567,2,4,66058,1876,64182,0.9716007145236005,23.73152711111111,3238.389536,13.027512733498073,124,2.900000000000001E-4
8,test_20231101_134825,11382381.png,312486,767,311719,0.9975454900379537,2,3,46745,100,46645,0.9978607337683175,21.58402311111111,2479.723024,14.186771864393144,124,2.900000000000001E-4
9,test_20231101_134825,11079715.png,443815,122782,321033,0.7233486925858748,3,5,124136,17120,107016,0.8620867435715667,16.763402666666668,2067.635402666667,14.97606401189655,124,2.900000000000001E-4
10,test_20231101_134825,11551286.png,271883,547,271336,0.9979881051775947,2,3,40092,79,40013,0.9980295320762247,17.838736,1852.2023093333332,15.453919395217167,124,2.900000000000001E-4
1,test_20231101_134826,10404007.png,502730,22704,480026,0.9548385813458516,2,3,61265,3271,57994,0.9466089937158247,25.603198222222222,3403.693370666667,12.811299320833328,124,3.0000000000000014E-4
2,test_20231101_134826,1254659.png,342646,76204,266442,0.777601372845444,4,4,80080,10632,69448,0.8672327672327672,20.676924444444445,3114.4299733333332,13.197017904793334,124,3.0000000000000014E-4
3,test_20231101_134826,10188041.png,221231,10042,211189,0.954608531354105,2,3,41731,1414,40317,0.9661163164074669,10.599658666666667,1012.831872,18.07543001512229,124,3.0000000000000014E-4
4,test_20231101_134826,10287332.png,216980,12687,204293,0.9415291731956862,2,4,22337,1739,20598,0.9221471101759413,9.440839111111112,776.604096,19.22880684076492,124,3.0000000000000014E-4
5,test_20231101_134826,11610969.png,368720,26582,342138,0.9279073551746583,2,5,84111,3877,80234,0.9539061478284647,21.465290666666668,2964.25984,13.411640906658562,124,3.0000000000000014E-4
6,test_20231101_134826,10350842.png,212614,6264,206350,0.9705381583526955,1,4,42529,917,41612,0.978438242140657,19.265742222222222,2361.7458346666667,14.398472027898631,124,3.0000000000000014E-4
7,test_20231101_134826,10863862.png,317432,12917,304515,0.959307820257567,2,6,66058,1876,64182,0.9716007145236005,23.73152711111111,3238.389536,13.027512733498073,124,3.0000000000000014E-4
8,test_20231101_134826,11382381.png,312486,767,311719,0.9975454900379537,2,3,46745,100,46645,0.9978607337683175,21.58402311111111,2479.723024,14.186771864393144,124,3.0000000000000014E-4
9,test_20231101_134826,11079715.png,443815,122782,321033,0.7233486925858748,4,4,124136,17120,107016,0.8620867435715667,16.763402666666668,2067.635402666667,14.97606401189655,124,3.0000000000000014E-4
10,test_20231101_134826,11551286.png,271883,547,271336,0.9979881051775947,1,3,40092,79,40013,0.9980295320762247,17.838736,1852.2023093333332,15.453919395217167,124,3.0000000000000014E-4
1,test_20231101_134827,10404007.png,502730,22704,480026,0.9548385813458516,3,4,61265,3271,57994,0.9466089937158247,25.603198222222222,3403.693370666667,12.811299320833328,124,3.1000000000000016E-4
2,test_20231101_134827,1254659.png,342646,76204,266442,0.777601372845444,3,4,80080,10632,69448,0.8672327672327672,20.676924444444445,3114.4299733333332,13.197017904793334,124,3.1000000000000016E-4
3,test_20231101_134827,10188041.png,221231,10042,211189,0.954608531354105,2,3,41731,1414,40317,0.9661163164074669,10.599658666666667,1012.831872,18.07543001512229,124,3.1000000000000016E-4
4,test_20231101_134827,10287332.png,216980,12687,204293,0.9415291731956862,2,4,22337,1739,20598,0.9221471101759413,9.440839111111112,776.604096,19.22880684076492,124,3.1000000000000016E-4
5,test_20231101_134827,11610969.png,368720,26582,342138,0.9279073551746583,3,4,84111,3877,80234,0.9539061478284647,21.465290666666668,2964.25984,13.411640906658562,124,3.1000000000000016E-4
6,test_20231101_134827,10350842.png,212614,6264,206350,0.9705381583526955,2,4,42529,917,41612,0.978438242140657,19.265742222222222,2361.7458346666667,14.398472027898631,124,3.1000000000000016E-4
7,test_20231101_134827,10863862.png,317432,12917,304515,0.959307820257567,3,4,66058,1876,64182,0.9716007145236005,23.73152711111111,3238.389536,13.027512733498073,124,3.1000000000000016E-4
8,test_20231101_134827,11382381.png,312486,767,311719,0.9975454900379537,2,4,46745,100,46645,0.9978607337683175,21.58402311111111,2479.723024,14.186771864393144,124,3.1000000000000016E-4
9,test_20231101_134827,11079715.png,443815,122782,321033,0.7233486925858748,4,5,124136,17120,107016,0.8620867435715667,16.763402666666668,2067.635402666667,14.97606401189655,124,3.1000000000000016E-4
10,test_20231101_134827,11551286.png,271883,547,271336,0.9979881051775947,1,4,40092,79,40013,0.9980295320762247,17.838736,1852.2023093333332,15.453919395217167,124,3.1000000000000016E-4
1,test_20231101_134828,10404007.png,502730,22704,480026,0.9548385813458516,2,4,61265,3271,57994,0.9466089937158247,25.603198222222222,3403.693370666667,12.811299320833328,124,3.200000000000002E-4
2,test_20231101_134828,1254659.png,342646,76204,266442,0.777601372845444,3,4,80080,10632,69448,0.8672327672327672,20.676924444444445,3114.4299733333332,13.197017904793334,124,3.200000000000002E-4
3,test_20231101_134828,10188041.png,221231,10042,211189,0.954608531354105,2,3,41731,1414,40317,0.9661163164074669,10.599658666666667,1012.831872,18.07543001512229,124,3.200000000000002E-4
4,test_20231101_134828,10287332.png,216980,12687,204293,0.9415291731956862,1,3,22337,1739,20598,0.9221471101759413,9.440839111111112,776.604096,19.22880684076492,124,3.200000000000002E-4
5,test_20231101_134828,11610969.png,368720,26582,342138,0.9279073551746583,3,4,84111,3877,80234,0.9539061478284647,21.465290666666668,2964.25984,13.411640906658562,124,3.200000000000002E-4
6,test_20231101_134828,10350842.png,212614,6264,206350,0.9705381583526955,2,4,42529,917,41612,0.978438242140657,19.265742222222222,2361.7458346666667,14.398472027898631,124,3.200000000000002E-4
7,test_20231101_134828,10863862.png,317432,12917,304515,0.959307820257567,3,4,66058,1876,64182,0.9716007145236005,23.73152711111111,3238.389536,13.027512733498073,124,3.200000000000002E-4
8,test_20231101_134828,11382381.png,312486,767,311719,0.9975454900379537,2,3,46745,100,46645,0.9978607337683175,21.58402311111111,2479.723024,14.186771864393144,124,3.200000000000002E-4
9,test_20231101_134828,11079715.png,443815,122782,321033,0.7233486925858748,3,4,124136,17120,107016,0.8620867435715667,16.763402666666668,2067.635402666667,14.97606401189655,124,3.200000000000002E-4
10,test_20231101_134828,11551286.png,271883,547,271336,0.9979881051775947,1,4,40092,79,40013,0.9980295320762247,17.838736,1852.2023093333332,15.453919395217167,124,3.200000000000002E-4
1,test_20231101_134828,10404007.png,502730,22704,480026,0.9548385813458516,2,4,61265,3271,57994,0.9466089937158247,25.603198222222222,3403.693370666667,12.811299320833328,124,3.300000000000002E-4
2,test_20231101_134828,1254659.png,342646,76204,266442,0.777601372845444,3,4,80080,10632,69448,0.8672327672327672,20.676924444444445,3114.4299733333332,13.197017904793334,124,3.300000000000002E-4
3,test_20231101_134828,10188041.png,221231,10042,211189,0.954608531354105,2,3,41731,1414,40317,0.9661163164074669,10.599658666666667,1012.831872,18.07543001512229,124,3.300000000000002E-4
4,test_20231101_134828,10287332.png,216980,12687,204293,0.9415291731956862,2,4,22337,1739,20598,0.9221471101759413,9.440839111111112,776.604096,19.22880684076492,124,3.300000000000002E-4
5,test_20231101_134828,11610969.png,368720,26582,342138,0.9279073551746583,4,4,84111,3877,80234,0.9539061478284647,21.465290666666668,2964.25984,13.411640906658562,124,3.300000000000002E-4
6,test_20231101_134828,10350842.png,212614,6264,206350,0.9705381583526955,1,4,42529,917,41612,0.978438242140657,19.265742222222222,2361.7458346666667,14.398472027898631,124,3.300000000000002E-4
7,test_20231101_134828,10863862.png,317432,12917,304515,0.959307820257567,2,4,66058,1876,64182,0.9716007145236005,23.73152711111111,3238.389536,13.027512733498073,124,3.300000000000002E-4
8,test_20231101_134828,11382381.png,312486,767,311719,0.9975454900379537,1,4,46745,100,46645,0.9978607337683175,21.58402311111111,2479.723024,14.186771864393144,124,3.300000000000002E-4
9,test_20231101_134828,11079715.png,443815,122782,321033,0.7233486925858748,3,4,124136,17120,107016,0.8620867435715667,16.763402666666668,2067.635402666667,14.97606401189655,124,3.300000000000002E-4
10,test_20231101_134828,11551286.png,271883,547,271336,0.9979881051775947,1,4,40092,79,40013,0.9980295320762247,17.838736,1852.2023093333332,15.453919395217167,124,3.300000000000002E-4
1,test_20231101_134829,10404007.png,502730,22704,480026,0.9548385813458516,2,4,61265,3271,57994,0.9466089937158247,25.603198222222222,3403.693370666667,12.811299320833328,124,3.4000000000000024E-4
2,test_20231101_134829,1254659.png,342646,76204,266442,0.777601372845444,3,4,80080,10632,69448,0.8672327672327672,20.676924444444445,3114.4299733333332,13.197017904793334,124,3.4000000000000024E-4
3,test_20231101_134829,10188041.png,221231,10042,211189,0.954608531354105,2,3,41731,1414,40317,0.9661163164074669,10.599658666666667,1012.831872,18.07543001512229,124,3.4000000000000024E-4
4,test_20231101_134829,10287332.png,216980,12687,204293,0.9415291731956862,1,4,22337,1739,20598,0.9221471101759413,9.440839111111112,776.604096,19.22880684076492,124,3.4000000000000024E-4
5,test_20231101_134829,11610969.png,368720,26582,342138,0.9279073551746583,2,4,84111,3877,80234,0.9539061478284647,21.465290666666668,2964.25984,13.411640906658562,124,3.4000000000000024E-4
6,test_20231101_134829,10350842.png,212614,6264,206350,0.9705381583526955,2,4,42529,917,41612,0.978438242140657,19.265742222222222,2361.7458346666667,14.398472027898631,124,3.4000000000000024E-4
7,test_20231101_134829,10863862.png,317432,12917,304515,0.959307820257567,2,4,66058,1876,64182,0.9716007145236005,23.73152711111111,3238.389536,13.027512733498073,124,3.4000000000000024E-4
8,test_20231101_134829,11382381.png,312486,767,311719,0.9975454900379537,1,5,46745,100,46645,0.9978607337683175,21.58402311111111,2479.723024,14.186771864393144,124,3.4000000000000024E-4
9,test_20231101_134829,11079715.png,443815,122782,321033,0.7233486925858748,4,5,124136,17120,107016,0.8620867435715667,16.763402666666668,2067.635402666667,14.97606401189655,124,3.4000000000000024E-4
10,test_20231101_134829,11551286.png,271883,547,271336,0.9979881051775947,2,4,40092,79,40013,0.9980295320762247,17.838736,1852.2023093333332,15.453919395217167,124,3.4000000000000024E-4
1,test_20231101_134830,10404007.png,502730,22704,480026,0.9548385813458516,2,4,61265,3271,57994,0.9466089937158247,25.603198222222222,3403.693370666667,12.811299320833328,124,3.5000000000000027E-4
2,test_20231101_134830,1254659.png,342646,76204,266442,0.777601372845444,3,4,80080,10632,69448,0.8672327672327672,20.676924444444445,3114.4299733333332,13.197017904793334,124,3.5000000000000027E-4
3,test_20231101_134830,10188041.png,221231,10042,211189,0.954608531354105,2,3,41731,1414,40317,0.9661163164074669,10.599658666666667,1012.831872,18.07543001512229,124,3.5000000000000027E-4
4,test_20231101_134830,10287332.png,216980,12687,204293,0.9415291731956862,2,4,22337,1739,20598,0.9221471101759413,9.440839111111112,776.604096,19.22880684076492,124,3.5000000000000027E-4
5,test_20231101_134830,11610969.png,368720,26582,342138,0.9279073551746583,3,4,84111,3877,80234,0.9539061478284647,21.465290666666668,2964.25984,13.411640906658562,124,3.5000000000000027E-4
6,test_20231101_134830,10350842.png,212614,6264,206350,0.9705381583526955,2,4,42529,917,41612,0.978438242140657,19.265742222222222,2361.7458346666667,14.398472027898631,124,3.5000000000000027E-4
7,test_20231101_134830,10863862.png,317432,12917,304515,0.959307820257567,2,4,66058,1876,64182,0.9716007145236005,23.73152711111111,3238.389536,13.027512733498073,124,3.5000000000000027E-4
8,test_20231101_134830,11382381.png,312486,767,311719,0.9975454900379537,2,4,46745,100,46645,0.9978607337683175,21.58402311111111,2479.723024,14.186771864393144,124,3.5000000000000027E-4
9,test_20231101_134830,11079715.png,443815,122782,321033,0.7233486925858748,4,5,124136,17120,107016,0.8620867435715667,16.763402666666668,2067.635402666667,14.97606401189655,124,3.5000000000000027E-4
10,test_20231101_134830,11551286.png,271883,547,271336,0.9979881051775947,1,4,40092,79,40013,0.9980295320762247,17.838736,1852.2023093333332,15.453919395217167,124,3.5000000000000027E-4
1,test_20231101_134830,10404007.png,502730,22704,480026,0.9548385813458516,2,3,61265,3271,57994,0.9466089937158247,25.603198222222222,3403.693370666667,12.811299320833328,124,3.600000000000003E-4
2,test_20231101_134830,1254659.png,342646,76204,266442,0.777601372845444,2,4,80080,10632,69448,0.8672327672327672,20.676924444444445,3114.4299733333332,13.197017904793334,124,3.600000000000003E-4
3,test_20231101_134830,10188041.png,221231,10042,211189,0.954608531354105,2,3,41731,1414,40317,0.9661163164074669,10.599658666666667,1012.831872,18.07543001512229,124,3.600000000000003E-4
4,test_20231101_134830,10287332.png,216980,12687,204293,0.9415291731956862,1,4,22337,1739,20598,0.9221471101759413,9.440839111111112,776.604096,19.22880684076492,124,3.600000000000003E-4
5,test_20231101_134830,11610969.png,368720,26582,342138,0.9279073551746583,3,3,84111,3877,80234,0.9539061478284647,21.465290666666668,2964.25984,13.411640906658562,124,3.600000000000003E-4
6,test_20231101_134830,10350842.png,212614,6264,206350,0.9705381583526955,1,3,42529,917,41612,0.978438242140657,19.265742222222222,2361.7458346666667,14.398472027898631,124,3.600000000000003E-4
7,test_20231101_134830,10863862.png,317432,12917,304515,0.959307820257567,2,3,66058,1876,64182,0.9716007145236005,23.73152711111111,3238.389536,13.027512733498073,124,3.600000000000003E-4
8,test_20231101_134830,11382381.png,312486,767,311719,0.9975454900379537,2,3,46745,100,46645,0.9978607337683175,21.58402311111111,2479.723024,14.186771864393144,124,3.600000000000003E-4
9,test_20231101_134830,11079715.png,443815,122782,321033,0.7233486925858748,5,4,124136,17120,107016,0.8620867435715667,16.763402666666668,2067.635402666667,14.97606401189655,124,3.600000000000003E-4
10,test_20231101_134830,11551286.png,271883,547,271336,0.9979881051775947,1,4,40092,79,40013,0.9980295320762247,17.838736,1852.2023093333332,15.453919395217167,124,3.600000000000003E-4
1,test_20231101_134831,10404007.png,502730,22704,480026,0.9548385813458516,2,3,61265,3271,57994,0.9466089937158247,25.603198222222222,3403.693370666667,12.811299320833328,124,3.700000000000003E-4
2,test_20231101_134831,1254659.png,342646,76204,266442,0.777601372845444,3,4,80080,10632,69448,0.8672327672327672,20.676924444444445,3114.4299733333332,13.197017904793334,124,3.700000000000003E-4
3,test_20231101_134831,10188041.png,221231,10042,211189,0.954608531354105,2,3,41731,1414,40317,0.9661163164074669,10.599658666666667,1012.831872,18.07543001512229,124,3.700000000000003E-4
4,test_20231101_134831,10287332.png,216980,12687,204293,0.9415291731956862,2,3,22337,1739,20598,0.9221471101759413,9.440839111111112,776.604096,19.22880684076492,124,3.700000000000003E-4
5,test_20231101_134831,11610969.png,368720,26582,342138,0.9279073551746583,2,3,84111,3877,80234,0.9539061478284647,21.465290666666668,2964.25984,13.411640906658562,124,3.700000000000003E-4
6,test_20231101_134831,10350842.png,212614,6264,206350,0.9705381583526955,1,4,42529,917,41612,0.978438242140657,19.265742222222222,2361.7458346666667,14.398472027898631,124,3.700000000000003E-4
7,test_20231101_134831,10863862.png,317432,12917,304515,0.959307820257567,2,3,66058,1876,64182,0.9716007145236005,23.73152711111111,3238.389536,13.027512733498073,124,3.700000000000003E-4
8,test_20231101_134831,11382381.png,312486,767,311719,0.9975454900379537,1,3,46745,100,46645,0.9978607337683175,21.58402311111111,2479.723024,14.186771864393144,124,3.700000000000003E-4
9,test_20231101_134831,11079715.png,443815,122782,321033,0.7233486925858748,3,5,124136,17120,107016,0.8620867435715667,16.763402666666668,2067.635402666667,14.97606401189655,124,3.700000000000003E-4
10,test_20231101_134831,11551286.png,271883,547,271336,0.9979881051775947,1,4,40092,79,40013,0.9980295320762247,17.838736,1852.2023093333332,15.453919395217167,124,3.700000000000003E-4
1,test_20231101_134832,10404007.png,502730,22704,480026,0.9548385813458516,2,11,61265,3271,57994,0.9466089937158247,25.603198222222222,3403.693370666667,12.811299320833328,124,3.8000000000000035E-4
2,test_20231101_134832,1254659.png,342646,76204,266442,0.777601372845444,3,4,80080,10632,69448,0.8672327672327672,20.676924444444445,3114.4299733333332,13.197017904793334,124,3.8000000000000035E-4
3,test_20231101_134832,10188041.png,221231,10042,211189,0.954608531354105,2,3,41731,1414,40317,0.9661163164074669,10.599658666666667,1012.831872,18.07543001512229,124,3.8000000000000035E-4
4,test_20231101_134832,10287332.png,216980,12687,204293,0.9415291731956862,1,3,22337,1739,20598,0.9221471101759413,9.440839111111112,776.604096,19.22880684076492,124,3.8000000000000035E-4
5,test_20231101_134832,11610969.png,368720,26582,342138,0.9279073551746583,3,4,84111,3877,80234,0.9539061478284647,21.465290666666668,2964.25984,13.411640906658562,124,3.8000000000000035E-4
6,test_20231101_134832,10350842.png,212614,6264,206350,0.9705381583526955,2,4,42529,917,41612,0.978438242140657,19.265742222222222,2361.7458346666667,14.398472027898631,124,3.8000000000000035E-4
7,test_20231101_134832,10863862.png,317432,12917,304515,0.959307820257567,2,4,66058,1876,64182,0.9716007145236005,23.73152711111111,3238.389536,13.027512733498073,124,3.8000000000000035E-4
8,test_20231101_134832,11382381.png,312486,767,311719,0.9975454900379537,1,4,46745,100,46645,0.9978607337683175,21.58402311111111,2479.723024,14.186771864393144,124,3.8000000000000035E-4
9,test_20231101_134832,11079715.png,443815,122782,321033,0.7233486925858748,4,14,124136,17120,107016,0.8620867435715667,16.763402666666668,2067.635402666667,14.97606401189655,124,3.8000000000000035E-4
10,test_20231101_134832,11551286.png,271883,547,271336,0.9979881051775947,1,4,40092,79,40013,0.9980295320762247,17.838736,1852.2023093333332,15.453919395217167,124,3.8000000000000035E-4
1,test_20231101_134832,10404007.png,502730,22704,480026,0.9548385813458516,2,4,61265,3271,57994,0.9466089937158247,25.603198222222222,3403.693370666667,12.811299320833328,124,3.9000000000000037E-4
2,test_20231101_134832,1254659.png,342646,76204,266442,0.777601372845444,3,4,80080,10632,69448,0.8672327672327672,20.676924444444445,3114.4299733333332,13.197017904793334,124,3.9000000000000037E-4
3,test_20231101_134832,10188041.png,221231,10042,211189,0.954608531354105,2,3,41731,1414,40317,0.9661163164074669,10.599658666666667,1012.831872,18.07543001512229,124,3.9000000000000037E-4
4,test_20231101_134832,10287332.png,216980,12687,204293,0.9415291731956862,2,4,22337,1739,20598,0.9221471101759413,9.440839111111112,776.604096,19.22880684076492,124,3.9000000000000037E-4
5,test_20231101_134832,11610969.png,368720,26582,342138,0.9279073551746583,2,4,84111,3877,80234,0.9539061478284647,21.465290666666668,2964.25984,13.411640906658562,124,3.9000000000000037E-4
6,test_20231101_134832,10350842.png,212614,6264,206350,0.9705381583526955,2,4,42529,917,41612,0.978438242140657,19.265742222222222,2361.7458346666667,14.398472027898631,124,3.9000000000000037E-4
7,test_20231101_134832,10863862.png,317432,12917,304515,0.959307820257567,2,4,66058,1876,64182,0.9716007145236005,23.73152711111111,3238.389536,13.027512733498073,124,3.9000000000000037E-4
8,test_20231101_134832,11382381.png,312486,767,311719,0.9975454900379537,1,4,46745,100,46645,0.9978607337683175,21.58402311111111,2479.723024,14.186771864393144,124,3.9000000000000037E-4
9,test_20231101_134832,11079715.png,443815,122782,321033,0.7233486925858748,3,5,124136,17120,107016,0.8620867435715667,16.763402666666668,2067.635402666667,14.97606401189655,124,3.9000000000000037E-4
10,test_20231101_134832,11551286.png,271883,547,271336,0.9979881051775947,1,4,40092,79,40013,0.9980295320762247,17.838736,1852.2023093333332,15.453919395217167,124,3.9000000000000037E-4
1,test_20231101_134833,10404007.png,502730,22704,480026,0.9548385813458516,3,3,61265,3271,57994,0.9466089937158247,25.603198222222222,3403.693370666667,12.811299320833328,124,4.000000000000004E-4
2,test_20231101_134833,1254659.png,342646,76204,266442,0.777601372845444,3,4,80080,10632,69448,0.8672327672327672,20.676924444444445,3114.4299733333332,13.197017904793334,124,4.000000000000004E-4
3,test_20231101_134833,10188041.png,221231,10042,211189,0.954608531354105,2,4,41731,1414,40317,0.9661163164074669,10.599658666666667,1012.831872,18.07543001512229,124,4.000000000000004E-4
4,test_20231101_134833,10287332.png,216980,12687,204293,0.9415291731956862,2,4,22337,1739,20598,0.9221471101759413,9.440839111111112,776.604096,19.22880684076492,124,4.000000000000004E-4
5,test_20231101_134833,11610969.png,368720,26582,342138,0.9279073551746583,2,4,84111,3877,80234,0.9539061478284647,21.465290666666668,2964.25984,13.411640906658562,124,4.000000000000004E-4
6,test_20231101_134833,10350842.png,212614,6264,206350,0.9705381583526955,2,4,42529,917,41612,0.978438242140657,19.265742222222222,2361.7458346666667,14.398472027898631,124,4.000000000000004E-4
7,test_20231101_134833,10863862.png,317432,12917,304515,0.959307820257567,2,4,66058,1876,64182,0.9716007145236005,23.73152711111111,3238.389536,13.027512733498073,124,4.000000000000004E-4
8,test_20231101_134833,11382381.png,312486,767,311719,0.9975454900379537,1,4,46745,100,46645,0.9978607337683175,21.58402311111111,2479.723024,14.186771864393144,124,4.000000000000004E-4
9,test_20231101_134833,11079715.png,443815,122782,321033,0.7233486925858748,3,4,124136,17120,107016,0.8620867435715667,16.763402666666668,2067.635402666667,14.97606401189655,124,4.000000000000004E-4
10,test_20231101_134833,11551286.png,271883,547,271336,0.9979881051775947,1,3,40092,79,40013,0.9980295320762247,17.838736,1852.2023093333332,15.453919395217167,124,4.000000000000004E-4
1,test_20231101_134834,10404007.png,502730,22704,480026,0.9548385813458516,2,4,61265,3271,57994,0.9466089937158247,25.603198222222222,3403.693370666667,12.811299320833328,124,4.100000000000004E-4
2,test_20231101_134834,1254659.png,342646,76204,266442,0.777601372845444,3,4,80080,10632,69448,0.8672327672327672,20.676924444444445,3114.4299733333332,13.197017904793334,124,4.100000000000004E-4
3,test_20231101_134834,10188041.png,221231,10042,211189,0.954608531354105,2,4,41731,1414,40317,0.9661163164074669,10.599658666666667,1012.831872,18.07543001512229,124,4.100000000000004E-4
4,test_20231101_134834,10287332.png,216980,12687,204293,0.9415291731956862,2,3,22337,1739,20598,0.9221471101759413,9.440839111111112,776.604096,19.22880684076492,124,4.100000000000004E-4
5,test_20231101_134834,11610969.png,368720,26582,342138,0.9279073551746583,2,4,84111,3877,80234,0.9539061478284647,21.465290666666668,2964.25984,13.411640906658562,124,4.100000000000004E-4
6,test_20231101_134834,10350842.png,212614,6264,206350,0.9705381583526955,1,4,42529,917,41612,0.978438242140657,19.265742222222222,2361.7458346666667,14.398472027898631,124,4.100000000000004E-4
7,test_20231101_134834,10863862.png,317432,12917,304515,0.959307820257567,2,3,66058,1876,64182,0.9716007145236005,23.73152711111111,3238.389536,13.027512733498073,124,4.100000000000004E-4
8,test_20231101_134834,11382381.png,312486,767,311719,0.9975454900379537,1,4,46745,100,46645,0.9978607337683175,21.58402311111111,2479.723024,14.186771864393144,124,4.100000000000004E-4
9,test_20231101_134834,11079715.png,443815,122782,321033,0.7233486925858748,3,5,124136,17120,107016,0.8620867435715667,16.763402666666668,2067.635402666667,14.97606401189655,124,4.100000000000004E-4
10,test_20231101_134834,11551286.png,271883,547,271336,0.9979881051775947,1,4,40092,79,40013,0.9980295320762247,17.838736,1852.2023093333332,15.453919395217167,124,4.100000000000004E-4
1,test_20231101_134834,10404007.png,502730,22704,480026,0.9548385813458516,3,4,61265,3271,57994,0.9466089937158247,25.603198222222222,3403.693370666667,12.811299320833328,124,4.2000000000000045E-4
2,test_20231101_134834,1254659.png,342646,76204,266442,0.777601372845444,3,4,80080,10632,69448,0.8672327672327672,20.676924444444445,3114.4299733333332,13.197017904793334,124,4.2000000000000045E-4
3,test_20231101_134834,10188041.png,221231,10042,211189,0.954608531354105,3,3,41731,1414,40317,0.9661163164074669,10.599658666666667,1012.831872,18.07543001512229,124,4.2000000000000045E-4
4,test_20231101_134834,10287332.png,216980,12687,204293,0.9415291731956862,1,4,22337,1739,20598,0.9221471101759413,9.440839111111112,776.604096,19.22880684076492,124,4.2000000000000045E-4
5,test_20231101_134834,11610969.png,368720,26582,342138,0.9279073551746583,2,3,84111,3877,80234,0.9539061478284647,21.465290666666668,2964.25984,13.411640906658562,124,4.2000000000000045E-4
6,test_20231101_134834,10350842.png,212614,6264,206350,0.9705381583526955,2,3,42529,917,41612,0.978438242140657,19.265742222222222,2361.7458346666667,14.398472027898631,124,4.2000000000000045E-4
7,test_20231101_134834,10863862.png,317432,12917,304515,0.959307820257567,2,3,66058,1876,64182,0.9716007145236005,23.73152711111111,3238.389536,13.027512733498073,124,4.2000000000000045E-4
8,test_20231101_134834,11382381.png,312486,767,311719,0.9975454900379537,2,3,46745,100,46645,0.9978607337683175,21.58402311111111,2479.723024,14.186771864393144,124,4.2000000000000045E-4
9,test_20231101_134834,11079715.png,443815,122782,321033,0.7233486925858748,3,4,124136,17120,107016,0.8620867435715667,16.763402666666668,2067.635402666667,14.97606401189655,124,4.2000000000000045E-4
10,test_20231101_134834,11551286.png,271883,547,271336,0.9979881051775947,1,4,40092,79,40013,0.9980295320762247,17.838736,1852.2023093333332,15.453919395217167,124,4.2000000000000045E-4
1,test_20231101_134835,10404007.png,502730,22704,480026,0.9548385813458516,2,4,61265,3271,57994,0.9466089937158247,25.603198222222222,3403.693370666667,12.811299320833328,124,4.300000000000005E-4
2,test_20231101_134835,1254659.png,342646,76204,266442,0.777601372845444,3,4,80080,10632,69448,0.8672327672327672,20.676924444444445,3114.4299733333332,13.197017904793334,124,4.300000000000005E-4
3,test_20231101_134835,10188041.png,221231,10042,211189,0.954608531354105,2,3,41731,1414,40317,0.9661163164074669,10.599658666666667,1012.831872,18.07543001512229,124,4.300000000000005E-4
4,test_20231101_134835,10287332.png,216980,12687,204293,0.9415291731956862,1,3,22337,1739,20598,0.9221471101759413,9.440839111111112,776.604096,19.22880684076492,124,4.300000000000005E-4
5,test_20231101_134835,11610969.png,368720,26582,342138,0.9279073551746583,2,4,84111,3877,80234,0.9539061478284647,21.465290666666668,2964.25984,13.411640906658562,124,4.300000000000005E-4
6,test_20231101_134835,10350842.png,212614,6264,206350,0.9705381583526955,2,4,42529,917,41612,0.978438242140657,19.265742222222222,2361.7458346666667,14.398472027898631,124,4.300000000000005E-4
7,test_20231101_134835,10863862.png,317432,12917,304515,0.959307820257567,2,4,66058,1876,64182,0.9716007145236005,23.73152711111111,3238.389536,13.027512733498073,124,4.300000000000005E-4
8,test_20231101_134835,11382381.png,312486,767,311719,0.9975454900379537,1,3,46745,100,46645,0.9978607337683175,21.58402311111111,2479.723024,14.186771864393144,124,4.300000000000005E-4
9,test_20231101_134835,11079715.png,443815,122782,321033,0.7233486925858748,4,5,124136,17120,107016,0.8620867435715667,16.763402666666668,2067.635402666667,14.97606401189655,124,4.300000000000005E-4
10,test_20231101_134835,11551286.png,271883,547,271336,0.9979881051775947,2,3,40092,79,40013,0.9980295320762247,17.838736,1852.2023093333332,15.453919395217167,124,4.300000000000005E-4
1,test_20231101_134836,10404007.png,502730,22704,480026,0.9548385813458516,2,4,61265,3271,57994,0.9466089937158247,25.603198222222222,3403.693370666667,12.811299320833328,124,4.400000000000005E-4
2,test_20231101_134836,1254659.png,342646,76204,266442,0.777601372845444,3,4,80080,10632,69448,0.8672327672327672,20.676924444444445,3114.4299733333332,13.197017904793334,124,4.400000000000005E-4
3,test_20231101_134836,10188041.png,221231,10042,211189,0.954608531354105,2,4,41731,1414,40317,0.9661163164074669,10.599658666666667,1012.831872,18.07543001512229,124,4.400000000000005E-4
4,test_20231101_134836,10287332.png,216980,12687,204293,0.9415291731956862,2,4,22337,1739,20598,0.9221471101759413,9.440839111111112,776.604096,19.22880684076492,124,4.400000000000005E-4
5,test_20231101_134836,11610969.png,368720,26582,342138,0.9279073551746583,2,4,84111,3877,80234,0.9539061478284647,21.465290666666668,2964.25984,13.411640906658562,124,4.400000000000005E-4
6,test_20231101_134836,10350842.png,212614,6264,206350,0.9705381583526955,2,4,42529,917,41612,0.978438242140657,19.265742222222222,2361.7458346666667,14.398472027898631,124,4.400000000000005E-4
7,test_20231101_134836,10863862.png,317432,12917,304515,0.959307820257567,2,3,66058,1876,64182,0.9716007145236005,23.73152711111111,3238.389536,13.027512733498073,124,4.400000000000005E-4
8,test_20231101_134836,11382381.png,312486,767,311719,0.9975454900379537,2,4,46745,100,46645,0.9978607337683175,21.58402311111111,2479.723024,14.186771864393144,124,4.400000000000005E-4
9,test_20231101_134836,11079715.png,443815,122782,321033,0.7233486925858748,4,4,124136,17120,107016,0.8620867435715667,16.763402666666668,2067.635402666667,14.97606401189655,124,4.400000000000005E-4
10,test_20231101_134836,11551286.png,271883,547,271336,0.9979881051775947,1,4,40092,79,40013,0.9980295320762247,17.838736,1852.2023093333332,15.453919395217167,124,4.400000000000005E-4
1,test_20231101_134836,10404007.png,502730,22382,480348,0.9554790842002665,2,4,61265,3225,58040,0.9473598302456542,25.693242666666666,3423.687909333333,12.785861917295664,124,4.5000000000000053E-4
2,test_20231101_134836,1254659.png,342646,76204,266442,0.777601372845444,3,4,80080,10632,69448,0.8672327672327672,20.676924444444445,3114.4299733333332,13.197017904793334,124,4.5000000000000053E-4
3,test_20231101_134836,10188041.png,221231,10042,211189,0.954608531354105,2,4,41731,1414,40317,0.9661163164074669,10.599658666666667,1012.831872,18.07543001512229,124,4.5000000000000053E-4
4,test_20231101_134836,10287332.png,216980,12687,204293,0.9415291731956862,1,3,22337,1739,20598,0.9221471101759413,9.440839111111112,776.604096,19.22880684076492,124,4.5000000000000053E-4
5,test_20231101_134836,11610969.png,368720,26582,342138,0.9279073551746583,2,3,84111,3877,80234,0.9539061478284647,21.465290666666668,2964.25984,13.411640906658562,124,4.5000000000000053E-4
6,test_20231101_134836,10350842.png,212614,6264,206350,0.9705381583526955,2,3,42529,917,41612,0.978438242140657,19.265742222222222,2361.7458346666667,14.398472027898631,124,4.5000000000000053E-4
7,test_20231101_134836,10863862.png,317432,12917,304515,0.959307820257567,2,4,66058,1876,64182,0.9716007145236005,23.73152711111111,3238.389536,13.027512733498073,124,4.5000000000000053E-4
8,test_20231101_134836,11382381.png,312486,767,311719,0.9975454900379537,1,3,46745,100,46645,0.9978607337683175,21.58402311111111,2479.723024,14.186771864393144,124,4.5000000000000053E-4
9,test_20231101_134836,11079715.png,443815,122782,321033,0.7233486925858748,3,4,124136,17120,107016,0.8620867435715667,16.763402666666668,2067.635402666667,14.97606401189655,124,4.5000000000000053E-4
10,test_20231101_134836,11551286.png,271883,547,271336,0.9979881051775947,1,4,40092,79,40013,0.9980295320762247,17.838736,1852.2023093333332,15.453919395217167,124,4.5000000000000053E-4
1,test_20231101_134837,10404007.png,502730,22382,480348,0.9554790842002665,2,4,61265,3225,58040,0.9473598302456542,25.693242666666666,3423.687909333333,12.785861917295664,124,4.6000000000000056E-4
2,test_20231101_134837,1254659.png,342646,76204,266442,0.777601372845444,3,4,80080,10632,69448,0.8672327672327672,20.676924444444445,3114.4299733333332,13.197017904793334,124,4.6000000000000056E-4
3,test_20231101_134837,10188041.png,221231,10042,211189,0.954608531354105,2,4,41731,1414,40317,0.9661163164074669,10.599658666666667,1012.831872,18.07543001512229,124,4.6000000000000056E-4
4,test_20231101_134837,10287332.png,216980,12687,204293,0.9415291731956862,2,4,22337,1739,20598,0.9221471101759413,9.440839111111112,776.604096,19.22880684076492,124,4.6000000000000056E-4
5,test_20231101_134837,11610969.png,368720,26582,342138,0.9279073551746583,2,4,84111,3877,80234,0.9539061478284647,21.465290666666668,2964.25984,13.411640906658562,124,4.6000000000000056E-4
6,test_20231101_134837,10350842.png,212614,6264,206350,0.9705381583526955,1,4,42529,917,41612,0.978438242140657,19.265742222222222,2361.7458346666667,14.398472027898631,124,4.6000000000000056E-4
7,test_20231101_134837,10863862.png,317432,12917,304515,0.959307820257567,2,4,66058,1876,64182,0.9716007145236005,23.73152711111111,3238.389536,13.027512733498073,124,4.6000000000000056E-4
8,test_20231101_134837,11382381.png,312486,767,311719,0.9975454900379537,1,3,46745,100,46645,0.9978607337683175,21.58402311111111,2479.723024,14.186771864393144,124,4.6000000000000056E-4
9,test_20231101_134837,11079715.png,443815,122782,321033,0.7233486925858748,3,5,124136,17120,107016,0.8620867435715667,16.763402666666668,2067.635402666667,14.97606401189655,124,4.6000000000000056E-4
10,test_20231101_134837,11551286.png,271883,547,271336,0.9979881051775947,1,4,40092,79,40013,0.9980295320762247,17.838736,1852.2023093333332,15.453919395217167,124,4.6000000000000056E-4
1,test_20231101_134838,10404007.png,502730,22382,480348,0.9554790842002665,2,3,61265,3225,58040,0.9473598302456542,25.693242666666666,3423.687909333333,12.785861917295664,124,4.700000000000006E-4
2,test_20231101_134838,1254659.png,342646,76204,266442,0.777601372845444,3,4,80080,10632,69448,0.8672327672327672,20.676924444444445,3114.4299733333332,13.197017904793334,124,4.700000000000006E-4
3,test_20231101_134838,10188041.png,221231,10042,211189,0.954608531354105,2,3,41731,1414,40317,0.9661163164074669,10.599658666666667,1012.831872,18.07543001512229,124,4.700000000000006E-4
4,test_20231101_134838,10287332.png,216980,12687,204293,0.9415291731956862,1,3,22337,1739,20598,0.9221471101759413,9.440839111111112,776.604096,19.22880684076492,124,4.700000000000006E-4
5,test_20231101_134838,11610969.png,368720,26582,342138,0.9279073551746583,2,4,84111,3877,80234,0.9539061478284647,21.465290666666668,2964.25984,13.411640906658562,124,4.700000000000006E-4
6,test_20231101_134838,10350842.png,212614,6264,206350,0.9705381583526955,2,3,42529,917,41612,0.978438242140657,19.265742222222222,2361.7458346666667,14.398472027898631,124,4.700000000000006E-4
7,test_20231101_134838,10863862.png,317432,12917,304515,0.959307820257567,2,4,66058,1876,64182,0.9716007145236005,23.73152711111111,3238.389536,13.027512733498073,124,4.700000000000006E-4
8,test_20231101_134838,11382381.png,312486,767,311719,0.9975454900379537,2,3,46745,100,46645,0.9978607337683175,21.58402311111111,2479.723024,14.186771864393144,124,4.700000000000006E-4
9,test_20231101_134838,11079715.png,443815,122782,321033,0.7233486925858748,3,4,124136,17120,107016,0.8620867435715667,16.763402666666668,2067.635402666667,14.97606401189655,124,4.700000000000006E-4
10,test_20231101_134838,11551286.png,271883,547,271336,0.9979881051775947,1,3,40092,79,40013,0.9980295320762247,17.838736,1852.2023093333332,15.453919395217167,124,4.700000000000006E-4
1,test_20231101_134838,10404007.png,502730,22382,480348,0.9554790842002665,2,3,61265,3225,58040,0.9473598302456542,25.693242666666666,3423.687909333333,12.785861917295664,124,4.800000000000006E-4
2,test_20231101_134838,1254659.png,342646,76204,266442,0.777601372845444,2,4,80080,10632,69448,0.8672327672327672,20.676924444444445,3114.4299733333332,13.197017904793334,124,4.800000000000006E-4
3,test_20231101_134838,10188041.png,221231,10042,211189,0.954608531354105,2,4,41731,1414,40317,0.9661163164074669,10.599658666666667,1012.831872,18.07543001512229,124,4.800000000000006E-4
4,test_20231101_134838,10287332.png,216980,12687,204293,0.9415291731956862,2,5,22337,1739,20598,0.9221471101759413,9.440839111111112,776.604096,19.22880684076492,124,4.800000000000006E-4
5,test_20231101_134838,11610969.png,368720,26582,342138,0.9279073551746583,3,4,84111,3877,80234,0.9539061478284647,21.465290666666668,2964.25984,13.411640906658562,124,4.800000000000006E-4
6,test_20231101_134838,10350842.png,212614,6264,206350,0.9705381583526955,2,4,42529,917,41612,0.978438242140657,19.265742222222222,2361.7458346666667,14.398472027898631,124,4.800000000000006E-4
7,test_20231101_134838,10863862.png,317432,12917,304515,0.959307820257567,2,4,66058,1876,64182,0.9716007145236005,23.73152711111111,3238.389536,13.027512733498073,124,4.800000000000006E-4
8,test_20231101_134838,11382381.png,312486,767,311719,0.9975454900379537,2,4,46745,100,46645,0.9978607337683175,21.58402311111111,2479.723024,14.186771864393144,124,4.800000000000006E-4
9,test_20231101_134838,11079715.png,443815,122782,321033,0.7233486925858748,3,4,124136,17120,107016,0.8620867435715667,16.763402666666668,2067.635402666667,14.97606401189655,124,4.800000000000006E-4
10,test_20231101_134838,11551286.png,271883,547,271336,0.9979881051775947,1,3,40092,79,40013,0.9980295320762247,17.838736,1852.2023093333332,15.453919395217167,124,4.800000000000006E-4
1,test_20231101_134839,10404007.png,502730,22382,480348,0.9554790842002665,2,4,61265,3225,58040,0.9473598302456542,25.693242666666666,3423.687909333333,12.785861917295664,124,4.900000000000006E-4
2,test_20231101_134839,1254659.png,342646,76204,266442,0.777601372845444,3,4,80080,10632,69448,0.8672327672327672,20.676924444444445,3114.4299733333332,13.197017904793334,124,4.900000000000006E-4
3,test_20231101_134839,10188041.png,221231,10042,211189,0.954608531354105,2,4,41731,1414,40317,0.9661163164074669,10.599658666666667,1012.831872,18.07543001512229,124,4.900000000000006E-4
4,test_20231101_134839,10287332.png,216980,12687,204293,0.9415291731956862,2,4,22337,1739,20598,0.9221471101759413,9.440839111111112,776.604096,19.22880684076492,124,4.900000000000006E-4
5,test_20231101_134839,11610969.png,368720,26582,342138,0.9279073551746583,2,4,84111,3877,80234,0.9539061478284647,21.465290666666668,2964.25984,13.411640906658562,124,4.900000000000006E-4
6,test_20231101_134839,10350842.png,212614,6264,206350,0.9705381583526955,1,4,42529,917,41612,0.978438242140657,19.265742222222222,2361.7458346666667,14.398472027898631,124,4.900000000000006E-4
7,test_20231101_134839,10863862.png,317432,12917,304515,0.959307820257567,2,3,66058,1876,64182,0.9716007145236005,23.73152711111111,3238.389536,13.027512733498073,124,4.900000000000006E-4
8,test_20231101_134839,11382381.png,312486,767,311719,0.9975454900379537,1,4,46745,100,46645,0.9978607337683175,21.58402311111111,2479.723024,14.186771864393144,124,4.900000000000006E-4
9,test_20231101_134839,11079715.png,443815,122782,321033,0.7233486925858748,3,5,124136,17120,107016,0.8620867435715667,16.763402666666668,2067.635402666667,14.97606401189655,124,4.900000000000006E-4
10,test_20231101_134839,11551286.png,271883,547,271336,0.9979881051775947,1,4,40092,79,40013,0.9980295320762247,17.838736,1852.2023093333332,15.453919395217167,124,4.900000000000006E-4
1,test_20231101_134840,10404007.png,502730,22382,480348,0.9554790842002665,2,3,61265,3225,58040,0.9473598302456542,25.693242666666666,3423.687909333333,12.785861917295664,124,5.000000000000007E-4
2,test_20231101_134840,1254659.png,342646,76204,266442,0.777601372845444,11,4,80080,10632,69448,0.8672327672327672,20.676924444444445,3114.4299733333332,13.197017904793334,124,5.000000000000007E-4
3,test_20231101_134840,10188041.png,221231,10042,211189,0.954608531354105,2,4,41731,1414,40317,0.9661163164074669,10.599658666666667,1012.831872,18.07543001512229,124,5.000000000000007E-4
4,test_20231101_134840,10287332.png,216980,12687,204293,0.9415291731956862,1,3,22337,1739,20598,0.9221471101759413,9.440839111111112,776.604096,19.22880684076492,124,5.000000000000007E-4
5,test_20231101_134840,11610969.png,368720,26582,342138,0.9279073551746583,2,4,84111,3877,80234,0.9539061478284647,21.465290666666668,2964.25984,13.411640906658562,124,5.000000000000007E-4
6,test_20231101_134840,10350842.png,212614,6264,206350,0.9705381583526955,2,3,42529,917,41612,0.978438242140657,19.265742222222222,2361.7458346666667,14.398472027898631,124,5.000000000000007E-4
7,test_20231101_134840,10863862.png,317432,12917,304515,0.959307820257567,2,4,66058,1876,64182,0.9716007145236005,23.73152711111111,3238.389536,13.027512733498073,124,5.000000000000007E-4
8,test_20231101_134840,11382381.png,312486,767,311719,0.9975454900379537,1,3,46745,100,46645,0.9978607337683175,21.58402311111111,2479.723024,14.186771864393144,124,5.000000000000007E-4
9,test_20231101_134840,11079715.png,443815,122782,321033,0.7233486925858748,4,5,124136,17120,107016,0.8620867435715667,16.763402666666668,2067.635402666667,14.97606401189655,124,5.000000000000007E-4
10,test_20231101_134840,11551286.png,271883,547,271336,0.9979881051775947,1,3,40092,79,40013,0.9980295320762247,17.838736,1852.2023093333332,15.453919395217167,124,5.000000000000007E-4
1,test_20231101_134841,10404007.png,502730,22102,480628,0.9560360432041056,2,4,61265,3186,58079,0.9479964090426835,25.709000888888887,3427.5201546666667,12.781003436398297,124,5.100000000000007E-4
2,test_20231101_134841,1254659.png,342646,76204,266442,0.777601372845444,7,4,80080,10632,69448,0.8672327672327672,20.676924444444445,3114.4299733333332,13.197017904793334,124,5.100000000000007E-4
3,test_20231101_134841,10188041.png,221231,10022,211209,0.9546989345977733,2,4,41731,1411,40320,0.9661882054108457,10.857368888888889,1051.873824,17.911167130910616,124,5.100000000000007E-4
4,test_20231101_134841,10287332.png,216980,12687,204293,0.9415291731956862,1,4,22337,1739,20598,0.9221471101759413,9.440839111111112,776.604096,19.22880684076492,124,5.100000000000007E-4
5,test_20231101_134841,11610969.png,368720,26582,342138,0.9279073551746583,3,4,84111,3877,80234,0.9539061478284647,21.465290666666668,2964.25984,13.411640906658562,124,5.100000000000007E-4
6,test_20231101_134841,10350842.png,212614,6264,206350,0.9705381583526955,1,3,42529,917,41612,0.978438242140657,19.265742222222222,2361.7458346666667,14.398472027898631,124,5.100000000000007E-4
7,test_20231101_134841,10863862.png,317432,12857,304575,0.9594968371178709,2,4,66058,1867,64191,0.9717369584304701,23.773376,3240.2564693333334,13.025009744859632,124,5.100000000000007E-4
8,test_20231101_134841,11382381.png,312486,767,311719,0.9975454900379537,1,4,46745,100,46645,0.9978607337683175,21.58402311111111,2479.723024,14.186771864393144,124,5.100000000000007E-4
9,test_20231101_134841,11079715.png,443815,122782,321033,0.7233486925858748,4,5,124136,17120,107016,0.8620867435715667,16.763402666666668,2067.635402666667,14.97606401189655,124,5.100000000000007E-4
10,test_20231101_134841,11551286.png,271883,467,271416,0.9982823493929374,1,4,40092,67,40025,0.998328843659583,17.988837333333333,1870.894224,15.410311266718583,124,5.100000000000007E-4
1,test_20231101_134841,10404007.png,502730,22102,480628,0.9560360432041056,2,4,61265,3186,58079,0.9479964090426835,25.709000888888887,3427.5201546666667,12.781003436398297,124,5.200000000000007E-4
2,test_20231101_134841,1254659.png,342646,76204,266442,0.777601372845444,5,5,80080,10632,69448,0.8672327672327672,20.676924444444445,3114.4299733333332,13.197017904793334,124,5.200000000000007E-4
3,test_20231101_134841,10188041.png,221231,10022,211209,0.9546989345977733,2,8,41731,1411,40320,0.9661882054108457,10.857368888888889,1051.873824,17.911167130910616,124,5.200000000000007E-4
4,test_20231101_134841,10287332.png,216980,12687,204293,0.9415291731956862,2,3,22337,1739,20598,0.9221471101759413,9.440839111111112,776.604096,19.22880684076492,124,5.200000000000007E-4
5,test_20231101_134841,11610969.png,368720,26582,342138,0.9279073551746583,3,3,84111,3877,80234,0.9539061478284647,21.465290666666668,2964.25984,13.411640906658562,124,5.200000000000007E-4
6,test_20231101_134841,10350842.png,212614,6264,206350,0.9705381583526955,2,4,42529,917,41612,0.978438242140657,19.265742222222222,2361.7458346666667,14.398472027898631,124,5.200000000000007E-4
7,test_20231101_134841,10863862.png,317432,12857,304575,0.9594968371178709,2,3,66058,1867,64191,0.9717369584304701,23.773376,3240.2564693333334,13.025009744859632,124,5.200000000000007E-4
8,test_20231101_134841,11382381.png,312486,767,311719,0.9975454900379537,1,3,46745,100,46645,0.9978607337683175,21.58402311111111,2479.723024,14.186771864393144,124,5.200000000000007E-4
9,test_20231101_134841,11079715.png,443815,122782,321033,0.7233486925858748,4,4,124136,17120,107016,0.8620867435715667,16.763402666666668,2067.635402666667,14.97606401189655,124,5.200000000000007E-4
10,test_20231101_134841,11551286.png,271883,467,271416,0.9982823493929374,2,4,40092,67,40025,0.998328843659583,17.988837333333333,1870.894224,15.410311266718583,124,5.200000000000007E-4
1,test_20231101_134842,10404007.png,502730,22102,480628,0.9560360432041056,2,4,61265,3186,58079,0.9479964090426835,25.709000888888887,3427.5201546666667,12.781003436398297,124,5.300000000000007E-4
2,test_20231101_134842,1254659.png,342646,76204,266442,0.777601372845444,3,4,80080,10632,69448,0.8672327672327672,20.676924444444445,3114.4299733333332,13.197017904793334,124,5.300000000000007E-4
3,test_20231101_134842,10188041.png,221231,10022,211209,0.9546989345977733,2,3,41731,1411,40320,0.9661882054108457,10.857368888888889,1051.873824,17.911167130910616,124,5.300000000000007E-4
4,test_20231101_134842,10287332.png,216980,12687,204293,0.9415291731956862,1,3,22337,1739,20598,0.9221471101759413,9.440839111111112,776.604096,19.22880684076492,124,5.300000000000007E-4
5,test_20231101_134842,11610969.png,368720,26582,342138,0.9279073551746583,3,10,84111,3877,80234,0.9539061478284647,21.465290666666668,2964.25984,13.411640906658562,124,5.300000000000007E-4
6,test_20231101_134842,10350842.png,212614,6264,206350,0.9705381583526955,2,3,42529,917,41612,0.978438242140657,19.265742222222222,2361.7458346666667,14.398472027898631,124,5.300000000000007E-4
7,test_20231101_134842,10863862.png,317432,12857,304575,0.9594968371178709,2,4,66058,1867,64191,0.9717369584304701,23.773376,3240.2564693333334,13.025009744859632,124,5.300000000000007E-4
8,test_20231101_134842,11382381.png,312486,767,311719,0.9975454900379537,1,4,46745,100,46645,0.9978607337683175,21.58402311111111,2479.723024,14.186771864393144,124,5.300000000000007E-4
9,test_20231101_134842,11079715.png,443815,122782,321033,0.7233486925858748,3,9,124136,17120,107016,0.8620867435715667,16.763402666666668,2067.635402666667,14.97606401189655,124,5.300000000000007E-4
10,test_20231101_134842,11551286.png,271883,467,271416,0.9982823493929374,1,4,40092,67,40025,0.998328843659583,17.988837333333333,1870.894224,15.410311266718583,124,5.300000000000007E-4
1,test_20231101_134843,10404007.png,502730,22102,480628,0.9560360432041056,3,3,61265,3186,58079,0.9479964090426835,25.709000888888887,3427.5201546666667,12.781003436398297,124,5.400000000000008E-4
2,test_20231101_134843,1254659.png,342646,76204,266442,0.777601372845444,3,4,80080,10632,69448,0.8672327672327672,20.676924444444445,3114.4299733333332,13.197017904793334,124,5.400000000000008E-4
3,test_20231101_134843,10188041.png,221231,10022,211209,0.9546989345977733,2,4,41731,1411,40320,0.9661882054108457,10.857368888888889,1051.873824,17.911167130910616,124,5.400000000000008E-4
4,test_20231101_134843,10287332.png,216980,12687,204293,0.9415291731956862,2,4,22337,1739,20598,0.9221471101759413,9.440839111111112,776.604096,19.22880684076492,124,5.400000000000008E-4
5,test_20231101_134843,11610969.png,368720,26582,342138,0.9279073551746583,2,3,84111,3877,80234,0.9539061478284647,21.465290666666668,2964.25984,13.411640906658562,124,5.400000000000008E-4
6,test_20231101_134843,10350842.png,212614,6264,206350,0.9705381583526955,2,4,42529,917,41612,0.978438242140657,19.265742222222222,2361.7458346666667,14.398472027898631,124,5.400000000000008E-4
7,test_20231101_134843,10863862.png,317432,12857,304575,0.9594968371178709,2,4,66058,1867,64191,0.9717369584304701,23.773376,3240.2564693333334,13.025009744859632,124,5.400000000000008E-4
8,test_20231101_134843,11382381.png,312486,767,311719,0.9975454900379537,1,3,46745,100,46645,0.9978607337683175,21.58402311111111,2479.723024,14.186771864393144,124,5.400000000000008E-4
9,test_20231101_134843,11079715.png,443815,122782,321033,0.7233486925858748,4,4,124136,17120,107016,0.8620867435715667,16.763402666666668,2067.635402666667,14.97606401189655,124,5.400000000000008E-4
10,test_20231101_134843,11551286.png,271883,467,271416,0.9982823493929374,1,4,40092,67,40025,0.998328843659583,17.988837333333333,1870.894224,15.410311266718583,124,5.400000000000008E-4
1,test_20231101_134843,10404007.png,502730,22102,480628,0.9560360432041056,2,4,61265,3186,58079,0.9479964090426835,25.709000888888887,3427.5201546666667,12.781003436398297,124,5.500000000000008E-4
2,test_20231101_134843,1254659.png,342646,76204,266442,0.777601372845444,3,5,80080,10632,69448,0.8672327672327672,20.676924444444445,3114.4299733333332,13.197017904793334,124,5.500000000000008E-4
3,test_20231101_134843,10188041.png,221231,10022,211209,0.9546989345977733,2,4,41731,1411,40320,0.9661882054108457,10.857368888888889,1051.873824,17.911167130910616,124,5.500000000000008E-4
4,test_20231101_134843,10287332.png,216980,12687,204293,0.9415291731956862,2,4,22337,1739,20598,0.9221471101759413,9.440839111111112,776.604096,19.22880684076492,124,5.500000000000008E-4
5,test_20231101_134843,11610969.png,368720,26582,342138,0.9279073551746583,2,3,84111,3877,80234,0.9539061478284647,21.465290666666668,2964.25984,13.411640906658562,124,5.500000000000008E-4
6,test_20231101_134843,10350842.png,212614,6264,206350,0.9705381583526955,1,4,42529,917,41612,0.978438242140657,19.265742222222222,2361.7458346666667,14.398472027898631,124,5.500000000000008E-4
7,test_20231101_134843,10863862.png,317432,12857,304575,0.9594968371178709,2,3,66058,1867,64191,0.9717369584304701,23.773376,3240.2564693333334,13.025009744859632,124,5.500000000000008E-4
8,test_20231101_134843,11382381.png,312486,767,311719,0.9975454900379537,2,4,46745,100,46645,0.9978607337683175,21.58402311111111,2479.723024,14.186771864393144,124,5.500000000000008E-4
9,test_20231101_134843,11079715.png,443815,122782,321033,0.7233486925858748,3,5,124136,17120,107016,0.8620867435715667,16.763402666666668,2067.635402666667,14.97606401189655,124,5.500000000000008E-4
10,test_20231101_134843,11551286.png,271883,467,271416,0.9982823493929374,2,3,40092,67,40025,0.998328843659583,17.988837333333333,1870.894224,15.410311266718583,124,5.500000000000008E-4
1,test_20231101_134844,10404007.png,502730,22102,480628,0.9560360432041056,2,3,61265,3186,58079,0.9479964090426835,25.709000888888887,3427.5201546666667,12.781003436398297,124,5.600000000000008E-4
2,test_20231101_134844,1254659.png,342646,76204,266442,0.777601372845444,3,4,80080,10632,69448,0.8672327672327672,20.676924444444445,3114.4299733333332,13.197017904793334,124,5.600000000000008E-4
3,test_20231101_134844,10188041.png,221231,10022,211209,0.9546989345977733,2,4,41731,1411,40320,0.9661882054108457,10.857368888888889,1051.873824,17.911167130910616,124,5.600000000000008E-4
4,test_20231101_134844,10287332.png,216980,12687,204293,0.9415291731956862,1,3,22337,1739,20598,0.9221471101759413,9.440839111111112,776.604096,19.22880684076492,124,5.600000000000008E-4
5,test_20231101_134844,11610969.png,368720,26582,342138,0.9279073551746583,2,3,84111,3877,80234,0.9539061478284647,21.465290666666668,2964.25984,13.411640906658562,124,5.600000000000008E-4
6,test_20231101_134844,10350842.png,212614,6264,206350,0.9705381583526955,1,3,42529,917,41612,0.978438242140657,19.265742222222222,2361.7458346666667,14.398472027898631,124,5.600000000000008E-4
7,test_20231101_134844,10863862.png,317432,12857,304575,0.9594968371178709,2,4,66058,1867,64191,0.9717369584304701,23.773376,3240.2564693333334,13.025009744859632,124,5.600000000000008E-4
8,test_20231101_134844,11382381.png,312486,767,311719,0.9975454900379537,1,4,46745,100,46645,0.9978607337683175,21.58402311111111,2479.723024,14.186771864393144,124,5.600000000000008E-4
9,test_20231101_134844,11079715.png,443815,122782,321033,0.7233486925858748,4,4,124136,17120,107016,0.8620867435715667,16.763402666666668,2067.635402666667,14.97606401189655,124,5.600000000000008E-4
10,test_20231101_134844,11551286.png,271883,467,271416,0.9982823493929374,1,3,40092,67,40025,0.998328843659583,17.988837333333333,1870.894224,15.410311266718583,124,5.600000000000008E-4
1,test_20231101_134845,10404007.png,502730,22102,480628,0.9560360432041056,2,4,61265,3186,58079,0.9479964090426835,25.709000888888887,3427.5201546666667,12.781003436398297,124,5.700000000000008E-4
2,test_20231101_134845,1254659.png,342646,76204,266442,0.777601372845444,3,4,80080,10632,69448,0.8672327672327672,20.676924444444445,3114.4299733333332,13.197017904793334,124,5.700000000000008E-4
3,test_20231101_134845,10188041.png,221231,10022,211209,0.9546989345977733,2,4,41731,1411,40320,0.9661882054108457,10.857368888888889,1051.873824,17.911167130910616,124,5.700000000000008E-4
4,test_20231101_134845,10287332.png,216980,12687,204293,0.9415291731956862,2,4,22337,1739,20598,0.9221471101759413,9.440839111111112,776.604096,19.22880684076492,124,5.700000000000008E-4
5,test_20231101_134845,11610969.png,368720,26582,342138,0.9279073551746583,3,12,84111,3877,80234,0.9539061478284647,21.465290666666668,2964.25984,13.411640906658562,124,5.700000000000008E-4
6,test_20231101_134845,10350842.png,212614,6264,206350,0.9705381583526955,2,4,42529,917,41612,0.978438242140657,19.265742222222222,2361.7458346666667,14.398472027898631,124,5.700000000000008E-4
7,test_20231101_134845,10863862.png,317432,12857,304575,0.9594968371178709,2,4,66058,1867,64191,0.9717369584304701,23.773376,3240.2564693333334,13.025009744859632,124,5.700000000000008E-4
8,test_20231101_134845,11382381.png,312486,767,311719,0.9975454900379537,2,3,46745,100,46645,0.9978607337683175,21.58402311111111,2479.723024,14.186771864393144,124,5.700000000000008E-4
9,test_20231101_134845,11079715.png,443815,122782,321033,0.7233486925858748,3,5,124136,17120,107016,0.8620867435715667,16.763402666666668,2067.635402666667,14.97606401189655,124,5.700000000000008E-4
10,test_20231101_134845,11551286.png,271883,467,271416,0.9982823493929374,2,3,40092,67,40025,0.998328843659583,17.988837333333333,1870.894224,15.410311266718583,124,5.700000000000008E-4
1,test_20231101_134845,10404007.png,502730,22102,480628,0.9560360432041056,2,3,61265,3186,58079,0.9479964090426835,25.709000888888887,3427.5201546666667,12.781003436398297,124,5.800000000000009E-4
2,test_20231101_134845,1254659.png,342646,76204,266442,0.777601372845444,3,4,80080,10632,69448,0.8672327672327672,20.676924444444445,3114.4299733333332,13.197017904793334,124,5.800000000000009E-4
3,test_20231101_134845,10188041.png,221231,10022,211209,0.9546989345977733,2,4,41731,1411,40320,0.9661882054108457,10.857368888888889,1051.873824,17.911167130910616,124,5.800000000000009E-4
4,test_20231101_134845,10287332.png,216980,12687,204293,0.9415291731956862,1,3,22337,1739,20598,0.9221471101759413,9.440839111111112,776.604096,19.22880684076492,124,5.800000000000009E-4
5,test_20231101_134845,11610969.png,368720,26582,342138,0.9279073551746583,2,4,84111,3877,80234,0.9539061478284647,21.465290666666668,2964.25984,13.411640906658562,124,5.800000000000009E-4
6,test_20231101_134845,10350842.png,212614,6264,206350,0.9705381583526955,2,4,42529,917,41612,0.978438242140657,19.265742222222222,2361.7458346666667,14.398472027898631,124,5.800000000000009E-4
7,test_20231101_134845,10863862.png,317432,12857,304575,0.9594968371178709,2,4,66058,1867,64191,0.9717369584304701,23.773376,3240.2564693333334,13.025009744859632,124,5.800000000000009E-4
8,test_20231101_134845,11382381.png,312486,767,311719,0.9975454900379537,1,4,46745,100,46645,0.9978607337683175,21.58402311111111,2479.723024,14.186771864393144,124,5.800000000000009E-4
9,test_20231101_134845,11079715.png,443815,122782,321033,0.7233486925858748,4,4,124136,17120,107016,0.8620867435715667,16.763402666666668,2067.635402666667,14.97606401189655,124,5.800000000000009E-4
10,test_20231101_134845,11551286.png,271883,467,271416,0.9982823493929374,1,4,40092,67,40025,0.998328843659583,17.988837333333333,1870.894224,15.410311266718583,124,5.800000000000009E-4
1,test_20231101_134846,10404007.png,502730,22102,480628,0.9560360432041056,2,3,61265,3186,58079,0.9479964090426835,25.709000888888887,3427.5201546666667,12.781003436398297,124,5.900000000000009E-4
2,test_20231101_134846,1254659.png,342646,76204,266442,0.777601372845444,3,4,80080,10632,69448,0.8672327672327672,20.676924444444445,3114.4299733333332,13.197017904793334,124,5.900000000000009E-4
3,test_20231101_134846,10188041.png,221231,10022,211209,0.9546989345977733,2,3,41731,1411,40320,0.9661882054108457,10.857368888888889,1051.873824,17.911167130910616,124,5.900000000000009E-4
4,test_20231101_134846,10287332.png,216980,12687,204293,0.9415291731956862,1,4,22337,1739,20598,0.9221471101759413,9.440839111111112,776.604096,19.22880684076492,124,5.900000000000009E-4
5,test_20231101_134846,11610969.png,368720,26582,342138,0.9279073551746583,3,3,84111,3877,80234,0.9539061478284647,21.465290666666668,2964.25984,13.411640906658562,124,5.900000000000009E-4
6,test_20231101_134846,10350842.png,212614,6264,206350,0.9705381583526955,1,3,42529,917,41612,0.978438242140657,19.265742222222222,2361.7458346666667,14.398472027898631,124,5.900000000000009E-4
7,test_20231101_134846,10863862.png,317432,12857,304575,0.9594968371178709,2,4,66058,1867,64191,0.9717369584304701,23.773376,3240.2564693333334,13.025009744859632,124,5.900000000000009E-4
8,test_20231101_134846,11382381.png,312486,767,311719,0.9975454900379537,1,3,46745,100,46645,0.9978607337683175,21.58402311111111,2479.723024,14.186771864393144,124,5.900000000000009E-4
9,test_20231101_134846,11079715.png,443815,122782,321033,0.7233486925858748,3,5,124136,17120,107016,0.8620867435715667,16.763402666666668,2067.635402666667,14.97606401189655,124,5.900000000000009E-4
10,test_20231101_134846,11551286.png,271883,467,271416,0.9982823493929374,1,3,40092,67,40025,0.998328843659583,17.988837333333333,1870.894224,15.410311266718583,124,5.900000000000009E-4
1,test_20231101_134847,10404007.png,502730,22102,480628,0.9560360432041056,3,3,61265,3186,58079,0.9479964090426835,25.709000888888887,3427.5201546666667,12.781003436398297,124,6.000000000000009E-4
2,test_20231101_134847,1254659.png,342646,76204,266442,0.777601372845444,3,4,80080,10632,69448,0.8672327672327672,20.676924444444445,3114.4299733333332,13.197017904793334,124,6.000000000000009E-4
3,test_20231101_134847,10188041.png,221231,10022,211209,0.9546989345977733,2,3,41731,1411,40320,0.9661882054108457,10.857368888888889,1051.873824,17.911167130910616,124,6.000000000000009E-4
4,test_20231101_134847,10287332.png,216980,12687,204293,0.9415291731956862,2,3,22337,1739,20598,0.9221471101759413,9.440839111111112,776.604096,19.22880684076492,124,6.000000000000009E-4
5,test_20231101_134847,11610969.png,368720,26582,342138,0.9279073551746583,2,4,84111,3877,80234,0.9539061478284647,21.465290666666668,2964.25984,13.411640906658562,124,6.000000000000009E-4
6,test_20231101_134847,10350842.png,212614,6264,206350,0.9705381583526955,2,3,42529,917,41612,0.978438242140657,19.265742222222222,2361.7458346666667,14.398472027898631,124,6.000000000000009E-4
7,test_20231101_134847,10863862.png,317432,12857,304575,0.9594968371178709,2,3,66058,1867,64191,0.9717369584304701,23.773376,3240.2564693333334,13.025009744859632,124,6.000000000000009E-4
8,test_20231101_134847,11382381.png,312486,767,311719,0.9975454900379537,2,4,46745,100,46645,0.9978607337683175,21.58402311111111,2479.723024,14.186771864393144,124,6.000000000000009E-4
9,test_20231101_134847,11079715.png,443815,122782,321033,0.7233486925858748,3,5,124136,17120,107016,0.8620867435715667,16.763402666666668,2067.635402666667,14.97606401189655,124,6.000000000000009E-4
10,test_20231101_134847,11551286.png,271883,467,271416,0.9982823493929374,1,4,40092,67,40025,0.998328843659583,17.988837333333333,1870.894224,15.410311266718583,124,6.000000000000009E-4
1,test_20231101_134847,10404007.png,502730,22102,480628,0.9560360432041056,2,4,61265,3186,58079,0.9479964090426835,25.709000888888887,3427.5201546666667,12.781003436398297,124,6.10000000000001E-4
2,test_20231101_134847,1254659.png,342646,76204,266442,0.777601372845444,3,5,80080,10632,69448,0.8672327672327672,20.676924444444445,3114.4299733333332,13.197017904793334,124,6.10000000000001E-4
3,test_20231101_134847,10188041.png,221231,10022,211209,0.9546989345977733,2,4,41731,1411,40320,0.9661882054108457,10.857368888888889,1051.873824,17.911167130910616,124,6.10000000000001E-4
4,test_20231101_134847,10287332.png,216980,12687,204293,0.9415291731956862,1,4,22337,1739,20598,0.9221471101759413,9.440839111111112,776.604096,19.22880684076492,124,6.10000000000001E-4
5,test_20231101_134847,11610969.png,368720,26582,342138,0.9279073551746583,3,4,84111,3877,80234,0.9539061478284647,21.465290666666668,2964.25984,13.411640906658562,124,6.10000000000001E-4
6,test_20231101_134847,10350842.png,212614,6264,206350,0.9705381583526955,1,4,42529,917,41612,0.978438242140657,19.265742222222222,2361.7458346666667,14.398472027898631,124,6.10000000000001E-4
7,test_20231101_134847,10863862.png,317432,12857,304575,0.9594968371178709,2,4,66058,1867,64191,0.9717369584304701,23.773376,3240.2564693333334,13.025009744859632,124,6.10000000000001E-4
8,test_20231101_134847,11382381.png,312486,767,311719,0.9975454900379537,1,4,46745,100,46645,0.9978607337683175,21.58402311111111,2479.723024,14.186771864393144,124,6.10000000000001E-4
9,test_20231101_134847,11079715.png,443815,122782,321033,0.7233486925858748,4,5,124136,17120,107016,0.8620867435715667,16.763402666666668,2067.635402666667,14.97606401189655,124,6.10000000000001E-4
10,test_20231101_134847,11551286.png,271883,467,271416,0.9982823493929374,1,4,40092,67,40025,0.998328843659583,17.988837333333333,1870.894224,15.410311266718583,124,6.10000000000001E-4
1,test_20231101_134848,10404007.png,502730,22102,480628,0.9560360432041056,3,3,61265,3186,58079,0.9479964090426835,25.709000888888887,3427.5201546666667,12.781003436398297,124,6.20000000000001E-4
2,test_20231101_134848,1254659.png,342646,76204,266442,0.777601372845444,3,4,80080,10632,69448,0.8672327672327672,20.676924444444445,3114.4299733333332,13.197017904793334,124,6.20000000000001E-4
3,test_20231101_134848,10188041.png,221231,10022,211209,0.9546989345977733,2,3,41731,1411,40320,0.9661882054108457,10.857368888888889,1051.873824,17.911167130910616,124,6.20000000000001E-4
4,test_20231101_134848,10287332.png,216980,12687,204293,0.9415291731956862,2,4,22337,1739,20598,0.9221471101759413,9.440839111111112,776.604096,19.22880684076492,124,6.20000000000001E-4
5,test_20231101_134848,11610969.png,368720,26582,342138,0.9279073551746583,2,3,84111,3877,80234,0.9539061478284647,21.465290666666668,2964.25984,13.411640906658562,124,6.20000000000001E-4
6,test_20231101_134848,10350842.png,212614,6264,206350,0.9705381583526955,1,4,42529,917,41612,0.978438242140657,19.265742222222222,2361.7458346666667,14.398472027898631,124,6.20000000000001E-4
7,test_20231101_134848,10863862.png,317432,12857,304575,0.9594968371178709,2,4,66058,1867,64191,0.9717369584304701,23.773376,3240.2564693333334,13.025009744859632,124,6.20000000000001E-4
8,test_20231101_134848,11382381.png,312486,767,311719,0.9975454900379537,2,3,46745,100,46645,0.9978607337683175,21.58402311111111,2479.723024,14.186771864393144,124,6.20000000000001E-4
9,test_20231101_134848,11079715.png,443815,122782,321033,0.7233486925858748,3,4,124136,17120,107016,0.8620867435715667,16.763402666666668,2067.635402666667,14.97606401189655,124,6.20000000000001E-4
10,test_20231101_134848,11551286.png,271883,467,271416,0.9982823493929374,1,3,40092,67,40025,0.998328843659583,17.988837333333333,1870.894224,15.410311266718583,124,6.20000000000001E-4
1,test_20231101_134849,10404007.png,502730,22102,480628,0.9560360432041056,2,3,61265,3186,58079,0.9479964090426835,25.709000888888887,3427.5201546666667,12.781003436398297,124,6.30000000000001E-4
2,test_20231101_134849,1254659.png,342646,76204,266442,0.777601372845444,3,4,80080,10632,69448,0.8672327672327672,20.676924444444445,3114.4299733333332,13.197017904793334,124,6.30000000000001E-4
3,test_20231101_134849,10188041.png,221231,10022,211209,0.9546989345977733,2,3,41731,1411,40320,0.9661882054108457,10.857368888888889,1051.873824,17.911167130910616,124,6.30000000000001E-4
4,test_20231101_134849,10287332.png,216980,12687,204293,0.9415291731956862,1,4,22337,1739,20598,0.9221471101759413,9.440839111111112,776.604096,19.22880684076492,124,6.30000000000001E-4
5,test_20231101_134849,11610969.png,368720,26582,342138,0.9279073551746583,3,4,84111,3877,80234,0.9539061478284647,21.465290666666668,2964.25984,13.411640906658562,124,6.30000000000001E-4
6,test_20231101_134849,10350842.png,212614,6264,206350,0.9705381583526955,1,4,42529,917,41612,0.978438242140657,19.265742222222222,2361.7458346666667,14.398472027898631,124,6.30000000000001E-4
7,test_20231101_134849,10863862.png,317432,12857,304575,0.9594968371178709,2,4,66058,1867,64191,0.9717369584304701,23.773376,3240.2564693333334,13.025009744859632,124,6.30000000000001E-4
8,test_20231101_134849,11382381.png,312486,767,311719,0.9975454900379537,2,3,46745,100,46645,0.9978607337683175,21.58402311111111,2479.723024,14.186771864393144,124,6.30000000000001E-4
9,test_20231101_134849,11079715.png,443815,122782,321033,0.7233486925858748,3,4,124136,17120,107016,0.8620867435715667,16.763402666666668,2067.635402666667,14.97606401189655,124,6.30000000000001E-4
10,test_20231101_134849,11551286.png,271883,467,271416,0.9982823493929374,1,4,40092,67,40025,0.998328843659583,17.988837333333333,1870.894224,15.410311266718583,124,6.30000000000001E-4
1,test_20231101_134849,10404007.png,502730,22102,480628,0.9560360432041056,2,4,61265,3186,58079,0.9479964090426835,25.709000888888887,3427.5201546666667,12.781003436398297,124,6.40000000000001E-4
2,test_20231101_134849,1254659.png,342646,76204,266442,0.777601372845444,3,4,80080,10632,69448,0.8672327672327672,20.676924444444445,3114.4299733333332,13.197017904793334,124,6.40000000000001E-4
3,test_20231101_134849,10188041.png,221231,10022,211209,0.9546989345977733,2,4,41731,1411,40320,0.9661882054108457,10.857368888888889,1051.873824,17.911167130910616,124,6.40000000000001E-4
4,test_20231101_134849,10287332.png,216980,12687,204293,0.9415291731956862,1,4,22337,1739,20598,0.9221471101759413,9.440839111111112,776.604096,19.22880684076492,124,6.40000000000001E-4
5,test_20231101_134849,11610969.png,368720,26582,342138,0.9279073551746583,2,4,84111,3877,80234,0.9539061478284647,21.465290666666668,2964.25984,13.411640906658562,124,6.40000000000001E-4
6,test_20231101_134849,10350842.png,212614,6264,206350,0.9705381583526955,1,3,42529,917,41612,0.978438242140657,19.265742222222222,2361.7458346666667,14.398472027898631,124,6.40000000000001E-4
7,test_20231101_134849,10863862.png,317432,12857,304575,0.9594968371178709,2,3,66058,1867,64191,0.9717369584304701,23.773376,3240.2564693333334,13.025009744859632,124,6.40000000000001E-4
8,test_20231101_134849,11382381.png,312486,767,311719,0.9975454900379537,2,3,46745,100,46645,0.9978607337683175,21.58402311111111,2479.723024,14.186771864393144,124,6.40000000000001E-4
9,test_20231101_134849,11079715.png,443815,122782,321033,0.7233486925858748,4,5,124136,17120,107016,0.8620867435715667,16.763402666666668,2067.635402666667,14.97606401189655,124,6.40000000000001E-4
10,test_20231101_134849,11551286.png,271883,467,271416,0.9982823493929374,2,4,40092,67,40025,0.998328843659583,17.988837333333333,1870.894224,15.410311266718583,124,6.40000000000001E-4
1,test_20231101_134850,10404007.png,502730,22102,480628,0.9560360432041056,2,3,61265,3186,58079,0.9479964090426835,25.709000888888887,3427.5201546666667,12.781003436398297,124,6.500000000000011E-4
2,test_20231101_134850,1254659.png,342646,76204,266442,0.777601372845444,2,4,80080,10632,69448,0.8672327672327672,20.676924444444445,3114.4299733333332,13.197017904793334,124,6.500000000000011E-4
3,test_20231101_134850,10188041.png,221231,10022,211209,0.9546989345977733,2,3,41731,1411,40320,0.9661882054108457,10.857368888888889,1051.873824,17.911167130910616,124,6.500000000000011E-4
4,test_20231101_134850,10287332.png,216980,12687,204293,0.9415291731956862,2,4,22337,1739,20598,0.9221471101759413,9.440839111111112,776.604096,19.22880684076492,124,6.500000000000011E-4
5,test_20231101_134850,11610969.png,368720,26582,342138,0.9279073551746583,2,3,84111,3877,80234,0.9539061478284647,21.465290666666668,2964.25984,13.411640906658562,124,6.500000000000011E-4
6,test_20231101_134850,10350842.png,212614,6264,206350,0.9705381583526955,2,4,42529,917,41612,0.978438242140657,19.265742222222222,2361.7458346666667,14.398472027898631,124,6.500000000000011E-4
7,test_20231101_134850,10863862.png,317432,12857,304575,0.9594968371178709,2,4,66058,1867,64191,0.9717369584304701,23.773376,3240.2564693333334,13.025009744859632,124,6.500000000000011E-4
8,test_20231101_134850,11382381.png,312486,767,311719,0.9975454900379537,2,4,46745,100,46645,0.9978607337683175,21.58402311111111,2479.723024,14.186771864393144,124,6.500000000000011E-4
9,test_20231101_134850,11079715.png,443815,122782,321033,0.7233486925858748,3,4,124136,17120,107016,0.8620867435715667,16.763402666666668,2067.635402666667,14.97606401189655,124,6.500000000000011E-4
10,test_20231101_134850,11551286.png,271883,467,271416,0.9982823493929374,1,4,40092,67,40025,0.998328843659583,17.988837333333333,1870.894224,15.410311266718583,124,6.500000000000011E-4
1,test_20231101_134851,10404007.png,502730,22102,480628,0.9560360432041056,3,4,61265,3186,58079,0.9479964090426835,25.709000888888887,3427.5201546666667,12.781003436398297,124,6.600000000000011E-4
2,test_20231101_134851,1254659.png,342646,76204,266442,0.777601372845444,3,4,80080,10632,69448,0.8672327672327672,20.676924444444445,3114.4299733333332,13.197017904793334,124,6.600000000000011E-4
3,test_20231101_134851,10188041.png,221231,10022,211209,0.9546989345977733,2,4,41731,1411,40320,0.9661882054108457,10.857368888888889,1051.873824,17.911167130910616,124,6.600000000000011E-4
4,test_20231101_134851,10287332.png,216980,12687,204293,0.9415291731956862,1,4,22337,1739,20598,0.9221471101759413,9.440839111111112,776.604096,19.22880684076492,124,6.600000000000011E-4
5,test_20231101_134851,11610969.png,368720,26582,342138,0.9279073551746583,2,4,84111,3877,80234,0.9539061478284647,21.465290666666668,2964.25984,13.411640906658562,124,6.600000000000011E-4
6,test_20231101_134851,10350842.png,212614,6264,206350,0.9705381583526955,2,4,42529,917,41612,0.978438242140657,19.265742222222222,2361.7458346666667,14.398472027898631,124,6.600000000000011E-4
7,test_20231101_134851,10863862.png,317432,12857,304575,0.9594968371178709,2,4,66058,1867,64191,0.9717369584304701,23.773376,3240.2564693333334,13.025009744859632,124,6.600000000000011E-4
8,test_20231101_134851,11382381.png,312486,767,311719,0.9975454900379537,1,3,46745,100,46645,0.9978607337683175,21.58402311111111,2479.723024,14.186771864393144,124,6.600000000000011E-4
9,test_20231101_134851,11079715.png,443815,122782,321033,0.7233486925858748,3,4,124136,17120,107016,0.8620867435715667,16.763402666666668,2067.635402666667,14.97606401189655,124,6.600000000000011E-4
10,test_20231101_134851,11551286.png,271883,467,271416,0.9982823493929374,1,3,40092,67,40025,0.998328843659583,17.988837333333333,1870.894224,15.410311266718583,124,6.600000000000011E-4
1,test_20231101_134851,10404007.png,502730,22102,480628,0.9560360432041056,2,4,61265,3186,58079,0.9479964090426835,25.709000888888887,3427.5201546666667,12.781003436398297,124,6.700000000000011E-4
2,test_20231101_134851,1254659.png,342646,76204,266442,0.777601372845444,3,4,80080,10632,69448,0.8672327672327672,20.676924444444445,3114.4299733333332,13.197017904793334,124,6.700000000000011E-4
3,test_20231101_134851,10188041.png,221231,10022,211209,0.9546989345977733,2,4,41731,1411,40320,0.9661882054108457,10.857368888888889,1051.873824,17.911167130910616,124,6.700000000000011E-4
4,test_20231101_134851,10287332.png,216980,12687,204293,0.9415291731956862,2,4,22337,1739,20598,0.9221471101759413,9.440839111111112,776.604096,19.22880684076492,124,6.700000000000011E-4
5,test_20231101_134851,11610969.png,368720,26582,342138,0.9279073551746583,2,4,84111,3877,80234,0.9539061478284647,21.465290666666668,2964.25984,13.411640906658562,124,6.700000000000011E-4
6,test_20231101_134851,10350842.png,212614,6264,206350,0.9705381583526955,1,4,42529,917,41612,0.978438242140657,19.265742222222222,2361.7458346666667,14.398472027898631,124,6.700000000000011E-4
7,test_20231101_134851,10863862.png,317432,12857,304575,0.9594968371178709,2,4,66058,1867,64191,0.9717369584304701,23.773376,3240.2564693333334,13.025009744859632,124,6.700000000000011E-4
8,test_20231101_134851,11382381.png,312486,767,311719,0.9975454900379537,2,3,46745,100,46645,0.9978607337683175,21.58402311111111,2479.723024,14.186771864393144,124,6.700000000000011E-4
9,test_20231101_134851,11079715.png,443815,122782,321033,0.7233486925858748,4,5,124136,17120,107016,0.8620867435715667,16.763402666666668,2067.635402666667,14.97606401189655,124,6.700000000000011E-4
10,test_20231101_134851,11551286.png,271883,467,271416,0.9982823493929374,1,3,40092,67,40025,0.998328843659583,17.988837333333333,1870.894224,15.410311266718583,124,6.700000000000011E-4
1,test_20231101_134852,10404007.png,502730,22102,480628,0.9560360432041056,2,4,61265,3186,58079,0.9479964090426835,25.709000888888887,3427.5201546666667,12.781003436398297,124,6.800000000000011E-4
2,test_20231101_134852,1254659.png,342646,76204,266442,0.777601372845444,4,4,80080,10632,69448,0.8672327672327672,20.676924444444445,3114.4299733333332,13.197017904793334,124,6.800000000000011E-4
3,test_20231101_134852,10188041.png,221231,10022,211209,0.9546989345977733,2,4,41731,1411,40320,0.9661882054108457,10.857368888888889,1051.873824,17.911167130910616,124,6.800000000000011E-4
4,test_20231101_134852,10287332.png,216980,12687,204293,0.9415291731956862,2,4,22337,1739,20598,0.9221471101759413,9.440839111111112,776.604096,19.22880684076492,124,6.800000000000011E-4
5,test_20231101_134852,11610969.png,368720,26582,342138,0.9279073551746583,2,4,84111,3877,80234,0.9539061478284647,21.465290666666668,2964.25984,13.411640906658562,124,6.800000000000011E-4
6,test_20231101_134852,10350842.png,212614,6264,206350,0.9705381583526955,1,4,42529,917,41612,0.978438242140657,19.265742222222222,2361.7458346666667,14.398472027898631,124,6.800000000000011E-4
7,test_20231101_134852,10863862.png,317432,12857,304575,0.9594968371178709,2,4,66058,1867,64191,0.9717369584304701,23.773376,3240.2564693333334,13.025009744859632,124,6.800000000000011E-4
8,test_20231101_134852,11382381.png,312486,767,311719,0.9975454900379537,2,3,46745,100,46645,0.9978607337683175,21.58402311111111,2479.723024,14.186771864393144,124,6.800000000000011E-4
9,test_20231101_134852,11079715.png,443815,122782,321033,0.7233486925858748,4,4,124136,17120,107016,0.8620867435715667,16.763402666666668,2067.635402666667,14.97606401189655,124,6.800000000000011E-4
10,test_20231101_134852,11551286.png,271883,467,271416,0.9982823493929374,1,3,40092,67,40025,0.998328843659583,17.988837333333333,1870.894224,15.410311266718583,124,6.800000000000011E-4
1,test_20231101_134853,10404007.png,502730,22102,480628,0.9560360432041056,2,3,61265,3186,58079,0.9479964090426835,25.709000888888887,3427.5201546666667,12.781003436398297,124,6.900000000000012E-4
2,test_20231101_134853,1254659.png,342646,76204,266442,0.777601372845444,3,4,80080,10632,69448,0.8672327672327672,20.676924444444445,3114.4299733333332,13.197017904793334,124,6.900000000000012E-4
3,test_20231101_134853,10188041.png,221231,10022,211209,0.9546989345977733,2,5,41731,1411,40320,0.9661882054108457,10.857368888888889,1051.873824,17.911167130910616,124,6.900000000000012E-4
4,test_20231101_134853,10287332.png,216980,12687,204293,0.9415291731956862,2,12,22337,1739,20598,0.9221471101759413,9.440839111111112,776.604096,19.22880684076492,124,6.900000000000012E-4
5,test_20231101_134853,11610969.png,368720,26582,342138,0.9279073551746583,2,5,84111,3877,80234,0.9539061478284647,21.465290666666668,2964.25984,13.411640906658562,124,6.900000000000012E-4
6,test_20231101_134853,10350842.png,212614,6264,206350,0.9705381583526955,2,4,42529,917,41612,0.978438242140657,19.265742222222222,2361.7458346666667,14.398472027898631,124,6.900000000000012E-4
7,test_20231101_134853,10863862.png,317432,12857,304575,0.9594968371178709,2,3,66058,1867,64191,0.9717369584304701,23.773376,3240.2564693333334,13.025009744859632,124,6.900000000000012E-4
8,test_20231101_134853,11382381.png,312486,767,311719,0.9975454900379537,2,4,46745,100,46645,0.9978607337683175,21.58402311111111,2479.723024,14.186771864393144,124,6.900000000000012E-4
9,test_20231101_134853,11079715.png,443815,122782,321033,0.7233486925858748,3,4,124136,17120,107016,0.8620867435715667,16.763402666666668,2067.635402666667,14.97606401189655,124,6.900000000000012E-4
10,test_20231101_134853,11551286.png,271883,467,271416,0.9982823493929374,1,3,40092,67,40025,0.998328843659583,17.988837333333333,1870.894224,15.410311266718583,124,6.900000000000012E-4
1,test_20231101_134853,10404007.png,502730,22102,480628,0.9560360432041056,3,3,61265,3186,58079,0.9479964090426835,25.709000888888887,3427.5201546666667,12.781003436398297,124,7.000000000000012E-4
2,test_20231101_134853,1254659.png,342646,76204,266442,0.777601372845444,3,4,80080,10632,69448,0.8672327672327672,20.676924444444445,3114.4299733333332,13.197017904793334,124,7.000000000000012E-4
3,test_20231101_134853,10188041.png,221231,10022,211209,0.9546989345977733,2,4,41731,1411,40320,0.9661882054108457,10.857368888888889,1051.873824,17.911167130910616,124,7.000000000000012E-4
4,test_20231101_134853,10287332.png,216980,12687,204293,0.9415291731956862,2,4,22337,1739,20598,0.9221471101759413,9.440839111111112,776.604096,19.22880684076492,124,7.000000000000012E-4
5,test_20231101_134853,11610969.png,368720,26582,342138,0.9279073551746583,3,4,84111,3877,80234,0.9539061478284647,21.465290666666668,2964.25984,13.411640906658562,124,7.000000000000012E-4
6,test_20231101_134853,10350842.png,212614,6264,206350,0.9705381583526955,1,4,42529,917,41612,0.978438242140657,19.265742222222222,2361.7458346666667,14.398472027898631,124,7.000000000000012E-4
7,test_20231101_134853,10863862.png,317432,12857,304575,0.9594968371178709,2,3,66058,1867,64191,0.9717369584304701,23.773376,3240.2564693333334,13.025009744859632,124,7.000000000000012E-4
8,test_20231101_134853,11382381.png,312486,767,311719,0.9975454900379537,2,3,46745,100,46645,0.9978607337683175,21.58402311111111,2479.723024,14.186771864393144,124,7.000000000000012E-4
9,test_20231101_134853,11079715.png,443815,122782,321033,0.7233486925858748,4,4,124136,17120,107016,0.8620867435715667,16.763402666666668,2067.635402666667,14.97606401189655,124,7.000000000000012E-4
10,test_20231101_134853,11551286.png,271883,467,271416,0.9982823493929374,2,4,40092,67,40025,0.998328843659583,17.988837333333333,1870.894224,15.410311266718583,124,7.000000000000012E-4
1,test_20231101_134854,10404007.png,502730,21839,480891,0.9565591868398544,2,4,61265,3149,58116,0.9486003427731984,25.754179555555556,3436.142549333333,12.770091885071036,124,7.100000000000012E-4
2,test_20231101_134854,1254659.png,342646,76204,266442,0.777601372845444,3,4,80080,10632,69448,0.8672327672327672,20.676924444444445,3114.4299733333332,13.197017904793334,124,7.100000000000012E-4
3,test_20231101_134854,10188041.png,221231,10022,211209,0.9546989345977733,2,4,41731,1411,40320,0.9661882054108457,10.857368888888889,1051.873824,17.911167130910616,124,7.100000000000012E-4
4,test_20231101_134854,10287332.png,216980,12687,204293,0.9415291731956862,2,3,22337,1739,20598,0.9221471101759413,9.440839111111112,776.604096,19.22880684076492,124,7.100000000000012E-4
5,test_20231101_134854,11610969.png,368720,26582,342138,0.9279073551746583,3,4,84111,3877,80234,0.9539061478284647,21.465290666666668,2964.25984,13.411640906658562,124,7.100000000000012E-4
6,test_20231101_134854,10350842.png,212614,6264,206350,0.9705381583526955,2,3,42529,917,41612,0.978438242140657,19.265742222222222,2361.7458346666667,14.398472027898631,124,7.100000000000012E-4
7,test_20231101_134854,10863862.png,317432,12857,304575,0.9594968371178709,2,4,66058,1867,64191,0.9717369584304701,23.773376,3240.2564693333334,13.025009744859632,124,7.100000000000012E-4
8,test_20231101_134854,11382381.png,312486,767,311719,0.9975454900379537,2,8,46745,100,46645,0.9978607337683175,21.58402311111111,2479.723024,14.186771864393144,124,7.100000000000012E-4
9,test_20231101_134854,11079715.png,443815,122782,321033,0.7233486925858748,4,5,124136,17120,107016,0.8620867435715667,16.763402666666668,2067.635402666667,14.97606401189655,124,7.100000000000012E-4
10,test_20231101_134854,11551286.png,271883,467,271416,0.9982823493929374,1,3,40092,67,40025,0.998328843659583,17.988837333333333,1870.894224,15.410311266718583,124,7.100000000000012E-4
1,test_20231101_134855,10404007.png,502730,21839,480891,0.9565591868398544,2,4,61265,3149,58116,0.9486003427731984,25.754179555555556,3436.142549333333,12.770091885071036,124,7.200000000000012E-4
2,test_20231101_134855,1254659.png,342646,76204,266442,0.777601372845444,3,4,80080,10632,69448,0.8672327672327672,20.676924444444445,3114.4299733333332,13.197017904793334,124,7.200000000000012E-4
3,test_20231101_134855,10188041.png,221231,10022,211209,0.9546989345977733,2,3,41731,1411,40320,0.9661882054108457,10.857368888888889,1051.873824,17.911167130910616,124,7.200000000000012E-4
4,test_20231101_134855,10287332.png,216980,12687,204293,0.9415291731956862,2,4,22337,1739,20598,0.9221471101759413,9.440839111111112,776.604096,19.22880684076492,124,7.200000000000012E-4
5,test_20231101_134855,11610969.png,368720,26582,342138,0.9279073551746583,3,4,84111,3877,80234,0.9539061478284647,21.465290666666668,2964.25984,13.411640906658562,124,7.200000000000012E-4
6,test_20231101_134855,10350842.png,212614,6264,206350,0.9705381583526955,2,3,42529,917,41612,0.978438242140657,19.265742222222222,2361.7458346666667,14.398472027898631,124,7.200000000000012E-4
7,test_20231101_134855,10863862.png,317432,12857,304575,0.9594968371178709,2,3,66058,1867,64191,0.9717369584304701,23.773376,3240.2564693333334,13.025009744859632,124,7.200000000000012E-4
8,test_20231101_134855,11382381.png,312486,767,311719,0.9975454900379537,2,4,46745,100,46645,0.9978607337683175,21.58402311111111,2479.723024,14.186771864393144,124,7.200000000000012E-4
9,test_20231101_134855,11079715.png,443815,122782,321033,0.7233486925858748,3,4,124136,17120,107016,0.8620867435715667,16.763402666666668,2067.635402666667,14.97606401189655,124,7.200000000000012E-4
10,test_20231101_134855,11551286.png,271883,467,271416,0.9982823493929374,1,3,40092,67,40025,0.998328843659583,17.988837333333333,1870.894224,15.410311266718583,124,7.200000000000012E-4
1,test_20231101_134856,10404007.png,502730,21839,480891,0.9565591868398544,3,4,61265,3149,58116,0.9486003427731984,25.754179555555556,3436.142549333333,12.770091885071036,124,7.300000000000013E-4
2,test_20231101_134856,1254659.png,342646,76204,266442,0.777601372845444,3,4,80080,10632,69448,0.8672327672327672,20.676924444444445,3114.4299733333332,13.197017904793334,124,7.300000000000013E-4
3,test_20231101_134856,10188041.png,221231,10022,211209,0.9546989345977733,2,3,41731,1411,40320,0.9661882054108457,10.857368888888889,1051.873824,17.911167130910616,124,7.300000000000013E-4
4,test_20231101_134856,10287332.png,216980,12687,204293,0.9415291731956862,2,3,22337,1739,20598,0.9221471101759413,9.440839111111112,776.604096,19.22880684076492,124,7.300000000000013E-4
5,test_20231101_134856,11610969.png,368720,26582,342138,0.9279073551746583,3,4,84111,3877,80234,0.9539061478284647,21.465290666666668,2964.25984,13.411640906658562,124,7.300000000000013E-4
6,test_20231101_134856,10350842.png,212614,6264,206350,0.9705381583526955,1,3,42529,917,41612,0.978438242140657,19.265742222222222,2361.7458346666667,14.398472027898631,124,7.300000000000013E-4
7,test_20231101_134856,10863862.png,317432,12857,304575,0.9594968371178709,2,3,66058,1867,64191,0.9717369584304701,23.773376,3240.2564693333334,13.025009744859632,124,7.300000000000013E-4
8,test_20231101_134856,11382381.png,312486,767,311719,0.9975454900379537,2,4,46745,100,46645,0.9978607337683175,21.58402311111111,2479.723024,14.186771864393144,124,7.300000000000013E-4
9,test_20231101_134856,11079715.png,443815,122782,321033,0.7233486925858748,3,5,124136,17120,107016,0.8620867435715667,16.763402666666668,2067.635402666667,14.97606401189655,124,7.300000000000013E-4
10,test_20231101_134856,11551286.png,271883,467,271416,0.9982823493929374,2,3,40092,67,40025,0.998328843659583,17.988837333333333,1870.894224,15.410311266718583,124,7.300000000000013E-4
1,test_20231101_134856,10404007.png,502730,21839,480891,0.9565591868398544,3,4,61265,3149,58116,0.9486003427731984,25.754179555555556,3436.142549333333,12.770091885071036,124,7.400000000000013E-4
2,test_20231101_134856,1254659.png,342646,76204,266442,0.777601372845444,3,4,80080,10632,69448,0.8672327672327672,20.676924444444445,3114.4299733333332,13.197017904793334,124,7.400000000000013E-4
3,test_20231101_134856,10188041.png,221231,10022,211209,0.9546989345977733,2,3,41731,1411,40320,0.9661882054108457,10.857368888888889,1051.873824,17.911167130910616,124,7.400000000000013E-4
4,test_20231101_134856,10287332.png,216980,12687,204293,0.9415291731956862,1,4,22337,1739,20598,0.9221471101759413,9.440839111111112,776.604096,19.22880684076492,124,7.400000000000013E-4
5,test_20231101_134856,11610969.png,368720,26582,342138,0.9279073551746583,2,4,84111,3877,80234,0.9539061478284647,21.465290666666668,2964.25984,13.411640906658562,124,7.400000000000013E-4
6,test_20231101_134856,10350842.png,212614,6264,206350,0.9705381583526955,1,4,42529,917,41612,0.978438242140657,19.265742222222222,2361.7458346666667,14.398472027898631,124,7.400000000000013E-4
7,test_20231101_134856,10863862.png,317432,12857,304575,0.9594968371178709,2,4,66058,1867,64191,0.9717369584304701,23.773376,3240.2564693333334,13.025009744859632,124,7.400000000000013E-4
8,test_20231101_134856,11382381.png,312486,767,311719,0.9975454900379537,1,4,46745,100,46645,0.9978607337683175,21.58402311111111,2479.723024,14.186771864393144,124,7.400000000000013E-4
9,test_20231101_134856,11079715.png,443815,122782,321033,0.7233486925858748,4,4,124136,17120,107016,0.8620867435715667,16.763402666666668,2067.635402666667,14.97606401189655,124,7.400000000000013E-4
10,test_20231101_134856,11551286.png,271883,467,271416,0.9982823493929374,1,4,40092,67,40025,0.998328843659583,17.988837333333333,1870.894224,15.410311266718583,124,7.400000000000013E-4
1,test_20231101_134857,10404007.png,502730,21839,480891,0.9565591868398544,3,4,61265,3149,58116,0.9486003427731984,25.754179555555556,3436.142549333333,12.770091885071036,124,7.500000000000013E-4
2,test_20231101_134857,1254659.png,342646,76204,266442,0.777601372845444,4,4,80080,10632,69448,0.8672327672327672,20.676924444444445,3114.4299733333332,13.197017904793334,124,7.500000000000013E-4
3,test_20231101_134857,10188041.png,221231,10022,211209,0.9546989345977733,3,3,41731,1411,40320,0.9661882054108457,10.857368888888889,1051.873824,17.911167130910616,124,7.500000000000013E-4
4,test_20231101_134857,10287332.png,216980,12687,204293,0.9415291731956862,2,23,22337,1739,20598,0.9221471101759413,9.440839111111112,776.604096,19.22880684076492,124,7.500000000000013E-4
5,test_20231101_134857,11610969.png,368720,26582,342138,0.9279073551746583,2,4,84111,3877,80234,0.9539061478284647,21.465290666666668,2964.25984,13.411640906658562,124,7.500000000000013E-4
6,test_20231101_134857,10350842.png,212614,6264,206350,0.9705381583526955,2,3,42529,917,41612,0.978438242140657,19.265742222222222,2361.7458346666667,14.398472027898631,124,7.500000000000013E-4
7,test_20231101_134857,10863862.png,317432,12857,304575,0.9594968371178709,2,4,66058,1867,64191,0.9717369584304701,23.773376,3240.2564693333334,13.025009744859632,124,7.500000000000013E-4
8,test_20231101_134857,11382381.png,312486,767,311719,0.9975454900379537,2,3,46745,100,46645,0.9978607337683175,21.58402311111111,2479.723024,14.186771864393144,124,7.500000000000013E-4
9,test_20231101_134857,11079715.png,443815,122782,321033,0.7233486925858748,3,4,124136,17120,107016,0.8620867435715667,16.763402666666668,2067.635402666667,14.97606401189655,124,7.500000000000013E-4
10,test_20231101_134857,11551286.png,271883,467,271416,0.9982823493929374,1,4,40092,67,40025,0.998328843659583,17.988837333333333,1870.894224,15.410311266718583,124,7.500000000000013E-4
1,test_20231101_134858,10404007.png,502730,21839,480891,0.9565591868398544,2,4,61265,3149,58116,0.9486003427731984,25.754179555555556,3436.142549333333,12.770091885071036,124,7.600000000000013E-4
2,test_20231101_134858,1254659.png,342646,76204,266442,0.777601372845444,3,4,80080,10632,69448,0.8672327672327672,20.676924444444445,3114.4299733333332,13.197017904793334,124,7.600000000000013E-4
3,test_20231101_134858,10188041.png,221231,9942,211289,0.9550605475724468,2,4,41731,1401,40330,0.9664278354221083,10.984138666666666,1062.7922133333334,17.86631997025374,124,7.600000000000013E-4
4,test_20231101_134858,10287332.png,216980,12687,204293,0.9415291731956862,2,4,22337,1739,20598,0.9221471101759413,9.440839111111112,776.604096,19.22880684076492,124,7.600000000000013E-4
5,test_20231101_134858,11610969.png,368720,26502,342218,0.9281243219787373,3,4,84111,3866,80245,0.9540369273935633,21.558876444444444,2980.7761066666667,13.3875100452361,124,7.600000000000013E-4
6,test_20231101_134858,10350842.png,212614,6264,206350,0.9705381583526955,1,4,42529,917,41612,0.978438242140657,19.265742222222222,2361.7458346666667,14.398472027898631,124,7.600000000000013E-4
7,test_20231101_134858,10863862.png,317432,12857,304575,0.9594968371178709,2,4,66058,1867,64191,0.9717369584304701,23.773376,3240.2564693333334,13.025009744859632,124,7.600000000000013E-4
8,test_20231101_134858,11382381.png,312486,767,311719,0.9975454900379537,1,4,46745,100,46645,0.9978607337683175,21.58402311111111,2479.723024,14.186771864393144,124,7.600000000000013E-4
9,test_20231101_134858,11079715.png,443815,122782,321033,0.7233486925858748,3,5,124136,17120,107016,0.8620867435715667,16.763402666666668,2067.635402666667,14.97606401189655,124,7.600000000000013E-4
10,test_20231101_134858,11551286.png,271883,467,271416,0.9982823493929374,1,4,40092,67,40025,0.998328843659583,17.988837333333333,1870.894224,15.410311266718583,124,7.600000000000013E-4
1,test_20231101_134858,10404007.png,502730,21839,480891,0.9565591868398544,3,4,61265,3149,58116,0.9486003427731984,25.754179555555556,3436.142549333333,12.770091885071036,124,7.700000000000014E-4
2,test_20231101_134858,1254659.png,342646,76204,266442,0.777601372845444,3,4,80080,10632,69448,0.8672327672327672,20.676924444444445,3114.4299733333332,13.197017904793334,124,7.700000000000014E-4
3,test_20231101_134858,10188041.png,221231,9942,211289,0.9550605475724468,2,4,41731,1401,40330,0.9664278354221083,10.984138666666666,1062.7922133333334,17.86631997025374,124,7.700000000000014E-4
4,test_20231101_134858,10287332.png,216980,12687,204293,0.9415291731956862,2,3,22337,1739,20598,0.9221471101759413,9.440839111111112,776.604096,19.22880684076492,124,7.700000000000014E-4
5,test_20231101_134858,11610969.png,368720,26502,342218,0.9281243219787373,2,3,84111,3866,80245,0.9540369273935633,21.558876444444444,2980.7761066666667,13.3875100452361,124,7.700000000000014E-4
6,test_20231101_134858,10350842.png,212614,6264,206350,0.9705381583526955,2,4,42529,917,41612,0.978438242140657,19.265742222222222,2361.7458346666667,14.398472027898631,124,7.700000000000014E-4
7,test_20231101_134858,10863862.png,317432,12857,304575,0.9594968371178709,2,4,66058,1867,64191,0.9717369584304701,23.773376,3240.2564693333334,13.025009744859632,124,7.700000000000014E-4
8,test_20231101_134858,11382381.png,312486,767,311719,0.9975454900379537,1,4,46745,100,46645,0.9978607337683175,21.58402311111111,2479.723024,14.186771864393144,124,7.700000000000014E-4
9,test_20231101_134858,11079715.png,443815,122782,321033,0.7233486925858748,4,4,124136,17120,107016,0.8620867435715667,16.763402666666668,2067.635402666667,14.97606401189655,124,7.700000000000014E-4
10,test_20231101_134858,11551286.png,271883,467,271416,0.9982823493929374,1,4,40092,67,40025,0.998328843659583,17.988837333333333,1870.894224,15.410311266718583,124,7.700000000000014E-4
1,test_20231101_134859,10404007.png,502730,21839,480891,0.9565591868398544,2,4,61265,3149,58116,0.9486003427731984,25.754179555555556,3436.142549333333,12.770091885071036,124,7.800000000000014E-4
2,test_20231101_134859,1254659.png,342646,76204,266442,0.777601372845444,3,4,80080,10632,69448,0.8672327672327672,20.676924444444445,3114.4299733333332,13.197017904793334,124,7.800000000000014E-4
3,test_20231101_134859,10188041.png,221231,9942,211289,0.9550605475724468,2,4,41731,1401,40330,0.9664278354221083,10.984138666666666,1062.7922133333334,17.86631997025374,124,7.800000000000014E-4
4,test_20231101_134859,10287332.png,216980,12687,204293,0.9415291731956862,4,4,22337,1739,20598,0.9221471101759413,9.440839111111112,776.604096,19.22880684076492,124,7.800000000000014E-4
5,test_20231101_134859,11610969.png,368720,26502,342218,0.9281243219787373,3,4,84111,3866,80245,0.9540369273935633,21.558876444444444,2980.7761066666667,13.3875100452361,124,7.800000000000014E-4
6,test_20231101_134859,10350842.png,212614,6264,206350,0.9705381583526955,2,3,42529,917,41612,0.978438242140657,19.265742222222222,2361.7458346666667,14.398472027898631,124,7.800000000000014E-4
7,test_20231101_134859,10863862.png,317432,12857,304575,0.9594968371178709,2,4,66058,1867,64191,0.9717369584304701,23.773376,3240.2564693333334,13.025009744859632,124,7.800000000000014E-4
8,test_20231101_134859,11382381.png,312486,767,311719,0.9975454900379537,2,3,46745,100,46645,0.9978607337683175,21.58402311111111,2479.723024,14.186771864393144,124,7.800000000000014E-4
9,test_20231101_134859,11079715.png,443815,122782,321033,0.7233486925858748,4,4,124136,17120,107016,0.8620867435715667,16.763402666666668,2067.635402666667,14.97606401189655,124,7.800000000000014E-4
10,test_20231101_134859,11551286.png,271883,467,271416,0.9982823493929374,1,3,40092,67,40025,0.998328843659583,17.988837333333333,1870.894224,15.410311266718583,124,7.800000000000014E-4
1,test_20231101_134900,10404007.png,502730,21839,480891,0.9565591868398544,2,4,61265,3149,58116,0.9486003427731984,25.754179555555556,3436.142549333333,12.770091885071036,124,7.900000000000014E-4
2,test_20231101_134900,1254659.png,342646,76204,266442,0.777601372845444,3,4,80080,10632,69448,0.8672327672327672,20.676924444444445,3114.4299733333332,13.197017904793334,124,7.900000000000014E-4
3,test_20231101_134900,10188041.png,221231,9942,211289,0.9550605475724468,2,4,41731,1401,40330,0.9664278354221083,10.984138666666666,1062.7922133333334,17.86631997025374,124,7.900000000000014E-4
4,test_20231101_134900,10287332.png,216980,12687,204293,0.9415291731956862,1,4,22337,1739,20598,0.9221471101759413,9.440839111111112,776.604096,19.22880684076492,124,7.900000000000014E-4
5,test_20231101_134900,11610969.png,368720,26502,342218,0.9281243219787373,2,4,84111,3866,80245,0.9540369273935633,21.558876444444444,2980.7761066666667,13.3875100452361,124,7.900000000000014E-4
6,test_20231101_134900,10350842.png,212614,6264,206350,0.9705381583526955,1,3,42529,917,41612,0.978438242140657,19.265742222222222,2361.7458346666667,14.398472027898631,124,7.900000000000014E-4
7,test_20231101_134900,10863862.png,317432,12857,304575,0.9594968371178709,2,4,66058,1867,64191,0.9717369584304701,23.773376,3240.2564693333334,13.025009744859632,124,7.900000000000014E-4
8,test_20231101_134900,11382381.png,312486,767,311719,0.9975454900379537,2,4,46745,100,46645,0.9978607337683175,21.58402311111111,2479.723024,14.186771864393144,124,7.900000000000014E-4
9,test_20231101_134900,11079715.png,443815,122782,321033,0.7233486925858748,4,10,124136,17120,107016,0.8620867435715667,16.763402666666668,2067.635402666667,14.97606401189655,124,7.900000000000014E-4
10,test_20231101_134900,11551286.png,271883,467,271416,0.9982823493929374,1,3,40092,67,40025,0.998328843659583,17.988837333333333,1870.894224,15.410311266718583,124,7.900000000000014E-4
1,test_20231101_134900,10404007.png,502730,21839,480891,0.9565591868398544,3,3,61265,3149,58116,0.9486003427731984,25.754179555555556,3436.142549333333,12.770091885071036,124,8.000000000000014E-4
2,test_20231101_134900,1254659.png,342646,76204,266442,0.777601372845444,3,4,80080,10632,69448,0.8672327672327672,20.676924444444445,3114.4299733333332,13.197017904793334,124,8.000000000000014E-4
3,test_20231101_134900,10188041.png,221231,9942,211289,0.9550605475724468,2,4,41731,1401,40330,0.9664278354221083,10.984138666666666,1062.7922133333334,17.86631997025374,124,8.000000000000014E-4
4,test_20231101_134900,10287332.png,216980,12687,204293,0.9415291731956862,3,4,22337,1739,20598,0.9221471101759413,9.440839111111112,776.604096,19.22880684076492,124,8.000000000000014E-4
5,test_20231101_134900,11610969.png,368720,26502,342218,0.9281243219787373,2,4,84111,3866,80245,0.9540369273935633,21.558876444444444,2980.7761066666667,13.3875100452361,124,8.000000000000014E-4
6,test_20231101_134900,10350842.png,212614,6264,206350,0.9705381583526955,2,3,42529,917,41612,0.978438242140657,19.265742222222222,2361.7458346666667,14.398472027898631,124,8.000000000000014E-4
7,test_20231101_134900,10863862.png,317432,12857,304575,0.9594968371178709,2,4,66058,1867,64191,0.9717369584304701,23.773376,3240.2564693333334,13.025009744859632,124,8.000000000000014E-4
8,test_20231101_134900,11382381.png,312486,767,311719,0.9975454900379537,2,3,46745,100,46645,0.9978607337683175,21.58402311111111,2479.723024,14.186771864393144,124,8.000000000000014E-4
9,test_20231101_134900,11079715.png,443815,122782,321033,0.7233486925858748,3,5,124136,17120,107016,0.8620867435715667,16.763402666666668,2067.635402666667,14.97606401189655,124,8.000000000000014E-4
10,test_20231101_134900,11551286.png,271883,467,271416,0.9982823493929374,1,4,40092,67,40025,0.998328843659583,17.988837333333333,1870.894224,15.410311266718583,124,8.000000000000014E-4
1,test_20231101_134901,10404007.png,502730,21839,480891,0.9565591868398544,3,4,61265,3149,58116,0.9486003427731984,25.754179555555556,3436.142549333333,12.770091885071036,124,8.100000000000015E-4
2,test_20231101_134901,1254659.png,342646,76204,266442,0.777601372845444,3,4,80080,10632,69448,0.8672327672327672,20.676924444444445,3114.4299733333332,13.197017904793334,124,8.100000000000015E-4
3,test_20231101_134901,10188041.png,221231,9942,211289,0.9550605475724468,2,4,41731,1401,40330,0.9664278354221083,10.984138666666666,1062.7922133333334,17.86631997025374,124,8.100000000000015E-4
4,test_20231101_134901,10287332.png,216980,12687,204293,0.9415291731956862,1,3,22337,1739,20598,0.9221471101759413,9.440839111111112,776.604096,19.22880684076492,124,8.100000000000015E-4
5,test_20231101_134901,11610969.png,368720,26502,342218,0.9281243219787373,2,3,84111,3866,80245,0.9540369273935633,21.558876444444444,2980.7761066666667,13.3875100452361,124,8.100000000000015E-4
6,test_20231101_134901,10350842.png,212614,6264,206350,0.9705381583526955,2,3,42529,917,41612,0.978438242140657,19.265742222222222,2361.7458346666667,14.398472027898631,124,8.100000000000015E-4
7,test_20231101_134901,10863862.png,317432,12857,304575,0.9594968371178709,2,4,66058,1867,64191,0.9717369584304701,23.773376,3240.2564693333334,13.025009744859632,124,8.100000000000015E-4
8,test_20231101_134901,11382381.png,312486,767,311719,0.9975454900379537,2,3,46745,100,46645,0.9978607337683175,21.58402311111111,2479.723024,14.186771864393144,124,8.100000000000015E-4
9,test_20231101_134901,11079715.png,443815,122782,321033,0.7233486925858748,3,4,124136,17120,107016,0.8620867435715667,16.763402666666668,2067.635402666667,14.97606401189655,124,8.100000000000015E-4
10,test_20231101_134901,11551286.png,271883,467,271416,0.9982823493929374,1,3,40092,67,40025,0.998328843659583,17.988837333333333,1870.894224,15.410311266718583,124,8.100000000000015E-4
1,test_20231101_134902,10404007.png,502730,21839,480891,0.9565591868398544,2,4,61265,3149,58116,0.9486003427731984,25.754179555555556,3436.142549333333,12.770091885071036,124,8.200000000000015E-4
2,test_20231101_134902,1254659.png,342646,76204,266442,0.777601372845444,3,4,80080,10632,69448,0.8672327672327672,20.676924444444445,3114.4299733333332,13.197017904793334,124,8.200000000000015E-4
3,test_20231101_134902,10188041.png,221231,9942,211289,0.9550605475724468,2,4,41731,1401,40330,0.9664278354221083,10.984138666666666,1062.7922133333334,17.86631997025374,124,8.200000000000015E-4
4,test_20231101_134902,10287332.png,216980,12687,204293,0.9415291731956862,2,3,22337,1739,20598,0.9221471101759413,9.440839111111112,776.604096,19.22880684076492,124,8.200000000000015E-4
5,test_20231101_134902,11610969.png,368720,26502,342218,0.9281243219787373,3,4,84111,3866,80245,0.9540369273935633,21.558876444444444,2980.7761066666667,13.3875100452361,124,8.200000000000015E-4
6,test_20231101_134902,10350842.png,212614,6264,206350,0.9705381583526955,2,4,42529,917,41612,0.978438242140657,19.265742222222222,2361.7458346666667,14.398472027898631,124,8.200000000000015E-4
7,test_20231101_134902,10863862.png,317432,12857,304575,0.9594968371178709,2,3,66058,1867,64191,0.9717369584304701,23.773376,3240.2564693333334,13.025009744859632,124,8.200000000000015E-4
8,test_20231101_134902,11382381.png,312486,767,311719,0.9975454900379537,1,3,46745,100,46645,0.9978607337683175,21.58402311111111,2479.723024,14.186771864393144,124,8.200000000000015E-4
9,test_20231101_134902,11079715.png,443815,122782,321033,0.7233486925858748,3,4,124136,17120,107016,0.8620867435715667,16.763402666666668,2067.635402666667,14.97606401189655,124,8.200000000000015E-4
10,test_20231101_134902,11551286.png,271883,467,271416,0.9982823493929374,2,4,40092,67,40025,0.998328843659583,17.988837333333333,1870.894224,15.410311266718583,124,8.200000000000015E-4
1,test_20231101_134902,10404007.png,502730,21839,480891,0.9565591868398544,2,4,61265,3149,58116,0.9486003427731984,25.754179555555556,3436.142549333333,12.770091885071036,124,8.300000000000015E-4
2,test_20231101_134902,1254659.png,342646,76204,266442,0.777601372845444,3,4,80080,10632,69448,0.8672327672327672,20.676924444444445,3114.4299733333332,13.197017904793334,124,8.300000000000015E-4
3,test_20231101_134902,10188041.png,221231,9942,211289,0.9550605475724468,2,4,41731,1401,40330,0.9664278354221083,10.984138666666666,1062.7922133333334,17.86631997025374,124,8.300000000000015E-4
4,test_20231101_134902,10287332.png,216980,12687,204293,0.9415291731956862,2,4,22337,1739,20598,0.9221471101759413,9.440839111111112,776.604096,19.22880684076492,124,8.300000000000015E-4
5,test_20231101_134902,11610969.png,368720,26502,342218,0.9281243219787373,3,3,84111,3866,80245,0.9540369273935633,21.558876444444444,2980.7761066666667,13.3875100452361,124,8.300000000000015E-4
6,test_20231101_134902,10350842.png,212614,6264,206350,0.9705381583526955,1,4,42529,917,41612,0.978438242140657,19.265742222222222,2361.7458346666667,14.398472027898631,124,8.300000000000015E-4
7,test_20231101_134902,10863862.png,317432,12857,304575,0.9594968371178709,2,4,66058,1867,64191,0.9717369584304701,23.773376,3240.2564693333334,13.025009744859632,124,8.300000000000015E-4
8,test_20231101_134902,11382381.png,312486,767,311719,0.9975454900379537,1,4,46745,100,46645,0.9978607337683175,21.58402311111111,2479.723024,14.186771864393144,124,8.300000000000015E-4
9,test_20231101_134902,11079715.png,443815,122782,321033,0.7233486925858748,3,5,124136,17120,107016,0.8620867435715667,16.763402666666668,2067.635402666667,14.97606401189655,124,8.300000000000015E-4
10,test_20231101_134902,11551286.png,271883,467,271416,0.9982823493929374,1,3,40092,67,40025,0.998328843659583,17.988837333333333,1870.894224,15.410311266718583,124,8.300000000000015E-4
1,test_20231101_134903,10404007.png,502730,21839,480891,0.9565591868398544,2,4,61265,3149,58116,0.9486003427731984,25.754179555555556,3436.142549333333,12.770091885071036,124,8.400000000000016E-4
2,test_20231101_134903,1254659.png,342646,76204,266442,0.777601372845444,3,4,80080,10632,69448,0.8672327672327672,20.676924444444445,3114.4299733333332,13.197017904793334,124,8.400000000000016E-4
3,test_20231101_134903,10188041.png,221231,9942,211289,0.9550605475724468,2,4,41731,1401,40330,0.9664278354221083,10.984138666666666,1062.7922133333334,17.86631997025374,124,8.400000000000016E-4
4,test_20231101_134903,10287332.png,216980,12687,204293,0.9415291731956862,2,4,22337,1739,20598,0.9221471101759413,9.440839111111112,776.604096,19.22880684076492,124,8.400000000000016E-4
5,test_20231101_134903,11610969.png,368720,26502,342218,0.9281243219787373,2,3,84111,3866,80245,0.9540369273935633,21.558876444444444,2980.7761066666667,13.3875100452361,124,8.400000000000016E-4
6,test_20231101_134903,10350842.png,212614,6264,206350,0.9705381583526955,2,4,42529,917,41612,0.978438242140657,19.265742222222222,2361.7458346666667,14.398472027898631,124,8.400000000000016E-4
7,test_20231101_134903,10863862.png,317432,12857,304575,0.9594968371178709,2,3,66058,1867,64191,0.9717369584304701,23.773376,3240.2564693333334,13.025009744859632,124,8.400000000000016E-4
8,test_20231101_134903,11382381.png,312486,767,311719,0.9975454900379537,1,3,46745,100,46645,0.9978607337683175,21.58402311111111,2479.723024,14.186771864393144,124,8.400000000000016E-4
9,test_20231101_134903,11079715.png,443815,122782,321033,0.7233486925858748,3,4,124136,17120,107016,0.8620867435715667,16.763402666666668,2067.635402666667,14.97606401189655,124,8.400000000000016E-4
10,test_20231101_134903,11551286.png,271883,467,271416,0.9982823493929374,2,3,40092,67,40025,0.998328843659583,17.988837333333333,1870.894224,15.410311266718583,124,8.400000000000016E-4
1,test_20231101_134904,10404007.png,502730,21839,480891,0.9565591868398544,3,3,61265,3149,58116,0.9486003427731984,25.754179555555556,3436.142549333333,12.770091885071036,124,8.500000000000016E-4
2,test_20231101_134904,1254659.png,342646,76204,266442,0.777601372845444,3,4,80080,10632,69448,0.8672327672327672,20.676924444444445,3114.4299733333332,13.197017904793334,124,8.500000000000016E-4
3,test_20231101_134904,10188041.png,221231,9942,211289,0.9550605475724468,1,3,41731,1401,40330,0.9664278354221083,10.984138666666666,1062.7922133333334,17.86631997025374,124,8.500000000000016E-4
4,test_20231101_134904,10287332.png,216980,12687,204293,0.9415291731956862,2,3,22337,1739,20598,0.9221471101759413,9.440839111111112,776.604096,19.22880684076492,124,8.500000000000016E-4
5,test_20231101_134904,11610969.png,368720,26502,342218,0.9281243219787373,3,4,84111,3866,80245,0.9540369273935633,21.558876444444444,2980.7761066666667,13.3875100452361,124,8.500000000000016E-4
6,test_20231101_134904,10350842.png,212614,6264,206350,0.9705381583526955,2,4,42529,917,41612,0.978438242140657,19.265742222222222,2361.7458346666667,14.398472027898631,124,8.500000000000016E-4
7,test_20231101_134904,10863862.png,317432,12857,304575,0.9594968371178709,2,4,66058,1867,64191,0.9717369584304701,23.773376,3240.2564693333334,13.025009744859632,124,8.500000000000016E-4
8,test_20231101_134904,11382381.png,312486,767,311719,0.9975454900379537,1,3,46745,100,46645,0.9978607337683175,21.58402311111111,2479.723024,14.186771864393144,124,8.500000000000016E-4
9,test_20231101_134904,11079715.png,443815,122782,321033,0.7233486925858748,3,5,124136,17120,107016,0.8620867435715667,16.763402666666668,2067.635402666667,14.97606401189655,124,8.500000000000016E-4
10,test_20231101_134904,11551286.png,271883,467,271416,0.9982823493929374,1,3,40092,67,40025,0.998328843659583,17.988837333333333,1870.894224,15.410311266718583,124,8.500000000000016E-4
1,test_20231101_134904,10404007.png,502730,21839,480891,0.9565591868398544,2,3,61265,3149,58116,0.9486003427731984,25.754179555555556,3436.142549333333,12.770091885071036,124,8.600000000000016E-4
2,test_20231101_134904,1254659.png,342646,76204,266442,0.777601372845444,3,4,80080,10632,69448,0.8672327672327672,20.676924444444445,3114.4299733333332,13.197017904793334,124,8.600000000000016E-4
3,test_20231101_134904,10188041.png,221231,9942,211289,0.9550605475724468,2,4,41731,1401,40330,0.9664278354221083,10.984138666666666,1062.7922133333334,17.86631997025374,124,8.600000000000016E-4
4,test_20231101_134904,10287332.png,216980,12687,204293,0.9415291731956862,2,3,22337,1739,20598,0.9221471101759413,9.440839111111112,776.604096,19.22880684076492,124,8.600000000000016E-4
5,test_20231101_134904,11610969.png,368720,26502,342218,0.9281243219787373,2,4,84111,3866,80245,0.9540369273935633,21.558876444444444,2980.7761066666667,13.3875100452361,124,8.600000000000016E-4
6,test_20231101_134904,10350842.png,212614,6264,206350,0.9705381583526955,1,4,42529,917,41612,0.978438242140657,19.265742222222222,2361.7458346666667,14.398472027898631,124,8.600000000000016E-4
7,test_20231101_134904,10863862.png,317432,12857,304575,0.9594968371178709,3,3,66058,1867,64191,0.9717369584304701,23.773376,3240.2564693333334,13.025009744859632,124,8.600000000000016E-4
8,test_20231101_134904,11382381.png,312486,767,311719,0.9975454900379537,1,13,46745,100,46645,0.9978607337683175,21.58402311111111,2479.723024,14.186771864393144,124,8.600000000000016E-4
9,test_20231101_134904,11079715.png,443815,122782,321033,0.7233486925858748,4,4,124136,17120,107016,0.8620867435715667,16.763402666666668,2067.635402666667,14.97606401189655,124,8.600000000000016E-4
10,test_20231101_134904,11551286.png,271883,467,271416,0.9982823493929374,1,3,40092,67,40025,0.998328843659583,17.988837333333333,1870.894224,15.410311266718583,124,8.600000000000016E-4
1,test_20231101_134905,10404007.png,502730,21839,480891,0.9565591868398544,2,3,61265,3149,58116,0.9486003427731984,25.754179555555556,3436.142549333333,12.770091885071036,124,8.700000000000016E-4
2,test_20231101_134905,1254659.png,342646,76204,266442,0.777601372845444,3,4,80080,10632,69448,0.8672327672327672,20.676924444444445,3114.4299733333332,13.197017904793334,124,8.700000000000016E-4
3,test_20231101_134905,10188041.png,221231,9942,211289,0.9550605475724468,2,3,41731,1401,40330,0.9664278354221083,10.984138666666666,1062.7922133333334,17.86631997025374,124,8.700000000000016E-4
4,test_20231101_134905,10287332.png,216980,12687,204293,0.9415291731956862,1,3,22337,1739,20598,0.9221471101759413,9.440839111111112,776.604096,19.22880684076492,124,8.700000000000016E-4
5,test_20231101_134905,11610969.png,368720,26502,342218,0.9281243219787373,3,4,84111,3866,80245,0.9540369273935633,21.558876444444444,2980.7761066666667,13.3875100452361,124,8.700000000000016E-4
6,test_20231101_134905,10350842.png,212614,6264,206350,0.9705381583526955,1,3,42529,917,41612,0.978438242140657,19.265742222222222,2361.7458346666667,14.398472027898631,124,8.700000000000016E-4
7,test_20231101_134905,10863862.png,317432,12857,304575,0.9594968371178709,2,3,66058,1867,64191,0.9717369584304701,23.773376,3240.2564693333334,13.025009744859632,124,8.700000000000016E-4
8,test_20231101_134905,11382381.png,312486,767,311719,0.9975454900379537,2,3,46745,100,46645,0.9978607337683175,21.58402311111111,2479.723024,14.186771864393144,124,8.700000000000016E-4
9,test_20231101_134905,11079715.png,443815,122782,321033,0.7233486925858748,4,4,124136,17120,107016,0.8620867435715667,16.763402666666668,2067.635402666667,14.97606401189655,124,8.700000000000016E-4
10,test_20231101_134905,11551286.png,271883,467,271416,0.9982823493929374,1,3,40092,67,40025,0.998328843659583,17.988837333333333,1870.894224,15.410311266718583,124,8.700000000000016E-4
1,test_20231101_134906,10404007.png,502730,21839,480891,0.9565591868398544,2,4,61265,3149,58116,0.9486003427731984,25.754179555555556,3436.142549333333,12.770091885071036,124,8.800000000000017E-4
2,test_20231101_134906,1254659.png,342646,76204,266442,0.777601372845444,3,4,80080,10632,69448,0.8672327672327672,20.676924444444445,3114.4299733333332,13.197017904793334,124,8.800000000000017E-4
3,test_20231101_134906,10188041.png,221231,9942,211289,0.9550605475724468,2,4,41731,1401,40330,0.9664278354221083,10.984138666666666,1062.7922133333334,17.86631997025374,124,8.800000000000017E-4
4,test_20231101_134906,10287332.png,216980,12687,204293,0.9415291731956862,2,4,22337,1739,20598,0.9221471101759413,9.440839111111112,776.604096,19.22880684076492,124,8.800000000000017E-4
5,test_20231101_134906,11610969.png,368720,26502,342218,0.9281243219787373,3,3,84111,3866,80245,0.9540369273935633,21.558876444444444,2980.7761066666667,13.3875100452361,124,8.800000000000017E-4
6,test_20231101_134906,10350842.png,212614,6264,206350,0.9705381583526955,2,4,42529,917,41612,0.978438242140657,19.265742222222222,2361.7458346666667,14.398472027898631,124,8.800000000000017E-4
7,test_20231101_134906,10863862.png,317432,12857,304575,0.9594968371178709,2,4,66058,1867,64191,0.9717369584304701,23.773376,3240.2564693333334,13.025009744859632,124,8.800000000000017E-4
8,test_20231101_134906,11382381.png,312486,767,311719,0.9975454900379537,2,24,46745,100,46645,0.9978607337683175,21.58402311111111,2479.723024,14.186771864393144,124,8.800000000000017E-4
9,test_20231101_134906,11079715.png,443815,122782,321033,0.7233486925858748,4,5,124136,17120,107016,0.8620867435715667,16.763402666666668,2067.635402666667,14.97606401189655,124,8.800000000000017E-4
10,test_20231101_134906,11551286.png,271883,467,271416,0.9982823493929374,1,4,40092,67,40025,0.998328843659583,17.988837333333333,1870.894224,15.410311266718583,124,8.800000000000017E-4
1,test_20231101_134906,10404007.png,502730,21839,480891,0.9565591868398544,2,3,61265,3149,58116,0.9486003427731984,25.754179555555556,3436.142549333333,12.770091885071036,124,8.900000000000017E-4
2,test_20231101_134906,1254659.png,342646,76204,266442,0.777601372845444,2,4,80080,10632,69448,0.8672327672327672,20.676924444444445,3114.4299733333332,13.197017904793334,124,8.900000000000017E-4
3,test_20231101_134906,10188041.png,221231,9942,211289,0.9550605475724468,2,4,41731,1401,40330,0.9664278354221083,10.984138666666666,1062.7922133333334,17.86631997025374,124,8.900000000000017E-4
4,test_20231101_134906,10287332.png,216980,12687,204293,0.9415291731956862,2,4,22337,1739,20598,0.9221471101759413,9.440839111111112,776.604096,19.22880684076492,124,8.900000000000017E-4
5,test_20231101_134906,11610969.png,368720,26502,342218,0.9281243219787373,2,4,84111,3866,80245,0.9540369273935633,21.558876444444444,2980.7761066666667,13.3875100452361,124,8.900000000000017E-4
6,test_20231101_134906,10350842.png,212614,6264,206350,0.9705381583526955,2,3,42529,917,41612,0.978438242140657,19.265742222222222,2361.7458346666667,14.398472027898631,124,8.900000000000017E-4
7,test_20231101_134906,10863862.png,317432,12857,304575,0.9594968371178709,2,4,66058,1867,64191,0.9717369584304701,23.773376,3240.2564693333334,13.025009744859632,124,8.900000000000017E-4
8,test_20231101_134906,11382381.png,312486,767,311719,0.9975454900379537,1,4,46745,100,46645,0.9978607337683175,21.58402311111111,2479.723024,14.186771864393144,124,8.900000000000017E-4
9,test_20231101_134906,11079715.png,443815,122782,321033,0.7233486925858748,3,4,124136,17120,107016,0.8620867435715667,16.763402666666668,2067.635402666667,14.97606401189655,124,8.900000000000017E-4
10,test_20231101_134906,11551286.png,271883,467,271416,0.9982823493929374,2,3,40092,67,40025,0.998328843659583,17.988837333333333,1870.894224,15.410311266718583,124,8.900000000000017E-4
1,test_20231101_134907,10404007.png,502730,21839,480891,0.9565591868398544,2,3,61265,3149,58116,0.9486003427731984,25.754179555555556,3436.142549333333,12.770091885071036,124,9.000000000000017E-4
2,test_20231101_134907,1254659.png,342646,76204,266442,0.777601372845444,3,4,80080,10632,69448,0.8672327672327672,20.676924444444445,3114.4299733333332,13.197017904793334,124,9.000000000000017E-4
3,test_20231101_134907,10188041.png,221231,9842,211389,0.9555125637907889,2,4,41731,1390,40341,0.9666914284344972,11.031626666666666,1067.9992426666668,17.84509416139609,124,9.000000000000017E-4
4,test_20231101_134907,10287332.png,216980,12687,204293,0.9415291731956862,2,4,22337,1739,20598,0.9221471101759413,9.440839111111112,776.604096,19.22880684076492,124,9.000000000000017E-4
5,test_20231101_134907,11610969.png,368720,26502,342218,0.9281243219787373,2,4,84111,3866,80245,0.9540369273935633,21.558876444444444,2980.7761066666667,13.3875100452361,124,9.000000000000017E-4
6,test_20231101_134907,10350842.png,212614,6264,206350,0.9705381583526955,2,4,42529,917,41612,0.978438242140657,19.265742222222222,2361.7458346666667,14.398472027898631,124,9.000000000000017E-4
7,test_20231101_134907,10863862.png,317432,12857,304575,0.9594968371178709,2,4,66058,1867,64191,0.9717369584304701,23.773376,3240.2564693333334,13.025009744859632,124,9.000000000000017E-4
8,test_20231101_134907,11382381.png,312486,767,311719,0.9975454900379537,1,3,46745,100,46645,0.9978607337683175,21.58402311111111,2479.723024,14.186771864393144,124,9.000000000000017E-4
9,test_20231101_134907,11079715.png,443815,122782,321033,0.7233486925858748,3,4,124136,17120,107016,0.8620867435715667,16.763402666666668,2067.635402666667,14.97606401189655,124,9.000000000000017E-4
10,test_20231101_134907,11551286.png,271883,467,271416,0.9982823493929374,1,3,40092,67,40025,0.998328843659583,17.988837333333333,1870.894224,15.410311266718583,124,9.000000000000017E-4
1,test_20231101_134908,10404007.png,502730,21839,480891,0.9565591868398544,3,4,61265,3149,58116,0.9486003427731984,25.754179555555556,3436.142549333333,12.770091885071036,124,9.100000000000017E-4
2,test_20231101_134908,1254659.png,342646,76204,266442,0.777601372845444,3,4,80080,10632,69448,0.8672327672327672,20.676924444444445,3114.4299733333332,13.197017904793334,124,9.100000000000017E-4
3,test_20231101_134908,10188041.png,221231,9842,211389,0.9555125637907889,2,3,41731,1390,40341,0.9666914284344972,11.031626666666666,1067.9992426666668,17.84509416139609,124,9.100000000000017E-4
4,test_20231101_134908,10287332.png,216980,12687,204293,0.9415291731956862,1,4,22337,1739,20598,0.9221471101759413,9.440839111111112,776.604096,19.22880684076492,124,9.100000000000017E-4
5,test_20231101_134908,11610969.png,368720,26502,342218,0.9281243219787373,2,3,84111,3866,80245,0.9540369273935633,21.558876444444444,2980.7761066666667,13.3875100452361,124,9.100000000000017E-4
6,test_20231101_134908,10350842.png,212614,6264,206350,0.9705381583526955,2,4,42529,917,41612,0.978438242140657,19.265742222222222,2361.7458346666667,14.398472027898631,124,9.100000000000017E-4
7,test_20231101_134908,10863862.png,317432,12857,304575,0.9594968371178709,2,3,66058,1867,64191,0.9717369584304701,23.773376,3240.2564693333334,13.025009744859632,124,9.100000000000017E-4
8,test_20231101_134908,11382381.png,312486,767,311719,0.9975454900379537,2,3,46745,100,46645,0.9978607337683175,21.58402311111111,2479.723024,14.186771864393144,124,9.100000000000017E-4
9,test_20231101_134908,11079715.png,443815,122782,321033,0.7233486925858748,3,4,124136,17120,107016,0.8620867435715667,16.763402666666668,2067.635402666667,14.97606401189655,124,9.100000000000017E-4
10,test_20231101_134908,11551286.png,271883,467,271416,0.9982823493929374,2,4,40092,67,40025,0.998328843659583,17.988837333333333,1870.894224,15.410311266718583,124,9.100000000000017E-4
1,test_20231101_134909,10404007.png,502730,21839,480891,0.9565591868398544,2,3,61265,3149,58116,0.9486003427731984,25.754179555555556,3436.142549333333,12.770091885071036,124,9.200000000000018E-4
2,test_20231101_134909,1254659.png,342646,76204,266442,0.777601372845444,3,4,80080,10632,69448,0.8672327672327672,20.676924444444445,3114.4299733333332,13.197017904793334,124,9.200000000000018E-4
3,test_20231101_134909,10188041.png,221231,9842,211389,0.9555125637907889,2,3,41731,1390,40341,0.9666914284344972,11.031626666666666,1067.9992426666668,17.84509416139609,124,9.200000000000018E-4
4,test_20231101_134909,10287332.png,216980,12687,204293,0.9415291731956862,2,6,22337,1739,20598,0.9221471101759413,9.440839111111112,776.604096,19.22880684076492,124,9.200000000000018E-4
5,test_20231101_134909,11610969.png,368720,26502,342218,0.9281243219787373,3,5,84111,3866,80245,0.9540369273935633,21.558876444444444,2980.7761066666667,13.3875100452361,124,9.200000000000018E-4
6,test_20231101_134909,10350842.png,212614,6264,206350,0.9705381583526955,1,3,42529,917,41612,0.978438242140657,19.265742222222222,2361.7458346666667,14.398472027898631,124,9.200000000000018E-4
7,test_20231101_134909,10863862.png,317432,12857,304575,0.9594968371178709,2,4,66058,1867,64191,0.9717369584304701,23.773376,3240.2564693333334,13.025009744859632,124,9.200000000000018E-4
8,test_20231101_134909,11382381.png,312486,767,311719,0.9975454900379537,2,4,46745,100,46645,0.9978607337683175,21.58402311111111,2479.723024,14.186771864393144,124,9.200000000000018E-4
9,test_20231101_134909,11079715.png,443815,122782,321033,0.7233486925858748,3,5,124136,17120,107016,0.8620867435715667,16.763402666666668,2067.635402666667,14.97606401189655,124,9.200000000000018E-4
10,test_20231101_134909,11551286.png,271883,467,271416,0.9982823493929374,1,3,40092,67,40025,0.998328843659583,17.988837333333333,1870.894224,15.410311266718583,124,9.200000000000018E-4
1,test_20231101_134909,10404007.png,502730,21839,480891,0.9565591868398544,2,4,61265,3149,58116,0.9486003427731984,25.754179555555556,3436.142549333333,12.770091885071036,124,9.300000000000018E-4
2,test_20231101_134909,1254659.png,342646,76204,266442,0.777601372845444,3,4,80080,10632,69448,0.8672327672327672,20.676924444444445,3114.4299733333332,13.197017904793334,124,9.300000000000018E-4
3,test_20231101_134909,10188041.png,221231,9842,211389,0.9555125637907889,2,3,41731,1390,40341,0.9666914284344972,11.031626666666666,1067.9992426666668,17.84509416139609,124,9.300000000000018E-4
4,test_20231101_134909,10287332.png,216980,12687,204293,0.9415291731956862,2,3,22337,1739,20598,0.9221471101759413,9.440839111111112,776.604096,19.22880684076492,124,9.300000000000018E-4
5,test_20231101_134909,11610969.png,368720,26502,342218,0.9281243219787373,2,3,84111,3866,80245,0.9540369273935633,21.558876444444444,2980.7761066666667,13.3875100452361,124,9.300000000000018E-4
6,test_20231101_134909,10350842.png,212614,6264,206350,0.9705381583526955,2,3,42529,917,41612,0.978438242140657,19.265742222222222,2361.7458346666667,14.398472027898631,124,9.300000000000018E-4
7,test_20231101_134909,10863862.png,317432,12857,304575,0.9594968371178709,2,4,66058,1867,64191,0.9717369584304701,23.773376,3240.2564693333334,13.025009744859632,124,9.300000000000018E-4
8,test_20231101_134909,11382381.png,312486,767,311719,0.9975454900379537,2,3,46745,100,46645,0.9978607337683175,21.58402311111111,2479.723024,14.186771864393144,124,9.300000000000018E-4
9,test_20231101_134909,11079715.png,443815,122782,321033,0.7233486925858748,3,4,124136,17120,107016,0.8620867435715667,16.763402666666668,2067.635402666667,14.97606401189655,124,9.300000000000018E-4
10,test_20231101_134909,11551286.png,271883,467,271416,0.9982823493929374,2,3,40092,67,40025,0.998328843659583,17.988837333333333,1870.894224,15.410311266718583,124,9.300000000000018E-4
1,test_20231101_134910,10404007.png,502730,21839,480891,0.9565591868398544,3,4,61265,3149,58116,0.9486003427731984,25.754179555555556,3436.142549333333,12.770091885071036,124,9.400000000000018E-4
2,test_20231101_134910,1254659.png,342646,76204,266442,0.777601372845444,3,4,80080,10632,69448,0.8672327672327672,20.676924444444445,3114.4299733333332,13.197017904793334,124,9.400000000000018E-4
3,test_20231101_134910,10188041.png,221231,9842,211389,0.9555125637907889,2,5,41731,1390,40341,0.9666914284344972,11.031626666666666,1067.9992426666668,17.84509416139609,124,9.400000000000018E-4
4,test_20231101_134910,10287332.png,216980,12687,204293,0.9415291731956862,2,3,22337,1739,20598,0.9221471101759413,9.440839111111112,776.604096,19.22880684076492,124,9.400000000000018E-4
5,test_20231101_134910,11610969.png,368720,26502,342218,0.9281243219787373,3,3,84111,3866,80245,0.9540369273935633,21.558876444444444,2980.7761066666667,13.3875100452361,124,9.400000000000018E-4
6,test_20231101_134910,10350842.png,212614,6264,206350,0.9705381583526955,1,4,42529,917,41612,0.978438242140657,19.265742222222222,2361.7458346666667,14.398472027898631,124,9.400000000000018E-4
7,test_20231101_134910,10863862.png,317432,12857,304575,0.9594968371178709,3,4,66058,1867,64191,0.9717369584304701,23.773376,3240.2564693333334,13.025009744859632,124,9.400000000000018E-4
8,test_20231101_134910,11382381.png,312486,767,311719,0.9975454900379537,1,6,46745,100,46645,0.9978607337683175,21.58402311111111,2479.723024,14.186771864393144,124,9.400000000000018E-4
9,test_20231101_134910,11079715.png,443815,122782,321033,0.7233486925858748,4,4,124136,17120,107016,0.8620867435715667,16.763402666666668,2067.635402666667,14.97606401189655,124,9.400000000000018E-4
10,test_20231101_134910,11551286.png,271883,467,271416,0.9982823493929374,1,4,40092,67,40025,0.998328843659583,17.988837333333333,1870.894224,15.410311266718583,124,9.400000000000018E-4
1,test_20231101_134911,10404007.png,502730,21839,480891,0.9565591868398544,2,10,61265,3149,58116,0.9486003427731984,25.754179555555556,3436.142549333333,12.770091885071036,124,9.500000000000018E-4
2,test_20231101_134911,1254659.png,342646,76204,266442,0.777601372845444,3,4,80080,10632,69448,0.8672327672327672,20.676924444444445,3114.4299733333332,13.197017904793334,124,9.500000000000018E-4
3,test_20231101_134911,10188041.png,221231,9842,211389,0.9555125637907889,2,4,41731,1390,40341,0.9666914284344972,11.031626666666666,1067.9992426666668,17.84509416139609,124,9.500000000000018E-4
4,test_20231101_134911,10287332.png,216980,12687,204293,0.9415291731956862,2,4,22337,1739,20598,0.9221471101759413,9.440839111111112,776.604096,19.22880684076492,124,9.500000000000018E-4
5,test_20231101_134911,11610969.png,368720,26502,342218,0.9281243219787373,3,4,84111,3866,80245,0.9540369273935633,21.558876444444444,2980.7761066666667,13.3875100452361,124,9.500000000000018E-4
6,test_20231101_134911,10350842.png,212614,6264,206350,0.9705381583526955,1,4,42529,917,41612,0.978438242140657,19.265742222222222,2361.7458346666667,14.398472027898631,124,9.500000000000018E-4
7,test_20231101_134911,10863862.png,317432,12857,304575,0.9594968371178709,2,7,66058,1867,64191,0.9717369584304701,23.773376,3240.2564693333334,13.025009744859632,124,9.500000000000018E-4
8,test_20231101_134911,11382381.png,312486,767,311719,0.9975454900379537,2,4,46745,100,46645,0.9978607337683175,21.58402311111111,2479.723024,14.186771864393144,124,9.500000000000018E-4
9,test_20231101_134911,11079715.png,443815,122782,321033,0.7233486925858748,3,4,124136,17120,107016,0.8620867435715667,16.763402666666668,2067.635402666667,14.97606401189655,124,9.500000000000018E-4
10,test_20231101_134911,11551286.png,271883,467,271416,0.9982823493929374,2,3,40092,67,40025,0.998328843659583,17.988837333333333,1870.894224,15.410311266718583,124,9.500000000000018E-4
1,test_20231101_134911,10404007.png,502730,21839,480891,0.9565591868398544,3,4,61265,3149,58116,0.9486003427731984,25.754179555555556,3436.142549333333,12.770091885071036,124,9.600000000000019E-4
2,test_20231101_134911,1254659.png,342646,76204,266442,0.777601372845444,3,4,80080,10632,69448,0.8672327672327672,20.676924444444445,3114.4299733333332,13.197017904793334,124,9.600000000000019E-4
3,test_20231101_134911,10188041.png,221231,9842,211389,0.9555125637907889,2,4,41731,1390,40341,0.9666914284344972,11.031626666666666,1067.9992426666668,17.84509416139609,124,9.600000000000019E-4
4,test_20231101_134911,10287332.png,216980,12687,204293,0.9415291731956862,2,3,22337,1739,20598,0.9221471101759413,9.440839111111112,776.604096,19.22880684076492,124,9.600000000000019E-4
5,test_20231101_134911,11610969.png,368720,26502,342218,0.9281243219787373,3,4,84111,3866,80245,0.9540369273935633,21.558876444444444,2980.7761066666667,13.3875100452361,124,9.600000000000019E-4
6,test_20231101_134911,10350842.png,212614,5582,207032,0.9737458492855597,2,4,42529,815,41714,0.9808366056102894,20.423171555555555,2643.014272,13.909808525851933,124,9.600000000000019E-4
7,test_20231101_134911,10863862.png,317432,12857,304575,0.9594968371178709,2,4,66058,1867,64191,0.9717369584304701,23.773376,3240.2564693333334,13.025009744859632,124,9.600000000000019E-4
8,test_20231101_134911,11382381.png,312486,767,311719,0.9975454900379537,2,3,46745,100,46645,0.9978607337683175,21.58402311111111,2479.723024,14.186771864393144,124,9.600000000000019E-4
9,test_20231101_134911,11079715.png,443815,122782,321033,0.7233486925858748,3,4,124136,17120,107016,0.8620867435715667,16.763402666666668,2067.635402666667,14.97606401189655,124,9.600000000000019E-4
10,test_20231101_134911,11551286.png,271883,467,271416,0.9982823493929374,1,4,40092,67,40025,0.998328843659583,17.988837333333333,1870.894224,15.410311266718583,124,9.600000000000019E-4
1,test_20231101_134912,10404007.png,502730,21839,480891,0.9565591868398544,3,4,61265,3149,58116,0.9486003427731984,25.754179555555556,3436.142549333333,12.770091885071036,124,9.700000000000019E-4
2,test_20231101_134912,1254659.png,342646,76204,266442,0.777601372845444,2,4,80080,10632,69448,0.8672327672327672,20.676924444444445,3114.4299733333332,13.197017904793334,124,9.700000000000019E-4
3,test_20231101_134912,10188041.png,221231,9842,211389,0.9555125637907889,2,4,41731,1390,40341,0.9666914284344972,11.031626666666666,1067.9992426666668,17.84509416139609,124,9.700000000000019E-4
4,test_20231101_134912,10287332.png,216980,12687,204293,0.9415291731956862,1,3,22337,1739,20598,0.9221471101759413,9.440839111111112,776.604096,19.22880684076492,124,9.700000000000019E-4
5,test_20231101_134912,11610969.png,368720,26502,342218,0.9281243219787373,3,4,84111,3866,80245,0.9540369273935633,21.558876444444444,2980.7761066666667,13.3875100452361,124,9.700000000000019E-4
6,test_20231101_134912,10350842.png,212614,5582,207032,0.9737458492855597,2,3,42529,815,41714,0.9808366056102894,20.423171555555555,2643.014272,13.909808525851933,124,9.700000000000019E-4
7,test_20231101_134912,10863862.png,317432,12857,304575,0.9594968371178709,3,4,66058,1867,64191,0.9717369584304701,23.773376,3240.2564693333334,13.025009744859632,124,9.700000000000019E-4
8,test_20231101_134912,11382381.png,312486,767,311719,0.9975454900379537,2,4,46745,100,46645,0.9978607337683175,21.58402311111111,2479.723024,14.186771864393144,124,9.700000000000019E-4
9,test_20231101_134912,11079715.png,443815,122782,321033,0.7233486925858748,4,4,124136,17120,107016,0.8620867435715667,16.763402666666668,2067.635402666667,14.97606401189655,124,9.700000000000019E-4
10,test_20231101_134912,11551286.png,271883,467,271416,0.9982823493929374,2,3,40092,67,40025,0.998328843659583,17.988837333333333,1870.894224,15.410311266718583,124,9.700000000000019E-4
1,test_20231101_134913,10404007.png,502730,21297,481433,0.9576373003401428,2,4,61265,3079,58186,0.9497429201011998,25.904113777777777,3475.3629546666666,12.720801933870991,124,9.80000000000002E-4
2,test_20231101_134913,1254659.png,342646,76022,266624,0.7781325332850814,3,5,80080,10617,69463,0.86742007992008,20.750830222222223,3130.270112,13.174985462960077,124,9.80000000000002E-4
3,test_20231101_134913,10188041.png,221231,9702,211529,0.9561453864964675,2,4,41731,1372,40359,0.9671227624547698,11.116775111111112,1082.9984213333332,17.784525373051217,124,9.80000000000002E-4
4,test_20231101_134913,10287332.png,216980,12584,204396,0.942003871324546,2,4,22337,1724,20613,0.9228186417155393,9.492426666666667,785.1949546666667,19.181028605250994,124,9.80000000000002E-4
5,test_20231101_134913,11610969.png,368720,26242,342478,0.928829464091994,3,4,84111,3834,80277,0.9544173770374862,21.61884088888889,2989.316704,13.375084319399264,124,9.80000000000002E-4
6,test_20231101_134913,10350842.png,212614,5462,207152,0.9743102523822514,2,4,42529,797,41732,0.9812598462225776,20.577888,2671.673152,13.862970346711855,124,9.80000000000002E-4
7,test_20231101_134913,10863862.png,317432,12514,304918,0.9605773835026085,2,3,66058,1818,64240,0.9724787308123164,23.941692444444445,3280.01456,12.972045893167124,124,9.80000000000002E-4
8,test_20231101_134913,11382381.png,312486,727,311759,0.9976734957726107,1,4,46745,95,46650,0.9979676970799016,21.638337777777778,2485.5710026666666,14.176541871865357,124,9.80000000000002E-4
9,test_20231101_134913,11079715.png,443815,122699,321116,0.7235357074456699,4,4,124136,17114,107022,0.8621350776567636,16.782133333333334,2070.500992,14.970049179541583,124,9.80000000000002E-4
10,test_20231101_134913,11551286.png,271883,467,271416,0.9982823493929374,1,11,40092,67,40025,0.998328843659583,17.988837333333333,1870.894224,15.410311266718583,124,9.80000000000002E-4
1,test_20231101_134913,10404007.png,502730,21297,481433,0.9576373003401428,3,3,61265,3079,58186,0.9497429201011998,25.904113777777777,3475.3629546666666,12.720801933870991,124,9.90000000000002E-4
2,test_20231101_134913,1254659.png,342646,76022,266624,0.7781325332850814,3,3,80080,10617,69463,0.86742007992008,20.750830222222223,3130.270112,13.174985462960077,124,9.90000000000002E-4
3,test_20231101_134913,10188041.png,221231,9702,211529,0.9561453864964675,2,4,41731,1372,40359,0.9671227624547698,11.116775111111112,1082.9984213333332,17.784525373051217,124,9.90000000000002E-4
4,test_20231101_134913,10287332.png,216980,12584,204396,0.942003871324546,1,4,22337,1724,20613,0.9228186417155393,9.492426666666667,785.1949546666667,19.181028605250994,124,9.90000000000002E-4
5,test_20231101_134913,11610969.png,368720,26242,342478,0.928829464091994,2,5,84111,3834,80277,0.9544173770374862,21.61884088888889,2989.316704,13.375084319399264,124,9.90000000000002E-4
6,test_20231101_134913,10350842.png,212614,5462,207152,0.9743102523822514,1,4,42529,797,41732,0.9812598462225776,20.577888,2671.673152,13.862970346711855,124,9.90000000000002E-4
7,test_20231101_134913,10863862.png,317432,12514,304918,0.9605773835026085,2,3,66058,1818,64240,0.9724787308123164,23.941692444444445,3280.01456,12.972045893167124,124,9.90000000000002E-4
8,test_20231101_134913,11382381.png,312486,727,311759,0.9976734957726107,2,3,46745,95,46650,0.9979676970799016,21.638337777777778,2485.5710026666666,14.176541871865357,124,9.90000000000002E-4
9,test_20231101_134913,11079715.png,443815,122699,321116,0.7235357074456699,4,5,124136,17114,107022,0.8621350776567636,16.782133333333334,2070.500992,14.970049179541583,124,9.90000000000002E-4
10,test_20231101_134913,11551286.png,271883,467,271416,0.9982823493929374,2,4,40092,67,40025,0.998328843659583,17.988837333333333,1870.894224,15.410311266718583,124,9.90000000000002E-4
1,test_20231101_134914,10404007.png,502730,21859,480871,0.9565194040538659,2,4,61265,3161,58104,0.9484044723741125,25.648606222222224,3418.377488,12.792603411306079,125,0.0
2,test_20231101_134914,1254659.png,342646,74757,267889,0.7818243901869568,2,4,80080,10445,69635,0.869567932067932,20.832983111111112,3162.755813333333,13.130146982015201,125,0.0
3,test_20231101_134914,10188041.png,221231,9952,211279,0.9550153459506127,2,3,41731,1403,40328,0.9663799094198557,10.516405333333333,1008.327776,18.094786301784424,125,0.0
4,test_20231101_134914,10287332.png,216980,12797,204183,0.9410222140289428,1,3,22337,1754,20583,0.9214755786363433,9.318817777777777,752.2076,19.367426438243534,125,0.0
5,test_20231101_134914,11610969.png,368720,26082,342638,0.9292633977001519,2,4,84111,3804,80307,0.9547740485786639,21.12351288888889,2899.7180693333335,13.507245860327119,125,0.0
6,test_20231101_134914,10350842.png,212614,6184,206430,0.9709144270838233,2,4,42529,906,41623,0.9786968891814997,19.249219555555555,2368.0866986666665,14.386827624524777,125,0.0
7,test_20231101_134914,10863862.png,317432,12282,305150,0.9613082486957837,3,4,66058,1783,64275,0.9730085682279209,23.971452444444445,3305.626730666667,12.938265491291542,125,0.0
8,test_20231101_134914,11382381.png,312486,1049,311437,0.9966430496086225,2,3,46745,141,46604,0.9969836346133276,20.099987555555554,2270.406096,14.569768166799841,125,0.0
9,test_20231101_134914,11079715.png,443815,120387,323428,0.7287450852269527,3,5,124136,16809,107327,0.8645920603209383,16.86984177777778,2095.0260693333335,14.918909294142013,125,0.0
10,test_20231101_134914,11551286.png,271883,1179,270704,0.995663575876388,2,4,40092,173,39919,0.9956849246732515,15.771648,1500.8809066666668,16.367341280713223,125,0.0
1,test_20231101_134915,10404007.png,502730,21859,480871,0.9565194040538659,2,4,61265,3161,58104,0.9484044723741125,25.648606222222224,3418.377488,12.792603411306079,125,1.0E-5
2,test_20231101_134915,1254659.png,342646,74757,267889,0.7818243901869568,3,4,80080,10445,69635,0.869567932067932,20.832983111111112,3162.755813333333,13.130146982015201,125,1.0E-5
3,test_20231101_134915,10188041.png,221231,9952,211279,0.9550153459506127,2,4,41731,1403,40328,0.9663799094198557,10.516405333333333,1008.327776,18.094786301784424,125,1.0E-5
4,test_20231101_134915,10287332.png,216980,12797,204183,0.9410222140289428,2,4,22337,1754,20583,0.9214755786363433,9.318817777777777,752.2076,19.367426438243534,125,1.0E-5
5,test_20231101_134915,11610969.png,368720,26082,342638,0.9292633977001519,2,4,84111,3804,80307,0.9547740485786639,21.12351288888889,2899.7180693333335,13.507245860327119,125,1.0E-5
6,test_20231101_134915,10350842.png,212614,6184,206430,0.9709144270838233,1,4,42529,906,41623,0.9786968891814997,19.249219555555555,2368.0866986666665,14.386827624524777,125,1.0E-5
7,test_20231101_134915,10863862.png,317432,12282,305150,0.9613082486957837,2,3,66058,1783,64275,0.9730085682279209,23.971452444444445,3305.626730666667,12.938265491291542,125,1.0E-5
8,test_20231101_134915,11382381.png,312486,1049,311437,0.9966430496086225,2,3,46745,141,46604,0.9969836346133276,20.099987555555554,2270.406096,14.569768166799841,125,1.0E-5
9,test_20231101_134915,11079715.png,443815,120387,323428,0.7287450852269527,4,4,124136,16809,107327,0.8645920603209383,16.86984177777778,2095.0260693333335,14.918909294142013,125,1.0E-5
10,test_20231101_134915,11551286.png,271883,1179,270704,0.995663575876388,3,14,40092,173,39919,0.9956849246732515,15.771648,1500.8809066666668,16.367341280713223,125,1.0E-5
1,test_20231101_134915,10404007.png,502730,21859,480871,0.9565194040538659,2,3,61265,3161,58104,0.9484044723741125,25.648606222222224,3418.377488,12.792603411306079,125,2.0E-5
2,test_20231101_134915,1254659.png,342646,74757,267889,0.7818243901869568,3,4,80080,10445,69635,0.869567932067932,20.832983111111112,3162.755813333333,13.130146982015201,125,2.0E-5
3,test_20231101_134915,10188041.png,221231,9952,211279,0.9550153459506127,2,4,41731,1403,40328,0.9663799094198557,10.516405333333333,1008.327776,18.094786301784424,125,2.0E-5
4,test_20231101_134915,10287332.png,216980,12797,204183,0.9410222140289428,2,4,22337,1754,20583,0.9214755786363433,9.318817777777777,752.2076,19.367426438243534,125,2.0E-5
5,test_20231101_134915,11610969.png,368720,26082,342638,0.9292633977001519,3,3,84111,3804,80307,0.9547740485786639,21.12351288888889,2899.7180693333335,13.507245860327119,125,2.0E-5
6,test_20231101_134915,10350842.png,212614,6184,206430,0.9709144270838233,2,4,42529,906,41623,0.9786968891814997,19.249219555555555,2368.0866986666665,14.386827624524777,125,2.0E-5
7,test_20231101_134915,10863862.png,317432,12282,305150,0.9613082486957837,2,4,66058,1783,64275,0.9730085682279209,23.971452444444445,3305.626730666667,12.938265491291542,125,2.0E-5
8,test_20231101_134915,11382381.png,312486,1049,311437,0.9966430496086225,2,3,46745,141,46604,0.9969836346133276,20.099987555555554,2270.406096,14.569768166799841,125,2.0E-5
9,test_20231101_134915,11079715.png,443815,120387,323428,0.7287450852269527,5,4,124136,16809,107327,0.8645920603209383,16.86984177777778,2095.0260693333335,14.918909294142013,125,2.0E-5
10,test_20231101_134915,11551286.png,271883,1179,270704,0.995663575876388,1,3,40092,173,39919,0.9956849246732515,15.771648,1500.8809066666668,16.367341280713223,125,2.0E-5
1,test_20231101_134916,10404007.png,502730,21859,480871,0.9565194040538659,2,4,61265,3161,58104,0.9484044723741125,25.648606222222224,3418.377488,12.792603411306079,125,3.0000000000000004E-5
2,test_20231101_134916,1254659.png,342646,74757,267889,0.7818243901869568,4,4,80080,10445,69635,0.869567932067932,20.832983111111112,3162.755813333333,13.130146982015201,125,3.0000000000000004E-5
3,test_20231101_134916,10188041.png,221231,9952,211279,0.9550153459506127,2,4,41731,1403,40328,0.9663799094198557,10.516405333333333,1008.327776,18.094786301784424,125,3.0000000000000004E-5
4,test_20231101_134916,10287332.png,216980,12797,204183,0.9410222140289428,1,3,22337,1754,20583,0.9214755786363433,9.318817777777777,752.2076,19.367426438243534,125,3.0000000000000004E-5
5,test_20231101_134916,11610969.png,368720,26082,342638,0.9292633977001519,3,4,84111,3804,80307,0.9547740485786639,21.12351288888889,2899.7180693333335,13.507245860327119,125,3.0000000000000004E-5
6,test_20231101_134916,10350842.png,212614,6184,206430,0.9709144270838233,2,4,42529,906,41623,0.9786968891814997,19.249219555555555,2368.0866986666665,14.386827624524777,125,3.0000000000000004E-5
7,test_20231101_134916,10863862.png,317432,12282,305150,0.9613082486957837,2,4,66058,1783,64275,0.9730085682279209,23.971452444444445,3305.626730666667,12.938265491291542,125,3.0000000000000004E-5
8,test_20231101_134916,11382381.png,312486,1049,311437,0.9966430496086225,1,3,46745,141,46604,0.9969836346133276,20.099987555555554,2270.406096,14.569768166799841,125,3.0000000000000004E-5
9,test_20231101_134916,11079715.png,443815,120387,323428,0.7287450852269527,4,4,124136,16809,107327,0.8645920603209383,16.86984177777778,2095.0260693333335,14.918909294142013,125,3.0000000000000004E-5
10,test_20231101_134916,11551286.png,271883,1179,270704,0.995663575876388,1,3,40092,173,39919,0.9956849246732515,15.771648,1500.8809066666668,16.367341280713223,125,3.0000000000000004E-5
1,test_20231101_134917,10404007.png,502730,21859,480871,0.9565194040538659,2,4,61265,3161,58104,0.9484044723741125,25.648606222222224,3418.377488,12.792603411306079,125,4.0E-5
2,test_20231101_134917,1254659.png,342646,74757,267889,0.7818243901869568,9,4,80080,10445,69635,0.869567932067932,20.832983111111112,3162.755813333333,13.130146982015201,125,4.0E-5
3,test_20231101_134917,10188041.png,221231,9952,211279,0.9550153459506127,2,4,41731,1403,40328,0.9663799094198557,10.516405333333333,1008.327776,18.094786301784424,125,4.0E-5
4,test_20231101_134917,10287332.png,216980,12797,204183,0.9410222140289428,5,4,22337,1754,20583,0.9214755786363433,9.318817777777777,752.2076,19.367426438243534,125,4.0E-5
5,test_20231101_134917,11610969.png,368720,26082,342638,0.9292633977001519,2,4,84111,3804,80307,0.9547740485786639,21.12351288888889,2899.7180693333335,13.507245860327119,125,4.0E-5
6,test_20231101_134917,10350842.png,212614,6184,206430,0.9709144270838233,1,4,42529,906,41623,0.9786968891814997,19.249219555555555,2368.0866986666665,14.386827624524777,125,4.0E-5
7,test_20231101_134917,10863862.png,317432,12282,305150,0.9613082486957837,2,3,66058,1783,64275,0.9730085682279209,23.971452444444445,3305.626730666667,12.938265491291542,125,4.0E-5
8,test_20231101_134917,11382381.png,312486,1049,311437,0.9966430496086225,1,4,46745,141,46604,0.9969836346133276,20.099987555555554,2270.406096,14.569768166799841,125,4.0E-5
9,test_20231101_134917,11079715.png,443815,120387,323428,0.7287450852269527,3,4,124136,16809,107327,0.8645920603209383,16.86984177777778,2095.0260693333335,14.918909294142013,125,4.0E-5
10,test_20231101_134917,11551286.png,271883,1179,270704,0.995663575876388,1,3,40092,173,39919,0.9956849246732515,15.771648,1500.8809066666668,16.367341280713223,125,4.0E-5
1,test_20231101_134917,10404007.png,502730,21859,480871,0.9565194040538659,2,4,61265,3161,58104,0.9484044723741125,25.648606222222224,3418.377488,12.792603411306079,125,5.0E-5
2,test_20231101_134917,1254659.png,342646,74757,267889,0.7818243901869568,2,4,80080,10445,69635,0.869567932067932,20.832983111111112,3162.755813333333,13.130146982015201,125,5.0E-5
3,test_20231101_134917,10188041.png,221231,9952,211279,0.9550153459506127,2,3,41731,1403,40328,0.9663799094198557,10.516405333333333,1008.327776,18.094786301784424,125,5.0E-5
4,test_20231101_134917,10287332.png,216980,12797,204183,0.9410222140289428,2,4,22337,1754,20583,0.9214755786363433,9.318817777777777,752.2076,19.367426438243534,125,5.0E-5
5,test_20231101_134917,11610969.png,368720,26082,342638,0.9292633977001519,2,11,84111,3804,80307,0.9547740485786639,21.12351288888889,2899.7180693333335,13.507245860327119,125,5.0E-5
6,test_20231101_134917,10350842.png,212614,6184,206430,0.9709144270838233,2,3,42529,906,41623,0.9786968891814997,19.249219555555555,2368.0866986666665,14.386827624524777,125,5.0E-5
7,test_20231101_134917,10863862.png,317432,12282,305150,0.9613082486957837,2,4,66058,1783,64275,0.9730085682279209,23.971452444444445,3305.626730666667,12.938265491291542,125,5.0E-5
8,test_20231101_134917,11382381.png,312486,1039,311447,0.9966750510422867,1,4,46745,140,46605,0.9970050272756444,20.829804444444445,2368.9669066666665,14.385213669887252,125,5.0E-5
9,test_20231101_134917,11079715.png,443815,120387,323428,0.7287450852269527,3,5,124136,16809,107327,0.8645920603209383,16.86984177777778,2095.0260693333335,14.918909294142013,125,5.0E-5
10,test_20231101_134917,11551286.png,271883,1179,270704,0.995663575876388,2,3,40092,173,39919,0.9956849246732515,15.771648,1500.8809066666668,16.367341280713223,125,5.0E-5
1,test_20231101_134918,10404007.png,502730,21859,480871,0.9565194040538659,2,4,61265,3161,58104,0.9484044723741125,25.648606222222224,3418.377488,12.792603411306079,125,6.0E-5
2,test_20231101_134918,1254659.png,342646,74757,267889,0.7818243901869568,3,4,80080,10445,69635,0.869567932067932,20.832983111111112,3162.755813333333,13.130146982015201,125,6.0E-5
3,test_20231101_134918,10188041.png,221231,9952,211279,0.9550153459506127,2,3,41731,1403,40328,0.9663799094198557,10.516405333333333,1008.327776,18.094786301784424,125,6.0E-5
4,test_20231101_134918,10287332.png,216980,12797,204183,0.9410222140289428,2,3,22337,1754,20583,0.9214755786363433,9.318817777777777,752.2076,19.367426438243534,125,6.0E-5
5,test_20231101_134918,11610969.png,368720,26082,342638,0.9292633977001519,2,3,84111,3804,80307,0.9547740485786639,21.12351288888889,2899.7180693333335,13.507245860327119,125,6.0E-5
6,test_20231101_134918,10350842.png,212614,6184,206430,0.9709144270838233,1,3,42529,906,41623,0.9786968891814997,19.249219555555555,2368.0866986666665,14.386827624524777,125,6.0E-5
7,test_20231101_134918,10863862.png,317432,12282,305150,0.9613082486957837,2,4,66058,1783,64275,0.9730085682279209,23.971452444444445,3305.626730666667,12.938265491291542,125,6.0E-5
8,test_20231101_134918,11382381.png,312486,1039,311447,0.9966750510422867,1,4,46745,140,46605,0.9970050272756444,20.829804444444445,2368.9669066666665,14.385213669887252,125,6.0E-5
9,test_20231101_134918,11079715.png,443815,120387,323428,0.7287450852269527,4,4,124136,16809,107327,0.8645920603209383,16.86984177777778,2095.0260693333335,14.918909294142013,125,6.0E-5
10,test_20231101_134918,11551286.png,271883,1179,270704,0.995663575876388,2,3,40092,173,39919,0.9956849246732515,15.771648,1500.8809066666668,16.367341280713223,125,6.0E-5
1,test_20231101_134919,10404007.png,502730,21859,480871,0.9565194040538659,3,3,61265,3161,58104,0.9484044723741125,25.648606222222224,3418.377488,12.792603411306079,125,7.000000000000001E-5
2,test_20231101_134919,1254659.png,342646,74757,267889,0.7818243901869568,2,4,80080,10445,69635,0.869567932067932,20.832983111111112,3162.755813333333,13.130146982015201,125,7.000000000000001E-5
3,test_20231101_134919,10188041.png,221231,9952,211279,0.9550153459506127,2,4,41731,1403,40328,0.9663799094198557,10.516405333333333,1008.327776,18.094786301784424,125,7.000000000000001E-5
4,test_20231101_134919,10287332.png,216980,12797,204183,0.9410222140289428,2,4,22337,1754,20583,0.9214755786363433,9.318817777777777,752.2076,19.367426438243534,125,7.000000000000001E-5
5,test_20231101_134919,11610969.png,368720,26082,342638,0.9292633977001519,2,4,84111,3804,80307,0.9547740485786639,21.12351288888889,2899.7180693333335,13.507245860327119,125,7.000000000000001E-5
6,test_20231101_134919,10350842.png,212614,6184,206430,0.9709144270838233,2,4,42529,906,41623,0.9786968891814997,19.249219555555555,2368.0866986666665,14.386827624524777,125,7.000000000000001E-5
7,test_20231101_134919,10863862.png,317432,12282,305150,0.9613082486957837,2,4,66058,1783,64275,0.9730085682279209,23.971452444444445,3305.626730666667,12.938265491291542,125,7.000000000000001E-5
8,test_20231101_134919,11382381.png,312486,1039,311447,0.9966750510422867,1,3,46745,140,46605,0.9970050272756444,20.829804444444445,2368.9669066666665,14.385213669887252,125,7.000000000000001E-5
9,test_20231101_134919,11079715.png,443815,120387,323428,0.7287450852269527,3,5,124136,16809,107327,0.8645920603209383,16.86984177777778,2095.0260693333335,14.918909294142013,125,7.000000000000001E-5
10,test_20231101_134919,11551286.png,271883,1059,270824,0.9961049421994019,2,4,40092,155,39937,0.996133892048289,15.857982222222223,1506.99288,16.349691604338467,125,7.000000000000001E-5
1,test_20231101_134919,10404007.png,502730,21859,480871,0.9565194040538659,2,4,61265,3161,58104,0.9484044723741125,25.648606222222224,3418.377488,12.792603411306079,125,8.0E-5
2,test_20231101_134919,1254659.png,342646,74757,267889,0.7818243901869568,3,4,80080,10445,69635,0.869567932067932,20.832983111111112,3162.755813333333,13.130146982015201,125,8.0E-5
3,test_20231101_134919,10188041.png,221231,9952,211279,0.9550153459506127,2,4,41731,1403,40328,0.9663799094198557,10.516405333333333,1008.327776,18.094786301784424,125,8.0E-5
4,test_20231101_134919,10287332.png,216980,12797,204183,0.9410222140289428,2,4,22337,1754,20583,0.9214755786363433,9.318817777777777,752.2076,19.367426438243534,125,8.0E-5
5,test_20231101_134919,11610969.png,368720,26082,342638,0.9292633977001519,3,4,84111,3804,80307,0.9547740485786639,21.12351288888889,2899.7180693333335,13.507245860327119,125,8.0E-5
6,test_20231101_134919,10350842.png,212614,6184,206430,0.9709144270838233,2,3,42529,906,41623,0.9786968891814997,19.249219555555555,2368.0866986666665,14.386827624524777,125,8.0E-5
7,test_20231101_134919,10863862.png,317432,12282,305150,0.9613082486957837,2,4,66058,1783,64275,0.9730085682279209,23.971452444444445,3305.626730666667,12.938265491291542,125,8.0E-5
8,test_20231101_134919,11382381.png,312486,1039,311447,0.9966750510422867,2,3,46745,140,46605,0.9970050272756444,20.829804444444445,2368.9669066666665,14.385213669887252,125,8.0E-5
9,test_20231101_134919,11079715.png,443815,120387,323428,0.7287450852269527,8,4,124136,16809,107327,0.8645920603209383,16.86984177777778,2095.0260693333335,14.918909294142013,125,8.0E-5
10,test_20231101_134919,11551286.png,271883,1059,270824,0.9961049421994019,2,4,40092,155,39937,0.996133892048289,15.857982222222223,1506.99288,16.349691604338467,125,8.0E-5
1,test_20231101_134920,10404007.png,502730,21859,480871,0.9565194040538659,2,4,61265,3161,58104,0.9484044723741125,25.648606222222224,3418.377488,12.792603411306079,125,9.0E-5
2,test_20231101_134920,1254659.png,342646,74757,267889,0.7818243901869568,3,4,80080,10445,69635,0.869567932067932,20.832983111111112,3162.755813333333,13.130146982015201,125,9.0E-5
3,test_20231101_134920,10188041.png,221231,9952,211279,0.9550153459506127,2,4,41731,1403,40328,0.9663799094198557,10.516405333333333,1008.327776,18.094786301784424,125,9.0E-5
4,test_20231101_134920,10287332.png,216980,12797,204183,0.9410222140289428,1,3,22337,1754,20583,0.9214755786363433,9.318817777777777,752.2076,19.367426438243534,125,9.0E-5
5,test_20231101_134920,11610969.png,368720,26082,342638,0.9292633977001519,2,4,84111,3804,80307,0.9547740485786639,21.12351288888889,2899.7180693333335,13.507245860327119,125,9.0E-5
6,test_20231101_134920,10350842.png,212614,6184,206430,0.9709144270838233,2,4,42529,906,41623,0.9786968891814997,19.249219555555555,2368.0866986666665,14.386827624524777,125,9.0E-5
7,test_20231101_134920,10863862.png,317432,12282,305150,0.9613082486957837,2,11,66058,1783,64275,0.9730085682279209,23.971452444444445,3305.626730666667,12.938265491291542,125,9.0E-5
8,test_20231101_134920,11382381.png,312486,1039,311447,0.9966750510422867,1,4,46745,140,46605,0.9970050272756444,20.829804444444445,2368.9669066666665,14.385213669887252,125,9.0E-5
9,test_20231101_134920,11079715.png,443815,120387,323428,0.7287450852269527,4,4,124136,16809,107327,0.8645920603209383,16.86984177777778,2095.0260693333335,14.918909294142013,125,9.0E-5
10,test_20231101_134920,11551286.png,271883,1059,270824,0.9961049421994019,1,4,40092,155,39937,0.996133892048289,15.857982222222223,1506.99288,16.349691604338467,125,9.0E-5
1,test_20231101_134921,10404007.png,502730,21859,480871,0.9565194040538659,2,4,61265,3161,58104,0.9484044723741125,25.648606222222224,3418.377488,12.792603411306079,125,1.0E-4
2,test_20231101_134921,1254659.png,342646,74757,267889,0.7818243901869568,3,4,80080,10445,69635,0.869567932067932,20.832983111111112,3162.755813333333,13.130146982015201,125,1.0E-4
3,test_20231101_134921,10188041.png,221231,9952,211279,0.9550153459506127,2,3,41731,1403,40328,0.9663799094198557,10.516405333333333,1008.327776,18.094786301784424,125,1.0E-4
4,test_20231101_134921,10287332.png,216980,12797,204183,0.9410222140289428,2,4,22337,1754,20583,0.9214755786363433,9.318817777777777,752.2076,19.367426438243534,125,1.0E-4
5,test_20231101_134921,11610969.png,368720,26082,342638,0.9292633977001519,2,4,84111,3804,80307,0.9547740485786639,21.12351288888889,2899.7180693333335,13.507245860327119,125,1.0E-4
6,test_20231101_134921,10350842.png,212614,6184,206430,0.9709144270838233,2,3,42529,906,41623,0.9786968891814997,19.249219555555555,2368.0866986666665,14.386827624524777,125,1.0E-4
7,test_20231101_134921,10863862.png,317432,12282,305150,0.9613082486957837,2,4,66058,1783,64275,0.9730085682279209,23.971452444444445,3305.626730666667,12.938265491291542,125,1.0E-4
8,test_20231101_134921,11382381.png,312486,1039,311447,0.9966750510422867,1,3,46745,140,46605,0.9970050272756444,20.829804444444445,2368.9669066666665,14.385213669887252,125,1.0E-4
9,test_20231101_134921,11079715.png,443815,120387,323428,0.7287450852269527,3,4,124136,16809,107327,0.8645920603209383,16.86984177777778,2095.0260693333335,14.918909294142013,125,1.0E-4
10,test_20231101_134921,11551286.png,271883,1059,270824,0.9961049421994019,1,3,40092,155,39937,0.996133892048289,15.857982222222223,1506.99288,16.349691604338467,125,1.0E-4
1,test_20231101_134921,10404007.png,502730,21859,480871,0.9565194040538659,2,3,61265,3161,58104,0.9484044723741125,25.648606222222224,3418.377488,12.792603411306079,125,1.1E-4
2,test_20231101_134921,1254659.png,342646,74757,267889,0.7818243901869568,4,4,80080,10445,69635,0.869567932067932,20.832983111111112,3162.755813333333,13.130146982015201,125,1.1E-4
3,test_20231101_134921,10188041.png,221231,9952,211279,0.9550153459506127,2,4,41731,1403,40328,0.9663799094198557,10.516405333333333,1008.327776,18.094786301784424,125,1.1E-4
4,test_20231101_134921,10287332.png,216980,12797,204183,0.9410222140289428,2,3,22337,1754,20583,0.9214755786363433,9.318817777777777,752.2076,19.367426438243534,125,1.1E-4
5,test_20231101_134921,11610969.png,368720,26082,342638,0.9292633977001519,3,4,84111,3804,80307,0.9547740485786639,21.12351288888889,2899.7180693333335,13.507245860327119,125,1.1E-4
6,test_20231101_134921,10350842.png,212614,6184,206430,0.9709144270838233,2,3,42529,906,41623,0.9786968891814997,19.249219555555555,2368.0866986666665,14.386827624524777,125,1.1E-4
7,test_20231101_134921,10863862.png,317432,12282,305150,0.9613082486957837,3,3,66058,1783,64275,0.9730085682279209,23.971452444444445,3305.626730666667,12.938265491291542,125,1.1E-4
8,test_20231101_134921,11382381.png,312486,1039,311447,0.9966750510422867,2,3,46745,140,46605,0.9970050272756444,20.829804444444445,2368.9669066666665,14.385213669887252,125,1.1E-4
9,test_20231101_134921,11079715.png,443815,120387,323428,0.7287450852269527,4,5,124136,16809,107327,0.8645920603209383,16.86984177777778,2095.0260693333335,14.918909294142013,125,1.1E-4
10,test_20231101_134921,11551286.png,271883,1059,270824,0.9961049421994019,2,4,40092,155,39937,0.996133892048289,15.857982222222223,1506.99288,16.349691604338467,125,1.1E-4
1,test_20231101_134922,10404007.png,502730,21859,480871,0.9565194040538659,3,4,61265,3161,58104,0.9484044723741125,25.648606222222224,3418.377488,12.792603411306079,125,1.2E-4
2,test_20231101_134922,1254659.png,342646,74757,267889,0.7818243901869568,3,4,80080,10445,69635,0.869567932067932,20.832983111111112,3162.755813333333,13.130146982015201,125,1.2E-4
3,test_20231101_134922,10188041.png,221231,9952,211279,0.9550153459506127,2,3,41731,1403,40328,0.9663799094198557,10.516405333333333,1008.327776,18.094786301784424,125,1.2E-4
4,test_20231101_134922,10287332.png,216980,12797,204183,0.9410222140289428,2,4,22337,1754,20583,0.9214755786363433,9.318817777777777,752.2076,19.367426438243534,125,1.2E-4
5,test_20231101_134922,11610969.png,368720,26082,342638,0.9292633977001519,3,4,84111,3804,80307,0.9547740485786639,21.12351288888889,2899.7180693333335,13.507245860327119,125,1.2E-4
6,test_20231101_134922,10350842.png,212614,6184,206430,0.9709144270838233,1,3,42529,906,41623,0.9786968891814997,19.249219555555555,2368.0866986666665,14.386827624524777,125,1.2E-4
7,test_20231101_134922,10863862.png,317432,12282,305150,0.9613082486957837,2,4,66058,1783,64275,0.9730085682279209,23.971452444444445,3305.626730666667,12.938265491291542,125,1.2E-4
8,test_20231101_134922,11382381.png,312486,1039,311447,0.9966750510422867,2,3,46745,140,46605,0.9970050272756444,20.829804444444445,2368.9669066666665,14.385213669887252,125,1.2E-4
9,test_20231101_134922,11079715.png,443815,120387,323428,0.7287450852269527,3,4,124136,16809,107327,0.8645920603209383,16.86984177777778,2095.0260693333335,14.918909294142013,125,1.2E-4
10,test_20231101_134922,11551286.png,271883,1059,270824,0.9961049421994019,1,3,40092,155,39937,0.996133892048289,15.857982222222223,1506.99288,16.349691604338467,125,1.2E-4
1,test_20231101_134923,10404007.png,502730,21859,480871,0.9565194040538659,3,3,61265,3161,58104,0.9484044723741125,25.648606222222224,3418.377488,12.792603411306079,125,1.3000000000000002E-4
2,test_20231101_134923,1254659.png,342646,74757,267889,0.7818243901869568,2,3,80080,10445,69635,0.869567932067932,20.832983111111112,3162.755813333333,13.130146982015201,125,1.3000000000000002E-4
3,test_20231101_134923,10188041.png,221231,9952,211279,0.9550153459506127,2,4,41731,1403,40328,0.9663799094198557,10.516405333333333,1008.327776,18.094786301784424,125,1.3000000000000002E-4
4,test_20231101_134923,10287332.png,216980,12797,204183,0.9410222140289428,2,4,22337,1754,20583,0.9214755786363433,9.318817777777777,752.2076,19.367426438243534,125,1.3000000000000002E-4
5,test_20231101_134923,11610969.png,368720,26082,342638,0.9292633977001519,3,4,84111,3804,80307,0.9547740485786639,21.12351288888889,2899.7180693333335,13.507245860327119,125,1.3000000000000002E-4
6,test_20231101_134923,10350842.png,212614,6184,206430,0.9709144270838233,1,4,42529,906,41623,0.9786968891814997,19.249219555555555,2368.0866986666665,14.386827624524777,125,1.3000000000000002E-4
7,test_20231101_134923,10863862.png,317432,12282,305150,0.9613082486957837,3,4,66058,1783,64275,0.9730085682279209,23.971452444444445,3305.626730666667,12.938265491291542,125,1.3000000000000002E-4
8,test_20231101_134923,11382381.png,312486,1039,311447,0.9966750510422867,1,3,46745,140,46605,0.9970050272756444,20.829804444444445,2368.9669066666665,14.385213669887252,125,1.3000000000000002E-4
9,test_20231101_134923,11079715.png,443815,120387,323428,0.7287450852269527,4,4,124136,16809,107327,0.8645920603209383,16.86984177777778,2095.0260693333335,14.918909294142013,125,1.3000000000000002E-4
10,test_20231101_134923,11551286.png,271883,877,271006,0.9967743477893064,2,3,40092,128,39964,0.9968073431108451,17.018796444444444,1715.096528,15.787917931083486,125,1.3000000000000002E-4
1,test_20231101_134924,10404007.png,502730,21859,480871,0.9565194040538659,2,4,61265,3161,58104,0.9484044723741125,25.648606222222224,3418.377488,12.792603411306079,125,1.4000000000000001E-4
2,test_20231101_134924,1254659.png,342646,74757,267889,0.7818243901869568,2,4,80080,10445,69635,0.869567932067932,20.832983111111112,3162.755813333333,13.130146982015201,125,1.4000000000000001E-4
3,test_20231101_134924,10188041.png,221231,9952,211279,0.9550153459506127,2,4,41731,1403,40328,0.9663799094198557,10.516405333333333,1008.327776,18.094786301784424,125,1.4000000000000001E-4
4,test_20231101_134924,10287332.png,216980,12797,204183,0.9410222140289428,2,4,22337,1754,20583,0.9214755786363433,9.318817777777777,752.2076,19.367426438243534,125,1.4000000000000001E-4
5,test_20231101_134924,11610969.png,368720,26082,342638,0.9292633977001519,2,4,84111,3804,80307,0.9547740485786639,21.12351288888889,2899.7180693333335,13.507245860327119,125,1.4000000000000001E-4
6,test_20231101_134924,10350842.png,212614,6184,206430,0.9709144270838233,1,6,42529,906,41623,0.9786968891814997,19.249219555555555,2368.0866986666665,14.386827624524777,125,1.4000000000000001E-4
7,test_20231101_134924,10863862.png,317432,12282,305150,0.9613082486957837,2,3,66058,1783,64275,0.9730085682279209,23.971452444444445,3305.626730666667,12.938265491291542,125,1.4000000000000001E-4
8,test_20231101_134924,11382381.png,312486,1039,311447,0.9966750510422867,1,3,46745,140,46605,0.9970050272756444,20.829804444444445,2368.9669066666665,14.385213669887252,125,1.4000000000000001E-4
9,test_20231101_134924,11079715.png,443815,120387,323428,0.7287450852269527,4,5,124136,16809,107327,0.8645920603209383,16.86984177777778,2095.0260693333335,14.918909294142013,125,1.4000000000000001E-4
10,test_20231101_134924,11551286.png,271883,877,271006,0.9967743477893064,1,3,40092,128,39964,0.9968073431108451,17.018796444444444,1715.096528,15.787917931083486,125,1.4000000000000001E-4
1,test_20231101_134924,10404007.png,502730,21859,480871,0.9565194040538659,2,3,61265,3161,58104,0.9484044723741125,25.648606222222224,3418.377488,12.792603411306079,125,1.5000000000000001E-4
2,test_20231101_134924,1254659.png,342646,74757,267889,0.7818243901869568,3,4,80080,10445,69635,0.869567932067932,20.832983111111112,3162.755813333333,13.130146982015201,125,1.5000000000000001E-4
3,test_20231101_134924,10188041.png,221231,9952,211279,0.9550153459506127,2,7,41731,1403,40328,0.9663799094198557,10.516405333333333,1008.327776,18.094786301784424,125,1.5000000000000001E-4
4,test_20231101_134924,10287332.png,216980,12797,204183,0.9410222140289428,2,3,22337,1754,20583,0.9214755786363433,9.318817777777777,752.2076,19.367426438243534,125,1.5000000000000001E-4
5,test_20231101_134924,11610969.png,368720,26082,342638,0.9292633977001519,3,3,84111,3804,80307,0.9547740485786639,21.12351288888889,2899.7180693333335,13.507245860327119,125,1.5000000000000001E-4
6,test_20231101_134924,10350842.png,212614,6184,206430,0.9709144270838233,1,3,42529,906,41623,0.9786968891814997,19.249219555555555,2368.0866986666665,14.386827624524777,125,1.5000000000000001E-4
7,test_20231101_134924,10863862.png,317432,12282,305150,0.9613082486957837,2,4,66058,1783,64275,0.9730085682279209,23.971452444444445,3305.626730666667,12.938265491291542,125,1.5000000000000001E-4
8,test_20231101_134924,11382381.png,312486,1039,311447,0.9966750510422867,2,6,46745,140,46605,0.9970050272756444,20.829804444444445,2368.9669066666665,14.385213669887252,125,1.5000000000000001E-4
9,test_20231101_134924,11079715.png,443815,120387,323428,0.7287450852269527,3,4,124136,16809,107327,0.8645920603209383,16.86984177777778,2095.0260693333335,14.918909294142013,125,1.5000000000000001E-4
10,test_20231101_134924,11551286.png,271883,877,271006,0.9967743477893064,1,4,40092,128,39964,0.9968073431108451,17.018796444444444,1715.096528,15.787917931083486,125,1.5000000000000001E-4
1,test_20231101_134925,10404007.png,502730,21859,480871,0.9565194040538659,3,8,61265,3161,58104,0.9484044723741125,25.648606222222224,3418.377488,12.792603411306079,125,1.6E-4
2,test_20231101_134925,1254659.png,342646,74757,267889,0.7818243901869568,3,4,80080,10445,69635,0.869567932067932,20.832983111111112,3162.755813333333,13.130146982015201,125,1.6E-4
3,test_20231101_134925,10188041.png,221231,9952,211279,0.9550153459506127,2,3,41731,1403,40328,0.9663799094198557,10.516405333333333,1008.327776,18.094786301784424,125,1.6E-4
4,test_20231101_134925,10287332.png,216980,12584,204396,0.942003871324546,2,4,22337,1727,20610,0.9226843354076196,9.448579555555556,778.9383466666667,19.21577276445775,125,1.6E-4
5,test_20231101_134925,11610969.png,368720,26082,342638,0.9292633977001519,2,4,84111,3804,80307,0.9547740485786639,21.12351288888889,2899.7180693333335,13.507245860327119,125,1.6E-4
6,test_20231101_134925,10350842.png,212614,6184,206430,0.9709144270838233,2,4,42529,906,41623,0.9786968891814997,19.249219555555555,2368.0866986666665,14.386827624524777,125,1.6E-4
7,test_20231101_134925,10863862.png,317432,12282,305150,0.9613082486957837,2,5,66058,1783,64275,0.9730085682279209,23.971452444444445,3305.626730666667,12.938265491291542,125,1.6E-4
8,test_20231101_134925,11382381.png,312486,907,311579,0.9970974699666545,2,4,46745,121,46624,0.9974114878596642,21.088220444444445,2409.5101546666665,14.311515999312824,125,1.6E-4
9,test_20231101_134925,11079715.png,443815,120387,323428,0.7287450852269527,3,4,124136,16809,107327,0.8645920603209383,16.86984177777778,2095.0260693333335,14.918909294142013,125,1.6E-4
10,test_20231101_134925,11551286.png,271883,877,271006,0.9967743477893064,2,8,40092,128,39964,0.9968073431108451,17.018796444444444,1715.096528,15.787917931083486,125,1.6E-4
1,test_20231101_134926,10404007.png,502730,21859,480871,0.9565194040538659,2,4,61265,3161,58104,0.9484044723741125,25.648606222222224,3418.377488,12.792603411306079,125,1.7E-4
2,test_20231101_134926,1254659.png,342646,74757,267889,0.7818243901869568,3,3,80080,10445,69635,0.869567932067932,20.832983111111112,3162.755813333333,13.130146982015201,125,1.7E-4
3,test_20231101_134926,10188041.png,221231,9952,211279,0.9550153459506127,3,3,41731,1403,40328,0.9663799094198557,10.516405333333333,1008.327776,18.094786301784424,125,1.7E-4
4,test_20231101_134926,10287332.png,216980,12584,204396,0.942003871324546,2,4,22337,1727,20610,0.9226843354076196,9.448579555555556,778.9383466666667,19.21577276445775,125,1.7E-4
5,test_20231101_134926,11610969.png,368720,26082,342638,0.9292633977001519,2,4,84111,3804,80307,0.9547740485786639,21.12351288888889,2899.7180693333335,13.507245860327119,125,1.7E-4
6,test_20231101_134926,10350842.png,212614,6184,206430,0.9709144270838233,2,6,42529,906,41623,0.9786968891814997,19.249219555555555,2368.0866986666665,14.386827624524777,125,1.7E-4
7,test_20231101_134926,10863862.png,317432,12282,305150,0.9613082486957837,2,4,66058,1783,64275,0.9730085682279209,23.971452444444445,3305.626730666667,12.938265491291542,125,1.7E-4
8,test_20231101_134926,11382381.png,312486,907,311579,0.9970974699666545,2,3,46745,121,46624,0.9974114878596642,21.088220444444445,2409.5101546666665,14.311515999312824,125,1.7E-4
9,test_20231101_134926,11079715.png,443815,120387,323428,0.7287450852269527,3,4,124136,16809,107327,0.8645920603209383,16.86984177777778,2095.0260693333335,14.918909294142013,125,1.7E-4
10,test_20231101_134926,11551286.png,271883,877,271006,0.9967743477893064,2,3,40092,128,39964,0.9968073431108451,17.018796444444444,1715.096528,15.787917931083486,125,1.7E-4
1,test_20231101_134926,10404007.png,502730,21859,480871,0.9565194040538659,2,4,61265,3161,58104,0.9484044723741125,25.648606222222224,3418.377488,12.792603411306079,125,1.8E-4
2,test_20231101_134926,1254659.png,342646,74757,267889,0.7818243901869568,2,4,80080,10445,69635,0.869567932067932,20.832983111111112,3162.755813333333,13.130146982015201,125,1.8E-4
3,test_20231101_134926,10188041.png,221231,9952,211279,0.9550153459506127,2,4,41731,1403,40328,0.9663799094198557,10.516405333333333,1008.327776,18.094786301784424,125,1.8E-4
4,test_20231101_134926,10287332.png,216980,12584,204396,0.942003871324546,2,4,22337,1727,20610,0.9226843354076196,9.448579555555556,778.9383466666667,19.21577276445775,125,1.8E-4
5,test_20231101_134926,11610969.png,368720,26082,342638,0.9292633977001519,2,4,84111,3804,80307,0.9547740485786639,21.12351288888889,2899.7180693333335,13.507245860327119,125,1.8E-4
6,test_20231101_134926,10350842.png,212614,6184,206430,0.9709144270838233,1,4,42529,906,41623,0.9786968891814997,19.249219555555555,2368.0866986666665,14.386827624524777,125,1.8E-4
7,test_20231101_134926,10863862.png,317432,12282,305150,0.9613082486957837,2,8,66058,1783,64275,0.9730085682279209,23.971452444444445,3305.626730666667,12.938265491291542,125,1.8E-4
8,test_20231101_134926,11382381.png,312486,907,311579,0.9970974699666545,2,3,46745,121,46624,0.9974114878596642,21.088220444444445,2409.5101546666665,14.311515999312824,125,1.8E-4
9,test_20231101_134926,11079715.png,443815,120387,323428,0.7287450852269527,3,5,124136,16809,107327,0.8645920603209383,16.86984177777778,2095.0260693333335,14.918909294142013,125,1.8E-4
10,test_20231101_134926,11551286.png,271883,877,271006,0.9967743477893064,1,3,40092,128,39964,0.9968073431108451,17.018796444444444,1715.096528,15.787917931083486,125,1.8E-4
1,test_20231101_134927,10404007.png,502730,21859,480871,0.9565194040538659,2,3,61265,3161,58104,0.9484044723741125,25.648606222222224,3418.377488,12.792603411306079,125,1.9E-4
2,test_20231101_134927,1254659.png,342646,74757,267889,0.7818243901869568,3,4,80080,10445,69635,0.869567932067932,20.832983111111112,3162.755813333333,13.130146982015201,125,1.9E-4
3,test_20231101_134927,10188041.png,221231,9952,211279,0.9550153459506127,2,4,41731,1403,40328,0.9663799094198557,10.516405333333333,1008.327776,18.094786301784424,125,1.9E-4
4,test_20231101_134927,10287332.png,216980,12584,204396,0.942003871324546,2,4,22337,1727,20610,0.9226843354076196,9.448579555555556,778.9383466666667,19.21577276445775,125,1.9E-4
5,test_20231101_134927,11610969.png,368720,26082,342638,0.9292633977001519,2,3,84111,3804,80307,0.9547740485786639,21.12351288888889,2899.7180693333335,13.507245860327119,125,1.9E-4
6,test_20231101_134927,10350842.png,212614,6184,206430,0.9709144270838233,1,3,42529,906,41623,0.9786968891814997,19.249219555555555,2368.0866986666665,14.386827624524777,125,1.9E-4
7,test_20231101_134927,10863862.png,317432,12282,305150,0.9613082486957837,2,4,66058,1783,64275,0.9730085682279209,23.971452444444445,3305.626730666667,12.938265491291542,125,1.9E-4
8,test_20231101_134927,11382381.png,312486,907,311579,0.9970974699666545,1,4,46745,121,46624,0.9974114878596642,21.088220444444445,2409.5101546666665,14.311515999312824,125,1.9E-4
9,test_20231101_134927,11079715.png,443815,120387,323428,0.7287450852269527,3,4,124136,16809,107327,0.8645920603209383,16.86984177777778,2095.0260693333335,14.918909294142013,125,1.9E-4
10,test_20231101_134927,11551286.png,271883,877,271006,0.9967743477893064,1,4,40092,128,39964,0.9968073431108451,17.018796444444444,1715.096528,15.787917931083486,125,1.9E-4
1,test_20231101_134928,10404007.png,502730,21859,480871,0.9565194040538659,3,4,61265,3161,58104,0.9484044723741125,25.648606222222224,3418.377488,12.792603411306079,125,2.0E-4
2,test_20231101_134928,1254659.png,342646,74757,267889,0.7818243901869568,2,3,80080,10445,69635,0.869567932067932,20.832983111111112,3162.755813333333,13.130146982015201,125,2.0E-4
3,test_20231101_134928,10188041.png,221231,9952,211279,0.9550153459506127,2,4,41731,1403,40328,0.9663799094198557,10.516405333333333,1008.327776,18.094786301784424,125,2.0E-4
4,test_20231101_134928,10287332.png,216980,12584,204396,0.942003871324546,2,4,22337,1727,20610,0.9226843354076196,9.448579555555556,778.9383466666667,19.21577276445775,125,2.0E-4
5,test_20231101_134928,11610969.png,368720,26082,342638,0.9292633977001519,3,4,84111,3804,80307,0.9547740485786639,21.12351288888889,2899.7180693333335,13.507245860327119,125,2.0E-4
6,test_20231101_134928,10350842.png,212614,6184,206430,0.9709144270838233,1,4,42529,906,41623,0.9786968891814997,19.249219555555555,2368.0866986666665,14.386827624524777,125,2.0E-4
7,test_20231101_134928,10863862.png,317432,12282,305150,0.9613082486957837,2,4,66058,1783,64275,0.9730085682279209,23.971452444444445,3305.626730666667,12.938265491291542,125,2.0E-4
8,test_20231101_134928,11382381.png,312486,907,311579,0.9970974699666545,1,4,46745,121,46624,0.9974114878596642,21.088220444444445,2409.5101546666665,14.311515999312824,125,2.0E-4
9,test_20231101_134928,11079715.png,443815,120387,323428,0.7287450852269527,3,4,124136,16809,107327,0.8645920603209383,16.86984177777778,2095.0260693333335,14.918909294142013,125,2.0E-4
10,test_20231101_134928,11551286.png,271883,877,271006,0.9967743477893064,1,3,40092,128,39964,0.9968073431108451,17.018796444444444,1715.096528,15.787917931083486,125,2.0E-4
1,test_20231101_134928,10404007.png,502730,21859,480871,0.9565194040538659,2,3,61265,3161,58104,0.9484044723741125,25.648606222222224,3418.377488,12.792603411306079,125,2.1E-4
2,test_20231101_134928,1254659.png,342646,74757,267889,0.7818243901869568,4,4,80080,10445,69635,0.869567932067932,20.832983111111112,3162.755813333333,13.130146982015201,125,2.1E-4
3,test_20231101_134928,10188041.png,221231,9952,211279,0.9550153459506127,3,3,41731,1403,40328,0.9663799094198557,10.516405333333333,1008.327776,18.094786301784424,125,2.1E-4
4,test_20231101_134928,10287332.png,216980,12584,204396,0.942003871324546,2,4,22337,1727,20610,0.9226843354076196,9.448579555555556,778.9383466666667,19.21577276445775,125,2.1E-4
5,test_20231101_134928,11610969.png,368720,26082,342638,0.9292633977001519,2,4,84111,3804,80307,0.9547740485786639,21.12351288888889,2899.7180693333335,13.507245860327119,125,2.1E-4
6,test_20231101_134928,10350842.png,212614,6184,206430,0.9709144270838233,2,3,42529,906,41623,0.9786968891814997,19.249219555555555,2368.0866986666665,14.386827624524777,125,2.1E-4
7,test_20231101_134928,10863862.png,317432,12282,305150,0.9613082486957837,2,4,66058,1783,64275,0.9730085682279209,23.971452444444445,3305.626730666667,12.938265491291542,125,2.1E-4
8,test_20231101_134928,11382381.png,312486,907,311579,0.9970974699666545,2,4,46745,121,46624,0.9974114878596642,21.088220444444445,2409.5101546666665,14.311515999312824,125,2.1E-4
9,test_20231101_134928,11079715.png,443815,120387,323428,0.7287450852269527,4,4,124136,16809,107327,0.8645920603209383,16.86984177777778,2095.0260693333335,14.918909294142013,125,2.1E-4
10,test_20231101_134928,11551286.png,271883,877,271006,0.9967743477893064,1,3,40092,128,39964,0.9968073431108451,17.018796444444444,1715.096528,15.787917931083486,125,2.1E-4
1,test_20231101_134929,10404007.png,502730,21859,480871,0.9565194040538659,3,3,61265,3161,58104,0.9484044723741125,25.648606222222224,3418.377488,12.792603411306079,125,2.2E-4
2,test_20231101_134929,1254659.png,342646,74757,267889,0.7818243901869568,3,4,80080,10445,69635,0.869567932067932,20.832983111111112,3162.755813333333,13.130146982015201,125,2.2E-4
3,test_20231101_134929,10188041.png,221231,9952,211279,0.9550153459506127,2,3,41731,1403,40328,0.9663799094198557,10.516405333333333,1008.327776,18.094786301784424,125,2.2E-4
4,test_20231101_134929,10287332.png,216980,12584,204396,0.942003871324546,1,3,22337,1727,20610,0.9226843354076196,9.448579555555556,778.9383466666667,19.21577276445775,125,2.2E-4
5,test_20231101_134929,11610969.png,368720,26082,342638,0.9292633977001519,3,3,84111,3804,80307,0.9547740485786639,21.12351288888889,2899.7180693333335,13.507245860327119,125,2.2E-4
6,test_20231101_134929,10350842.png,212614,6184,206430,0.9709144270838233,1,3,42529,906,41623,0.9786968891814997,19.249219555555555,2368.0866986666665,14.386827624524777,125,2.2E-4
7,test_20231101_134929,10863862.png,317432,12282,305150,0.9613082486957837,2,4,66058,1783,64275,0.9730085682279209,23.971452444444445,3305.626730666667,12.938265491291542,125,2.2E-4
8,test_20231101_134929,11382381.png,312486,907,311579,0.9970974699666545,1,4,46745,121,46624,0.9974114878596642,21.088220444444445,2409.5101546666665,14.311515999312824,125,2.2E-4
9,test_20231101_134929,11079715.png,443815,120387,323428,0.7287450852269527,4,4,124136,16809,107327,0.8645920603209383,16.86984177777778,2095.0260693333335,14.918909294142013,125,2.2E-4
10,test_20231101_134929,11551286.png,271883,877,271006,0.9967743477893064,1,3,40092,128,39964,0.9968073431108451,17.018796444444444,1715.096528,15.787917931083486,125,2.2E-4
1,test_20231101_134930,10404007.png,502730,21859,480871,0.9565194040538659,2,4,61265,3161,58104,0.9484044723741125,25.648606222222224,3418.377488,12.792603411306079,125,2.3E-4
2,test_20231101_134930,1254659.png,342646,74757,267889,0.7818243901869568,2,3,80080,10445,69635,0.869567932067932,20.832983111111112,3162.755813333333,13.130146982015201,125,2.3E-4
3,test_20231101_134930,10188041.png,221231,9952,211279,0.9550153459506127,2,4,41731,1403,40328,0.9663799094198557,10.516405333333333,1008.327776,18.094786301784424,125,2.3E-4
4,test_20231101_134930,10287332.png,216980,12584,204396,0.942003871324546,1,4,22337,1727,20610,0.9226843354076196,9.448579555555556,778.9383466666667,19.21577276445775,125,2.3E-4
5,test_20231101_134930,11610969.png,368720,26082,342638,0.9292633977001519,2,10,84111,3804,80307,0.9547740485786639,21.12351288888889,2899.7180693333335,13.507245860327119,125,2.3E-4
6,test_20231101_134930,10350842.png,212614,6184,206430,0.9709144270838233,2,3,42529,906,41623,0.9786968891814997,19.249219555555555,2368.0866986666665,14.386827624524777,125,2.3E-4
7,test_20231101_134930,10863862.png,317432,12282,305150,0.9613082486957837,1,3,66058,1783,64275,0.9730085682279209,23.971452444444445,3305.626730666667,12.938265491291542,125,2.3E-4
8,test_20231101_134930,11382381.png,312486,907,311579,0.9970974699666545,1,4,46745,121,46624,0.9974114878596642,21.088220444444445,2409.5101546666665,14.311515999312824,125,2.3E-4
9,test_20231101_134930,11079715.png,443815,120387,323428,0.7287450852269527,3,5,124136,16809,107327,0.8645920603209383,16.86984177777778,2095.0260693333335,14.918909294142013,125,2.3E-4
10,test_20231101_134930,11551286.png,271883,877,271006,0.9967743477893064,1,4,40092,128,39964,0.9968073431108451,17.018796444444444,1715.096528,15.787917931083486,125,2.3E-4
1,test_20231101_134930,10404007.png,502730,21859,480871,0.9565194040538659,2,4,61265,3161,58104,0.9484044723741125,25.648606222222224,3418.377488,12.792603411306079,125,2.4E-4
2,test_20231101_134930,1254659.png,342646,74757,267889,0.7818243901869568,3,3,80080,10445,69635,0.869567932067932,20.832983111111112,3162.755813333333,13.130146982015201,125,2.4E-4
3,test_20231101_134930,10188041.png,221231,9952,211279,0.9550153459506127,2,3,41731,1403,40328,0.9663799094198557,10.516405333333333,1008.327776,18.094786301784424,125,2.4E-4
4,test_20231101_134930,10287332.png,216980,12584,204396,0.942003871324546,1,3,22337,1727,20610,0.9226843354076196,9.448579555555556,778.9383466666667,19.21577276445775,125,2.4E-4
5,test_20231101_134930,11610969.png,368720,26082,342638,0.9292633977001519,2,4,84111,3804,80307,0.9547740485786639,21.12351288888889,2899.7180693333335,13.507245860327119,125,2.4E-4
6,test_20231101_134930,10350842.png,212614,6184,206430,0.9709144270838233,2,3,42529,906,41623,0.9786968891814997,19.249219555555555,2368.0866986666665,14.386827624524777,125,2.4E-4
7,test_20231101_134930,10863862.png,317432,12282,305150,0.9613082486957837,2,4,66058,1783,64275,0.9730085682279209,23.971452444444445,3305.626730666667,12.938265491291542,125,2.4E-4
8,test_20231101_134930,11382381.png,312486,907,311579,0.9970974699666545,2,4,46745,121,46624,0.9974114878596642,21.088220444444445,2409.5101546666665,14.311515999312824,125,2.4E-4
9,test_20231101_134930,11079715.png,443815,120387,323428,0.7287450852269527,3,4,124136,16809,107327,0.8645920603209383,16.86984177777778,2095.0260693333335,14.918909294142013,125,2.4E-4
10,test_20231101_134930,11551286.png,271883,877,271006,0.9967743477893064,2,4,40092,128,39964,0.9968073431108451,17.018796444444444,1715.096528,15.787917931083486,125,2.4E-4
1,test_20231101_134931,10404007.png,502730,21859,480871,0.9565194040538659,2,4,61265,3161,58104,0.9484044723741125,25.648606222222224,3418.377488,12.792603411306079,125,2.5E-4
2,test_20231101_134931,1254659.png,342646,74757,267889,0.7818243901869568,3,4,80080,10445,69635,0.869567932067932,20.832983111111112,3162.755813333333,13.130146982015201,125,2.5E-4
3,test_20231101_134931,10188041.png,221231,9952,211279,0.9550153459506127,2,3,41731,1403,40328,0.9663799094198557,10.516405333333333,1008.327776,18.094786301784424,125,2.5E-4
4,test_20231101_134931,10287332.png,216980,12584,204396,0.942003871324546,1,3,22337,1727,20610,0.9226843354076196,9.448579555555556,778.9383466666667,19.21577276445775,125,2.5E-4
5,test_20231101_134931,11610969.png,368720,26082,342638,0.9292633977001519,2,4,84111,3804,80307,0.9547740485786639,21.12351288888889,2899.7180693333335,13.507245860327119,125,2.5E-4
6,test_20231101_134931,10350842.png,212614,6184,206430,0.9709144270838233,2,4,42529,906,41623,0.9786968891814997,19.249219555555555,2368.0866986666665,14.386827624524777,125,2.5E-4
7,test_20231101_134931,10863862.png,317432,12282,305150,0.9613082486957837,2,4,66058,1783,64275,0.9730085682279209,23.971452444444445,3305.626730666667,12.938265491291542,125,2.5E-4
8,test_20231101_134931,11382381.png,312486,907,311579,0.9970974699666545,1,4,46745,121,46624,0.9974114878596642,21.088220444444445,2409.5101546666665,14.311515999312824,125,2.5E-4
9,test_20231101_134931,11079715.png,443815,120387,323428,0.7287450852269527,3,4,124136,16809,107327,0.8645920603209383,16.86984177777778,2095.0260693333335,14.918909294142013,125,2.5E-4
10,test_20231101_134931,11551286.png,271883,877,271006,0.9967743477893064,2,3,40092,128,39964,0.9968073431108451,17.018796444444444,1715.096528,15.787917931083486,125,2.5E-4
1,test_20231101_134932,10404007.png,502730,21619,481111,0.956996797485728,2,4,61265,3126,58139,0.9489757610381131,25.66681422222222,3421.940368,12.788079237733479,125,2.6000000000000003E-4
2,test_20231101_134932,1254659.png,342646,74697,267949,0.7819994980241999,3,4,80080,10439,69641,0.8696428571428572,20.84253688888889,3163.838,13.12866122928261,125,2.6000000000000003E-4
3,test_20231101_134932,10188041.png,221231,9852,211379,0.9554673621689547,2,4,41731,1388,40343,0.9667393544367496,10.639758222222222,1024.043168,18.02762096387238,125,2.6000000000000003E-4
4,test_20231101_134932,10287332.png,216980,12584,204396,0.942003871324546,2,4,22337,1727,20610,0.9226843354076196,9.448579555555556,778.9383466666667,19.21577276445775,125,2.6000000000000003E-4
5,test_20231101_134932,11610969.png,368720,25759,342961,0.9301394011716207,2,4,84111,3758,80353,0.9553209449418031,21.541429333333333,2985.787157333333,13.380215151782494,125,2.6000000000000003E-4
6,test_20231101_134932,10350842.png,212614,6102,206512,0.9713001025332292,2,3,42529,894,41635,0.9789790495896917,19.318012444444445,2373.8444053333333,14.37628111337661,125,2.6000000000000003E-4
7,test_20231101_134932,10863862.png,317432,12162,305270,0.9616862824163915,2,3,66058,1765,64293,0.9732810560416604,24.022609777777777,3308.937994666667,12.933917317637896,125,2.6000000000000003E-4
8,test_20231101_134932,11382381.png,312486,767,311719,0.9975454900379537,1,3,46745,100,46645,0.9978607337683175,21.58402311111111,2479.723024,14.186771864393144,125,2.6000000000000003E-4
9,test_20231101_134932,11079715.png,443815,120387,323428,0.7287450852269527,4,5,124136,16809,107327,0.8645920603209383,16.86984177777778,2095.0260693333335,14.918909294142013,125,2.6000000000000003E-4
10,test_20231101_134932,11551286.png,271883,757,271126,0.9972157141123204,2,4,40092,110,39982,0.9972563104858825,17.568885333333334,1810.9495893333333,15.55173999664329,125,2.6000000000000003E-4
1,test_20231101_134932,10404007.png,502730,21619,481111,0.956996797485728,3,4,61265,3126,58139,0.9489757610381131,25.66681422222222,3421.940368,12.788079237733479,125,2.7000000000000006E-4
2,test_20231101_134932,1254659.png,342646,74697,267949,0.7819994980241999,2,4,80080,10439,69641,0.8696428571428572,20.84253688888889,3163.838,13.12866122928261,125,2.7000000000000006E-4
3,test_20231101_134932,10188041.png,221231,9852,211379,0.9554673621689547,2,3,41731,1388,40343,0.9667393544367496,10.639758222222222,1024.043168,18.02762096387238,125,2.7000000000000006E-4
4,test_20231101_134932,10287332.png,216980,12584,204396,0.942003871324546,2,4,22337,1727,20610,0.9226843354076196,9.448579555555556,778.9383466666667,19.21577276445775,125,2.7000000000000006E-4
5,test_20231101_134932,11610969.png,368720,25759,342961,0.9301394011716207,2,4,84111,3758,80353,0.9553209449418031,21.541429333333333,2985.787157333333,13.380215151782494,125,2.7000000000000006E-4
6,test_20231101_134932,10350842.png,212614,6102,206512,0.9713001025332292,2,3,42529,894,41635,0.9789790495896917,19.318012444444445,2373.8444053333333,14.37628111337661,125,2.7000000000000006E-4
7,test_20231101_134932,10863862.png,317432,12162,305270,0.9616862824163915,2,3,66058,1765,64293,0.9732810560416604,24.022609777777777,3308.937994666667,12.933917317637896,125,2.7000000000000006E-4
8,test_20231101_134932,11382381.png,312486,767,311719,0.9975454900379537,1,3,46745,100,46645,0.9978607337683175,21.58402311111111,2479.723024,14.186771864393144,125,2.7000000000000006E-4
9,test_20231101_134932,11079715.png,443815,120387,323428,0.7287450852269527,4,4,124136,16809,107327,0.8645920603209383,16.86984177777778,2095.0260693333335,14.918909294142013,125,2.7000000000000006E-4
10,test_20231101_134932,11551286.png,271883,757,271126,0.9972157141123204,2,3,40092,110,39982,0.9972563104858825,17.568885333333334,1810.9495893333333,15.55173999664329,125,2.7000000000000006E-4
1,test_20231101_134933,10404007.png,502730,21619,481111,0.956996797485728,2,4,61265,3126,58139,0.9489757610381131,25.66681422222222,3421.940368,12.788079237733479,125,2.800000000000001E-4
2,test_20231101_134933,1254659.png,342646,74697,267949,0.7819994980241999,2,13,80080,10439,69641,0.8696428571428572,20.84253688888889,3163.838,13.12866122928261,125,2.800000000000001E-4
3,test_20231101_134933,10188041.png,221231,9852,211379,0.9554673621689547,2,4,41731,1388,40343,0.9667393544367496,10.639758222222222,1024.043168,18.02762096387238,125,2.800000000000001E-4
4,test_20231101_134933,10287332.png,216980,12584,204396,0.942003871324546,2,4,22337,1727,20610,0.9226843354076196,9.448579555555556,778.9383466666667,19.21577276445775,125,2.800000000000001E-4
5,test_20231101_134933,11610969.png,368720,25759,342961,0.9301394011716207,3,4,84111,3758,80353,0.9553209449418031,21.541429333333333,2985.787157333333,13.380215151782494,125,2.800000000000001E-4
6,test_20231101_134933,10350842.png,212614,6102,206512,0.9713001025332292,1,4,42529,894,41635,0.9789790495896917,19.318012444444445,2373.8444053333333,14.37628111337661,125,2.800000000000001E-4
7,test_20231101_134933,10863862.png,317432,12162,305270,0.9616862824163915,2,9,66058,1765,64293,0.9732810560416604,24.022609777777777,3308.937994666667,12.933917317637896,125,2.800000000000001E-4
8,test_20231101_134933,11382381.png,312486,767,311719,0.9975454900379537,2,4,46745,100,46645,0.9978607337683175,21.58402311111111,2479.723024,14.186771864393144,125,2.800000000000001E-4
9,test_20231101_134933,11079715.png,443815,120387,323428,0.7287450852269527,4,4,124136,16809,107327,0.8645920603209383,16.86984177777778,2095.0260693333335,14.918909294142013,125,2.800000000000001E-4
10,test_20231101_134933,11551286.png,271883,757,271126,0.9972157141123204,2,4,40092,110,39982,0.9972563104858825,17.568885333333334,1810.9495893333333,15.55173999664329,125,2.800000000000001E-4
1,test_20231101_134934,10404007.png,502730,21619,481111,0.956996797485728,2,3,61265,3126,58139,0.9489757610381131,25.66681422222222,3421.940368,12.788079237733479,125,2.900000000000001E-4
2,test_20231101_134934,1254659.png,342646,74697,267949,0.7819994980241999,3,13,80080,10439,69641,0.8696428571428572,20.84253688888889,3163.838,13.12866122928261,125,2.900000000000001E-4
3,test_20231101_134934,10188041.png,221231,9852,211379,0.9554673621689547,2,3,41731,1388,40343,0.9667393544367496,10.639758222222222,1024.043168,18.02762096387238,125,2.900000000000001E-4
4,test_20231101_134934,10287332.png,216980,12584,204396,0.942003871324546,2,4,22337,1727,20610,0.9226843354076196,9.448579555555556,778.9383466666667,19.21577276445775,125,2.900000000000001E-4
5,test_20231101_134934,11610969.png,368720,25759,342961,0.9301394011716207,3,4,84111,3758,80353,0.9553209449418031,21.541429333333333,2985.787157333333,13.380215151782494,125,2.900000000000001E-4
6,test_20231101_134934,10350842.png,212614,6102,206512,0.9713001025332292,2,4,42529,894,41635,0.9789790495896917,19.318012444444445,2373.8444053333333,14.37628111337661,125,2.900000000000001E-4
7,test_20231101_134934,10863862.png,317432,12162,305270,0.9616862824163915,3,4,66058,1765,64293,0.9732810560416604,24.022609777777777,3308.937994666667,12.933917317637896,125,2.900000000000001E-4
8,test_20231101_134934,11382381.png,312486,767,311719,0.9975454900379537,2,4,46745,100,46645,0.9978607337683175,21.58402311111111,2479.723024,14.186771864393144,125,2.900000000000001E-4
9,test_20231101_134934,11079715.png,443815,120387,323428,0.7287450852269527,4,4,124136,16809,107327,0.8645920603209383,16.86984177777778,2095.0260693333335,14.918909294142013,125,2.900000000000001E-4
10,test_20231101_134934,11551286.png,271883,447,271436,0.9983559104467731,1,4,40092,64,40028,0.9984036715554225,17.85190933333333,1855.3641226666666,15.446512065144763,125,2.900000000000001E-4
1,test_20231101_134934,10404007.png,502730,21619,481111,0.956996797485728,2,3,61265,3126,58139,0.9489757610381131,25.66681422222222,3421.940368,12.788079237733479,125,3.0000000000000014E-4
2,test_20231101_134934,1254659.png,342646,74697,267949,0.7819994980241999,3,4,80080,10439,69641,0.8696428571428572,20.84253688888889,3163.838,13.12866122928261,125,3.0000000000000014E-4
3,test_20231101_134934,10188041.png,221231,9852,211379,0.9554673621689547,2,4,41731,1388,40343,0.9667393544367496,10.639758222222222,1024.043168,18.02762096387238,125,3.0000000000000014E-4
4,test_20231101_134934,10287332.png,216980,12584,204396,0.942003871324546,2,3,22337,1727,20610,0.9226843354076196,9.448579555555556,778.9383466666667,19.21577276445775,125,3.0000000000000014E-4
5,test_20231101_134934,11610969.png,368720,25759,342961,0.9301394011716207,3,4,84111,3758,80353,0.9553209449418031,21.541429333333333,2985.787157333333,13.380215151782494,125,3.0000000000000014E-4
6,test_20231101_134934,10350842.png,212614,6102,206512,0.9713001025332292,1,4,42529,894,41635,0.9789790495896917,19.318012444444445,2373.8444053333333,14.37628111337661,125,3.0000000000000014E-4
7,test_20231101_134934,10863862.png,317432,12162,305270,0.9616862824163915,2,4,66058,1765,64293,0.9732810560416604,24.022609777777777,3308.937994666667,12.933917317637896,125,3.0000000000000014E-4
8,test_20231101_134934,11382381.png,312486,767,311719,0.9975454900379537,2,3,46745,100,46645,0.9978607337683175,21.58402311111111,2479.723024,14.186771864393144,125,3.0000000000000014E-4
9,test_20231101_134934,11079715.png,443815,120387,323428,0.7287450852269527,3,5,124136,16809,107327,0.8645920603209383,16.86984177777778,2095.0260693333335,14.918909294142013,125,3.0000000000000014E-4
10,test_20231101_134934,11551286.png,271883,447,271436,0.9983559104467731,2,4,40092,64,40028,0.9984036715554225,17.85190933333333,1855.3641226666666,15.446512065144763,125,3.0000000000000014E-4
1,test_20231101_134935,10404007.png,502730,21619,481111,0.956996797485728,2,3,61265,3126,58139,0.9489757610381131,25.66681422222222,3421.940368,12.788079237733479,125,3.1000000000000016E-4
2,test_20231101_134935,1254659.png,342646,74697,267949,0.7819994980241999,4,4,80080,10439,69641,0.8696428571428572,20.84253688888889,3163.838,13.12866122928261,125,3.1000000000000016E-4
3,test_20231101_134935,10188041.png,221231,9852,211379,0.9554673621689547,2,4,41731,1388,40343,0.9667393544367496,10.639758222222222,1024.043168,18.02762096387238,125,3.1000000000000016E-4
4,test_20231101_134935,10287332.png,216980,12584,204396,0.942003871324546,2,4,22337,1727,20610,0.9226843354076196,9.448579555555556,778.9383466666667,19.21577276445775,125,3.1000000000000016E-4
5,test_20231101_134935,11610969.png,368720,25759,342961,0.9301394011716207,3,3,84111,3758,80353,0.9553209449418031,21.541429333333333,2985.787157333333,13.380215151782494,125,3.1000000000000016E-4
6,test_20231101_134935,10350842.png,212614,6102,206512,0.9713001025332292,2,3,42529,894,41635,0.9789790495896917,19.318012444444445,2373.8444053333333,14.37628111337661,125,3.1000000000000016E-4
7,test_20231101_134935,10863862.png,317432,12162,305270,0.9616862824163915,2,4,66058,1765,64293,0.9732810560416604,24.022609777777777,3308.937994666667,12.933917317637896,125,3.1000000000000016E-4
8,test_20231101_134935,11382381.png,312486,767,311719,0.9975454900379537,1,4,46745,100,46645,0.9978607337683175,21.58402311111111,2479.723024,14.186771864393144,125,3.1000000000000016E-4
9,test_20231101_134935,11079715.png,443815,120387,323428,0.7287450852269527,3,5,124136,16809,107327,0.8645920603209383,16.86984177777778,2095.0260693333335,14.918909294142013,125,3.1000000000000016E-4
10,test_20231101_134935,11551286.png,271883,447,271436,0.9983559104467731,1,3,40092,64,40028,0.9984036715554225,17.85190933333333,1855.3641226666666,15.446512065144763,125,3.1000000000000016E-4
1,test_20231101_134936,10404007.png,502730,21619,481111,0.956996797485728,4,3,61265,3126,58139,0.9489757610381131,25.66681422222222,3421.940368,12.788079237733479,125,3.200000000000002E-4
2,test_20231101_134936,1254659.png,342646,74697,267949,0.7819994980241999,3,4,80080,10439,69641,0.8696428571428572,20.84253688888889,3163.838,13.12866122928261,125,3.200000000000002E-4
3,test_20231101_134936,10188041.png,221231,9852,211379,0.9554673621689547,2,4,41731,1388,40343,0.9667393544367496,10.639758222222222,1024.043168,18.02762096387238,125,3.200000000000002E-4
4,test_20231101_134936,10287332.png,216980,12584,204396,0.942003871324546,2,4,22337,1727,20610,0.9226843354076196,9.448579555555556,778.9383466666667,19.21577276445775,125,3.200000000000002E-4
5,test_20231101_134936,11610969.png,368720,25759,342961,0.9301394011716207,2,7,84111,3758,80353,0.9553209449418031,21.541429333333333,2985.787157333333,13.380215151782494,125,3.200000000000002E-4
6,test_20231101_134936,10350842.png,212614,6102,206512,0.9713001025332292,2,4,42529,894,41635,0.9789790495896917,19.318012444444445,2373.8444053333333,14.37628111337661,125,3.200000000000002E-4
7,test_20231101_134936,10863862.png,317432,12162,305270,0.9616862824163915,2,4,66058,1765,64293,0.9732810560416604,24.022609777777777,3308.937994666667,12.933917317637896,125,3.200000000000002E-4
8,test_20231101_134936,11382381.png,312486,767,311719,0.9975454900379537,2,3,46745,100,46645,0.9978607337683175,21.58402311111111,2479.723024,14.186771864393144,125,3.200000000000002E-4
9,test_20231101_134936,11079715.png,443815,120387,323428,0.7287450852269527,4,4,124136,16809,107327,0.8645920603209383,16.86984177777778,2095.0260693333335,14.918909294142013,125,3.200000000000002E-4
10,test_20231101_134936,11551286.png,271883,447,271436,0.9983559104467731,2,3,40092,64,40028,0.9984036715554225,17.85190933333333,1855.3641226666666,15.446512065144763,125,3.200000000000002E-4
1,test_20231101_134937,10404007.png,502730,21619,481111,0.956996797485728,3,3,61265,3126,58139,0.9489757610381131,25.66681422222222,3421.940368,12.788079237733479,125,3.300000000000002E-4
2,test_20231101_134937,1254659.png,342646,74697,267949,0.7819994980241999,2,4,80080,10439,69641,0.8696428571428572,20.84253688888889,3163.838,13.12866122928261,125,3.300000000000002E-4
3,test_20231101_134937,10188041.png,221231,9852,211379,0.9554673621689547,2,4,41731,1388,40343,0.9667393544367496,10.639758222222222,1024.043168,18.02762096387238,125,3.300000000000002E-4
4,test_20231101_134937,10287332.png,216980,12584,204396,0.942003871324546,1,3,22337,1727,20610,0.9226843354076196,9.448579555555556,778.9383466666667,19.21577276445775,125,3.300000000000002E-4
5,test_20231101_134937,11610969.png,368720,25759,342961,0.9301394011716207,2,4,84111,3758,80353,0.9553209449418031,21.541429333333333,2985.787157333333,13.380215151782494,125,3.300000000000002E-4
6,test_20231101_134937,10350842.png,212614,6102,206512,0.9713001025332292,1,4,42529,894,41635,0.9789790495896917,19.318012444444445,2373.8444053333333,14.37628111337661,125,3.300000000000002E-4
7,test_20231101_134937,10863862.png,317432,12162,305270,0.9616862824163915,2,3,66058,1765,64293,0.9732810560416604,24.022609777777777,3308.937994666667,12.933917317637896,125,3.300000000000002E-4
8,test_20231101_134937,11382381.png,312486,767,311719,0.9975454900379537,2,3,46745,100,46645,0.9978607337683175,21.58402311111111,2479.723024,14.186771864393144,125,3.300000000000002E-4
9,test_20231101_134937,11079715.png,443815,120387,323428,0.7287450852269527,4,8,124136,16809,107327,0.8645920603209383,16.86984177777778,2095.0260693333335,14.918909294142013,125,3.300000000000002E-4
10,test_20231101_134937,11551286.png,271883,447,271436,0.9983559104467731,2,3,40092,64,40028,0.9984036715554225,17.85190933333333,1855.3641226666666,15.446512065144763,125,3.300000000000002E-4
1,test_20231101_134937,10404007.png,502730,21619,481111,0.956996797485728,3,4,61265,3126,58139,0.9489757610381131,25.66681422222222,3421.940368,12.788079237733479,125,3.4000000000000024E-4
2,test_20231101_134937,1254659.png,342646,74697,267949,0.7819994980241999,3,4,80080,10439,69641,0.8696428571428572,20.84253688888889,3163.838,13.12866122928261,125,3.4000000000000024E-4
3,test_20231101_134937,10188041.png,221231,9852,211379,0.9554673621689547,2,4,41731,1388,40343,0.9667393544367496,10.639758222222222,1024.043168,18.02762096387238,125,3.4000000000000024E-4
4,test_20231101_134937,10287332.png,216980,12584,204396,0.942003871324546,1,4,22337,1727,20610,0.9226843354076196,9.448579555555556,778.9383466666667,19.21577276445775,125,3.4000000000000024E-4
5,test_20231101_134937,11610969.png,368720,25759,342961,0.9301394011716207,2,4,84111,3758,80353,0.9553209449418031,21.541429333333333,2985.787157333333,13.380215151782494,125,3.4000000000000024E-4
6,test_20231101_134937,10350842.png,212614,6102,206512,0.9713001025332292,2,3,42529,894,41635,0.9789790495896917,19.318012444444445,2373.8444053333333,14.37628111337661,125,3.4000000000000024E-4
7,test_20231101_134937,10863862.png,317432,12162,305270,0.9616862824163915,2,4,66058,1765,64293,0.9732810560416604,24.022609777777777,3308.937994666667,12.933917317637896,125,3.4000000000000024E-4
8,test_20231101_134937,11382381.png,312486,767,311719,0.9975454900379537,1,6,46745,100,46645,0.9978607337683175,21.58402311111111,2479.723024,14.186771864393144,125,3.4000000000000024E-4
9,test_20231101_134937,11079715.png,443815,120387,323428,0.7287450852269527,4,4,124136,16809,107327,0.8645920603209383,16.86984177777778,2095.0260693333335,14.918909294142013,125,3.4000000000000024E-4
10,test_20231101_134937,11551286.png,271883,447,271436,0.9983559104467731,1,4,40092,64,40028,0.9984036715554225,17.85190933333333,1855.3641226666666,15.446512065144763,125,3.4000000000000024E-4
1,test_20231101_134938,10404007.png,502730,21619,481111,0.956996797485728,2,4,61265,3126,58139,0.9489757610381131,25.66681422222222,3421.940368,12.788079237733479,125,3.5000000000000027E-4
2,test_20231101_134938,1254659.png,342646,74697,267949,0.7819994980241999,3,4,80080,10439,69641,0.8696428571428572,20.84253688888889,3163.838,13.12866122928261,125,3.5000000000000027E-4
3,test_20231101_134938,10188041.png,221231,9852,211379,0.9554673621689547,2,3,41731,1388,40343,0.9667393544367496,10.639758222222222,1024.043168,18.02762096387238,125,3.5000000000000027E-4
4,test_20231101_134938,10287332.png,216980,12584,204396,0.942003871324546,2,4,22337,1727,20610,0.9226843354076196,9.448579555555556,778.9383466666667,19.21577276445775,125,3.5000000000000027E-4
5,test_20231101_134938,11610969.png,368720,25759,342961,0.9301394011716207,3,3,84111,3758,80353,0.9553209449418031,21.541429333333333,2985.787157333333,13.380215151782494,125,3.5000000000000027E-4
6,test_20231101_134938,10350842.png,212614,6102,206512,0.9713001025332292,1,4,42529,894,41635,0.9789790495896917,19.318012444444445,2373.8444053333333,14.37628111337661,125,3.5000000000000027E-4
7,test_20231101_134938,10863862.png,317432,12162,305270,0.9616862824163915,2,4,66058,1765,64293,0.9732810560416604,24.022609777777777,3308.937994666667,12.933917317637896,125,3.5000000000000027E-4
8,test_20231101_134938,11382381.png,312486,767,311719,0.9975454900379537,2,4,46745,100,46645,0.9978607337683175,21.58402311111111,2479.723024,14.186771864393144,125,3.5000000000000027E-4
9,test_20231101_134938,11079715.png,443815,120387,323428,0.7287450852269527,3,5,124136,16809,107327,0.8645920603209383,16.86984177777778,2095.0260693333335,14.918909294142013,125,3.5000000000000027E-4
10,test_20231101_134938,11551286.png,271883,447,271436,0.9983559104467731,2,3,40092,64,40028,0.9984036715554225,17.85190933333333,1855.3641226666666,15.446512065144763,125,3.5000000000000027E-4
1,test_20231101_134939,10404007.png,502730,21619,481111,0.956996797485728,2,3,61265,3126,58139,0.9489757610381131,25.66681422222222,3421.940368,12.788079237733479,125,3.600000000000003E-4
2,test_20231101_134939,1254659.png,342646,74697,267949,0.7819994980241999,3,4,80080,10439,69641,0.8696428571428572,20.84253688888889,3163.838,13.12866122928261,125,3.600000000000003E-4
3,test_20231101_134939,10188041.png,221231,9852,211379,0.9554673621689547,2,4,41731,1388,40343,0.9667393544367496,10.639758222222222,1024.043168,18.02762096387238,125,3.600000000000003E-4
4,test_20231101_134939,10287332.png,216980,12584,204396,0.942003871324546,1,3,22337,1727,20610,0.9226843354076196,9.448579555555556,778.9383466666667,19.21577276445775,125,3.600000000000003E-4
5,test_20231101_134939,11610969.png,368720,25759,342961,0.9301394011716207,2,4,84111,3758,80353,0.9553209449418031,21.541429333333333,2985.787157333333,13.380215151782494,125,3.600000000000003E-4
6,test_20231101_134939,10350842.png,212614,6102,206512,0.9713001025332292,1,3,42529,894,41635,0.9789790495896917,19.318012444444445,2373.8444053333333,14.37628111337661,125,3.600000000000003E-4
7,test_20231101_134939,10863862.png,317432,12162,305270,0.9616862824163915,1,3,66058,1765,64293,0.9732810560416604,24.022609777777777,3308.937994666667,12.933917317637896,125,3.600000000000003E-4
8,test_20231101_134939,11382381.png,312486,767,311719,0.9975454900379537,1,3,46745,100,46645,0.9978607337683175,21.58402311111111,2479.723024,14.186771864393144,125,3.600000000000003E-4
9,test_20231101_134939,11079715.png,443815,120387,323428,0.7287450852269527,3,5,124136,16809,107327,0.8645920603209383,16.86984177777778,2095.0260693333335,14.918909294142013,125,3.600000000000003E-4
10,test_20231101_134939,11551286.png,271883,447,271436,0.9983559104467731,1,3,40092,64,40028,0.9984036715554225,17.85190933333333,1855.3641226666666,15.446512065144763,125,3.600000000000003E-4
1,test_20231101_134939,10404007.png,502730,21619,481111,0.956996797485728,2,4,61265,3126,58139,0.9489757610381131,25.66681422222222,3421.940368,12.788079237733479,125,3.700000000000003E-4
2,test_20231101_134939,1254659.png,342646,74697,267949,0.7819994980241999,2,4,80080,10439,69641,0.8696428571428572,20.84253688888889,3163.838,13.12866122928261,125,3.700000000000003E-4
3,test_20231101_134939,10188041.png,221231,9852,211379,0.9554673621689547,2,3,41731,1388,40343,0.9667393544367496,10.639758222222222,1024.043168,18.02762096387238,125,3.700000000000003E-4
4,test_20231101_134939,10287332.png,216980,12584,204396,0.942003871324546,2,4,22337,1727,20610,0.9226843354076196,9.448579555555556,778.9383466666667,19.21577276445775,125,3.700000000000003E-4
5,test_20231101_134939,11610969.png,368720,25759,342961,0.9301394011716207,3,4,84111,3758,80353,0.9553209449418031,21.541429333333333,2985.787157333333,13.380215151782494,125,3.700000000000003E-4
6,test_20231101_134939,10350842.png,212614,6102,206512,0.9713001025332292,2,4,42529,894,41635,0.9789790495896917,19.318012444444445,2373.8444053333333,14.37628111337661,125,3.700000000000003E-4
7,test_20231101_134939,10863862.png,317432,12162,305270,0.9616862824163915,3,4,66058,1765,64293,0.9732810560416604,24.022609777777777,3308.937994666667,12.933917317637896,125,3.700000000000003E-4
8,test_20231101_134939,11382381.png,312486,767,311719,0.9975454900379537,2,4,46745,100,46645,0.9978607337683175,21.58402311111111,2479.723024,14.186771864393144,125,3.700000000000003E-4
9,test_20231101_134939,11079715.png,443815,120387,323428,0.7287450852269527,3,4,124136,16809,107327,0.8645920603209383,16.86984177777778,2095.0260693333335,14.918909294142013,125,3.700000000000003E-4
10,test_20231101_134939,11551286.png,271883,447,271436,0.9983559104467731,1,4,40092,64,40028,0.9984036715554225,17.85190933333333,1855.3641226666666,15.446512065144763,125,3.700000000000003E-4
1,test_20231101_134940,10404007.png,502730,21619,481111,0.956996797485728,2,3,61265,3126,58139,0.9489757610381131,25.66681422222222,3421.940368,12.788079237733479,125,3.8000000000000035E-4
2,test_20231101_134940,1254659.png,342646,74697,267949,0.7819994980241999,3,4,80080,10439,69641,0.8696428571428572,20.84253688888889,3163.838,13.12866122928261,125,3.8000000000000035E-4
3,test_20231101_134940,10188041.png,221231,9852,211379,0.9554673621689547,2,4,41731,1388,40343,0.9667393544367496,10.639758222222222,1024.043168,18.02762096387238,125,3.8000000000000035E-4
4,test_20231101_134940,10287332.png,216980,12584,204396,0.942003871324546,2,4,22337,1727,20610,0.9226843354076196,9.448579555555556,778.9383466666667,19.21577276445775,125,3.8000000000000035E-4
5,test_20231101_134940,11610969.png,368720,25759,342961,0.9301394011716207,3,3,84111,3758,80353,0.9553209449418031,21.541429333333333,2985.787157333333,13.380215151782494,125,3.8000000000000035E-4
6,test_20231101_134940,10350842.png,212614,6102,206512,0.9713001025332292,2,3,42529,894,41635,0.9789790495896917,19.318012444444445,2373.8444053333333,14.37628111337661,125,3.8000000000000035E-4
7,test_20231101_134940,10863862.png,317432,12162,305270,0.9616862824163915,2,4,66058,1765,64293,0.9732810560416604,24.022609777777777,3308.937994666667,12.933917317637896,125,3.8000000000000035E-4
8,test_20231101_134940,11382381.png,312486,767,311719,0.9975454900379537,2,3,46745,100,46645,0.9978607337683175,21.58402311111111,2479.723024,14.186771864393144,125,3.8000000000000035E-4
9,test_20231101_134940,11079715.png,443815,120387,323428,0.7287450852269527,6,4,124136,16809,107327,0.8645920603209383,16.86984177777778,2095.0260693333335,14.918909294142013,125,3.8000000000000035E-4
10,test_20231101_134940,11551286.png,271883,447,271436,0.9983559104467731,1,4,40092,64,40028,0.9984036715554225,17.85190933333333,1855.3641226666666,15.446512065144763,125,3.8000000000000035E-4
1,test_20231101_134941,10404007.png,502730,21297,481433,0.9576373003401428,3,4,61265,3080,58185,0.9497265975679425,25.756858666666666,3441.934906666667,12.76277708107859,125,3.9000000000000037E-4
2,test_20231101_134941,1254659.png,342646,74697,267949,0.7819994980241999,4,4,80080,10439,69641,0.8696428571428572,20.84253688888889,3163.838,13.12866122928261,125,3.9000000000000037E-4
3,test_20231101_134941,10188041.png,221231,9852,211379,0.9554673621689547,2,4,41731,1388,40343,0.9667393544367496,10.639758222222222,1024.043168,18.02762096387238,125,3.9000000000000037E-4
4,test_20231101_134941,10287332.png,216980,12584,204396,0.942003871324546,2,4,22337,1727,20610,0.9226843354076196,9.448579555555556,778.9383466666667,19.21577276445775,125,3.9000000000000037E-4
5,test_20231101_134941,11610969.png,368720,25759,342961,0.9301394011716207,2,4,84111,3758,80353,0.9553209449418031,21.541429333333333,2985.787157333333,13.380215151782494,125,3.9000000000000037E-4
6,test_20231101_134941,10350842.png,212614,6102,206512,0.9713001025332292,1,3,42529,894,41635,0.9789790495896917,19.318012444444445,2373.8444053333333,14.37628111337661,125,3.9000000000000037E-4
7,test_20231101_134941,10863862.png,317432,12162,305270,0.9616862824163915,2,4,66058,1765,64293,0.9732810560416604,24.022609777777777,3308.937994666667,12.933917317637896,125,3.9000000000000037E-4
8,test_20231101_134941,11382381.png,312486,767,311719,0.9975454900379537,2,4,46745,100,46645,0.9978607337683175,21.58402311111111,2479.723024,14.186771864393144,125,3.9000000000000037E-4
9,test_20231101_134941,11079715.png,443815,120387,323428,0.7287450852269527,4,4,124136,16809,107327,0.8645920603209383,16.86984177777778,2095.0260693333335,14.918909294142013,125,3.9000000000000037E-4
10,test_20231101_134941,11551286.png,271883,447,271436,0.9983559104467731,1,3,40092,64,40028,0.9984036715554225,17.85190933333333,1855.3641226666666,15.446512065144763,125,3.9000000000000037E-4
1,test_20231101_134941,10404007.png,502730,21297,481433,0.9576373003401428,2,4,61265,3080,58185,0.9497265975679425,25.756858666666666,3441.934906666667,12.76277708107859,125,4.000000000000004E-4
2,test_20231101_134941,1254659.png,342646,74697,267949,0.7819994980241999,2,4,80080,10439,69641,0.8696428571428572,20.84253688888889,3163.838,13.12866122928261,125,4.000000000000004E-4
3,test_20231101_134941,10188041.png,221231,9852,211379,0.9554673621689547,2,4,41731,1388,40343,0.9667393544367496,10.639758222222222,1024.043168,18.02762096387238,125,4.000000000000004E-4
4,test_20231101_134941,10287332.png,216980,12584,204396,0.942003871324546,1,4,22337,1727,20610,0.9226843354076196,9.448579555555556,778.9383466666667,19.21577276445775,125,4.000000000000004E-4
5,test_20231101_134941,11610969.png,368720,25759,342961,0.9301394011716207,2,4,84111,3758,80353,0.9553209449418031,21.541429333333333,2985.787157333333,13.380215151782494,125,4.000000000000004E-4
6,test_20231101_134941,10350842.png,212614,6102,206512,0.9713001025332292,1,4,42529,894,41635,0.9789790495896917,19.318012444444445,2373.8444053333333,14.37628111337661,125,4.000000000000004E-4
7,test_20231101_134941,10863862.png,317432,12162,305270,0.9616862824163915,2,3,66058,1765,64293,0.9732810560416604,24.022609777777777,3308.937994666667,12.933917317637896,125,4.000000000000004E-4
8,test_20231101_134941,11382381.png,312486,767,311719,0.9975454900379537,1,3,46745,100,46645,0.9978607337683175,21.58402311111111,2479.723024,14.186771864393144,125,4.000000000000004E-4
9,test_20231101_134941,11079715.png,443815,120387,323428,0.7287450852269527,3,4,124136,16809,107327,0.8645920603209383,16.86984177777778,2095.0260693333335,14.918909294142013,125,4.000000000000004E-4
10,test_20231101_134941,11551286.png,271883,447,271436,0.9983559104467731,1,3,40092,64,40028,0.9984036715554225,17.85190933333333,1855.3641226666666,15.446512065144763,125,4.000000000000004E-4
1,test_20231101_134942,10404007.png,502730,21297,481433,0.9576373003401428,2,3,61265,3080,58185,0.9497265975679425,25.756858666666666,3441.934906666667,12.76277708107859,125,4.100000000000004E-4
2,test_20231101_134942,1254659.png,342646,74697,267949,0.7819994980241999,3,4,80080,10439,69641,0.8696428571428572,20.84253688888889,3163.838,13.12866122928261,125,4.100000000000004E-4
3,test_20231101_134942,10188041.png,221231,9852,211379,0.9554673621689547,2,4,41731,1388,40343,0.9667393544367496,10.639758222222222,1024.043168,18.02762096387238,125,4.100000000000004E-4
4,test_20231101_134942,10287332.png,216980,12584,204396,0.942003871324546,1,4,22337,1727,20610,0.9226843354076196,9.448579555555556,778.9383466666667,19.21577276445775,125,4.100000000000004E-4
5,test_20231101_134942,11610969.png,368720,25759,342961,0.9301394011716207,2,4,84111,3758,80353,0.9553209449418031,21.541429333333333,2985.787157333333,13.380215151782494,125,4.100000000000004E-4
6,test_20231101_134942,10350842.png,212614,6102,206512,0.9713001025332292,1,4,42529,894,41635,0.9789790495896917,19.318012444444445,2373.8444053333333,14.37628111337661,125,4.100000000000004E-4
7,test_20231101_134942,10863862.png,317432,12162,305270,0.9616862824163915,2,3,66058,1765,64293,0.9732810560416604,24.022609777777777,3308.937994666667,12.933917317637896,125,4.100000000000004E-4
8,test_20231101_134942,11382381.png,312486,767,311719,0.9975454900379537,2,3,46745,100,46645,0.9978607337683175,21.58402311111111,2479.723024,14.186771864393144,125,4.100000000000004E-4
9,test_20231101_134942,11079715.png,443815,120387,323428,0.7287450852269527,3,5,124136,16809,107327,0.8645920603209383,16.86984177777778,2095.0260693333335,14.918909294142013,125,4.100000000000004E-4
10,test_20231101_134942,11551286.png,271883,447,271436,0.9983559104467731,1,4,40092,64,40028,0.9984036715554225,17.85190933333333,1855.3641226666666,15.446512065144763,125,4.100000000000004E-4
1,test_20231101_134943,10404007.png,502730,21297,481433,0.9576373003401428,2,4,61265,3080,58185,0.9497265975679425,25.756858666666666,3441.934906666667,12.76277708107859,125,4.2000000000000045E-4
2,test_20231101_134943,1254659.png,342646,74697,267949,0.7819994980241999,3,4,80080,10439,69641,0.8696428571428572,20.84253688888889,3163.838,13.12866122928261,125,4.2000000000000045E-4
3,test_20231101_134943,10188041.png,221231,9852,211379,0.9554673621689547,2,4,41731,1388,40343,0.9667393544367496,10.639758222222222,1024.043168,18.02762096387238,125,4.2000000000000045E-4
4,test_20231101_134943,10287332.png,216980,12584,204396,0.942003871324546,1,3,22337,1727,20610,0.9226843354076196,9.448579555555556,778.9383466666667,19.21577276445775,125,4.2000000000000045E-4
5,test_20231101_134943,11610969.png,368720,25759,342961,0.9301394011716207,3,4,84111,3758,80353,0.9553209449418031,21.541429333333333,2985.787157333333,13.380215151782494,125,4.2000000000000045E-4
6,test_20231101_134943,10350842.png,212614,6102,206512,0.9713001025332292,1,4,42529,894,41635,0.9789790495896917,19.318012444444445,2373.8444053333333,14.37628111337661,125,4.2000000000000045E-4
7,test_20231101_134943,10863862.png,317432,12162,305270,0.9616862824163915,2,3,66058,1765,64293,0.9732810560416604,24.022609777777777,3308.937994666667,12.933917317637896,125,4.2000000000000045E-4
8,test_20231101_134943,11382381.png,312486,767,311719,0.9975454900379537,2,3,46745,100,46645,0.9978607337683175,21.58402311111111,2479.723024,14.186771864393144,125,4.2000000000000045E-4
9,test_20231101_134943,11079715.png,443815,120387,323428,0.7287450852269527,3,4,124136,16809,107327,0.8645920603209383,16.86984177777778,2095.0260693333335,14.918909294142013,125,4.2000000000000045E-4
10,test_20231101_134943,11551286.png,271883,447,271436,0.9983559104467731,1,3,40092,64,40028,0.9984036715554225,17.85190933333333,1855.3641226666666,15.446512065144763,125,4.2000000000000045E-4
1,test_20231101_134943,10404007.png,502730,21297,481433,0.9576373003401428,2,4,61265,3080,58185,0.9497265975679425,25.756858666666666,3441.934906666667,12.76277708107859,125,4.300000000000005E-4
2,test_20231101_134943,1254659.png,342646,74697,267949,0.7819994980241999,3,3,80080,10439,69641,0.8696428571428572,20.84253688888889,3163.838,13.12866122928261,125,4.300000000000005E-4
3,test_20231101_134943,10188041.png,221231,9852,211379,0.9554673621689547,2,3,41731,1388,40343,0.9667393544367496,10.639758222222222,1024.043168,18.02762096387238,125,4.300000000000005E-4
4,test_20231101_134943,10287332.png,216980,12584,204396,0.942003871324546,2,4,22337,1727,20610,0.9226843354076196,9.448579555555556,778.9383466666667,19.21577276445775,125,4.300000000000005E-4
5,test_20231101_134943,11610969.png,368720,25759,342961,0.9301394011716207,3,4,84111,3758,80353,0.9553209449418031,21.541429333333333,2985.787157333333,13.380215151782494,125,4.300000000000005E-4
6,test_20231101_134943,10350842.png,212614,6102,206512,0.9713001025332292,2,4,42529,894,41635,0.9789790495896917,19.318012444444445,2373.8444053333333,14.37628111337661,125,4.300000000000005E-4
7,test_20231101_134943,10863862.png,317432,12162,305270,0.9616862824163915,2,3,66058,1765,64293,0.9732810560416604,24.022609777777777,3308.937994666667,12.933917317637896,125,4.300000000000005E-4
8,test_20231101_134943,11382381.png,312486,767,311719,0.9975454900379537,2,4,46745,100,46645,0.9978607337683175,21.58402311111111,2479.723024,14.186771864393144,125,4.300000000000005E-4
9,test_20231101_134943,11079715.png,443815,120387,323428,0.7287450852269527,3,4,124136,16809,107327,0.8645920603209383,16.86984177777778,2095.0260693333335,14.918909294142013,125,4.300000000000005E-4
10,test_20231101_134943,11551286.png,271883,447,271436,0.9983559104467731,1,4,40092,64,40028,0.9984036715554225,17.85190933333333,1855.3641226666666,15.446512065144763,125,4.300000000000005E-4
1,test_20231101_134944,10404007.png,502730,21297,481433,0.9576373003401428,2,3,61265,3080,58185,0.9497265975679425,25.756858666666666,3441.934906666667,12.76277708107859,125,4.400000000000005E-4
2,test_20231101_134944,1254659.png,342646,74697,267949,0.7819994980241999,3,4,80080,10439,69641,0.8696428571428572,20.84253688888889,3163.838,13.12866122928261,125,4.400000000000005E-4
3,test_20231101_134944,10188041.png,221231,9852,211379,0.9554673621689547,2,4,41731,1388,40343,0.9667393544367496,10.639758222222222,1024.043168,18.02762096387238,125,4.400000000000005E-4
4,test_20231101_134944,10287332.png,216980,12584,204396,0.942003871324546,2,4,22337,1727,20610,0.9226843354076196,9.448579555555556,778.9383466666667,19.21577276445775,125,4.400000000000005E-4
5,test_20231101_134944,11610969.png,368720,25759,342961,0.9301394011716207,2,3,84111,3758,80353,0.9553209449418031,21.541429333333333,2985.787157333333,13.380215151782494,125,4.400000000000005E-4
6,test_20231101_134944,10350842.png,212614,6102,206512,0.9713001025332292,2,4,42529,894,41635,0.9789790495896917,19.318012444444445,2373.8444053333333,14.37628111337661,125,4.400000000000005E-4
7,test_20231101_134944,10863862.png,317432,12162,305270,0.9616862824163915,2,3,66058,1765,64293,0.9732810560416604,24.022609777777777,3308.937994666667,12.933917317637896,125,4.400000000000005E-4
8,test_20231101_134944,11382381.png,312486,767,311719,0.9975454900379537,1,4,46745,100,46645,0.9978607337683175,21.58402311111111,2479.723024,14.186771864393144,125,4.400000000000005E-4
9,test_20231101_134944,11079715.png,443815,120387,323428,0.7287450852269527,9,4,124136,16809,107327,0.8645920603209383,16.86984177777778,2095.0260693333335,14.918909294142013,125,4.400000000000005E-4
10,test_20231101_134944,11551286.png,271883,447,271436,0.9983559104467731,1,4,40092,64,40028,0.9984036715554225,17.85190933333333,1855.3641226666666,15.446512065144763,125,4.400000000000005E-4
1,test_20231101_134945,10404007.png,502730,21297,481433,0.9576373003401428,3,4,61265,3080,58185,0.9497265975679425,25.756858666666666,3441.934906666667,12.76277708107859,125,4.5000000000000053E-4
2,test_20231101_134945,1254659.png,342646,74697,267949,0.7819994980241999,3,4,80080,10439,69641,0.8696428571428572,20.84253688888889,3163.838,13.12866122928261,125,4.5000000000000053E-4
3,test_20231101_134945,10188041.png,221231,9852,211379,0.9554673621689547,2,3,41731,1388,40343,0.9667393544367496,10.639758222222222,1024.043168,18.02762096387238,125,4.5000000000000053E-4
4,test_20231101_134945,10287332.png,216980,12584,204396,0.942003871324546,1,3,22337,1727,20610,0.9226843354076196,9.448579555555556,778.9383466666667,19.21577276445775,125,4.5000000000000053E-4
5,test_20231101_134945,11610969.png,368720,25759,342961,0.9301394011716207,3,4,84111,3758,80353,0.9553209449418031,21.541429333333333,2985.787157333333,13.380215151782494,125,4.5000000000000053E-4
6,test_20231101_134945,10350842.png,212614,6102,206512,0.9713001025332292,2,4,42529,894,41635,0.9789790495896917,19.318012444444445,2373.8444053333333,14.37628111337661,125,4.5000000000000053E-4
7,test_20231101_134945,10863862.png,317432,12162,305270,0.9616862824163915,2,4,66058,1765,64293,0.9732810560416604,24.022609777777777,3308.937994666667,12.933917317637896,125,4.5000000000000053E-4
8,test_20231101_134945,11382381.png,312486,767,311719,0.9975454900379537,1,4,46745,100,46645,0.9978607337683175,21.58402311111111,2479.723024,14.186771864393144,125,4.5000000000000053E-4
9,test_20231101_134945,11079715.png,443815,120387,323428,0.7287450852269527,3,5,124136,16809,107327,0.8645920603209383,16.86984177777778,2095.0260693333335,14.918909294142013,125,4.5000000000000053E-4
10,test_20231101_134945,11551286.png,271883,447,271436,0.9983559104467731,1,3,40092,64,40028,0.9984036715554225,17.85190933333333,1855.3641226666666,15.446512065144763,125,4.5000000000000053E-4
1,test_20231101_134945,10404007.png,502730,21297,481433,0.9576373003401428,2,4,61265,3080,58185,0.9497265975679425,25.756858666666666,3441.934906666667,12.76277708107859,125,4.6000000000000056E-4
2,test_20231101_134945,1254659.png,342646,74697,267949,0.7819994980241999,2,4,80080,10439,69641,0.8696428571428572,20.84253688888889,3163.838,13.12866122928261,125,4.6000000000000056E-4
3,test_20231101_134945,10188041.png,221231,9852,211379,0.9554673621689547,2,3,41731,1388,40343,0.9667393544367496,10.639758222222222,1024.043168,18.02762096387238,125,4.6000000000000056E-4
4,test_20231101_134945,10287332.png,216980,12584,204396,0.942003871324546,2,4,22337,1727,20610,0.9226843354076196,9.448579555555556,778.9383466666667,19.21577276445775,125,4.6000000000000056E-4
5,test_20231101_134945,11610969.png,368720,25759,342961,0.9301394011716207,3,3,84111,3758,80353,0.9553209449418031,21.541429333333333,2985.787157333333,13.380215151782494,125,4.6000000000000056E-4
6,test_20231101_134945,10350842.png,212614,6102,206512,0.9713001025332292,1,4,42529,894,41635,0.9789790495896917,19.318012444444445,2373.8444053333333,14.37628111337661,125,4.6000000000000056E-4
7,test_20231101_134945,10863862.png,317432,12162,305270,0.9616862824163915,2,4,66058,1765,64293,0.9732810560416604,24.022609777777777,3308.937994666667,12.933917317637896,125,4.6000000000000056E-4
8,test_20231101_134945,11382381.png,312486,767,311719,0.9975454900379537,1,3,46745,100,46645,0.9978607337683175,21.58402311111111,2479.723024,14.186771864393144,125,4.6000000000000056E-4
9,test_20231101_134945,11079715.png,443815,120387,323428,0.7287450852269527,3,4,124136,16809,107327,0.8645920603209383,16.86984177777778,2095.0260693333335,14.918909294142013,125,4.6000000000000056E-4
10,test_20231101_134945,11551286.png,271883,447,271436,0.9983559104467731,1,4,40092,64,40028,0.9984036715554225,17.85190933333333,1855.3641226666666,15.446512065144763,125,4.6000000000000056E-4
1,test_20231101_134946,10404007.png,502730,21297,481433,0.9576373003401428,3,4,61265,3080,58185,0.9497265975679425,25.756858666666666,3441.934906666667,12.76277708107859,125,4.700000000000006E-4
2,test_20231101_134946,1254659.png,342646,74697,267949,0.7819994980241999,4,4,80080,10439,69641,0.8696428571428572,20.84253688888889,3163.838,13.12866122928261,125,4.700000000000006E-4
3,test_20231101_134946,10188041.png,221231,9852,211379,0.9554673621689547,4,4,41731,1388,40343,0.9667393544367496,10.639758222222222,1024.043168,18.02762096387238,125,4.700000000000006E-4
4,test_20231101_134946,10287332.png,216980,12584,204396,0.942003871324546,1,3,22337,1727,20610,0.9226843354076196,9.448579555555556,778.9383466666667,19.21577276445775,125,4.700000000000006E-4
5,test_20231101_134946,11610969.png,368720,25759,342961,0.9301394011716207,2,3,84111,3758,80353,0.9553209449418031,21.541429333333333,2985.787157333333,13.380215151782494,125,4.700000000000006E-4
6,test_20231101_134946,10350842.png,212614,6102,206512,0.9713001025332292,2,4,42529,894,41635,0.9789790495896917,19.318012444444445,2373.8444053333333,14.37628111337661,125,4.700000000000006E-4
7,test_20231101_134946,10863862.png,317432,12162,305270,0.9616862824163915,2,4,66058,1765,64293,0.9732810560416604,24.022609777777777,3308.937994666667,12.933917317637896,125,4.700000000000006E-4
8,test_20231101_134946,11382381.png,312486,767,311719,0.9975454900379537,2,4,46745,100,46645,0.9978607337683175,21.58402311111111,2479.723024,14.186771864393144,125,4.700000000000006E-4
9,test_20231101_134946,11079715.png,443815,120387,323428,0.7287450852269527,4,4,124136,16809,107327,0.8645920603209383,16.86984177777778,2095.0260693333335,14.918909294142013,125,4.700000000000006E-4
10,test_20231101_134946,11551286.png,271883,447,271436,0.9983559104467731,1,4,40092,64,40028,0.9984036715554225,17.85190933333333,1855.3641226666666,15.446512065144763,125,4.700000000000006E-4
1,test_20231101_134947,10404007.png,502730,21297,481433,0.9576373003401428,2,4,61265,3080,58185,0.9497265975679425,25.756858666666666,3441.934906666667,12.76277708107859,125,4.800000000000006E-4
2,test_20231101_134947,1254659.png,342646,74697,267949,0.7819994980241999,3,4,80080,10439,69641,0.8696428571428572,20.84253688888889,3163.838,13.12866122928261,125,4.800000000000006E-4
3,test_20231101_134947,10188041.png,221231,9852,211379,0.9554673621689547,3,4,41731,1388,40343,0.9667393544367496,10.639758222222222,1024.043168,18.02762096387238,125,4.800000000000006E-4
4,test_20231101_134947,10287332.png,216980,12584,204396,0.942003871324546,2,4,22337,1727,20610,0.9226843354076196,9.448579555555556,778.9383466666667,19.21577276445775,125,4.800000000000006E-4
5,test_20231101_134947,11610969.png,368720,25759,342961,0.9301394011716207,2,4,84111,3758,80353,0.9553209449418031,21.541429333333333,2985.787157333333,13.380215151782494,125,4.800000000000006E-4
6,test_20231101_134947,10350842.png,212614,6102,206512,0.9713001025332292,2,3,42529,894,41635,0.9789790495896917,19.318012444444445,2373.8444053333333,14.37628111337661,125,4.800000000000006E-4
7,test_20231101_134947,10863862.png,317432,12162,305270,0.9616862824163915,2,3,66058,1765,64293,0.9732810560416604,24.022609777777777,3308.937994666667,12.933917317637896,125,4.800000000000006E-4
8,test_20231101_134947,11382381.png,312486,767,311719,0.9975454900379537,2,4,46745,100,46645,0.9978607337683175,21.58402311111111,2479.723024,14.186771864393144,125,4.800000000000006E-4
9,test_20231101_134947,11079715.png,443815,120387,323428,0.7287450852269527,4,4,124136,16809,107327,0.8645920603209383,16.86984177777778,2095.0260693333335,14.918909294142013,125,4.800000000000006E-4
10,test_20231101_134947,11551286.png,271883,447,271436,0.9983559104467731,2,3,40092,64,40028,0.9984036715554225,17.85190933333333,1855.3641226666666,15.446512065144763,125,4.800000000000006E-4
1,test_20231101_134947,10404007.png,502730,21297,481433,0.9576373003401428,3,3,61265,3080,58185,0.9497265975679425,25.756858666666666,3441.934906666667,12.76277708107859,125,4.900000000000006E-4
2,test_20231101_134947,1254659.png,342646,74697,267949,0.7819994980241999,3,4,80080,10439,69641,0.8696428571428572,20.84253688888889,3163.838,13.12866122928261,125,4.900000000000006E-4
3,test_20231101_134947,10188041.png,221231,9852,211379,0.9554673621689547,2,3,41731,1388,40343,0.9667393544367496,10.639758222222222,1024.043168,18.02762096387238,125,4.900000000000006E-4
4,test_20231101_134947,10287332.png,216980,12584,204396,0.942003871324546,2,3,22337,1727,20610,0.9226843354076196,9.448579555555556,778.9383466666667,19.21577276445775,125,4.900000000000006E-4
5,test_20231101_134947,11610969.png,368720,25759,342961,0.9301394011716207,3,4,84111,3758,80353,0.9553209449418031,21.541429333333333,2985.787157333333,13.380215151782494,125,4.900000000000006E-4
6,test_20231101_134947,10350842.png,212614,6102,206512,0.9713001025332292,2,3,42529,894,41635,0.9789790495896917,19.318012444444445,2373.8444053333333,14.37628111337661,125,4.900000000000006E-4
7,test_20231101_134947,10863862.png,317432,12162,305270,0.9616862824163915,2,4,66058,1765,64293,0.9732810560416604,24.022609777777777,3308.937994666667,12.933917317637896,125,4.900000000000006E-4
8,test_20231101_134947,11382381.png,312486,767,311719,0.9975454900379537,2,3,46745,100,46645,0.9978607337683175,21.58402311111111,2479.723024,14.186771864393144,125,4.900000000000006E-4
9,test_20231101_134947,11079715.png,443815,120387,323428,0.7287450852269527,3,4,124136,16809,107327,0.8645920603209383,16.86984177777778,2095.0260693333335,14.918909294142013,125,4.900000000000006E-4
10,test_20231101_134947,11551286.png,271883,447,271436,0.9983559104467731,2,4,40092,64,40028,0.9984036715554225,17.85190933333333,1855.3641226666666,15.446512065144763,125,4.900000000000006E-4
1,test_20231101_134948,10404007.png,502730,21297,481433,0.9576373003401428,2,4,61265,3080,58185,0.9497265975679425,25.756858666666666,3441.934906666667,12.76277708107859,125,5.000000000000007E-4
2,test_20231101_134948,1254659.png,342646,74697,267949,0.7819994980241999,3,4,80080,10439,69641,0.8696428571428572,20.84253688888889,3163.838,13.12866122928261,125,5.000000000000007E-4
3,test_20231101_134948,10188041.png,221231,9852,211379,0.9554673621689547,2,3,41731,1388,40343,0.9667393544367496,10.639758222222222,1024.043168,18.02762096387238,125,5.000000000000007E-4
4,test_20231101_134948,10287332.png,216980,12584,204396,0.942003871324546,2,4,22337,1727,20610,0.9226843354076196,9.448579555555556,778.9383466666667,19.21577276445775,125,5.000000000000007E-4
5,test_20231101_134948,11610969.png,368720,25759,342961,0.9301394011716207,2,4,84111,3758,80353,0.9553209449418031,21.541429333333333,2985.787157333333,13.380215151782494,125,5.000000000000007E-4
6,test_20231101_134948,10350842.png,212614,6102,206512,0.9713001025332292,2,4,42529,894,41635,0.9789790495896917,19.318012444444445,2373.8444053333333,14.37628111337661,125,5.000000000000007E-4
7,test_20231101_134948,10863862.png,317432,12162,305270,0.9616862824163915,2,3,66058,1765,64293,0.9732810560416604,24.022609777777777,3308.937994666667,12.933917317637896,125,5.000000000000007E-4
8,test_20231101_134948,11382381.png,312486,767,311719,0.9975454900379537,1,3,46745,100,46645,0.9978607337683175,21.58402311111111,2479.723024,14.186771864393144,125,5.000000000000007E-4
9,test_20231101_134948,11079715.png,443815,120387,323428,0.7287450852269527,3,4,124136,16809,107327,0.8645920603209383,16.86984177777778,2095.0260693333335,14.918909294142013,125,5.000000000000007E-4
10,test_20231101_134948,11551286.png,271883,447,271436,0.9983559104467731,1,3,40092,64,40028,0.9984036715554225,17.85190933333333,1855.3641226666666,15.446512065144763,125,5.000000000000007E-4
1,test_20231101_134949,10404007.png,502730,21177,481553,0.9578759970560738,2,4,61265,3065,58200,0.9499714355668,25.765313777777777,3444.1170506666667,12.760024580413443,125,5.100000000000007E-4
2,test_20231101_134949,1254659.png,342646,74697,267949,0.7819994980241999,3,4,80080,10439,69641,0.8696428571428572,20.84253688888889,3163.838,13.12866122928261,125,5.100000000000007E-4
3,test_20231101_134949,10188041.png,221231,9752,211479,0.9559193783872966,2,4,41731,1375,40356,0.9670508734513911,11.024238222222221,1074.0035093333333,17.82074660433971,125,5.100000000000007E-4
4,test_20231101_134949,10287332.png,216980,12584,204396,0.942003871324546,1,4,22337,1727,20610,0.9226843354076196,9.448579555555556,778.9383466666667,19.21577276445775,125,5.100000000000007E-4
5,test_20231101_134949,11610969.png,368720,25697,343023,0.930307550444782,2,3,84111,3750,80361,0.9554160573527838,21.631701333333332,3001.576629333333,13.357309256291893,125,5.100000000000007E-4
6,test_20231101_134949,10350842.png,212614,6102,206512,0.9713001025332292,1,3,42529,894,41635,0.9789790495896917,19.318012444444445,2373.8444053333333,14.37628111337661,125,5.100000000000007E-4
7,test_20231101_134949,10863862.png,317432,12162,305270,0.9616862824163915,2,3,66058,1765,64293,0.9732810560416604,24.022609777777777,3308.937994666667,12.933917317637896,125,5.100000000000007E-4
8,test_20231101_134949,11382381.png,312486,767,311719,0.9975454900379537,2,3,46745,100,46645,0.9978607337683175,21.58402311111111,2479.723024,14.186771864393144,125,5.100000000000007E-4
9,test_20231101_134949,11079715.png,443815,120387,323428,0.7287450852269527,4,4,124136,16809,107327,0.8645920603209383,16.86984177777778,2095.0260693333335,14.918909294142013,125,5.100000000000007E-4
10,test_20231101_134949,11551286.png,271883,367,271516,0.9986501546621157,2,3,40092,52,40040,0.9987029831387808,18.002010666666667,1874.0560373333333,15.402977880083654,125,5.100000000000007E-4
1,test_20231101_134949,10404007.png,502730,21177,481553,0.9578759970560738,2,3,61265,3065,58200,0.9499714355668,25.765313777777777,3444.1170506666667,12.760024580413443,125,5.200000000000007E-4
2,test_20231101_134949,1254659.png,342646,74697,267949,0.7819994980241999,3,11,80080,10439,69641,0.8696428571428572,20.84253688888889,3163.838,13.12866122928261,125,5.200000000000007E-4
3,test_20231101_134949,10188041.png,221231,9752,211479,0.9559193783872966,2,3,41731,1375,40356,0.9670508734513911,11.024238222222221,1074.0035093333333,17.82074660433971,125,5.200000000000007E-4
4,test_20231101_134949,10287332.png,216980,12584,204396,0.942003871324546,1,4,22337,1727,20610,0.9226843354076196,9.448579555555556,778.9383466666667,19.21577276445775,125,5.200000000000007E-4
5,test_20231101_134949,11610969.png,368720,25697,343023,0.930307550444782,3,4,84111,3750,80361,0.9554160573527838,21.631701333333332,3001.576629333333,13.357309256291893,125,5.200000000000007E-4
6,test_20231101_134949,10350842.png,212614,6102,206512,0.9713001025332292,2,4,42529,894,41635,0.9789790495896917,19.318012444444445,2373.8444053333333,14.37628111337661,125,5.200000000000007E-4
7,test_20231101_134949,10863862.png,317432,12162,305270,0.9616862824163915,2,4,66058,1765,64293,0.9732810560416604,24.022609777777777,3308.937994666667,12.933917317637896,125,5.200000000000007E-4
8,test_20231101_134949,11382381.png,312486,767,311719,0.9975454900379537,1,4,46745,100,46645,0.9978607337683175,21.58402311111111,2479.723024,14.186771864393144,125,5.200000000000007E-4
9,test_20231101_134949,11079715.png,443815,120387,323428,0.7287450852269527,3,5,124136,16809,107327,0.8645920603209383,16.86984177777778,2095.0260693333335,14.918909294142013,125,5.200000000000007E-4
10,test_20231101_134949,11551286.png,271883,367,271516,0.9986501546621157,1,3,40092,52,40040,0.9987029831387808,18.002010666666667,1874.0560373333333,15.402977880083654,125,5.200000000000007E-4
1,test_20231101_134950,10404007.png,502730,21177,481553,0.9578759970560738,2,4,61265,3065,58200,0.9499714355668,25.765313777777777,3444.1170506666667,12.760024580413443,125,5.300000000000007E-4
2,test_20231101_134950,1254659.png,342646,74697,267949,0.7819994980241999,3,4,80080,10439,69641,0.8696428571428572,20.84253688888889,3163.838,13.12866122928261,125,5.300000000000007E-4
3,test_20231101_134950,10188041.png,221231,9752,211479,0.9559193783872966,2,4,41731,1375,40356,0.9670508734513911,11.024238222222221,1074.0035093333333,17.82074660433971,125,5.300000000000007E-4
4,test_20231101_134950,10287332.png,216980,12584,204396,0.942003871324546,2,4,22337,1727,20610,0.9226843354076196,9.448579555555556,778.9383466666667,19.21577276445775,125,5.300000000000007E-4
5,test_20231101_134950,11610969.png,368720,25697,343023,0.930307550444782,2,4,84111,3750,80361,0.9554160573527838,21.631701333333332,3001.576629333333,13.357309256291893,125,5.300000000000007E-4
6,test_20231101_134950,10350842.png,212614,6102,206512,0.9713001025332292,1,3,42529,894,41635,0.9789790495896917,19.318012444444445,2373.8444053333333,14.37628111337661,125,5.300000000000007E-4
7,test_20231101_134950,10863862.png,317432,12162,305270,0.9616862824163915,2,3,66058,1765,64293,0.9732810560416604,24.022609777777777,3308.937994666667,12.933917317637896,125,5.300000000000007E-4
8,test_20231101_134950,11382381.png,312486,767,311719,0.9975454900379537,1,3,46745,100,46645,0.9978607337683175,21.58402311111111,2479.723024,14.186771864393144,125,5.300000000000007E-4
9,test_20231101_134950,11079715.png,443815,120387,323428,0.7287450852269527,3,4,124136,16809,107327,0.8645920603209383,16.86984177777778,2095.0260693333335,14.918909294142013,125,5.300000000000007E-4
10,test_20231101_134950,11551286.png,271883,367,271516,0.9986501546621157,1,3,40092,52,40040,0.9987029831387808,18.002010666666667,1874.0560373333333,15.402977880083654,125,5.300000000000007E-4
1,test_20231101_134951,10404007.png,502730,21177,481553,0.9578759970560738,2,4,61265,3065,58200,0.9499714355668,25.765313777777777,3444.1170506666667,12.760024580413443,125,5.400000000000008E-4
2,test_20231101_134951,1254659.png,342646,74697,267949,0.7819994980241999,3,4,80080,10439,69641,0.8696428571428572,20.84253688888889,3163.838,13.12866122928261,125,5.400000000000008E-4
3,test_20231101_134951,10188041.png,221231,9752,211479,0.9559193783872966,2,3,41731,1375,40356,0.9670508734513911,11.024238222222221,1074.0035093333333,17.82074660433971,125,5.400000000000008E-4
4,test_20231101_134951,10287332.png,216980,12584,204396,0.942003871324546,2,3,22337,1727,20610,0.9226843354076196,9.448579555555556,778.9383466666667,19.21577276445775,125,5.400000000000008E-4
5,test_20231101_134951,11610969.png,368720,25697,343023,0.930307550444782,3,4,84111,3750,80361,0.9554160573527838,21.631701333333332,3001.576629333333,13.357309256291893,125,5.400000000000008E-4
6,test_20231101_134951,10350842.png,212614,6102,206512,0.9713001025332292,2,4,42529,894,41635,0.9789790495896917,19.318012444444445,2373.8444053333333,14.37628111337661,125,5.400000000000008E-4
7,test_20231101_134951,10863862.png,317432,12162,305270,0.9616862824163915,2,4,66058,1765,64293,0.9732810560416604,24.022609777777777,3308.937994666667,12.933917317637896,125,5.400000000000008E-4
8,test_20231101_134951,11382381.png,312486,767,311719,0.9975454900379537,2,3,46745,100,46645,0.9978607337683175,21.58402311111111,2479.723024,14.186771864393144,125,5.400000000000008E-4
9,test_20231101_134951,11079715.png,443815,120387,323428,0.7287450852269527,3,4,124136,16809,107327,0.8645920603209383,16.86984177777778,2095.0260693333335,14.918909294142013,125,5.400000000000008E-4
10,test_20231101_134951,11551286.png,271883,367,271516,0.9986501546621157,1,4,40092,52,40040,0.9987029831387808,18.002010666666667,1874.0560373333333,15.402977880083654,125,5.400000000000008E-4
1,test_20231101_134952,10404007.png,502730,21177,481553,0.9578759970560738,2,3,61265,3065,58200,0.9499714355668,25.765313777777777,3444.1170506666667,12.760024580413443,125,5.500000000000008E-4
2,test_20231101_134952,1254659.png,342646,74697,267949,0.7819994980241999,3,4,80080,10439,69641,0.8696428571428572,20.84253688888889,3163.838,13.12866122928261,125,5.500000000000008E-4
3,test_20231101_134952,10188041.png,221231,9752,211479,0.9559193783872966,2,4,41731,1375,40356,0.9670508734513911,11.024238222222221,1074.0035093333333,17.82074660433971,125,5.500000000000008E-4
4,test_20231101_134952,10287332.png,216980,12584,204396,0.942003871324546,2,4,22337,1727,20610,0.9226843354076196,9.448579555555556,778.9383466666667,19.21577276445775,125,5.500000000000008E-4
5,test_20231101_134952,11610969.png,368720,25697,343023,0.930307550444782,2,4,84111,3750,80361,0.9554160573527838,21.631701333333332,3001.576629333333,13.357309256291893,125,5.500000000000008E-4
6,test_20231101_134952,10350842.png,212614,6102,206512,0.9713001025332292,2,4,42529,894,41635,0.9789790495896917,19.318012444444445,2373.8444053333333,14.37628111337661,125,5.500000000000008E-4
7,test_20231101_134952,10863862.png,317432,12162,305270,0.9616862824163915,2,3,66058,1765,64293,0.9732810560416604,24.022609777777777,3308.937994666667,12.933917317637896,125,5.500000000000008E-4
8,test_20231101_134952,11382381.png,312486,767,311719,0.9975454900379537,1,3,46745,100,46645,0.9978607337683175,21.58402311111111,2479.723024,14.186771864393144,125,5.500000000000008E-4
9,test_20231101_134952,11079715.png,443815,120387,323428,0.7287450852269527,3,4,124136,16809,107327,0.8645920603209383,16.86984177777778,2095.0260693333335,14.918909294142013,125,5.500000000000008E-4
10,test_20231101_134952,11551286.png,271883,367,271516,0.9986501546621157,1,4,40092,52,40040,0.9987029831387808,18.002010666666667,1874.0560373333333,15.402977880083654,125,5.500000000000008E-4
1,test_20231101_134952,10404007.png,502730,21177,481553,0.9578759970560738,2,4,61265,3065,58200,0.9499714355668,25.765313777777777,3444.1170506666667,12.760024580413443,125,5.600000000000008E-4
2,test_20231101_134952,1254659.png,342646,74697,267949,0.7819994980241999,3,4,80080,10439,69641,0.8696428571428572,20.84253688888889,3163.838,13.12866122928261,125,5.600000000000008E-4
3,test_20231101_134952,10188041.png,221231,9752,211479,0.9559193783872966,2,3,41731,1375,40356,0.9670508734513911,11.024238222222221,1074.0035093333333,17.82074660433971,125,5.600000000000008E-4
4,test_20231101_134952,10287332.png,216980,12584,204396,0.942003871324546,2,3,22337,1727,20610,0.9226843354076196,9.448579555555556,778.9383466666667,19.21577276445775,125,5.600000000000008E-4
5,test_20231101_134952,11610969.png,368720,25697,343023,0.930307550444782,3,3,84111,3750,80361,0.9554160573527838,21.631701333333332,3001.576629333333,13.357309256291893,125,5.600000000000008E-4
6,test_20231101_134952,10350842.png,212614,6102,206512,0.9713001025332292,2,3,42529,894,41635,0.9789790495896917,19.318012444444445,2373.8444053333333,14.37628111337661,125,5.600000000000008E-4
7,test_20231101_134952,10863862.png,317432,12162,305270,0.9616862824163915,2,3,66058,1765,64293,0.9732810560416604,24.022609777777777,3308.937994666667,12.933917317637896,125,5.600000000000008E-4
8,test_20231101_134952,11382381.png,312486,767,311719,0.9975454900379537,2,3,46745,100,46645,0.9978607337683175,21.58402311111111,2479.723024,14.186771864393144,125,5.600000000000008E-4
9,test_20231101_134952,11079715.png,443815,120387,323428,0.7287450852269527,4,4,124136,16809,107327,0.8645920603209383,16.86984177777778,2095.0260693333335,14.918909294142013,125,5.600000000000008E-4
10,test_20231101_134952,11551286.png,271883,367,271516,0.9986501546621157,1,3,40092,52,40040,0.9987029831387808,18.002010666666667,1874.0560373333333,15.402977880083654,125,5.600000000000008E-4
1,test_20231101_134953,10404007.png,502730,21177,481553,0.9578759970560738,2,10,61265,3065,58200,0.9499714355668,25.765313777777777,3444.1170506666667,12.760024580413443,125,5.700000000000008E-4
2,test_20231101_134953,1254659.png,342646,74697,267949,0.7819994980241999,4,4,80080,10439,69641,0.8696428571428572,20.84253688888889,3163.838,13.12866122928261,125,5.700000000000008E-4
3,test_20231101_134953,10188041.png,221231,9752,211479,0.9559193783872966,2,8,41731,1375,40356,0.9670508734513911,11.024238222222221,1074.0035093333333,17.82074660433971,125,5.700000000000008E-4
4,test_20231101_134953,10287332.png,216980,12584,204396,0.942003871324546,3,4,22337,1727,20610,0.9226843354076196,9.448579555555556,778.9383466666667,19.21577276445775,125,5.700000000000008E-4
5,test_20231101_134953,11610969.png,368720,25697,343023,0.930307550444782,2,4,84111,3750,80361,0.9554160573527838,21.631701333333332,3001.576629333333,13.357309256291893,125,5.700000000000008E-4
6,test_20231101_134953,10350842.png,212614,6102,206512,0.9713001025332292,2,4,42529,894,41635,0.9789790495896917,19.318012444444445,2373.8444053333333,14.37628111337661,125,5.700000000000008E-4
7,test_20231101_134953,10863862.png,317432,12162,305270,0.9616862824163915,2,4,66058,1765,64293,0.9732810560416604,24.022609777777777,3308.937994666667,12.933917317637896,125,5.700000000000008E-4
8,test_20231101_134953,11382381.png,312486,767,311719,0.9975454900379537,2,4,46745,100,46645,0.9978607337683175,21.58402311111111,2479.723024,14.186771864393144,125,5.700000000000008E-4
9,test_20231101_134953,11079715.png,443815,120387,323428,0.7287450852269527,4,4,124136,16809,107327,0.8645920603209383,16.86984177777778,2095.0260693333335,14.918909294142013,125,5.700000000000008E-4
10,test_20231101_134953,11551286.png,271883,367,271516,0.9986501546621157,2,3,40092,52,40040,0.9987029831387808,18.002010666666667,1874.0560373333333,15.402977880083654,125,5.700000000000008E-4
1,test_20231101_134954,10404007.png,502730,21177,481553,0.9578759970560738,2,4,61265,3065,58200,0.9499714355668,25.765313777777777,3444.1170506666667,12.760024580413443,125,5.800000000000009E-4
2,test_20231101_134954,1254659.png,342646,74697,267949,0.7819994980241999,3,4,80080,10439,69641,0.8696428571428572,20.84253688888889,3163.838,13.12866122928261,125,5.800000000000009E-4
3,test_20231101_134954,10188041.png,221231,9752,211479,0.9559193783872966,2,4,41731,1375,40356,0.9670508734513911,11.024238222222221,1074.0035093333333,17.82074660433971,125,5.800000000000009E-4
4,test_20231101_134954,10287332.png,216980,12584,204396,0.942003871324546,2,4,22337,1727,20610,0.9226843354076196,9.448579555555556,778.9383466666667,19.21577276445775,125,5.800000000000009E-4
5,test_20231101_134954,11610969.png,368720,25697,343023,0.930307550444782,2,3,84111,3750,80361,0.9554160573527838,21.631701333333332,3001.576629333333,13.357309256291893,125,5.800000000000009E-4
6,test_20231101_134954,10350842.png,212614,6102,206512,0.9713001025332292,1,7,42529,894,41635,0.9789790495896917,19.318012444444445,2373.8444053333333,14.37628111337661,125,5.800000000000009E-4
7,test_20231101_134954,10863862.png,317432,12162,305270,0.9616862824163915,2,4,66058,1765,64293,0.9732810560416604,24.022609777777777,3308.937994666667,12.933917317637896,125,5.800000000000009E-4
8,test_20231101_134954,11382381.png,312486,767,311719,0.9975454900379537,2,3,46745,100,46645,0.9978607337683175,21.58402311111111,2479.723024,14.186771864393144,125,5.800000000000009E-4
9,test_20231101_134954,11079715.png,443815,120387,323428,0.7287450852269527,3,4,124136,16809,107327,0.8645920603209383,16.86984177777778,2095.0260693333335,14.918909294142013,125,5.800000000000009E-4
10,test_20231101_134954,11551286.png,271883,367,271516,0.9986501546621157,2,3,40092,52,40040,0.9987029831387808,18.002010666666667,1874.0560373333333,15.402977880083654,125,5.800000000000009E-4
1,test_20231101_134954,10404007.png,502730,21177,481553,0.9578759970560738,2,3,61265,3065,58200,0.9499714355668,25.765313777777777,3444.1170506666667,12.760024580413443,125,5.900000000000009E-4
2,test_20231101_134954,1254659.png,342646,74697,267949,0.7819994980241999,3,4,80080,10439,69641,0.8696428571428572,20.84253688888889,3163.838,13.12866122928261,125,5.900000000000009E-4
3,test_20231101_134954,10188041.png,221231,9752,211479,0.9559193783872966,2,3,41731,1375,40356,0.9670508734513911,11.024238222222221,1074.0035093333333,17.82074660433971,125,5.900000000000009E-4
4,test_20231101_134954,10287332.png,216980,12584,204396,0.942003871324546,2,4,22337,1727,20610,0.9226843354076196,9.448579555555556,778.9383466666667,19.21577276445775,125,5.900000000000009E-4
5,test_20231101_134954,11610969.png,368720,25697,343023,0.930307550444782,3,4,84111,3750,80361,0.9554160573527838,21.631701333333332,3001.576629333333,13.357309256291893,125,5.900000000000009E-4
6,test_20231101_134954,10350842.png,212614,6102,206512,0.9713001025332292,2,4,42529,894,41635,0.9789790495896917,19.318012444444445,2373.8444053333333,14.37628111337661,125,5.900000000000009E-4
7,test_20231101_134954,10863862.png,317432,12162,305270,0.9616862824163915,2,4,66058,1765,64293,0.9732810560416604,24.022609777777777,3308.937994666667,12.933917317637896,125,5.900000000000009E-4
8,test_20231101_134954,11382381.png,312486,767,311719,0.9975454900379537,1,3,46745,100,46645,0.9978607337683175,21.58402311111111,2479.723024,14.186771864393144,125,5.900000000000009E-4
9,test_20231101_134954,11079715.png,443815,120387,323428,0.7287450852269527,4,4,124136,16809,107327,0.8645920603209383,16.86984177777778,2095.0260693333335,14.918909294142013,125,5.900000000000009E-4
10,test_20231101_134954,11551286.png,271883,367,271516,0.9986501546621157,1,4,40092,52,40040,0.9987029831387808,18.002010666666667,1874.0560373333333,15.402977880083654,125,5.900000000000009E-4
1,test_20231101_134955,10404007.png,502730,21177,481553,0.9578759970560738,3,3,61265,3065,58200,0.9499714355668,25.765313777777777,3444.1170506666667,12.760024580413443,125,6.000000000000009E-4
2,test_20231101_134955,1254659.png,342646,74697,267949,0.7819994980241999,3,4,80080,10439,69641,0.8696428571428572,20.84253688888889,3163.838,13.12866122928261,125,6.000000000000009E-4
3,test_20231101_134955,10188041.png,221231,9752,211479,0.9559193783872966,2,4,41731,1375,40356,0.9670508734513911,11.024238222222221,1074.0035093333333,17.82074660433971,125,6.000000000000009E-4
4,test_20231101_134955,10287332.png,216980,12584,204396,0.942003871324546,2,4,22337,1727,20610,0.9226843354076196,9.448579555555556,778.9383466666667,19.21577276445775,125,6.000000000000009E-4
5,test_20231101_134955,11610969.png,368720,25697,343023,0.930307550444782,2,5,84111,3750,80361,0.9554160573527838,21.631701333333332,3001.576629333333,13.357309256291893,125,6.000000000000009E-4
6,test_20231101_134955,10350842.png,212614,6102,206512,0.9713001025332292,2,4,42529,894,41635,0.9789790495896917,19.318012444444445,2373.8444053333333,14.37628111337661,125,6.000000000000009E-4
7,test_20231101_134955,10863862.png,317432,12162,305270,0.9616862824163915,2,3,66058,1765,64293,0.9732810560416604,24.022609777777777,3308.937994666667,12.933917317637896,125,6.000000000000009E-4
8,test_20231101_134955,11382381.png,312486,767,311719,0.9975454900379537,2,3,46745,100,46645,0.9978607337683175,21.58402311111111,2479.723024,14.186771864393144,125,6.000000000000009E-4
9,test_20231101_134955,11079715.png,443815,120387,323428,0.7287450852269527,4,4,124136,16809,107327,0.8645920603209383,16.86984177777778,2095.0260693333335,14.918909294142013,125,6.000000000000009E-4
10,test_20231101_134955,11551286.png,271883,367,271516,0.9986501546621157,1,4,40092,52,40040,0.9987029831387808,18.002010666666667,1874.0560373333333,15.402977880083654,125,6.000000000000009E-4
1,test_20231101_134956,10404007.png,502730,21177,481553,0.9578759970560738,2,4,61265,3065,58200,0.9499714355668,25.765313777777777,3444.1170506666667,12.760024580413443,125,6.10000000000001E-4
2,test_20231101_134956,1254659.png,342646,74697,267949,0.7819994980241999,3,4,80080,10439,69641,0.8696428571428572,20.84253688888889,3163.838,13.12866122928261,125,6.10000000000001E-4
3,test_20231101_134956,10188041.png,221231,9752,211479,0.9559193783872966,2,4,41731,1375,40356,0.9670508734513911,11.024238222222221,1074.0035093333333,17.82074660433971,125,6.10000000000001E-4
4,test_20231101_134956,10287332.png,216980,12584,204396,0.942003871324546,2,4,22337,1727,20610,0.9226843354076196,9.448579555555556,778.9383466666667,19.21577276445775,125,6.10000000000001E-4
5,test_20231101_134956,11610969.png,368720,25697,343023,0.930307550444782,2,3,84111,3750,80361,0.9554160573527838,21.631701333333332,3001.576629333333,13.357309256291893,125,6.10000000000001E-4
6,test_20231101_134956,10350842.png,212614,6102,206512,0.9713001025332292,1,3,42529,894,41635,0.9789790495896917,19.318012444444445,2373.8444053333333,14.37628111337661,125,6.10000000000001E-4
7,test_20231101_134956,10863862.png,317432,12162,305270,0.9616862824163915,1,3,66058,1765,64293,0.9732810560416604,24.022609777777777,3308.937994666667,12.933917317637896,125,6.10000000000001E-4
8,test_20231101_134956,11382381.png,312486,767,311719,0.9975454900379537,1,3,46745,100,46645,0.9978607337683175,21.58402311111111,2479.723024,14.186771864393144,125,6.10000000000001E-4
9,test_20231101_134956,11079715.png,443815,120387,323428,0.7287450852269527,3,4,124136,16809,107327,0.8645920603209383,16.86984177777778,2095.0260693333335,14.918909294142013,125,6.10000000000001E-4
10,test_20231101_134956,11551286.png,271883,367,271516,0.9986501546621157,2,3,40092,52,40040,0.9987029831387808,18.002010666666667,1874.0560373333333,15.402977880083654,125,6.10000000000001E-4
1,test_20231101_134956,10404007.png,502730,21177,481553,0.9578759970560738,2,3,61265,3065,58200,0.9499714355668,25.765313777777777,3444.1170506666667,12.760024580413443,125,6.20000000000001E-4
2,test_20231101_134956,1254659.png,342646,74697,267949,0.7819994980241999,2,4,80080,10439,69641,0.8696428571428572,20.84253688888889,3163.838,13.12866122928261,125,6.20000000000001E-4
3,test_20231101_134956,10188041.png,221231,9752,211479,0.9559193783872966,2,4,41731,1375,40356,0.9670508734513911,11.024238222222221,1074.0035093333333,17.82074660433971,125,6.20000000000001E-4
4,test_20231101_134956,10287332.png,216980,12584,204396,0.942003871324546,1,4,22337,1727,20610,0.9226843354076196,9.448579555555556,778.9383466666667,19.21577276445775,125,6.20000000000001E-4
5,test_20231101_134956,11610969.png,368720,25697,343023,0.930307550444782,2,4,84111,3750,80361,0.9554160573527838,21.631701333333332,3001.576629333333,13.357309256291893,125,6.20000000000001E-4
6,test_20231101_134956,10350842.png,212614,6102,206512,0.9713001025332292,2,4,42529,894,41635,0.9789790495896917,19.318012444444445,2373.8444053333333,14.37628111337661,125,6.20000000000001E-4
7,test_20231101_134956,10863862.png,317432,12162,305270,0.9616862824163915,2,4,66058,1765,64293,0.9732810560416604,24.022609777777777,3308.937994666667,12.933917317637896,125,6.20000000000001E-4
8,test_20231101_134956,11382381.png,312486,767,311719,0.9975454900379537,1,5,46745,100,46645,0.9978607337683175,21.58402311111111,2479.723024,14.186771864393144,125,6.20000000000001E-4
9,test_20231101_134956,11079715.png,443815,120387,323428,0.7287450852269527,3,5,124136,16809,107327,0.8645920603209383,16.86984177777778,2095.0260693333335,14.918909294142013,125,6.20000000000001E-4
10,test_20231101_134956,11551286.png,271883,367,271516,0.9986501546621157,2,3,40092,52,40040,0.9987029831387808,18.002010666666667,1874.0560373333333,15.402977880083654,125,6.20000000000001E-4
1,test_20231101_134957,10404007.png,502730,21177,481553,0.9578759970560738,2,4,61265,3065,58200,0.9499714355668,25.765313777777777,3444.1170506666667,12.760024580413443,125,6.30000000000001E-4
2,test_20231101_134957,1254659.png,342646,74697,267949,0.7819994980241999,3,4,80080,10439,69641,0.8696428571428572,20.84253688888889,3163.838,13.12866122928261,125,6.30000000000001E-4
3,test_20231101_134957,10188041.png,221231,9752,211479,0.9559193783872966,2,4,41731,1375,40356,0.9670508734513911,11.024238222222221,1074.0035093333333,17.82074660433971,125,6.30000000000001E-4
4,test_20231101_134957,10287332.png,216980,12584,204396,0.942003871324546,1,3,22337,1727,20610,0.9226843354076196,9.448579555555556,778.9383466666667,19.21577276445775,125,6.30000000000001E-4
5,test_20231101_134957,11610969.png,368720,25697,343023,0.930307550444782,2,3,84111,3750,80361,0.9554160573527838,21.631701333333332,3001.576629333333,13.357309256291893,125,6.30000000000001E-4
6,test_20231101_134957,10350842.png,212614,6102,206512,0.9713001025332292,1,4,42529,894,41635,0.9789790495896917,19.318012444444445,2373.8444053333333,14.37628111337661,125,6.30000000000001E-4
7,test_20231101_134957,10863862.png,317432,12162,305270,0.9616862824163915,2,4,66058,1765,64293,0.9732810560416604,24.022609777777777,3308.937994666667,12.933917317637896,125,6.30000000000001E-4
8,test_20231101_134957,11382381.png,312486,767,311719,0.9975454900379537,2,3,46745,100,46645,0.9978607337683175,21.58402311111111,2479.723024,14.186771864393144,125,6.30000000000001E-4
9,test_20231101_134957,11079715.png,443815,120387,323428,0.7287450852269527,4,5,124136,16809,107327,0.8645920603209383,16.86984177777778,2095.0260693333335,14.918909294142013,125,6.30000000000001E-4
10,test_20231101_134957,11551286.png,271883,367,271516,0.9986501546621157,1,3,40092,52,40040,0.9987029831387808,18.002010666666667,1874.0560373333333,15.402977880083654,125,6.30000000000001E-4
1,test_20231101_134958,10404007.png,502730,21177,481553,0.9578759970560738,2,4,61265,3065,58200,0.9499714355668,25.765313777777777,3444.1170506666667,12.760024580413443,125,6.40000000000001E-4
2,test_20231101_134958,1254659.png,342646,74697,267949,0.7819994980241999,3,11,80080,10439,69641,0.8696428571428572,20.84253688888889,3163.838,13.12866122928261,125,6.40000000000001E-4
3,test_20231101_134958,10188041.png,221231,9752,211479,0.9559193783872966,2,4,41731,1375,40356,0.9670508734513911,11.024238222222221,1074.0035093333333,17.82074660433971,125,6.40000000000001E-4
4,test_20231101_134958,10287332.png,216980,12584,204396,0.942003871324546,2,4,22337,1727,20610,0.9226843354076196,9.448579555555556,778.9383466666667,19.21577276445775,125,6.40000000000001E-4
5,test_20231101_134958,11610969.png,368720,25697,343023,0.930307550444782,3,3,84111,3750,80361,0.9554160573527838,21.631701333333332,3001.576629333333,13.357309256291893,125,6.40000000000001E-4
6,test_20231101_134958,10350842.png,212614,6102,206512,0.9713001025332292,1,4,42529,894,41635,0.9789790495896917,19.318012444444445,2373.8444053333333,14.37628111337661,125,6.40000000000001E-4
7,test_20231101_134958,10863862.png,317432,12162,305270,0.9616862824163915,2,3,66058,1765,64293,0.9732810560416604,24.022609777777777,3308.937994666667,12.933917317637896,125,6.40000000000001E-4
8,test_20231101_134958,11382381.png,312486,767,311719,0.9975454900379537,1,4,46745,100,46645,0.9978607337683175,21.58402311111111,2479.723024,14.186771864393144,125,6.40000000000001E-4
9,test_20231101_134958,11079715.png,443815,120387,323428,0.7287450852269527,4,4,124136,16809,107327,0.8645920603209383,16.86984177777778,2095.0260693333335,14.918909294142013,125,6.40000000000001E-4
10,test_20231101_134958,11551286.png,271883,367,271516,0.9986501546621157,1,4,40092,52,40040,0.9987029831387808,18.002010666666667,1874.0560373333333,15.402977880083654,125,6.40000000000001E-4
1,test_20231101_134958,10404007.png,502730,21177,481553,0.9578759970560738,2,3,61265,3065,58200,0.9499714355668,25.765313777777777,3444.1170506666667,12.760024580413443,125,6.500000000000011E-4
2,test_20231101_134958,1254659.png,342646,74697,267949,0.7819994980241999,3,4,80080,10439,69641,0.8696428571428572,20.84253688888889,3163.838,13.12866122928261,125,6.500000000000011E-4
3,test_20231101_134958,10188041.png,221231,9752,211479,0.9559193783872966,2,3,41731,1375,40356,0.9670508734513911,11.024238222222221,1074.0035093333333,17.82074660433971,125,6.500000000000011E-4
4,test_20231101_134958,10287332.png,216980,12584,204396,0.942003871324546,1,3,22337,1727,20610,0.9226843354076196,9.448579555555556,778.9383466666667,19.21577276445775,125,6.500000000000011E-4
5,test_20231101_134958,11610969.png,368720,25697,343023,0.930307550444782,3,4,84111,3750,80361,0.9554160573527838,21.631701333333332,3001.576629333333,13.357309256291893,125,6.500000000000011E-4
6,test_20231101_134958,10350842.png,212614,6102,206512,0.9713001025332292,2,4,42529,894,41635,0.9789790495896917,19.318012444444445,2373.8444053333333,14.37628111337661,125,6.500000000000011E-4
7,test_20231101_134958,10863862.png,317432,12162,305270,0.9616862824163915,2,4,66058,1765,64293,0.9732810560416604,24.022609777777777,3308.937994666667,12.933917317637896,125,6.500000000000011E-4
8,test_20231101_134958,11382381.png,312486,767,311719,0.9975454900379537,1,4,46745,100,46645,0.9978607337683175,21.58402311111111,2479.723024,14.186771864393144,125,6.500000000000011E-4
9,test_20231101_134958,11079715.png,443815,120387,323428,0.7287450852269527,4,4,124136,16809,107327,0.8645920603209383,16.86984177777778,2095.0260693333335,14.918909294142013,125,6.500000000000011E-4
10,test_20231101_134958,11551286.png,271883,367,271516,0.9986501546621157,2,3,40092,52,40040,0.9987029831387808,18.002010666666667,1874.0560373333333,15.402977880083654,125,6.500000000000011E-4
1,test_20231101_134959,10404007.png,502730,21177,481553,0.9578759970560738,2,3,61265,3065,58200,0.9499714355668,25.765313777777777,3444.1170506666667,12.760024580413443,125,6.600000000000011E-4
2,test_20231101_134959,1254659.png,342646,74697,267949,0.7819994980241999,4,4,80080,10439,69641,0.8696428571428572,20.84253688888889,3163.838,13.12866122928261,125,6.600000000000011E-4
3,test_20231101_134959,10188041.png,221231,9752,211479,0.9559193783872966,2,3,41731,1375,40356,0.9670508734513911,11.024238222222221,1074.0035093333333,17.82074660433971,125,6.600000000000011E-4
4,test_20231101_134959,10287332.png,216980,12584,204396,0.942003871324546,1,4,22337,1727,20610,0.9226843354076196,9.448579555555556,778.9383466666667,19.21577276445775,125,6.600000000000011E-4
5,test_20231101_134959,11610969.png,368720,25697,343023,0.930307550444782,3,3,84111,3750,80361,0.9554160573527838,21.631701333333332,3001.576629333333,13.357309256291893,125,6.600000000000011E-4
6,test_20231101_134959,10350842.png,212614,6102,206512,0.9713001025332292,2,4,42529,894,41635,0.9789790495896917,19.318012444444445,2373.8444053333333,14.37628111337661,125,6.600000000000011E-4
7,test_20231101_134959,10863862.png,317432,12162,305270,0.9616862824163915,2,4,66058,1765,64293,0.9732810560416604,24.022609777777777,3308.937994666667,12.933917317637896,125,6.600000000000011E-4
8,test_20231101_134959,11382381.png,312486,767,311719,0.9975454900379537,2,4,46745,100,46645,0.9978607337683175,21.58402311111111,2479.723024,14.186771864393144,125,6.600000000000011E-4
9,test_20231101_134959,11079715.png,443815,120387,323428,0.7287450852269527,3,4,124136,16809,107327,0.8645920603209383,16.86984177777778,2095.0260693333335,14.918909294142013,125,6.600000000000011E-4
10,test_20231101_134959,11551286.png,271883,367,271516,0.9986501546621157,1,6,40092,52,40040,0.9987029831387808,18.002010666666667,1874.0560373333333,15.402977880083654,125,6.600000000000011E-4
1,test_20231101_135000,10404007.png,502730,21177,481553,0.9578759970560738,3,4,61265,3065,58200,0.9499714355668,25.765313777777777,3444.1170506666667,12.760024580413443,125,6.700000000000011E-4
2,test_20231101_135000,1254659.png,342646,74697,267949,0.7819994980241999,3,4,80080,10439,69641,0.8696428571428572,20.84253688888889,3163.838,13.12866122928261,125,6.700000000000011E-4
3,test_20231101_135000,10188041.png,221231,9752,211479,0.9559193783872966,2,4,41731,1375,40356,0.9670508734513911,11.024238222222221,1074.0035093333333,17.82074660433971,125,6.700000000000011E-4
4,test_20231101_135000,10287332.png,216980,12584,204396,0.942003871324546,2,4,22337,1727,20610,0.9226843354076196,9.448579555555556,778.9383466666667,19.21577276445775,125,6.700000000000011E-4
5,test_20231101_135000,11610969.png,368720,25697,343023,0.930307550444782,3,3,84111,3750,80361,0.9554160573527838,21.631701333333332,3001.576629333333,13.357309256291893,125,6.700000000000011E-4
6,test_20231101_135000,10350842.png,212614,6102,206512,0.9713001025332292,2,4,42529,894,41635,0.9789790495896917,19.318012444444445,2373.8444053333333,14.37628111337661,125,6.700000000000011E-4
7,test_20231101_135000,10863862.png,317432,12162,305270,0.9616862824163915,3,3,66058,1765,64293,0.9732810560416604,24.022609777777777,3308.937994666667,12.933917317637896,125,6.700000000000011E-4
8,test_20231101_135000,11382381.png,312486,767,311719,0.9975454900379537,1,4,46745,100,46645,0.9978607337683175,21.58402311111111,2479.723024,14.186771864393144,125,6.700000000000011E-4
9,test_20231101_135000,11079715.png,443815,120387,323428,0.7287450852269527,3,4,124136,16809,107327,0.8645920603209383,16.86984177777778,2095.0260693333335,14.918909294142013,125,6.700000000000011E-4
10,test_20231101_135000,11551286.png,271883,367,271516,0.9986501546621157,1,4,40092,52,40040,0.9987029831387808,18.002010666666667,1874.0560373333333,15.402977880083654,125,6.700000000000011E-4
1,test_20231101_135000,10404007.png,502730,21177,481553,0.9578759970560738,3,3,61265,3065,58200,0.9499714355668,25.765313777777777,3444.1170506666667,12.760024580413443,125,6.800000000000011E-4
2,test_20231101_135000,1254659.png,342646,74697,267949,0.7819994980241999,4,4,80080,10439,69641,0.8696428571428572,20.84253688888889,3163.838,13.12866122928261,125,6.800000000000011E-4
3,test_20231101_135000,10188041.png,221231,9752,211479,0.9559193783872966,4,13,41731,1375,40356,0.9670508734513911,11.024238222222221,1074.0035093333333,17.82074660433971,125,6.800000000000011E-4
4,test_20231101_135000,10287332.png,216980,12584,204396,0.942003871324546,2,3,22337,1727,20610,0.9226843354076196,9.448579555555556,778.9383466666667,19.21577276445775,125,6.800000000000011E-4
5,test_20231101_135000,11610969.png,368720,25697,343023,0.930307550444782,2,4,84111,3750,80361,0.9554160573527838,21.631701333333332,3001.576629333333,13.357309256291893,125,6.800000000000011E-4
6,test_20231101_135000,10350842.png,212614,6102,206512,0.9713001025332292,1,4,42529,894,41635,0.9789790495896917,19.318012444444445,2373.8444053333333,14.37628111337661,125,6.800000000000011E-4
7,test_20231101_135000,10863862.png,317432,12162,305270,0.9616862824163915,2,4,66058,1765,64293,0.9732810560416604,24.022609777777777,3308.937994666667,12.933917317637896,125,6.800000000000011E-4
8,test_20231101_135000,11382381.png,312486,767,311719,0.9975454900379537,2,3,46745,100,46645,0.9978607337683175,21.58402311111111,2479.723024,14.186771864393144,125,6.800000000000011E-4
9,test_20231101_135000,11079715.png,443815,120387,323428,0.7287450852269527,4,4,124136,16809,107327,0.8645920603209383,16.86984177777778,2095.0260693333335,14.918909294142013,125,6.800000000000011E-4
10,test_20231101_135000,11551286.png,271883,367,271516,0.9986501546621157,1,4,40092,52,40040,0.9987029831387808,18.002010666666667,1874.0560373333333,15.402977880083654,125,6.800000000000011E-4
1,test_20231101_135001,10404007.png,502730,21177,481553,0.9578759970560738,2,4,61265,3065,58200,0.9499714355668,25.765313777777777,3444.1170506666667,12.760024580413443,125,6.900000000000012E-4
2,test_20231101_135001,1254659.png,342646,74697,267949,0.7819994980241999,3,4,80080,10439,69641,0.8696428571428572,20.84253688888889,3163.838,13.12866122928261,125,6.900000000000012E-4
3,test_20231101_135001,10188041.png,221231,9752,211479,0.9559193783872966,2,3,41731,1375,40356,0.9670508734513911,11.024238222222221,1074.0035093333333,17.82074660433971,125,6.900000000000012E-4
4,test_20231101_135001,10287332.png,216980,12584,204396,0.942003871324546,1,3,22337,1727,20610,0.9226843354076196,9.448579555555556,778.9383466666667,19.21577276445775,125,6.900000000000012E-4
5,test_20231101_135001,11610969.png,368720,25697,343023,0.930307550444782,2,4,84111,3750,80361,0.9554160573527838,21.631701333333332,3001.576629333333,13.357309256291893,125,6.900000000000012E-4
6,test_20231101_135001,10350842.png,212614,6102,206512,0.9713001025332292,2,3,42529,894,41635,0.9789790495896917,19.318012444444445,2373.8444053333333,14.37628111337661,125,6.900000000000012E-4
7,test_20231101_135001,10863862.png,317432,12162,305270,0.9616862824163915,3,4,66058,1765,64293,0.9732810560416604,24.022609777777777,3308.937994666667,12.933917317637896,125,6.900000000000012E-4
8,test_20231101_135001,11382381.png,312486,767,311719,0.9975454900379537,1,4,46745,100,46645,0.9978607337683175,21.58402311111111,2479.723024,14.186771864393144,125,6.900000000000012E-4
9,test_20231101_135001,11079715.png,443815,120387,323428,0.7287450852269527,4,4,124136,16809,107327,0.8645920603209383,16.86984177777778,2095.0260693333335,14.918909294142013,125,6.900000000000012E-4
10,test_20231101_135001,11551286.png,271883,367,271516,0.9986501546621157,1,3,40092,52,40040,0.9987029831387808,18.002010666666667,1874.0560373333333,15.402977880083654,125,6.900000000000012E-4
1,test_20231101_135002,10404007.png,502730,21177,481553,0.9578759970560738,3,4,61265,3065,58200,0.9499714355668,25.765313777777777,3444.1170506666667,12.760024580413443,125,7.000000000000012E-4
2,test_20231101_135002,1254659.png,342646,74697,267949,0.7819994980241999,3,4,80080,10439,69641,0.8696428571428572,20.84253688888889,3163.838,13.12866122928261,125,7.000000000000012E-4
3,test_20231101_135002,10188041.png,221231,9752,211479,0.9559193783872966,2,4,41731,1375,40356,0.9670508734513911,11.024238222222221,1074.0035093333333,17.82074660433971,125,7.000000000000012E-4
4,test_20231101_135002,10287332.png,216980,12584,204396,0.942003871324546,2,3,22337,1727,20610,0.9226843354076196,9.448579555555556,778.9383466666667,19.21577276445775,125,7.000000000000012E-4
5,test_20231101_135002,11610969.png,368720,25697,343023,0.930307550444782,3,4,84111,3750,80361,0.9554160573527838,21.631701333333332,3001.576629333333,13.357309256291893,125,7.000000000000012E-4
6,test_20231101_135002,10350842.png,212614,6102,206512,0.9713001025332292,2,3,42529,894,41635,0.9789790495896917,19.318012444444445,2373.8444053333333,14.37628111337661,125,7.000000000000012E-4
7,test_20231101_135002,10863862.png,317432,12162,305270,0.9616862824163915,2,4,66058,1765,64293,0.9732810560416604,24.022609777777777,3308.937994666667,12.933917317637896,125,7.000000000000012E-4
8,test_20231101_135002,11382381.png,312486,767,311719,0.9975454900379537,2,4,46745,100,46645,0.9978607337683175,21.58402311111111,2479.723024,14.186771864393144,125,7.000000000000012E-4
9,test_20231101_135002,11079715.png,443815,120387,323428,0.7287450852269527,3,4,124136,16809,107327,0.8645920603209383,16.86984177777778,2095.0260693333335,14.918909294142013,125,7.000000000000012E-4
10,test_20231101_135002,11551286.png,271883,367,271516,0.9986501546621157,1,3,40092,52,40040,0.9987029831387808,18.002010666666667,1874.0560373333333,15.402977880083654,125,7.000000000000012E-4
1,test_20231101_135002,10404007.png,502730,20937,481793,0.9583533904879359,3,4,61265,3030,58235,0.9505427242308007,25.80952177777778,3452.553962666667,12.749398856360063,125,7.100000000000012E-4
2,test_20231101_135002,1254659.png,342646,74697,267949,0.7819994980241999,3,4,80080,10439,69641,0.8696428571428572,20.84253688888889,3163.838,13.12866122928261,125,7.100000000000012E-4
3,test_20231101_135002,10188041.png,221231,9752,211479,0.9559193783872966,2,4,41731,1375,40356,0.9670508734513911,11.024238222222221,1074.0035093333333,17.82074660433971,125,7.100000000000012E-4
4,test_20231101_135002,10287332.png,216980,12584,204396,0.942003871324546,2,4,22337,1727,20610,0.9226843354076196,9.448579555555556,778.9383466666667,19.21577276445775,125,7.100000000000012E-4
5,test_20231101_135002,11610969.png,368720,25697,343023,0.930307550444782,2,3,84111,3750,80361,0.9554160573527838,21.631701333333332,3001.576629333333,13.357309256291893,125,7.100000000000012E-4
6,test_20231101_135002,10350842.png,212614,6102,206512,0.9713001025332292,1,3,42529,894,41635,0.9789790495896917,19.318012444444445,2373.8444053333333,14.37628111337661,125,7.100000000000012E-4
7,test_20231101_135002,10863862.png,317432,12162,305270,0.9616862824163915,2,3,66058,1765,64293,0.9732810560416604,24.022609777777777,3308.937994666667,12.933917317637896,125,7.100000000000012E-4
8,test_20231101_135002,11382381.png,312486,767,311719,0.9975454900379537,1,4,46745,100,46645,0.9978607337683175,21.58402311111111,2479.723024,14.186771864393144,125,7.100000000000012E-4
9,test_20231101_135002,11079715.png,443815,120387,323428,0.7287450852269527,4,6,124136,16809,107327,0.8645920603209383,16.86984177777778,2095.0260693333335,14.918909294142013,125,7.100000000000012E-4
10,test_20231101_135002,11551286.png,271883,367,271516,0.9986501546621157,2,3,40092,52,40040,0.9987029831387808,18.002010666666667,1874.0560373333333,15.402977880083654,125,7.100000000000012E-4
1,test_20231101_135003,10404007.png,502730,20937,481793,0.9583533904879359,2,3,61265,3030,58235,0.9505427242308007,25.80952177777778,3452.553962666667,12.749398856360063,125,7.200000000000012E-4
2,test_20231101_135003,1254659.png,342646,74697,267949,0.7819994980241999,3,4,80080,10439,69641,0.8696428571428572,20.84253688888889,3163.838,13.12866122928261,125,7.200000000000012E-4
3,test_20231101_135003,10188041.png,221231,9752,211479,0.9559193783872966,2,3,41731,1375,40356,0.9670508734513911,11.024238222222221,1074.0035093333333,17.82074660433971,125,7.200000000000012E-4
4,test_20231101_135003,10287332.png,216980,12584,204396,0.942003871324546,2,3,22337,1727,20610,0.9226843354076196,9.448579555555556,778.9383466666667,19.21577276445775,125,7.200000000000012E-4
5,test_20231101_135003,11610969.png,368720,25697,343023,0.930307550444782,2,4,84111,3750,80361,0.9554160573527838,21.631701333333332,3001.576629333333,13.357309256291893,125,7.200000000000012E-4
6,test_20231101_135003,10350842.png,212614,6102,206512,0.9713001025332292,1,3,42529,894,41635,0.9789790495896917,19.318012444444445,2373.8444053333333,14.37628111337661,125,7.200000000000012E-4
7,test_20231101_135003,10863862.png,317432,12162,305270,0.9616862824163915,1,3,66058,1765,64293,0.9732810560416604,24.022609777777777,3308.937994666667,12.933917317637896,125,7.200000000000012E-4
8,test_20231101_135003,11382381.png,312486,767,311719,0.9975454900379537,1,4,46745,100,46645,0.9978607337683175,21.58402311111111,2479.723024,14.186771864393144,125,7.200000000000012E-4
9,test_20231101_135003,11079715.png,443815,120387,323428,0.7287450852269527,3,4,124136,16809,107327,0.8645920603209383,16.86984177777778,2095.0260693333335,14.918909294142013,125,7.200000000000012E-4
10,test_20231101_135003,11551286.png,271883,367,271516,0.9986501546621157,1,3,40092,52,40040,0.9987029831387808,18.002010666666667,1874.0560373333333,15.402977880083654,125,7.200000000000012E-4
1,test_20231101_135004,10404007.png,502730,20937,481793,0.9583533904879359,2,3,61265,3030,58235,0.9505427242308007,25.80952177777778,3452.553962666667,12.749398856360063,125,7.300000000000013E-4
2,test_20231101_135004,1254659.png,342646,74697,267949,0.7819994980241999,3,4,80080,10439,69641,0.8696428571428572,20.84253688888889,3163.838,13.12866122928261,125,7.300000000000013E-4
3,test_20231101_135004,10188041.png,221231,9752,211479,0.9559193783872966,2,3,41731,1375,40356,0.9670508734513911,11.024238222222221,1074.0035093333333,17.82074660433971,125,7.300000000000013E-4
4,test_20231101_135004,10287332.png,216980,12584,204396,0.942003871324546,2,4,22337,1727,20610,0.9226843354076196,9.448579555555556,778.9383466666667,19.21577276445775,125,7.300000000000013E-4
5,test_20231101_135004,11610969.png,368720,25697,343023,0.930307550444782,2,3,84111,3750,80361,0.9554160573527838,21.631701333333332,3001.576629333333,13.357309256291893,125,7.300000000000013E-4
6,test_20231101_135004,10350842.png,212614,6102,206512,0.9713001025332292,1,4,42529,894,41635,0.9789790495896917,19.318012444444445,2373.8444053333333,14.37628111337661,125,7.300000000000013E-4
7,test_20231101_135004,10863862.png,317432,12162,305270,0.9616862824163915,2,4,66058,1765,64293,0.9732810560416604,24.022609777777777,3308.937994666667,12.933917317637896,125,7.300000000000013E-4
8,test_20231101_135004,11382381.png,312486,767,311719,0.9975454900379537,1,3,46745,100,46645,0.9978607337683175,21.58402311111111,2479.723024,14.186771864393144,125,7.300000000000013E-4
9,test_20231101_135004,11079715.png,443815,120387,323428,0.7287450852269527,4,4,124136,16809,107327,0.8645920603209383,16.86984177777778,2095.0260693333335,14.918909294142013,125,7.300000000000013E-4
10,test_20231101_135004,11551286.png,271883,367,271516,0.9986501546621157,1,4,40092,52,40040,0.9987029831387808,18.002010666666667,1874.0560373333333,15.402977880083654,125,7.300000000000013E-4
1,test_20231101_135004,10404007.png,502730,20937,481793,0.9583533904879359,2,4,61265,3030,58235,0.9505427242308007,25.80952177777778,3452.553962666667,12.749398856360063,125,7.400000000000013E-4
2,test_20231101_135004,1254659.png,342646,74697,267949,0.7819994980241999,3,4,80080,10439,69641,0.8696428571428572,20.84253688888889,3163.838,13.12866122928261,125,7.400000000000013E-4
3,test_20231101_135004,10188041.png,221231,9752,211479,0.9559193783872966,2,4,41731,1375,40356,0.9670508734513911,11.024238222222221,1074.0035093333333,17.82074660433971,125,7.400000000000013E-4
4,test_20231101_135004,10287332.png,216980,12584,204396,0.942003871324546,2,4,22337,1727,20610,0.9226843354076196,9.448579555555556,778.9383466666667,19.21577276445775,125,7.400000000000013E-4
5,test_20231101_135004,11610969.png,368720,25697,343023,0.930307550444782,2,4,84111,3750,80361,0.9554160573527838,21.631701333333332,3001.576629333333,13.357309256291893,125,7.400000000000013E-4
6,test_20231101_135004,10350842.png,212614,6102,206512,0.9713001025332292,1,4,42529,894,41635,0.9789790495896917,19.318012444444445,2373.8444053333333,14.37628111337661,125,7.400000000000013E-4
7,test_20231101_135004,10863862.png,317432,12162,305270,0.9616862824163915,2,3,66058,1765,64293,0.9732810560416604,24.022609777777777,3308.937994666667,12.933917317637896,125,7.400000000000013E-4
8,test_20231101_135004,11382381.png,312486,767,311719,0.9975454900379537,2,3,46745,100,46645,0.9978607337683175,21.58402311111111,2479.723024,14.186771864393144,125,7.400000000000013E-4
9,test_20231101_135004,11079715.png,443815,120387,323428,0.7287450852269527,4,5,124136,16809,107327,0.8645920603209383,16.86984177777778,2095.0260693333335,14.918909294142013,125,7.400000000000013E-4
10,test_20231101_135004,11551286.png,271883,367,271516,0.9986501546621157,1,3,40092,52,40040,0.9987029831387808,18.002010666666667,1874.0560373333333,15.402977880083654,125,7.400000000000013E-4
1,test_20231101_135005,10404007.png,502730,20937,481793,0.9583533904879359,2,13,61265,3030,58235,0.9505427242308007,25.80952177777778,3452.553962666667,12.749398856360063,125,7.500000000000013E-4
2,test_20231101_135005,1254659.png,342646,74697,267949,0.7819994980241999,3,4,80080,10439,69641,0.8696428571428572,20.84253688888889,3163.838,13.12866122928261,125,7.500000000000013E-4
3,test_20231101_135005,10188041.png,221231,9752,211479,0.9559193783872966,2,4,41731,1375,40356,0.9670508734513911,11.024238222222221,1074.0035093333333,17.82074660433971,125,7.500000000000013E-4
4,test_20231101_135005,10287332.png,216980,12584,204396,0.942003871324546,2,4,22337,1727,20610,0.9226843354076196,9.448579555555556,778.9383466666667,19.21577276445775,125,7.500000000000013E-4
5,test_20231101_135005,11610969.png,368720,25697,343023,0.930307550444782,3,4,84111,3750,80361,0.9554160573527838,21.631701333333332,3001.576629333333,13.357309256291893,125,7.500000000000013E-4
6,test_20231101_135005,10350842.png,212614,6102,206512,0.9713001025332292,2,3,42529,894,41635,0.9789790495896917,19.318012444444445,2373.8444053333333,14.37628111337661,125,7.500000000000013E-4
7,test_20231101_135005,10863862.png,317432,12162,305270,0.9616862824163915,2,4,66058,1765,64293,0.9732810560416604,24.022609777777777,3308.937994666667,12.933917317637896,125,7.500000000000013E-4
8,test_20231101_135005,11382381.png,312486,767,311719,0.9975454900379537,1,4,46745,100,46645,0.9978607337683175,21.58402311111111,2479.723024,14.186771864393144,125,7.500000000000013E-4
9,test_20231101_135005,11079715.png,443815,120387,323428,0.7287450852269527,4,4,124136,16809,107327,0.8645920603209383,16.86984177777778,2095.0260693333335,14.918909294142013,125,7.500000000000013E-4
10,test_20231101_135005,11551286.png,271883,367,271516,0.9986501546621157,1,3,40092,52,40040,0.9987029831387808,18.002010666666667,1874.0560373333333,15.402977880083654,125,7.500000000000013E-4
1,test_20231101_135006,10404007.png,502730,20937,481793,0.9583533904879359,2,3,61265,3030,58235,0.9505427242308007,25.80952177777778,3452.553962666667,12.749398856360063,125,7.600000000000013E-4
2,test_20231101_135006,1254659.png,342646,74697,267949,0.7819994980241999,3,4,80080,10439,69641,0.8696428571428572,20.84253688888889,3163.838,13.12866122928261,125,7.600000000000013E-4
3,test_20231101_135006,10188041.png,221231,9632,211599,0.9564617978493068,2,4,41731,1357,40374,0.9674822074716638,11.119096888888889,1097.8743786666666,17.72527710893187,125,7.600000000000013E-4
4,test_20231101_135006,10287332.png,216980,12584,204396,0.942003871324546,2,4,22337,1727,20610,0.9226843354076196,9.448579555555556,778.9383466666667,19.21577276445775,125,7.600000000000013E-4
5,test_20231101_135006,11610969.png,368720,25697,343023,0.930307550444782,2,6,84111,3750,80361,0.9554160573527838,21.631701333333332,3001.576629333333,13.357309256291893,125,7.600000000000013E-4
6,test_20231101_135006,10350842.png,212614,6102,206512,0.9713001025332292,2,4,42529,894,41635,0.9789790495896917,19.318012444444445,2373.8444053333333,14.37628111337661,125,7.600000000000013E-4
7,test_20231101_135006,10863862.png,317432,12162,305270,0.9616862824163915,2,3,66058,1765,64293,0.9732810560416604,24.022609777777777,3308.937994666667,12.933917317637896,125,7.600000000000013E-4
8,test_20231101_135006,11382381.png,312486,767,311719,0.9975454900379537,1,3,46745,100,46645,0.9978607337683175,21.58402311111111,2479.723024,14.186771864393144,125,7.600000000000013E-4
9,test_20231101_135006,11079715.png,443815,120387,323428,0.7287450852269527,3,4,124136,16809,107327,0.8645920603209383,16.86984177777778,2095.0260693333335,14.918909294142013,125,7.600000000000013E-4
10,test_20231101_135006,11551286.png,271883,367,271516,0.9986501546621157,1,4,40092,52,40040,0.9987029831387808,18.002010666666667,1874.0560373333333,15.402977880083654,125,7.600000000000013E-4
1,test_20231101_135007,10404007.png,502730,20937,481793,0.9583533904879359,2,4,61265,3030,58235,0.9505427242308007,25.80952177777778,3452.553962666667,12.749398856360063,125,7.700000000000014E-4
2,test_20231101_135007,1254659.png,342646,74697,267949,0.7819994980241999,3,4,80080,10439,69641,0.8696428571428572,20.84253688888889,3163.838,13.12866122928261,125,7.700000000000014E-4
3,test_20231101_135007,10188041.png,221231,9632,211599,0.9564617978493068,2,4,41731,1357,40374,0.9674822074716638,11.119096888888889,1097.8743786666666,17.72527710893187,125,7.700000000000014E-4
4,test_20231101_135007,10287332.png,216980,12584,204396,0.942003871324546,2,4,22337,1727,20610,0.9226843354076196,9.448579555555556,778.9383466666667,19.21577276445775,125,7.700000000000014E-4
5,test_20231101_135007,11610969.png,368720,25697,343023,0.930307550444782,2,4,84111,3750,80361,0.9554160573527838,21.631701333333332,3001.576629333333,13.357309256291893,125,7.700000000000014E-4
6,test_20231101_135007,10350842.png,212614,6102,206512,0.9713001025332292,2,3,42529,894,41635,0.9789790495896917,19.318012444444445,2373.8444053333333,14.37628111337661,125,7.700000000000014E-4
7,test_20231101_135007,10863862.png,317432,12162,305270,0.9616862824163915,2,5,66058,1765,64293,0.9732810560416604,24.022609777777777,3308.937994666667,12.933917317637896,125,7.700000000000014E-4
8,test_20231101_135007,11382381.png,312486,767,311719,0.9975454900379537,2,4,46745,100,46645,0.9978607337683175,21.58402311111111,2479.723024,14.186771864393144,125,7.700000000000014E-4
9,test_20231101_135007,11079715.png,443815,120387,323428,0.7287450852269527,4,5,124136,16809,107327,0.8645920603209383,16.86984177777778,2095.0260693333335,14.918909294142013,125,7.700000000000014E-4
10,test_20231101_135007,11551286.png,271883,367,271516,0.9986501546621157,1,3,40092,52,40040,0.9987029831387808,18.002010666666667,1874.0560373333333,15.402977880083654,125,7.700000000000014E-4
1,test_20231101_135007,10404007.png,502730,20937,481793,0.9583533904879359,2,3,61265,3030,58235,0.9505427242308007,25.80952177777778,3452.553962666667,12.749398856360063,125,7.800000000000014E-4
2,test_20231101_135007,1254659.png,342646,74697,267949,0.7819994980241999,4,4,80080,10439,69641,0.8696428571428572,20.84253688888889,3163.838,13.12866122928261,125,7.800000000000014E-4
3,test_20231101_135007,10188041.png,221231,9632,211599,0.9564617978493068,2,3,41731,1357,40374,0.9674822074716638,11.119096888888889,1097.8743786666666,17.72527710893187,125,7.800000000000014E-4
4,test_20231101_135007,10287332.png,216980,12584,204396,0.942003871324546,2,4,22337,1727,20610,0.9226843354076196,9.448579555555556,778.9383466666667,19.21577276445775,125,7.800000000000014E-4
5,test_20231101_135007,11610969.png,368720,25697,343023,0.930307550444782,3,4,84111,3750,80361,0.9554160573527838,21.631701333333332,3001.576629333333,13.357309256291893,125,7.800000000000014E-4
6,test_20231101_135007,10350842.png,212614,6102,206512,0.9713001025332292,2,4,42529,894,41635,0.9789790495896917,19.318012444444445,2373.8444053333333,14.37628111337661,125,7.800000000000014E-4
7,test_20231101_135007,10863862.png,317432,12162,305270,0.9616862824163915,2,3,66058,1765,64293,0.9732810560416604,24.022609777777777,3308.937994666667,12.933917317637896,125,7.800000000000014E-4
8,test_20231101_135007,11382381.png,312486,767,311719,0.9975454900379537,2,3,46745,100,46645,0.9978607337683175,21.58402311111111,2479.723024,14.186771864393144,125,7.800000000000014E-4
9,test_20231101_135007,11079715.png,443815,120387,323428,0.7287450852269527,3,4,124136,16809,107327,0.8645920603209383,16.86984177777778,2095.0260693333335,14.918909294142013,125,7.800000000000014E-4
10,test_20231101_135007,11551286.png,271883,367,271516,0.9986501546621157,1,4,40092,52,40040,0.9987029831387808,18.002010666666667,1874.0560373333333,15.402977880083654,125,7.800000000000014E-4
1,test_20231101_135008,10404007.png,502730,20937,481793,0.9583533904879359,3,4,61265,3030,58235,0.9505427242308007,25.80952177777778,3452.553962666667,12.749398856360063,125,7.900000000000014E-4
2,test_20231101_135008,1254659.png,342646,74697,267949,0.7819994980241999,3,4,80080,10439,69641,0.8696428571428572,20.84253688888889,3163.838,13.12866122928261,125,7.900000000000014E-4
3,test_20231101_135008,10188041.png,221231,9632,211599,0.9564617978493068,2,4,41731,1357,40374,0.9674822074716638,11.119096888888889,1097.8743786666666,17.72527710893187,125,7.900000000000014E-4
4,test_20231101_135008,10287332.png,216980,12584,204396,0.942003871324546,2,3,22337,1727,20610,0.9226843354076196,9.448579555555556,778.9383466666667,19.21577276445775,125,7.900000000000014E-4
5,test_20231101_135008,11610969.png,368720,25697,343023,0.930307550444782,2,3,84111,3750,80361,0.9554160573527838,21.631701333333332,3001.576629333333,13.357309256291893,125,7.900000000000014E-4
6,test_20231101_135008,10350842.png,212614,6102,206512,0.9713001025332292,1,10,42529,894,41635,0.9789790495896917,19.318012444444445,2373.8444053333333,14.37628111337661,125,7.900000000000014E-4
7,test_20231101_135008,10863862.png,317432,12162,305270,0.9616862824163915,2,4,66058,1765,64293,0.9732810560416604,24.022609777777777,3308.937994666667,12.933917317637896,125,7.900000000000014E-4
8,test_20231101_135008,11382381.png,312486,767,311719,0.9975454900379537,2,3,46745,100,46645,0.9978607337683175,21.58402311111111,2479.723024,14.186771864393144,125,7.900000000000014E-4
9,test_20231101_135008,11079715.png,443815,120387,323428,0.7287450852269527,3,4,124136,16809,107327,0.8645920603209383,16.86984177777778,2095.0260693333335,14.918909294142013,125,7.900000000000014E-4
10,test_20231101_135008,11551286.png,271883,367,271516,0.9986501546621157,1,4,40092,52,40040,0.9987029831387808,18.002010666666667,1874.0560373333333,15.402977880083654,125,7.900000000000014E-4
1,test_20231101_135009,10404007.png,502730,20937,481793,0.9583533904879359,2,4,61265,3030,58235,0.9505427242308007,25.80952177777778,3452.553962666667,12.749398856360063,125,8.000000000000014E-4
2,test_20231101_135009,1254659.png,342646,74697,267949,0.7819994980241999,3,4,80080,10439,69641,0.8696428571428572,20.84253688888889,3163.838,13.12866122928261,125,8.000000000000014E-4
3,test_20231101_135009,10188041.png,221231,9632,211599,0.9564617978493068,2,4,41731,1357,40374,0.9674822074716638,11.119096888888889,1097.8743786666666,17.72527710893187,125,8.000000000000014E-4
4,test_20231101_135009,10287332.png,216980,12584,204396,0.942003871324546,1,3,22337,1727,20610,0.9226843354076196,9.448579555555556,778.9383466666667,19.21577276445775,125,8.000000000000014E-4
5,test_20231101_135009,11610969.png,368720,25697,343023,0.930307550444782,2,4,84111,3750,80361,0.9554160573527838,21.631701333333332,3001.576629333333,13.357309256291893,125,8.000000000000014E-4
6,test_20231101_135009,10350842.png,212614,6102,206512,0.9713001025332292,1,3,42529,894,41635,0.9789790495896917,19.318012444444445,2373.8444053333333,14.37628111337661,125,8.000000000000014E-4
7,test_20231101_135009,10863862.png,317432,12162,305270,0.9616862824163915,2,4,66058,1765,64293,0.9732810560416604,24.022609777777777,3308.937994666667,12.933917317637896,125,8.000000000000014E-4
8,test_20231101_135009,11382381.png,312486,767,311719,0.9975454900379537,1,4,46745,100,46645,0.9978607337683175,21.58402311111111,2479.723024,14.186771864393144,125,8.000000000000014E-4
9,test_20231101_135009,11079715.png,443815,120387,323428,0.7287450852269527,4,4,124136,16809,107327,0.8645920603209383,16.86984177777778,2095.0260693333335,14.918909294142013,125,8.000000000000014E-4
10,test_20231101_135009,11551286.png,271883,367,271516,0.9986501546621157,2,3,40092,52,40040,0.9987029831387808,18.002010666666667,1874.0560373333333,15.402977880083654,125,8.000000000000014E-4
1,test_20231101_135009,10404007.png,502730,20937,481793,0.9583533904879359,3,3,61265,3030,58235,0.9505427242308007,25.80952177777778,3452.553962666667,12.749398856360063,125,8.100000000000015E-4
2,test_20231101_135009,1254659.png,342646,74697,267949,0.7819994980241999,3,3,80080,10439,69641,0.8696428571428572,20.84253688888889,3163.838,13.12866122928261,125,8.100000000000015E-4
3,test_20231101_135009,10188041.png,221231,9632,211599,0.9564617978493068,2,4,41731,1357,40374,0.9674822074716638,11.119096888888889,1097.8743786666666,17.72527710893187,125,8.100000000000015E-4
4,test_20231101_135009,10287332.png,216980,12584,204396,0.942003871324546,1,3,22337,1727,20610,0.9226843354076196,9.448579555555556,778.9383466666667,19.21577276445775,125,8.100000000000015E-4
5,test_20231101_135009,11610969.png,368720,25697,343023,0.930307550444782,3,4,84111,3750,80361,0.9554160573527838,21.631701333333332,3001.576629333333,13.357309256291893,125,8.100000000000015E-4
6,test_20231101_135009,10350842.png,212614,6102,206512,0.9713001025332292,1,3,42529,894,41635,0.9789790495896917,19.318012444444445,2373.8444053333333,14.37628111337661,125,8.100000000000015E-4
7,test_20231101_135009,10863862.png,317432,12162,305270,0.9616862824163915,2,4,66058,1765,64293,0.9732810560416604,24.022609777777777,3308.937994666667,12.933917317637896,125,8.100000000000015E-4
8,test_20231101_135009,11382381.png,312486,767,311719,0.9975454900379537,1,3,46745,100,46645,0.9978607337683175,21.58402311111111,2479.723024,14.186771864393144,125,8.100000000000015E-4
9,test_20231101_135009,11079715.png,443815,120387,323428,0.7287450852269527,3,4,124136,16809,107327,0.8645920603209383,16.86984177777778,2095.0260693333335,14.918909294142013,125,8.100000000000015E-4
10,test_20231101_135009,11551286.png,271883,367,271516,0.9986501546621157,1,4,40092,52,40040,0.9987029831387808,18.002010666666667,1874.0560373333333,15.402977880083654,125,8.100000000000015E-4
1,test_20231101_135010,10404007.png,502730,20937,481793,0.9583533904879359,3,3,61265,3030,58235,0.9505427242308007,25.80952177777778,3452.553962666667,12.749398856360063,125,8.200000000000015E-4
2,test_20231101_135010,1254659.png,342646,74697,267949,0.7819994980241999,2,4,80080,10439,69641,0.8696428571428572,20.84253688888889,3163.838,13.12866122928261,125,8.200000000000015E-4
3,test_20231101_135010,10188041.png,221231,9632,211599,0.9564617978493068,2,3,41731,1357,40374,0.9674822074716638,11.119096888888889,1097.8743786666666,17.72527710893187,125,8.200000000000015E-4
4,test_20231101_135010,10287332.png,216980,12584,204396,0.942003871324546,2,3,22337,1727,20610,0.9226843354076196,9.448579555555556,778.9383466666667,19.21577276445775,125,8.200000000000015E-4
5,test_20231101_135010,11610969.png,368720,25697,343023,0.930307550444782,2,4,84111,3750,80361,0.9554160573527838,21.631701333333332,3001.576629333333,13.357309256291893,125,8.200000000000015E-4
6,test_20231101_135010,10350842.png,212614,6102,206512,0.9713001025332292,2,4,42529,894,41635,0.9789790495896917,19.318012444444445,2373.8444053333333,14.37628111337661,125,8.200000000000015E-4
7,test_20231101_135010,10863862.png,317432,12162,305270,0.9616862824163915,2,4,66058,1765,64293,0.9732810560416604,24.022609777777777,3308.937994666667,12.933917317637896,125,8.200000000000015E-4
8,test_20231101_135010,11382381.png,312486,767,311719,0.9975454900379537,1,3,46745,100,46645,0.9978607337683175,21.58402311111111,2479.723024,14.186771864393144,125,8.200000000000015E-4
9,test_20231101_135010,11079715.png,443815,120387,323428,0.7287450852269527,3,4,124136,16809,107327,0.8645920603209383,16.86984177777778,2095.0260693333335,14.918909294142013,125,8.200000000000015E-4
10,test_20231101_135010,11551286.png,271883,367,271516,0.9986501546621157,1,4,40092,52,40040,0.9987029831387808,18.002010666666667,1874.0560373333333,15.402977880083654,125,8.200000000000015E-4
1,test_20231101_135011,10404007.png,502730,20937,481793,0.9583533904879359,3,3,61265,3030,58235,0.9505427242308007,25.80952177777778,3452.553962666667,12.749398856360063,125,8.300000000000015E-4
2,test_20231101_135011,1254659.png,342646,74697,267949,0.7819994980241999,3,3,80080,10439,69641,0.8696428571428572,20.84253688888889,3163.838,13.12866122928261,125,8.300000000000015E-4
3,test_20231101_135011,10188041.png,221231,9632,211599,0.9564617978493068,2,4,41731,1357,40374,0.9674822074716638,11.119096888888889,1097.8743786666666,17.72527710893187,125,8.300000000000015E-4
4,test_20231101_135011,10287332.png,216980,12584,204396,0.942003871324546,1,4,22337,1727,20610,0.9226843354076196,9.448579555555556,778.9383466666667,19.21577276445775,125,8.300000000000015E-4
5,test_20231101_135011,11610969.png,368720,25697,343023,0.930307550444782,2,4,84111,3750,80361,0.9554160573527838,21.631701333333332,3001.576629333333,13.357309256291893,125,8.300000000000015E-4
6,test_20231101_135011,10350842.png,212614,6102,206512,0.9713001025332292,1,4,42529,894,41635,0.9789790495896917,19.318012444444445,2373.8444053333333,14.37628111337661,125,8.300000000000015E-4
7,test_20231101_135011,10863862.png,317432,12162,305270,0.9616862824163915,2,3,66058,1765,64293,0.9732810560416604,24.022609777777777,3308.937994666667,12.933917317637896,125,8.300000000000015E-4
8,test_20231101_135011,11382381.png,312486,767,311719,0.9975454900379537,2,3,46745,100,46645,0.9978607337683175,21.58402311111111,2479.723024,14.186771864393144,125,8.300000000000015E-4
9,test_20231101_135011,11079715.png,443815,120387,323428,0.7287450852269527,3,4,124136,16809,107327,0.8645920603209383,16.86984177777778,2095.0260693333335,14.918909294142013,125,8.300000000000015E-4
10,test_20231101_135011,11551286.png,271883,367,271516,0.9986501546621157,2,4,40092,52,40040,0.9987029831387808,18.002010666666667,1874.0560373333333,15.402977880083654,125,8.300000000000015E-4
1,test_20231101_135011,10404007.png,502730,20937,481793,0.9583533904879359,2,4,61265,3030,58235,0.9505427242308007,25.80952177777778,3452.553962666667,12.749398856360063,125,8.400000000000016E-4
2,test_20231101_135011,1254659.png,342646,74697,267949,0.7819994980241999,2,4,80080,10439,69641,0.8696428571428572,20.84253688888889,3163.838,13.12866122928261,125,8.400000000000016E-4
3,test_20231101_135011,10188041.png,221231,9632,211599,0.9564617978493068,1,3,41731,1357,40374,0.9674822074716638,11.119096888888889,1097.8743786666666,17.72527710893187,125,8.400000000000016E-4
4,test_20231101_135011,10287332.png,216980,12584,204396,0.942003871324546,2,4,22337,1727,20610,0.9226843354076196,9.448579555555556,778.9383466666667,19.21577276445775,125,8.400000000000016E-4
5,test_20231101_135011,11610969.png,368720,25697,343023,0.930307550444782,2,4,84111,3750,80361,0.9554160573527838,21.631701333333332,3001.576629333333,13.357309256291893,125,8.400000000000016E-4
6,test_20231101_135011,10350842.png,212614,6102,206512,0.9713001025332292,2,3,42529,894,41635,0.9789790495896917,19.318012444444445,2373.8444053333333,14.37628111337661,125,8.400000000000016E-4
7,test_20231101_135011,10863862.png,317432,12162,305270,0.9616862824163915,2,4,66058,1765,64293,0.9732810560416604,24.022609777777777,3308.937994666667,12.933917317637896,125,8.400000000000016E-4
8,test_20231101_135011,11382381.png,312486,767,311719,0.9975454900379537,2,4,46745,100,46645,0.9978607337683175,21.58402311111111,2479.723024,14.186771864393144,125,8.400000000000016E-4
9,test_20231101_135011,11079715.png,443815,120387,323428,0.7287450852269527,4,4,124136,16809,107327,0.8645920603209383,16.86984177777778,2095.0260693333335,14.918909294142013,125,8.400000000000016E-4
10,test_20231101_135011,11551286.png,271883,367,271516,0.9986501546621157,1,3,40092,52,40040,0.9987029831387808,18.002010666666667,1874.0560373333333,15.402977880083654,125,8.400000000000016E-4
1,test_20231101_135012,10404007.png,502730,20937,481793,0.9583533904879359,2,4,61265,3030,58235,0.9505427242308007,25.80952177777778,3452.553962666667,12.749398856360063,125,8.500000000000016E-4
2,test_20231101_135012,1254659.png,342646,74697,267949,0.7819994980241999,3,4,80080,10439,69641,0.8696428571428572,20.84253688888889,3163.838,13.12866122928261,125,8.500000000000016E-4
3,test_20231101_135012,10188041.png,221231,9632,211599,0.9564617978493068,2,3,41731,1357,40374,0.9674822074716638,11.119096888888889,1097.8743786666666,17.72527710893187,125,8.500000000000016E-4
4,test_20231101_135012,10287332.png,216980,12584,204396,0.942003871324546,2,4,22337,1727,20610,0.9226843354076196,9.448579555555556,778.9383466666667,19.21577276445775,125,8.500000000000016E-4
5,test_20231101_135012,11610969.png,368720,25697,343023,0.930307550444782,2,4,84111,3750,80361,0.9554160573527838,21.631701333333332,3001.576629333333,13.357309256291893,125,8.500000000000016E-4
6,test_20231101_135012,10350842.png,212614,6102,206512,0.9713001025332292,2,4,42529,894,41635,0.9789790495896917,19.318012444444445,2373.8444053333333,14.37628111337661,125,8.500000000000016E-4
7,test_20231101_135012,10863862.png,317432,12162,305270,0.9616862824163915,3,3,66058,1765,64293,0.9732810560416604,24.022609777777777,3308.937994666667,12.933917317637896,125,8.500000000000016E-4
8,test_20231101_135012,11382381.png,312486,767,311719,0.9975454900379537,2,4,46745,100,46645,0.9978607337683175,21.58402311111111,2479.723024,14.186771864393144,125,8.500000000000016E-4
9,test_20231101_135012,11079715.png,443815,120387,323428,0.7287450852269527,4,4,124136,16809,107327,0.8645920603209383,16.86984177777778,2095.0260693333335,14.918909294142013,125,8.500000000000016E-4
10,test_20231101_135012,11551286.png,271883,367,271516,0.9986501546621157,1,3,40092,52,40040,0.9987029831387808,18.002010666666667,1874.0560373333333,15.402977880083654,125,8.500000000000016E-4
1,test_20231101_135013,10404007.png,502730,20937,481793,0.9583533904879359,2,3,61265,3030,58235,0.9505427242308007,25.80952177777778,3452.553962666667,12.749398856360063,125,8.600000000000016E-4
2,test_20231101_135013,1254659.png,342646,74697,267949,0.7819994980241999,3,4,80080,10439,69641,0.8696428571428572,20.84253688888889,3163.838,13.12866122928261,125,8.600000000000016E-4
3,test_20231101_135013,10188041.png,221231,9632,211599,0.9564617978493068,2,3,41731,1357,40374,0.9674822074716638,11.119096888888889,1097.8743786666666,17.72527710893187,125,8.600000000000016E-4
4,test_20231101_135013,10287332.png,216980,12584,204396,0.942003871324546,2,3,22337,1727,20610,0.9226843354076196,9.448579555555556,778.9383466666667,19.21577276445775,125,8.600000000000016E-4
5,test_20231101_135013,11610969.png,368720,25697,343023,0.930307550444782,3,3,84111,3750,80361,0.9554160573527838,21.631701333333332,3001.576629333333,13.357309256291893,125,8.600000000000016E-4
6,test_20231101_135013,10350842.png,212614,6102,206512,0.9713001025332292,1,4,42529,894,41635,0.9789790495896917,19.318012444444445,2373.8444053333333,14.37628111337661,125,8.600000000000016E-4
7,test_20231101_135013,10863862.png,317432,12162,305270,0.9616862824163915,2,4,66058,1765,64293,0.9732810560416604,24.022609777777777,3308.937994666667,12.933917317637896,125,8.600000000000016E-4
8,test_20231101_135013,11382381.png,312486,767,311719,0.9975454900379537,1,3,46745,100,46645,0.9978607337683175,21.58402311111111,2479.723024,14.186771864393144,125,8.600000000000016E-4
9,test_20231101_135013,11079715.png,443815,120387,323428,0.7287450852269527,4,5,124136,16809,107327,0.8645920603209383,16.86984177777778,2095.0260693333335,14.918909294142013,125,8.600000000000016E-4
10,test_20231101_135013,11551286.png,271883,367,271516,0.9986501546621157,2,3,40092,52,40040,0.9987029831387808,18.002010666666667,1874.0560373333333,15.402977880083654,125,8.600000000000016E-4
1,test_20231101_135013,10404007.png,502730,20937,481793,0.9583533904879359,2,4,61265,3030,58235,0.9505427242308007,25.80952177777778,3452.553962666667,12.749398856360063,125,8.700000000000016E-4
2,test_20231101_135013,1254659.png,342646,74697,267949,0.7819994980241999,5,4,80080,10439,69641,0.8696428571428572,20.84253688888889,3163.838,13.12866122928261,125,8.700000000000016E-4
3,test_20231101_135013,10188041.png,221231,9632,211599,0.9564617978493068,2,4,41731,1357,40374,0.9674822074716638,11.119096888888889,1097.8743786666666,17.72527710893187,125,8.700000000000016E-4
4,test_20231101_135013,10287332.png,216980,12584,204396,0.942003871324546,2,4,22337,1727,20610,0.9226843354076196,9.448579555555556,778.9383466666667,19.21577276445775,125,8.700000000000016E-4
5,test_20231101_135013,11610969.png,368720,25697,343023,0.930307550444782,3,4,84111,3750,80361,0.9554160573527838,21.631701333333332,3001.576629333333,13.357309256291893,125,8.700000000000016E-4
6,test_20231101_135013,10350842.png,212614,6102,206512,0.9713001025332292,2,3,42529,894,41635,0.9789790495896917,19.318012444444445,2373.8444053333333,14.37628111337661,125,8.700000000000016E-4
7,test_20231101_135013,10863862.png,317432,12162,305270,0.9616862824163915,3,3,66058,1765,64293,0.9732810560416604,24.022609777777777,3308.937994666667,12.933917317637896,125,8.700000000000016E-4
8,test_20231101_135013,11382381.png,312486,767,311719,0.9975454900379537,2,4,46745,100,46645,0.9978607337683175,21.58402311111111,2479.723024,14.186771864393144,125,8.700000000000016E-4
9,test_20231101_135013,11079715.png,443815,120387,323428,0.7287450852269527,4,4,124136,16809,107327,0.8645920603209383,16.86984177777778,2095.0260693333335,14.918909294142013,125,8.700000000000016E-4
10,test_20231101_135013,11551286.png,271883,367,271516,0.9986501546621157,1,3,40092,52,40040,0.9987029831387808,18.002010666666667,1874.0560373333333,15.402977880083654,125,8.700000000000016E-4
1,test_20231101_135014,10404007.png,502730,20937,481793,0.9583533904879359,3,4,61265,3030,58235,0.9505427242308007,25.80952177777778,3452.553962666667,12.749398856360063,125,8.800000000000017E-4
2,test_20231101_135014,1254659.png,342646,74697,267949,0.7819994980241999,3,4,80080,10439,69641,0.8696428571428572,20.84253688888889,3163.838,13.12866122928261,125,8.800000000000017E-4
3,test_20231101_135014,10188041.png,221231,9632,211599,0.9564617978493068,2,4,41731,1357,40374,0.9674822074716638,11.119096888888889,1097.8743786666666,17.72527710893187,125,8.800000000000017E-4
4,test_20231101_135014,10287332.png,216980,12584,204396,0.942003871324546,2,3,22337,1727,20610,0.9226843354076196,9.448579555555556,778.9383466666667,19.21577276445775,125,8.800000000000017E-4
5,test_20231101_135014,11610969.png,368720,25697,343023,0.930307550444782,2,3,84111,3750,80361,0.9554160573527838,21.631701333333332,3001.576629333333,13.357309256291893,125,8.800000000000017E-4
6,test_20231101_135014,10350842.png,212614,6102,206512,0.9713001025332292,2,4,42529,894,41635,0.9789790495896917,19.318012444444445,2373.8444053333333,14.37628111337661,125,8.800000000000017E-4
7,test_20231101_135014,10863862.png,317432,12162,305270,0.9616862824163915,4,4,66058,1765,64293,0.9732810560416604,24.022609777777777,3308.937994666667,12.933917317637896,125,8.800000000000017E-4
8,test_20231101_135014,11382381.png,312486,767,311719,0.9975454900379537,1,3,46745,100,46645,0.9978607337683175,21.58402311111111,2479.723024,14.186771864393144,125,8.800000000000017E-4
9,test_20231101_135014,11079715.png,443815,120387,323428,0.7287450852269527,4,4,124136,16809,107327,0.8645920603209383,16.86984177777778,2095.0260693333335,14.918909294142013,125,8.800000000000017E-4
10,test_20231101_135014,11551286.png,271883,367,271516,0.9986501546621157,1,4,40092,52,40040,0.9987029831387808,18.002010666666667,1874.0560373333333,15.402977880083654,125,8.800000000000017E-4
1,test_20231101_135015,10404007.png,502730,20937,481793,0.9583533904879359,2,4,61265,3030,58235,0.9505427242308007,25.80952177777778,3452.553962666667,12.749398856360063,125,8.900000000000017E-4
2,test_20231101_135015,1254659.png,342646,74697,267949,0.7819994980241999,3,4,80080,10439,69641,0.8696428571428572,20.84253688888889,3163.838,13.12866122928261,125,8.900000000000017E-4
3,test_20231101_135015,10188041.png,221231,9632,211599,0.9564617978493068,1,3,41731,1357,40374,0.9674822074716638,11.119096888888889,1097.8743786666666,17.72527710893187,125,8.900000000000017E-4
4,test_20231101_135015,10287332.png,216980,12584,204396,0.942003871324546,2,4,22337,1727,20610,0.9226843354076196,9.448579555555556,778.9383466666667,19.21577276445775,125,8.900000000000017E-4
5,test_20231101_135015,11610969.png,368720,25697,343023,0.930307550444782,2,4,84111,3750,80361,0.9554160573527838,21.631701333333332,3001.576629333333,13.357309256291893,125,8.900000000000017E-4
6,test_20231101_135015,10350842.png,212614,6102,206512,0.9713001025332292,1,3,42529,894,41635,0.9789790495896917,19.318012444444445,2373.8444053333333,14.37628111337661,125,8.900000000000017E-4
7,test_20231101_135015,10863862.png,317432,12162,305270,0.9616862824163915,2,10,66058,1765,64293,0.9732810560416604,24.022609777777777,3308.937994666667,12.933917317637896,125,8.900000000000017E-4
8,test_20231101_135015,11382381.png,312486,767,311719,0.9975454900379537,2,3,46745,100,46645,0.9978607337683175,21.58402311111111,2479.723024,14.186771864393144,125,8.900000000000017E-4
9,test_20231101_135015,11079715.png,443815,120387,323428,0.7287450852269527,3,5,124136,16809,107327,0.8645920603209383,16.86984177777778,2095.0260693333335,14.918909294142013,125,8.900000000000017E-4
10,test_20231101_135015,11551286.png,271883,367,271516,0.9986501546621157,1,4,40092,52,40040,0.9987029831387808,18.002010666666667,1874.0560373333333,15.402977880083654,125,8.900000000000017E-4
1,test_20231101_135015,10404007.png,502730,20937,481793,0.9583533904879359,2,3,61265,3030,58235,0.9505427242308007,25.80952177777778,3452.553962666667,12.749398856360063,125,9.000000000000017E-4
2,test_20231101_135015,1254659.png,342646,74697,267949,0.7819994980241999,3,4,80080,10439,69641,0.8696428571428572,20.84253688888889,3163.838,13.12866122928261,125,9.000000000000017E-4
3,test_20231101_135015,10188041.png,221231,9532,211699,0.9569138140676487,2,3,41731,1346,40385,0.9677458004840527,11.166584888888888,1103.081408,17.704727960790887,125,9.000000000000017E-4
4,test_20231101_135015,10287332.png,216980,12584,204396,0.942003871324546,2,4,22337,1727,20610,0.9226843354076196,9.448579555555556,778.9383466666667,19.21577276445775,125,9.000000000000017E-4
5,test_20231101_135015,11610969.png,368720,25697,343023,0.930307550444782,3,3,84111,3750,80361,0.9554160573527838,21.631701333333332,3001.576629333333,13.357309256291893,125,9.000000000000017E-4
6,test_20231101_135015,10350842.png,212614,6102,206512,0.9713001025332292,1,4,42529,894,41635,0.9789790495896917,19.318012444444445,2373.8444053333333,14.37628111337661,125,9.000000000000017E-4
7,test_20231101_135015,10863862.png,317432,12162,305270,0.9616862824163915,2,3,66058,1765,64293,0.9732810560416604,24.022609777777777,3308.937994666667,12.933917317637896,125,9.000000000000017E-4
8,test_20231101_135015,11382381.png,312486,767,311719,0.9975454900379537,2,3,46745,100,46645,0.9978607337683175,21.58402311111111,2479.723024,14.186771864393144,125,9.000000000000017E-4
9,test_20231101_135015,11079715.png,443815,120387,323428,0.7287450852269527,3,4,124136,16809,107327,0.8645920603209383,16.86984177777778,2095.0260693333335,14.918909294142013,125,9.000000000000017E-4
10,test_20231101_135015,11551286.png,271883,367,271516,0.9986501546621157,2,3,40092,52,40040,0.9987029831387808,18.002010666666667,1874.0560373333333,15.402977880083654,125,9.000000000000017E-4
1,test_20231101_135016,10404007.png,502730,20937,481793,0.9583533904879359,3,3,61265,3030,58235,0.9505427242308007,25.80952177777778,3452.553962666667,12.749398856360063,125,9.100000000000017E-4
2,test_20231101_135016,1254659.png,342646,74697,267949,0.7819994980241999,3,4,80080,10439,69641,0.8696428571428572,20.84253688888889,3163.838,13.12866122928261,125,9.100000000000017E-4
3,test_20231101_135016,10188041.png,221231,9532,211699,0.9569138140676487,2,4,41731,1346,40385,0.9677458004840527,11.166584888888888,1103.081408,17.704727960790887,125,9.100000000000017E-4
4,test_20231101_135016,10287332.png,216980,12584,204396,0.942003871324546,1,3,22337,1727,20610,0.9226843354076196,9.448579555555556,778.9383466666667,19.21577276445775,125,9.100000000000017E-4
5,test_20231101_135016,11610969.png,368720,25697,343023,0.930307550444782,2,4,84111,3750,80361,0.9554160573527838,21.631701333333332,3001.576629333333,13.357309256291893,125,9.100000000000017E-4
6,test_20231101_135016,10350842.png,212614,6102,206512,0.9713001025332292,1,3,42529,894,41635,0.9789790495896917,19.318012444444445,2373.8444053333333,14.37628111337661,125,9.100000000000017E-4
7,test_20231101_135016,10863862.png,317432,12162,305270,0.9616862824163915,2,4,66058,1765,64293,0.9732810560416604,24.022609777777777,3308.937994666667,12.933917317637896,125,9.100000000000017E-4
8,test_20231101_135016,11382381.png,312486,767,311719,0.9975454900379537,2,4,46745,100,46645,0.9978607337683175,21.58402311111111,2479.723024,14.186771864393144,125,9.100000000000017E-4
9,test_20231101_135016,11079715.png,443815,120387,323428,0.7287450852269527,4,4,124136,16809,107327,0.8645920603209383,16.86984177777778,2095.0260693333335,14.918909294142013,125,9.100000000000017E-4
10,test_20231101_135016,11551286.png,271883,367,271516,0.9986501546621157,1,4,40092,52,40040,0.9987029831387808,18.002010666666667,1874.0560373333333,15.402977880083654,125,9.100000000000017E-4
1,test_20231101_135017,10404007.png,502730,20937,481793,0.9583533904879359,2,4,61265,3030,58235,0.9505427242308007,25.80952177777778,3452.553962666667,12.749398856360063,125,9.200000000000018E-4
2,test_20231101_135017,1254659.png,342646,74697,267949,0.7819994980241999,3,4,80080,10439,69641,0.8696428571428572,20.84253688888889,3163.838,13.12866122928261,125,9.200000000000018E-4
3,test_20231101_135017,10188041.png,221231,9532,211699,0.9569138140676487,2,3,41731,1346,40385,0.9677458004840527,11.166584888888888,1103.081408,17.704727960790887,125,9.200000000000018E-4
4,test_20231101_135017,10287332.png,216980,12584,204396,0.942003871324546,1,3,22337,1727,20610,0.9226843354076196,9.448579555555556,778.9383466666667,19.21577276445775,125,9.200000000000018E-4
5,test_20231101_135017,11610969.png,368720,25697,343023,0.930307550444782,2,4,84111,3750,80361,0.9554160573527838,21.631701333333332,3001.576629333333,13.357309256291893,125,9.200000000000018E-4
6,test_20231101_135017,10350842.png,212614,6102,206512,0.9713001025332292,2,4,42529,894,41635,0.9789790495896917,19.318012444444445,2373.8444053333333,14.37628111337661,125,9.200000000000018E-4
7,test_20231101_135017,10863862.png,317432,12162,305270,0.9616862824163915,2,3,66058,1765,64293,0.9732810560416604,24.022609777777777,3308.937994666667,12.933917317637896,125,9.200000000000018E-4
8,test_20231101_135017,11382381.png,312486,767,311719,0.9975454900379537,2,4,46745,100,46645,0.9978607337683175,21.58402311111111,2479.723024,14.186771864393144,125,9.200000000000018E-4
9,test_20231101_135017,11079715.png,443815,120387,323428,0.7287450852269527,3,4,124136,16809,107327,0.8645920603209383,16.86984177777778,2095.0260693333335,14.918909294142013,125,9.200000000000018E-4
10,test_20231101_135017,11551286.png,271883,367,271516,0.9986501546621157,2,3,40092,52,40040,0.9987029831387808,18.002010666666667,1874.0560373333333,15.402977880083654,125,9.200000000000018E-4
1,test_20231101_135017,10404007.png,502730,20937,481793,0.9583533904879359,3,3,61265,3030,58235,0.9505427242308007,25.80952177777778,3452.553962666667,12.749398856360063,125,9.300000000000018E-4
2,test_20231101_135017,1254659.png,342646,74697,267949,0.7819994980241999,3,4,80080,10439,69641,0.8696428571428572,20.84253688888889,3163.838,13.12866122928261,125,9.300000000000018E-4
3,test_20231101_135017,10188041.png,221231,9532,211699,0.9569138140676487,2,4,41731,1346,40385,0.9677458004840527,11.166584888888888,1103.081408,17.704727960790887,125,9.300000000000018E-4
4,test_20231101_135017,10287332.png,216980,12584,204396,0.942003871324546,2,3,22337,1727,20610,0.9226843354076196,9.448579555555556,778.9383466666667,19.21577276445775,125,9.300000000000018E-4
5,test_20231101_135017,11610969.png,368720,25697,343023,0.930307550444782,2,4,84111,3750,80361,0.9554160573527838,21.631701333333332,3001.576629333333,13.357309256291893,125,9.300000000000018E-4
6,test_20231101_135017,10350842.png,212614,6102,206512,0.9713001025332292,1,3,42529,894,41635,0.9789790495896917,19.318012444444445,2373.8444053333333,14.37628111337661,125,9.300000000000018E-4
7,test_20231101_135017,10863862.png,317432,12162,305270,0.9616862824163915,2,4,66058,1765,64293,0.9732810560416604,24.022609777777777,3308.937994666667,12.933917317637896,125,9.300000000000018E-4
8,test_20231101_135017,11382381.png,312486,767,311719,0.9975454900379537,2,4,46745,100,46645,0.9978607337683175,21.58402311111111,2479.723024,14.186771864393144,125,9.300000000000018E-4
9,test_20231101_135017,11079715.png,443815,120387,323428,0.7287450852269527,4,4,124136,16809,107327,0.8645920603209383,16.86984177777778,2095.0260693333335,14.918909294142013,125,9.300000000000018E-4
10,test_20231101_135017,11551286.png,271883,367,271516,0.9986501546621157,1,3,40092,52,40040,0.9987029831387808,18.002010666666667,1874.0560373333333,15.402977880083654,125,9.300000000000018E-4
1,test_20231101_135018,10404007.png,502730,20937,481793,0.9583533904879359,2,4,61265,3030,58235,0.9505427242308007,25.80952177777778,3452.553962666667,12.749398856360063,125,9.400000000000018E-4
2,test_20231101_135018,1254659.png,342646,74697,267949,0.7819994980241999,3,4,80080,10439,69641,0.8696428571428572,20.84253688888889,3163.838,13.12866122928261,125,9.400000000000018E-4
3,test_20231101_135018,10188041.png,221231,9532,211699,0.9569138140676487,2,4,41731,1346,40385,0.9677458004840527,11.166584888888888,1103.081408,17.704727960790887,125,9.400000000000018E-4
4,test_20231101_135018,10287332.png,216980,12584,204396,0.942003871324546,2,4,22337,1727,20610,0.9226843354076196,9.448579555555556,778.9383466666667,19.21577276445775,125,9.400000000000018E-4
5,test_20231101_135018,11610969.png,368720,25697,343023,0.930307550444782,3,3,84111,3750,80361,0.9554160573527838,21.631701333333332,3001.576629333333,13.357309256291893,125,9.400000000000018E-4
6,test_20231101_135018,10350842.png,212614,6102,206512,0.9713001025332292,1,4,42529,894,41635,0.9789790495896917,19.318012444444445,2373.8444053333333,14.37628111337661,125,9.400000000000018E-4
7,test_20231101_135018,10863862.png,317432,12162,305270,0.9616862824163915,2,4,66058,1765,64293,0.9732810560416604,24.022609777777777,3308.937994666667,12.933917317637896,125,9.400000000000018E-4
8,test_20231101_135018,11382381.png,312486,767,311719,0.9975454900379537,2,3,46745,100,46645,0.9978607337683175,21.58402311111111,2479.723024,14.186771864393144,125,9.400000000000018E-4
9,test_20231101_135018,11079715.png,443815,120387,323428,0.7287450852269527,4,4,124136,16809,107327,0.8645920603209383,16.86984177777778,2095.0260693333335,14.918909294142013,125,9.400000000000018E-4
10,test_20231101_135018,11551286.png,271883,367,271516,0.9986501546621157,2,4,40092,52,40040,0.9987029831387808,18.002010666666667,1874.0560373333333,15.402977880083654,125,9.400000000000018E-4
1,test_20231101_135019,10404007.png,502730,20937,481793,0.9583533904879359,3,4,61265,3030,58235,0.9505427242308007,25.80952177777778,3452.553962666667,12.749398856360063,125,9.500000000000018E-4
2,test_20231101_135019,1254659.png,342646,74697,267949,0.7819994980241999,3,4,80080,10439,69641,0.8696428571428572,20.84253688888889,3163.838,13.12866122928261,125,9.500000000000018E-4
3,test_20231101_135019,10188041.png,221231,9532,211699,0.9569138140676487,2,4,41731,1346,40385,0.9677458004840527,11.166584888888888,1103.081408,17.704727960790887,125,9.500000000000018E-4
4,test_20231101_135019,10287332.png,216980,12584,204396,0.942003871324546,2,3,22337,1727,20610,0.9226843354076196,9.448579555555556,778.9383466666667,19.21577276445775,125,9.500000000000018E-4
5,test_20231101_135019,11610969.png,368720,25697,343023,0.930307550444782,3,4,84111,3750,80361,0.9554160573527838,21.631701333333332,3001.576629333333,13.357309256291893,125,9.500000000000018E-4
6,test_20231101_135019,10350842.png,212614,6102,206512,0.9713001025332292,1,4,42529,894,41635,0.9789790495896917,19.318012444444445,2373.8444053333333,14.37628111337661,125,9.500000000000018E-4
7,test_20231101_135019,10863862.png,317432,12162,305270,0.9616862824163915,2,4,66058,1765,64293,0.9732810560416604,24.022609777777777,3308.937994666667,12.933917317637896,125,9.500000000000018E-4
8,test_20231101_135019,11382381.png,312486,767,311719,0.9975454900379537,3,3,46745,100,46645,0.9978607337683175,21.58402311111111,2479.723024,14.186771864393144,125,9.500000000000018E-4
9,test_20231101_135019,11079715.png,443815,120387,323428,0.7287450852269527,3,5,124136,16809,107327,0.8645920603209383,16.86984177777778,2095.0260693333335,14.918909294142013,125,9.500000000000018E-4
10,test_20231101_135019,11551286.png,271883,367,271516,0.9986501546621157,1,4,40092,52,40040,0.9987029831387808,18.002010666666667,1874.0560373333333,15.402977880083654,125,9.500000000000018E-4
1,test_20231101_135020,10404007.png,502730,20937,481793,0.9583533904879359,2,3,61265,3030,58235,0.9505427242308007,25.80952177777778,3452.553962666667,12.749398856360063,125,9.600000000000019E-4
2,test_20231101_135020,1254659.png,342646,74697,267949,0.7819994980241999,3,4,80080,10439,69641,0.8696428571428572,20.84253688888889,3163.838,13.12866122928261,125,9.600000000000019E-4
3,test_20231101_135020,10188041.png,221231,9532,211699,0.9569138140676487,2,3,41731,1346,40385,0.9677458004840527,11.166584888888888,1103.081408,17.704727960790887,125,9.600000000000019E-4
4,test_20231101_135020,10287332.png,216980,12584,204396,0.942003871324546,2,4,22337,1727,20610,0.9226843354076196,9.448579555555556,778.9383466666667,19.21577276445775,125,9.600000000000019E-4
5,test_20231101_135020,11610969.png,368720,25697,343023,0.930307550444782,2,4,84111,3750,80361,0.9554160573527838,21.631701333333332,3001.576629333333,13.357309256291893,125,9.600000000000019E-4
6,test_20231101_135020,10350842.png,212614,5522,207092,0.9740280508339055,2,3,42529,807,41722,0.9810247125490842,20.426321777777776,2643.907722666667,13.908340674809413,125,9.600000000000019E-4
7,test_20231101_135020,10863862.png,317432,12162,305270,0.9616862824163915,2,12,66058,1765,64293,0.9732810560416604,24.022609777777777,3308.937994666667,12.933917317637896,125,9.600000000000019E-4
8,test_20231101_135020,11382381.png,312486,767,311719,0.9975454900379537,2,4,46745,100,46645,0.9978607337683175,21.58402311111111,2479.723024,14.186771864393144,125,9.600000000000019E-4
9,test_20231101_135020,11079715.png,443815,120387,323428,0.7287450852269527,3,4,124136,16809,107327,0.8645920603209383,16.86984177777778,2095.0260693333335,14.918909294142013,125,9.600000000000019E-4
10,test_20231101_135020,11551286.png,271883,367,271516,0.9986501546621157,1,4,40092,52,40040,0.9987029831387808,18.002010666666667,1874.0560373333333,15.402977880083654,125,9.600000000000019E-4
1,test_20231101_135020,10404007.png,502730,20937,481793,0.9583533904879359,2,4,61265,3030,58235,0.9505427242308007,25.80952177777778,3452.553962666667,12.749398856360063,125,9.700000000000019E-4
2,test_20231101_135020,1254659.png,342646,74697,267949,0.7819994980241999,4,13,80080,10439,69641,0.8696428571428572,20.84253688888889,3163.838,13.12866122928261,125,9.700000000000019E-4
3,test_20231101_135020,10188041.png,221231,9532,211699,0.9569138140676487,2,4,41731,1346,40385,0.9677458004840527,11.166584888888888,1103.081408,17.704727960790887,125,9.700000000000019E-4
4,test_20231101_135020,10287332.png,216980,12584,204396,0.942003871324546,1,3,22337,1727,20610,0.9226843354076196,9.448579555555556,778.9383466666667,19.21577276445775,125,9.700000000000019E-4
5,test_20231101_135020,11610969.png,368720,25697,343023,0.930307550444782,2,4,84111,3750,80361,0.9554160573527838,21.631701333333332,3001.576629333333,13.357309256291893,125,9.700000000000019E-4
6,test_20231101_135020,10350842.png,212614,5522,207092,0.9740280508339055,2,3,42529,807,41722,0.9810247125490842,20.426321777777776,2643.907722666667,13.908340674809413,125,9.700000000000019E-4
7,test_20231101_135020,10863862.png,317432,12162,305270,0.9616862824163915,2,4,66058,1765,64293,0.9732810560416604,24.022609777777777,3308.937994666667,12.933917317637896,125,9.700000000000019E-4
8,test_20231101_135020,11382381.png,312486,767,311719,0.9975454900379537,1,3,46745,100,46645,0.9978607337683175,21.58402311111111,2479.723024,14.186771864393144,125,9.700000000000019E-4
9,test_20231101_135020,11079715.png,443815,120387,323428,0.7287450852269527,3,4,124136,16809,107327,0.8645920603209383,16.86984177777778,2095.0260693333335,14.918909294142013,125,9.700000000000019E-4
10,test_20231101_135020,11551286.png,271883,367,271516,0.9986501546621157,1,3,40092,52,40040,0.9987029831387808,18.002010666666667,1874.0560373333333,15.402977880083654,125,9.700000000000019E-4
1,test_20231101_135021,10404007.png,502730,20432,482298,0.9593579058341456,2,3,61265,2964,58301,0.9516200114257732,25.95758222222222,3491.477024,12.700711723980348,125,9.80000000000002E-4
2,test_20231101_135021,1254659.png,342646,74537,268109,0.7824664522568482,3,5,80080,10425,69655,0.8698176823176823,20.912261333333333,3178.5184586666664,13.108556230080575,125,9.80000000000002E-4
3,test_20231101_135021,10188041.png,221231,9329,211902,0.9578314069908829,2,3,41731,1326,40405,0.9682250605065779,11.250503111111112,1118.0084053333333,17.646352922225475,125,9.80000000000002E-4
4,test_20231101_135021,10287332.png,216980,12484,204496,0.9424647432943128,2,4,22337,1712,20625,0.9233558669472176,9.50016711111111,787.5292053333334,19.16813692400025,125,9.80000000000002E-4
5,test_20231101_135021,11610969.png,368720,25417,343303,0.9310669342590584,3,4,84111,3715,80396,0.9558321741508246,21.703139555555556,3011.838026666667,13.342487485903638,125,9.80000000000002E-4
6,test_20231101_135021,10350842.png,212614,5399,207215,0.9746065640080145,1,4,42529,789,41740,0.9814479531613722,20.581038222222222,2672.5666026666668,13.861518238588664,125,9.80000000000002E-4
7,test_20231101_135021,10863862.png,317432,11902,305530,0.9625053554777087,2,5,66058,1728,64330,0.9738411698810137,24.169952,3343.8964906666665,12.888275353509457,125,9.80000000000002E-4
8,test_20231101_135021,11382381.png,312486,547,311939,0.9982495215785667,1,3,46745,73,46672,0.9984383356508717,22.032236444444443,2581.941392,14.011339809622479,125,9.80000000000002E-4
9,test_20231101_135021,11079715.png,443815,120307,323508,0.7289253405135023,3,4,124136,16802,107334,0.8646484500870013,16.910190222222223,2101.7455466666665,14.905002249928847,125,9.80000000000002E-4
10,test_20231101_135021,11551286.png,271883,367,271516,0.9986501546621157,1,4,40092,52,40040,0.9987029831387808,18.002010666666667,1874.0560373333333,15.402977880083654,125,9.80000000000002E-4
1,test_20231101_135022,10404007.png,502730,20432,482298,0.9593579058341456,3,10,61265,2964,58301,0.9516200114257732,25.95758222222222,3491.477024,12.700711723980348,125,9.90000000000002E-4
2,test_20231101_135022,1254659.png,342646,74537,268109,0.7824664522568482,3,4,80080,10425,69655,0.8698176823176823,20.912261333333333,3178.5184586666664,13.108556230080575,125,9.90000000000002E-4
3,test_20231101_135022,10188041.png,221231,9329,211902,0.9578314069908829,2,4,41731,1326,40405,0.9682250605065779,11.250503111111112,1118.0084053333333,17.646352922225475,125,9.90000000000002E-4
4,test_20231101_135022,10287332.png,216980,12484,204496,0.9424647432943128,1,4,22337,1712,20625,0.9233558669472176,9.50016711111111,787.5292053333334,19.16813692400025,125,9.90000000000002E-4
5,test_20231101_135022,11610969.png,368720,25417,343303,0.9310669342590584,2,3,84111,3715,80396,0.9558321741508246,21.703139555555556,3011.838026666667,13.342487485903638,125,9.90000000000002E-4
6,test_20231101_135022,10350842.png,212614,5399,207215,0.9746065640080145,2,3,42529,789,41740,0.9814479531613722,20.581038222222222,2672.5666026666668,13.861518238588664,125,9.90000000000002E-4
7,test_20231101_135022,10863862.png,317432,11902,305530,0.9625053554777087,2,4,66058,1728,64330,0.9738411698810137,24.169952,3343.8964906666665,12.888275353509457,125,9.90000000000002E-4
8,test_20231101_135022,11382381.png,312486,547,311939,0.9982495215785667,1,3,46745,73,46672,0.9984383356508717,22.032236444444443,2581.941392,14.011339809622479,125,9.90000000000002E-4
9,test_20231101_135022,11079715.png,443815,120307,323508,0.7289253405135023,3,4,124136,16802,107334,0.8646484500870013,16.910190222222223,2101.7455466666665,14.905002249928847,125,9.90000000000002E-4
10,test_20231101_135022,11551286.png,271883,367,271516,0.9986501546621157,2,3,40092,52,40040,0.9987029831387808,18.002010666666667,1874.0560373333333,15.402977880083654,125,9.90000000000002E-4
1,test_20231101_135022,10404007.png,502730,20834,481896,0.9585582718357767,2,4,61265,3016,58249,0.9507712396964009,25.686528,3429.773024,12.778149806752824,126,0.0
2,test_20231101_135022,1254659.png,342646,73249,269397,0.7862254338296668,2,4,80080,10244,69836,0.8720779220779221,20.98264711111111,3208.4044853333335,13.067912460579436,126,0.0
3,test_20231101_135022,10188041.png,221231,9692,211539,0.9561905881183017,2,3,41731,1366,40365,0.9672665404615274,10.568042666666667,1021.7253333333333,18.037461991689202,126,0.0
4,test_20231101_135022,10287332.png,216980,12574,204406,0.9420499585215227,2,4,22337,1723,20614,0.9228634104848458,9.367333333333333,764.1768586666667,19.29886478922929,126,0.0
5,test_20231101_135022,11610969.png,368720,25357,343363,0.9312296593621177,2,3,84111,3701,80410,0.9559986208700408,21.3076,2937.504816,13.451017735675183,126,0.0
6,test_20231101_135022,10350842.png,212614,6082,206532,0.9713941697160112,1,3,42529,891,41638,0.9790495896917397,19.26112,2371.9918826666667,14.379671623979055,126,0.0
7,test_20231101_135022,10863862.png,317432,11479,305953,0.9638379243428514,2,4,66058,1667,64391,0.9747646008053529,24.188906666666668,3362.179488,12.864594665868092,126,0.0
8,test_20231101_135022,11382381.png,312486,1007,311479,0.9967774556300122,1,3,46745,136,46609,0.9970905979249117,20.14226311111111,2274.987984,14.561012537192962,126,0.0
9,test_20231101_135022,11079715.png,443815,118057,325758,0.733995020447709,3,4,124136,16497,107639,0.8671054327511761,17.022149333333335,2131.304528,14.84434853255526,126,0.0
10,test_20231101_135022,11551286.png,271883,1159,270724,0.9957371369302237,1,4,40092,170,39922,0.9957597525690911,15.773507555555556,1501.2797866666667,16.36618723599906,126,0.0
1,test_20231101_135023,10404007.png,502730,20834,481896,0.9585582718357767,3,4,61265,3016,58249,0.9507712396964009,25.686528,3429.773024,12.778149806752824,126,1.0E-5
2,test_20231101_135023,1254659.png,342646,73249,269397,0.7862254338296668,3,4,80080,10244,69836,0.8720779220779221,20.98264711111111,3208.4044853333335,13.067912460579436,126,1.0E-5
3,test_20231101_135023,10188041.png,221231,9692,211539,0.9561905881183017,2,4,41731,1366,40365,0.9672665404615274,10.568042666666667,1021.7253333333333,18.037461991689202,126,1.0E-5
4,test_20231101_135023,10287332.png,216980,12574,204406,0.9420499585215227,2,3,22337,1723,20614,0.9228634104848458,9.367333333333333,764.1768586666667,19.29886478922929,126,1.0E-5
5,test_20231101_135023,11610969.png,368720,25357,343363,0.9312296593621177,2,4,84111,3701,80410,0.9559986208700408,21.3076,2937.504816,13.451017735675183,126,1.0E-5
6,test_20231101_135023,10350842.png,212614,6082,206532,0.9713941697160112,2,4,42529,891,41638,0.9790495896917397,19.26112,2371.9918826666667,14.379671623979055,126,1.0E-5
7,test_20231101_135023,10863862.png,317432,11479,305953,0.9638379243428514,2,4,66058,1667,64391,0.9747646008053529,24.188906666666668,3362.179488,12.864594665868092,126,1.0E-5
8,test_20231101_135023,11382381.png,312486,1007,311479,0.9967774556300122,1,3,46745,136,46609,0.9970905979249117,20.14226311111111,2274.987984,14.561012537192962,126,1.0E-5
9,test_20231101_135023,11079715.png,443815,118057,325758,0.733995020447709,3,4,124136,16497,107639,0.8671054327511761,17.022149333333335,2131.304528,14.84434853255526,126,1.0E-5
10,test_20231101_135023,11551286.png,271883,1159,270724,0.9957371369302237,1,4,40092,170,39922,0.9957597525690911,15.773507555555556,1501.2797866666667,16.36618723599906,126,1.0E-5
1,test_20231101_135024,10404007.png,502730,20834,481896,0.9585582718357767,2,3,61265,3016,58249,0.9507712396964009,25.686528,3429.773024,12.778149806752824,126,2.0E-5
2,test_20231101_135024,1254659.png,342646,73249,269397,0.7862254338296668,3,4,80080,10244,69836,0.8720779220779221,20.98264711111111,3208.4044853333335,13.067912460579436,126,2.0E-5
3,test_20231101_135024,10188041.png,221231,9692,211539,0.9561905881183017,2,3,41731,1366,40365,0.9672665404615274,10.568042666666667,1021.7253333333333,18.037461991689202,126,2.0E-5
4,test_20231101_135024,10287332.png,216980,12574,204406,0.9420499585215227,1,3,22337,1723,20614,0.9228634104848458,9.367333333333333,764.1768586666667,19.29886478922929,126,2.0E-5
5,test_20231101_135024,11610969.png,368720,25357,343363,0.9312296593621177,2,3,84111,3701,80410,0.9559986208700408,21.3076,2937.504816,13.451017735675183,126,2.0E-5
6,test_20231101_135024,10350842.png,212614,6082,206532,0.9713941697160112,1,4,42529,891,41638,0.9790495896917397,19.26112,2371.9918826666667,14.379671623979055,126,2.0E-5
7,test_20231101_135024,10863862.png,317432,11479,305953,0.9638379243428514,2,4,66058,1667,64391,0.9747646008053529,24.188906666666668,3362.179488,12.864594665868092,126,2.0E-5
8,test_20231101_135024,11382381.png,312486,1007,311479,0.9967774556300122,2,4,46745,136,46609,0.9970905979249117,20.14226311111111,2274.987984,14.561012537192962,126,2.0E-5
9,test_20231101_135024,11079715.png,443815,118057,325758,0.733995020447709,3,4,124136,16497,107639,0.8671054327511761,17.022149333333335,2131.304528,14.84434853255526,126,2.0E-5
10,test_20231101_135024,11551286.png,271883,1159,270724,0.9957371369302237,2,4,40092,170,39922,0.9957597525690911,15.773507555555556,1501.2797866666667,16.36618723599906,126,2.0E-5
1,test_20231101_135024,10404007.png,502730,20834,481896,0.9585582718357767,2,4,61265,3016,58249,0.9507712396964009,25.686528,3429.773024,12.778149806752824,126,3.0000000000000004E-5
2,test_20231101_135024,1254659.png,342646,73249,269397,0.7862254338296668,3,4,80080,10244,69836,0.8720779220779221,20.98264711111111,3208.4044853333335,13.067912460579436,126,3.0000000000000004E-5
3,test_20231101_135024,10188041.png,221231,9692,211539,0.9561905881183017,2,4,41731,1366,40365,0.9672665404615274,10.568042666666667,1021.7253333333333,18.037461991689202,126,3.0000000000000004E-5
4,test_20231101_135024,10287332.png,216980,12574,204406,0.9420499585215227,2,3,22337,1723,20614,0.9228634104848458,9.367333333333333,764.1768586666667,19.29886478922929,126,3.0000000000000004E-5
5,test_20231101_135024,11610969.png,368720,25357,343363,0.9312296593621177,2,3,84111,3701,80410,0.9559986208700408,21.3076,2937.504816,13.451017735675183,126,3.0000000000000004E-5
6,test_20231101_135024,10350842.png,212614,6082,206532,0.9713941697160112,1,4,42529,891,41638,0.9790495896917397,19.26112,2371.9918826666667,14.379671623979055,126,3.0000000000000004E-5
7,test_20231101_135024,10863862.png,317432,11479,305953,0.9638379243428514,2,3,66058,1667,64391,0.9747646008053529,24.188906666666668,3362.179488,12.864594665868092,126,3.0000000000000004E-5
8,test_20231101_135024,11382381.png,312486,1007,311479,0.9967774556300122,2,3,46745,136,46609,0.9970905979249117,20.14226311111111,2274.987984,14.561012537192962,126,3.0000000000000004E-5
9,test_20231101_135024,11079715.png,443815,118057,325758,0.733995020447709,4,4,124136,16497,107639,0.8671054327511761,17.022149333333335,2131.304528,14.84434853255526,126,3.0000000000000004E-5
10,test_20231101_135024,11551286.png,271883,1159,270724,0.9957371369302237,2,3,40092,170,39922,0.9957597525690911,15.773507555555556,1501.2797866666667,16.36618723599906,126,3.0000000000000004E-5
1,test_20231101_135025,10404007.png,502730,20834,481896,0.9585582718357767,2,4,61265,3016,58249,0.9507712396964009,25.686528,3429.773024,12.778149806752824,126,4.0E-5
2,test_20231101_135025,1254659.png,342646,73249,269397,0.7862254338296668,3,4,80080,10244,69836,0.8720779220779221,20.98264711111111,3208.4044853333335,13.067912460579436,126,4.0E-5
3,test_20231101_135025,10188041.png,221231,9692,211539,0.9561905881183017,2,4,41731,1366,40365,0.9672665404615274,10.568042666666667,1021.7253333333333,18.037461991689202,126,4.0E-5
4,test_20231101_135025,10287332.png,216980,12574,204406,0.9420499585215227,2,4,22337,1723,20614,0.9228634104848458,9.367333333333333,764.1768586666667,19.29886478922929,126,4.0E-5
5,test_20231101_135025,11610969.png,368720,25357,343363,0.9312296593621177,6,3,84111,3701,80410,0.9559986208700408,21.3076,2937.504816,13.451017735675183,126,4.0E-5
6,test_20231101_135025,10350842.png,212614,6082,206532,0.9713941697160112,1,3,42529,891,41638,0.9790495896917397,19.26112,2371.9918826666667,14.379671623979055,126,4.0E-5
7,test_20231101_135025,10863862.png,317432,11479,305953,0.9638379243428514,2,4,66058,1667,64391,0.9747646008053529,24.188906666666668,3362.179488,12.864594665868092,126,4.0E-5
8,test_20231101_135025,11382381.png,312486,1007,311479,0.9967774556300122,2,3,46745,136,46609,0.9970905979249117,20.14226311111111,2274.987984,14.561012537192962,126,4.0E-5
9,test_20231101_135025,11079715.png,443815,118057,325758,0.733995020447709,4,4,124136,16497,107639,0.8671054327511761,17.022149333333335,2131.304528,14.84434853255526,126,4.0E-5
10,test_20231101_135025,11551286.png,271883,1159,270724,0.9957371369302237,2,3,40092,170,39922,0.9957597525690911,15.773507555555556,1501.2797866666667,16.36618723599906,126,4.0E-5
1,test_20231101_135026,10404007.png,502730,20834,481896,0.9585582718357767,2,4,61265,3016,58249,0.9507712396964009,25.686528,3429.773024,12.778149806752824,126,5.0E-5
2,test_20231101_135026,1254659.png,342646,73249,269397,0.7862254338296668,2,3,80080,10244,69836,0.8720779220779221,20.98264711111111,3208.4044853333335,13.067912460579436,126,5.0E-5
3,test_20231101_135026,10188041.png,221231,9692,211539,0.9561905881183017,2,4,41731,1366,40365,0.9672665404615274,10.568042666666667,1021.7253333333333,18.037461991689202,126,5.0E-5
4,test_20231101_135026,10287332.png,216980,12574,204406,0.9420499585215227,2,4,22337,1723,20614,0.9228634104848458,9.367333333333333,764.1768586666667,19.29886478922929,126,5.0E-5
5,test_20231101_135026,11610969.png,368720,25357,343363,0.9312296593621177,2,4,84111,3701,80410,0.9559986208700408,21.3076,2937.504816,13.451017735675183,126,5.0E-5
6,test_20231101_135026,10350842.png,212614,6082,206532,0.9713941697160112,1,4,42529,891,41638,0.9790495896917397,19.26112,2371.9918826666667,14.379671623979055,126,5.0E-5
7,test_20231101_135026,10863862.png,317432,11479,305953,0.9638379243428514,2,3,66058,1667,64391,0.9747646008053529,24.188906666666668,3362.179488,12.864594665868092,126,5.0E-5
8,test_20231101_135026,11382381.png,312486,997,311489,0.9968094570636764,2,4,46745,135,46610,0.9971119905872285,20.87208,2373.5487946666667,14.376821966329306,126,5.0E-5
9,test_20231101_135026,11079715.png,443815,118057,325758,0.733995020447709,4,4,124136,16497,107639,0.8671054327511761,17.022149333333335,2131.304528,14.84434853255526,126,5.0E-5
10,test_20231101_135026,11551286.png,271883,1159,270724,0.9957371369302237,1,3,40092,170,39922,0.9957597525690911,15.773507555555556,1501.2797866666667,16.36618723599906,126,5.0E-5
1,test_20231101_135026,10404007.png,502730,20834,481896,0.9585582718357767,2,3,61265,3016,58249,0.9507712396964009,25.686528,3429.773024,12.778149806752824,126,6.0E-5
2,test_20231101_135026,1254659.png,342646,73249,269397,0.7862254338296668,3,4,80080,10244,69836,0.8720779220779221,20.98264711111111,3208.4044853333335,13.067912460579436,126,6.0E-5
3,test_20231101_135026,10188041.png,221231,9692,211539,0.9561905881183017,2,4,41731,1366,40365,0.9672665404615274,10.568042666666667,1021.7253333333333,18.037461991689202,126,6.0E-5
4,test_20231101_135026,10287332.png,216980,12574,204406,0.9420499585215227,1,4,22337,1723,20614,0.9228634104848458,9.367333333333333,764.1768586666667,19.29886478922929,126,6.0E-5
5,test_20231101_135026,11610969.png,368720,25357,343363,0.9312296593621177,2,4,84111,3701,80410,0.9559986208700408,21.3076,2937.504816,13.451017735675183,126,6.0E-5
6,test_20231101_135026,10350842.png,212614,6082,206532,0.9713941697160112,1,4,42529,891,41638,0.9790495896917397,19.26112,2371.9918826666667,14.379671623979055,126,6.0E-5
7,test_20231101_135026,10863862.png,317432,11479,305953,0.9638379243428514,2,3,66058,1667,64391,0.9747646008053529,24.188906666666668,3362.179488,12.864594665868092,126,6.0E-5
8,test_20231101_135026,11382381.png,312486,997,311489,0.9968094570636764,2,4,46745,135,46610,0.9971119905872285,20.87208,2373.5487946666667,14.376821966329306,126,6.0E-5
9,test_20231101_135026,11079715.png,443815,118057,325758,0.733995020447709,3,5,124136,16497,107639,0.8671054327511761,17.022149333333335,2131.304528,14.84434853255526,126,6.0E-5
10,test_20231101_135026,11551286.png,271883,1159,270724,0.9957371369302237,2,3,40092,170,39922,0.9957597525690911,15.773507555555556,1501.2797866666667,16.36618723599906,126,6.0E-5
1,test_20231101_135027,10404007.png,502730,20834,481896,0.9585582718357767,3,4,61265,3016,58249,0.9507712396964009,25.686528,3429.773024,12.778149806752824,126,7.000000000000001E-5
2,test_20231101_135027,1254659.png,342646,73249,269397,0.7862254338296668,3,4,80080,10244,69836,0.8720779220779221,20.98264711111111,3208.4044853333335,13.067912460579436,126,7.000000000000001E-5
3,test_20231101_135027,10188041.png,221231,9692,211539,0.9561905881183017,2,3,41731,1366,40365,0.9672665404615274,10.568042666666667,1021.7253333333333,18.037461991689202,126,7.000000000000001E-5
4,test_20231101_135027,10287332.png,216980,12574,204406,0.9420499585215227,2,3,22337,1723,20614,0.9228634104848458,9.367333333333333,764.1768586666667,19.29886478922929,126,7.000000000000001E-5
5,test_20231101_135027,11610969.png,368720,25357,343363,0.9312296593621177,2,3,84111,3701,80410,0.9559986208700408,21.3076,2937.504816,13.451017735675183,126,7.000000000000001E-5
6,test_20231101_135027,10350842.png,212614,6082,206532,0.9713941697160112,2,4,42529,891,41638,0.9790495896917397,19.26112,2371.9918826666667,14.379671623979055,126,7.000000000000001E-5
7,test_20231101_135027,10863862.png,317432,11479,305953,0.9638379243428514,2,4,66058,1667,64391,0.9747646008053529,24.188906666666668,3362.179488,12.864594665868092,126,7.000000000000001E-5
8,test_20231101_135027,11382381.png,312486,997,311489,0.9968094570636764,2,4,46745,135,46610,0.9971119905872285,20.87208,2373.5487946666667,14.376821966329306,126,7.000000000000001E-5
9,test_20231101_135027,11079715.png,443815,118057,325758,0.733995020447709,4,4,124136,16497,107639,0.8671054327511761,17.022149333333335,2131.304528,14.84434853255526,126,7.000000000000001E-5
10,test_20231101_135027,11551286.png,271883,1039,270844,0.9961785032532376,1,4,40092,152,39940,0.9962087199441285,15.859841777777778,1507.39176,16.348542239511865,126,7.000000000000001E-5
1,test_20231101_135028,10404007.png,502730,20834,481896,0.9585582718357767,3,3,61265,3016,58249,0.9507712396964009,25.686528,3429.773024,12.778149806752824,126,8.0E-5
2,test_20231101_135028,1254659.png,342646,73249,269397,0.7862254338296668,2,4,80080,10244,69836,0.8720779220779221,20.98264711111111,3208.4044853333335,13.067912460579436,126,8.0E-5
3,test_20231101_135028,10188041.png,221231,9692,211539,0.9561905881183017,2,13,41731,1366,40365,0.9672665404615274,10.568042666666667,1021.7253333333333,18.037461991689202,126,8.0E-5
4,test_20231101_135028,10287332.png,216980,12574,204406,0.9420499585215227,2,4,22337,1723,20614,0.9228634104848458,9.367333333333333,764.1768586666667,19.29886478922929,126,8.0E-5
5,test_20231101_135028,11610969.png,368720,25357,343363,0.9312296593621177,3,3,84111,3701,80410,0.9559986208700408,21.3076,2937.504816,13.451017735675183,126,8.0E-5
6,test_20231101_135028,10350842.png,212614,6082,206532,0.9713941697160112,2,3,42529,891,41638,0.9790495896917397,19.26112,2371.9918826666667,14.379671623979055,126,8.0E-5
7,test_20231101_135028,10863862.png,317432,11479,305953,0.9638379243428514,2,4,66058,1667,64391,0.9747646008053529,24.188906666666668,3362.179488,12.864594665868092,126,8.0E-5
8,test_20231101_135028,11382381.png,312486,997,311489,0.9968094570636764,1,4,46745,135,46610,0.9971119905872285,20.87208,2373.5487946666667,14.376821966329306,126,8.0E-5
9,test_20231101_135028,11079715.png,443815,118057,325758,0.733995020447709,3,4,124136,16497,107639,0.8671054327511761,17.022149333333335,2131.304528,14.84434853255526,126,8.0E-5
10,test_20231101_135028,11551286.png,271883,1039,270844,0.9961785032532376,2,4,40092,152,39940,0.9962087199441285,15.859841777777778,1507.39176,16.348542239511865,126,8.0E-5
1,test_20231101_135028,10404007.png,502730,20834,481896,0.9585582718357767,2,4,61265,3016,58249,0.9507712396964009,25.686528,3429.773024,12.778149806752824,126,9.0E-5
2,test_20231101_135028,1254659.png,342646,73249,269397,0.7862254338296668,3,4,80080,10244,69836,0.8720779220779221,20.98264711111111,3208.4044853333335,13.067912460579436,126,9.0E-5
3,test_20231101_135028,10188041.png,221231,9692,211539,0.9561905881183017,2,3,41731,1366,40365,0.9672665404615274,10.568042666666667,1021.7253333333333,18.037461991689202,126,9.0E-5
4,test_20231101_135028,10287332.png,216980,12574,204406,0.9420499585215227,1,3,22337,1723,20614,0.9228634104848458,9.367333333333333,764.1768586666667,19.29886478922929,126,9.0E-5
5,test_20231101_135028,11610969.png,368720,25357,343363,0.9312296593621177,2,4,84111,3701,80410,0.9559986208700408,21.3076,2937.504816,13.451017735675183,126,9.0E-5
6,test_20231101_135028,10350842.png,212614,6082,206532,0.9713941697160112,1,3,42529,891,41638,0.9790495896917397,19.26112,2371.9918826666667,14.379671623979055,126,9.0E-5
7,test_20231101_135028,10863862.png,317432,11479,305953,0.9638379243428514,2,3,66058,1667,64391,0.9747646008053529,24.188906666666668,3362.179488,12.864594665868092,126,9.0E-5
8,test_20231101_135028,11382381.png,312486,997,311489,0.9968094570636764,1,3,46745,135,46610,0.9971119905872285,20.87208,2373.5487946666667,14.376821966329306,126,9.0E-5
9,test_20231101_135028,11079715.png,443815,118057,325758,0.733995020447709,3,4,124136,16497,107639,0.8671054327511761,17.022149333333335,2131.304528,14.84434853255526,126,9.0E-5
10,test_20231101_135028,11551286.png,271883,1039,270844,0.9961785032532376,1,4,40092,152,39940,0.9962087199441285,15.859841777777778,1507.39176,16.348542239511865,126,9.0E-5
1,test_20231101_135029,10404007.png,502730,20834,481896,0.9585582718357767,2,3,61265,3016,58249,0.9507712396964009,25.686528,3429.773024,12.778149806752824,126,1.0E-4
2,test_20231101_135029,1254659.png,342646,73249,269397,0.7862254338296668,3,4,80080,10244,69836,0.8720779220779221,20.98264711111111,3208.4044853333335,13.067912460579436,126,1.0E-4
3,test_20231101_135029,10188041.png,221231,9692,211539,0.9561905881183017,2,3,41731,1366,40365,0.9672665404615274,10.568042666666667,1021.7253333333333,18.037461991689202,126,1.0E-4
4,test_20231101_135029,10287332.png,216980,12574,204406,0.9420499585215227,2,3,22337,1723,20614,0.9228634104848458,9.367333333333333,764.1768586666667,19.29886478922929,126,1.0E-4
5,test_20231101_135029,11610969.png,368720,25357,343363,0.9312296593621177,3,11,84111,3701,80410,0.9559986208700408,21.3076,2937.504816,13.451017735675183,126,1.0E-4
6,test_20231101_135029,10350842.png,212614,6082,206532,0.9713941697160112,2,4,42529,891,41638,0.9790495896917397,19.26112,2371.9918826666667,14.379671623979055,126,1.0E-4
7,test_20231101_135029,10863862.png,317432,11479,305953,0.9638379243428514,2,4,66058,1667,64391,0.9747646008053529,24.188906666666668,3362.179488,12.864594665868092,126,1.0E-4
8,test_20231101_135029,11382381.png,312486,997,311489,0.9968094570636764,1,3,46745,135,46610,0.9971119905872285,20.87208,2373.5487946666667,14.376821966329306,126,1.0E-4
9,test_20231101_135029,11079715.png,443815,118057,325758,0.733995020447709,3,4,124136,16497,107639,0.8671054327511761,17.022149333333335,2131.304528,14.84434853255526,126,1.0E-4
10,test_20231101_135029,11551286.png,271883,1039,270844,0.9961785032532376,2,4,40092,152,39940,0.9962087199441285,15.859841777777778,1507.39176,16.348542239511865,126,1.0E-4
1,test_20231101_135030,10404007.png,502730,20834,481896,0.9585582718357767,2,3,61265,3016,58249,0.9507712396964009,25.686528,3429.773024,12.778149806752824,126,1.1E-4
2,test_20231101_135030,1254659.png,342646,73249,269397,0.7862254338296668,3,4,80080,10244,69836,0.8720779220779221,20.98264711111111,3208.4044853333335,13.067912460579436,126,1.1E-4
3,test_20231101_135030,10188041.png,221231,9692,211539,0.9561905881183017,2,4,41731,1366,40365,0.9672665404615274,10.568042666666667,1021.7253333333333,18.037461991689202,126,1.1E-4
4,test_20231101_135030,10287332.png,216980,12574,204406,0.9420499585215227,2,4,22337,1723,20614,0.9228634104848458,9.367333333333333,764.1768586666667,19.29886478922929,126,1.1E-4
5,test_20231101_135030,11610969.png,368720,25357,343363,0.9312296593621177,2,4,84111,3701,80410,0.9559986208700408,21.3076,2937.504816,13.451017735675183,126,1.1E-4
6,test_20231101_135030,10350842.png,212614,6082,206532,0.9713941697160112,1,4,42529,891,41638,0.9790495896917397,19.26112,2371.9918826666667,14.379671623979055,126,1.1E-4
7,test_20231101_135030,10863862.png,317432,11479,305953,0.9638379243428514,2,4,66058,1667,64391,0.9747646008053529,24.188906666666668,3362.179488,12.864594665868092,126,1.1E-4
8,test_20231101_135030,11382381.png,312486,997,311489,0.9968094570636764,1,4,46745,135,46610,0.9971119905872285,20.87208,2373.5487946666667,14.376821966329306,126,1.1E-4
9,test_20231101_135030,11079715.png,443815,118057,325758,0.733995020447709,3,4,124136,16497,107639,0.8671054327511761,17.022149333333335,2131.304528,14.84434853255526,126,1.1E-4
10,test_20231101_135030,11551286.png,271883,1039,270844,0.9961785032532376,1,4,40092,152,39940,0.9962087199441285,15.859841777777778,1507.39176,16.348542239511865,126,1.1E-4
1,test_20231101_135030,10404007.png,502730,20834,481896,0.9585582718357767,2,4,61265,3016,58249,0.9507712396964009,25.686528,3429.773024,12.778149806752824,126,1.2E-4
2,test_20231101_135030,1254659.png,342646,73249,269397,0.7862254338296668,3,4,80080,10244,69836,0.8720779220779221,20.98264711111111,3208.4044853333335,13.067912460579436,126,1.2E-4
3,test_20231101_135030,10188041.png,221231,9692,211539,0.9561905881183017,2,4,41731,1366,40365,0.9672665404615274,10.568042666666667,1021.7253333333333,18.037461991689202,126,1.2E-4
4,test_20231101_135030,10287332.png,216980,12574,204406,0.9420499585215227,1,3,22337,1723,20614,0.9228634104848458,9.367333333333333,764.1768586666667,19.29886478922929,126,1.2E-4
5,test_20231101_135030,11610969.png,368720,25357,343363,0.9312296593621177,2,4,84111,3701,80410,0.9559986208700408,21.3076,2937.504816,13.451017735675183,126,1.2E-4
6,test_20231101_135030,10350842.png,212614,6082,206532,0.9713941697160112,1,3,42529,891,41638,0.9790495896917397,19.26112,2371.9918826666667,14.379671623979055,126,1.2E-4
7,test_20231101_135030,10863862.png,317432,11479,305953,0.9638379243428514,2,4,66058,1667,64391,0.9747646008053529,24.188906666666668,3362.179488,12.864594665868092,126,1.2E-4
8,test_20231101_135030,11382381.png,312486,997,311489,0.9968094570636764,1,3,46745,135,46610,0.9971119905872285,20.87208,2373.5487946666667,14.376821966329306,126,1.2E-4
9,test_20231101_135030,11079715.png,443815,118057,325758,0.733995020447709,3,5,124136,16497,107639,0.8671054327511761,17.022149333333335,2131.304528,14.84434853255526,126,1.2E-4
10,test_20231101_135030,11551286.png,271883,1039,270844,0.9961785032532376,2,4,40092,152,39940,0.9962087199441285,15.859841777777778,1507.39176,16.348542239511865,126,1.2E-4
1,test_20231101_135031,10404007.png,502730,20834,481896,0.9585582718357767,2,3,61265,3016,58249,0.9507712396964009,25.686528,3429.773024,12.778149806752824,126,1.3000000000000002E-4
2,test_20231101_135031,1254659.png,342646,73249,269397,0.7862254338296668,3,4,80080,10244,69836,0.8720779220779221,20.98264711111111,3208.4044853333335,13.067912460579436,126,1.3000000000000002E-4
3,test_20231101_135031,10188041.png,221231,9692,211539,0.9561905881183017,2,4,41731,1366,40365,0.9672665404615274,10.568042666666667,1021.7253333333333,18.037461991689202,126,1.3000000000000002E-4
4,test_20231101_135031,10287332.png,216980,12574,204406,0.9420499585215227,2,4,22337,1723,20614,0.9228634104848458,9.367333333333333,764.1768586666667,19.29886478922929,126,1.3000000000000002E-4
5,test_20231101_135031,11610969.png,368720,25357,343363,0.9312296593621177,2,3,84111,3701,80410,0.9559986208700408,21.3076,2937.504816,13.451017735675183,126,1.3000000000000002E-4
6,test_20231101_135031,10350842.png,212614,6082,206532,0.9713941697160112,1,3,42529,891,41638,0.9790495896917397,19.26112,2371.9918826666667,14.379671623979055,126,1.3000000000000002E-4
7,test_20231101_135031,10863862.png,317432,11479,305953,0.9638379243428514,2,4,66058,1667,64391,0.9747646008053529,24.188906666666668,3362.179488,12.864594665868092,126,1.3000000000000002E-4
8,test_20231101_135031,11382381.png,312486,997,311489,0.9968094570636764,2,4,46745,135,46610,0.9971119905872285,20.87208,2373.5487946666667,14.376821966329306,126,1.3000000000000002E-4
9,test_20231101_135031,11079715.png,443815,118057,325758,0.733995020447709,4,4,124136,16497,107639,0.8671054327511761,17.022149333333335,2131.304528,14.84434853255526,126,1.3000000000000002E-4
10,test_20231101_135031,11551286.png,271883,857,271026,0.9968479088431421,2,4,40092,125,39967,0.9968821710066846,17.020656,1715.495408,15.78690800983984,126,1.3000000000000002E-4
1,test_20231101_135032,10404007.png,502730,20834,481896,0.9585582718357767,2,3,61265,3016,58249,0.9507712396964009,25.686528,3429.773024,12.778149806752824,126,1.4000000000000001E-4
2,test_20231101_135032,1254659.png,342646,73249,269397,0.7862254338296668,3,4,80080,10244,69836,0.8720779220779221,20.98264711111111,3208.4044853333335,13.067912460579436,126,1.4000000000000001E-4
3,test_20231101_135032,10188041.png,221231,9692,211539,0.9561905881183017,2,3,41731,1366,40365,0.9672665404615274,10.568042666666667,1021.7253333333333,18.037461991689202,126,1.4000000000000001E-4
4,test_20231101_135032,10287332.png,216980,12574,204406,0.9420499585215227,1,4,22337,1723,20614,0.9228634104848458,9.367333333333333,764.1768586666667,19.29886478922929,126,1.4000000000000001E-4
5,test_20231101_135032,11610969.png,368720,25357,343363,0.9312296593621177,3,3,84111,3701,80410,0.9559986208700408,21.3076,2937.504816,13.451017735675183,126,1.4000000000000001E-4
6,test_20231101_135032,10350842.png,212614,6082,206532,0.9713941697160112,1,4,42529,891,41638,0.9790495896917397,19.26112,2371.9918826666667,14.379671623979055,126,1.4000000000000001E-4
7,test_20231101_135032,10863862.png,317432,11479,305953,0.9638379243428514,2,3,66058,1667,64391,0.9747646008053529,24.188906666666668,3362.179488,12.864594665868092,126,1.4000000000000001E-4
8,test_20231101_135032,11382381.png,312486,997,311489,0.9968094570636764,1,3,46745,135,46610,0.9971119905872285,20.87208,2373.5487946666667,14.376821966329306,126,1.4000000000000001E-4
9,test_20231101_135032,11079715.png,443815,118057,325758,0.733995020447709,3,4,124136,16497,107639,0.8671054327511761,17.022149333333335,2131.304528,14.84434853255526,126,1.4000000000000001E-4
10,test_20231101_135032,11551286.png,271883,857,271026,0.9968479088431421,2,4,40092,125,39967,0.9968821710066846,17.020656,1715.495408,15.78690800983984,126,1.4000000000000001E-4
1,test_20231101_135032,10404007.png,502730,20834,481896,0.9585582718357767,2,4,61265,3016,58249,0.9507712396964009,25.686528,3429.773024,12.778149806752824,126,1.5000000000000001E-4
2,test_20231101_135032,1254659.png,342646,73249,269397,0.7862254338296668,3,4,80080,10244,69836,0.8720779220779221,20.98264711111111,3208.4044853333335,13.067912460579436,126,1.5000000000000001E-4
3,test_20231101_135032,10188041.png,221231,9692,211539,0.9561905881183017,2,4,41731,1366,40365,0.9672665404615274,10.568042666666667,1021.7253333333333,18.037461991689202,126,1.5000000000000001E-4
4,test_20231101_135032,10287332.png,216980,12574,204406,0.9420499585215227,2,4,22337,1723,20614,0.9228634104848458,9.367333333333333,764.1768586666667,19.29886478922929,126,1.5000000000000001E-4
5,test_20231101_135032,11610969.png,368720,25357,343363,0.9312296593621177,2,3,84111,3701,80410,0.9559986208700408,21.3076,2937.504816,13.451017735675183,126,1.5000000000000001E-4
6,test_20231101_135032,10350842.png,212614,6082,206532,0.9713941697160112,2,3,42529,891,41638,0.9790495896917397,19.26112,2371.9918826666667,14.379671623979055,126,1.5000000000000001E-4
7,test_20231101_135032,10863862.png,317432,11479,305953,0.9638379243428514,2,4,66058,1667,64391,0.9747646008053529,24.188906666666668,3362.179488,12.864594665868092,126,1.5000000000000001E-4
8,test_20231101_135032,11382381.png,312486,867,311619,0.9972254757013114,1,4,46745,116,46629,0.9975184511712483,21.130496,2414.0920426666667,14.303265363409706,126,1.5000000000000001E-4
9,test_20231101_135032,11079715.png,443815,118057,325758,0.733995020447709,3,4,124136,16497,107639,0.8671054327511761,17.022149333333335,2131.304528,14.84434853255526,126,1.5000000000000001E-4
10,test_20231101_135032,11551286.png,271883,857,271026,0.9968479088431421,2,3,40092,125,39967,0.9968821710066846,17.020656,1715.495408,15.78690800983984,126,1.5000000000000001E-4
1,test_20231101_135033,10404007.png,502730,20834,481896,0.9585582718357767,3,3,61265,3016,58249,0.9507712396964009,25.686528,3429.773024,12.778149806752824,126,1.6E-4
2,test_20231101_135033,1254659.png,342646,73249,269397,0.7862254338296668,3,4,80080,10244,69836,0.8720779220779221,20.98264711111111,3208.4044853333335,13.067912460579436,126,1.6E-4
3,test_20231101_135033,10188041.png,221231,9692,211539,0.9561905881183017,2,4,41731,1366,40365,0.9672665404615274,10.568042666666667,1021.7253333333333,18.037461991689202,126,1.6E-4
4,test_20231101_135033,10287332.png,216980,12364,204616,0.943017789658033,2,4,22337,1696,20641,0.9240721672561221,9.497095111111111,790.9076053333333,19.149546091497648,126,1.6E-4
5,test_20231101_135033,11610969.png,368720,25357,343363,0.9312296593621177,3,4,84111,3701,80410,0.9559986208700408,21.3076,2937.504816,13.451017735675183,126,1.6E-4
6,test_20231101_135033,10350842.png,212614,6082,206532,0.9713941697160112,2,3,42529,891,41638,0.9790495896917397,19.26112,2371.9918826666667,14.379671623979055,126,1.6E-4
7,test_20231101_135033,10863862.png,317432,11479,305953,0.9638379243428514,2,4,66058,1667,64391,0.9747646008053529,24.188906666666668,3362.179488,12.864594665868092,126,1.6E-4
8,test_20231101_135033,11382381.png,312486,867,311619,0.9972254757013114,1,3,46745,116,46629,0.9975184511712483,21.130496,2414.0920426666667,14.303265363409706,126,1.6E-4
9,test_20231101_135033,11079715.png,443815,118057,325758,0.733995020447709,3,4,124136,16497,107639,0.8671054327511761,17.022149333333335,2131.304528,14.84434853255526,126,1.6E-4
10,test_20231101_135033,11551286.png,271883,857,271026,0.9968479088431421,1,3,40092,125,39967,0.9968821710066846,17.020656,1715.495408,15.78690800983984,126,1.6E-4
1,test_20231101_135034,10404007.png,502730,20834,481896,0.9585582718357767,2,4,61265,3016,58249,0.9507712396964009,25.686528,3429.773024,12.778149806752824,126,1.7E-4
2,test_20231101_135034,1254659.png,342646,73249,269397,0.7862254338296668,3,4,80080,10244,69836,0.8720779220779221,20.98264711111111,3208.4044853333335,13.067912460579436,126,1.7E-4
3,test_20231101_135034,10188041.png,221231,9692,211539,0.9561905881183017,2,4,41731,1366,40365,0.9672665404615274,10.568042666666667,1021.7253333333333,18.037461991689202,126,1.7E-4
4,test_20231101_135034,10287332.png,216980,12364,204616,0.943017789658033,1,3,22337,1696,20641,0.9240721672561221,9.497095111111111,790.9076053333333,19.149546091497648,126,1.7E-4
5,test_20231101_135034,11610969.png,368720,25357,343363,0.9312296593621177,2,4,84111,3701,80410,0.9559986208700408,21.3076,2937.504816,13.451017735675183,126,1.7E-4
6,test_20231101_135034,10350842.png,212614,6082,206532,0.9713941697160112,1,4,42529,891,41638,0.9790495896917397,19.26112,2371.9918826666667,14.379671623979055,126,1.7E-4
7,test_20231101_135034,10863862.png,317432,11479,305953,0.9638379243428514,2,3,66058,1667,64391,0.9747646008053529,24.188906666666668,3362.179488,12.864594665868092,126,1.7E-4
8,test_20231101_135034,11382381.png,312486,867,311619,0.9972254757013114,1,6,46745,116,46629,0.9975184511712483,21.130496,2414.0920426666667,14.303265363409706,126,1.7E-4
9,test_20231101_135034,11079715.png,443815,118057,325758,0.733995020447709,3,4,124136,16497,107639,0.8671054327511761,17.022149333333335,2131.304528,14.84434853255526,126,1.7E-4
10,test_20231101_135034,11551286.png,271883,857,271026,0.9968479088431421,2,3,40092,125,39967,0.9968821710066846,17.020656,1715.495408,15.78690800983984,126,1.7E-4
1,test_20231101_135034,10404007.png,502730,20834,481896,0.9585582718357767,2,4,61265,3016,58249,0.9507712396964009,25.686528,3429.773024,12.778149806752824,126,1.8E-4
2,test_20231101_135034,1254659.png,342646,73249,269397,0.7862254338296668,3,4,80080,10244,69836,0.8720779220779221,20.98264711111111,3208.4044853333335,13.067912460579436,126,1.8E-4
3,test_20231101_135034,10188041.png,221231,9692,211539,0.9561905881183017,2,4,41731,1366,40365,0.9672665404615274,10.568042666666667,1021.7253333333333,18.037461991689202,126,1.8E-4
4,test_20231101_135034,10287332.png,216980,12364,204616,0.943017789658033,2,4,22337,1696,20641,0.9240721672561221,9.497095111111111,790.9076053333333,19.149546091497648,126,1.8E-4
5,test_20231101_135034,11610969.png,368720,25357,343363,0.9312296593621177,2,4,84111,3701,80410,0.9559986208700408,21.3076,2937.504816,13.451017735675183,126,1.8E-4
6,test_20231101_135034,10350842.png,212614,6082,206532,0.9713941697160112,1,4,42529,891,41638,0.9790495896917397,19.26112,2371.9918826666667,14.379671623979055,126,1.8E-4
7,test_20231101_135034,10863862.png,317432,11479,305953,0.9638379243428514,2,4,66058,1667,64391,0.9747646008053529,24.188906666666668,3362.179488,12.864594665868092,126,1.8E-4
8,test_20231101_135034,11382381.png,312486,867,311619,0.9972254757013114,1,3,46745,116,46629,0.9975184511712483,21.130496,2414.0920426666667,14.303265363409706,126,1.8E-4
9,test_20231101_135034,11079715.png,443815,118057,325758,0.733995020447709,3,4,124136,16497,107639,0.8671054327511761,17.022149333333335,2131.304528,14.84434853255526,126,1.8E-4
10,test_20231101_135034,11551286.png,271883,857,271026,0.9968479088431421,2,4,40092,125,39967,0.9968821710066846,17.020656,1715.495408,15.78690800983984,126,1.8E-4
1,test_20231101_135035,10404007.png,502730,20834,481896,0.9585582718357767,2,4,61265,3016,58249,0.9507712396964009,25.686528,3429.773024,12.778149806752824,126,1.9E-4
2,test_20231101_135035,1254659.png,342646,73249,269397,0.7862254338296668,3,4,80080,10244,69836,0.8720779220779221,20.98264711111111,3208.4044853333335,13.067912460579436,126,1.9E-4
3,test_20231101_135035,10188041.png,221231,9692,211539,0.9561905881183017,2,4,41731,1366,40365,0.9672665404615274,10.568042666666667,1021.7253333333333,18.037461991689202,126,1.9E-4
4,test_20231101_135035,10287332.png,216980,12364,204616,0.943017789658033,1,4,22337,1696,20641,0.9240721672561221,9.497095111111111,790.9076053333333,19.149546091497648,126,1.9E-4
5,test_20231101_135035,11610969.png,368720,25357,343363,0.9312296593621177,2,4,84111,3701,80410,0.9559986208700408,21.3076,2937.504816,13.451017735675183,126,1.9E-4
6,test_20231101_135035,10350842.png,212614,6082,206532,0.9713941697160112,2,3,42529,891,41638,0.9790495896917397,19.26112,2371.9918826666667,14.379671623979055,126,1.9E-4
7,test_20231101_135035,10863862.png,317432,11479,305953,0.9638379243428514,2,4,66058,1667,64391,0.9747646008053529,24.188906666666668,3362.179488,12.864594665868092,126,1.9E-4
8,test_20231101_135035,11382381.png,312486,867,311619,0.9972254757013114,1,3,46745,116,46629,0.9975184511712483,21.130496,2414.0920426666667,14.303265363409706,126,1.9E-4
9,test_20231101_135035,11079715.png,443815,118057,325758,0.733995020447709,3,5,124136,16497,107639,0.8671054327511761,17.022149333333335,2131.304528,14.84434853255526,126,1.9E-4
10,test_20231101_135035,11551286.png,271883,857,271026,0.9968479088431421,1,4,40092,125,39967,0.9968821710066846,17.020656,1715.495408,15.78690800983984,126,1.9E-4
1,test_20231101_135036,10404007.png,502730,20834,481896,0.9585582718357767,2,3,61265,3016,58249,0.9507712396964009,25.686528,3429.773024,12.778149806752824,126,2.0E-4
2,test_20231101_135036,1254659.png,342646,73249,269397,0.7862254338296668,3,4,80080,10244,69836,0.8720779220779221,20.98264711111111,3208.4044853333335,13.067912460579436,126,2.0E-4
3,test_20231101_135036,10188041.png,221231,9692,211539,0.9561905881183017,2,4,41731,1366,40365,0.9672665404615274,10.568042666666667,1021.7253333333333,18.037461991689202,126,2.0E-4
4,test_20231101_135036,10287332.png,216980,12364,204616,0.943017789658033,1,4,22337,1696,20641,0.9240721672561221,9.497095111111111,790.9076053333333,19.149546091497648,126,2.0E-4
5,test_20231101_135036,11610969.png,368720,25357,343363,0.9312296593621177,2,4,84111,3701,80410,0.9559986208700408,21.3076,2937.504816,13.451017735675183,126,2.0E-4
6,test_20231101_135036,10350842.png,212614,6082,206532,0.9713941697160112,1,7,42529,891,41638,0.9790495896917397,19.26112,2371.9918826666667,14.379671623979055,126,2.0E-4
7,test_20231101_135036,10863862.png,317432,11479,305953,0.9638379243428514,2,4,66058,1667,64391,0.9747646008053529,24.188906666666668,3362.179488,12.864594665868092,126,2.0E-4
8,test_20231101_135036,11382381.png,312486,867,311619,0.9972254757013114,1,3,46745,116,46629,0.9975184511712483,21.130496,2414.0920426666667,14.303265363409706,126,2.0E-4
9,test_20231101_135036,11079715.png,443815,118057,325758,0.733995020447709,3,4,124136,16497,107639,0.8671054327511761,17.022149333333335,2131.304528,14.84434853255526,126,2.0E-4
10,test_20231101_135036,11551286.png,271883,737,271146,0.9972892751661561,1,4,40092,107,39985,0.997331138381722,17.57074488888889,1811.3484693333332,15.5507835243661,126,2.0E-4
1,test_20231101_135037,10404007.png,502730,20834,481896,0.9585582718357767,2,4,61265,3016,58249,0.9507712396964009,25.686528,3429.773024,12.778149806752824,126,2.1E-4
2,test_20231101_135037,1254659.png,342646,73249,269397,0.7862254338296668,3,3,80080,10244,69836,0.8720779220779221,20.98264711111111,3208.4044853333335,13.067912460579436,126,2.1E-4
3,test_20231101_135037,10188041.png,221231,9692,211539,0.9561905881183017,2,4,41731,1366,40365,0.9672665404615274,10.568042666666667,1021.7253333333333,18.037461991689202,126,2.1E-4
4,test_20231101_135037,10287332.png,216980,12364,204616,0.943017789658033,1,3,22337,1696,20641,0.9240721672561221,9.497095111111111,790.9076053333333,19.149546091497648,126,2.1E-4
5,test_20231101_135037,11610969.png,368720,25357,343363,0.9312296593621177,2,4,84111,3701,80410,0.9559986208700408,21.3076,2937.504816,13.451017735675183,126,2.1E-4
6,test_20231101_135037,10350842.png,212614,6082,206532,0.9713941697160112,1,4,42529,891,41638,0.9790495896917397,19.26112,2371.9918826666667,14.379671623979055,126,2.1E-4
7,test_20231101_135037,10863862.png,317432,11479,305953,0.9638379243428514,2,9,66058,1667,64391,0.9747646008053529,24.188906666666668,3362.179488,12.864594665868092,126,2.1E-4
8,test_20231101_135037,11382381.png,312486,867,311619,0.9972254757013114,1,3,46745,116,46629,0.9975184511712483,21.130496,2414.0920426666667,14.303265363409706,126,2.1E-4
9,test_20231101_135037,11079715.png,443815,118057,325758,0.733995020447709,3,4,124136,16497,107639,0.8671054327511761,17.022149333333335,2131.304528,14.84434853255526,126,2.1E-4
10,test_20231101_135037,11551286.png,271883,737,271146,0.9972892751661561,2,4,40092,107,39985,0.997331138381722,17.57074488888889,1811.3484693333332,15.5507835243661,126,2.1E-4
1,test_20231101_135037,10404007.png,502730,20834,481896,0.9585582718357767,2,3,61265,3016,58249,0.9507712396964009,25.686528,3429.773024,12.778149806752824,126,2.2E-4
2,test_20231101_135037,1254659.png,342646,73249,269397,0.7862254338296668,2,3,80080,10244,69836,0.8720779220779221,20.98264711111111,3208.4044853333335,13.067912460579436,126,2.2E-4
3,test_20231101_135037,10188041.png,221231,9692,211539,0.9561905881183017,2,3,41731,1366,40365,0.9672665404615274,10.568042666666667,1021.7253333333333,18.037461991689202,126,2.2E-4
4,test_20231101_135037,10287332.png,216980,12364,204616,0.943017789658033,2,4,22337,1696,20641,0.9240721672561221,9.497095111111111,790.9076053333333,19.149546091497648,126,2.2E-4
5,test_20231101_135037,11610969.png,368720,25357,343363,0.9312296593621177,2,4,84111,3701,80410,0.9559986208700408,21.3076,2937.504816,13.451017735675183,126,2.2E-4
6,test_20231101_135037,10350842.png,212614,6082,206532,0.9713941697160112,1,3,42529,891,41638,0.9790495896917397,19.26112,2371.9918826666667,14.379671623979055,126,2.2E-4
7,test_20231101_135037,10863862.png,317432,11479,305953,0.9638379243428514,2,4,66058,1667,64391,0.9747646008053529,24.188906666666668,3362.179488,12.864594665868092,126,2.2E-4
8,test_20231101_135037,11382381.png,312486,867,311619,0.9972254757013114,2,4,46745,116,46629,0.9975184511712483,21.130496,2414.0920426666667,14.303265363409706,126,2.2E-4
9,test_20231101_135037,11079715.png,443815,118057,325758,0.733995020447709,3,5,124136,16497,107639,0.8671054327511761,17.022149333333335,2131.304528,14.84434853255526,126,2.2E-4
10,test_20231101_135037,11551286.png,271883,737,271146,0.9972892751661561,1,4,40092,107,39985,0.997331138381722,17.57074488888889,1811.3484693333332,15.5507835243661,126,2.2E-4
1,test_20231101_135038,10404007.png,502730,20834,481896,0.9585582718357767,2,3,61265,3016,58249,0.9507712396964009,25.686528,3429.773024,12.778149806752824,126,2.3E-4
2,test_20231101_135038,1254659.png,342646,73249,269397,0.7862254338296668,3,4,80080,10244,69836,0.8720779220779221,20.98264711111111,3208.4044853333335,13.067912460579436,126,2.3E-4
3,test_20231101_135038,10188041.png,221231,9692,211539,0.9561905881183017,2,3,41731,1366,40365,0.9672665404615274,10.568042666666667,1021.7253333333333,18.037461991689202,126,2.3E-4
4,test_20231101_135038,10287332.png,216980,12364,204616,0.943017789658033,2,3,22337,1696,20641,0.9240721672561221,9.497095111111111,790.9076053333333,19.149546091497648,126,2.3E-4
5,test_20231101_135038,11610969.png,368720,25357,343363,0.9312296593621177,3,3,84111,3701,80410,0.9559986208700408,21.3076,2937.504816,13.451017735675183,126,2.3E-4
6,test_20231101_135038,10350842.png,212614,6082,206532,0.9713941697160112,2,4,42529,891,41638,0.9790495896917397,19.26112,2371.9918826666667,14.379671623979055,126,2.3E-4
7,test_20231101_135038,10863862.png,317432,11479,305953,0.9638379243428514,2,4,66058,1667,64391,0.9747646008053529,24.188906666666668,3362.179488,12.864594665868092,126,2.3E-4
8,test_20231101_135038,11382381.png,312486,867,311619,0.9972254757013114,1,4,46745,116,46629,0.9975184511712483,21.130496,2414.0920426666667,14.303265363409706,126,2.3E-4
9,test_20231101_135038,11079715.png,443815,118057,325758,0.733995020447709,4,4,124136,16497,107639,0.8671054327511761,17.022149333333335,2131.304528,14.84434853255526,126,2.3E-4
10,test_20231101_135038,11551286.png,271883,737,271146,0.9972892751661561,1,4,40092,107,39985,0.997331138381722,17.57074488888889,1811.3484693333332,15.5507835243661,126,2.3E-4
1,test_20231101_135039,10404007.png,502730,20834,481896,0.9585582718357767,2,3,61265,3016,58249,0.9507712396964009,25.686528,3429.773024,12.778149806752824,126,2.4E-4
2,test_20231101_135039,1254659.png,342646,73249,269397,0.7862254338296668,2,4,80080,10244,69836,0.8720779220779221,20.98264711111111,3208.4044853333335,13.067912460579436,126,2.4E-4
3,test_20231101_135039,10188041.png,221231,9692,211539,0.9561905881183017,2,8,41731,1366,40365,0.9672665404615274,10.568042666666667,1021.7253333333333,18.037461991689202,126,2.4E-4
4,test_20231101_135039,10287332.png,216980,12364,204616,0.943017789658033,2,4,22337,1696,20641,0.9240721672561221,9.497095111111111,790.9076053333333,19.149546091497648,126,2.4E-4
5,test_20231101_135039,11610969.png,368720,25357,343363,0.9312296593621177,2,3,84111,3701,80410,0.9559986208700408,21.3076,2937.504816,13.451017735675183,126,2.4E-4
6,test_20231101_135039,10350842.png,212614,6082,206532,0.9713941697160112,2,3,42529,891,41638,0.9790495896917397,19.26112,2371.9918826666667,14.379671623979055,126,2.4E-4
7,test_20231101_135039,10863862.png,317432,11479,305953,0.9638379243428514,2,4,66058,1667,64391,0.9747646008053529,24.188906666666668,3362.179488,12.864594665868092,126,2.4E-4
8,test_20231101_135039,11382381.png,312486,867,311619,0.9972254757013114,2,4,46745,116,46629,0.9975184511712483,21.130496,2414.0920426666667,14.303265363409706,126,2.4E-4
9,test_20231101_135039,11079715.png,443815,118057,325758,0.733995020447709,5,4,124136,16497,107639,0.8671054327511761,17.022149333333335,2131.304528,14.84434853255526,126,2.4E-4
10,test_20231101_135039,11551286.png,271883,737,271146,0.9972892751661561,1,4,40092,107,39985,0.997331138381722,17.57074488888889,1811.3484693333332,15.5507835243661,126,2.4E-4
1,test_20231101_135039,10404007.png,502730,20834,481896,0.9585582718357767,2,3,61265,3016,58249,0.9507712396964009,25.686528,3429.773024,12.778149806752824,126,2.5E-4
2,test_20231101_135039,1254659.png,342646,73249,269397,0.7862254338296668,3,4,80080,10244,69836,0.8720779220779221,20.98264711111111,3208.4044853333335,13.067912460579436,126,2.5E-4
3,test_20231101_135039,10188041.png,221231,9692,211539,0.9561905881183017,2,8,41731,1366,40365,0.9672665404615274,10.568042666666667,1021.7253333333333,18.037461991689202,126,2.5E-4
4,test_20231101_135039,10287332.png,216980,12364,204616,0.943017789658033,1,3,22337,1696,20641,0.9240721672561221,9.497095111111111,790.9076053333333,19.149546091497648,126,2.5E-4
5,test_20231101_135039,11610969.png,368720,25357,343363,0.9312296593621177,2,4,84111,3701,80410,0.9559986208700408,21.3076,2937.504816,13.451017735675183,126,2.5E-4
6,test_20231101_135039,10350842.png,212614,6082,206532,0.9713941697160112,2,4,42529,891,41638,0.9790495896917397,19.26112,2371.9918826666667,14.379671623979055,126,2.5E-4
7,test_20231101_135039,10863862.png,317432,11479,305953,0.9638379243428514,2,4,66058,1667,64391,0.9747646008053529,24.188906666666668,3362.179488,12.864594665868092,126,2.5E-4
8,test_20231101_135039,11382381.png,312486,867,311619,0.9972254757013114,1,4,46745,116,46629,0.9975184511712483,21.130496,2414.0920426666667,14.303265363409706,126,2.5E-4
9,test_20231101_135039,11079715.png,443815,118057,325758,0.733995020447709,4,4,124136,16497,107639,0.8671054327511761,17.022149333333335,2131.304528,14.84434853255526,126,2.5E-4
10,test_20231101_135039,11551286.png,271883,737,271146,0.9972892751661561,1,4,40092,107,39985,0.997331138381722,17.57074488888889,1811.3484693333332,15.5507835243661,126,2.5E-4
1,test_20231101_135040,10404007.png,502730,20754,481976,0.9587174029797306,2,3,61265,3004,58261,0.9509671100954868,25.695610666666667,3431.257168,12.776270918184878,126,2.6000000000000003E-4
2,test_20231101_135040,1254659.png,342646,73189,269457,0.7864005416669099,3,4,80080,10238,69842,0.8721528471528471,20.99220088888889,3209.486672,13.066447843337867,126,2.6000000000000003E-4
3,test_20231101_135040,10188041.png,221231,9592,211639,0.9566426043366436,2,4,41731,1351,40380,0.9676259854784213,10.691395555555555,1037.4407253333334,17.971170683956313,126,2.6000000000000003E-4
4,test_20231101_135040,10287332.png,216980,12364,204616,0.943017789658033,2,4,22337,1696,20641,0.9240721672561221,9.497095111111111,790.9076053333333,19.149546091497648,126,2.6000000000000003E-4
5,test_20231101_135040,11610969.png,368720,25037,343683,0.9320975265784335,4,4,84111,3655,80456,0.9565455172331799,21.725516444444445,3023.573904,13.3255977251099,126,2.6000000000000003E-4
6,test_20231101_135040,10350842.png,212614,6002,206612,0.971770438447139,2,4,42529,879,41650,0.9793317500999318,19.329912888888888,2377.7495893333335,14.369142455293513,126,2.6000000000000003E-4
7,test_20231101_135040,10863862.png,317432,11359,306073,0.9642159580634593,2,3,66058,1649,64409,0.9750370886190923,24.240064,3365.490752,12.860319593671788,126,2.6000000000000003E-4
8,test_20231101_135040,11382381.png,312486,747,311739,0.9976094929052821,2,3,46745,98,46647,0.9979035190929512,21.62502222222222,2484.034352,14.179227634129312,126,2.6000000000000003E-4
9,test_20231101_135040,11079715.png,443815,118057,325758,0.733995020447709,3,4,124136,16497,107639,0.8671054327511761,17.022149333333335,2131.304528,14.84434853255526,126,2.6000000000000003E-4
10,test_20231101_135040,11551286.png,271883,737,271146,0.9972892751661561,1,3,40092,107,39985,0.997331138381722,17.57074488888889,1811.3484693333332,15.5507835243661,126,2.6000000000000003E-4
1,test_20231101_135041,10404007.png,502730,20754,481976,0.9587174029797306,2,4,61265,3004,58261,0.9509671100954868,25.695610666666667,3431.257168,12.776270918184878,126,2.7000000000000006E-4
2,test_20231101_135041,1254659.png,342646,73189,269457,0.7864005416669099,3,4,80080,10238,69842,0.8721528471528471,20.99220088888889,3209.486672,13.066447843337867,126,2.7000000000000006E-4
3,test_20231101_135041,10188041.png,221231,9592,211639,0.9566426043366436,2,3,41731,1351,40380,0.9676259854784213,10.691395555555555,1037.4407253333334,17.971170683956313,126,2.7000000000000006E-4
4,test_20231101_135041,10287332.png,216980,12364,204616,0.943017789658033,2,3,22337,1696,20641,0.9240721672561221,9.497095111111111,790.9076053333333,19.149546091497648,126,2.7000000000000006E-4
5,test_20231101_135041,11610969.png,368720,25037,343683,0.9320975265784335,3,3,84111,3655,80456,0.9565455172331799,21.725516444444445,3023.573904,13.3255977251099,126,2.7000000000000006E-4
6,test_20231101_135041,10350842.png,212614,6002,206612,0.971770438447139,1,3,42529,879,41650,0.9793317500999318,19.329912888888888,2377.7495893333335,14.369142455293513,126,2.7000000000000006E-4
7,test_20231101_135041,10863862.png,317432,11359,306073,0.9642159580634593,2,4,66058,1649,64409,0.9750370886190923,24.240064,3365.490752,12.860319593671788,126,2.7000000000000006E-4
8,test_20231101_135041,11382381.png,312486,747,311739,0.9976094929052821,2,4,46745,98,46647,0.9979035190929512,21.62502222222222,2484.034352,14.179227634129312,126,2.7000000000000006E-4
9,test_20231101_135041,11079715.png,443815,118057,325758,0.733995020447709,5,6,124136,16497,107639,0.8671054327511761,17.022149333333335,2131.304528,14.84434853255526,126,2.7000000000000006E-4
10,test_20231101_135041,11551286.png,271883,737,271146,0.9972892751661561,2,4,40092,107,39985,0.997331138381722,17.57074488888889,1811.3484693333332,15.5507835243661,126,2.7000000000000006E-4
1,test_20231101_135041,10404007.png,502730,20754,481976,0.9587174029797306,2,4,61265,3004,58261,0.9509671100954868,25.695610666666667,3431.257168,12.776270918184878,126,2.800000000000001E-4
2,test_20231101_135041,1254659.png,342646,73189,269457,0.7864005416669099,3,4,80080,10238,69842,0.8721528471528471,20.99220088888889,3209.486672,13.066447843337867,126,2.800000000000001E-4
3,test_20231101_135041,10188041.png,221231,9592,211639,0.9566426043366436,2,4,41731,1351,40380,0.9676259854784213,10.691395555555555,1037.4407253333334,17.971170683956313,126,2.800000000000001E-4
4,test_20231101_135041,10287332.png,216980,12364,204616,0.943017789658033,2,4,22337,1696,20641,0.9240721672561221,9.497095111111111,790.9076053333333,19.149546091497648,126,2.800000000000001E-4
5,test_20231101_135041,11610969.png,368720,25037,343683,0.9320975265784335,2,3,84111,3655,80456,0.9565455172331799,21.725516444444445,3023.573904,13.3255977251099,126,2.800000000000001E-4
6,test_20231101_135041,10350842.png,212614,6002,206612,0.971770438447139,1,3,42529,879,41650,0.9793317500999318,19.329912888888888,2377.7495893333335,14.369142455293513,126,2.800000000000001E-4
7,test_20231101_135041,10863862.png,317432,11359,306073,0.9642159580634593,2,4,66058,1649,64409,0.9750370886190923,24.240064,3365.490752,12.860319593671788,126,2.800000000000001E-4
8,test_20231101_135041,11382381.png,312486,747,311739,0.9976094929052821,1,3,46745,98,46647,0.9979035190929512,21.62502222222222,2484.034352,14.179227634129312,126,2.800000000000001E-4
9,test_20231101_135041,11079715.png,443815,118057,325758,0.733995020447709,5,4,124136,16497,107639,0.8671054327511761,17.022149333333335,2131.304528,14.84434853255526,126,2.800000000000001E-4
10,test_20231101_135041,11551286.png,271883,427,271456,0.9984294715006087,1,3,40092,61,40031,0.9984784994512621,17.85376888888889,1855.7630026666666,15.445578486866474,126,2.800000000000001E-4
1,test_20231101_135042,10404007.png,502730,20754,481976,0.9587174029797306,2,3,61265,3004,58261,0.9509671100954868,25.695610666666667,3431.257168,12.776270918184878,126,2.900000000000001E-4
2,test_20231101_135042,1254659.png,342646,73189,269457,0.7864005416669099,3,4,80080,10238,69842,0.8721528471528471,20.99220088888889,3209.486672,13.066447843337867,126,2.900000000000001E-4
3,test_20231101_135042,10188041.png,221231,9592,211639,0.9566426043366436,2,3,41731,1351,40380,0.9676259854784213,10.691395555555555,1037.4407253333334,17.971170683956313,126,2.900000000000001E-4
4,test_20231101_135042,10287332.png,216980,12364,204616,0.943017789658033,2,3,22337,1696,20641,0.9240721672561221,9.497095111111111,790.9076053333333,19.149546091497648,126,2.900000000000001E-4
5,test_20231101_135042,11610969.png,368720,25037,343683,0.9320975265784335,2,3,84111,3655,80456,0.9565455172331799,21.725516444444445,3023.573904,13.3255977251099,126,2.900000000000001E-4
6,test_20231101_135042,10350842.png,212614,6002,206612,0.971770438447139,2,3,42529,879,41650,0.9793317500999318,19.329912888888888,2377.7495893333335,14.369142455293513,126,2.900000000000001E-4
7,test_20231101_135042,10863862.png,317432,11359,306073,0.9642159580634593,2,4,66058,1649,64409,0.9750370886190923,24.240064,3365.490752,12.860319593671788,126,2.900000000000001E-4
8,test_20231101_135042,11382381.png,312486,747,311739,0.9976094929052821,1,4,46745,98,46647,0.9979035190929512,21.62502222222222,2484.034352,14.179227634129312,126,2.900000000000001E-4
9,test_20231101_135042,11079715.png,443815,118057,325758,0.733995020447709,4,4,124136,16497,107639,0.8671054327511761,17.022149333333335,2131.304528,14.84434853255526,126,2.900000000000001E-4
10,test_20231101_135042,11551286.png,271883,427,271456,0.9984294715006087,1,4,40092,61,40031,0.9984784994512621,17.85376888888889,1855.7630026666666,15.445578486866474,126,2.900000000000001E-4
1,test_20231101_135043,10404007.png,502730,20754,481976,0.9587174029797306,3,3,61265,3004,58261,0.9509671100954868,25.695610666666667,3431.257168,12.776270918184878,126,3.0000000000000014E-4
2,test_20231101_135043,1254659.png,342646,73189,269457,0.7864005416669099,2,3,80080,10238,69842,0.8721528471528471,20.99220088888889,3209.486672,13.066447843337867,126,3.0000000000000014E-4
3,test_20231101_135043,10188041.png,221231,9592,211639,0.9566426043366436,2,3,41731,1351,40380,0.9676259854784213,10.691395555555555,1037.4407253333334,17.971170683956313,126,3.0000000000000014E-4
4,test_20231101_135043,10287332.png,216980,12364,204616,0.943017789658033,2,4,22337,1696,20641,0.9240721672561221,9.497095111111111,790.9076053333333,19.149546091497648,126,3.0000000000000014E-4
5,test_20231101_135043,11610969.png,368720,25037,343683,0.9320975265784335,3,3,84111,3655,80456,0.9565455172331799,21.725516444444445,3023.573904,13.3255977251099,126,3.0000000000000014E-4
6,test_20231101_135043,10350842.png,212614,6002,206612,0.971770438447139,1,3,42529,879,41650,0.9793317500999318,19.329912888888888,2377.7495893333335,14.369142455293513,126,3.0000000000000014E-4
7,test_20231101_135043,10863862.png,317432,11359,306073,0.9642159580634593,2,4,66058,1649,64409,0.9750370886190923,24.240064,3365.490752,12.860319593671788,126,3.0000000000000014E-4
8,test_20231101_135043,11382381.png,312486,747,311739,0.9976094929052821,2,4,46745,98,46647,0.9979035190929512,21.62502222222222,2484.034352,14.179227634129312,126,3.0000000000000014E-4
9,test_20231101_135043,11079715.png,443815,118057,325758,0.733995020447709,3,5,124136,16497,107639,0.8671054327511761,17.022149333333335,2131.304528,14.84434853255526,126,3.0000000000000014E-4
10,test_20231101_135043,11551286.png,271883,427,271456,0.9984294715006087,1,4,40092,61,40031,0.9984784994512621,17.85376888888889,1855.7630026666666,15.445578486866474,126,3.0000000000000014E-4
1,test_20231101_135043,10404007.png,502730,20754,481976,0.9587174029797306,2,3,61265,3004,58261,0.9509671100954868,25.695610666666667,3431.257168,12.776270918184878,126,3.1000000000000016E-4
2,test_20231101_135043,1254659.png,342646,73189,269457,0.7864005416669099,3,4,80080,10238,69842,0.8721528471528471,20.99220088888889,3209.486672,13.066447843337867,126,3.1000000000000016E-4
3,test_20231101_135043,10188041.png,221231,9592,211639,0.9566426043366436,2,4,41731,1351,40380,0.9676259854784213,10.691395555555555,1037.4407253333334,17.971170683956313,126,3.1000000000000016E-4
4,test_20231101_135043,10287332.png,216980,12364,204616,0.943017789658033,2,4,22337,1696,20641,0.9240721672561221,9.497095111111111,790.9076053333333,19.149546091497648,126,3.1000000000000016E-4
5,test_20231101_135043,11610969.png,368720,25037,343683,0.9320975265784335,2,4,84111,3655,80456,0.9565455172331799,21.725516444444445,3023.573904,13.3255977251099,126,3.1000000000000016E-4
6,test_20231101_135043,10350842.png,212614,6002,206612,0.971770438447139,1,4,42529,879,41650,0.9793317500999318,19.329912888888888,2377.7495893333335,14.369142455293513,126,3.1000000000000016E-4
7,test_20231101_135043,10863862.png,317432,11359,306073,0.9642159580634593,2,3,66058,1649,64409,0.9750370886190923,24.240064,3365.490752,12.860319593671788,126,3.1000000000000016E-4
8,test_20231101_135043,11382381.png,312486,747,311739,0.9976094929052821,2,3,46745,98,46647,0.9979035190929512,21.62502222222222,2484.034352,14.179227634129312,126,3.1000000000000016E-4
9,test_20231101_135043,11079715.png,443815,118057,325758,0.733995020447709,3,4,124136,16497,107639,0.8671054327511761,17.022149333333335,2131.304528,14.84434853255526,126,3.1000000000000016E-4
10,test_20231101_135043,11551286.png,271883,427,271456,0.9984294715006087,1,3,40092,61,40031,0.9984784994512621,17.85376888888889,1855.7630026666666,15.445578486866474,126,3.1000000000000016E-4
1,test_20231101_135044,10404007.png,502730,20472,482258,0.9592783402621685,3,3,61265,2964,58301,0.9516200114257732,25.783781333333334,3450.961552,12.75140240129671,126,3.200000000000002E-4
2,test_20231101_135044,1254659.png,342646,73189,269457,0.7864005416669099,3,4,80080,10238,69842,0.8721528471528471,20.99220088888889,3209.486672,13.066447843337867,126,3.200000000000002E-4
3,test_20231101_135044,10188041.png,221231,9592,211639,0.9566426043366436,2,3,41731,1351,40380,0.9676259854784213,10.691395555555555,1037.4407253333334,17.971170683956313,126,3.200000000000002E-4
4,test_20231101_135044,10287332.png,216980,12364,204616,0.943017789658033,2,4,22337,1696,20641,0.9240721672561221,9.497095111111111,790.9076053333333,19.149546091497648,126,3.200000000000002E-4
5,test_20231101_135044,11610969.png,368720,25037,343683,0.9320975265784335,2,4,84111,3655,80456,0.9565455172331799,21.725516444444445,3023.573904,13.3255977251099,126,3.200000000000002E-4
6,test_20231101_135044,10350842.png,212614,6002,206612,0.971770438447139,2,4,42529,879,41650,0.9793317500999318,19.329912888888888,2377.7495893333335,14.369142455293513,126,3.200000000000002E-4
7,test_20231101_135044,10863862.png,317432,11359,306073,0.9642159580634593,2,4,66058,1649,64409,0.9750370886190923,24.240064,3365.490752,12.860319593671788,126,3.200000000000002E-4
8,test_20231101_135044,11382381.png,312486,747,311739,0.9976094929052821,2,3,46745,98,46647,0.9979035190929512,21.62502222222222,2484.034352,14.179227634129312,126,3.200000000000002E-4
9,test_20231101_135044,11079715.png,443815,118057,325758,0.733995020447709,4,4,124136,16497,107639,0.8671054327511761,17.022149333333335,2131.304528,14.84434853255526,126,3.200000000000002E-4
10,test_20231101_135044,11551286.png,271883,427,271456,0.9984294715006087,2,3,40092,61,40031,0.9984784994512621,17.85376888888889,1855.7630026666666,15.445578486866474,126,3.200000000000002E-4
1,test_20231101_135045,10404007.png,502730,20472,482258,0.9592783402621685,2,4,61265,2964,58301,0.9516200114257732,25.783781333333334,3450.961552,12.75140240129671,126,3.300000000000002E-4
2,test_20231101_135045,1254659.png,342646,73189,269457,0.7864005416669099,2,4,80080,10238,69842,0.8721528471528471,20.99220088888889,3209.486672,13.066447843337867,126,3.300000000000002E-4
3,test_20231101_135045,10188041.png,221231,9592,211639,0.9566426043366436,2,4,41731,1351,40380,0.9676259854784213,10.691395555555555,1037.4407253333334,17.971170683956313,126,3.300000000000002E-4
4,test_20231101_135045,10287332.png,216980,12364,204616,0.943017789658033,2,4,22337,1696,20641,0.9240721672561221,9.497095111111111,790.9076053333333,19.149546091497648,126,3.300000000000002E-4
5,test_20231101_135045,11610969.png,368720,25037,343683,0.9320975265784335,2,4,84111,3655,80456,0.9565455172331799,21.725516444444445,3023.573904,13.3255977251099,126,3.300000000000002E-4
6,test_20231101_135045,10350842.png,212614,6002,206612,0.971770438447139,2,4,42529,879,41650,0.9793317500999318,19.329912888888888,2377.7495893333335,14.369142455293513,126,3.300000000000002E-4
7,test_20231101_135045,10863862.png,317432,11359,306073,0.9642159580634593,2,4,66058,1649,64409,0.9750370886190923,24.240064,3365.490752,12.860319593671788,126,3.300000000000002E-4
8,test_20231101_135045,11382381.png,312486,747,311739,0.9976094929052821,2,4,46745,98,46647,0.9979035190929512,21.62502222222222,2484.034352,14.179227634129312,126,3.300000000000002E-4
9,test_20231101_135045,11079715.png,443815,118057,325758,0.733995020447709,4,4,124136,16497,107639,0.8671054327511761,17.022149333333335,2131.304528,14.84434853255526,126,3.300000000000002E-4
10,test_20231101_135045,11551286.png,271883,427,271456,0.9984294715006087,1,4,40092,61,40031,0.9984784994512621,17.85376888888889,1855.7630026666666,15.445578486866474,126,3.300000000000002E-4
1,test_20231101_135045,10404007.png,502730,20472,482258,0.9592783402621685,2,4,61265,2964,58301,0.9516200114257732,25.783781333333334,3450.961552,12.75140240129671,126,3.4000000000000024E-4
2,test_20231101_135045,1254659.png,342646,73189,269457,0.7864005416669099,3,4,80080,10238,69842,0.8721528471528471,20.99220088888889,3209.486672,13.066447843337867,126,3.4000000000000024E-4
3,test_20231101_135045,10188041.png,221231,9592,211639,0.9566426043366436,2,4,41731,1351,40380,0.9676259854784213,10.691395555555555,1037.4407253333334,17.971170683956313,126,3.4000000000000024E-4
4,test_20231101_135045,10287332.png,216980,12364,204616,0.943017789658033,2,4,22337,1696,20641,0.9240721672561221,9.497095111111111,790.9076053333333,19.149546091497648,126,3.4000000000000024E-4
5,test_20231101_135045,11610969.png,368720,25037,343683,0.9320975265784335,2,4,84111,3655,80456,0.9565455172331799,21.725516444444445,3023.573904,13.3255977251099,126,3.4000000000000024E-4
6,test_20231101_135045,10350842.png,212614,6002,206612,0.971770438447139,1,4,42529,879,41650,0.9793317500999318,19.329912888888888,2377.7495893333335,14.369142455293513,126,3.4000000000000024E-4
7,test_20231101_135045,10863862.png,317432,11359,306073,0.9642159580634593,2,4,66058,1649,64409,0.9750370886190923,24.240064,3365.490752,12.860319593671788,126,3.4000000000000024E-4
8,test_20231101_135045,11382381.png,312486,747,311739,0.9976094929052821,1,4,46745,98,46647,0.9979035190929512,21.62502222222222,2484.034352,14.179227634129312,126,3.4000000000000024E-4
9,test_20231101_135045,11079715.png,443815,118057,325758,0.733995020447709,3,4,124136,16497,107639,0.8671054327511761,17.022149333333335,2131.304528,14.84434853255526,126,3.4000000000000024E-4
10,test_20231101_135045,11551286.png,271883,427,271456,0.9984294715006087,1,4,40092,61,40031,0.9984784994512621,17.85376888888889,1855.7630026666666,15.445578486866474,126,3.4000000000000024E-4
1,test_20231101_135046,10404007.png,502730,20472,482258,0.9592783402621685,2,4,61265,2964,58301,0.9516200114257732,25.783781333333334,3450.961552,12.75140240129671,126,3.5000000000000027E-4
2,test_20231101_135046,1254659.png,342646,73189,269457,0.7864005416669099,2,4,80080,10238,69842,0.8721528471528471,20.99220088888889,3209.486672,13.066447843337867,126,3.5000000000000027E-4
3,test_20231101_135046,10188041.png,221231,9592,211639,0.9566426043366436,2,3,41731,1351,40380,0.9676259854784213,10.691395555555555,1037.4407253333334,17.971170683956313,126,3.5000000000000027E-4
4,test_20231101_135046,10287332.png,216980,12364,204616,0.943017789658033,2,3,22337,1696,20641,0.9240721672561221,9.497095111111111,790.9076053333333,19.149546091497648,126,3.5000000000000027E-4
5,test_20231101_135046,11610969.png,368720,25037,343683,0.9320975265784335,2,4,84111,3655,80456,0.9565455172331799,21.725516444444445,3023.573904,13.3255977251099,126,3.5000000000000027E-4
6,test_20231101_135046,10350842.png,212614,6002,206612,0.971770438447139,2,4,42529,879,41650,0.9793317500999318,19.329912888888888,2377.7495893333335,14.369142455293513,126,3.5000000000000027E-4
7,test_20231101_135046,10863862.png,317432,11359,306073,0.9642159580634593,2,3,66058,1649,64409,0.9750370886190923,24.240064,3365.490752,12.860319593671788,126,3.5000000000000027E-4
8,test_20231101_135046,11382381.png,312486,747,311739,0.9976094929052821,2,3,46745,98,46647,0.9979035190929512,21.62502222222222,2484.034352,14.179227634129312,126,3.5000000000000027E-4
9,test_20231101_135046,11079715.png,443815,118057,325758,0.733995020447709,4,4,124136,16497,107639,0.8671054327511761,17.022149333333335,2131.304528,14.84434853255526,126,3.5000000000000027E-4
10,test_20231101_135046,11551286.png,271883,427,271456,0.9984294715006087,1,3,40092,61,40031,0.9984784994512621,17.85376888888889,1855.7630026666666,15.445578486866474,126,3.5000000000000027E-4
1,test_20231101_135047,10404007.png,502730,20472,482258,0.9592783402621685,2,4,61265,2964,58301,0.9516200114257732,25.783781333333334,3450.961552,12.75140240129671,126,3.600000000000003E-4
2,test_20231101_135047,1254659.png,342646,73189,269457,0.7864005416669099,3,4,80080,10238,69842,0.8721528471528471,20.99220088888889,3209.486672,13.066447843337867,126,3.600000000000003E-4
3,test_20231101_135047,10188041.png,221231,9592,211639,0.9566426043366436,2,3,41731,1351,40380,0.9676259854784213,10.691395555555555,1037.4407253333334,17.971170683956313,126,3.600000000000003E-4
4,test_20231101_135047,10287332.png,216980,12364,204616,0.943017789658033,1,4,22337,1696,20641,0.9240721672561221,9.497095111111111,790.9076053333333,19.149546091497648,126,3.600000000000003E-4
5,test_20231101_135047,11610969.png,368720,25037,343683,0.9320975265784335,2,4,84111,3655,80456,0.9565455172331799,21.725516444444445,3023.573904,13.3255977251099,126,3.600000000000003E-4
6,test_20231101_135047,10350842.png,212614,6002,206612,0.971770438447139,2,4,42529,879,41650,0.9793317500999318,19.329912888888888,2377.7495893333335,14.369142455293513,126,3.600000000000003E-4
7,test_20231101_135047,10863862.png,317432,11359,306073,0.9642159580634593,2,3,66058,1649,64409,0.9750370886190923,24.240064,3365.490752,12.860319593671788,126,3.600000000000003E-4
8,test_20231101_135047,11382381.png,312486,747,311739,0.9976094929052821,2,4,46745,98,46647,0.9979035190929512,21.62502222222222,2484.034352,14.179227634129312,126,3.600000000000003E-4
9,test_20231101_135047,11079715.png,443815,118057,325758,0.733995020447709,4,4,124136,16497,107639,0.8671054327511761,17.022149333333335,2131.304528,14.84434853255526,126,3.600000000000003E-4
10,test_20231101_135047,11551286.png,271883,427,271456,0.9984294715006087,1,4,40092,61,40031,0.9984784994512621,17.85376888888889,1855.7630026666666,15.445578486866474,126,3.600000000000003E-4
1,test_20231101_135047,10404007.png,502730,20472,482258,0.9592783402621685,3,3,61265,2964,58301,0.9516200114257732,25.783781333333334,3450.961552,12.75140240129671,126,3.700000000000003E-4
2,test_20231101_135047,1254659.png,342646,73189,269457,0.7864005416669099,4,4,80080,10238,69842,0.8721528471528471,20.99220088888889,3209.486672,13.066447843337867,126,3.700000000000003E-4
3,test_20231101_135047,10188041.png,221231,9592,211639,0.9566426043366436,2,4,41731,1351,40380,0.9676259854784213,10.691395555555555,1037.4407253333334,17.971170683956313,126,3.700000000000003E-4
4,test_20231101_135047,10287332.png,216980,12364,204616,0.943017789658033,2,3,22337,1696,20641,0.9240721672561221,9.497095111111111,790.9076053333333,19.149546091497648,126,3.700000000000003E-4
5,test_20231101_135047,11610969.png,368720,25037,343683,0.9320975265784335,2,4,84111,3655,80456,0.9565455172331799,21.725516444444445,3023.573904,13.3255977251099,126,3.700000000000003E-4
6,test_20231101_135047,10350842.png,212614,6002,206612,0.971770438447139,1,4,42529,879,41650,0.9793317500999318,19.329912888888888,2377.7495893333335,14.369142455293513,126,3.700000000000003E-4
7,test_20231101_135047,10863862.png,317432,11359,306073,0.9642159580634593,2,4,66058,1649,64409,0.9750370886190923,24.240064,3365.490752,12.860319593671788,126,3.700000000000003E-4
8,test_20231101_135047,11382381.png,312486,747,311739,0.9976094929052821,2,4,46745,98,46647,0.9979035190929512,21.62502222222222,2484.034352,14.179227634129312,126,3.700000000000003E-4
9,test_20231101_135047,11079715.png,443815,118057,325758,0.733995020447709,3,4,124136,16497,107639,0.8671054327511761,17.022149333333335,2131.304528,14.84434853255526,126,3.700000000000003E-4
10,test_20231101_135047,11551286.png,271883,427,271456,0.9984294715006087,1,3,40092,61,40031,0.9984784994512621,17.85376888888889,1855.7630026666666,15.445578486866474,126,3.700000000000003E-4
1,test_20231101_135048,10404007.png,502730,20472,482258,0.9592783402621685,2,3,61265,2964,58301,0.9516200114257732,25.783781333333334,3450.961552,12.75140240129671,126,3.8000000000000035E-4
2,test_20231101_135048,1254659.png,342646,73189,269457,0.7864005416669099,3,4,80080,10238,69842,0.8721528471528471,20.99220088888889,3209.486672,13.066447843337867,126,3.8000000000000035E-4
3,test_20231101_135048,10188041.png,221231,9592,211639,0.9566426043366436,2,4,41731,1351,40380,0.9676259854784213,10.691395555555555,1037.4407253333334,17.971170683956313,126,3.8000000000000035E-4
4,test_20231101_135048,10287332.png,216980,12364,204616,0.943017789658033,2,3,22337,1696,20641,0.9240721672561221,9.497095111111111,790.9076053333333,19.149546091497648,126,3.8000000000000035E-4
5,test_20231101_135048,11610969.png,368720,25037,343683,0.9320975265784335,2,4,84111,3655,80456,0.9565455172331799,21.725516444444445,3023.573904,13.3255977251099,126,3.8000000000000035E-4
6,test_20231101_135048,10350842.png,212614,6002,206612,0.971770438447139,2,4,42529,879,41650,0.9793317500999318,19.329912888888888,2377.7495893333335,14.369142455293513,126,3.8000000000000035E-4
7,test_20231101_135048,10863862.png,317432,11359,306073,0.9642159580634593,2,3,66058,1649,64409,0.9750370886190923,24.240064,3365.490752,12.860319593671788,126,3.8000000000000035E-4
8,test_20231101_135048,11382381.png,312486,747,311739,0.9976094929052821,2,3,46745,98,46647,0.9979035190929512,21.62502222222222,2484.034352,14.179227634129312,126,3.8000000000000035E-4
9,test_20231101_135048,11079715.png,443815,118057,325758,0.733995020447709,4,4,124136,16497,107639,0.8671054327511761,17.022149333333335,2131.304528,14.84434853255526,126,3.8000000000000035E-4
10,test_20231101_135048,11551286.png,271883,427,271456,0.9984294715006087,2,4,40092,61,40031,0.9984784994512621,17.85376888888889,1855.7630026666666,15.445578486866474,126,3.8000000000000035E-4
1,test_20231101_135049,10404007.png,502730,20472,482258,0.9592783402621685,3,4,61265,2964,58301,0.9516200114257732,25.783781333333334,3450.961552,12.75140240129671,126,3.9000000000000037E-4
2,test_20231101_135049,1254659.png,342646,73189,269457,0.7864005416669099,3,4,80080,10238,69842,0.8721528471528471,20.99220088888889,3209.486672,13.066447843337867,126,3.9000000000000037E-4
3,test_20231101_135049,10188041.png,221231,9592,211639,0.9566426043366436,2,4,41731,1351,40380,0.9676259854784213,10.691395555555555,1037.4407253333334,17.971170683956313,126,3.9000000000000037E-4
4,test_20231101_135049,10287332.png,216980,12364,204616,0.943017789658033,2,3,22337,1696,20641,0.9240721672561221,9.497095111111111,790.9076053333333,19.149546091497648,126,3.9000000000000037E-4
5,test_20231101_135049,11610969.png,368720,25037,343683,0.9320975265784335,2,4,84111,3655,80456,0.9565455172331799,21.725516444444445,3023.573904,13.3255977251099,126,3.9000000000000037E-4
6,test_20231101_135049,10350842.png,212614,6002,206612,0.971770438447139,1,4,42529,879,41650,0.9793317500999318,19.329912888888888,2377.7495893333335,14.369142455293513,126,3.9000000000000037E-4
7,test_20231101_135049,10863862.png,317432,11359,306073,0.9642159580634593,1,3,66058,1649,64409,0.9750370886190923,24.240064,3365.490752,12.860319593671788,126,3.9000000000000037E-4
8,test_20231101_135049,11382381.png,312486,747,311739,0.9976094929052821,2,4,46745,98,46647,0.9979035190929512,21.62502222222222,2484.034352,14.179227634129312,126,3.9000000000000037E-4
9,test_20231101_135049,11079715.png,443815,118057,325758,0.733995020447709,3,5,124136,16497,107639,0.8671054327511761,17.022149333333335,2131.304528,14.84434853255526,126,3.9000000000000037E-4
10,test_20231101_135049,11551286.png,271883,427,271456,0.9984294715006087,2,3,40092,61,40031,0.9984784994512621,17.85376888888889,1855.7630026666666,15.445578486866474,126,3.9000000000000037E-4
1,test_20231101_135050,10404007.png,502730,20472,482258,0.9592783402621685,2,4,61265,2964,58301,0.9516200114257732,25.783781333333334,3450.961552,12.75140240129671,126,4.000000000000004E-4
2,test_20231101_135050,1254659.png,342646,73189,269457,0.7864005416669099,3,4,80080,10238,69842,0.8721528471528471,20.99220088888889,3209.486672,13.066447843337867,126,4.000000000000004E-4
3,test_20231101_135050,10188041.png,221231,9592,211639,0.9566426043366436,2,4,41731,1351,40380,0.9676259854784213,10.691395555555555,1037.4407253333334,17.971170683956313,126,4.000000000000004E-4
4,test_20231101_135050,10287332.png,216980,12364,204616,0.943017789658033,1,4,22337,1696,20641,0.9240721672561221,9.497095111111111,790.9076053333333,19.149546091497648,126,4.000000000000004E-4
5,test_20231101_135050,11610969.png,368720,25037,343683,0.9320975265784335,2,4,84111,3655,80456,0.9565455172331799,21.725516444444445,3023.573904,13.3255977251099,126,4.000000000000004E-4
6,test_20231101_135050,10350842.png,212614,6002,206612,0.971770438447139,1,3,42529,879,41650,0.9793317500999318,19.329912888888888,2377.7495893333335,14.369142455293513,126,4.000000000000004E-4
7,test_20231101_135050,10863862.png,317432,11359,306073,0.9642159580634593,2,4,66058,1649,64409,0.9750370886190923,24.240064,3365.490752,12.860319593671788,126,4.000000000000004E-4
8,test_20231101_135050,11382381.png,312486,747,311739,0.9976094929052821,1,4,46745,98,46647,0.9979035190929512,21.62502222222222,2484.034352,14.179227634129312,126,4.000000000000004E-4
9,test_20231101_135050,11079715.png,443815,118057,325758,0.733995020447709,3,4,124136,16497,107639,0.8671054327511761,17.022149333333335,2131.304528,14.84434853255526,126,4.000000000000004E-4
10,test_20231101_135050,11551286.png,271883,427,271456,0.9984294715006087,1,4,40092,61,40031,0.9984784994512621,17.85376888888889,1855.7630026666666,15.445578486866474,126,4.000000000000004E-4
1,test_20231101_135050,10404007.png,502730,20472,482258,0.9592783402621685,2,4,61265,2964,58301,0.9516200114257732,25.783781333333334,3450.961552,12.75140240129671,126,4.100000000000004E-4
2,test_20231101_135050,1254659.png,342646,73189,269457,0.7864005416669099,3,4,80080,10238,69842,0.8721528471528471,20.99220088888889,3209.486672,13.066447843337867,126,4.100000000000004E-4
3,test_20231101_135050,10188041.png,221231,9592,211639,0.9566426043366436,2,3,41731,1351,40380,0.9676259854784213,10.691395555555555,1037.4407253333334,17.971170683956313,126,4.100000000000004E-4
4,test_20231101_135050,10287332.png,216980,12364,204616,0.943017789658033,2,4,22337,1696,20641,0.9240721672561221,9.497095111111111,790.9076053333333,19.149546091497648,126,4.100000000000004E-4
5,test_20231101_135050,11610969.png,368720,25037,343683,0.9320975265784335,2,4,84111,3655,80456,0.9565455172331799,21.725516444444445,3023.573904,13.3255977251099,126,4.100000000000004E-4
6,test_20231101_135050,10350842.png,212614,6002,206612,0.971770438447139,2,4,42529,879,41650,0.9793317500999318,19.329912888888888,2377.7495893333335,14.369142455293513,126,4.100000000000004E-4
7,test_20231101_135050,10863862.png,317432,11359,306073,0.9642159580634593,2,3,66058,1649,64409,0.9750370886190923,24.240064,3365.490752,12.860319593671788,126,4.100000000000004E-4
8,test_20231101_135050,11382381.png,312486,747,311739,0.9976094929052821,1,4,46745,98,46647,0.9979035190929512,21.62502222222222,2484.034352,14.179227634129312,126,4.100000000000004E-4
9,test_20231101_135050,11079715.png,443815,118057,325758,0.733995020447709,3,4,124136,16497,107639,0.8671054327511761,17.022149333333335,2131.304528,14.84434853255526,126,4.100000000000004E-4
10,test_20231101_135050,11551286.png,271883,427,271456,0.9984294715006087,2,3,40092,61,40031,0.9984784994512621,17.85376888888889,1855.7630026666666,15.445578486866474,126,4.100000000000004E-4
1,test_20231101_135051,10404007.png,502730,20472,482258,0.9592783402621685,2,4,61265,2964,58301,0.9516200114257732,25.783781333333334,3450.961552,12.75140240129671,126,4.2000000000000045E-4
2,test_20231101_135051,1254659.png,342646,73189,269457,0.7864005416669099,3,4,80080,10238,69842,0.8721528471528471,20.99220088888889,3209.486672,13.066447843337867,126,4.2000000000000045E-4
3,test_20231101_135051,10188041.png,221231,9592,211639,0.9566426043366436,2,5,41731,1351,40380,0.9676259854784213,10.691395555555555,1037.4407253333334,17.971170683956313,126,4.2000000000000045E-4
4,test_20231101_135051,10287332.png,216980,12364,204616,0.943017789658033,2,4,22337,1696,20641,0.9240721672561221,9.497095111111111,790.9076053333333,19.149546091497648,126,4.2000000000000045E-4
5,test_20231101_135051,11610969.png,368720,25037,343683,0.9320975265784335,3,4,84111,3655,80456,0.9565455172331799,21.725516444444445,3023.573904,13.3255977251099,126,4.2000000000000045E-4
6,test_20231101_135051,10350842.png,212614,6002,206612,0.971770438447139,2,4,42529,879,41650,0.9793317500999318,19.329912888888888,2377.7495893333335,14.369142455293513,126,4.2000000000000045E-4
7,test_20231101_135051,10863862.png,317432,11359,306073,0.9642159580634593,2,4,66058,1649,64409,0.9750370886190923,24.240064,3365.490752,12.860319593671788,126,4.2000000000000045E-4
8,test_20231101_135051,11382381.png,312486,747,311739,0.9976094929052821,1,3,46745,98,46647,0.9979035190929512,21.62502222222222,2484.034352,14.179227634129312,126,4.2000000000000045E-4
9,test_20231101_135051,11079715.png,443815,118057,325758,0.733995020447709,4,4,124136,16497,107639,0.8671054327511761,17.022149333333335,2131.304528,14.84434853255526,126,4.2000000000000045E-4
10,test_20231101_135051,11551286.png,271883,427,271456,0.9984294715006087,1,3,40092,61,40031,0.9984784994512621,17.85376888888889,1855.7630026666666,15.445578486866474,126,4.2000000000000045E-4
1,test_20231101_135052,10404007.png,502730,20472,482258,0.9592783402621685,2,4,61265,2964,58301,0.9516200114257732,25.783781333333334,3450.961552,12.75140240129671,126,4.300000000000005E-4
2,test_20231101_135052,1254659.png,342646,73189,269457,0.7864005416669099,3,4,80080,10238,69842,0.8721528471528471,20.99220088888889,3209.486672,13.066447843337867,126,4.300000000000005E-4
3,test_20231101_135052,10188041.png,221231,9592,211639,0.9566426043366436,2,3,41731,1351,40380,0.9676259854784213,10.691395555555555,1037.4407253333334,17.971170683956313,126,4.300000000000005E-4
4,test_20231101_135052,10287332.png,216980,12364,204616,0.943017789658033,1,3,22337,1696,20641,0.9240721672561221,9.497095111111111,790.9076053333333,19.149546091497648,126,4.300000000000005E-4
5,test_20231101_135052,11610969.png,368720,25037,343683,0.9320975265784335,2,4,84111,3655,80456,0.9565455172331799,21.725516444444445,3023.573904,13.3255977251099,126,4.300000000000005E-4
6,test_20231101_135052,10350842.png,212614,6002,206612,0.971770438447139,2,4,42529,879,41650,0.9793317500999318,19.329912888888888,2377.7495893333335,14.369142455293513,126,4.300000000000005E-4
7,test_20231101_135052,10863862.png,317432,11359,306073,0.9642159580634593,2,4,66058,1649,64409,0.9750370886190923,24.240064,3365.490752,12.860319593671788,126,4.300000000000005E-4
8,test_20231101_135052,11382381.png,312486,747,311739,0.9976094929052821,1,3,46745,98,46647,0.9979035190929512,21.62502222222222,2484.034352,14.179227634129312,126,4.300000000000005E-4
9,test_20231101_135052,11079715.png,443815,118057,325758,0.733995020447709,3,4,124136,16497,107639,0.8671054327511761,17.022149333333335,2131.304528,14.84434853255526,126,4.300000000000005E-4
10,test_20231101_135052,11551286.png,271883,427,271456,0.9984294715006087,1,4,40092,61,40031,0.9984784994512621,17.85376888888889,1855.7630026666666,15.445578486866474,126,4.300000000000005E-4
1,test_20231101_135052,10404007.png,502730,20472,482258,0.9592783402621685,2,4,61265,2964,58301,0.9516200114257732,25.783781333333334,3450.961552,12.75140240129671,126,4.400000000000005E-4
2,test_20231101_135052,1254659.png,342646,73189,269457,0.7864005416669099,3,4,80080,10238,69842,0.8721528471528471,20.99220088888889,3209.486672,13.066447843337867,126,4.400000000000005E-4
3,test_20231101_135052,10188041.png,221231,9592,211639,0.9566426043366436,2,3,41731,1351,40380,0.9676259854784213,10.691395555555555,1037.4407253333334,17.971170683956313,126,4.400000000000005E-4
4,test_20231101_135052,10287332.png,216980,12364,204616,0.943017789658033,5,4,22337,1696,20641,0.9240721672561221,9.497095111111111,790.9076053333333,19.149546091497648,126,4.400000000000005E-4
5,test_20231101_135052,11610969.png,368720,25037,343683,0.9320975265784335,2,3,84111,3655,80456,0.9565455172331799,21.725516444444445,3023.573904,13.3255977251099,126,4.400000000000005E-4
6,test_20231101_135052,10350842.png,212614,6002,206612,0.971770438447139,1,4,42529,879,41650,0.9793317500999318,19.329912888888888,2377.7495893333335,14.369142455293513,126,4.400000000000005E-4
7,test_20231101_135052,10863862.png,317432,11359,306073,0.9642159580634593,2,4,66058,1649,64409,0.9750370886190923,24.240064,3365.490752,12.860319593671788,126,4.400000000000005E-4
8,test_20231101_135052,11382381.png,312486,747,311739,0.9976094929052821,2,4,46745,98,46647,0.9979035190929512,21.62502222222222,2484.034352,14.179227634129312,126,4.400000000000005E-4
9,test_20231101_135052,11079715.png,443815,118057,325758,0.733995020447709,3,4,124136,16497,107639,0.8671054327511761,17.022149333333335,2131.304528,14.84434853255526,126,4.400000000000005E-4
10,test_20231101_135052,11551286.png,271883,427,271456,0.9984294715006087,1,3,40092,61,40031,0.9984784994512621,17.85376888888889,1855.7630026666666,15.445578486866474,126,4.400000000000005E-4
1,test_20231101_135053,10404007.png,502730,20472,482258,0.9592783402621685,3,4,61265,2964,58301,0.9516200114257732,25.783781333333334,3450.961552,12.75140240129671,126,4.5000000000000053E-4
2,test_20231101_135053,1254659.png,342646,73189,269457,0.7864005416669099,3,4,80080,10238,69842,0.8721528471528471,20.99220088888889,3209.486672,13.066447843337867,126,4.5000000000000053E-4
3,test_20231101_135053,10188041.png,221231,9592,211639,0.9566426043366436,2,3,41731,1351,40380,0.9676259854784213,10.691395555555555,1037.4407253333334,17.971170683956313,126,4.5000000000000053E-4
4,test_20231101_135053,10287332.png,216980,12364,204616,0.943017789658033,2,3,22337,1696,20641,0.9240721672561221,9.497095111111111,790.9076053333333,19.149546091497648,126,4.5000000000000053E-4
5,test_20231101_135053,11610969.png,368720,25037,343683,0.9320975265784335,2,4,84111,3655,80456,0.9565455172331799,21.725516444444445,3023.573904,13.3255977251099,126,4.5000000000000053E-4
6,test_20231101_135053,10350842.png,212614,6002,206612,0.971770438447139,2,3,42529,879,41650,0.9793317500999318,19.329912888888888,2377.7495893333335,14.369142455293513,126,4.5000000000000053E-4
7,test_20231101_135053,10863862.png,317432,10292,307140,0.9675773078958643,2,4,66058,1495,64563,0.9773683732477519,26.677214222222222,4038.738533333333,12.068346228764726,126,4.5000000000000053E-4
8,test_20231101_135053,11382381.png,312486,747,311739,0.9976094929052821,2,4,46745,98,46647,0.9979035190929512,21.62502222222222,2484.034352,14.179227634129312,126,4.5000000000000053E-4
9,test_20231101_135053,11079715.png,443815,118057,325758,0.733995020447709,3,4,124136,16497,107639,0.8671054327511761,17.022149333333335,2131.304528,14.84434853255526,126,4.5000000000000053E-4
10,test_20231101_135053,11551286.png,271883,427,271456,0.9984294715006087,1,4,40092,61,40031,0.9984784994512621,17.85376888888889,1855.7630026666666,15.445578486866474,126,4.5000000000000053E-4
1,test_20231101_135054,10404007.png,502730,20472,482258,0.9592783402621685,2,4,61265,2964,58301,0.9516200114257732,25.783781333333334,3450.961552,12.75140240129671,126,4.6000000000000056E-4
2,test_20231101_135054,1254659.png,342646,73189,269457,0.7864005416669099,3,5,80080,10238,69842,0.8721528471528471,20.99220088888889,3209.486672,13.066447843337867,126,4.6000000000000056E-4
3,test_20231101_135054,10188041.png,221231,9592,211639,0.9566426043366436,2,4,41731,1351,40380,0.9676259854784213,10.691395555555555,1037.4407253333334,17.971170683956313,126,4.6000000000000056E-4
4,test_20231101_135054,10287332.png,216980,12364,204616,0.943017789658033,1,3,22337,1696,20641,0.9240721672561221,9.497095111111111,790.9076053333333,19.149546091497648,126,4.6000000000000056E-4
5,test_20231101_135054,11610969.png,368720,25037,343683,0.9320975265784335,2,3,84111,3655,80456,0.9565455172331799,21.725516444444445,3023.573904,13.3255977251099,126,4.6000000000000056E-4
6,test_20231101_135054,10350842.png,212614,6002,206612,0.971770438447139,2,4,42529,879,41650,0.9793317500999318,19.329912888888888,2377.7495893333335,14.369142455293513,126,4.6000000000000056E-4
7,test_20231101_135054,10863862.png,317432,10292,307140,0.9675773078958643,2,3,66058,1495,64563,0.9773683732477519,26.677214222222222,4038.738533333333,12.068346228764726,126,4.6000000000000056E-4
8,test_20231101_135054,11382381.png,312486,747,311739,0.9976094929052821,1,3,46745,98,46647,0.9979035190929512,21.62502222222222,2484.034352,14.179227634129312,126,4.6000000000000056E-4
9,test_20231101_135054,11079715.png,443815,118057,325758,0.733995020447709,4,4,124136,16497,107639,0.8671054327511761,17.022149333333335,2131.304528,14.84434853255526,126,4.6000000000000056E-4
10,test_20231101_135054,11551286.png,271883,427,271456,0.9984294715006087,1,4,40092,61,40031,0.9984784994512621,17.85376888888889,1855.7630026666666,15.445578486866474,126,4.6000000000000056E-4
1,test_20231101_135054,10404007.png,502730,20472,482258,0.9592783402621685,2,4,61265,2964,58301,0.9516200114257732,25.783781333333334,3450.961552,12.75140240129671,126,4.700000000000006E-4
2,test_20231101_135054,1254659.png,342646,73189,269457,0.7864005416669099,3,4,80080,10238,69842,0.8721528471528471,20.99220088888889,3209.486672,13.066447843337867,126,4.700000000000006E-4
3,test_20231101_135054,10188041.png,221231,9592,211639,0.9566426043366436,2,3,41731,1351,40380,0.9676259854784213,10.691395555555555,1037.4407253333334,17.971170683956313,126,4.700000000000006E-4
4,test_20231101_135054,10287332.png,216980,12364,204616,0.943017789658033,1,3,22337,1696,20641,0.9240721672561221,9.497095111111111,790.9076053333333,19.149546091497648,126,4.700000000000006E-4
5,test_20231101_135054,11610969.png,368720,25037,343683,0.9320975265784335,3,4,84111,3655,80456,0.9565455172331799,21.725516444444445,3023.573904,13.3255977251099,126,4.700000000000006E-4
6,test_20231101_135054,10350842.png,212614,6002,206612,0.971770438447139,2,3,42529,879,41650,0.9793317500999318,19.329912888888888,2377.7495893333335,14.369142455293513,126,4.700000000000006E-4
7,test_20231101_135054,10863862.png,317432,10292,307140,0.9675773078958643,2,4,66058,1495,64563,0.9773683732477519,26.677214222222222,4038.738533333333,12.068346228764726,126,4.700000000000006E-4
8,test_20231101_135054,11382381.png,312486,747,311739,0.9976094929052821,2,3,46745,98,46647,0.9979035190929512,21.62502222222222,2484.034352,14.179227634129312,126,4.700000000000006E-4
9,test_20231101_135054,11079715.png,443815,118057,325758,0.733995020447709,4,4,124136,16497,107639,0.8671054327511761,17.022149333333335,2131.304528,14.84434853255526,126,4.700000000000006E-4
10,test_20231101_135054,11551286.png,271883,427,271456,0.9984294715006087,2,3,40092,61,40031,0.9984784994512621,17.85376888888889,1855.7630026666666,15.445578486866474,126,4.700000000000006E-4
1,test_20231101_135055,10404007.png,502730,20472,482258,0.9592783402621685,2,4,61265,2964,58301,0.9516200114257732,25.783781333333334,3450.961552,12.75140240129671,126,4.800000000000006E-4
2,test_20231101_135055,1254659.png,342646,73189,269457,0.7864005416669099,4,4,80080,10238,69842,0.8721528471528471,20.99220088888889,3209.486672,13.066447843337867,126,4.800000000000006E-4
3,test_20231101_135055,10188041.png,221231,9592,211639,0.9566426043366436,2,3,41731,1351,40380,0.9676259854784213,10.691395555555555,1037.4407253333334,17.971170683956313,126,4.800000000000006E-4
4,test_20231101_135055,10287332.png,216980,12364,204616,0.943017789658033,2,4,22337,1696,20641,0.9240721672561221,9.497095111111111,790.9076053333333,19.149546091497648,126,4.800000000000006E-4
5,test_20231101_135055,11610969.png,368720,25037,343683,0.9320975265784335,2,4,84111,3655,80456,0.9565455172331799,21.725516444444445,3023.573904,13.3255977251099,126,4.800000000000006E-4
6,test_20231101_135055,10350842.png,212614,6002,206612,0.971770438447139,2,4,42529,879,41650,0.9793317500999318,19.329912888888888,2377.7495893333335,14.369142455293513,126,4.800000000000006E-4
7,test_20231101_135055,10863862.png,317432,10292,307140,0.9675773078958643,2,4,66058,1495,64563,0.9773683732477519,26.677214222222222,4038.738533333333,12.068346228764726,126,4.800000000000006E-4
8,test_20231101_135055,11382381.png,312486,747,311739,0.9976094929052821,2,4,46745,98,46647,0.9979035190929512,21.62502222222222,2484.034352,14.179227634129312,126,4.800000000000006E-4
9,test_20231101_135055,11079715.png,443815,118057,325758,0.733995020447709,3,4,124136,16497,107639,0.8671054327511761,17.022149333333335,2131.304528,14.84434853255526,126,4.800000000000006E-4
10,test_20231101_135055,11551286.png,271883,427,271456,0.9984294715006087,1,3,40092,61,40031,0.9984784994512621,17.85376888888889,1855.7630026666666,15.445578486866474,126,4.800000000000006E-4
1,test_20231101_135056,10404007.png,502730,20472,482258,0.9592783402621685,4,3,61265,2964,58301,0.9516200114257732,25.783781333333334,3450.961552,12.75140240129671,126,4.900000000000006E-4
2,test_20231101_135056,1254659.png,342646,73189,269457,0.7864005416669099,2,3,80080,10238,69842,0.8721528471528471,20.99220088888889,3209.486672,13.066447843337867,126,4.900000000000006E-4
3,test_20231101_135056,10188041.png,221231,9592,211639,0.9566426043366436,2,4,41731,1351,40380,0.9676259854784213,10.691395555555555,1037.4407253333334,17.971170683956313,126,4.900000000000006E-4
4,test_20231101_135056,10287332.png,216980,12364,204616,0.943017789658033,1,3,22337,1696,20641,0.9240721672561221,9.497095111111111,790.9076053333333,19.149546091497648,126,4.900000000000006E-4
5,test_20231101_135056,11610969.png,368720,25037,343683,0.9320975265784335,3,3,84111,3655,80456,0.9565455172331799,21.725516444444445,3023.573904,13.3255977251099,126,4.900000000000006E-4
6,test_20231101_135056,10350842.png,212614,6002,206612,0.971770438447139,2,3,42529,879,41650,0.9793317500999318,19.329912888888888,2377.7495893333335,14.369142455293513,126,4.900000000000006E-4
7,test_20231101_135056,10863862.png,317432,10292,307140,0.9675773078958643,1,3,66058,1495,64563,0.9773683732477519,26.677214222222222,4038.738533333333,12.068346228764726,126,4.900000000000006E-4
8,test_20231101_135056,11382381.png,312486,747,311739,0.9976094929052821,1,4,46745,98,46647,0.9979035190929512,21.62502222222222,2484.034352,14.179227634129312,126,4.900000000000006E-4
9,test_20231101_135056,11079715.png,443815,118057,325758,0.733995020447709,3,4,124136,16497,107639,0.8671054327511761,17.022149333333335,2131.304528,14.84434853255526,126,4.900000000000006E-4
10,test_20231101_135056,11551286.png,271883,427,271456,0.9984294715006087,2,3,40092,61,40031,0.9984784994512621,17.85376888888889,1855.7630026666666,15.445578486866474,126,4.900000000000006E-4
1,test_20231101_135056,10404007.png,502730,20472,482258,0.9592783402621685,2,3,61265,2964,58301,0.9516200114257732,25.783781333333334,3450.961552,12.75140240129671,126,5.000000000000007E-4
2,test_20231101_135056,1254659.png,342646,73189,269457,0.7864005416669099,3,4,80080,10238,69842,0.8721528471528471,20.99220088888889,3209.486672,13.066447843337867,126,5.000000000000007E-4
3,test_20231101_135056,10188041.png,221231,9592,211639,0.9566426043366436,2,4,41731,1351,40380,0.9676259854784213,10.691395555555555,1037.4407253333334,17.971170683956313,126,5.000000000000007E-4
4,test_20231101_135056,10287332.png,216980,12364,204616,0.943017789658033,2,4,22337,1696,20641,0.9240721672561221,9.497095111111111,790.9076053333333,19.149546091497648,126,5.000000000000007E-4
5,test_20231101_135056,11610969.png,368720,25037,343683,0.9320975265784335,2,4,84111,3655,80456,0.9565455172331799,21.725516444444445,3023.573904,13.3255977251099,126,5.000000000000007E-4
6,test_20231101_135056,10350842.png,212614,6002,206612,0.971770438447139,2,4,42529,879,41650,0.9793317500999318,19.329912888888888,2377.7495893333335,14.369142455293513,126,5.000000000000007E-4
7,test_20231101_135056,10863862.png,317432,10292,307140,0.9675773078958643,2,3,66058,1495,64563,0.9773683732477519,26.677214222222222,4038.738533333333,12.068346228764726,126,5.000000000000007E-4
8,test_20231101_135056,11382381.png,312486,747,311739,0.9976094929052821,1,3,46745,98,46647,0.9979035190929512,21.62502222222222,2484.034352,14.179227634129312,126,5.000000000000007E-4
9,test_20231101_135056,11079715.png,443815,118057,325758,0.733995020447709,4,4,124136,16497,107639,0.8671054327511761,17.022149333333335,2131.304528,14.84434853255526,126,5.000000000000007E-4
10,test_20231101_135056,11551286.png,271883,427,271456,0.9984294715006087,1,4,40092,61,40031,0.9984784994512621,17.85376888888889,1855.7630026666666,15.445578486866474,126,5.000000000000007E-4
1,test_20231101_135057,10404007.png,502730,20372,482358,0.959477254192111,2,4,61265,2952,58313,0.9518158818248592,25.79210488888889,3453.019728,12.748813012740124,126,5.100000000000007E-4
2,test_20231101_135057,1254659.png,342646,73189,269457,0.7864005416669099,3,4,80080,10238,69842,0.8721528471528471,20.99220088888889,3209.486672,13.066447843337867,126,5.100000000000007E-4
3,test_20231101_135057,10188041.png,221231,9489,211742,0.9571081810415357,2,3,41731,1338,40393,0.9679375044930627,11.075875555555555,1087.4010666666666,17.766906061885894,126,5.100000000000007E-4
4,test_20231101_135057,10287332.png,216980,12364,204616,0.943017789658033,1,3,22337,1696,20641,0.9240721672561221,9.497095111111111,790.9076053333333,19.149546091497648,126,5.100000000000007E-4
5,test_20231101_135057,11610969.png,368720,25037,343683,0.9320975265784335,2,3,84111,3655,80456,0.9565455172331799,21.725516444444445,3023.573904,13.3255977251099,126,5.100000000000007E-4
6,test_20231101_135057,10350842.png,212614,6002,206612,0.971770438447139,1,3,42529,879,41650,0.9793317500999318,19.329912888888888,2377.7495893333335,14.369142455293513,126,5.100000000000007E-4
7,test_20231101_135057,10863862.png,317432,10292,307140,0.9675773078958643,2,3,66058,1495,64563,0.9773683732477519,26.677214222222222,4038.738533333333,12.068346228764726,126,5.100000000000007E-4
8,test_20231101_135057,11382381.png,312486,747,311739,0.9976094929052821,1,3,46745,98,46647,0.9979035190929512,21.62502222222222,2484.034352,14.179227634129312,126,5.100000000000007E-4
9,test_20231101_135057,11079715.png,443815,118057,325758,0.733995020447709,4,4,124136,16497,107639,0.8671054327511761,17.022149333333335,2131.304528,14.84434853255526,126,5.100000000000007E-4
10,test_20231101_135057,11551286.png,271883,367,271516,0.9986501546621157,1,3,40092,52,40040,0.9987029831387808,18.002010666666667,1874.0560373333333,15.402977880083654,126,5.100000000000007E-4
1,test_20231101_135058,10404007.png,502730,20152,482578,0.9599148648379846,3,3,61265,2920,58345,0.9523382028890884,25.83563022222222,3461.3983253333336,12.738287816430331,126,5.200000000000007E-4
2,test_20231101_135058,1254659.png,342646,73189,269457,0.7864005416669099,3,4,80080,10238,69842,0.8721528471528471,20.99220088888889,3209.486672,13.066447843337867,126,5.200000000000007E-4
3,test_20231101_135058,10188041.png,221231,9489,211742,0.9571081810415357,2,4,41731,1338,40393,0.9679375044930627,11.075875555555555,1087.4010666666666,17.766906061885894,126,5.200000000000007E-4
4,test_20231101_135058,10287332.png,216980,12364,204616,0.943017789658033,2,4,22337,1696,20641,0.9240721672561221,9.497095111111111,790.9076053333333,19.149546091497648,126,5.200000000000007E-4
5,test_20231101_135058,11610969.png,368720,25037,343683,0.9320975265784335,2,4,84111,3655,80456,0.9565455172331799,21.725516444444445,3023.573904,13.3255977251099,126,5.200000000000007E-4
6,test_20231101_135058,10350842.png,212614,6002,206612,0.971770438447139,1,3,42529,879,41650,0.9793317500999318,19.329912888888888,2377.7495893333335,14.369142455293513,126,5.200000000000007E-4
7,test_20231101_135058,10863862.png,317432,10292,307140,0.9675773078958643,2,3,66058,1495,64563,0.9773683732477519,26.677214222222222,4038.738533333333,12.068346228764726,126,5.200000000000007E-4
8,test_20231101_135058,11382381.png,312486,747,311739,0.9976094929052821,2,3,46745,98,46647,0.9979035190929512,21.62502222222222,2484.034352,14.179227634129312,126,5.200000000000007E-4
9,test_20231101_135058,11079715.png,443815,118057,325758,0.733995020447709,3,10,124136,16497,107639,0.8671054327511761,17.022149333333335,2131.304528,14.84434853255526,126,5.200000000000007E-4
10,test_20231101_135058,11551286.png,271883,367,271516,0.9986501546621157,1,3,40092,52,40040,0.9987029831387808,18.002010666666667,1874.0560373333333,15.402977880083654,126,5.200000000000007E-4
1,test_20231101_135058,10404007.png,502730,20152,482578,0.9599148648379846,3,3,61265,2920,58345,0.9523382028890884,25.83563022222222,3461.3983253333336,12.738287816430331,126,5.300000000000007E-4
2,test_20231101_135058,1254659.png,342646,73189,269457,0.7864005416669099,3,3,80080,10238,69842,0.8721528471528471,20.99220088888889,3209.486672,13.066447843337867,126,5.300000000000007E-4
3,test_20231101_135058,10188041.png,221231,9489,211742,0.9571081810415357,2,4,41731,1338,40393,0.9679375044930627,11.075875555555555,1087.4010666666666,17.766906061885894,126,5.300000000000007E-4
4,test_20231101_135058,10287332.png,216980,12364,204616,0.943017789658033,1,3,22337,1696,20641,0.9240721672561221,9.497095111111111,790.9076053333333,19.149546091497648,126,5.300000000000007E-4
5,test_20231101_135058,11610969.png,368720,25037,343683,0.9320975265784335,2,4,84111,3655,80456,0.9565455172331799,21.725516444444445,3023.573904,13.3255977251099,126,5.300000000000007E-4
6,test_20231101_135058,10350842.png,212614,6002,206612,0.971770438447139,1,4,42529,879,41650,0.9793317500999318,19.329912888888888,2377.7495893333335,14.369142455293513,126,5.300000000000007E-4
7,test_20231101_135058,10863862.png,317432,10292,307140,0.9675773078958643,2,4,66058,1495,64563,0.9773683732477519,26.677214222222222,4038.738533333333,12.068346228764726,126,5.300000000000007E-4
8,test_20231101_135058,11382381.png,312486,747,311739,0.9976094929052821,1,3,46745,98,46647,0.9979035190929512,21.62502222222222,2484.034352,14.179227634129312,126,5.300000000000007E-4
9,test_20231101_135058,11079715.png,443815,118057,325758,0.733995020447709,4,4,124136,16497,107639,0.8671054327511761,17.022149333333335,2131.304528,14.84434853255526,126,5.300000000000007E-4
10,test_20231101_135058,11551286.png,271883,367,271516,0.9986501546621157,1,3,40092,52,40040,0.9987029831387808,18.002010666666667,1874.0560373333333,15.402977880083654,126,5.300000000000007E-4
1,test_20231101_135059,10404007.png,502730,20152,482578,0.9599148648379846,2,4,61265,2920,58345,0.9523382028890884,25.83563022222222,3461.3983253333336,12.738287816430331,126,5.400000000000008E-4
2,test_20231101_135059,1254659.png,342646,73189,269457,0.7864005416669099,3,4,80080,10238,69842,0.8721528471528471,20.99220088888889,3209.486672,13.066447843337867,126,5.400000000000008E-4
3,test_20231101_135059,10188041.png,221231,9489,211742,0.9571081810415357,2,3,41731,1338,40393,0.9679375044930627,11.075875555555555,1087.4010666666666,17.766906061885894,126,5.400000000000008E-4
4,test_20231101_135059,10287332.png,216980,12364,204616,0.943017789658033,2,4,22337,1696,20641,0.9240721672561221,9.497095111111111,790.9076053333333,19.149546091497648,126,5.400000000000008E-4
5,test_20231101_135059,11610969.png,368720,25037,343683,0.9320975265784335,3,4,84111,3655,80456,0.9565455172331799,21.725516444444445,3023.573904,13.3255977251099,126,5.400000000000008E-4
6,test_20231101_135059,10350842.png,212614,6002,206612,0.971770438447139,2,4,42529,879,41650,0.9793317500999318,19.329912888888888,2377.7495893333335,14.369142455293513,126,5.400000000000008E-4
7,test_20231101_135059,10863862.png,317432,10292,307140,0.9675773078958643,2,3,66058,1495,64563,0.9773683732477519,26.677214222222222,4038.738533333333,12.068346228764726,126,5.400000000000008E-4
8,test_20231101_135059,11382381.png,312486,747,311739,0.9976094929052821,2,3,46745,98,46647,0.9979035190929512,21.62502222222222,2484.034352,14.179227634129312,126,5.400000000000008E-4
9,test_20231101_135059,11079715.png,443815,118057,325758,0.733995020447709,4,4,124136,16497,107639,0.8671054327511761,17.022149333333335,2131.304528,14.84434853255526,126,5.400000000000008E-4
10,test_20231101_135059,11551286.png,271883,367,271516,0.9986501546621157,1,4,40092,52,40040,0.9987029831387808,18.002010666666667,1874.0560373333333,15.402977880083654,126,5.400000000000008E-4
1,test_20231101_135100,10404007.png,502730,20152,482578,0.9599148648379846,2,3,61265,2920,58345,0.9523382028890884,25.83563022222222,3461.3983253333336,12.738287816430331,126,5.500000000000008E-4
2,test_20231101_135100,1254659.png,342646,73189,269457,0.7864005416669099,3,4,80080,10238,69842,0.8721528471528471,20.99220088888889,3209.486672,13.066447843337867,126,5.500000000000008E-4
3,test_20231101_135100,10188041.png,221231,9489,211742,0.9571081810415357,2,14,41731,1338,40393,0.9679375044930627,11.075875555555555,1087.4010666666666,17.766906061885894,126,5.500000000000008E-4
4,test_20231101_135100,10287332.png,216980,12364,204616,0.943017789658033,2,4,22337,1696,20641,0.9240721672561221,9.497095111111111,790.9076053333333,19.149546091497648,126,5.500000000000008E-4
5,test_20231101_135100,11610969.png,368720,25037,343683,0.9320975265784335,2,3,84111,3655,80456,0.9565455172331799,21.725516444444445,3023.573904,13.3255977251099,126,5.500000000000008E-4
6,test_20231101_135100,10350842.png,212614,6002,206612,0.971770438447139,1,4,42529,879,41650,0.9793317500999318,19.329912888888888,2377.7495893333335,14.369142455293513,126,5.500000000000008E-4
7,test_20231101_135100,10863862.png,317432,10292,307140,0.9675773078958643,2,3,66058,1495,64563,0.9773683732477519,26.677214222222222,4038.738533333333,12.068346228764726,126,5.500000000000008E-4
8,test_20231101_135100,11382381.png,312486,747,311739,0.9976094929052821,2,3,46745,98,46647,0.9979035190929512,21.62502222222222,2484.034352,14.179227634129312,126,5.500000000000008E-4
9,test_20231101_135100,11079715.png,443815,118057,325758,0.733995020447709,4,4,124136,16497,107639,0.8671054327511761,17.022149333333335,2131.304528,14.84434853255526,126,5.500000000000008E-4
10,test_20231101_135100,11551286.png,271883,367,271516,0.9986501546621157,1,4,40092,52,40040,0.9987029831387808,18.002010666666667,1874.0560373333333,15.402977880083654,126,5.500000000000008E-4
1,test_20231101_135100,10404007.png,502730,20152,482578,0.9599148648379846,2,3,61265,2920,58345,0.9523382028890884,25.83563022222222,3461.3983253333336,12.738287816430331,126,5.600000000000008E-4
2,test_20231101_135100,1254659.png,342646,73189,269457,0.7864005416669099,2,4,80080,10238,69842,0.8721528471528471,20.99220088888889,3209.486672,13.066447843337867,126,5.600000000000008E-4
3,test_20231101_135100,10188041.png,221231,9489,211742,0.9571081810415357,2,3,41731,1338,40393,0.9679375044930627,11.075875555555555,1087.4010666666666,17.766906061885894,126,5.600000000000008E-4
4,test_20231101_135100,10287332.png,216980,12364,204616,0.943017789658033,1,3,22337,1696,20641,0.9240721672561221,9.497095111111111,790.9076053333333,19.149546091497648,126,5.600000000000008E-4
5,test_20231101_135100,11610969.png,368720,25037,343683,0.9320975265784335,2,4,84111,3655,80456,0.9565455172331799,21.725516444444445,3023.573904,13.3255977251099,126,5.600000000000008E-4
6,test_20231101_135100,10350842.png,212614,6002,206612,0.971770438447139,2,3,42529,879,41650,0.9793317500999318,19.329912888888888,2377.7495893333335,14.369142455293513,126,5.600000000000008E-4
7,test_20231101_135100,10863862.png,317432,10292,307140,0.9675773078958643,2,3,66058,1495,64563,0.9773683732477519,26.677214222222222,4038.738533333333,12.068346228764726,126,5.600000000000008E-4
8,test_20231101_135100,11382381.png,312486,747,311739,0.9976094929052821,2,3,46745,98,46647,0.9979035190929512,21.62502222222222,2484.034352,14.179227634129312,126,5.600000000000008E-4
9,test_20231101_135100,11079715.png,443815,118057,325758,0.733995020447709,3,4,124136,16497,107639,0.8671054327511761,17.022149333333335,2131.304528,14.84434853255526,126,5.600000000000008E-4
10,test_20231101_135100,11551286.png,271883,367,271516,0.9986501546621157,1,3,40092,52,40040,0.9987029831387808,18.002010666666667,1874.0560373333333,15.402977880083654,126,5.600000000000008E-4
1,test_20231101_135101,10404007.png,502730,20152,482578,0.9599148648379846,2,4,61265,2920,58345,0.9523382028890884,25.83563022222222,3461.3983253333336,12.738287816430331,126,5.700000000000008E-4
2,test_20231101_135101,1254659.png,342646,73189,269457,0.7864005416669099,3,4,80080,10238,69842,0.8721528471528471,20.99220088888889,3209.486672,13.066447843337867,126,5.700000000000008E-4
3,test_20231101_135101,10188041.png,221231,9489,211742,0.9571081810415357,2,4,41731,1338,40393,0.9679375044930627,11.075875555555555,1087.4010666666666,17.766906061885894,126,5.700000000000008E-4
4,test_20231101_135101,10287332.png,216980,12364,204616,0.943017789658033,2,4,22337,1696,20641,0.9240721672561221,9.497095111111111,790.9076053333333,19.149546091497648,126,5.700000000000008E-4
5,test_20231101_135101,11610969.png,368720,25037,343683,0.9320975265784335,2,4,84111,3655,80456,0.9565455172331799,21.725516444444445,3023.573904,13.3255977251099,126,5.700000000000008E-4
6,test_20231101_135101,10350842.png,212614,6002,206612,0.971770438447139,2,4,42529,879,41650,0.9793317500999318,19.329912888888888,2377.7495893333335,14.369142455293513,126,5.700000000000008E-4
7,test_20231101_135101,10863862.png,317432,10292,307140,0.9675773078958643,3,4,66058,1495,64563,0.9773683732477519,26.677214222222222,4038.738533333333,12.068346228764726,126,5.700000000000008E-4
8,test_20231101_135101,11382381.png,312486,747,311739,0.9976094929052821,1,3,46745,98,46647,0.9979035190929512,21.62502222222222,2484.034352,14.179227634129312,126,5.700000000000008E-4
9,test_20231101_135101,11079715.png,443815,118057,325758,0.733995020447709,4,4,124136,16497,107639,0.8671054327511761,17.022149333333335,2131.304528,14.84434853255526,126,5.700000000000008E-4
10,test_20231101_135101,11551286.png,271883,367,271516,0.9986501546621157,1,4,40092,52,40040,0.9987029831387808,18.002010666666667,1874.0560373333333,15.402977880083654,126,5.700000000000008E-4
1,test_20231101_135102,10404007.png,502730,20152,482578,0.9599148648379846,4,4,61265,2920,58345,0.9523382028890884,25.83563022222222,3461.3983253333336,12.738287816430331,126,5.800000000000009E-4
2,test_20231101_135102,1254659.png,342646,73189,269457,0.7864005416669099,3,4,80080,10238,69842,0.8721528471528471,20.99220088888889,3209.486672,13.066447843337867,126,5.800000000000009E-4
3,test_20231101_135102,10188041.png,221231,9489,211742,0.9571081810415357,2,4,41731,1338,40393,0.9679375044930627,11.075875555555555,1087.4010666666666,17.766906061885894,126,5.800000000000009E-4
4,test_20231101_135102,10287332.png,216980,12364,204616,0.943017789658033,1,3,22337,1696,20641,0.9240721672561221,9.497095111111111,790.9076053333333,19.149546091497648,126,5.800000000000009E-4
5,test_20231101_135102,11610969.png,368720,25037,343683,0.9320975265784335,2,3,84111,3655,80456,0.9565455172331799,21.725516444444445,3023.573904,13.3255977251099,126,5.800000000000009E-4
6,test_20231101_135102,10350842.png,212614,6002,206612,0.971770438447139,2,3,42529,879,41650,0.9793317500999318,19.329912888888888,2377.7495893333335,14.369142455293513,126,5.800000000000009E-4
7,test_20231101_135102,10863862.png,317432,10292,307140,0.9675773078958643,2,3,66058,1495,64563,0.9773683732477519,26.677214222222222,4038.738533333333,12.068346228764726,126,5.800000000000009E-4
8,test_20231101_135102,11382381.png,312486,747,311739,0.9976094929052821,1,4,46745,98,46647,0.9979035190929512,21.62502222222222,2484.034352,14.179227634129312,126,5.800000000000009E-4
9,test_20231101_135102,11079715.png,443815,118057,325758,0.733995020447709,3,4,124136,16497,107639,0.8671054327511761,17.022149333333335,2131.304528,14.84434853255526,126,5.800000000000009E-4
10,test_20231101_135102,11551286.png,271883,367,271516,0.9986501546621157,1,4,40092,52,40040,0.9987029831387808,18.002010666666667,1874.0560373333333,15.402977880083654,126,5.800000000000009E-4
1,test_20231101_135102,10404007.png,502730,20152,482578,0.9599148648379846,2,4,61265,2920,58345,0.9523382028890884,25.83563022222222,3461.3983253333336,12.738287816430331,126,5.900000000000009E-4
2,test_20231101_135102,1254659.png,342646,73189,269457,0.7864005416669099,3,4,80080,10238,69842,0.8721528471528471,20.99220088888889,3209.486672,13.066447843337867,126,5.900000000000009E-4
3,test_20231101_135102,10188041.png,221231,9489,211742,0.9571081810415357,2,4,41731,1338,40393,0.9679375044930627,11.075875555555555,1087.4010666666666,17.766906061885894,126,5.900000000000009E-4
4,test_20231101_135102,10287332.png,216980,12364,204616,0.943017789658033,2,3,22337,1696,20641,0.9240721672561221,9.497095111111111,790.9076053333333,19.149546091497648,126,5.900000000000009E-4
5,test_20231101_135102,11610969.png,368720,25037,343683,0.9320975265784335,2,4,84111,3655,80456,0.9565455172331799,21.725516444444445,3023.573904,13.3255977251099,126,5.900000000000009E-4
6,test_20231101_135102,10350842.png,212614,6002,206612,0.971770438447139,2,4,42529,879,41650,0.9793317500999318,19.329912888888888,2377.7495893333335,14.369142455293513,126,5.900000000000009E-4
7,test_20231101_135102,10863862.png,317432,10292,307140,0.9675773078958643,2,4,66058,1495,64563,0.9773683732477519,26.677214222222222,4038.738533333333,12.068346228764726,126,5.900000000000009E-4
8,test_20231101_135102,11382381.png,312486,747,311739,0.9976094929052821,1,3,46745,98,46647,0.9979035190929512,21.62502222222222,2484.034352,14.179227634129312,126,5.900000000000009E-4
9,test_20231101_135102,11079715.png,443815,118057,325758,0.733995020447709,3,4,124136,16497,107639,0.8671054327511761,17.022149333333335,2131.304528,14.84434853255526,126,5.900000000000009E-4
10,test_20231101_135102,11551286.png,271883,367,271516,0.9986501546621157,1,3,40092,52,40040,0.9987029831387808,18.002010666666667,1874.0560373333333,15.402977880083654,126,5.900000000000009E-4
1,test_20231101_135103,10404007.png,502730,20152,482578,0.9599148648379846,2,4,61265,2920,58345,0.9523382028890884,25.83563022222222,3461.3983253333336,12.738287816430331,126,6.000000000000009E-4
2,test_20231101_135103,1254659.png,342646,73189,269457,0.7864005416669099,3,4,80080,10238,69842,0.8721528471528471,20.99220088888889,3209.486672,13.066447843337867,126,6.000000000000009E-4
3,test_20231101_135103,10188041.png,221231,9489,211742,0.9571081810415357,2,4,41731,1338,40393,0.9679375044930627,11.075875555555555,1087.4010666666666,17.766906061885894,126,6.000000000000009E-4
4,test_20231101_135103,10287332.png,216980,12364,204616,0.943017789658033,2,4,22337,1696,20641,0.9240721672561221,9.497095111111111,790.9076053333333,19.149546091497648,126,6.000000000000009E-4
5,test_20231101_135103,11610969.png,368720,25037,343683,0.9320975265784335,3,4,84111,3655,80456,0.9565455172331799,21.725516444444445,3023.573904,13.3255977251099,126,6.000000000000009E-4
6,test_20231101_135103,10350842.png,212614,6002,206612,0.971770438447139,2,3,42529,879,41650,0.9793317500999318,19.329912888888888,2377.7495893333335,14.369142455293513,126,6.000000000000009E-4
7,test_20231101_135103,10863862.png,317432,10292,307140,0.9675773078958643,2,4,66058,1495,64563,0.9773683732477519,26.677214222222222,4038.738533333333,12.068346228764726,126,6.000000000000009E-4
8,test_20231101_135103,11382381.png,312486,747,311739,0.9976094929052821,3,4,46745,98,46647,0.9979035190929512,21.62502222222222,2484.034352,14.179227634129312,126,6.000000000000009E-4
9,test_20231101_135103,11079715.png,443815,118057,325758,0.733995020447709,4,4,124136,16497,107639,0.8671054327511761,17.022149333333335,2131.304528,14.84434853255526,126,6.000000000000009E-4
10,test_20231101_135103,11551286.png,271883,367,271516,0.9986501546621157,2,3,40092,52,40040,0.9987029831387808,18.002010666666667,1874.0560373333333,15.402977880083654,126,6.000000000000009E-4
1,test_20231101_135104,10404007.png,502730,20152,482578,0.9599148648379846,2,4,61265,2920,58345,0.9523382028890884,25.83563022222222,3461.3983253333336,12.738287816430331,126,6.10000000000001E-4
2,test_20231101_135104,1254659.png,342646,73189,269457,0.7864005416669099,3,4,80080,10238,69842,0.8721528471528471,20.99220088888889,3209.486672,13.066447843337867,126,6.10000000000001E-4
3,test_20231101_135104,10188041.png,221231,9489,211742,0.9571081810415357,2,4,41731,1338,40393,0.9679375044930627,11.075875555555555,1087.4010666666666,17.766906061885894,126,6.10000000000001E-4
4,test_20231101_135104,10287332.png,216980,12364,204616,0.943017789658033,2,4,22337,1696,20641,0.9240721672561221,9.497095111111111,790.9076053333333,19.149546091497648,126,6.10000000000001E-4
5,test_20231101_135104,11610969.png,368720,25037,343683,0.9320975265784335,3,3,84111,3655,80456,0.9565455172331799,21.725516444444445,3023.573904,13.3255977251099,126,6.10000000000001E-4
6,test_20231101_135104,10350842.png,212614,6002,206612,0.971770438447139,1,4,42529,879,41650,0.9793317500999318,19.329912888888888,2377.7495893333335,14.369142455293513,126,6.10000000000001E-4
7,test_20231101_135104,10863862.png,317432,10292,307140,0.9675773078958643,2,4,66058,1495,64563,0.9773683732477519,26.677214222222222,4038.738533333333,12.068346228764726,126,6.10000000000001E-4
8,test_20231101_135104,11382381.png,312486,747,311739,0.9976094929052821,1,3,46745,98,46647,0.9979035190929512,21.62502222222222,2484.034352,14.179227634129312,126,6.10000000000001E-4
9,test_20231101_135104,11079715.png,443815,118057,325758,0.733995020447709,3,4,124136,16497,107639,0.8671054327511761,17.022149333333335,2131.304528,14.84434853255526,126,6.10000000000001E-4
10,test_20231101_135104,11551286.png,271883,367,271516,0.9986501546621157,2,4,40092,52,40040,0.9987029831387808,18.002010666666667,1874.0560373333333,15.402977880083654,126,6.10000000000001E-4
1,test_20231101_135105,10404007.png,502730,20152,482578,0.9599148648379846,2,4,61265,2920,58345,0.9523382028890884,25.83563022222222,3461.3983253333336,12.738287816430331,126,6.20000000000001E-4
2,test_20231101_135105,1254659.png,342646,73189,269457,0.7864005416669099,3,4,80080,10238,69842,0.8721528471528471,20.99220088888889,3209.486672,13.066447843337867,126,6.20000000000001E-4
3,test_20231101_135105,10188041.png,221231,9489,211742,0.9571081810415357,2,3,41731,1338,40393,0.9679375044930627,11.075875555555555,1087.4010666666666,17.766906061885894,126,6.20000000000001E-4
4,test_20231101_135105,10287332.png,216980,12364,204616,0.943017789658033,1,4,22337,1696,20641,0.9240721672561221,9.497095111111111,790.9076053333333,19.149546091497648,126,6.20000000000001E-4
5,test_20231101_135105,11610969.png,368720,25037,343683,0.9320975265784335,3,4,84111,3655,80456,0.9565455172331799,21.725516444444445,3023.573904,13.3255977251099,126,6.20000000000001E-4
6,test_20231101_135105,10350842.png,212614,6002,206612,0.971770438447139,2,4,42529,879,41650,0.9793317500999318,19.329912888888888,2377.7495893333335,14.369142455293513,126,6.20000000000001E-4
7,test_20231101_135105,10863862.png,317432,10292,307140,0.9675773078958643,2,4,66058,1495,64563,0.9773683732477519,26.677214222222222,4038.738533333333,12.068346228764726,126,6.20000000000001E-4
8,test_20231101_135105,11382381.png,312486,747,311739,0.9976094929052821,2,3,46745,98,46647,0.9979035190929512,21.62502222222222,2484.034352,14.179227634129312,126,6.20000000000001E-4
9,test_20231101_135105,11079715.png,443815,118057,325758,0.733995020447709,3,4,124136,16497,107639,0.8671054327511761,17.022149333333335,2131.304528,14.84434853255526,126,6.20000000000001E-4
10,test_20231101_135105,11551286.png,271883,367,271516,0.9986501546621157,1,4,40092,52,40040,0.9987029831387808,18.002010666666667,1874.0560373333333,15.402977880083654,126,6.20000000000001E-4
1,test_20231101_135105,10404007.png,502730,20152,482578,0.9599148648379846,2,3,61265,2920,58345,0.9523382028890884,25.83563022222222,3461.3983253333336,12.738287816430331,126,6.30000000000001E-4
2,test_20231101_135105,1254659.png,342646,73189,269457,0.7864005416669099,3,4,80080,10238,69842,0.8721528471528471,20.99220088888889,3209.486672,13.066447843337867,126,6.30000000000001E-4
3,test_20231101_135105,10188041.png,221231,9489,211742,0.9571081810415357,2,4,41731,1338,40393,0.9679375044930627,11.075875555555555,1087.4010666666666,17.766906061885894,126,6.30000000000001E-4
4,test_20231101_135105,10287332.png,216980,12364,204616,0.943017789658033,2,4,22337,1696,20641,0.9240721672561221,9.497095111111111,790.9076053333333,19.149546091497648,126,6.30000000000001E-4
5,test_20231101_135105,11610969.png,368720,25037,343683,0.9320975265784335,2,4,84111,3655,80456,0.9565455172331799,21.725516444444445,3023.573904,13.3255977251099,126,6.30000000000001E-4
6,test_20231101_135105,10350842.png,212614,6002,206612,0.971770438447139,2,3,42529,879,41650,0.9793317500999318,19.329912888888888,2377.7495893333335,14.369142455293513,126,6.30000000000001E-4
7,test_20231101_135105,10863862.png,317432,10292,307140,0.9675773078958643,2,4,66058,1495,64563,0.9773683732477519,26.677214222222222,4038.738533333333,12.068346228764726,126,6.30000000000001E-4
8,test_20231101_135105,11382381.png,312486,747,311739,0.9976094929052821,2,4,46745,98,46647,0.9979035190929512,21.62502222222222,2484.034352,14.179227634129312,126,6.30000000000001E-4
9,test_20231101_135105,11079715.png,443815,118057,325758,0.733995020447709,5,5,124136,16497,107639,0.8671054327511761,17.022149333333335,2131.304528,14.84434853255526,126,6.30000000000001E-4
10,test_20231101_135105,11551286.png,271883,367,271516,0.9986501546621157,1,4,40092,52,40040,0.9987029831387808,18.002010666666667,1874.0560373333333,15.402977880083654,126,6.30000000000001E-4
1,test_20231101_135106,10404007.png,502730,20152,482578,0.9599148648379846,2,3,61265,2920,58345,0.9523382028890884,25.83563022222222,3461.3983253333336,12.738287816430331,126,6.40000000000001E-4
2,test_20231101_135106,1254659.png,342646,73189,269457,0.7864005416669099,4,4,80080,10238,69842,0.8721528471528471,20.99220088888889,3209.486672,13.066447843337867,126,6.40000000000001E-4
3,test_20231101_135106,10188041.png,221231,9489,211742,0.9571081810415357,2,4,41731,1338,40393,0.9679375044930627,11.075875555555555,1087.4010666666666,17.766906061885894,126,6.40000000000001E-4
4,test_20231101_135106,10287332.png,216980,12364,204616,0.943017789658033,2,4,22337,1696,20641,0.9240721672561221,9.497095111111111,790.9076053333333,19.149546091497648,126,6.40000000000001E-4
5,test_20231101_135106,11610969.png,368720,25037,343683,0.9320975265784335,2,4,84111,3655,80456,0.9565455172331799,21.725516444444445,3023.573904,13.3255977251099,126,6.40000000000001E-4
6,test_20231101_135106,10350842.png,212614,6002,206612,0.971770438447139,2,4,42529,879,41650,0.9793317500999318,19.329912888888888,2377.7495893333335,14.369142455293513,126,6.40000000000001E-4
7,test_20231101_135106,10863862.png,317432,10292,307140,0.9675773078958643,2,3,66058,1495,64563,0.9773683732477519,26.677214222222222,4038.738533333333,12.068346228764726,126,6.40000000000001E-4
8,test_20231101_135106,11382381.png,312486,747,311739,0.9976094929052821,1,3,46745,98,46647,0.9979035190929512,21.62502222222222,2484.034352,14.179227634129312,126,6.40000000000001E-4
9,test_20231101_135106,11079715.png,443815,118057,325758,0.733995020447709,10,5,124136,16497,107639,0.8671054327511761,17.022149333333335,2131.304528,14.84434853255526,126,6.40000000000001E-4
10,test_20231101_135106,11551286.png,271883,367,271516,0.9986501546621157,1,4,40092,52,40040,0.9987029831387808,18.002010666666667,1874.0560373333333,15.402977880083654,126,6.40000000000001E-4
1,test_20231101_135107,10404007.png,502730,20152,482578,0.9599148648379846,2,4,61265,2920,58345,0.9523382028890884,25.83563022222222,3461.3983253333336,12.738287816430331,126,6.500000000000011E-4
2,test_20231101_135107,1254659.png,342646,73189,269457,0.7864005416669099,3,4,80080,10238,69842,0.8721528471528471,20.99220088888889,3209.486672,13.066447843337867,126,6.500000000000011E-4
3,test_20231101_135107,10188041.png,221231,9489,211742,0.9571081810415357,2,4,41731,1338,40393,0.9679375044930627,11.075875555555555,1087.4010666666666,17.766906061885894,126,6.500000000000011E-4
4,test_20231101_135107,10287332.png,216980,12364,204616,0.943017789658033,1,5,22337,1696,20641,0.9240721672561221,9.497095111111111,790.9076053333333,19.149546091497648,126,6.500000000000011E-4
5,test_20231101_135107,11610969.png,368720,25037,343683,0.9320975265784335,2,4,84111,3655,80456,0.9565455172331799,21.725516444444445,3023.573904,13.3255977251099,126,6.500000000000011E-4
6,test_20231101_135107,10350842.png,212614,6002,206612,0.971770438447139,2,4,42529,879,41650,0.9793317500999318,19.329912888888888,2377.7495893333335,14.369142455293513,126,6.500000000000011E-4
7,test_20231101_135107,10863862.png,317432,10292,307140,0.9675773078958643,2,4,66058,1495,64563,0.9773683732477519,26.677214222222222,4038.738533333333,12.068346228764726,126,6.500000000000011E-4
8,test_20231101_135107,11382381.png,312486,747,311739,0.9976094929052821,2,4,46745,98,46647,0.9979035190929512,21.62502222222222,2484.034352,14.179227634129312,126,6.500000000000011E-4
9,test_20231101_135107,11079715.png,443815,118057,325758,0.733995020447709,4,5,124136,16497,107639,0.8671054327511761,17.022149333333335,2131.304528,14.84434853255526,126,6.500000000000011E-4
10,test_20231101_135107,11551286.png,271883,367,271516,0.9986501546621157,1,3,40092,52,40040,0.9987029831387808,18.002010666666667,1874.0560373333333,15.402977880083654,126,6.500000000000011E-4
1,test_20231101_135107,10404007.png,502730,20152,482578,0.9599148648379846,2,3,61265,2920,58345,0.9523382028890884,25.83563022222222,3461.3983253333336,12.738287816430331,126,6.600000000000011E-4
2,test_20231101_135107,1254659.png,342646,73189,269457,0.7864005416669099,3,4,80080,10238,69842,0.8721528471528471,20.99220088888889,3209.486672,13.066447843337867,126,6.600000000000011E-4
3,test_20231101_135107,10188041.png,221231,9489,211742,0.9571081810415357,1,3,41731,1338,40393,0.9679375044930627,11.075875555555555,1087.4010666666666,17.766906061885894,126,6.600000000000011E-4
4,test_20231101_135107,10287332.png,216980,12364,204616,0.943017789658033,2,4,22337,1696,20641,0.9240721672561221,9.497095111111111,790.9076053333333,19.149546091497648,126,6.600000000000011E-4
5,test_20231101_135107,11610969.png,368720,25037,343683,0.9320975265784335,2,4,84111,3655,80456,0.9565455172331799,21.725516444444445,3023.573904,13.3255977251099,126,6.600000000000011E-4
6,test_20231101_135107,10350842.png,212614,6002,206612,0.971770438447139,1,4,42529,879,41650,0.9793317500999318,19.329912888888888,2377.7495893333335,14.369142455293513,126,6.600000000000011E-4
7,test_20231101_135107,10863862.png,317432,10292,307140,0.9675773078958643,2,3,66058,1495,64563,0.9773683732477519,26.677214222222222,4038.738533333333,12.068346228764726,126,6.600000000000011E-4
8,test_20231101_135107,11382381.png,312486,747,311739,0.9976094929052821,1,4,46745,98,46647,0.9979035190929512,21.62502222222222,2484.034352,14.179227634129312,126,6.600000000000011E-4
9,test_20231101_135107,11079715.png,443815,118057,325758,0.733995020447709,4,4,124136,16497,107639,0.8671054327511761,17.022149333333335,2131.304528,14.84434853255526,126,6.600000000000011E-4
10,test_20231101_135107,11551286.png,271883,367,271516,0.9986501546621157,1,4,40092,52,40040,0.9987029831387808,18.002010666666667,1874.0560373333333,15.402977880083654,126,6.600000000000011E-4
1,test_20231101_135108,10404007.png,502730,20152,482578,0.9599148648379846,2,3,61265,2920,58345,0.9523382028890884,25.83563022222222,3461.3983253333336,12.738287816430331,126,6.700000000000011E-4
2,test_20231101_135108,1254659.png,342646,73189,269457,0.7864005416669099,3,4,80080,10238,69842,0.8721528471528471,20.99220088888889,3209.486672,13.066447843337867,126,6.700000000000011E-4
3,test_20231101_135108,10188041.png,221231,9489,211742,0.9571081810415357,2,4,41731,1338,40393,0.9679375044930627,11.075875555555555,1087.4010666666666,17.766906061885894,126,6.700000000000011E-4
4,test_20231101_135108,10287332.png,216980,12364,204616,0.943017789658033,2,4,22337,1696,20641,0.9240721672561221,9.497095111111111,790.9076053333333,19.149546091497648,126,6.700000000000011E-4
5,test_20231101_135108,11610969.png,368720,25037,343683,0.9320975265784335,2,4,84111,3655,80456,0.9565455172331799,21.725516444444445,3023.573904,13.3255977251099,126,6.700000000000011E-4
6,test_20231101_135108,10350842.png,212614,6002,206612,0.971770438447139,2,3,42529,879,41650,0.9793317500999318,19.329912888888888,2377.7495893333335,14.369142455293513,126,6.700000000000011E-4
7,test_20231101_135108,10863862.png,317432,10292,307140,0.9675773078958643,1,3,66058,1495,64563,0.9773683732477519,26.677214222222222,4038.738533333333,12.068346228764726,126,6.700000000000011E-4
8,test_20231101_135108,11382381.png,312486,747,311739,0.9976094929052821,1,4,46745,98,46647,0.9979035190929512,21.62502222222222,2484.034352,14.179227634129312,126,6.700000000000011E-4
9,test_20231101_135108,11079715.png,443815,118057,325758,0.733995020447709,3,4,124136,16497,107639,0.8671054327511761,17.022149333333335,2131.304528,14.84434853255526,126,6.700000000000011E-4
10,test_20231101_135108,11551286.png,271883,367,271516,0.9986501546621157,2,3,40092,52,40040,0.9987029831387808,18.002010666666667,1874.0560373333333,15.402977880083654,126,6.700000000000011E-4
1,test_20231101_135109,10404007.png,502730,20152,482578,0.9599148648379846,3,3,61265,2920,58345,0.9523382028890884,25.83563022222222,3461.3983253333336,12.738287816430331,126,6.800000000000011E-4
2,test_20231101_135109,1254659.png,342646,73189,269457,0.7864005416669099,3,11,80080,10238,69842,0.8721528471528471,20.99220088888889,3209.486672,13.066447843337867,126,6.800000000000011E-4
3,test_20231101_135109,10188041.png,221231,9489,211742,0.9571081810415357,2,3,41731,1338,40393,0.9679375044930627,11.075875555555555,1087.4010666666666,17.766906061885894,126,6.800000000000011E-4
4,test_20231101_135109,10287332.png,216980,12364,204616,0.943017789658033,2,4,22337,1696,20641,0.9240721672561221,9.497095111111111,790.9076053333333,19.149546091497648,126,6.800000000000011E-4
5,test_20231101_135109,11610969.png,368720,25037,343683,0.9320975265784335,2,3,84111,3655,80456,0.9565455172331799,21.725516444444445,3023.573904,13.3255977251099,126,6.800000000000011E-4
6,test_20231101_135109,10350842.png,212614,6002,206612,0.971770438447139,1,4,42529,879,41650,0.9793317500999318,19.329912888888888,2377.7495893333335,14.369142455293513,126,6.800000000000011E-4
7,test_20231101_135109,10863862.png,317432,10292,307140,0.9675773078958643,2,4,66058,1495,64563,0.9773683732477519,26.677214222222222,4038.738533333333,12.068346228764726,126,6.800000000000011E-4
8,test_20231101_135109,11382381.png,312486,747,311739,0.9976094929052821,1,5,46745,98,46647,0.9979035190929512,21.62502222222222,2484.034352,14.179227634129312,126,6.800000000000011E-4
9,test_20231101_135109,11079715.png,443815,118057,325758,0.733995020447709,3,5,124136,16497,107639,0.8671054327511761,17.022149333333335,2131.304528,14.84434853255526,126,6.800000000000011E-4
10,test_20231101_135109,11551286.png,271883,367,271516,0.9986501546621157,1,4,40092,52,40040,0.9987029831387808,18.002010666666667,1874.0560373333333,15.402977880083654,126,6.800000000000011E-4
1,test_20231101_135109,10404007.png,502730,20152,482578,0.9599148648379846,2,4,61265,2920,58345,0.9523382028890884,25.83563022222222,3461.3983253333336,12.738287816430331,126,6.900000000000012E-4
2,test_20231101_135109,1254659.png,342646,73189,269457,0.7864005416669099,3,4,80080,10238,69842,0.8721528471528471,20.99220088888889,3209.486672,13.066447843337867,126,6.900000000000012E-4
3,test_20231101_135109,10188041.png,221231,9489,211742,0.9571081810415357,2,3,41731,1338,40393,0.9679375044930627,11.075875555555555,1087.4010666666666,17.766906061885894,126,6.900000000000012E-4
4,test_20231101_135109,10287332.png,216980,12364,204616,0.943017789658033,1,4,22337,1696,20641,0.9240721672561221,9.497095111111111,790.9076053333333,19.149546091497648,126,6.900000000000012E-4
5,test_20231101_135109,11610969.png,368720,25037,343683,0.9320975265784335,3,4,84111,3655,80456,0.9565455172331799,21.725516444444445,3023.573904,13.3255977251099,126,6.900000000000012E-4
6,test_20231101_135109,10350842.png,212614,6002,206612,0.971770438447139,2,4,42529,879,41650,0.9793317500999318,19.329912888888888,2377.7495893333335,14.369142455293513,126,6.900000000000012E-4
7,test_20231101_135109,10863862.png,317432,10292,307140,0.9675773078958643,2,4,66058,1495,64563,0.9773683732477519,26.677214222222222,4038.738533333333,12.068346228764726,126,6.900000000000012E-4
8,test_20231101_135109,11382381.png,312486,747,311739,0.9976094929052821,1,4,46745,98,46647,0.9979035190929512,21.62502222222222,2484.034352,14.179227634129312,126,6.900000000000012E-4
9,test_20231101_135109,11079715.png,443815,118057,325758,0.733995020447709,3,4,124136,16497,107639,0.8671054327511761,17.022149333333335,2131.304528,14.84434853255526,126,6.900000000000012E-4
10,test_20231101_135109,11551286.png,271883,367,271516,0.9986501546621157,1,3,40092,52,40040,0.9987029831387808,18.002010666666667,1874.0560373333333,15.402977880083654,126,6.900000000000012E-4
1,test_20231101_135110,10404007.png,502730,20152,482578,0.9599148648379846,2,3,61265,2920,58345,0.9523382028890884,25.83563022222222,3461.3983253333336,12.738287816430331,126,7.000000000000012E-4
2,test_20231101_135110,1254659.png,342646,73189,269457,0.7864005416669099,2,3,80080,10238,69842,0.8721528471528471,20.99220088888889,3209.486672,13.066447843337867,126,7.000000000000012E-4
3,test_20231101_135110,10188041.png,221231,9489,211742,0.9571081810415357,2,4,41731,1338,40393,0.9679375044930627,11.075875555555555,1087.4010666666666,17.766906061885894,126,7.000000000000012E-4
4,test_20231101_135110,10287332.png,216980,12364,204616,0.943017789658033,2,4,22337,1696,20641,0.9240721672561221,9.497095111111111,790.9076053333333,19.149546091497648,126,7.000000000000012E-4
5,test_20231101_135110,11610969.png,368720,25037,343683,0.9320975265784335,3,4,84111,3655,80456,0.9565455172331799,21.725516444444445,3023.573904,13.3255977251099,126,7.000000000000012E-4
6,test_20231101_135110,10350842.png,212614,6002,206612,0.971770438447139,1,3,42529,879,41650,0.9793317500999318,19.329912888888888,2377.7495893333335,14.369142455293513,126,7.000000000000012E-4
7,test_20231101_135110,10863862.png,317432,10292,307140,0.9675773078958643,2,3,66058,1495,64563,0.9773683732477519,26.677214222222222,4038.738533333333,12.068346228764726,126,7.000000000000012E-4
8,test_20231101_135110,11382381.png,312486,747,311739,0.9976094929052821,1,4,46745,98,46647,0.9979035190929512,21.62502222222222,2484.034352,14.179227634129312,126,7.000000000000012E-4
9,test_20231101_135110,11079715.png,443815,118057,325758,0.733995020447709,3,4,124136,16497,107639,0.8671054327511761,17.022149333333335,2131.304528,14.84434853255526,126,7.000000000000012E-4
10,test_20231101_135110,11551286.png,271883,367,271516,0.9986501546621157,1,3,40092,52,40040,0.9987029831387808,18.002010666666667,1874.0560373333333,15.402977880083654,126,7.000000000000012E-4
1,test_20231101_135111,10404007.png,502730,20152,482578,0.9599148648379846,2,4,61265,2920,58345,0.9523382028890884,25.83563022222222,3461.3983253333336,12.738287816430331,126,7.100000000000012E-4
2,test_20231101_135111,1254659.png,342646,73189,269457,0.7864005416669099,3,4,80080,10238,69842,0.8721528471528471,20.99220088888889,3209.486672,13.066447843337867,126,7.100000000000012E-4
3,test_20231101_135111,10188041.png,221231,9489,211742,0.9571081810415357,3,4,41731,1338,40393,0.9679375044930627,11.075875555555555,1087.4010666666666,17.766906061885894,126,7.100000000000012E-4
4,test_20231101_135111,10287332.png,216980,12364,204616,0.943017789658033,2,4,22337,1696,20641,0.9240721672561221,9.497095111111111,790.9076053333333,19.149546091497648,126,7.100000000000012E-4
5,test_20231101_135111,11610969.png,368720,25037,343683,0.9320975265784335,2,4,84111,3655,80456,0.9565455172331799,21.725516444444445,3023.573904,13.3255977251099,126,7.100000000000012E-4
6,test_20231101_135111,10350842.png,212614,6002,206612,0.971770438447139,2,3,42529,879,41650,0.9793317500999318,19.329912888888888,2377.7495893333335,14.369142455293513,126,7.100000000000012E-4
7,test_20231101_135111,10863862.png,317432,10292,307140,0.9675773078958643,2,3,66058,1495,64563,0.9773683732477519,26.677214222222222,4038.738533333333,12.068346228764726,126,7.100000000000012E-4
8,test_20231101_135111,11382381.png,312486,747,311739,0.9976094929052821,2,3,46745,98,46647,0.9979035190929512,21.62502222222222,2484.034352,14.179227634129312,126,7.100000000000012E-4
9,test_20231101_135111,11079715.png,443815,118057,325758,0.733995020447709,3,5,124136,16497,107639,0.8671054327511761,17.022149333333335,2131.304528,14.84434853255526,126,7.100000000000012E-4
10,test_20231101_135111,11551286.png,271883,367,271516,0.9986501546621157,1,3,40092,52,40040,0.9987029831387808,18.002010666666667,1874.0560373333333,15.402977880083654,126,7.100000000000012E-4
1,test_20231101_135111,10404007.png,502730,20152,482578,0.9599148648379846,2,4,61265,2920,58345,0.9523382028890884,25.83563022222222,3461.3983253333336,12.738287816430331,126,7.200000000000012E-4
2,test_20231101_135111,1254659.png,342646,73189,269457,0.7864005416669099,3,4,80080,10238,69842,0.8721528471528471,20.99220088888889,3209.486672,13.066447843337867,126,7.200000000000012E-4
3,test_20231101_135111,10188041.png,221231,9489,211742,0.9571081810415357,2,4,41731,1338,40393,0.9679375044930627,11.075875555555555,1087.4010666666666,17.766906061885894,126,7.200000000000012E-4
4,test_20231101_135111,10287332.png,216980,12364,204616,0.943017789658033,2,4,22337,1696,20641,0.9240721672561221,9.497095111111111,790.9076053333333,19.149546091497648,126,7.200000000000012E-4
5,test_20231101_135111,11610969.png,368720,25037,343683,0.9320975265784335,2,4,84111,3655,80456,0.9565455172331799,21.725516444444445,3023.573904,13.3255977251099,126,7.200000000000012E-4
6,test_20231101_135111,10350842.png,212614,6002,206612,0.971770438447139,2,4,42529,879,41650,0.9793317500999318,19.329912888888888,2377.7495893333335,14.369142455293513,126,7.200000000000012E-4
7,test_20231101_135111,10863862.png,317432,10292,307140,0.9675773078958643,2,3,66058,1495,64563,0.9773683732477519,26.677214222222222,4038.738533333333,12.068346228764726,126,7.200000000000012E-4
8,test_20231101_135111,11382381.png,312486,747,311739,0.9976094929052821,1,3,46745,98,46647,0.9979035190929512,21.62502222222222,2484.034352,14.179227634129312,126,7.200000000000012E-4
9,test_20231101_135111,11079715.png,443815,118057,325758,0.733995020447709,4,4,124136,16497,107639,0.8671054327511761,17.022149333333335,2131.304528,14.84434853255526,126,7.200000000000012E-4
10,test_20231101_135111,11551286.png,271883,367,271516,0.9986501546621157,1,3,40092,52,40040,0.9987029831387808,18.002010666666667,1874.0560373333333,15.402977880083654,126,7.200000000000012E-4
1,test_20231101_135112,10404007.png,502730,20152,482578,0.9599148648379846,2,4,61265,2920,58345,0.9523382028890884,25.83563022222222,3461.3983253333336,12.738287816430331,126,7.300000000000013E-4
2,test_20231101_135112,1254659.png,342646,73189,269457,0.7864005416669099,3,4,80080,10238,69842,0.8721528471528471,20.99220088888889,3209.486672,13.066447843337867,126,7.300000000000013E-4
3,test_20231101_135112,10188041.png,221231,9489,211742,0.9571081810415357,2,4,41731,1338,40393,0.9679375044930627,11.075875555555555,1087.4010666666666,17.766906061885894,126,7.300000000000013E-4
4,test_20231101_135112,10287332.png,216980,12364,204616,0.943017789658033,1,3,22337,1696,20641,0.9240721672561221,9.497095111111111,790.9076053333333,19.149546091497648,126,7.300000000000013E-4
5,test_20231101_135112,11610969.png,368720,25037,343683,0.9320975265784335,2,3,84111,3655,80456,0.9565455172331799,21.725516444444445,3023.573904,13.3255977251099,126,7.300000000000013E-4
6,test_20231101_135112,10350842.png,212614,6002,206612,0.971770438447139,2,3,42529,879,41650,0.9793317500999318,19.329912888888888,2377.7495893333335,14.369142455293513,126,7.300000000000013E-4
7,test_20231101_135112,10863862.png,317432,10292,307140,0.9675773078958643,2,3,66058,1495,64563,0.9773683732477519,26.677214222222222,4038.738533333333,12.068346228764726,126,7.300000000000013E-4
8,test_20231101_135112,11382381.png,312486,747,311739,0.9976094929052821,1,4,46745,98,46647,0.9979035190929512,21.62502222222222,2484.034352,14.179227634129312,126,7.300000000000013E-4
9,test_20231101_135112,11079715.png,443815,118057,325758,0.733995020447709,3,4,124136,16497,107639,0.8671054327511761,17.022149333333335,2131.304528,14.84434853255526,126,7.300000000000013E-4
10,test_20231101_135112,11551286.png,271883,367,271516,0.9986501546621157,2,3,40092,52,40040,0.9987029831387808,18.002010666666667,1874.0560373333333,15.402977880083654,126,7.300000000000013E-4
1,test_20231101_135113,10404007.png,502730,20152,482578,0.9599148648379846,2,4,61265,2920,58345,0.9523382028890884,25.83563022222222,3461.3983253333336,12.738287816430331,126,7.400000000000013E-4
2,test_20231101_135113,1254659.png,342646,73189,269457,0.7864005416669099,3,3,80080,10238,69842,0.8721528471528471,20.99220088888889,3209.486672,13.066447843337867,126,7.400000000000013E-4
3,test_20231101_135113,10188041.png,221231,9489,211742,0.9571081810415357,2,4,41731,1338,40393,0.9679375044930627,11.075875555555555,1087.4010666666666,17.766906061885894,126,7.400000000000013E-4
4,test_20231101_135113,10287332.png,216980,12364,204616,0.943017789658033,1,4,22337,1696,20641,0.9240721672561221,9.497095111111111,790.9076053333333,19.149546091497648,126,7.400000000000013E-4
5,test_20231101_135113,11610969.png,368720,25037,343683,0.9320975265784335,2,3,84111,3655,80456,0.9565455172331799,21.725516444444445,3023.573904,13.3255977251099,126,7.400000000000013E-4
6,test_20231101_135113,10350842.png,212614,6002,206612,0.971770438447139,1,3,42529,879,41650,0.9793317500999318,19.329912888888888,2377.7495893333335,14.369142455293513,126,7.400000000000013E-4
7,test_20231101_135113,10863862.png,317432,10292,307140,0.9675773078958643,2,4,66058,1495,64563,0.9773683732477519,26.677214222222222,4038.738533333333,12.068346228764726,126,7.400000000000013E-4
8,test_20231101_135113,11382381.png,312486,747,311739,0.9976094929052821,2,4,46745,98,46647,0.9979035190929512,21.62502222222222,2484.034352,14.179227634129312,126,7.400000000000013E-4
9,test_20231101_135113,11079715.png,443815,118057,325758,0.733995020447709,4,4,124136,16497,107639,0.8671054327511761,17.022149333333335,2131.304528,14.84434853255526,126,7.400000000000013E-4
10,test_20231101_135113,11551286.png,271883,367,271516,0.9986501546621157,1,4,40092,52,40040,0.9987029831387808,18.002010666666667,1874.0560373333333,15.402977880083654,126,7.400000000000013E-4
1,test_20231101_135113,10404007.png,502730,20152,482578,0.9599148648379846,3,3,61265,2920,58345,0.9523382028890884,25.83563022222222,3461.3983253333336,12.738287816430331,126,7.500000000000013E-4
2,test_20231101_135113,1254659.png,342646,73189,269457,0.7864005416669099,3,4,80080,10238,69842,0.8721528471528471,20.99220088888889,3209.486672,13.066447843337867,126,7.500000000000013E-4
3,test_20231101_135113,10188041.png,221231,9489,211742,0.9571081810415357,2,4,41731,1338,40393,0.9679375044930627,11.075875555555555,1087.4010666666666,17.766906061885894,126,7.500000000000013E-4
4,test_20231101_135113,10287332.png,216980,12364,204616,0.943017789658033,2,4,22337,1696,20641,0.9240721672561221,9.497095111111111,790.9076053333333,19.149546091497648,126,7.500000000000013E-4
5,test_20231101_135113,11610969.png,368720,25037,343683,0.9320975265784335,3,3,84111,3655,80456,0.9565455172331799,21.725516444444445,3023.573904,13.3255977251099,126,7.500000000000013E-4
6,test_20231101_135113,10350842.png,212614,6002,206612,0.971770438447139,2,4,42529,879,41650,0.9793317500999318,19.329912888888888,2377.7495893333335,14.369142455293513,126,7.500000000000013E-4
7,test_20231101_135113,10863862.png,317432,10292,307140,0.9675773078958643,2,4,66058,1495,64563,0.9773683732477519,26.677214222222222,4038.738533333333,12.068346228764726,126,7.500000000000013E-4
8,test_20231101_135113,11382381.png,312486,747,311739,0.9976094929052821,2,4,46745,98,46647,0.9979035190929512,21.62502222222222,2484.034352,14.179227634129312,126,7.500000000000013E-4
9,test_20231101_135113,11079715.png,443815,118057,325758,0.733995020447709,3,4,124136,16497,107639,0.8671054327511761,17.022149333333335,2131.304528,14.84434853255526,126,7.500000000000013E-4
10,test_20231101_135113,11551286.png,271883,367,271516,0.9986501546621157,1,3,40092,52,40040,0.9987029831387808,18.002010666666667,1874.0560373333333,15.402977880083654,126,7.500000000000013E-4
1,test_20231101_135114,10404007.png,502730,20012,482718,0.9601933443399041,2,4,61265,2900,58365,0.9526646535542316,25.84072888888889,3462.5373013333333,12.736859001886254,126,7.600000000000013E-4
2,test_20231101_135114,1254659.png,342646,73189,269457,0.7864005416669099,3,4,80080,10238,69842,0.8721528471528471,20.99220088888889,3209.486672,13.066447843337867,126,7.600000000000013E-4
3,test_20231101_135114,10188041.png,221231,9369,211862,0.9576506005035461,2,4,41731,1320,40411,0.9683688385133354,11.170734222222222,1111.271936,17.672600140304922,126,7.600000000000013E-4
4,test_20231101_135114,10287332.png,216980,12364,204616,0.943017789658033,2,3,22337,1696,20641,0.9240721672561221,9.497095111111111,790.9076053333333,19.149546091497648,126,7.600000000000013E-4
5,test_20231101_135114,11610969.png,368720,24997,343723,0.932206009980473,2,4,84111,3653,80458,0.9565692953359252,22.103546666666666,3086.686544,13.235878321707402,126,7.600000000000013E-4
6,test_20231101_135114,10350842.png,212614,6002,206612,0.971770438447139,1,3,42529,879,41650,0.9793317500999318,19.329912888888888,2377.7495893333335,14.369142455293513,126,7.600000000000013E-4
7,test_20231101_135114,10863862.png,317432,10292,307140,0.9675773078958643,2,4,66058,1495,64563,0.9773683732477519,26.677214222222222,4038.738533333333,12.068346228764726,126,7.600000000000013E-4
8,test_20231101_135114,11382381.png,312486,747,311739,0.9976094929052821,2,3,46745,98,46647,0.9979035190929512,21.62502222222222,2484.034352,14.179227634129312,126,7.600000000000013E-4
9,test_20231101_135114,11079715.png,443815,118057,325758,0.733995020447709,3,4,124136,16497,107639,0.8671054327511761,17.022149333333335,2131.304528,14.84434853255526,126,7.600000000000013E-4
10,test_20231101_135114,11551286.png,271883,367,271516,0.9986501546621157,1,4,40092,52,40040,0.9987029831387808,18.002010666666667,1874.0560373333333,15.402977880083654,126,7.600000000000013E-4
1,test_20231101_135115,10404007.png,502730,20012,482718,0.9601933443399041,2,4,61265,2900,58365,0.9526646535542316,25.84072888888889,3462.5373013333333,12.736859001886254,126,7.700000000000014E-4
2,test_20231101_135115,1254659.png,342646,73189,269457,0.7864005416669099,2,3,80080,10238,69842,0.8721528471528471,20.99220088888889,3209.486672,13.066447843337867,126,7.700000000000014E-4
3,test_20231101_135115,10188041.png,221231,9369,211862,0.9576506005035461,2,4,41731,1320,40411,0.9683688385133354,11.170734222222222,1111.271936,17.672600140304922,126,7.700000000000014E-4
4,test_20231101_135115,10287332.png,216980,12364,204616,0.943017789658033,2,4,22337,1696,20641,0.9240721672561221,9.497095111111111,790.9076053333333,19.149546091497648,126,7.700000000000014E-4
5,test_20231101_135115,11610969.png,368720,24997,343723,0.932206009980473,2,3,84111,3653,80458,0.9565692953359252,22.103546666666666,3086.686544,13.235878321707402,126,7.700000000000014E-4
6,test_20231101_135115,10350842.png,212614,6002,206612,0.971770438447139,2,3,42529,879,41650,0.9793317500999318,19.329912888888888,2377.7495893333335,14.369142455293513,126,7.700000000000014E-4
7,test_20231101_135115,10863862.png,317432,10292,307140,0.9675773078958643,2,4,66058,1495,64563,0.9773683732477519,26.677214222222222,4038.738533333333,12.068346228764726,126,7.700000000000014E-4
8,test_20231101_135115,11382381.png,312486,747,311739,0.9976094929052821,1,4,46745,98,46647,0.9979035190929512,21.62502222222222,2484.034352,14.179227634129312,126,7.700000000000014E-4
9,test_20231101_135115,11079715.png,443815,118057,325758,0.733995020447709,4,4,124136,16497,107639,0.8671054327511761,17.022149333333335,2131.304528,14.84434853255526,126,7.700000000000014E-4
10,test_20231101_135115,11551286.png,271883,367,271516,0.9986501546621157,2,3,40092,52,40040,0.9987029831387808,18.002010666666667,1874.0560373333333,15.402977880083654,126,7.700000000000014E-4
1,test_20231101_135116,10404007.png,502730,20012,482718,0.9601933443399041,2,4,61265,2900,58365,0.9526646535542316,25.84072888888889,3462.5373013333333,12.736859001886254,126,7.800000000000014E-4
2,test_20231101_135116,1254659.png,342646,73189,269457,0.7864005416669099,3,4,80080,10238,69842,0.8721528471528471,20.99220088888889,3209.486672,13.066447843337867,126,7.800000000000014E-4
3,test_20231101_135116,10188041.png,221231,9369,211862,0.9576506005035461,2,4,41731,1320,40411,0.9683688385133354,11.170734222222222,1111.271936,17.672600140304922,126,7.800000000000014E-4
4,test_20231101_135116,10287332.png,216980,12364,204616,0.943017789658033,2,3,22337,1696,20641,0.9240721672561221,9.497095111111111,790.9076053333333,19.149546091497648,126,7.800000000000014E-4
5,test_20231101_135116,11610969.png,368720,24997,343723,0.932206009980473,2,3,84111,3653,80458,0.9565692953359252,22.103546666666666,3086.686544,13.235878321707402,126,7.800000000000014E-4
6,test_20231101_135116,10350842.png,212614,6002,206612,0.971770438447139,2,3,42529,879,41650,0.9793317500999318,19.329912888888888,2377.7495893333335,14.369142455293513,126,7.800000000000014E-4
7,test_20231101_135116,10863862.png,317432,10292,307140,0.9675773078958643,2,3,66058,1495,64563,0.9773683732477519,26.677214222222222,4038.738533333333,12.068346228764726,126,7.800000000000014E-4
8,test_20231101_135116,11382381.png,312486,747,311739,0.9976094929052821,2,4,46745,98,46647,0.9979035190929512,21.62502222222222,2484.034352,14.179227634129312,126,7.800000000000014E-4
9,test_20231101_135116,11079715.png,443815,118057,325758,0.733995020447709,3,4,124136,16497,107639,0.8671054327511761,17.022149333333335,2131.304528,14.84434853255526,126,7.800000000000014E-4
10,test_20231101_135116,11551286.png,271883,367,271516,0.9986501546621157,1,3,40092,52,40040,0.9987029831387808,18.002010666666667,1874.0560373333333,15.402977880083654,126,7.800000000000014E-4
1,test_20231101_135116,10404007.png,502730,20012,482718,0.9601933443399041,2,3,61265,2900,58365,0.9526646535542316,25.84072888888889,3462.5373013333333,12.736859001886254,126,7.900000000000014E-4
2,test_20231101_135116,1254659.png,342646,73189,269457,0.7864005416669099,3,4,80080,10238,69842,0.8721528471528471,20.99220088888889,3209.486672,13.066447843337867,126,7.900000000000014E-4
3,test_20231101_135116,10188041.png,221231,9369,211862,0.9576506005035461,2,4,41731,1320,40411,0.9683688385133354,11.170734222222222,1111.271936,17.672600140304922,126,7.900000000000014E-4
4,test_20231101_135116,10287332.png,216980,12364,204616,0.943017789658033,2,4,22337,1696,20641,0.9240721672561221,9.497095111111111,790.9076053333333,19.149546091497648,126,7.900000000000014E-4
5,test_20231101_135116,11610969.png,368720,24997,343723,0.932206009980473,3,4,84111,3653,80458,0.9565692953359252,22.103546666666666,3086.686544,13.235878321707402,126,7.900000000000014E-4
6,test_20231101_135116,10350842.png,212614,6002,206612,0.971770438447139,2,4,42529,879,41650,0.9793317500999318,19.329912888888888,2377.7495893333335,14.369142455293513,126,7.900000000000014E-4
7,test_20231101_135116,10863862.png,317432,10292,307140,0.9675773078958643,2,4,66058,1495,64563,0.9773683732477519,26.677214222222222,4038.738533333333,12.068346228764726,126,7.900000000000014E-4
8,test_20231101_135116,11382381.png,312486,747,311739,0.9976094929052821,1,4,46745,98,46647,0.9979035190929512,21.62502222222222,2484.034352,14.179227634129312,126,7.900000000000014E-4
9,test_20231101_135116,11079715.png,443815,118057,325758,0.733995020447709,3,4,124136,16497,107639,0.8671054327511761,17.022149333333335,2131.304528,14.84434853255526,126,7.900000000000014E-4
10,test_20231101_135116,11551286.png,271883,367,271516,0.9986501546621157,1,8,40092,52,40040,0.9987029831387808,18.002010666666667,1874.0560373333333,15.402977880083654,126,7.900000000000014E-4
1,test_20231101_135117,10404007.png,502730,20012,482718,0.9601933443399041,2,3,61265,2900,58365,0.9526646535542316,25.84072888888889,3462.5373013333333,12.736859001886254,126,8.000000000000014E-4
2,test_20231101_135117,1254659.png,342646,73189,269457,0.7864005416669099,3,4,80080,10238,69842,0.8721528471528471,20.99220088888889,3209.486672,13.066447843337867,126,8.000000000000014E-4
3,test_20231101_135117,10188041.png,221231,9369,211862,0.9576506005035461,2,3,41731,1320,40411,0.9683688385133354,11.170734222222222,1111.271936,17.672600140304922,126,8.000000000000014E-4
4,test_20231101_135117,10287332.png,216980,12364,204616,0.943017789658033,2,3,22337,1696,20641,0.9240721672561221,9.497095111111111,790.9076053333333,19.149546091497648,126,8.000000000000014E-4
5,test_20231101_135117,11610969.png,368720,24997,343723,0.932206009980473,3,3,84111,3653,80458,0.9565692953359252,22.103546666666666,3086.686544,13.235878321707402,126,8.000000000000014E-4
6,test_20231101_135117,10350842.png,212614,6002,206612,0.971770438447139,2,4,42529,879,41650,0.9793317500999318,19.329912888888888,2377.7495893333335,14.369142455293513,126,8.000000000000014E-4
7,test_20231101_135117,10863862.png,317432,10292,307140,0.9675773078958643,2,3,66058,1495,64563,0.9773683732477519,26.677214222222222,4038.738533333333,12.068346228764726,126,8.000000000000014E-4
8,test_20231101_135117,11382381.png,312486,747,311739,0.9976094929052821,1,6,46745,98,46647,0.9979035190929512,21.62502222222222,2484.034352,14.179227634129312,126,8.000000000000014E-4
9,test_20231101_135117,11079715.png,443815,118057,325758,0.733995020447709,3,4,124136,16497,107639,0.8671054327511761,17.022149333333335,2131.304528,14.84434853255526,126,8.000000000000014E-4
10,test_20231101_135117,11551286.png,271883,367,271516,0.9986501546621157,2,9,40092,52,40040,0.9987029831387808,18.002010666666667,1874.0560373333333,15.402977880083654,126,8.000000000000014E-4
1,test_20231101_135118,10404007.png,502730,20012,482718,0.9601933443399041,2,3,61265,2900,58365,0.9526646535542316,25.84072888888889,3462.5373013333333,12.736859001886254,126,8.100000000000015E-4
2,test_20231101_135118,1254659.png,342646,73189,269457,0.7864005416669099,4,4,80080,10238,69842,0.8721528471528471,20.99220088888889,3209.486672,13.066447843337867,126,8.100000000000015E-4
3,test_20231101_135118,10188041.png,221231,9369,211862,0.9576506005035461,2,4,41731,1320,40411,0.9683688385133354,11.170734222222222,1111.271936,17.672600140304922,126,8.100000000000015E-4
4,test_20231101_135118,10287332.png,216980,12364,204616,0.943017789658033,2,7,22337,1696,20641,0.9240721672561221,9.497095111111111,790.9076053333333,19.149546091497648,126,8.100000000000015E-4
5,test_20231101_135118,11610969.png,368720,24997,343723,0.932206009980473,3,4,84111,3653,80458,0.9565692953359252,22.103546666666666,3086.686544,13.235878321707402,126,8.100000000000015E-4
6,test_20231101_135118,10350842.png,212614,6002,206612,0.971770438447139,2,4,42529,879,41650,0.9793317500999318,19.329912888888888,2377.7495893333335,14.369142455293513,126,8.100000000000015E-4
7,test_20231101_135118,10863862.png,317432,10292,307140,0.9675773078958643,2,4,66058,1495,64563,0.9773683732477519,26.677214222222222,4038.738533333333,12.068346228764726,126,8.100000000000015E-4
8,test_20231101_135118,11382381.png,312486,747,311739,0.9976094929052821,1,3,46745,98,46647,0.9979035190929512,21.62502222222222,2484.034352,14.179227634129312,126,8.100000000000015E-4
9,test_20231101_135118,11079715.png,443815,118057,325758,0.733995020447709,4,4,124136,16497,107639,0.8671054327511761,17.022149333333335,2131.304528,14.84434853255526,126,8.100000000000015E-4
10,test_20231101_135118,11551286.png,271883,367,271516,0.9986501546621157,1,4,40092,52,40040,0.9987029831387808,18.002010666666667,1874.0560373333333,15.402977880083654,126,8.100000000000015E-4
1,test_20231101_135118,10404007.png,502730,20012,482718,0.9601933443399041,2,4,61265,2900,58365,0.9526646535542316,25.84072888888889,3462.5373013333333,12.736859001886254,126,8.200000000000015E-4
2,test_20231101_135118,1254659.png,342646,73189,269457,0.7864005416669099,3,4,80080,10238,69842,0.8721528471528471,20.99220088888889,3209.486672,13.066447843337867,126,8.200000000000015E-4
3,test_20231101_135118,10188041.png,221231,9369,211862,0.9576506005035461,2,3,41731,1320,40411,0.9683688385133354,11.170734222222222,1111.271936,17.672600140304922,126,8.200000000000015E-4
4,test_20231101_135118,10287332.png,216980,12364,204616,0.943017789658033,1,4,22337,1696,20641,0.9240721672561221,9.497095111111111,790.9076053333333,19.149546091497648,126,8.200000000000015E-4
5,test_20231101_135118,11610969.png,368720,24997,343723,0.932206009980473,2,4,84111,3653,80458,0.9565692953359252,22.103546666666666,3086.686544,13.235878321707402,126,8.200000000000015E-4
6,test_20231101_135118,10350842.png,212614,6002,206612,0.971770438447139,1,3,42529,879,41650,0.9793317500999318,19.329912888888888,2377.7495893333335,14.369142455293513,126,8.200000000000015E-4
7,test_20231101_135118,10863862.png,317432,10292,307140,0.9675773078958643,2,4,66058,1495,64563,0.9773683732477519,26.677214222222222,4038.738533333333,12.068346228764726,126,8.200000000000015E-4
8,test_20231101_135118,11382381.png,312486,747,311739,0.9976094929052821,2,4,46745,98,46647,0.9979035190929512,21.62502222222222,2484.034352,14.179227634129312,126,8.200000000000015E-4
9,test_20231101_135118,11079715.png,443815,118057,325758,0.733995020447709,3,4,124136,16497,107639,0.8671054327511761,17.022149333333335,2131.304528,14.84434853255526,126,8.200000000000015E-4
10,test_20231101_135118,11551286.png,271883,367,271516,0.9986501546621157,2,3,40092,52,40040,0.9987029831387808,18.002010666666667,1874.0560373333333,15.402977880083654,126,8.200000000000015E-4
1,test_20231101_135119,10404007.png,502730,20012,482718,0.9601933443399041,3,4,61265,2900,58365,0.9526646535542316,25.84072888888889,3462.5373013333333,12.736859001886254,126,8.300000000000015E-4
2,test_20231101_135119,1254659.png,342646,73189,269457,0.7864005416669099,2,4,80080,10238,69842,0.8721528471528471,20.99220088888889,3209.486672,13.066447843337867,126,8.300000000000015E-4
3,test_20231101_135119,10188041.png,221231,9369,211862,0.9576506005035461,1,4,41731,1320,40411,0.9683688385133354,11.170734222222222,1111.271936,17.672600140304922,126,8.300000000000015E-4
4,test_20231101_135119,10287332.png,216980,12364,204616,0.943017789658033,1,4,22337,1696,20641,0.9240721672561221,9.497095111111111,790.9076053333333,19.149546091497648,126,8.300000000000015E-4
5,test_20231101_135119,11610969.png,368720,24997,343723,0.932206009980473,3,4,84111,3653,80458,0.9565692953359252,22.103546666666666,3086.686544,13.235878321707402,126,8.300000000000015E-4
6,test_20231101_135119,10350842.png,212614,6002,206612,0.971770438447139,1,4,42529,879,41650,0.9793317500999318,19.329912888888888,2377.7495893333335,14.369142455293513,126,8.300000000000015E-4
7,test_20231101_135119,10863862.png,317432,10292,307140,0.9675773078958643,2,4,66058,1495,64563,0.9773683732477519,26.677214222222222,4038.738533333333,12.068346228764726,126,8.300000000000015E-4
8,test_20231101_135119,11382381.png,312486,747,311739,0.9976094929052821,1,6,46745,98,46647,0.9979035190929512,21.62502222222222,2484.034352,14.179227634129312,126,8.300000000000015E-4
9,test_20231101_135119,11079715.png,443815,118057,325758,0.733995020447709,4,4,124136,16497,107639,0.8671054327511761,17.022149333333335,2131.304528,14.84434853255526,126,8.300000000000015E-4
10,test_20231101_135119,11551286.png,271883,367,271516,0.9986501546621157,2,3,40092,52,40040,0.9987029831387808,18.002010666666667,1874.0560373333333,15.402977880083654,126,8.300000000000015E-4
1,test_20231101_135120,10404007.png,502730,20012,482718,0.9601933443399041,2,9,61265,2900,58365,0.9526646535542316,25.84072888888889,3462.5373013333333,12.736859001886254,126,8.400000000000016E-4
2,test_20231101_135120,1254659.png,342646,73189,269457,0.7864005416669099,3,4,80080,10238,69842,0.8721528471528471,20.99220088888889,3209.486672,13.066447843337867,126,8.400000000000016E-4
3,test_20231101_135120,10188041.png,221231,9269,211962,0.958102616721888,1,3,41731,1309,40422,0.9686324315257243,11.218222222222222,1116.4789653333332,17.65229815570365,126,8.400000000000016E-4
4,test_20231101_135120,10287332.png,216980,12364,204616,0.943017789658033,2,4,22337,1696,20641,0.9240721672561221,9.497095111111111,790.9076053333333,19.149546091497648,126,8.400000000000016E-4
5,test_20231101_135120,11610969.png,368720,24997,343723,0.932206009980473,2,4,84111,3653,80458,0.9565692953359252,22.103546666666666,3086.686544,13.235878321707402,126,8.400000000000016E-4
6,test_20231101_135120,10350842.png,212614,6002,206612,0.971770438447139,2,3,42529,879,41650,0.9793317500999318,19.329912888888888,2377.7495893333335,14.369142455293513,126,8.400000000000016E-4
7,test_20231101_135120,10863862.png,317432,10292,307140,0.9675773078958643,2,8,66058,1495,64563,0.9773683732477519,26.677214222222222,4038.738533333333,12.068346228764726,126,8.400000000000016E-4
8,test_20231101_135120,11382381.png,312486,747,311739,0.9976094929052821,1,4,46745,98,46647,0.9979035190929512,21.62502222222222,2484.034352,14.179227634129312,126,8.400000000000016E-4
9,test_20231101_135120,11079715.png,443815,118057,325758,0.733995020447709,6,4,124136,16497,107639,0.8671054327511761,17.022149333333335,2131.304528,14.84434853255526,126,8.400000000000016E-4
10,test_20231101_135120,11551286.png,271883,367,271516,0.9986501546621157,2,3,40092,52,40040,0.9987029831387808,18.002010666666667,1874.0560373333333,15.402977880083654,126,8.400000000000016E-4
1,test_20231101_135120,10404007.png,502730,20012,482718,0.9601933443399041,2,4,61265,2900,58365,0.9526646535542316,25.84072888888889,3462.5373013333333,12.736859001886254,126,8.500000000000016E-4
2,test_20231101_135120,1254659.png,342646,73189,269457,0.7864005416669099,3,4,80080,10238,69842,0.8721528471528471,20.99220088888889,3209.486672,13.066447843337867,126,8.500000000000016E-4
3,test_20231101_135120,10188041.png,221231,9269,211962,0.958102616721888,2,4,41731,1309,40422,0.9686324315257243,11.218222222222222,1116.4789653333332,17.65229815570365,126,8.500000000000016E-4
4,test_20231101_135120,10287332.png,216980,12364,204616,0.943017789658033,2,4,22337,1696,20641,0.9240721672561221,9.497095111111111,790.9076053333333,19.149546091497648,126,8.500000000000016E-4
5,test_20231101_135120,11610969.png,368720,24997,343723,0.932206009980473,2,4,84111,3653,80458,0.9565692953359252,22.103546666666666,3086.686544,13.235878321707402,126,8.500000000000016E-4
6,test_20231101_135120,10350842.png,212614,6002,206612,0.971770438447139,1,3,42529,879,41650,0.9793317500999318,19.329912888888888,2377.7495893333335,14.369142455293513,126,8.500000000000016E-4
7,test_20231101_135120,10863862.png,317432,10292,307140,0.9675773078958643,2,3,66058,1495,64563,0.9773683732477519,26.677214222222222,4038.738533333333,12.068346228764726,126,8.500000000000016E-4
8,test_20231101_135120,11382381.png,312486,747,311739,0.9976094929052821,1,3,46745,98,46647,0.9979035190929512,21.62502222222222,2484.034352,14.179227634129312,126,8.500000000000016E-4
9,test_20231101_135120,11079715.png,443815,118057,325758,0.733995020447709,4,4,124136,16497,107639,0.8671054327511761,17.022149333333335,2131.304528,14.84434853255526,126,8.500000000000016E-4
10,test_20231101_135120,11551286.png,271883,367,271516,0.9986501546621157,1,3,40092,52,40040,0.9987029831387808,18.002010666666667,1874.0560373333333,15.402977880083654,126,8.500000000000016E-4
1,test_20231101_135121,10404007.png,502730,20012,482718,0.9601933443399041,2,4,61265,2900,58365,0.9526646535542316,25.84072888888889,3462.5373013333333,12.736859001886254,126,8.600000000000016E-4
2,test_20231101_135121,1254659.png,342646,73189,269457,0.7864005416669099,2,4,80080,10238,69842,0.8721528471528471,20.99220088888889,3209.486672,13.066447843337867,126,8.600000000000016E-4
3,test_20231101_135121,10188041.png,221231,9269,211962,0.958102616721888,2,4,41731,1309,40422,0.9686324315257243,11.218222222222222,1116.4789653333332,17.65229815570365,126,8.600000000000016E-4
4,test_20231101_135121,10287332.png,216980,12364,204616,0.943017789658033,1,4,22337,1696,20641,0.9240721672561221,9.497095111111111,790.9076053333333,19.149546091497648,126,8.600000000000016E-4
5,test_20231101_135121,11610969.png,368720,24997,343723,0.932206009980473,2,3,84111,3653,80458,0.9565692953359252,22.103546666666666,3086.686544,13.235878321707402,126,8.600000000000016E-4
6,test_20231101_135121,10350842.png,212614,6002,206612,0.971770438447139,1,3,42529,879,41650,0.9793317500999318,19.329912888888888,2377.7495893333335,14.369142455293513,126,8.600000000000016E-4
7,test_20231101_135121,10863862.png,317432,10292,307140,0.9675773078958643,2,3,66058,1495,64563,0.9773683732477519,26.677214222222222,4038.738533333333,12.068346228764726,126,8.600000000000016E-4
8,test_20231101_135121,11382381.png,312486,747,311739,0.9976094929052821,1,3,46745,98,46647,0.9979035190929512,21.62502222222222,2484.034352,14.179227634129312,126,8.600000000000016E-4
9,test_20231101_135121,11079715.png,443815,118057,325758,0.733995020447709,3,4,124136,16497,107639,0.8671054327511761,17.022149333333335,2131.304528,14.84434853255526,126,8.600000000000016E-4
10,test_20231101_135121,11551286.png,271883,367,271516,0.9986501546621157,1,4,40092,52,40040,0.9987029831387808,18.002010666666667,1874.0560373333333,15.402977880083654,126,8.600000000000016E-4
1,test_20231101_135122,10404007.png,502730,20012,482718,0.9601933443399041,3,4,61265,2900,58365,0.9526646535542316,25.84072888888889,3462.5373013333333,12.736859001886254,126,8.700000000000016E-4
2,test_20231101_135122,1254659.png,342646,73189,269457,0.7864005416669099,3,4,80080,10238,69842,0.8721528471528471,20.99220088888889,3209.486672,13.066447843337867,126,8.700000000000016E-4
3,test_20231101_135122,10188041.png,221231,9269,211962,0.958102616721888,2,3,41731,1309,40422,0.9686324315257243,11.218222222222222,1116.4789653333332,17.65229815570365,126,8.700000000000016E-4
4,test_20231101_135122,10287332.png,216980,12364,204616,0.943017789658033,2,3,22337,1696,20641,0.9240721672561221,9.497095111111111,790.9076053333333,19.149546091497648,126,8.700000000000016E-4
5,test_20231101_135122,11610969.png,368720,24997,343723,0.932206009980473,3,4,84111,3653,80458,0.9565692953359252,22.103546666666666,3086.686544,13.235878321707402,126,8.700000000000016E-4
6,test_20231101_135122,10350842.png,212614,6002,206612,0.971770438447139,1,4,42529,879,41650,0.9793317500999318,19.329912888888888,2377.7495893333335,14.369142455293513,126,8.700000000000016E-4
7,test_20231101_135122,10863862.png,317432,10292,307140,0.9675773078958643,2,4,66058,1495,64563,0.9773683732477519,26.677214222222222,4038.738533333333,12.068346228764726,126,8.700000000000016E-4
8,test_20231101_135122,11382381.png,312486,747,311739,0.9976094929052821,1,4,46745,98,46647,0.9979035190929512,21.62502222222222,2484.034352,14.179227634129312,126,8.700000000000016E-4
9,test_20231101_135122,11079715.png,443815,118057,325758,0.733995020447709,3,4,124136,16497,107639,0.8671054327511761,17.022149333333335,2131.304528,14.84434853255526,126,8.700000000000016E-4
10,test_20231101_135122,11551286.png,271883,367,271516,0.9986501546621157,1,4,40092,52,40040,0.9987029831387808,18.002010666666667,1874.0560373333333,15.402977880083654,126,8.700000000000016E-4
1,test_20231101_135122,10404007.png,502730,20012,482718,0.9601933443399041,2,3,61265,2900,58365,0.9526646535542316,25.84072888888889,3462.5373013333333,12.736859001886254,126,8.800000000000017E-4
2,test_20231101_135122,1254659.png,342646,73189,269457,0.7864005416669099,2,4,80080,10238,69842,0.8721528471528471,20.99220088888889,3209.486672,13.066447843337867,126,8.800000000000017E-4
3,test_20231101_135122,10188041.png,221231,9269,211962,0.958102616721888,1,3,41731,1309,40422,0.9686324315257243,11.218222222222222,1116.4789653333332,17.65229815570365,126,8.800000000000017E-4
4,test_20231101_135122,10287332.png,216980,12364,204616,0.943017789658033,2,3,22337,1696,20641,0.9240721672561221,9.497095111111111,790.9076053333333,19.149546091497648,126,8.800000000000017E-4
5,test_20231101_135122,11610969.png,368720,24997,343723,0.932206009980473,3,4,84111,3653,80458,0.9565692953359252,22.103546666666666,3086.686544,13.235878321707402,126,8.800000000000017E-4
6,test_20231101_135122,10350842.png,212614,6002,206612,0.971770438447139,1,3,42529,879,41650,0.9793317500999318,19.329912888888888,2377.7495893333335,14.369142455293513,126,8.800000000000017E-4
7,test_20231101_135122,10863862.png,317432,10292,307140,0.9675773078958643,2,3,66058,1495,64563,0.9773683732477519,26.677214222222222,4038.738533333333,12.068346228764726,126,8.800000000000017E-4
8,test_20231101_135122,11382381.png,312486,747,311739,0.9976094929052821,2,4,46745,98,46647,0.9979035190929512,21.62502222222222,2484.034352,14.179227634129312,126,8.800000000000017E-4
9,test_20231101_135122,11079715.png,443815,118057,325758,0.733995020447709,4,4,124136,16497,107639,0.8671054327511761,17.022149333333335,2131.304528,14.84434853255526,126,8.800000000000017E-4
10,test_20231101_135122,11551286.png,271883,367,271516,0.9986501546621157,2,3,40092,52,40040,0.9987029831387808,18.002010666666667,1874.0560373333333,15.402977880083654,126,8.800000000000017E-4
1,test_20231101_135123,10404007.png,502730,20012,482718,0.9601933443399041,3,4,61265,2900,58365,0.9526646535542316,25.84072888888889,3462.5373013333333,12.736859001886254,126,8.900000000000017E-4
2,test_20231101_135123,1254659.png,342646,73189,269457,0.7864005416669099,3,4,80080,10238,69842,0.8721528471528471,20.99220088888889,3209.486672,13.066447843337867,126,8.900000000000017E-4
3,test_20231101_135123,10188041.png,221231,9269,211962,0.958102616721888,2,4,41731,1309,40422,0.9686324315257243,11.218222222222222,1116.4789653333332,17.65229815570365,126,8.900000000000017E-4
4,test_20231101_135123,10287332.png,216980,12364,204616,0.943017789658033,2,3,22337,1696,20641,0.9240721672561221,9.497095111111111,790.9076053333333,19.149546091497648,126,8.900000000000017E-4
5,test_20231101_135123,11610969.png,368720,24997,343723,0.932206009980473,2,4,84111,3653,80458,0.9565692953359252,22.103546666666666,3086.686544,13.235878321707402,126,8.900000000000017E-4
6,test_20231101_135123,10350842.png,212614,6002,206612,0.971770438447139,2,4,42529,879,41650,0.9793317500999318,19.329912888888888,2377.7495893333335,14.369142455293513,126,8.900000000000017E-4
7,test_20231101_135123,10863862.png,317432,10292,307140,0.9675773078958643,2,4,66058,1495,64563,0.9773683732477519,26.677214222222222,4038.738533333333,12.068346228764726,126,8.900000000000017E-4
8,test_20231101_135123,11382381.png,312486,747,311739,0.9976094929052821,1,3,46745,98,46647,0.9979035190929512,21.62502222222222,2484.034352,14.179227634129312,126,8.900000000000017E-4
9,test_20231101_135123,11079715.png,443815,118057,325758,0.733995020447709,3,5,124136,16497,107639,0.8671054327511761,17.022149333333335,2131.304528,14.84434853255526,126,8.900000000000017E-4
10,test_20231101_135123,11551286.png,271883,367,271516,0.9986501546621157,1,4,40092,52,40040,0.9987029831387808,18.002010666666667,1874.0560373333333,15.402977880083654,126,8.900000000000017E-4
1,test_20231101_135124,10404007.png,502730,20012,482718,0.9601933443399041,2,3,61265,2900,58365,0.9526646535542316,25.84072888888889,3462.5373013333333,12.736859001886254,126,9.000000000000017E-4
2,test_20231101_135124,1254659.png,342646,73189,269457,0.7864005416669099,3,3,80080,10238,69842,0.8721528471528471,20.99220088888889,3209.486672,13.066447843337867,126,9.000000000000017E-4
3,test_20231101_135124,10188041.png,221231,9269,211962,0.958102616721888,2,3,41731,1309,40422,0.9686324315257243,11.218222222222222,1116.4789653333332,17.65229815570365,126,9.000000000000017E-4
4,test_20231101_135124,10287332.png,216980,12364,204616,0.943017789658033,2,4,22337,1696,20641,0.9240721672561221,9.497095111111111,790.9076053333333,19.149546091497648,126,9.000000000000017E-4
5,test_20231101_135124,11610969.png,368720,24997,343723,0.932206009980473,2,4,84111,3653,80458,0.9565692953359252,22.103546666666666,3086.686544,13.235878321707402,126,9.000000000000017E-4
6,test_20231101_135124,10350842.png,212614,4294,208320,0.9798037758567169,2,3,42529,628,41901,0.9852336053046157,23.505242666666668,3390.545104,12.828108347509533,126,9.000000000000017E-4
7,test_20231101_135124,10863862.png,317432,10292,307140,0.9675773078958643,2,3,66058,1495,64563,0.9773683732477519,26.677214222222222,4038.738533333333,12.068346228764726,126,9.000000000000017E-4
8,test_20231101_135124,11382381.png,312486,747,311739,0.9976094929052821,1,3,46745,98,46647,0.9979035190929512,21.62502222222222,2484.034352,14.179227634129312,126,9.000000000000017E-4
9,test_20231101_135124,11079715.png,443815,118057,325758,0.733995020447709,4,4,124136,16497,107639,0.8671054327511761,17.022149333333335,2131.304528,14.84434853255526,126,9.000000000000017E-4
10,test_20231101_135124,11551286.png,271883,367,271516,0.9986501546621157,1,3,40092,52,40040,0.9987029831387808,18.002010666666667,1874.0560373333333,15.402977880083654,126,9.000000000000017E-4
1,test_20231101_135124,10404007.png,502730,20012,482718,0.9601933443399041,2,4,61265,2900,58365,0.9526646535542316,25.84072888888889,3462.5373013333333,12.736859001886254,126,9.100000000000017E-4
2,test_20231101_135124,1254659.png,342646,73189,269457,0.7864005416669099,3,5,80080,10238,69842,0.8721528471528471,20.99220088888889,3209.486672,13.066447843337867,126,9.100000000000017E-4
3,test_20231101_135124,10188041.png,221231,9269,211962,0.958102616721888,2,3,41731,1309,40422,0.9686324315257243,11.218222222222222,1116.4789653333332,17.65229815570365,126,9.100000000000017E-4
4,test_20231101_135124,10287332.png,216980,12364,204616,0.943017789658033,3,4,22337,1696,20641,0.9240721672561221,9.497095111111111,790.9076053333333,19.149546091497648,126,9.100000000000017E-4
5,test_20231101_135124,11610969.png,368720,24997,343723,0.932206009980473,2,4,84111,3653,80458,0.9565692953359252,22.103546666666666,3086.686544,13.235878321707402,126,9.100000000000017E-4
6,test_20231101_135124,10350842.png,212614,4294,208320,0.9798037758567169,1,3,42529,628,41901,0.9852336053046157,23.505242666666668,3390.545104,12.828108347509533,126,9.100000000000017E-4
7,test_20231101_135124,10863862.png,317432,10292,307140,0.9675773078958643,2,4,66058,1495,64563,0.9773683732477519,26.677214222222222,4038.738533333333,12.068346228764726,126,9.100000000000017E-4
8,test_20231101_135124,11382381.png,312486,747,311739,0.9976094929052821,2,3,46745,98,46647,0.9979035190929512,21.62502222222222,2484.034352,14.179227634129312,126,9.100000000000017E-4
9,test_20231101_135124,11079715.png,443815,118057,325758,0.733995020447709,4,4,124136,16497,107639,0.8671054327511761,17.022149333333335,2131.304528,14.84434853255526,126,9.100000000000017E-4
10,test_20231101_135124,11551286.png,271883,367,271516,0.9986501546621157,1,3,40092,52,40040,0.9987029831387808,18.002010666666667,1874.0560373333333,15.402977880083654,126,9.100000000000017E-4
1,test_20231101_135125,10404007.png,502730,20012,482718,0.9601933443399041,2,4,61265,2900,58365,0.9526646535542316,25.84072888888889,3462.5373013333333,12.736859001886254,126,9.200000000000018E-4
2,test_20231101_135125,1254659.png,342646,73189,269457,0.7864005416669099,2,3,80080,10238,69842,0.8721528471528471,20.99220088888889,3209.486672,13.066447843337867,126,9.200000000000018E-4
3,test_20231101_135125,10188041.png,221231,9269,211962,0.958102616721888,2,3,41731,1309,40422,0.9686324315257243,11.218222222222222,1116.4789653333332,17.65229815570365,126,9.200000000000018E-4
4,test_20231101_135125,10287332.png,216980,12364,204616,0.943017789658033,1,3,22337,1696,20641,0.9240721672561221,9.497095111111111,790.9076053333333,19.149546091497648,126,9.200000000000018E-4
5,test_20231101_135125,11610969.png,368720,24997,343723,0.932206009980473,3,3,84111,3653,80458,0.9565692953359252,22.103546666666666,3086.686544,13.235878321707402,126,9.200000000000018E-4
6,test_20231101_135125,10350842.png,212614,4294,208320,0.9798037758567169,2,3,42529,628,41901,0.9852336053046157,23.505242666666668,3390.545104,12.828108347509533,126,9.200000000000018E-4
7,test_20231101_135125,10863862.png,317432,10292,307140,0.9675773078958643,2,3,66058,1495,64563,0.9773683732477519,26.677214222222222,4038.738533333333,12.068346228764726,126,9.200000000000018E-4
8,test_20231101_135125,11382381.png,312486,747,311739,0.9976094929052821,1,4,46745,98,46647,0.9979035190929512,21.62502222222222,2484.034352,14.179227634129312,126,9.200000000000018E-4
9,test_20231101_135125,11079715.png,443815,118057,325758,0.733995020447709,3,4,124136,16497,107639,0.8671054327511761,17.022149333333335,2131.304528,14.84434853255526,126,9.200000000000018E-4
10,test_20231101_135125,11551286.png,271883,367,271516,0.9986501546621157,2,3,40092,52,40040,0.9987029831387808,18.002010666666667,1874.0560373333333,15.402977880083654,126,9.200000000000018E-4
1,test_20231101_135126,10404007.png,502730,20012,482718,0.9601933443399041,2,4,61265,2900,58365,0.9526646535542316,25.84072888888889,3462.5373013333333,12.736859001886254,126,9.300000000000018E-4
2,test_20231101_135126,1254659.png,342646,73189,269457,0.7864005416669099,3,14,80080,10238,69842,0.8721528471528471,20.99220088888889,3209.486672,13.066447843337867,126,9.300000000000018E-4
3,test_20231101_135126,10188041.png,221231,9269,211962,0.958102616721888,2,3,41731,1309,40422,0.9686324315257243,11.218222222222222,1116.4789653333332,17.65229815570365,126,9.300000000000018E-4
4,test_20231101_135126,10287332.png,216980,12364,204616,0.943017789658033,2,4,22337,1696,20641,0.9240721672561221,9.497095111111111,790.9076053333333,19.149546091497648,126,9.300000000000018E-4
5,test_20231101_135126,11610969.png,368720,24997,343723,0.932206009980473,3,4,84111,3653,80458,0.9565692953359252,22.103546666666666,3086.686544,13.235878321707402,126,9.300000000000018E-4
6,test_20231101_135126,10350842.png,212614,4294,208320,0.9798037758567169,1,3,42529,628,41901,0.9852336053046157,23.505242666666668,3390.545104,12.828108347509533,126,9.300000000000018E-4
7,test_20231101_135126,10863862.png,317432,10292,307140,0.9675773078958643,2,4,66058,1495,64563,0.9773683732477519,26.677214222222222,4038.738533333333,12.068346228764726,126,9.300000000000018E-4
8,test_20231101_135126,11382381.png,312486,747,311739,0.9976094929052821,2,4,46745,98,46647,0.9979035190929512,21.62502222222222,2484.034352,14.179227634129312,126,9.300000000000018E-4
9,test_20231101_135126,11079715.png,443815,118057,325758,0.733995020447709,4,4,124136,16497,107639,0.8671054327511761,17.022149333333335,2131.304528,14.84434853255526,126,9.300000000000018E-4
10,test_20231101_135126,11551286.png,271883,367,271516,0.9986501546621157,1,3,40092,52,40040,0.9987029831387808,18.002010666666667,1874.0560373333333,15.402977880083654,126,9.300000000000018E-4
1,test_20231101_135126,10404007.png,502730,20012,482718,0.9601933443399041,3,3,61265,2900,58365,0.9526646535542316,25.84072888888889,3462.5373013333333,12.736859001886254,126,9.400000000000018E-4
2,test_20231101_135126,1254659.png,342646,73189,269457,0.7864005416669099,3,4,80080,10238,69842,0.8721528471528471,20.99220088888889,3209.486672,13.066447843337867,126,9.400000000000018E-4
3,test_20231101_135126,10188041.png,221231,9269,211962,0.958102616721888,2,4,41731,1309,40422,0.9686324315257243,11.218222222222222,1116.4789653333332,17.65229815570365,126,9.400000000000018E-4
4,test_20231101_135126,10287332.png,216980,12364,204616,0.943017789658033,1,4,22337,1696,20641,0.9240721672561221,9.497095111111111,790.9076053333333,19.149546091497648,126,9.400000000000018E-4
5,test_20231101_135126,11610969.png,368720,24997,343723,0.932206009980473,3,3,84111,3653,80458,0.9565692953359252,22.103546666666666,3086.686544,13.235878321707402,126,9.400000000000018E-4
6,test_20231101_135126,10350842.png,212614,4294,208320,0.9798037758567169,1,3,42529,628,41901,0.9852336053046157,23.505242666666668,3390.545104,12.828108347509533,126,9.400000000000018E-4
7,test_20231101_135126,10863862.png,317432,10292,307140,0.9675773078958643,2,4,66058,1495,64563,0.9773683732477519,26.677214222222222,4038.738533333333,12.068346228764726,126,9.400000000000018E-4
8,test_20231101_135126,11382381.png,312486,747,311739,0.9976094929052821,1,3,46745,98,46647,0.9979035190929512,21.62502222222222,2484.034352,14.179227634129312,126,9.400000000000018E-4
9,test_20231101_135126,11079715.png,443815,118057,325758,0.733995020447709,4,4,124136,16497,107639,0.8671054327511761,17.022149333333335,2131.304528,14.84434853255526,126,9.400000000000018E-4
10,test_20231101_135126,11551286.png,271883,367,271516,0.9986501546621157,1,4,40092,52,40040,0.9987029831387808,18.002010666666667,1874.0560373333333,15.402977880083654,126,9.400000000000018E-4
1,test_20231101_135127,10404007.png,502730,20012,482718,0.9601933443399041,2,4,61265,2900,58365,0.9526646535542316,25.84072888888889,3462.5373013333333,12.736859001886254,126,9.500000000000018E-4
2,test_20231101_135127,1254659.png,342646,73189,269457,0.7864005416669099,3,4,80080,10238,69842,0.8721528471528471,20.99220088888889,3209.486672,13.066447843337867,126,9.500000000000018E-4
3,test_20231101_135127,10188041.png,221231,9269,211962,0.958102616721888,2,4,41731,1309,40422,0.9686324315257243,11.218222222222222,1116.4789653333332,17.65229815570365,126,9.500000000000018E-4
4,test_20231101_135127,10287332.png,216980,12364,204616,0.943017789658033,2,4,22337,1696,20641,0.9240721672561221,9.497095111111111,790.9076053333333,19.149546091497648,126,9.500000000000018E-4
5,test_20231101_135127,11610969.png,368720,24997,343723,0.932206009980473,3,4,84111,3653,80458,0.9565692953359252,22.103546666666666,3086.686544,13.235878321707402,126,9.500000000000018E-4
6,test_20231101_135127,10350842.png,212614,4294,208320,0.9798037758567169,1,4,42529,628,41901,0.9852336053046157,23.505242666666668,3390.545104,12.828108347509533,126,9.500000000000018E-4
7,test_20231101_135127,10863862.png,317432,10292,307140,0.9675773078958643,2,4,66058,1495,64563,0.9773683732477519,26.677214222222222,4038.738533333333,12.068346228764726,126,9.500000000000018E-4
8,test_20231101_135127,11382381.png,312486,747,311739,0.9976094929052821,2,3,46745,98,46647,0.9979035190929512,21.62502222222222,2484.034352,14.179227634129312,126,9.500000000000018E-4
9,test_20231101_135127,11079715.png,443815,118057,325758,0.733995020447709,4,4,124136,16497,107639,0.8671054327511761,17.022149333333335,2131.304528,14.84434853255526,126,9.500000000000018E-4
10,test_20231101_135127,11551286.png,271883,367,271516,0.9986501546621157,1,3,40092,52,40040,0.9987029831387808,18.002010666666667,1874.0560373333333,15.402977880083654,126,9.500000000000018E-4
1,test_20231101_135128,10404007.png,502730,20012,482718,0.9601933443399041,3,3,61265,2900,58365,0.9526646535542316,25.84072888888889,3462.5373013333333,12.736859001886254,126,9.600000000000019E-4
2,test_20231101_135128,1254659.png,342646,73189,269457,0.7864005416669099,3,4,80080,10238,69842,0.8721528471528471,20.99220088888889,3209.486672,13.066447843337867,126,9.600000000000019E-4
3,test_20231101_135128,10188041.png,221231,9269,211962,0.958102616721888,2,13,41731,1309,40422,0.9686324315257243,11.218222222222222,1116.4789653333332,17.65229815570365,126,9.600000000000019E-4
4,test_20231101_135128,10287332.png,216980,12364,204616,0.943017789658033,1,3,22337,1696,20641,0.9240721672561221,9.497095111111111,790.9076053333333,19.149546091497648,126,9.600000000000019E-4
5,test_20231101_135128,11610969.png,368720,24997,343723,0.932206009980473,3,4,84111,3653,80458,0.9565692953359252,22.103546666666666,3086.686544,13.235878321707402,126,9.600000000000019E-4
6,test_20231101_135128,10350842.png,212614,4294,208320,0.9798037758567169,2,3,42529,628,41901,0.9852336053046157,23.505242666666668,3390.545104,12.828108347509533,126,9.600000000000019E-4
7,test_20231101_135128,10863862.png,317432,10292,307140,0.9675773078958643,2,4,66058,1495,64563,0.9773683732477519,26.677214222222222,4038.738533333333,12.068346228764726,126,9.600000000000019E-4
8,test_20231101_135128,11382381.png,312486,747,311739,0.9976094929052821,1,10,46745,98,46647,0.9979035190929512,21.62502222222222,2484.034352,14.179227634129312,126,9.600000000000019E-4
9,test_20231101_135128,11079715.png,443815,118057,325758,0.733995020447709,4,4,124136,16497,107639,0.8671054327511761,17.022149333333335,2131.304528,14.84434853255526,126,9.600000000000019E-4
10,test_20231101_135128,11551286.png,271883,367,271516,0.9986501546621157,1,4,40092,52,40040,0.9987029831387808,18.002010666666667,1874.0560373333333,15.402977880083654,126,9.600000000000019E-4
1,test_20231101_135128,10404007.png,502730,20012,482718,0.9601933443399041,3,3,61265,2900,58365,0.9526646535542316,25.84072888888889,3462.5373013333333,12.736859001886254,126,9.700000000000019E-4
2,test_20231101_135128,1254659.png,342646,73189,269457,0.7864005416669099,3,4,80080,10238,69842,0.8721528471528471,20.99220088888889,3209.486672,13.066447843337867,126,9.700000000000019E-4
3,test_20231101_135128,10188041.png,221231,9269,211962,0.958102616721888,2,11,41731,1309,40422,0.9686324315257243,11.218222222222222,1116.4789653333332,17.65229815570365,126,9.700000000000019E-4
4,test_20231101_135128,10287332.png,216980,12364,204616,0.943017789658033,2,4,22337,1696,20641,0.9240721672561221,9.497095111111111,790.9076053333333,19.149546091497648,126,9.700000000000019E-4
5,test_20231101_135128,11610969.png,368720,24997,343723,0.932206009980473,2,4,84111,3653,80458,0.9565692953359252,22.103546666666666,3086.686544,13.235878321707402,126,9.700000000000019E-4
6,test_20231101_135128,10350842.png,212614,4294,208320,0.9798037758567169,1,3,42529,628,41901,0.9852336053046157,23.505242666666668,3390.545104,12.828108347509533,126,9.700000000000019E-4
7,test_20231101_135128,10863862.png,317432,10292,307140,0.9675773078958643,2,3,66058,1495,64563,0.9773683732477519,26.677214222222222,4038.738533333333,12.068346228764726,126,9.700000000000019E-4
8,test_20231101_135128,11382381.png,312486,747,311739,0.9976094929052821,2,3,46745,98,46647,0.9979035190929512,21.62502222222222,2484.034352,14.179227634129312,126,9.700000000000019E-4
9,test_20231101_135128,11079715.png,443815,118057,325758,0.733995020447709,4,4,124136,16497,107639,0.8671054327511761,17.022149333333335,2131.304528,14.84434853255526,126,9.700000000000019E-4
10,test_20231101_135128,11551286.png,271883,367,271516,0.9986501546621157,1,4,40092,52,40040,0.9987029831387808,18.002010666666667,1874.0560373333333,15.402977880083654,126,9.700000000000019E-4
1,test_20231101_135129,10404007.png,502730,19387,483343,0.9614365564020448,3,4,61265,2816,58449,0.9540357463478332,26.041116444444445,3512.823402666667,12.674240434627826,126,9.80000000000002E-4
2,test_20231101_135129,1254659.png,342646,73027,269619,0.7868733328274662,3,4,80080,10224,69856,0.8723276723276723,21.061925333333335,3224.1671306666667,13.046628146936053,126,9.80000000000002E-4
3,test_20231101_135129,10188041.png,221231,9067,212164,0.9590156894829387,2,4,41731,1289,40442,0.9691116915482495,11.302140444444445,1131.4059626666667,17.594618976652107,126,9.80000000000002E-4
4,test_20231101_135129,10287332.png,216980,12262,204718,0.9434878790671951,1,3,22337,1681,20656,0.92474369879572,9.548682666666666,799.498464,19.10262727153343,126,9.80000000000002E-4
5,test_20231101_135129,11610969.png,368720,24714,344006,0.9329735300499024,2,4,84111,3616,80495,0.957009190236711,22.159283555555554,3094.5564426666665,13.224819525221838,126,9.80000000000002E-4
6,test_20231101_135129,10350842.png,212614,4174,208440,0.9803681789534086,1,4,42529,610,41919,0.9856568459169037,23.65995911111111,3419.203984,12.791553500148652,126,9.80000000000002E-4
7,test_20231101_135129,10863862.png,317432,10072,307360,0.9682703697169788,2,3,66058,1463,64595,0.9778527960277332,26.819024,4073.011450666667,12.031647298257727,126,9.80000000000002E-4
8,test_20231101_135129,11382381.png,312486,547,311939,0.9982495215785667,2,3,46745,73,46672,0.9984383356508717,22.032236444444443,2581.941392,14.011339809622479,126,9.80000000000002E-4
9,test_20231101_135129,11079715.png,443815,117997,325818,0.7341302119126212,4,4,124136,16492,107644,0.8671457111555069,17.046920888888888,2135.3233546666665,14.836167107742856,126,9.80000000000002E-4
10,test_20231101_135129,11551286.png,271883,367,271516,0.9986501546621157,1,3,40092,52,40040,0.9987029831387808,18.002010666666667,1874.0560373333333,15.402977880083654,126,9.80000000000002E-4
1,test_20231101_135130,10404007.png,502730,19387,483343,0.9614365564020448,2,4,61265,2816,58449,0.9540357463478332,26.041116444444445,3512.823402666667,12.674240434627826,126,9.90000000000002E-4
2,test_20231101_135130,1254659.png,342646,73027,269619,0.7868733328274662,3,4,80080,10224,69856,0.8723276723276723,21.061925333333335,3224.1671306666667,13.046628146936053,126,9.90000000000002E-4
3,test_20231101_135130,10188041.png,221231,9067,212164,0.9590156894829387,2,4,41731,1289,40442,0.9691116915482495,11.302140444444445,1131.4059626666667,17.594618976652107,126,9.90000000000002E-4
4,test_20231101_135130,10287332.png,216980,12262,204718,0.9434878790671951,1,3,22337,1681,20656,0.92474369879572,9.548682666666666,799.498464,19.10262727153343,126,9.90000000000002E-4
5,test_20231101_135130,11610969.png,368720,24714,344006,0.9329735300499024,2,4,84111,3616,80495,0.957009190236711,22.159283555555554,3094.5564426666665,13.224819525221838,126,9.90000000000002E-4
6,test_20231101_135130,10350842.png,212614,4174,208440,0.9803681789534086,2,4,42529,610,41919,0.9856568459169037,23.65995911111111,3419.203984,12.791553500148652,126,9.90000000000002E-4
7,test_20231101_135130,10863862.png,317432,10072,307360,0.9682703697169788,2,3,66058,1463,64595,0.9778527960277332,26.819024,4073.011450666667,12.031647298257727,126,9.90000000000002E-4
8,test_20231101_135130,11382381.png,312486,547,311939,0.9982495215785667,1,3,46745,73,46672,0.9984383356508717,22.032236444444443,2581.941392,14.011339809622479,126,9.90000000000002E-4
9,test_20231101_135130,11079715.png,443815,117997,325818,0.7341302119126212,3,4,124136,16492,107644,0.8671457111555069,17.046920888888888,2135.3233546666665,14.836167107742856,126,9.90000000000002E-4
10,test_20231101_135130,11551286.png,271883,367,271516,0.9986501546621157,1,3,40092,52,40040,0.9987029831387808,18.002010666666667,1874.0560373333333,15.402977880083654,126,9.90000000000002E-4
1,test_20231101_135131,10404007.png,502730,19649,483081,0.9609154019055954,2,4,61265,2845,58420,0.9535623928833755,25.79059377777778,3461.428794666667,12.738249587356849,127,0.0
2,test_20231101_135131,1254659.png,342646,71682,270964,0.7907986668456658,4,4,80080,10037,70043,0.8746628371628371,21.233608888888888,3282.5188533333335,12.968731317042248,127,0.0
3,test_20231101_135131,10188041.png,221231,9489,211742,0.9571081810415357,2,4,41731,1337,40394,0.967961467494189,10.60381511111111,1029.055584,18.006415272400552,127,0.0
4,test_20231101_135131,10287332.png,216980,12312,204668,0.9432574430823117,1,3,22337,1688,20649,0.9244303174105744,9.401898666666666,774.2090986666667,19.242220899357278,127,0.0
5,test_20231101_135131,11610969.png,368720,24512,344208,0.9335213712302017,3,4,84111,3579,80532,0.9574490851374968,21.428912,2970.4620213333333,13.402563567661467,127,0.0
6,test_20231101_135131,10350842.png,212614,5842,206772,0.9725229759093945,2,3,42529,859,41670,0.9798020174469185,19.341116444444445,2392.76384,14.341805239536118,127,0.0
7,test_20231101_135131,10863862.png,317432,11017,306415,0.9652933541671918,2,3,66058,1602,64456,0.9757485845771897,24.437365333333332,3426.7552746666665,12.781972709279499,127,0.0
8,test_20231101_135131,11382381.png,312486,967,311519,0.9969054613646692,2,6,46745,132,46613,0.997176168574179,20.34548088888889,2312.227088,14.490498761790324,127,0.0
9,test_20231101_135131,11079715.png,443815,115577,328238,0.7395829343307458,5,5,124136,16143,107993,0.8699571437777921,17.25776711111111,2193.2968,14.719829558750817,127,0.0
10,test_20231101_135131,11551286.png,271883,1039,270844,0.9961785032532376,1,4,40092,152,39940,0.9962087199441285,15.89976888888889,1521.9435626666666,16.30681812820273,127,0.0
1,test_20231101_135131,10404007.png,502730,19649,483081,0.9609154019055954,3,10,61265,2845,58420,0.9535623928833755,25.79059377777778,3461.428794666667,12.738249587356849,127,1.0E-5
2,test_20231101_135131,1254659.png,342646,71682,270964,0.7907986668456658,3,4,80080,10037,70043,0.8746628371628371,21.233608888888888,3282.5188533333335,12.968731317042248,127,1.0E-5
3,test_20231101_135131,10188041.png,221231,9489,211742,0.9571081810415357,2,4,41731,1337,40394,0.967961467494189,10.60381511111111,1029.055584,18.006415272400552,127,1.0E-5
4,test_20231101_135131,10287332.png,216980,12312,204668,0.9432574430823117,2,3,22337,1688,20649,0.9244303174105744,9.401898666666666,774.2090986666667,19.242220899357278,127,1.0E-5
5,test_20231101_135131,11610969.png,368720,24512,344208,0.9335213712302017,2,3,84111,3579,80532,0.9574490851374968,21.428912,2970.4620213333333,13.402563567661467,127,1.0E-5
6,test_20231101_135131,10350842.png,212614,5842,206772,0.9725229759093945,1,4,42529,859,41670,0.9798020174469185,19.341116444444445,2392.76384,14.341805239536118,127,1.0E-5
7,test_20231101_135131,10863862.png,317432,11017,306415,0.9652933541671918,1,3,66058,1602,64456,0.9757485845771897,24.437365333333332,3426.7552746666665,12.781972709279499,127,1.0E-5
8,test_20231101_135131,11382381.png,312486,967,311519,0.9969054613646692,2,3,46745,132,46613,0.997176168574179,20.34548088888889,2312.227088,14.490498761790324,127,1.0E-5
9,test_20231101_135131,11079715.png,443815,115577,328238,0.7395829343307458,4,7,124136,16143,107993,0.8699571437777921,17.25776711111111,2193.2968,14.719829558750817,127,1.0E-5
10,test_20231101_135131,11551286.png,271883,1039,270844,0.9961785032532376,1,3,40092,152,39940,0.9962087199441285,15.89976888888889,1521.9435626666666,16.30681812820273,127,1.0E-5
1,test_20231101_135132,10404007.png,502730,19649,483081,0.9609154019055954,2,9,61265,2845,58420,0.9535623928833755,25.79059377777778,3461.428794666667,12.738249587356849,127,2.0E-5
2,test_20231101_135132,1254659.png,342646,71682,270964,0.7907986668456658,2,3,80080,10037,70043,0.8746628371628371,21.233608888888888,3282.5188533333335,12.968731317042248,127,2.0E-5
3,test_20231101_135132,10188041.png,221231,9489,211742,0.9571081810415357,2,3,41731,1337,40394,0.967961467494189,10.60381511111111,1029.055584,18.006415272400552,127,2.0E-5
4,test_20231101_135132,10287332.png,216980,12312,204668,0.9432574430823117,1,4,22337,1688,20649,0.9244303174105744,9.401898666666666,774.2090986666667,19.242220899357278,127,2.0E-5
5,test_20231101_135132,11610969.png,368720,24512,344208,0.9335213712302017,3,6,84111,3579,80532,0.9574490851374968,21.428912,2970.4620213333333,13.402563567661467,127,2.0E-5
6,test_20231101_135132,10350842.png,212614,5842,206772,0.9725229759093945,1,4,42529,859,41670,0.9798020174469185,19.341116444444445,2392.76384,14.341805239536118,127,2.0E-5
7,test_20231101_135132,10863862.png,317432,11017,306415,0.9652933541671918,2,6,66058,1602,64456,0.9757485845771897,24.437365333333332,3426.7552746666665,12.781972709279499,127,2.0E-5
8,test_20231101_135132,11382381.png,312486,967,311519,0.9969054613646692,2,4,46745,132,46613,0.997176168574179,20.34548088888889,2312.227088,14.490498761790324,127,2.0E-5
9,test_20231101_135132,11079715.png,443815,115577,328238,0.7395829343307458,3,4,124136,16143,107993,0.8699571437777921,17.25776711111111,2193.2968,14.719829558750817,127,2.0E-5
10,test_20231101_135132,11551286.png,271883,1039,270844,0.9961785032532376,1,3,40092,152,39940,0.9962087199441285,15.89976888888889,1521.9435626666666,16.30681812820273,127,2.0E-5
1,test_20231101_135133,10404007.png,502730,19649,483081,0.9609154019055954,2,4,61265,2845,58420,0.9535623928833755,25.79059377777778,3461.428794666667,12.738249587356849,127,3.0000000000000004E-5
2,test_20231101_135133,1254659.png,342646,71682,270964,0.7907986668456658,3,4,80080,10037,70043,0.8746628371628371,21.233608888888888,3282.5188533333335,12.968731317042248,127,3.0000000000000004E-5
3,test_20231101_135133,10188041.png,221231,9489,211742,0.9571081810415357,2,4,41731,1337,40394,0.967961467494189,10.60381511111111,1029.055584,18.006415272400552,127,3.0000000000000004E-5
4,test_20231101_135133,10287332.png,216980,12312,204668,0.9432574430823117,2,3,22337,1688,20649,0.9244303174105744,9.401898666666666,774.2090986666667,19.242220899357278,127,3.0000000000000004E-5
5,test_20231101_135133,11610969.png,368720,24512,344208,0.9335213712302017,2,4,84111,3579,80532,0.9574490851374968,21.428912,2970.4620213333333,13.402563567661467,127,3.0000000000000004E-5
6,test_20231101_135133,10350842.png,212614,5842,206772,0.9725229759093945,1,4,42529,859,41670,0.9798020174469185,19.341116444444445,2392.76384,14.341805239536118,127,3.0000000000000004E-5
7,test_20231101_135133,10863862.png,317432,11017,306415,0.9652933541671918,2,4,66058,1602,64456,0.9757485845771897,24.437365333333332,3426.7552746666665,12.781972709279499,127,3.0000000000000004E-5
8,test_20231101_135133,11382381.png,312486,967,311519,0.9969054613646692,2,4,46745,132,46613,0.997176168574179,20.34548088888889,2312.227088,14.490498761790324,127,3.0000000000000004E-5
9,test_20231101_135133,11079715.png,443815,115577,328238,0.7395829343307458,3,4,124136,16143,107993,0.8699571437777921,17.25776711111111,2193.2968,14.719829558750817,127,3.0000000000000004E-5
10,test_20231101_135133,11551286.png,271883,1039,270844,0.9961785032532376,2,3,40092,152,39940,0.9962087199441285,15.89976888888889,1521.9435626666666,16.30681812820273,127,3.0000000000000004E-5
1,test_20231101_135133,10404007.png,502730,19649,483081,0.9609154019055954,2,4,61265,2845,58420,0.9535623928833755,25.79059377777778,3461.428794666667,12.738249587356849,127,4.0E-5
2,test_20231101_135133,1254659.png,342646,71682,270964,0.7907986668456658,3,4,80080,10037,70043,0.8746628371628371,21.233608888888888,3282.5188533333335,12.968731317042248,127,4.0E-5
3,test_20231101_135133,10188041.png,221231,9489,211742,0.9571081810415357,2,4,41731,1337,40394,0.967961467494189,10.60381511111111,1029.055584,18.006415272400552,127,4.0E-5
4,test_20231101_135133,10287332.png,216980,12312,204668,0.9432574430823117,2,3,22337,1688,20649,0.9244303174105744,9.401898666666666,774.2090986666667,19.242220899357278,127,4.0E-5
5,test_20231101_135133,11610969.png,368720,24512,344208,0.9335213712302017,3,4,84111,3579,80532,0.9574490851374968,21.428912,2970.4620213333333,13.402563567661467,127,4.0E-5
6,test_20231101_135133,10350842.png,212614,5842,206772,0.9725229759093945,1,7,42529,859,41670,0.9798020174469185,19.341116444444445,2392.76384,14.341805239536118,127,4.0E-5
7,test_20231101_135133,10863862.png,317432,11017,306415,0.9652933541671918,2,3,66058,1602,64456,0.9757485845771897,24.437365333333332,3426.7552746666665,12.781972709279499,127,4.0E-5
8,test_20231101_135133,11382381.png,312486,967,311519,0.9969054613646692,2,3,46745,132,46613,0.997176168574179,20.34548088888889,2312.227088,14.490498761790324,127,4.0E-5
9,test_20231101_135133,11079715.png,443815,115577,328238,0.7395829343307458,3,8,124136,16143,107993,0.8699571437777921,17.25776711111111,2193.2968,14.719829558750817,127,4.0E-5
10,test_20231101_135133,11551286.png,271883,1039,270844,0.9961785032532376,2,4,40092,152,39940,0.9962087199441285,15.89976888888889,1521.9435626666666,16.30681812820273,127,4.0E-5
1,test_20231101_135134,10404007.png,502730,19649,483081,0.9609154019055954,2,3,61265,2845,58420,0.9535623928833755,25.79059377777778,3461.428794666667,12.738249587356849,127,5.0E-5
2,test_20231101_135134,1254659.png,342646,71682,270964,0.7907986668456658,9,4,80080,10037,70043,0.8746628371628371,21.233608888888888,3282.5188533333335,12.968731317042248,127,5.0E-5
3,test_20231101_135134,10188041.png,221231,9489,211742,0.9571081810415357,2,4,41731,1337,40394,0.967961467494189,10.60381511111111,1029.055584,18.006415272400552,127,5.0E-5
4,test_20231101_135134,10287332.png,216980,12312,204668,0.9432574430823117,2,4,22337,1688,20649,0.9244303174105744,9.401898666666666,774.2090986666667,19.242220899357278,127,5.0E-5
5,test_20231101_135134,11610969.png,368720,24512,344208,0.9335213712302017,2,4,84111,3579,80532,0.9574490851374968,21.428912,2970.4620213333333,13.402563567661467,127,5.0E-5
6,test_20231101_135134,10350842.png,212614,5842,206772,0.9725229759093945,2,4,42529,859,41670,0.9798020174469185,19.341116444444445,2392.76384,14.341805239536118,127,5.0E-5
7,test_20231101_135134,10863862.png,317432,11017,306415,0.9652933541671918,2,4,66058,1602,64456,0.9757485845771897,24.437365333333332,3426.7552746666665,12.781972709279499,127,5.0E-5
8,test_20231101_135134,11382381.png,312486,957,311529,0.9969374627983334,2,4,46745,131,46614,0.9971975612364958,21.075297777777777,2410.7878986666665,14.309213580767988,127,5.0E-5
9,test_20231101_135134,11079715.png,443815,115577,328238,0.7395829343307458,4,5,124136,16143,107993,0.8699571437777921,17.25776711111111,2193.2968,14.719829558750817,127,5.0E-5
10,test_20231101_135134,11551286.png,271883,1039,270844,0.9961785032532376,2,4,40092,152,39940,0.9962087199441285,15.89976888888889,1521.9435626666666,16.30681812820273,127,5.0E-5
1,test_20231101_135135,10404007.png,502730,19649,483081,0.9609154019055954,3,4,61265,2845,58420,0.9535623928833755,25.79059377777778,3461.428794666667,12.738249587356849,127,6.0E-5
2,test_20231101_135135,1254659.png,342646,71682,270964,0.7907986668456658,3,4,80080,10037,70043,0.8746628371628371,21.233608888888888,3282.5188533333335,12.968731317042248,127,6.0E-5
3,test_20231101_135135,10188041.png,221231,9489,211742,0.9571081810415357,2,3,41731,1337,40394,0.967961467494189,10.60381511111111,1029.055584,18.006415272400552,127,6.0E-5
4,test_20231101_135135,10287332.png,216980,12312,204668,0.9432574430823117,1,3,22337,1688,20649,0.9244303174105744,9.401898666666666,774.2090986666667,19.242220899357278,127,6.0E-5
5,test_20231101_135135,11610969.png,368720,24512,344208,0.9335213712302017,2,3,84111,3579,80532,0.9574490851374968,21.428912,2970.4620213333333,13.402563567661467,127,6.0E-5
6,test_20231101_135135,10350842.png,212614,5842,206772,0.9725229759093945,1,8,42529,859,41670,0.9798020174469185,19.341116444444445,2392.76384,14.341805239536118,127,6.0E-5
7,test_20231101_135135,10863862.png,317432,11017,306415,0.9652933541671918,2,4,66058,1602,64456,0.9757485845771897,24.437365333333332,3426.7552746666665,12.781972709279499,127,6.0E-5
8,test_20231101_135135,11382381.png,312486,957,311529,0.9969374627983334,1,4,46745,131,46614,0.9971975612364958,21.075297777777777,2410.7878986666665,14.309213580767988,127,6.0E-5
9,test_20231101_135135,11079715.png,443815,115577,328238,0.7395829343307458,3,5,124136,16143,107993,0.8699571437777921,17.25776711111111,2193.2968,14.719829558750817,127,6.0E-5
10,test_20231101_135135,11551286.png,271883,1039,270844,0.9961785032532376,1,3,40092,152,39940,0.9962087199441285,15.89976888888889,1521.9435626666666,16.30681812820273,127,6.0E-5
1,test_20231101_135135,10404007.png,502730,19649,483081,0.9609154019055954,2,3,61265,2845,58420,0.9535623928833755,25.79059377777778,3461.428794666667,12.738249587356849,127,7.000000000000001E-5
2,test_20231101_135135,1254659.png,342646,71682,270964,0.7907986668456658,2,3,80080,10037,70043,0.8746628371628371,21.233608888888888,3282.5188533333335,12.968731317042248,127,7.000000000000001E-5
3,test_20231101_135135,10188041.png,221231,9489,211742,0.9571081810415357,2,3,41731,1337,40394,0.967961467494189,10.60381511111111,1029.055584,18.006415272400552,127,7.000000000000001E-5
4,test_20231101_135135,10287332.png,216980,12312,204668,0.9432574430823117,1,4,22337,1688,20649,0.9244303174105744,9.401898666666666,774.2090986666667,19.242220899357278,127,7.000000000000001E-5
5,test_20231101_135135,11610969.png,368720,24512,344208,0.9335213712302017,2,4,84111,3579,80532,0.9574490851374968,21.428912,2970.4620213333333,13.402563567661467,127,7.000000000000001E-5
6,test_20231101_135135,10350842.png,212614,5842,206772,0.9725229759093945,1,3,42529,859,41670,0.9798020174469185,19.341116444444445,2392.76384,14.341805239536118,127,7.000000000000001E-5
7,test_20231101_135135,10863862.png,317432,11017,306415,0.9652933541671918,2,3,66058,1602,64456,0.9757485845771897,24.437365333333332,3426.7552746666665,12.781972709279499,127,7.000000000000001E-5
8,test_20231101_135135,11382381.png,312486,957,311529,0.9969374627983334,2,3,46745,131,46614,0.9971975612364958,21.075297777777777,2410.7878986666665,14.309213580767988,127,7.000000000000001E-5
9,test_20231101_135135,11079715.png,443815,115577,328238,0.7395829343307458,3,4,124136,16143,107993,0.8699571437777921,17.25776711111111,2193.2968,14.719829558750817,127,7.000000000000001E-5
10,test_20231101_135135,11551286.png,271883,917,270966,0.9966272256816351,1,3,40092,134,39958,0.9966576873191659,15.986103111111111,1528.055536,16.289412222433906,127,7.000000000000001E-5
1,test_20231101_135136,10404007.png,502730,19649,483081,0.9609154019055954,2,3,61265,2845,58420,0.9535623928833755,25.79059377777778,3461.428794666667,12.738249587356849,127,8.0E-5
2,test_20231101_135136,1254659.png,342646,71682,270964,0.7907986668456658,3,4,80080,10037,70043,0.8746628371628371,21.233608888888888,3282.5188533333335,12.968731317042248,127,8.0E-5
3,test_20231101_135136,10188041.png,221231,9489,211742,0.9571081810415357,2,4,41731,1337,40394,0.967961467494189,10.60381511111111,1029.055584,18.006415272400552,127,8.0E-5
4,test_20231101_135136,10287332.png,216980,12312,204668,0.9432574430823117,1,3,22337,1688,20649,0.9244303174105744,9.401898666666666,774.2090986666667,19.242220899357278,127,8.0E-5
5,test_20231101_135136,11610969.png,368720,24512,344208,0.9335213712302017,2,3,84111,3579,80532,0.9574490851374968,21.428912,2970.4620213333333,13.402563567661467,127,8.0E-5
6,test_20231101_135136,10350842.png,212614,5842,206772,0.9725229759093945,2,4,42529,859,41670,0.9798020174469185,19.341116444444445,2392.76384,14.341805239536118,127,8.0E-5
7,test_20231101_135136,10863862.png,317432,11017,306415,0.9652933541671918,2,3,66058,1602,64456,0.9757485845771897,24.437365333333332,3426.7552746666665,12.781972709279499,127,8.0E-5
8,test_20231101_135136,11382381.png,312486,957,311529,0.9969374627983334,2,3,46745,131,46614,0.9971975612364958,21.075297777777777,2410.7878986666665,14.309213580767988,127,8.0E-5
9,test_20231101_135136,11079715.png,443815,115577,328238,0.7395829343307458,3,5,124136,16143,107993,0.8699571437777921,17.25776711111111,2193.2968,14.719829558750817,127,8.0E-5
10,test_20231101_135136,11551286.png,271883,917,270966,0.9966272256816351,1,3,40092,134,39958,0.9966576873191659,15.986103111111111,1528.055536,16.289412222433906,127,8.0E-5
1,test_20231101_135137,10404007.png,502730,19649,483081,0.9609154019055954,2,3,61265,2845,58420,0.9535623928833755,25.79059377777778,3461.428794666667,12.738249587356849,127,9.0E-5
2,test_20231101_135137,1254659.png,342646,71682,270964,0.7907986668456658,3,4,80080,10037,70043,0.8746628371628371,21.233608888888888,3282.5188533333335,12.968731317042248,127,9.0E-5
3,test_20231101_135137,10188041.png,221231,9489,211742,0.9571081810415357,2,3,41731,1337,40394,0.967961467494189,10.60381511111111,1029.055584,18.006415272400552,127,9.0E-5
4,test_20231101_135137,10287332.png,216980,12312,204668,0.9432574430823117,1,3,22337,1688,20649,0.9244303174105744,9.401898666666666,774.2090986666667,19.242220899357278,127,9.0E-5
5,test_20231101_135137,11610969.png,368720,24512,344208,0.9335213712302017,2,4,84111,3579,80532,0.9574490851374968,21.428912,2970.4620213333333,13.402563567661467,127,9.0E-5
6,test_20231101_135137,10350842.png,212614,5842,206772,0.9725229759093945,2,4,42529,859,41670,0.9798020174469185,19.341116444444445,2392.76384,14.341805239536118,127,9.0E-5
7,test_20231101_135137,10863862.png,317432,11017,306415,0.9652933541671918,2,3,66058,1602,64456,0.9757485845771897,24.437365333333332,3426.7552746666665,12.781972709279499,127,9.0E-5
8,test_20231101_135137,11382381.png,312486,957,311529,0.9969374627983334,1,3,46745,131,46614,0.9971975612364958,21.075297777777777,2410.7878986666665,14.309213580767988,127,9.0E-5
9,test_20231101_135137,11079715.png,443815,115577,328238,0.7395829343307458,4,4,124136,16143,107993,0.8699571437777921,17.25776711111111,2193.2968,14.719829558750817,127,9.0E-5
10,test_20231101_135137,11551286.png,271883,917,270966,0.9966272256816351,1,3,40092,134,39958,0.9966576873191659,15.986103111111111,1528.055536,16.289412222433906,127,9.0E-5
1,test_20231101_135137,10404007.png,502730,19649,483081,0.9609154019055954,2,4,61265,2845,58420,0.9535623928833755,25.79059377777778,3461.428794666667,12.738249587356849,127,1.0E-4
2,test_20231101_135137,1254659.png,342646,71682,270964,0.7907986668456658,2,3,80080,10037,70043,0.8746628371628371,21.233608888888888,3282.5188533333335,12.968731317042248,127,1.0E-4
3,test_20231101_135137,10188041.png,221231,9489,211742,0.9571081810415357,2,3,41731,1337,40394,0.967961467494189,10.60381511111111,1029.055584,18.006415272400552,127,1.0E-4
4,test_20231101_135137,10287332.png,216980,12312,204668,0.9432574430823117,2,3,22337,1688,20649,0.9244303174105744,9.401898666666666,774.2090986666667,19.242220899357278,127,1.0E-4
5,test_20231101_135137,11610969.png,368720,24512,344208,0.9335213712302017,2,3,84111,3579,80532,0.9574490851374968,21.428912,2970.4620213333333,13.402563567661467,127,1.0E-4
6,test_20231101_135137,10350842.png,212614,5842,206772,0.9725229759093945,1,3,42529,859,41670,0.9798020174469185,19.341116444444445,2392.76384,14.341805239536118,127,1.0E-4
7,test_20231101_135137,10863862.png,317432,11017,306415,0.9652933541671918,2,4,66058,1602,64456,0.9757485845771897,24.437365333333332,3426.7552746666665,12.781972709279499,127,1.0E-4
8,test_20231101_135137,11382381.png,312486,957,311529,0.9969374627983334,2,4,46745,131,46614,0.9971975612364958,21.075297777777777,2410.7878986666665,14.309213580767988,127,1.0E-4
9,test_20231101_135137,11079715.png,443815,115577,328238,0.7395829343307458,4,5,124136,16143,107993,0.8699571437777921,17.25776711111111,2193.2968,14.719829558750817,127,1.0E-4
10,test_20231101_135137,11551286.png,271883,917,270966,0.9966272256816351,2,4,40092,134,39958,0.9966576873191659,15.986103111111111,1528.055536,16.289412222433906,127,1.0E-4
1,test_20231101_135138,10404007.png,502730,19649,483081,0.9609154019055954,2,4,61265,2845,58420,0.9535623928833755,25.79059377777778,3461.428794666667,12.738249587356849,127,1.1E-4
2,test_20231101_135138,1254659.png,342646,71682,270964,0.7907986668456658,3,4,80080,10037,70043,0.8746628371628371,21.233608888888888,3282.5188533333335,12.968731317042248,127,1.1E-4
3,test_20231101_135138,10188041.png,221231,9489,211742,0.9571081810415357,1,3,41731,1337,40394,0.967961467494189,10.60381511111111,1029.055584,18.006415272400552,127,1.1E-4
4,test_20231101_135138,10287332.png,216980,12312,204668,0.9432574430823117,2,3,22337,1688,20649,0.9244303174105744,9.401898666666666,774.2090986666667,19.242220899357278,127,1.1E-4
5,test_20231101_135138,11610969.png,368720,24512,344208,0.9335213712302017,2,4,84111,3579,80532,0.9574490851374968,21.428912,2970.4620213333333,13.402563567661467,127,1.1E-4
6,test_20231101_135138,10350842.png,212614,5842,206772,0.9725229759093945,2,3,42529,859,41670,0.9798020174469185,19.341116444444445,2392.76384,14.341805239536118,127,1.1E-4
7,test_20231101_135138,10863862.png,317432,11017,306415,0.9652933541671918,2,3,66058,1602,64456,0.9757485845771897,24.437365333333332,3426.7552746666665,12.781972709279499,127,1.1E-4
8,test_20231101_135138,11382381.png,312486,957,311529,0.9969374627983334,1,3,46745,131,46614,0.9971975612364958,21.075297777777777,2410.7878986666665,14.309213580767988,127,1.1E-4
9,test_20231101_135138,11079715.png,443815,115577,328238,0.7395829343307458,3,4,124136,16143,107993,0.8699571437777921,17.25776711111111,2193.2968,14.719829558750817,127,1.1E-4
10,test_20231101_135138,11551286.png,271883,917,270966,0.9966272256816351,1,4,40092,134,39958,0.9966576873191659,15.986103111111111,1528.055536,16.289412222433906,127,1.1E-4
1,test_20231101_135139,10404007.png,502730,19649,483081,0.9609154019055954,2,3,61265,2845,58420,0.9535623928833755,25.79059377777778,3461.428794666667,12.738249587356849,127,1.2E-4
2,test_20231101_135139,1254659.png,342646,71682,270964,0.7907986668456658,3,4,80080,10037,70043,0.8746628371628371,21.233608888888888,3282.5188533333335,12.968731317042248,127,1.2E-4
3,test_20231101_135139,10188041.png,221231,9489,211742,0.9571081810415357,2,4,41731,1337,40394,0.967961467494189,10.60381511111111,1029.055584,18.006415272400552,127,1.2E-4
4,test_20231101_135139,10287332.png,216980,12312,204668,0.9432574430823117,2,3,22337,1688,20649,0.9244303174105744,9.401898666666666,774.2090986666667,19.242220899357278,127,1.2E-4
5,test_20231101_135139,11610969.png,368720,24512,344208,0.9335213712302017,2,3,84111,3579,80532,0.9574490851374968,21.428912,2970.4620213333333,13.402563567661467,127,1.2E-4
6,test_20231101_135139,10350842.png,212614,5842,206772,0.9725229759093945,1,3,42529,859,41670,0.9798020174469185,19.341116444444445,2392.76384,14.341805239536118,127,1.2E-4
7,test_20231101_135139,10863862.png,317432,11017,306415,0.9652933541671918,2,4,66058,1602,64456,0.9757485845771897,24.437365333333332,3426.7552746666665,12.781972709279499,127,1.2E-4
8,test_20231101_135139,11382381.png,312486,957,311529,0.9969374627983334,2,4,46745,131,46614,0.9971975612364958,21.075297777777777,2410.7878986666665,14.309213580767988,127,1.2E-4
9,test_20231101_135139,11079715.png,443815,115577,328238,0.7395829343307458,3,4,124136,16143,107993,0.8699571437777921,17.25776711111111,2193.2968,14.719829558750817,127,1.2E-4
10,test_20231101_135139,11551286.png,271883,917,270966,0.9966272256816351,2,4,40092,134,39958,0.9966576873191659,15.986103111111111,1528.055536,16.289412222433906,127,1.2E-4
1,test_20231101_135139,10404007.png,502730,19649,483081,0.9609154019055954,2,3,61265,2845,58420,0.9535623928833755,25.79059377777778,3461.428794666667,12.738249587356849,127,1.3000000000000002E-4
2,test_20231101_135139,1254659.png,342646,71682,270964,0.7907986668456658,2,4,80080,10037,70043,0.8746628371628371,21.233608888888888,3282.5188533333335,12.968731317042248,127,1.3000000000000002E-4
3,test_20231101_135139,10188041.png,221231,9489,211742,0.9571081810415357,2,3,41731,1337,40394,0.967961467494189,10.60381511111111,1029.055584,18.006415272400552,127,1.3000000000000002E-4
4,test_20231101_135139,10287332.png,216980,12312,204668,0.9432574430823117,2,4,22337,1688,20649,0.9244303174105744,9.401898666666666,774.2090986666667,19.242220899357278,127,1.3000000000000002E-4
5,test_20231101_135139,11610969.png,368720,24512,344208,0.9335213712302017,2,3,84111,3579,80532,0.9574490851374968,21.428912,2970.4620213333333,13.402563567661467,127,1.3000000000000002E-4
6,test_20231101_135139,10350842.png,212614,5842,206772,0.9725229759093945,2,4,42529,859,41670,0.9798020174469185,19.341116444444445,2392.76384,14.341805239536118,127,1.3000000000000002E-4
7,test_20231101_135139,10863862.png,317432,11017,306415,0.9652933541671918,2,4,66058,1602,64456,0.9757485845771897,24.437365333333332,3426.7552746666665,12.781972709279499,127,1.3000000000000002E-4
8,test_20231101_135139,11382381.png,312486,957,311529,0.9969374627983334,2,4,46745,131,46614,0.9971975612364958,21.075297777777777,2410.7878986666665,14.309213580767988,127,1.3000000000000002E-4
9,test_20231101_135139,11079715.png,443815,115577,328238,0.7395829343307458,4,5,124136,16143,107993,0.8699571437777921,17.25776711111111,2193.2968,14.719829558750817,127,1.3000000000000002E-4
10,test_20231101_135139,11551286.png,271883,817,271066,0.9969950309508134,2,3,40092,119,39973,0.9970318267983638,17.022202666666665,1715.7899786666667,15.786162339334698,127,1.3000000000000002E-4
1,test_20231101_135140,10404007.png,502730,19649,483081,0.9609154019055954,2,4,61265,2845,58420,0.9535623928833755,25.79059377777778,3461.428794666667,12.738249587356849,127,1.4000000000000001E-4
2,test_20231101_135140,1254659.png,342646,71682,270964,0.7907986668456658,3,4,80080,10037,70043,0.8746628371628371,21.233608888888888,3282.5188533333335,12.968731317042248,127,1.4000000000000001E-4
3,test_20231101_135140,10188041.png,221231,9489,211742,0.9571081810415357,2,4,41731,1337,40394,0.967961467494189,10.60381511111111,1029.055584,18.006415272400552,127,1.4000000000000001E-4
4,test_20231101_135140,10287332.png,216980,12312,204668,0.9432574430823117,2,4,22337,1688,20649,0.9244303174105744,9.401898666666666,774.2090986666667,19.242220899357278,127,1.4000000000000001E-4
5,test_20231101_135140,11610969.png,368720,24512,344208,0.9335213712302017,3,4,84111,3579,80532,0.9574490851374968,21.428912,2970.4620213333333,13.402563567661467,127,1.4000000000000001E-4
6,test_20231101_135140,10350842.png,212614,5842,206772,0.9725229759093945,2,4,42529,859,41670,0.9798020174469185,19.341116444444445,2392.76384,14.341805239536118,127,1.4000000000000001E-4
7,test_20231101_135140,10863862.png,317432,11017,306415,0.9652933541671918,2,3,66058,1602,64456,0.9757485845771897,24.437365333333332,3426.7552746666665,12.781972709279499,127,1.4000000000000001E-4
8,test_20231101_135140,11382381.png,312486,957,311529,0.9969374627983334,2,4,46745,131,46614,0.9971975612364958,21.075297777777777,2410.7878986666665,14.309213580767988,127,1.4000000000000001E-4
9,test_20231101_135140,11079715.png,443815,115577,328238,0.7395829343307458,3,4,124136,16143,107993,0.8699571437777921,17.25776711111111,2193.2968,14.719829558750817,127,1.4000000000000001E-4
10,test_20231101_135140,11551286.png,271883,817,271066,0.9969950309508134,2,4,40092,119,39973,0.9970318267983638,17.022202666666665,1715.7899786666667,15.786162339334698,127,1.4000000000000001E-4
1,test_20231101_135141,10404007.png,502730,19649,483081,0.9609154019055954,2,4,61265,2845,58420,0.9535623928833755,25.79059377777778,3461.428794666667,12.738249587356849,127,1.5000000000000001E-4
2,test_20231101_135141,1254659.png,342646,71682,270964,0.7907986668456658,3,4,80080,10037,70043,0.8746628371628371,21.233608888888888,3282.5188533333335,12.968731317042248,127,1.5000000000000001E-4
3,test_20231101_135141,10188041.png,221231,9489,211742,0.9571081810415357,2,4,41731,1337,40394,0.967961467494189,10.60381511111111,1029.055584,18.006415272400552,127,1.5000000000000001E-4
4,test_20231101_135141,10287332.png,216980,12312,204668,0.9432574430823117,2,3,22337,1688,20649,0.9244303174105744,9.401898666666666,774.2090986666667,19.242220899357278,127,1.5000000000000001E-4
5,test_20231101_135141,11610969.png,368720,24512,344208,0.9335213712302017,2,3,84111,3579,80532,0.9574490851374968,21.428912,2970.4620213333333,13.402563567661467,127,1.5000000000000001E-4
6,test_20231101_135141,10350842.png,212614,5842,206772,0.9725229759093945,2,3,42529,859,41670,0.9798020174469185,19.341116444444445,2392.76384,14.341805239536118,127,1.5000000000000001E-4
7,test_20231101_135141,10863862.png,317432,11017,306415,0.9652933541671918,2,4,66058,1602,64456,0.9757485845771897,24.437365333333332,3426.7552746666665,12.781972709279499,127,1.5000000000000001E-4
8,test_20231101_135141,11382381.png,312486,827,311659,0.9973534814359684,2,4,46745,112,46633,0.9976040218205156,21.333713777777778,2451.331146666667,14.236783774592807,127,1.5000000000000001E-4
9,test_20231101_135141,11079715.png,443815,115577,328238,0.7395829343307458,4,4,124136,16143,107993,0.8699571437777921,17.25776711111111,2193.2968,14.719829558750817,127,1.5000000000000001E-4
10,test_20231101_135141,11551286.png,271883,817,271066,0.9969950309508134,1,3,40092,119,39973,0.9970318267983638,17.022202666666665,1715.7899786666667,15.786162339334698,127,1.5000000000000001E-4
1,test_20231101_135141,10404007.png,502730,19649,483081,0.9609154019055954,2,4,61265,2845,58420,0.9535623928833755,25.79059377777778,3461.428794666667,12.738249587356849,127,1.6E-4
2,test_20231101_135141,1254659.png,342646,71682,270964,0.7907986668456658,2,3,80080,10037,70043,0.8746628371628371,21.233608888888888,3282.5188533333335,12.968731317042248,127,1.6E-4
3,test_20231101_135141,10188041.png,221231,9489,211742,0.9571081810415357,2,13,41731,1337,40394,0.967961467494189,10.60381511111111,1029.055584,18.006415272400552,127,1.6E-4
4,test_20231101_135141,10287332.png,216980,12102,204878,0.944225274218822,2,4,22337,1661,20676,0.9256390741818508,9.531660444444444,800.9398453333333,19.09480461289071,127,1.6E-4
5,test_20231101_135141,11610969.png,368720,24512,344208,0.9335213712302017,3,3,84111,3579,80532,0.9574490851374968,21.428912,2970.4620213333333,13.402563567661467,127,1.6E-4
6,test_20231101_135141,10350842.png,212614,5842,206772,0.9725229759093945,1,3,42529,859,41670,0.9798020174469185,19.341116444444445,2392.76384,14.341805239536118,127,1.6E-4
7,test_20231101_135141,10863862.png,317432,11017,306415,0.9652933541671918,2,4,66058,1602,64456,0.9757485845771897,24.437365333333332,3426.7552746666665,12.781972709279499,127,1.6E-4
8,test_20231101_135141,11382381.png,312486,827,311659,0.9973534814359684,1,4,46745,112,46633,0.9976040218205156,21.333713777777778,2451.331146666667,14.236783774592807,127,1.6E-4
9,test_20231101_135141,11079715.png,443815,115577,328238,0.7395829343307458,4,4,124136,16143,107993,0.8699571437777921,17.25776711111111,2193.2968,14.719829558750817,127,1.6E-4
10,test_20231101_135141,11551286.png,271883,817,271066,0.9969950309508134,2,4,40092,119,39973,0.9970318267983638,17.022202666666665,1715.7899786666667,15.786162339334698,127,1.6E-4
1,test_20231101_135142,10404007.png,502730,19649,483081,0.9609154019055954,3,3,61265,2845,58420,0.9535623928833755,25.79059377777778,3461.428794666667,12.738249587356849,127,1.7E-4
2,test_20231101_135142,1254659.png,342646,71682,270964,0.7907986668456658,3,4,80080,10037,70043,0.8746628371628371,21.233608888888888,3282.5188533333335,12.968731317042248,127,1.7E-4
3,test_20231101_135142,10188041.png,221231,9489,211742,0.9571081810415357,2,4,41731,1337,40394,0.967961467494189,10.60381511111111,1029.055584,18.006415272400552,127,1.7E-4
4,test_20231101_135142,10287332.png,216980,12102,204878,0.944225274218822,1,4,22337,1661,20676,0.9256390741818508,9.531660444444444,800.9398453333333,19.09480461289071,127,1.7E-4
5,test_20231101_135142,11610969.png,368720,24512,344208,0.9335213712302017,2,4,84111,3579,80532,0.9574490851374968,21.428912,2970.4620213333333,13.402563567661467,127,1.7E-4
6,test_20231101_135142,10350842.png,212614,5842,206772,0.9725229759093945,1,3,42529,859,41670,0.9798020174469185,19.341116444444445,2392.76384,14.341805239536118,127,1.7E-4
7,test_20231101_135142,10863862.png,317432,11017,306415,0.9652933541671918,2,4,66058,1602,64456,0.9757485845771897,24.437365333333332,3426.7552746666665,12.781972709279499,127,1.7E-4
8,test_20231101_135142,11382381.png,312486,827,311659,0.9973534814359684,1,3,46745,112,46633,0.9976040218205156,21.333713777777778,2451.331146666667,14.236783774592807,127,1.7E-4
9,test_20231101_135142,11079715.png,443815,115577,328238,0.7395829343307458,3,4,124136,16143,107993,0.8699571437777921,17.25776711111111,2193.2968,14.719829558750817,127,1.7E-4
10,test_20231101_135142,11551286.png,271883,817,271066,0.9969950309508134,2,3,40092,119,39973,0.9970318267983638,17.022202666666665,1715.7899786666667,15.786162339334698,127,1.7E-4
1,test_20231101_135143,10404007.png,502730,19649,483081,0.9609154019055954,2,4,61265,2845,58420,0.9535623928833755,25.79059377777778,3461.428794666667,12.738249587356849,127,1.8E-4
2,test_20231101_135143,1254659.png,342646,71682,270964,0.7907986668456658,3,4,80080,10037,70043,0.8746628371628371,21.233608888888888,3282.5188533333335,12.968731317042248,127,1.8E-4
3,test_20231101_135143,10188041.png,221231,9489,211742,0.9571081810415357,2,4,41731,1337,40394,0.967961467494189,10.60381511111111,1029.055584,18.006415272400552,127,1.8E-4
4,test_20231101_135143,10287332.png,216980,12102,204878,0.944225274218822,2,3,22337,1661,20676,0.9256390741818508,9.531660444444444,800.9398453333333,19.09480461289071,127,1.8E-4
5,test_20231101_135143,11610969.png,368720,24512,344208,0.9335213712302017,3,4,84111,3579,80532,0.9574490851374968,21.428912,2970.4620213333333,13.402563567661467,127,1.8E-4
6,test_20231101_135143,10350842.png,212614,5842,206772,0.9725229759093945,2,3,42529,859,41670,0.9798020174469185,19.341116444444445,2392.76384,14.341805239536118,127,1.8E-4
7,test_20231101_135143,10863862.png,317432,11017,306415,0.9652933541671918,1,3,66058,1602,64456,0.9757485845771897,24.437365333333332,3426.7552746666665,12.781972709279499,127,1.8E-4
8,test_20231101_135143,11382381.png,312486,827,311659,0.9973534814359684,2,3,46745,112,46633,0.9976040218205156,21.333713777777778,2451.331146666667,14.236783774592807,127,1.8E-4
9,test_20231101_135143,11079715.png,443815,115577,328238,0.7395829343307458,4,5,124136,16143,107993,0.8699571437777921,17.25776711111111,2193.2968,14.719829558750817,127,1.8E-4
10,test_20231101_135143,11551286.png,271883,817,271066,0.9969950309508134,2,4,40092,119,39973,0.9970318267983638,17.022202666666665,1715.7899786666667,15.786162339334698,127,1.8E-4
1,test_20231101_135143,10404007.png,502730,19649,483081,0.9609154019055954,2,4,61265,2845,58420,0.9535623928833755,25.79059377777778,3461.428794666667,12.738249587356849,127,1.9E-4
2,test_20231101_135143,1254659.png,342646,71682,270964,0.7907986668456658,3,3,80080,10037,70043,0.8746628371628371,21.233608888888888,3282.5188533333335,12.968731317042248,127,1.9E-4
3,test_20231101_135143,10188041.png,221231,9489,211742,0.9571081810415357,2,4,41731,1337,40394,0.967961467494189,10.60381511111111,1029.055584,18.006415272400552,127,1.9E-4
4,test_20231101_135143,10287332.png,216980,12102,204878,0.944225274218822,1,3,22337,1661,20676,0.9256390741818508,9.531660444444444,800.9398453333333,19.09480461289071,127,1.9E-4
5,test_20231101_135143,11610969.png,368720,24512,344208,0.9335213712302017,2,4,84111,3579,80532,0.9574490851374968,21.428912,2970.4620213333333,13.402563567661467,127,1.9E-4
6,test_20231101_135143,10350842.png,212614,5842,206772,0.9725229759093945,2,4,42529,859,41670,0.9798020174469185,19.341116444444445,2392.76384,14.341805239536118,127,1.9E-4
7,test_20231101_135143,10863862.png,317432,11017,306415,0.9652933541671918,1,3,66058,1602,64456,0.9757485845771897,24.437365333333332,3426.7552746666665,12.781972709279499,127,1.9E-4
8,test_20231101_135143,11382381.png,312486,827,311659,0.9973534814359684,2,4,46745,112,46633,0.9976040218205156,21.333713777777778,2451.331146666667,14.236783774592807,127,1.9E-4
9,test_20231101_135143,11079715.png,443815,115577,328238,0.7395829343307458,3,4,124136,16143,107993,0.8699571437777921,17.25776711111111,2193.2968,14.719829558750817,127,1.9E-4
10,test_20231101_135143,11551286.png,271883,817,271066,0.9969950309508134,1,4,40092,119,39973,0.9970318267983638,17.022202666666665,1715.7899786666667,15.786162339334698,127,1.9E-4
1,test_20231101_135144,10404007.png,502730,19649,483081,0.9609154019055954,3,4,61265,2845,58420,0.9535623928833755,25.79059377777778,3461.428794666667,12.738249587356849,127,2.0E-4
2,test_20231101_135144,1254659.png,342646,71682,270964,0.7907986668456658,3,4,80080,10037,70043,0.8746628371628371,21.233608888888888,3282.5188533333335,12.968731317042248,127,2.0E-4
3,test_20231101_135144,10188041.png,221231,9489,211742,0.9571081810415357,2,3,41731,1337,40394,0.967961467494189,10.60381511111111,1029.055584,18.006415272400552,127,2.0E-4
4,test_20231101_135144,10287332.png,216980,12102,204878,0.944225274218822,1,3,22337,1661,20676,0.9256390741818508,9.531660444444444,800.9398453333333,19.09480461289071,127,2.0E-4
5,test_20231101_135144,11610969.png,368720,24512,344208,0.9335213712302017,2,4,84111,3579,80532,0.9574490851374968,21.428912,2970.4620213333333,13.402563567661467,127,2.0E-4
6,test_20231101_135144,10350842.png,212614,5842,206772,0.9725229759093945,1,4,42529,859,41670,0.9798020174469185,19.341116444444445,2392.76384,14.341805239536118,127,2.0E-4
7,test_20231101_135144,10863862.png,317432,11017,306415,0.9652933541671918,2,4,66058,1602,64456,0.9757485845771897,24.437365333333332,3426.7552746666665,12.781972709279499,127,2.0E-4
8,test_20231101_135144,11382381.png,312486,827,311659,0.9973534814359684,2,4,46745,112,46633,0.9976040218205156,21.333713777777778,2451.331146666667,14.236783774592807,127,2.0E-4
9,test_20231101_135144,11079715.png,443815,115577,328238,0.7395829343307458,3,4,124136,16143,107993,0.8699571437777921,17.25776711111111,2193.2968,14.719829558750817,127,2.0E-4
10,test_20231101_135144,11551286.png,271883,697,271186,0.9974363972738274,1,3,40092,101,39991,0.9974807941734012,17.572291555555555,1811.64304,15.55007731009529,127,2.0E-4
1,test_20231101_135145,10404007.png,502730,19649,483081,0.9609154019055954,2,4,61265,2845,58420,0.9535623928833755,25.79059377777778,3461.428794666667,12.738249587356849,127,2.1E-4
2,test_20231101_135145,1254659.png,342646,71682,270964,0.7907986668456658,5,4,80080,10037,70043,0.8746628371628371,21.233608888888888,3282.5188533333335,12.968731317042248,127,2.1E-4
3,test_20231101_135145,10188041.png,221231,9489,211742,0.9571081810415357,1,4,41731,1337,40394,0.967961467494189,10.60381511111111,1029.055584,18.006415272400552,127,2.1E-4
4,test_20231101_135145,10287332.png,216980,12102,204878,0.944225274218822,2,3,22337,1661,20676,0.9256390741818508,9.531660444444444,800.9398453333333,19.09480461289071,127,2.1E-4
5,test_20231101_135145,11610969.png,368720,24512,344208,0.9335213712302017,2,6,84111,3579,80532,0.9574490851374968,21.428912,2970.4620213333333,13.402563567661467,127,2.1E-4
6,test_20231101_135145,10350842.png,212614,5842,206772,0.9725229759093945,2,4,42529,859,41670,0.9798020174469185,19.341116444444445,2392.76384,14.341805239536118,127,2.1E-4
7,test_20231101_135145,10863862.png,317432,11017,306415,0.9652933541671918,2,3,66058,1602,64456,0.9757485845771897,24.437365333333332,3426.7552746666665,12.781972709279499,127,2.1E-4
8,test_20231101_135145,11382381.png,312486,827,311659,0.9973534814359684,1,4,46745,112,46633,0.9976040218205156,21.333713777777778,2451.331146666667,14.236783774592807,127,2.1E-4
9,test_20231101_135145,11079715.png,443815,115577,328238,0.7395829343307458,3,4,124136,16143,107993,0.8699571437777921,17.25776711111111,2193.2968,14.719829558750817,127,2.1E-4
10,test_20231101_135145,11551286.png,271883,697,271186,0.9974363972738274,2,3,40092,101,39991,0.9974807941734012,17.572291555555555,1811.64304,15.55007731009529,127,2.1E-4
1,test_20231101_135146,10404007.png,502730,19649,483081,0.9609154019055954,3,4,61265,2845,58420,0.9535623928833755,25.79059377777778,3461.428794666667,12.738249587356849,127,2.2E-4
2,test_20231101_135146,1254659.png,342646,71682,270964,0.7907986668456658,3,4,80080,10037,70043,0.8746628371628371,21.233608888888888,3282.5188533333335,12.968731317042248,127,2.2E-4
3,test_20231101_135146,10188041.png,221231,9489,211742,0.9571081810415357,2,4,41731,1337,40394,0.967961467494189,10.60381511111111,1029.055584,18.006415272400552,127,2.2E-4
4,test_20231101_135146,10287332.png,216980,12102,204878,0.944225274218822,2,3,22337,1661,20676,0.9256390741818508,9.531660444444444,800.9398453333333,19.09480461289071,127,2.2E-4
5,test_20231101_135146,11610969.png,368720,24512,344208,0.9335213712302017,2,4,84111,3579,80532,0.9574490851374968,21.428912,2970.4620213333333,13.402563567661467,127,2.2E-4
6,test_20231101_135146,10350842.png,212614,5842,206772,0.9725229759093945,1,4,42529,859,41670,0.9798020174469185,19.341116444444445,2392.76384,14.341805239536118,127,2.2E-4
7,test_20231101_135146,10863862.png,317432,11017,306415,0.9652933541671918,2,4,66058,1602,64456,0.9757485845771897,24.437365333333332,3426.7552746666665,12.781972709279499,127,2.2E-4
8,test_20231101_135146,11382381.png,312486,827,311659,0.9973534814359684,2,4,46745,112,46633,0.9976040218205156,21.333713777777778,2451.331146666667,14.236783774592807,127,2.2E-4
9,test_20231101_135146,11079715.png,443815,115577,328238,0.7395829343307458,4,4,124136,16143,107993,0.8699571437777921,17.25776711111111,2193.2968,14.719829558750817,127,2.2E-4
10,test_20231101_135146,11551286.png,271883,697,271186,0.9974363972738274,1,4,40092,101,39991,0.9974807941734012,17.572291555555555,1811.64304,15.55007731009529,127,2.2E-4
1,test_20231101_135146,10404007.png,502730,19649,483081,0.9609154019055954,2,3,61265,2845,58420,0.9535623928833755,25.79059377777778,3461.428794666667,12.738249587356849,127,2.3E-4
2,test_20231101_135146,1254659.png,342646,71682,270964,0.7907986668456658,3,4,80080,10037,70043,0.8746628371628371,21.233608888888888,3282.5188533333335,12.968731317042248,127,2.3E-4
3,test_20231101_135146,10188041.png,221231,9489,211742,0.9571081810415357,2,5,41731,1337,40394,0.967961467494189,10.60381511111111,1029.055584,18.006415272400552,127,2.3E-4
4,test_20231101_135146,10287332.png,216980,12102,204878,0.944225274218822,2,4,22337,1661,20676,0.9256390741818508,9.531660444444444,800.9398453333333,19.09480461289071,127,2.3E-4
5,test_20231101_135146,11610969.png,368720,24512,344208,0.9335213712302017,2,4,84111,3579,80532,0.9574490851374968,21.428912,2970.4620213333333,13.402563567661467,127,2.3E-4
6,test_20231101_135146,10350842.png,212614,5842,206772,0.9725229759093945,2,4,42529,859,41670,0.9798020174469185,19.341116444444445,2392.76384,14.341805239536118,127,2.3E-4
7,test_20231101_135146,10863862.png,317432,11017,306415,0.9652933541671918,2,3,66058,1602,64456,0.9757485845771897,24.437365333333332,3426.7552746666665,12.781972709279499,127,2.3E-4
8,test_20231101_135146,11382381.png,312486,827,311659,0.9973534814359684,1,4,46745,112,46633,0.9976040218205156,21.333713777777778,2451.331146666667,14.236783774592807,127,2.3E-4
9,test_20231101_135146,11079715.png,443815,115577,328238,0.7395829343307458,3,4,124136,16143,107993,0.8699571437777921,17.25776711111111,2193.2968,14.719829558750817,127,2.3E-4
10,test_20231101_135146,11551286.png,271883,697,271186,0.9974363972738274,1,4,40092,101,39991,0.9974807941734012,17.572291555555555,1811.64304,15.55007731009529,127,2.3E-4
1,test_20231101_135147,10404007.png,502730,19649,483081,0.9609154019055954,2,3,61265,2845,58420,0.9535623928833755,25.79059377777778,3461.428794666667,12.738249587356849,127,2.4E-4
2,test_20231101_135147,1254659.png,342646,71682,270964,0.7907986668456658,3,4,80080,10037,70043,0.8746628371628371,21.233608888888888,3282.5188533333335,12.968731317042248,127,2.4E-4
3,test_20231101_135147,10188041.png,221231,9489,211742,0.9571081810415357,2,4,41731,1337,40394,0.967961467494189,10.60381511111111,1029.055584,18.006415272400552,127,2.4E-4
4,test_20231101_135147,10287332.png,216980,12102,204878,0.944225274218822,1,4,22337,1661,20676,0.9256390741818508,9.531660444444444,800.9398453333333,19.09480461289071,127,2.4E-4
5,test_20231101_135147,11610969.png,368720,24512,344208,0.9335213712302017,2,4,84111,3579,80532,0.9574490851374968,21.428912,2970.4620213333333,13.402563567661467,127,2.4E-4
6,test_20231101_135147,10350842.png,212614,5842,206772,0.9725229759093945,1,3,42529,859,41670,0.9798020174469185,19.341116444444445,2392.76384,14.341805239536118,127,2.4E-4
7,test_20231101_135147,10863862.png,317432,11017,306415,0.9652933541671918,2,4,66058,1602,64456,0.9757485845771897,24.437365333333332,3426.7552746666665,12.781972709279499,127,2.4E-4
8,test_20231101_135147,11382381.png,312486,827,311659,0.9973534814359684,1,4,46745,112,46633,0.9976040218205156,21.333713777777778,2451.331146666667,14.236783774592807,127,2.4E-4
9,test_20231101_135147,11079715.png,443815,115577,328238,0.7395829343307458,3,6,124136,16143,107993,0.8699571437777921,17.25776711111111,2193.2968,14.719829558750817,127,2.4E-4
10,test_20231101_135147,11551286.png,271883,697,271186,0.9974363972738274,2,3,40092,101,39991,0.9974807941734012,17.572291555555555,1811.64304,15.55007731009529,127,2.4E-4
1,test_20231101_135148,10404007.png,502730,19649,483081,0.9609154019055954,3,4,61265,2845,58420,0.9535623928833755,25.79059377777778,3461.428794666667,12.738249587356849,127,2.5E-4
2,test_20231101_135148,1254659.png,342646,71682,270964,0.7907986668456658,4,4,80080,10037,70043,0.8746628371628371,21.233608888888888,3282.5188533333335,12.968731317042248,127,2.5E-4
3,test_20231101_135148,10188041.png,221231,9489,211742,0.9571081810415357,2,3,41731,1337,40394,0.967961467494189,10.60381511111111,1029.055584,18.006415272400552,127,2.5E-4
4,test_20231101_135148,10287332.png,216980,12102,204878,0.944225274218822,1,3,22337,1661,20676,0.9256390741818508,9.531660444444444,800.9398453333333,19.09480461289071,127,2.5E-4
5,test_20231101_135148,11610969.png,368720,24512,344208,0.9335213712302017,2,3,84111,3579,80532,0.9574490851374968,21.428912,2970.4620213333333,13.402563567661467,127,2.5E-4
6,test_20231101_135148,10350842.png,212614,5842,206772,0.9725229759093945,1,4,42529,859,41670,0.9798020174469185,19.341116444444445,2392.76384,14.341805239536118,127,2.5E-4
7,test_20231101_135148,10863862.png,317432,11017,306415,0.9652933541671918,2,3,66058,1602,64456,0.9757485845771897,24.437365333333332,3426.7552746666665,12.781972709279499,127,2.5E-4
8,test_20231101_135148,11382381.png,312486,827,311659,0.9973534814359684,2,4,46745,112,46633,0.9976040218205156,21.333713777777778,2451.331146666667,14.236783774592807,127,2.5E-4
9,test_20231101_135148,11079715.png,443815,115577,328238,0.7395829343307458,3,4,124136,16143,107993,0.8699571437777921,17.25776711111111,2193.2968,14.719829558750817,127,2.5E-4
10,test_20231101_135148,11551286.png,271883,697,271186,0.9974363972738274,1,4,40092,101,39991,0.9974807941734012,17.572291555555555,1811.64304,15.55007731009529,127,2.5E-4
1,test_20231101_135148,10404007.png,502730,19467,483263,0.9612774252580908,2,4,61265,2821,58444,0.9539541336815474,25.804821333333333,3464.2128746666667,12.734757894589483,127,2.6000000000000003E-4
2,test_20231101_135148,1254659.png,342646,71622,271024,0.7909737746829089,3,4,80080,10031,70049,0.8747377622377622,21.243162666666667,3283.60104,12.96729976321864,127,2.6000000000000003E-4
3,test_20231101_135148,10188041.png,221231,9449,211782,0.9572889875288726,2,4,41731,1331,40400,0.9681052455009466,10.71383111111111,1042.626304,17.949516834977533,127,2.6000000000000003E-4
4,test_20231101_135148,10287332.png,216980,12102,204878,0.944225274218822,1,5,22337,1661,20676,0.9256390741818508,9.531660444444444,800.9398453333333,19.09480461289071,127,2.6000000000000003E-4
5,test_20231101_135148,11610969.png,368720,24192,344528,0.9343892384465177,2,4,84111,3533,80578,0.957995981500636,21.846828444444444,3056.5311093333335,13.278515404761055,127,2.6000000000000003E-4
6,test_20231101_135148,10350842.png,212614,5762,206852,0.9728992446405222,2,3,42529,847,41682,0.9800841778551106,19.409909333333335,2398.521546666667,14.33136736645771,127,2.6000000000000003E-4
7,test_20231101_135148,10863862.png,317432,10897,306535,0.9656713878877996,2,4,66058,1584,64474,0.9760210723909292,24.488522666666668,3430.0665386666665,12.77777816015962,127,2.6000000000000003E-4
8,test_20231101_135148,11382381.png,312486,707,311779,0.9977374986399391,1,4,46745,94,46651,0.9979890897422184,21.82824,2521.273456,14.11460409284577,127,2.6000000000000003E-4
9,test_20231101_135148,11079715.png,443815,115577,328238,0.7395829343307458,4,4,124136,16143,107993,0.8699571437777921,17.25776711111111,2193.2968,14.719829558750817,127,2.6000000000000003E-4
10,test_20231101_135148,11551286.png,271883,697,271186,0.9974363972738274,2,4,40092,101,39991,0.9974807941734012,17.572291555555555,1811.64304,15.55007731009529,127,2.6000000000000003E-4
1,test_20231101_135149,10404007.png,502730,19467,483263,0.9612774252580908,2,10,61265,2821,58444,0.9539541336815474,25.804821333333333,3464.2128746666667,12.734757894589483,127,2.7000000000000006E-4
2,test_20231101_135149,1254659.png,342646,71622,271024,0.7909737746829089,3,4,80080,10031,70049,0.8747377622377622,21.243162666666667,3283.60104,12.96729976321864,127,2.7000000000000006E-4
3,test_20231101_135149,10188041.png,221231,9449,211782,0.9572889875288726,1,3,41731,1331,40400,0.9681052455009466,10.71383111111111,1042.626304,17.949516834977533,127,2.7000000000000006E-4
4,test_20231101_135149,10287332.png,216980,12102,204878,0.944225274218822,1,3,22337,1661,20676,0.9256390741818508,9.531660444444444,800.9398453333333,19.09480461289071,127,2.7000000000000006E-4
5,test_20231101_135149,11610969.png,368720,24192,344528,0.9343892384465177,2,4,84111,3533,80578,0.957995981500636,21.846828444444444,3056.5311093333335,13.278515404761055,127,2.7000000000000006E-4
6,test_20231101_135149,10350842.png,212614,5762,206852,0.9728992446405222,1,3,42529,847,41682,0.9800841778551106,19.409909333333335,2398.521546666667,14.33136736645771,127,2.7000000000000006E-4
7,test_20231101_135149,10863862.png,317432,10897,306535,0.9656713878877996,2,4,66058,1584,64474,0.9760210723909292,24.488522666666668,3430.0665386666665,12.77777816015962,127,2.7000000000000006E-4
8,test_20231101_135149,11382381.png,312486,707,311779,0.9977374986399391,2,4,46745,94,46651,0.9979890897422184,21.82824,2521.273456,14.11460409284577,127,2.7000000000000006E-4
9,test_20231101_135149,11079715.png,443815,115577,328238,0.7395829343307458,4,9,124136,16143,107993,0.8699571437777921,17.25776711111111,2193.2968,14.719829558750817,127,2.7000000000000006E-4
10,test_20231101_135149,11551286.png,271883,697,271186,0.9974363972738274,2,3,40092,101,39991,0.9974807941734012,17.572291555555555,1811.64304,15.55007731009529,127,2.7000000000000006E-4
1,test_20231101_135150,10404007.png,502730,19467,483263,0.9612774252580908,2,4,61265,2821,58444,0.9539541336815474,25.804821333333333,3464.2128746666667,12.734757894589483,127,2.800000000000001E-4
2,test_20231101_135150,1254659.png,342646,71622,271024,0.7909737746829089,2,3,80080,10031,70049,0.8747377622377622,21.243162666666667,3283.60104,12.96729976321864,127,2.800000000000001E-4
3,test_20231101_135150,10188041.png,221231,9449,211782,0.9572889875288726,2,11,41731,1331,40400,0.9681052455009466,10.71383111111111,1042.626304,17.949516834977533,127,2.800000000000001E-4
4,test_20231101_135150,10287332.png,216980,12102,204878,0.944225274218822,1,3,22337,1661,20676,0.9256390741818508,9.531660444444444,800.9398453333333,19.09480461289071,127,2.800000000000001E-4
5,test_20231101_135150,11610969.png,368720,24192,344528,0.9343892384465177,2,4,84111,3533,80578,0.957995981500636,21.846828444444444,3056.5311093333335,13.278515404761055,127,2.800000000000001E-4
6,test_20231101_135150,10350842.png,212614,5762,206852,0.9728992446405222,1,4,42529,847,41682,0.9800841778551106,19.409909333333335,2398.521546666667,14.33136736645771,127,2.800000000000001E-4
7,test_20231101_135150,10863862.png,317432,10897,306535,0.9656713878877996,2,4,66058,1584,64474,0.9760210723909292,24.488522666666668,3430.0665386666665,12.77777816015962,127,2.800000000000001E-4
8,test_20231101_135150,11382381.png,312486,707,311779,0.9977374986399391,2,4,46745,94,46651,0.9979890897422184,21.82824,2521.273456,14.11460409284577,127,2.800000000000001E-4
9,test_20231101_135150,11079715.png,443815,115577,328238,0.7395829343307458,3,5,124136,16143,107993,0.8699571437777921,17.25776711111111,2193.2968,14.719829558750817,127,2.800000000000001E-4
10,test_20231101_135150,11551286.png,271883,407,271476,0.9985030325544444,2,3,40092,58,40034,0.9985533273471017,17.855009777777777,1855.9584906666666,15.44512102064812,127,2.800000000000001E-4
1,test_20231101_135150,10404007.png,502730,19467,483263,0.9612774252580908,2,3,61265,2821,58444,0.9539541336815474,25.804821333333333,3464.2128746666667,12.734757894589483,127,2.900000000000001E-4
2,test_20231101_135150,1254659.png,342646,71622,271024,0.7909737746829089,3,11,80080,10031,70049,0.8747377622377622,21.243162666666667,3283.60104,12.96729976321864,127,2.900000000000001E-4
3,test_20231101_135150,10188041.png,221231,9449,211782,0.9572889875288726,2,4,41731,1331,40400,0.9681052455009466,10.71383111111111,1042.626304,17.949516834977533,127,2.900000000000001E-4
4,test_20231101_135150,10287332.png,216980,12102,204878,0.944225274218822,1,3,22337,1661,20676,0.9256390741818508,9.531660444444444,800.9398453333333,19.09480461289071,127,2.900000000000001E-4
5,test_20231101_135150,11610969.png,368720,24192,344528,0.9343892384465177,7,3,84111,3533,80578,0.957995981500636,21.846828444444444,3056.5311093333335,13.278515404761055,127,2.900000000000001E-4
6,test_20231101_135150,10350842.png,212614,5762,206852,0.9728992446405222,1,3,42529,847,41682,0.9800841778551106,19.409909333333335,2398.521546666667,14.33136736645771,127,2.900000000000001E-4
7,test_20231101_135150,10863862.png,317432,10897,306535,0.9656713878877996,2,4,66058,1584,64474,0.9760210723909292,24.488522666666668,3430.0665386666665,12.77777816015962,127,2.900000000000001E-4
8,test_20231101_135150,11382381.png,312486,707,311779,0.9977374986399391,1,3,46745,94,46651,0.9979890897422184,21.82824,2521.273456,14.11460409284577,127,2.900000000000001E-4
9,test_20231101_135150,11079715.png,443815,115577,328238,0.7395829343307458,3,4,124136,16143,107993,0.8699571437777921,17.25776711111111,2193.2968,14.719829558750817,127,2.900000000000001E-4
10,test_20231101_135150,11551286.png,271883,407,271476,0.9985030325544444,1,3,40092,58,40034,0.9985533273471017,17.855009777777777,1855.9584906666666,15.44512102064812,127,2.900000000000001E-4
1,test_20231101_135151,10404007.png,502730,19467,483263,0.9612774252580908,3,3,61265,2821,58444,0.9539541336815474,25.804821333333333,3464.2128746666667,12.734757894589483,127,3.0000000000000014E-4
2,test_20231101_135151,1254659.png,342646,71622,271024,0.7909737746829089,3,4,80080,10031,70049,0.8747377622377622,21.243162666666667,3283.60104,12.96729976321864,127,3.0000000000000014E-4
3,test_20231101_135151,10188041.png,221231,9449,211782,0.9572889875288726,2,3,41731,1331,40400,0.9681052455009466,10.71383111111111,1042.626304,17.949516834977533,127,3.0000000000000014E-4
4,test_20231101_135151,10287332.png,216980,12102,204878,0.944225274218822,1,3,22337,1661,20676,0.9256390741818508,9.531660444444444,800.9398453333333,19.09480461289071,127,3.0000000000000014E-4
5,test_20231101_135151,11610969.png,368720,24192,344528,0.9343892384465177,2,3,84111,3533,80578,0.957995981500636,21.846828444444444,3056.5311093333335,13.278515404761055,127,3.0000000000000014E-4
6,test_20231101_135151,10350842.png,212614,5762,206852,0.9728992446405222,2,4,42529,847,41682,0.9800841778551106,19.409909333333335,2398.521546666667,14.33136736645771,127,3.0000000000000014E-4
7,test_20231101_135151,10863862.png,317432,10897,306535,0.9656713878877996,2,3,66058,1584,64474,0.9760210723909292,24.488522666666668,3430.0665386666665,12.77777816015962,127,3.0000000000000014E-4
8,test_20231101_135151,11382381.png,312486,707,311779,0.9977374986399391,2,3,46745,94,46651,0.9979890897422184,21.82824,2521.273456,14.11460409284577,127,3.0000000000000014E-4
9,test_20231101_135151,11079715.png,443815,115577,328238,0.7395829343307458,3,4,124136,16143,107993,0.8699571437777921,17.25776711111111,2193.2968,14.719829558750817,127,3.0000000000000014E-4
10,test_20231101_135151,11551286.png,271883,407,271476,0.9985030325544444,2,3,40092,58,40034,0.9985533273471017,17.855009777777777,1855.9584906666666,15.44512102064812,127,3.0000000000000014E-4
1,test_20231101_135152,10404007.png,502730,19467,483263,0.9612774252580908,2,3,61265,2821,58444,0.9539541336815474,25.804821333333333,3464.2128746666667,12.734757894589483,127,3.1000000000000016E-4
2,test_20231101_135152,1254659.png,342646,71622,271024,0.7909737746829089,3,4,80080,10031,70049,0.8747377622377622,21.243162666666667,3283.60104,12.96729976321864,127,3.1000000000000016E-4
3,test_20231101_135152,10188041.png,221231,9449,211782,0.9572889875288726,2,4,41731,1331,40400,0.9681052455009466,10.71383111111111,1042.626304,17.949516834977533,127,3.1000000000000016E-4
4,test_20231101_135152,10287332.png,216980,12102,204878,0.944225274218822,1,3,22337,1661,20676,0.9256390741818508,9.531660444444444,800.9398453333333,19.09480461289071,127,3.1000000000000016E-4
5,test_20231101_135152,11610969.png,368720,24192,344528,0.9343892384465177,3,3,84111,3533,80578,0.957995981500636,21.846828444444444,3056.5311093333335,13.278515404761055,127,3.1000000000000016E-4
6,test_20231101_135152,10350842.png,212614,5762,206852,0.9728992446405222,1,4,42529,847,41682,0.9800841778551106,19.409909333333335,2398.521546666667,14.33136736645771,127,3.1000000000000016E-4
7,test_20231101_135152,10863862.png,317432,10897,306535,0.9656713878877996,2,4,66058,1584,64474,0.9760210723909292,24.488522666666668,3430.0665386666665,12.77777816015962,127,3.1000000000000016E-4
8,test_20231101_135152,11382381.png,312486,707,311779,0.9977374986399391,1,3,46745,94,46651,0.9979890897422184,21.82824,2521.273456,14.11460409284577,127,3.1000000000000016E-4
9,test_20231101_135152,11079715.png,443815,115577,328238,0.7395829343307458,3,4,124136,16143,107993,0.8699571437777921,17.25776711111111,2193.2968,14.719829558750817,127,3.1000000000000016E-4
10,test_20231101_135152,11551286.png,271883,407,271476,0.9985030325544444,1,3,40092,58,40034,0.9985533273471017,17.855009777777777,1855.9584906666666,15.44512102064812,127,3.1000000000000016E-4
1,test_20231101_135152,10404007.png,502730,19187,483543,0.9618343842619299,2,3,61265,2780,58485,0.954623357545091,25.892992,3483.917258666667,12.710125286916409,127,3.200000000000002E-4
2,test_20231101_135152,1254659.png,342646,71622,271024,0.7909737746829089,3,4,80080,10031,70049,0.8747377622377622,21.243162666666667,3283.60104,12.96729976321864,127,3.200000000000002E-4
3,test_20231101_135152,10188041.png,221231,9449,211782,0.9572889875288726,2,4,41731,1331,40400,0.9681052455009466,10.71383111111111,1042.626304,17.949516834977533,127,3.200000000000002E-4
4,test_20231101_135152,10287332.png,216980,12102,204878,0.944225274218822,4,4,22337,1661,20676,0.9256390741818508,9.531660444444444,800.9398453333333,19.09480461289071,127,3.200000000000002E-4
5,test_20231101_135152,11610969.png,368720,24192,344528,0.9343892384465177,3,4,84111,3533,80578,0.957995981500636,21.846828444444444,3056.5311093333335,13.278515404761055,127,3.200000000000002E-4
6,test_20231101_135152,10350842.png,212614,5762,206852,0.9728992446405222,2,4,42529,847,41682,0.9800841778551106,19.409909333333335,2398.521546666667,14.33136736645771,127,3.200000000000002E-4
7,test_20231101_135152,10863862.png,317432,10897,306535,0.9656713878877996,2,4,66058,1584,64474,0.9760210723909292,24.488522666666668,3430.0665386666665,12.77777816015962,127,3.200000000000002E-4
8,test_20231101_135152,11382381.png,312486,707,311779,0.9977374986399391,2,4,46745,94,46651,0.9979890897422184,21.82824,2521.273456,14.11460409284577,127,3.200000000000002E-4
9,test_20231101_135152,11079715.png,443815,115577,328238,0.7395829343307458,3,4,124136,16143,107993,0.8699571437777921,17.25776711111111,2193.2968,14.719829558750817,127,3.200000000000002E-4
10,test_20231101_135152,11551286.png,271883,407,271476,0.9985030325544444,2,4,40092,58,40034,0.9985533273471017,17.855009777777777,1855.9584906666666,15.44512102064812,127,3.200000000000002E-4
1,test_20231101_135153,10404007.png,502730,19187,483543,0.9618343842619299,2,13,61265,2780,58485,0.954623357545091,25.892992,3483.917258666667,12.710125286916409,127,3.300000000000002E-4
2,test_20231101_135153,1254659.png,342646,71622,271024,0.7909737746829089,3,4,80080,10031,70049,0.8747377622377622,21.243162666666667,3283.60104,12.96729976321864,127,3.300000000000002E-4
3,test_20231101_135153,10188041.png,221231,9449,211782,0.9572889875288726,2,4,41731,1331,40400,0.9681052455009466,10.71383111111111,1042.626304,17.949516834977533,127,3.300000000000002E-4
4,test_20231101_135153,10287332.png,216980,12102,204878,0.944225274218822,2,4,22337,1661,20676,0.9256390741818508,9.531660444444444,800.9398453333333,19.09480461289071,127,3.300000000000002E-4
5,test_20231101_135153,11610969.png,368720,24192,344528,0.9343892384465177,2,3,84111,3533,80578,0.957995981500636,21.846828444444444,3056.5311093333335,13.278515404761055,127,3.300000000000002E-4
6,test_20231101_135153,10350842.png,212614,5762,206852,0.9728992446405222,2,3,42529,847,41682,0.9800841778551106,19.409909333333335,2398.521546666667,14.33136736645771,127,3.300000000000002E-4
7,test_20231101_135153,10863862.png,317432,10897,306535,0.9656713878877996,2,4,66058,1584,64474,0.9760210723909292,24.488522666666668,3430.0665386666665,12.77777816015962,127,3.300000000000002E-4
8,test_20231101_135153,11382381.png,312486,707,311779,0.9977374986399391,1,3,46745,94,46651,0.9979890897422184,21.82824,2521.273456,14.11460409284577,127,3.300000000000002E-4
9,test_20231101_135153,11079715.png,443815,115577,328238,0.7395829343307458,4,4,124136,16143,107993,0.8699571437777921,17.25776711111111,2193.2968,14.719829558750817,127,3.300000000000002E-4
10,test_20231101_135153,11551286.png,271883,407,271476,0.9985030325544444,1,3,40092,58,40034,0.9985533273471017,17.855009777777777,1855.9584906666666,15.44512102064812,127,3.300000000000002E-4
1,test_20231101_135154,10404007.png,502730,19187,483543,0.9618343842619299,2,4,61265,2780,58485,0.954623357545091,25.892992,3483.917258666667,12.710125286916409,127,3.4000000000000024E-4
2,test_20231101_135154,1254659.png,342646,71622,271024,0.7909737746829089,3,4,80080,10031,70049,0.8747377622377622,21.243162666666667,3283.60104,12.96729976321864,127,3.4000000000000024E-4
3,test_20231101_135154,10188041.png,221231,9449,211782,0.9572889875288726,2,4,41731,1331,40400,0.9681052455009466,10.71383111111111,1042.626304,17.949516834977533,127,3.4000000000000024E-4
4,test_20231101_135154,10287332.png,216980,12102,204878,0.944225274218822,2,3,22337,1661,20676,0.9256390741818508,9.531660444444444,800.9398453333333,19.09480461289071,127,3.4000000000000024E-4
5,test_20231101_135154,11610969.png,368720,24192,344528,0.9343892384465177,2,4,84111,3533,80578,0.957995981500636,21.846828444444444,3056.5311093333335,13.278515404761055,127,3.4000000000000024E-4
6,test_20231101_135154,10350842.png,212614,5762,206852,0.9728992446405222,2,4,42529,847,41682,0.9800841778551106,19.409909333333335,2398.521546666667,14.33136736645771,127,3.4000000000000024E-4
7,test_20231101_135154,10863862.png,317432,10897,306535,0.9656713878877996,3,4,66058,1584,64474,0.9760210723909292,24.488522666666668,3430.0665386666665,12.77777816015962,127,3.4000000000000024E-4
8,test_20231101_135154,11382381.png,312486,707,311779,0.9977374986399391,2,3,46745,94,46651,0.9979890897422184,21.82824,2521.273456,14.11460409284577,127,3.4000000000000024E-4
9,test_20231101_135154,11079715.png,443815,115577,328238,0.7395829343307458,3,5,124136,16143,107993,0.8699571437777921,17.25776711111111,2193.2968,14.719829558750817,127,3.4000000000000024E-4
10,test_20231101_135154,11551286.png,271883,407,271476,0.9985030325544444,1,4,40092,58,40034,0.9985533273471017,17.855009777777777,1855.9584906666666,15.44512102064812,127,3.4000000000000024E-4
1,test_20231101_135154,10404007.png,502730,19187,483543,0.9618343842619299,2,4,61265,2780,58485,0.954623357545091,25.892992,3483.917258666667,12.710125286916409,127,3.5000000000000027E-4
2,test_20231101_135154,1254659.png,342646,71622,271024,0.7909737746829089,3,4,80080,10031,70049,0.8747377622377622,21.243162666666667,3283.60104,12.96729976321864,127,3.5000000000000027E-4
3,test_20231101_135154,10188041.png,221231,9449,211782,0.9572889875288726,2,4,41731,1331,40400,0.9681052455009466,10.71383111111111,1042.626304,17.949516834977533,127,3.5000000000000027E-4
4,test_20231101_135154,10287332.png,216980,12102,204878,0.944225274218822,2,3,22337,1661,20676,0.9256390741818508,9.531660444444444,800.9398453333333,19.09480461289071,127,3.5000000000000027E-4
5,test_20231101_135154,11610969.png,368720,24192,344528,0.9343892384465177,2,4,84111,3533,80578,0.957995981500636,21.846828444444444,3056.5311093333335,13.278515404761055,127,3.5000000000000027E-4
6,test_20231101_135154,10350842.png,212614,5762,206852,0.9728992446405222,1,4,42529,847,41682,0.9800841778551106,19.409909333333335,2398.521546666667,14.33136736645771,127,3.5000000000000027E-4
7,test_20231101_135154,10863862.png,317432,10897,306535,0.9656713878877996,2,4,66058,1584,64474,0.9760210723909292,24.488522666666668,3430.0665386666665,12.77777816015962,127,3.5000000000000027E-4
8,test_20231101_135154,11382381.png,312486,707,311779,0.9977374986399391,2,3,46745,94,46651,0.9979890897422184,21.82824,2521.273456,14.11460409284577,127,3.5000000000000027E-4
9,test_20231101_135154,11079715.png,443815,115577,328238,0.7395829343307458,3,4,124136,16143,107993,0.8699571437777921,17.25776711111111,2193.2968,14.719829558750817,127,3.5000000000000027E-4
10,test_20231101_135154,11551286.png,271883,407,271476,0.9985030325544444,1,4,40092,58,40034,0.9985533273471017,17.855009777777777,1855.9584906666666,15.44512102064812,127,3.5000000000000027E-4
1,test_20231101_135155,10404007.png,502730,19187,483543,0.9618343842619299,3,4,61265,2780,58485,0.954623357545091,25.892992,3483.917258666667,12.710125286916409,127,3.600000000000003E-4
2,test_20231101_135155,1254659.png,342646,71622,271024,0.7909737746829089,3,4,80080,10031,70049,0.8747377622377622,21.243162666666667,3283.60104,12.96729976321864,127,3.600000000000003E-4
3,test_20231101_135155,10188041.png,221231,9449,211782,0.9572889875288726,2,4,41731,1331,40400,0.9681052455009466,10.71383111111111,1042.626304,17.949516834977533,127,3.600000000000003E-4
4,test_20231101_135155,10287332.png,216980,12102,204878,0.944225274218822,2,3,22337,1661,20676,0.9256390741818508,9.531660444444444,800.9398453333333,19.09480461289071,127,3.600000000000003E-4
5,test_20231101_135155,11610969.png,368720,24192,344528,0.9343892384465177,2,4,84111,3533,80578,0.957995981500636,21.846828444444444,3056.5311093333335,13.278515404761055,127,3.600000000000003E-4
6,test_20231101_135155,10350842.png,212614,5762,206852,0.9728992446405222,1,3,42529,847,41682,0.9800841778551106,19.409909333333335,2398.521546666667,14.33136736645771,127,3.600000000000003E-4
7,test_20231101_135155,10863862.png,317432,10897,306535,0.9656713878877996,2,3,66058,1584,64474,0.9760210723909292,24.488522666666668,3430.0665386666665,12.77777816015962,127,3.600000000000003E-4
8,test_20231101_135155,11382381.png,312486,707,311779,0.9977374986399391,1,4,46745,94,46651,0.9979890897422184,21.82824,2521.273456,14.11460409284577,127,3.600000000000003E-4
9,test_20231101_135155,11079715.png,443815,115577,328238,0.7395829343307458,4,4,124136,16143,107993,0.8699571437777921,17.25776711111111,2193.2968,14.719829558750817,127,3.600000000000003E-4
10,test_20231101_135155,11551286.png,271883,407,271476,0.9985030325544444,1,4,40092,58,40034,0.9985533273471017,17.855009777777777,1855.9584906666666,15.44512102064812,127,3.600000000000003E-4
1,test_20231101_135156,10404007.png,502730,19187,483543,0.9618343842619299,2,3,61265,2780,58485,0.954623357545091,25.892992,3483.917258666667,12.710125286916409,127,3.700000000000003E-4
2,test_20231101_135156,1254659.png,342646,71622,271024,0.7909737746829089,3,4,80080,10031,70049,0.8747377622377622,21.243162666666667,3283.60104,12.96729976321864,127,3.700000000000003E-4
3,test_20231101_135156,10188041.png,221231,9449,211782,0.9572889875288726,2,4,41731,1331,40400,0.9681052455009466,10.71383111111111,1042.626304,17.949516834977533,127,3.700000000000003E-4
4,test_20231101_135156,10287332.png,216980,12102,204878,0.944225274218822,1,4,22337,1661,20676,0.9256390741818508,9.531660444444444,800.9398453333333,19.09480461289071,127,3.700000000000003E-4
5,test_20231101_135156,11610969.png,368720,24192,344528,0.9343892384465177,2,3,84111,3533,80578,0.957995981500636,21.846828444444444,3056.5311093333335,13.278515404761055,127,3.700000000000003E-4
6,test_20231101_135156,10350842.png,212614,5762,206852,0.9728992446405222,2,4,42529,847,41682,0.9800841778551106,19.409909333333335,2398.521546666667,14.33136736645771,127,3.700000000000003E-4
7,test_20231101_135156,10863862.png,317432,10897,306535,0.9656713878877996,2,4,66058,1584,64474,0.9760210723909292,24.488522666666668,3430.0665386666665,12.77777816015962,127,3.700000000000003E-4
8,test_20231101_135156,11382381.png,312486,707,311779,0.9977374986399391,1,4,46745,94,46651,0.9979890897422184,21.82824,2521.273456,14.11460409284577,127,3.700000000000003E-4
9,test_20231101_135156,11079715.png,443815,115577,328238,0.7395829343307458,4,4,124136,16143,107993,0.8699571437777921,17.25776711111111,2193.2968,14.719829558750817,127,3.700000000000003E-4
10,test_20231101_135156,11551286.png,271883,407,271476,0.9985030325544444,1,3,40092,58,40034,0.9985533273471017,17.855009777777777,1855.9584906666666,15.44512102064812,127,3.700000000000003E-4
1,test_20231101_135156,10404007.png,502730,19187,483543,0.9618343842619299,3,3,61265,2780,58485,0.954623357545091,25.892992,3483.917258666667,12.710125286916409,127,3.8000000000000035E-4
2,test_20231101_135156,1254659.png,342646,71622,271024,0.7909737746829089,3,4,80080,10031,70049,0.8747377622377622,21.243162666666667,3283.60104,12.96729976321864,127,3.8000000000000035E-4
3,test_20231101_135156,10188041.png,221231,9449,211782,0.9572889875288726,2,4,41731,1331,40400,0.9681052455009466,10.71383111111111,1042.626304,17.949516834977533,127,3.8000000000000035E-4
4,test_20231101_135156,10287332.png,216980,12102,204878,0.944225274218822,2,3,22337,1661,20676,0.9256390741818508,9.531660444444444,800.9398453333333,19.09480461289071,127,3.8000000000000035E-4
5,test_20231101_135156,11610969.png,368720,24192,344528,0.9343892384465177,2,4,84111,3533,80578,0.957995981500636,21.846828444444444,3056.5311093333335,13.278515404761055,127,3.8000000000000035E-4
6,test_20231101_135156,10350842.png,212614,5762,206852,0.9728992446405222,1,4,42529,847,41682,0.9800841778551106,19.409909333333335,2398.521546666667,14.33136736645771,127,3.8000000000000035E-4
7,test_20231101_135156,10863862.png,317432,10897,306535,0.9656713878877996,2,4,66058,1584,64474,0.9760210723909292,24.488522666666668,3430.0665386666665,12.77777816015962,127,3.8000000000000035E-4
8,test_20231101_135156,11382381.png,312486,707,311779,0.9977374986399391,1,4,46745,94,46651,0.9979890897422184,21.82824,2521.273456,14.11460409284577,127,3.8000000000000035E-4
9,test_20231101_135156,11079715.png,443815,115577,328238,0.7395829343307458,3,5,124136,16143,107993,0.8699571437777921,17.25776711111111,2193.2968,14.719829558750817,127,3.8000000000000035E-4
10,test_20231101_135156,11551286.png,271883,407,271476,0.9985030325544444,1,4,40092,58,40034,0.9985533273471017,17.855009777777777,1855.9584906666666,15.44512102064812,127,3.8000000000000035E-4
1,test_20231101_135157,10404007.png,502730,19187,483543,0.9618343842619299,2,3,61265,2780,58485,0.954623357545091,25.892992,3483.917258666667,12.710125286916409,127,3.9000000000000037E-4
2,test_20231101_135157,1254659.png,342646,71622,271024,0.7909737746829089,2,4,80080,10031,70049,0.8747377622377622,21.243162666666667,3283.60104,12.96729976321864,127,3.9000000000000037E-4
3,test_20231101_135157,10188041.png,221231,9449,211782,0.9572889875288726,2,3,41731,1331,40400,0.9681052455009466,10.71383111111111,1042.626304,17.949516834977533,127,3.9000000000000037E-4
4,test_20231101_135157,10287332.png,216980,12102,204878,0.944225274218822,2,4,22337,1661,20676,0.9256390741818508,9.531660444444444,800.9398453333333,19.09480461289071,127,3.9000000000000037E-4
5,test_20231101_135157,11610969.png,368720,24192,344528,0.9343892384465177,2,4,84111,3533,80578,0.957995981500636,21.846828444444444,3056.5311093333335,13.278515404761055,127,3.9000000000000037E-4
6,test_20231101_135157,10350842.png,212614,5762,206852,0.9728992446405222,1,4,42529,847,41682,0.9800841778551106,19.409909333333335,2398.521546666667,14.33136736645771,127,3.9000000000000037E-4
7,test_20231101_135157,10863862.png,317432,9872,307560,0.9689004259179919,2,3,66058,1435,64623,0.9782766659602168,26.91376177777778,4100.150074666667,12.002806077074947,127,3.9000000000000037E-4
8,test_20231101_135157,11382381.png,312486,707,311779,0.9977374986399391,2,4,46745,94,46651,0.9979890897422184,21.82824,2521.273456,14.11460409284577,127,3.9000000000000037E-4
9,test_20231101_135157,11079715.png,443815,115577,328238,0.7395829343307458,4,4,124136,16143,107993,0.8699571437777921,17.25776711111111,2193.2968,14.719829558750817,127,3.9000000000000037E-4
10,test_20231101_135157,11551286.png,271883,407,271476,0.9985030325544444,1,3,40092,58,40034,0.9985533273471017,17.855009777777777,1855.9584906666666,15.44512102064812,127,3.9000000000000037E-4
1,test_20231101_135158,10404007.png,502730,19187,483543,0.9618343842619299,2,4,61265,2780,58485,0.954623357545091,25.892992,3483.917258666667,12.710125286916409,127,4.000000000000004E-4
2,test_20231101_135158,1254659.png,342646,71622,271024,0.7909737746829089,4,4,80080,10031,70049,0.8747377622377622,21.243162666666667,3283.60104,12.96729976321864,127,4.000000000000004E-4
3,test_20231101_135158,10188041.png,221231,9449,211782,0.9572889875288726,2,3,41731,1331,40400,0.9681052455009466,10.71383111111111,1042.626304,17.949516834977533,127,4.000000000000004E-4
4,test_20231101_135158,10287332.png,216980,12102,204878,0.944225274218822,2,4,22337,1661,20676,0.9256390741818508,9.531660444444444,800.9398453333333,19.09480461289071,127,4.000000000000004E-4
5,test_20231101_135158,11610969.png,368720,24192,344528,0.9343892384465177,2,4,84111,3533,80578,0.957995981500636,21.846828444444444,3056.5311093333335,13.278515404761055,127,4.000000000000004E-4
6,test_20231101_135158,10350842.png,212614,5762,206852,0.9728992446405222,2,4,42529,847,41682,0.9800841778551106,19.409909333333335,2398.521546666667,14.33136736645771,127,4.000000000000004E-4
7,test_20231101_135158,10863862.png,317432,9872,307560,0.9689004259179919,3,4,66058,1435,64623,0.9782766659602168,26.91376177777778,4100.150074666667,12.002806077074947,127,4.000000000000004E-4
8,test_20231101_135158,11382381.png,312486,707,311779,0.9977374986399391,1,4,46745,94,46651,0.9979890897422184,21.82824,2521.273456,14.11460409284577,127,4.000000000000004E-4
9,test_20231101_135158,11079715.png,443815,115577,328238,0.7395829343307458,3,4,124136,16143,107993,0.8699571437777921,17.25776711111111,2193.2968,14.719829558750817,127,4.000000000000004E-4
10,test_20231101_135158,11551286.png,271883,407,271476,0.9985030325544444,1,3,40092,58,40034,0.9985533273471017,17.855009777777777,1855.9584906666666,15.44512102064812,127,4.000000000000004E-4
1,test_20231101_135158,10404007.png,502730,19187,483543,0.9618343842619299,2,3,61265,2780,58485,0.954623357545091,25.892992,3483.917258666667,12.710125286916409,127,4.100000000000004E-4
2,test_20231101_135158,1254659.png,342646,71622,271024,0.7909737746829089,2,4,80080,10031,70049,0.8747377622377622,21.243162666666667,3283.60104,12.96729976321864,127,4.100000000000004E-4
3,test_20231101_135158,10188041.png,221231,9449,211782,0.9572889875288726,2,4,41731,1331,40400,0.9681052455009466,10.71383111111111,1042.626304,17.949516834977533,127,4.100000000000004E-4
4,test_20231101_135158,10287332.png,216980,12102,204878,0.944225274218822,1,3,22337,1661,20676,0.9256390741818508,9.531660444444444,800.9398453333333,19.09480461289071,127,4.100000000000004E-4
5,test_20231101_135158,11610969.png,368720,24192,344528,0.9343892384465177,2,3,84111,3533,80578,0.957995981500636,21.846828444444444,3056.5311093333335,13.278515404761055,127,4.100000000000004E-4
6,test_20231101_135158,10350842.png,212614,5762,206852,0.9728992446405222,1,4,42529,847,41682,0.9800841778551106,19.409909333333335,2398.521546666667,14.33136736645771,127,4.100000000000004E-4
7,test_20231101_135158,10863862.png,317432,9872,307560,0.9689004259179919,2,4,66058,1435,64623,0.9782766659602168,26.91376177777778,4100.150074666667,12.002806077074947,127,4.100000000000004E-4
8,test_20231101_135158,11382381.png,312486,707,311779,0.9977374986399391,2,4,46745,94,46651,0.9979890897422184,21.82824,2521.273456,14.11460409284577,127,4.100000000000004E-4
9,test_20231101_135158,11079715.png,443815,115577,328238,0.7395829343307458,3,4,124136,16143,107993,0.8699571437777921,17.25776711111111,2193.2968,14.719829558750817,127,4.100000000000004E-4
10,test_20231101_135158,11551286.png,271883,407,271476,0.9985030325544444,1,4,40092,58,40034,0.9985533273471017,17.855009777777777,1855.9584906666666,15.44512102064812,127,4.100000000000004E-4
1,test_20231101_135159,10404007.png,502730,19187,483543,0.9618343842619299,3,4,61265,2780,58485,0.954623357545091,25.892992,3483.917258666667,12.710125286916409,127,4.2000000000000045E-4
2,test_20231101_135159,1254659.png,342646,71622,271024,0.7909737746829089,3,4,80080,10031,70049,0.8747377622377622,21.243162666666667,3283.60104,12.96729976321864,127,4.2000000000000045E-4
3,test_20231101_135159,10188041.png,221231,9449,211782,0.9572889875288726,2,4,41731,1331,40400,0.9681052455009466,10.71383111111111,1042.626304,17.949516834977533,127,4.2000000000000045E-4
4,test_20231101_135159,10287332.png,216980,12102,204878,0.944225274218822,1,4,22337,1661,20676,0.9256390741818508,9.531660444444444,800.9398453333333,19.09480461289071,127,4.2000000000000045E-4
5,test_20231101_135159,11610969.png,368720,24192,344528,0.9343892384465177,2,4,84111,3533,80578,0.957995981500636,21.846828444444444,3056.5311093333335,13.278515404761055,127,4.2000000000000045E-4
6,test_20231101_135159,10350842.png,212614,5762,206852,0.9728992446405222,1,4,42529,847,41682,0.9800841778551106,19.409909333333335,2398.521546666667,14.33136736645771,127,4.2000000000000045E-4
7,test_20231101_135159,10863862.png,317432,9872,307560,0.9689004259179919,3,4,66058,1435,64623,0.9782766659602168,26.91376177777778,4100.150074666667,12.002806077074947,127,4.2000000000000045E-4
8,test_20231101_135159,11382381.png,312486,707,311779,0.9977374986399391,1,3,46745,94,46651,0.9979890897422184,21.82824,2521.273456,14.11460409284577,127,4.2000000000000045E-4
9,test_20231101_135159,11079715.png,443815,115577,328238,0.7395829343307458,4,4,124136,16143,107993,0.8699571437777921,17.25776711111111,2193.2968,14.719829558750817,127,4.2000000000000045E-4
10,test_20231101_135159,11551286.png,271883,407,271476,0.9985030325544444,1,4,40092,58,40034,0.9985533273471017,17.855009777777777,1855.9584906666666,15.44512102064812,127,4.2000000000000045E-4
1,test_20231101_135200,10404007.png,502730,19187,483543,0.9618343842619299,3,3,61265,2780,58485,0.954623357545091,25.892992,3483.917258666667,12.710125286916409,127,4.300000000000005E-4
2,test_20231101_135200,1254659.png,342646,71622,271024,0.7909737746829089,3,4,80080,10031,70049,0.8747377622377622,21.243162666666667,3283.60104,12.96729976321864,127,4.300000000000005E-4
3,test_20231101_135200,10188041.png,221231,9449,211782,0.9572889875288726,2,3,41731,1331,40400,0.9681052455009466,10.71383111111111,1042.626304,17.949516834977533,127,4.300000000000005E-4
4,test_20231101_135200,10287332.png,216980,12102,204878,0.944225274218822,2,3,22337,1661,20676,0.9256390741818508,9.531660444444444,800.9398453333333,19.09480461289071,127,4.300000000000005E-4
5,test_20231101_135200,11610969.png,368720,24192,344528,0.9343892384465177,2,4,84111,3533,80578,0.957995981500636,21.846828444444444,3056.5311093333335,13.278515404761055,127,4.300000000000005E-4
6,test_20231101_135200,10350842.png,212614,5762,206852,0.9728992446405222,2,3,42529,847,41682,0.9800841778551106,19.409909333333335,2398.521546666667,14.33136736645771,127,4.300000000000005E-4
7,test_20231101_135200,10863862.png,317432,9872,307560,0.9689004259179919,2,3,66058,1435,64623,0.9782766659602168,26.91376177777778,4100.150074666667,12.002806077074947,127,4.300000000000005E-4
8,test_20231101_135200,11382381.png,312486,707,311779,0.9977374986399391,2,3,46745,94,46651,0.9979890897422184,21.82824,2521.273456,14.11460409284577,127,4.300000000000005E-4
9,test_20231101_135200,11079715.png,443815,115577,328238,0.7395829343307458,3,4,124136,16143,107993,0.8699571437777921,17.25776711111111,2193.2968,14.719829558750817,127,4.300000000000005E-4
10,test_20231101_135200,11551286.png,271883,407,271476,0.9985030325544444,1,4,40092,58,40034,0.9985533273471017,17.855009777777777,1855.9584906666666,15.44512102064812,127,4.300000000000005E-4
1,test_20231101_135201,10404007.png,502730,19187,483543,0.9618343842619299,2,8,61265,2780,58485,0.954623357545091,25.892992,3483.917258666667,12.710125286916409,127,4.400000000000005E-4
2,test_20231101_135201,1254659.png,342646,71622,271024,0.7909737746829089,2,4,80080,10031,70049,0.8747377622377622,21.243162666666667,3283.60104,12.96729976321864,127,4.400000000000005E-4
3,test_20231101_135201,10188041.png,221231,9449,211782,0.9572889875288726,2,4,41731,1331,40400,0.9681052455009466,10.71383111111111,1042.626304,17.949516834977533,127,4.400000000000005E-4
4,test_20231101_135201,10287332.png,216980,12102,204878,0.944225274218822,2,4,22337,1661,20676,0.9256390741818508,9.531660444444444,800.9398453333333,19.09480461289071,127,4.400000000000005E-4
5,test_20231101_135201,11610969.png,368720,24192,344528,0.9343892384465177,3,4,84111,3533,80578,0.957995981500636,21.846828444444444,3056.5311093333335,13.278515404761055,127,4.400000000000005E-4
6,test_20231101_135201,10350842.png,212614,5762,206852,0.9728992446405222,1,4,42529,847,41682,0.9800841778551106,19.409909333333335,2398.521546666667,14.33136736645771,127,4.400000000000005E-4
7,test_20231101_135201,10863862.png,317432,9872,307560,0.9689004259179919,2,4,66058,1435,64623,0.9782766659602168,26.91376177777778,4100.150074666667,12.002806077074947,127,4.400000000000005E-4
8,test_20231101_135201,11382381.png,312486,707,311779,0.9977374986399391,2,3,46745,94,46651,0.9979890897422184,21.82824,2521.273456,14.11460409284577,127,4.400000000000005E-4
9,test_20231101_135201,11079715.png,443815,115577,328238,0.7395829343307458,3,4,124136,16143,107993,0.8699571437777921,17.25776711111111,2193.2968,14.719829558750817,127,4.400000000000005E-4
10,test_20231101_135201,11551286.png,271883,407,271476,0.9985030325544444,1,3,40092,58,40034,0.9985533273471017,17.855009777777777,1855.9584906666666,15.44512102064812,127,4.400000000000005E-4
1,test_20231101_135201,10404007.png,502730,19187,483543,0.9618343842619299,2,3,61265,2780,58485,0.954623357545091,25.892992,3483.917258666667,12.710125286916409,127,4.5000000000000053E-4
2,test_20231101_135201,1254659.png,342646,71622,271024,0.7909737746829089,3,4,80080,10031,70049,0.8747377622377622,21.243162666666667,3283.60104,12.96729976321864,127,4.5000000000000053E-4
3,test_20231101_135201,10188041.png,221231,9449,211782,0.9572889875288726,1,3,41731,1331,40400,0.9681052455009466,10.71383111111111,1042.626304,17.949516834977533,127,4.5000000000000053E-4
4,test_20231101_135201,10287332.png,216980,12102,204878,0.944225274218822,1,4,22337,1661,20676,0.9256390741818508,9.531660444444444,800.9398453333333,19.09480461289071,127,4.5000000000000053E-4
5,test_20231101_135201,11610969.png,368720,24192,344528,0.9343892384465177,2,4,84111,3533,80578,0.957995981500636,21.846828444444444,3056.5311093333335,13.278515404761055,127,4.5000000000000053E-4
6,test_20231101_135201,10350842.png,212614,5762,206852,0.9728992446405222,2,3,42529,847,41682,0.9800841778551106,19.409909333333335,2398.521546666667,14.33136736645771,127,4.5000000000000053E-4
7,test_20231101_135201,10863862.png,317432,9872,307560,0.9689004259179919,2,4,66058,1435,64623,0.9782766659602168,26.91376177777778,4100.150074666667,12.002806077074947,127,4.5000000000000053E-4
8,test_20231101_135201,11382381.png,312486,707,311779,0.9977374986399391,2,4,46745,94,46651,0.9979890897422184,21.82824,2521.273456,14.11460409284577,127,4.5000000000000053E-4
9,test_20231101_135201,11079715.png,443815,115577,328238,0.7395829343307458,4,4,124136,16143,107993,0.8699571437777921,17.25776711111111,2193.2968,14.719829558750817,127,4.5000000000000053E-4
10,test_20231101_135201,11551286.png,271883,407,271476,0.9985030325544444,2,3,40092,58,40034,0.9985533273471017,17.855009777777777,1855.9584906666666,15.44512102064812,127,4.5000000000000053E-4
1,test_20231101_135202,10404007.png,502730,19187,483543,0.9618343842619299,3,4,61265,2780,58485,0.954623357545091,25.892992,3483.917258666667,12.710125286916409,127,4.6000000000000056E-4
2,test_20231101_135202,1254659.png,342646,71622,271024,0.7909737746829089,4,4,80080,10031,70049,0.8747377622377622,21.243162666666667,3283.60104,12.96729976321864,127,4.6000000000000056E-4
3,test_20231101_135202,10188041.png,221231,9449,211782,0.9572889875288726,2,3,41731,1331,40400,0.9681052455009466,10.71383111111111,1042.626304,17.949516834977533,127,4.6000000000000056E-4
4,test_20231101_135202,10287332.png,216980,12102,204878,0.944225274218822,2,4,22337,1661,20676,0.9256390741818508,9.531660444444444,800.9398453333333,19.09480461289071,127,4.6000000000000056E-4
5,test_20231101_135202,11610969.png,368720,24192,344528,0.9343892384465177,2,3,84111,3533,80578,0.957995981500636,21.846828444444444,3056.5311093333335,13.278515404761055,127,4.6000000000000056E-4
6,test_20231101_135202,10350842.png,212614,5762,206852,0.9728992446405222,1,3,42529,847,41682,0.9800841778551106,19.409909333333335,2398.521546666667,14.33136736645771,127,4.6000000000000056E-4
7,test_20231101_135202,10863862.png,317432,9872,307560,0.9689004259179919,3,3,66058,1435,64623,0.9782766659602168,26.91376177777778,4100.150074666667,12.002806077074947,127,4.6000000000000056E-4
8,test_20231101_135202,11382381.png,312486,707,311779,0.9977374986399391,2,3,46745,94,46651,0.9979890897422184,21.82824,2521.273456,14.11460409284577,127,4.6000000000000056E-4
9,test_20231101_135202,11079715.png,443815,115577,328238,0.7395829343307458,5,5,124136,16143,107993,0.8699571437777921,17.25776711111111,2193.2968,14.719829558750817,127,4.6000000000000056E-4
10,test_20231101_135202,11551286.png,271883,407,271476,0.9985030325544444,1,4,40092,58,40034,0.9985533273471017,17.855009777777777,1855.9584906666666,15.44512102064812,127,4.6000000000000056E-4
1,test_20231101_135203,10404007.png,502730,19187,483543,0.9618343842619299,2,4,61265,2780,58485,0.954623357545091,25.892992,3483.917258666667,12.710125286916409,127,4.700000000000006E-4
2,test_20231101_135203,1254659.png,342646,71622,271024,0.7909737746829089,2,4,80080,10031,70049,0.8747377622377622,21.243162666666667,3283.60104,12.96729976321864,127,4.700000000000006E-4
3,test_20231101_135203,10188041.png,221231,9449,211782,0.9572889875288726,2,3,41731,1331,40400,0.9681052455009466,10.71383111111111,1042.626304,17.949516834977533,127,4.700000000000006E-4
4,test_20231101_135203,10287332.png,216980,12102,204878,0.944225274218822,2,3,22337,1661,20676,0.9256390741818508,9.531660444444444,800.9398453333333,19.09480461289071,127,4.700000000000006E-4
5,test_20231101_135203,11610969.png,368720,24192,344528,0.9343892384465177,2,3,84111,3533,80578,0.957995981500636,21.846828444444444,3056.5311093333335,13.278515404761055,127,4.700000000000006E-4
6,test_20231101_135203,10350842.png,212614,5762,206852,0.9728992446405222,1,4,42529,847,41682,0.9800841778551106,19.409909333333335,2398.521546666667,14.33136736645771,127,4.700000000000006E-4
7,test_20231101_135203,10863862.png,317432,9872,307560,0.9689004259179919,2,4,66058,1435,64623,0.9782766659602168,26.91376177777778,4100.150074666667,12.002806077074947,127,4.700000000000006E-4
8,test_20231101_135203,11382381.png,312486,707,311779,0.9977374986399391,2,3,46745,94,46651,0.9979890897422184,21.82824,2521.273456,14.11460409284577,127,4.700000000000006E-4
9,test_20231101_135203,11079715.png,443815,115577,328238,0.7395829343307458,3,4,124136,16143,107993,0.8699571437777921,17.25776711111111,2193.2968,14.719829558750817,127,4.700000000000006E-4
10,test_20231101_135203,11551286.png,271883,407,271476,0.9985030325544444,1,4,40092,58,40034,0.9985533273471017,17.855009777777777,1855.9584906666666,15.44512102064812,127,4.700000000000006E-4
1,test_20231101_135203,10404007.png,502730,19187,483543,0.9618343842619299,3,4,61265,2780,58485,0.954623357545091,25.892992,3483.917258666667,12.710125286916409,127,4.800000000000006E-4
2,test_20231101_135203,1254659.png,342646,71622,271024,0.7909737746829089,3,4,80080,10031,70049,0.8747377622377622,21.243162666666667,3283.60104,12.96729976321864,127,4.800000000000006E-4
3,test_20231101_135203,10188041.png,221231,9449,211782,0.9572889875288726,2,4,41731,1331,40400,0.9681052455009466,10.71383111111111,1042.626304,17.949516834977533,127,4.800000000000006E-4
4,test_20231101_135203,10287332.png,216980,12102,204878,0.944225274218822,2,3,22337,1661,20676,0.9256390741818508,9.531660444444444,800.9398453333333,19.09480461289071,127,4.800000000000006E-4
5,test_20231101_135203,11610969.png,368720,24192,344528,0.9343892384465177,2,4,84111,3533,80578,0.957995981500636,21.846828444444444,3056.5311093333335,13.278515404761055,127,4.800000000000006E-4
6,test_20231101_135203,10350842.png,212614,5762,206852,0.9728992446405222,2,4,42529,847,41682,0.9800841778551106,19.409909333333335,2398.521546666667,14.33136736645771,127,4.800000000000006E-4
7,test_20231101_135203,10863862.png,317432,9872,307560,0.9689004259179919,2,3,66058,1435,64623,0.9782766659602168,26.91376177777778,4100.150074666667,12.002806077074947,127,4.800000000000006E-4
8,test_20231101_135203,11382381.png,312486,707,311779,0.9977374986399391,2,4,46745,94,46651,0.9979890897422184,21.82824,2521.273456,14.11460409284577,127,4.800000000000006E-4
9,test_20231101_135203,11079715.png,443815,115577,328238,0.7395829343307458,4,5,124136,16143,107993,0.8699571437777921,17.25776711111111,2193.2968,14.719829558750817,127,4.800000000000006E-4
10,test_20231101_135203,11551286.png,271883,407,271476,0.9985030325544444,1,4,40092,58,40034,0.9985533273471017,17.855009777777777,1855.9584906666666,15.44512102064812,127,4.800000000000006E-4
1,test_20231101_135204,10404007.png,502730,19187,483543,0.9618343842619299,2,4,61265,2780,58485,0.954623357545091,25.892992,3483.917258666667,12.710125286916409,127,4.900000000000006E-4
2,test_20231101_135204,1254659.png,342646,71622,271024,0.7909737746829089,3,4,80080,10031,70049,0.8747377622377622,21.243162666666667,3283.60104,12.96729976321864,127,4.900000000000006E-4
3,test_20231101_135204,10188041.png,221231,9449,211782,0.9572889875288726,2,3,41731,1331,40400,0.9681052455009466,10.71383111111111,1042.626304,17.949516834977533,127,4.900000000000006E-4
4,test_20231101_135204,10287332.png,216980,12102,204878,0.944225274218822,1,3,22337,1661,20676,0.9256390741818508,9.531660444444444,800.9398453333333,19.09480461289071,127,4.900000000000006E-4
5,test_20231101_135204,11610969.png,368720,24192,344528,0.9343892384465177,3,4,84111,3533,80578,0.957995981500636,21.846828444444444,3056.5311093333335,13.278515404761055,127,4.900000000000006E-4
6,test_20231101_135204,10350842.png,212614,5762,206852,0.9728992446405222,1,4,42529,847,41682,0.9800841778551106,19.409909333333335,2398.521546666667,14.33136736645771,127,4.900000000000006E-4
7,test_20231101_135204,10863862.png,317432,9872,307560,0.9689004259179919,2,4,66058,1435,64623,0.9782766659602168,26.91376177777778,4100.150074666667,12.002806077074947,127,4.900000000000006E-4
8,test_20231101_135204,11382381.png,312486,707,311779,0.9977374986399391,2,4,46745,94,46651,0.9979890897422184,21.82824,2521.273456,14.11460409284577,127,4.900000000000006E-4
9,test_20231101_135204,11079715.png,443815,115577,328238,0.7395829343307458,4,4,124136,16143,107993,0.8699571437777921,17.25776711111111,2193.2968,14.719829558750817,127,4.900000000000006E-4
10,test_20231101_135204,11551286.png,271883,407,271476,0.9985030325544444,2,3,40092,58,40034,0.9985533273471017,17.855009777777777,1855.9584906666666,15.44512102064812,127,4.900000000000006E-4
1,test_20231101_135205,10404007.png,502730,19187,483543,0.9618343842619299,2,4,61265,2780,58485,0.954623357545091,25.892992,3483.917258666667,12.710125286916409,127,5.000000000000007E-4
2,test_20231101_135205,1254659.png,342646,71622,271024,0.7909737746829089,3,4,80080,10031,70049,0.8747377622377622,21.243162666666667,3283.60104,12.96729976321864,127,5.000000000000007E-4
3,test_20231101_135205,10188041.png,221231,9449,211782,0.9572889875288726,3,4,41731,1331,40400,0.9681052455009466,10.71383111111111,1042.626304,17.949516834977533,127,5.000000000000007E-4
4,test_20231101_135205,10287332.png,216980,12102,204878,0.944225274218822,2,4,22337,1661,20676,0.9256390741818508,9.531660444444444,800.9398453333333,19.09480461289071,127,5.000000000000007E-4
5,test_20231101_135205,11610969.png,368720,24192,344528,0.9343892384465177,2,4,84111,3533,80578,0.957995981500636,21.846828444444444,3056.5311093333335,13.278515404761055,127,5.000000000000007E-4
6,test_20231101_135205,10350842.png,212614,5762,206852,0.9728992446405222,1,4,42529,847,41682,0.9800841778551106,19.409909333333335,2398.521546666667,14.33136736645771,127,5.000000000000007E-4
7,test_20231101_135205,10863862.png,317432,9872,307560,0.9689004259179919,2,3,66058,1435,64623,0.9782766659602168,26.91376177777778,4100.150074666667,12.002806077074947,127,5.000000000000007E-4
8,test_20231101_135205,11382381.png,312486,707,311779,0.9977374986399391,2,4,46745,94,46651,0.9979890897422184,21.82824,2521.273456,14.11460409284577,127,5.000000000000007E-4
9,test_20231101_135205,11079715.png,443815,115577,328238,0.7395829343307458,3,4,124136,16143,107993,0.8699571437777921,17.25776711111111,2193.2968,14.719829558750817,127,5.000000000000007E-4
10,test_20231101_135205,11551286.png,271883,407,271476,0.9985030325544444,1,10,40092,58,40034,0.9985533273471017,17.855009777777777,1855.9584906666666,15.44512102064812,127,5.000000000000007E-4
1,test_20231101_135205,10404007.png,502730,19087,483643,0.9620332981918723,2,4,61265,2768,58497,0.954819227944177,25.901315555555556,3485.975434666667,12.707560385145623,127,5.100000000000007E-4
2,test_20231101_135205,1254659.png,342646,71622,271024,0.7909737746829089,3,4,80080,10031,70049,0.8747377622377622,21.243162666666667,3283.60104,12.96729976321864,127,5.100000000000007E-4
3,test_20231101_135205,10188041.png,221231,9369,211862,0.9576506005035461,2,4,41731,1321,40410,0.9683448755122092,11.097500444444444,1092.3682453333333,17.7471129396718,127,5.100000000000007E-4
4,test_20231101_135205,10287332.png,216980,12102,204878,0.944225274218822,2,4,22337,1661,20676,0.9256390741818508,9.531660444444444,800.9398453333333,19.09480461289071,127,5.100000000000007E-4
5,test_20231101_135205,11610969.png,368720,23932,344788,0.9350943805597743,2,4,84111,3494,80617,0.9584596545041671,22.325708444444444,3166.5979893333333,13.124874291967245,127,5.100000000000007E-4
6,test_20231101_135205,10350842.png,212614,5762,206852,0.9728992446405222,1,4,42529,847,41682,0.9800841778551106,19.409909333333335,2398.521546666667,14.33136736645771,127,5.100000000000007E-4
7,test_20231101_135205,10863862.png,317432,9872,307560,0.9689004259179919,2,3,66058,1435,64623,0.9782766659602168,26.91376177777778,4100.150074666667,12.002806077074947,127,5.100000000000007E-4
8,test_20231101_135205,11382381.png,312486,707,311779,0.9977374986399391,2,4,46745,94,46651,0.9979890897422184,21.82824,2521.273456,14.11460409284577,127,5.100000000000007E-4
9,test_20231101_135205,11079715.png,443815,115577,328238,0.7395829343307458,5,4,124136,16143,107993,0.8699571437777921,17.25776711111111,2193.2968,14.719829558750817,127,5.100000000000007E-4
10,test_20231101_135205,11551286.png,271883,347,271536,0.9987237157159513,1,4,40092,49,40043,0.9987778110346204,18.003251555555554,1874.2515253333333,15.402524879051395,127,5.100000000000007E-4
1,test_20231101_135206,10404007.png,502730,18927,483803,0.9623515604797804,2,3,61265,2745,58520,0.9551946462090917,25.943144888888888,3493.450917333333,12.698257150325322,127,5.200000000000007E-4
2,test_20231101_135206,1254659.png,342646,71622,271024,0.7909737746829089,2,4,80080,10031,70049,0.8747377622377622,21.243162666666667,3283.60104,12.96729976321864,127,5.200000000000007E-4
3,test_20231101_135206,10188041.png,221231,9369,211862,0.9576506005035461,2,4,41731,1321,40410,0.9683448755122092,11.097500444444444,1092.3682453333333,17.7471129396718,127,5.200000000000007E-4
4,test_20231101_135206,10287332.png,216980,12102,204878,0.944225274218822,1,4,22337,1661,20676,0.9256390741818508,9.531660444444444,800.9398453333333,19.09480461289071,127,5.200000000000007E-4
5,test_20231101_135206,11610969.png,368720,23932,344788,0.9350943805597743,3,4,84111,3494,80617,0.9584596545041671,22.325708444444444,3166.5979893333333,13.124874291967245,127,5.200000000000007E-4
6,test_20231101_135206,10350842.png,212614,5762,206852,0.9728992446405222,1,4,42529,847,41682,0.9800841778551106,19.409909333333335,2398.521546666667,14.33136736645771,127,5.200000000000007E-4
7,test_20231101_135206,10863862.png,317432,9872,307560,0.9689004259179919,2,4,66058,1435,64623,0.9782766659602168,26.91376177777778,4100.150074666667,12.002806077074947,127,5.200000000000007E-4
8,test_20231101_135206,11382381.png,312486,707,311779,0.9977374986399391,1,4,46745,94,46651,0.9979890897422184,21.82824,2521.273456,14.11460409284577,127,5.200000000000007E-4
9,test_20231101_135206,11079715.png,443815,115577,328238,0.7395829343307458,3,4,124136,16143,107993,0.8699571437777921,17.25776711111111,2193.2968,14.719829558750817,127,5.200000000000007E-4
10,test_20231101_135206,11551286.png,271883,347,271536,0.9987237157159513,2,3,40092,49,40043,0.9987778110346204,18.003251555555554,1874.2515253333333,15.402524879051395,127,5.200000000000007E-4
1,test_20231101_135207,10404007.png,502730,18927,483803,0.9623515604797804,2,4,61265,2745,58520,0.9551946462090917,25.943144888888888,3493.450917333333,12.698257150325322,127,5.300000000000007E-4
2,test_20231101_135207,1254659.png,342646,71622,271024,0.7909737746829089,3,15,80080,10031,70049,0.8747377622377622,21.243162666666667,3283.60104,12.96729976321864,127,5.300000000000007E-4
3,test_20231101_135207,10188041.png,221231,9369,211862,0.9576506005035461,2,4,41731,1321,40410,0.9683448755122092,11.097500444444444,1092.3682453333333,17.7471129396718,127,5.300000000000007E-4
4,test_20231101_135207,10287332.png,216980,12102,204878,0.944225274218822,1,3,22337,1661,20676,0.9256390741818508,9.531660444444444,800.9398453333333,19.09480461289071,127,5.300000000000007E-4
5,test_20231101_135207,11610969.png,368720,23932,344788,0.9350943805597743,3,4,84111,3494,80617,0.9584596545041671,22.325708444444444,3166.5979893333333,13.124874291967245,127,5.300000000000007E-4
6,test_20231101_135207,10350842.png,212614,5762,206852,0.9728992446405222,2,4,42529,847,41682,0.9800841778551106,19.409909333333335,2398.521546666667,14.33136736645771,127,5.300000000000007E-4
7,test_20231101_135207,10863862.png,317432,9872,307560,0.9689004259179919,2,4,66058,1435,64623,0.9782766659602168,26.91376177777778,4100.150074666667,12.002806077074947,127,5.300000000000007E-4
8,test_20231101_135207,11382381.png,312486,707,311779,0.9977374986399391,1,4,46745,94,46651,0.9979890897422184,21.82824,2521.273456,14.11460409284577,127,5.300000000000007E-4
9,test_20231101_135207,11079715.png,443815,115577,328238,0.7395829343307458,4,4,124136,16143,107993,0.8699571437777921,17.25776711111111,2193.2968,14.719829558750817,127,5.300000000000007E-4
10,test_20231101_135207,11551286.png,271883,347,271536,0.9987237157159513,1,3,40092,49,40043,0.9987778110346204,18.003251555555554,1874.2515253333333,15.402524879051395,127,5.300000000000007E-4
1,test_20231101_135207,10404007.png,502730,18927,483803,0.9623515604797804,2,4,61265,2745,58520,0.9551946462090917,25.943144888888888,3493.450917333333,12.698257150325322,127,5.400000000000008E-4
2,test_20231101_135207,1254659.png,342646,71622,271024,0.7909737746829089,3,4,80080,10031,70049,0.8747377622377622,21.243162666666667,3283.60104,12.96729976321864,127,5.400000000000008E-4
3,test_20231101_135207,10188041.png,221231,9369,211862,0.9576506005035461,2,4,41731,1321,40410,0.9683448755122092,11.097500444444444,1092.3682453333333,17.7471129396718,127,5.400000000000008E-4
4,test_20231101_135207,10287332.png,216980,12102,204878,0.944225274218822,2,4,22337,1661,20676,0.9256390741818508,9.531660444444444,800.9398453333333,19.09480461289071,127,5.400000000000008E-4
5,test_20231101_135207,11610969.png,368720,23932,344788,0.9350943805597743,2,4,84111,3494,80617,0.9584596545041671,22.325708444444444,3166.5979893333333,13.124874291967245,127,5.400000000000008E-4
6,test_20231101_135207,10350842.png,212614,5762,206852,0.9728992446405222,1,4,42529,847,41682,0.9800841778551106,19.409909333333335,2398.521546666667,14.33136736645771,127,5.400000000000008E-4
7,test_20231101_135207,10863862.png,317432,9872,307560,0.9689004259179919,2,4,66058,1435,64623,0.9782766659602168,26.91376177777778,4100.150074666667,12.002806077074947,127,5.400000000000008E-4
8,test_20231101_135207,11382381.png,312486,707,311779,0.9977374986399391,2,6,46745,94,46651,0.9979890897422184,21.82824,2521.273456,14.11460409284577,127,5.400000000000008E-4
9,test_20231101_135207,11079715.png,443815,115577,328238,0.7395829343307458,3,4,124136,16143,107993,0.8699571437777921,17.25776711111111,2193.2968,14.719829558750817,127,5.400000000000008E-4
10,test_20231101_135207,11551286.png,271883,347,271536,0.9987237157159513,1,4,40092,49,40043,0.9987778110346204,18.003251555555554,1874.2515253333333,15.402524879051395,127,5.400000000000008E-4
1,test_20231101_135208,10404007.png,502730,18927,483803,0.9623515604797804,3,3,61265,2745,58520,0.9551946462090917,25.943144888888888,3493.450917333333,12.698257150325322,127,5.500000000000008E-4
2,test_20231101_135208,1254659.png,342646,71622,271024,0.7909737746829089,3,4,80080,10031,70049,0.8747377622377622,21.243162666666667,3283.60104,12.96729976321864,127,5.500000000000008E-4
3,test_20231101_135208,10188041.png,221231,9369,211862,0.9576506005035461,2,3,41731,1321,40410,0.9683448755122092,11.097500444444444,1092.3682453333333,17.7471129396718,127,5.500000000000008E-4
4,test_20231101_135208,10287332.png,216980,12102,204878,0.944225274218822,2,4,22337,1661,20676,0.9256390741818508,9.531660444444444,800.9398453333333,19.09480461289071,127,5.500000000000008E-4
5,test_20231101_135208,11610969.png,368720,23932,344788,0.9350943805597743,3,4,84111,3494,80617,0.9584596545041671,22.325708444444444,3166.5979893333333,13.124874291967245,127,5.500000000000008E-4
6,test_20231101_135208,10350842.png,212614,5762,206852,0.9728992446405222,1,4,42529,847,41682,0.9800841778551106,19.409909333333335,2398.521546666667,14.33136736645771,127,5.500000000000008E-4
7,test_20231101_135208,10863862.png,317432,9872,307560,0.9689004259179919,1,3,66058,1435,64623,0.9782766659602168,26.91376177777778,4100.150074666667,12.002806077074947,127,5.500000000000008E-4
8,test_20231101_135208,11382381.png,312486,707,311779,0.9977374986399391,2,4,46745,94,46651,0.9979890897422184,21.82824,2521.273456,14.11460409284577,127,5.500000000000008E-4
9,test_20231101_135208,11079715.png,443815,115577,328238,0.7395829343307458,3,5,124136,16143,107993,0.8699571437777921,17.25776711111111,2193.2968,14.719829558750817,127,5.500000000000008E-4
10,test_20231101_135208,11551286.png,271883,347,271536,0.9987237157159513,1,3,40092,49,40043,0.9987778110346204,18.003251555555554,1874.2515253333333,15.402524879051395,127,5.500000000000008E-4
1,test_20231101_135209,10404007.png,502730,18927,483803,0.9623515604797804,2,4,61265,2745,58520,0.9551946462090917,25.943144888888888,3493.450917333333,12.698257150325322,127,5.600000000000008E-4
2,test_20231101_135209,1254659.png,342646,71622,271024,0.7909737746829089,3,3,80080,10031,70049,0.8747377622377622,21.243162666666667,3283.60104,12.96729976321864,127,5.600000000000008E-4
3,test_20231101_135209,10188041.png,221231,9369,211862,0.9576506005035461,2,4,41731,1321,40410,0.9683448755122092,11.097500444444444,1092.3682453333333,17.7471129396718,127,5.600000000000008E-4
4,test_20231101_135209,10287332.png,216980,12102,204878,0.944225274218822,2,3,22337,1661,20676,0.9256390741818508,9.531660444444444,800.9398453333333,19.09480461289071,127,5.600000000000008E-4
5,test_20231101_135209,11610969.png,368720,23932,344788,0.9350943805597743,2,4,84111,3494,80617,0.9584596545041671,22.325708444444444,3166.5979893333333,13.124874291967245,127,5.600000000000008E-4
6,test_20231101_135209,10350842.png,212614,5762,206852,0.9728992446405222,1,4,42529,847,41682,0.9800841778551106,19.409909333333335,2398.521546666667,14.33136736645771,127,5.600000000000008E-4
7,test_20231101_135209,10863862.png,317432,9872,307560,0.9689004259179919,2,3,66058,1435,64623,0.9782766659602168,26.91376177777778,4100.150074666667,12.002806077074947,127,5.600000000000008E-4
8,test_20231101_135209,11382381.png,312486,707,311779,0.9977374986399391,2,4,46745,94,46651,0.9979890897422184,21.82824,2521.273456,14.11460409284577,127,5.600000000000008E-4
9,test_20231101_135209,11079715.png,443815,115577,328238,0.7395829343307458,4,4,124136,16143,107993,0.8699571437777921,17.25776711111111,2193.2968,14.719829558750817,127,5.600000000000008E-4
10,test_20231101_135209,11551286.png,271883,347,271536,0.9987237157159513,1,4,40092,49,40043,0.9987778110346204,18.003251555555554,1874.2515253333333,15.402524879051395,127,5.600000000000008E-4
1,test_20231101_135209,10404007.png,502730,18927,483803,0.9623515604797804,2,4,61265,2745,58520,0.9551946462090917,25.943144888888888,3493.450917333333,12.698257150325322,127,5.700000000000008E-4
2,test_20231101_135209,1254659.png,342646,71622,271024,0.7909737746829089,3,4,80080,10031,70049,0.8747377622377622,21.243162666666667,3283.60104,12.96729976321864,127,5.700000000000008E-4
3,test_20231101_135209,10188041.png,221231,9369,211862,0.9576506005035461,2,3,41731,1321,40410,0.9683448755122092,11.097500444444444,1092.3682453333333,17.7471129396718,127,5.700000000000008E-4
4,test_20231101_135209,10287332.png,216980,12102,204878,0.944225274218822,1,3,22337,1661,20676,0.9256390741818508,9.531660444444444,800.9398453333333,19.09480461289071,127,5.700000000000008E-4
5,test_20231101_135209,11610969.png,368720,23932,344788,0.9350943805597743,3,4,84111,3494,80617,0.9584596545041671,22.325708444444444,3166.5979893333333,13.124874291967245,127,5.700000000000008E-4
6,test_20231101_135209,10350842.png,212614,5762,206852,0.9728992446405222,2,3,42529,847,41682,0.9800841778551106,19.409909333333335,2398.521546666667,14.33136736645771,127,5.700000000000008E-4
7,test_20231101_135209,10863862.png,317432,9872,307560,0.9689004259179919,1,3,66058,1435,64623,0.9782766659602168,26.91376177777778,4100.150074666667,12.002806077074947,127,5.700000000000008E-4
8,test_20231101_135209,11382381.png,312486,707,311779,0.9977374986399391,2,5,46745,94,46651,0.9979890897422184,21.82824,2521.273456,14.11460409284577,127,5.700000000000008E-4
9,test_20231101_135209,11079715.png,443815,115577,328238,0.7395829343307458,4,4,124136,16143,107993,0.8699571437777921,17.25776711111111,2193.2968,14.719829558750817,127,5.700000000000008E-4
10,test_20231101_135209,11551286.png,271883,347,271536,0.9987237157159513,1,4,40092,49,40043,0.9987778110346204,18.003251555555554,1874.2515253333333,15.402524879051395,127,5.700000000000008E-4
1,test_20231101_135210,10404007.png,502730,18927,483803,0.9623515604797804,2,4,61265,2745,58520,0.9551946462090917,25.943144888888888,3493.450917333333,12.698257150325322,127,5.800000000000009E-4
2,test_20231101_135210,1254659.png,342646,71622,271024,0.7909737746829089,3,4,80080,10031,70049,0.8747377622377622,21.243162666666667,3283.60104,12.96729976321864,127,5.800000000000009E-4
3,test_20231101_135210,10188041.png,221231,9369,211862,0.9576506005035461,2,4,41731,1321,40410,0.9683448755122092,11.097500444444444,1092.3682453333333,17.7471129396718,127,5.800000000000009E-4
4,test_20231101_135210,10287332.png,216980,12102,204878,0.944225274218822,2,3,22337,1661,20676,0.9256390741818508,9.531660444444444,800.9398453333333,19.09480461289071,127,5.800000000000009E-4
5,test_20231101_135210,11610969.png,368720,23932,344788,0.9350943805597743,2,4,84111,3494,80617,0.9584596545041671,22.325708444444444,3166.5979893333333,13.124874291967245,127,5.800000000000009E-4
6,test_20231101_135210,10350842.png,212614,5762,206852,0.9728992446405222,1,3,42529,847,41682,0.9800841778551106,19.409909333333335,2398.521546666667,14.33136736645771,127,5.800000000000009E-4
7,test_20231101_135210,10863862.png,317432,9872,307560,0.9689004259179919,3,4,66058,1435,64623,0.9782766659602168,26.91376177777778,4100.150074666667,12.002806077074947,127,5.800000000000009E-4
8,test_20231101_135210,11382381.png,312486,707,311779,0.9977374986399391,1,4,46745,94,46651,0.9979890897422184,21.82824,2521.273456,14.11460409284577,127,5.800000000000009E-4
9,test_20231101_135210,11079715.png,443815,115577,328238,0.7395829343307458,4,12,124136,16143,107993,0.8699571437777921,17.25776711111111,2193.2968,14.719829558750817,127,5.800000000000009E-4
10,test_20231101_135210,11551286.png,271883,347,271536,0.9987237157159513,1,3,40092,49,40043,0.9987778110346204,18.003251555555554,1874.2515253333333,15.402524879051395,127,5.800000000000009E-4
1,test_20231101_135211,10404007.png,502730,18927,483803,0.9623515604797804,2,4,61265,2745,58520,0.9551946462090917,25.943144888888888,3493.450917333333,12.698257150325322,127,5.900000000000009E-4
2,test_20231101_135211,1254659.png,342646,71622,271024,0.7909737746829089,3,4,80080,10031,70049,0.8747377622377622,21.243162666666667,3283.60104,12.96729976321864,127,5.900000000000009E-4
3,test_20231101_135211,10188041.png,221231,9369,211862,0.9576506005035461,2,4,41731,1321,40410,0.9683448755122092,11.097500444444444,1092.3682453333333,17.7471129396718,127,5.900000000000009E-4
4,test_20231101_135211,10287332.png,216980,12102,204878,0.944225274218822,1,3,22337,1661,20676,0.9256390741818508,9.531660444444444,800.9398453333333,19.09480461289071,127,5.900000000000009E-4
5,test_20231101_135211,11610969.png,368720,23932,344788,0.9350943805597743,2,4,84111,3494,80617,0.9584596545041671,22.325708444444444,3166.5979893333333,13.124874291967245,127,5.900000000000009E-4
6,test_20231101_135211,10350842.png,212614,5762,206852,0.9728992446405222,1,3,42529,847,41682,0.9800841778551106,19.409909333333335,2398.521546666667,14.33136736645771,127,5.900000000000009E-4
7,test_20231101_135211,10863862.png,317432,9872,307560,0.9689004259179919,2,4,66058,1435,64623,0.9782766659602168,26.91376177777778,4100.150074666667,12.002806077074947,127,5.900000000000009E-4
8,test_20231101_135211,11382381.png,312486,707,311779,0.9977374986399391,2,3,46745,94,46651,0.9979890897422184,21.82824,2521.273456,14.11460409284577,127,5.900000000000009E-4
9,test_20231101_135211,11079715.png,443815,115577,328238,0.7395829343307458,3,4,124136,16143,107993,0.8699571437777921,17.25776711111111,2193.2968,14.719829558750817,127,5.900000000000009E-4
10,test_20231101_135211,11551286.png,271883,347,271536,0.9987237157159513,1,4,40092,49,40043,0.9987778110346204,18.003251555555554,1874.2515253333333,15.402524879051395,127,5.900000000000009E-4
1,test_20231101_135211,10404007.png,502730,18927,483803,0.9623515604797804,2,3,61265,2745,58520,0.9551946462090917,25.943144888888888,3493.450917333333,12.698257150325322,127,6.000000000000009E-4
2,test_20231101_135211,1254659.png,342646,71622,271024,0.7909737746829089,3,4,80080,10031,70049,0.8747377622377622,21.243162666666667,3283.60104,12.96729976321864,127,6.000000000000009E-4
3,test_20231101_135211,10188041.png,221231,9369,211862,0.9576506005035461,2,4,41731,1321,40410,0.9683448755122092,11.097500444444444,1092.3682453333333,17.7471129396718,127,6.000000000000009E-4
4,test_20231101_135211,10287332.png,216980,12102,204878,0.944225274218822,2,3,22337,1661,20676,0.9256390741818508,9.531660444444444,800.9398453333333,19.09480461289071,127,6.000000000000009E-4
5,test_20231101_135211,11610969.png,368720,23932,344788,0.9350943805597743,3,4,84111,3494,80617,0.9584596545041671,22.325708444444444,3166.5979893333333,13.124874291967245,127,6.000000000000009E-4
6,test_20231101_135211,10350842.png,212614,5762,206852,0.9728992446405222,2,4,42529,847,41682,0.9800841778551106,19.409909333333335,2398.521546666667,14.33136736645771,127,6.000000000000009E-4
7,test_20231101_135211,10863862.png,317432,9872,307560,0.9689004259179919,2,4,66058,1435,64623,0.9782766659602168,26.91376177777778,4100.150074666667,12.002806077074947,127,6.000000000000009E-4
8,test_20231101_135211,11382381.png,312486,707,311779,0.9977374986399391,2,4,46745,94,46651,0.9979890897422184,21.82824,2521.273456,14.11460409284577,127,6.000000000000009E-4
9,test_20231101_135211,11079715.png,443815,115577,328238,0.7395829343307458,5,4,124136,16143,107993,0.8699571437777921,17.25776711111111,2193.2968,14.719829558750817,127,6.000000000000009E-4
10,test_20231101_135211,11551286.png,271883,347,271536,0.9987237157159513,1,4,40092,49,40043,0.9987778110346204,18.003251555555554,1874.2515253333333,15.402524879051395,127,6.000000000000009E-4
1,test_20231101_135212,10404007.png,502730,18927,483803,0.9623515604797804,3,3,61265,2745,58520,0.9551946462090917,25.943144888888888,3493.450917333333,12.698257150325322,127,6.10000000000001E-4
2,test_20231101_135212,1254659.png,342646,71622,271024,0.7909737746829089,3,4,80080,10031,70049,0.8747377622377622,21.243162666666667,3283.60104,12.96729976321864,127,6.10000000000001E-4
3,test_20231101_135212,10188041.png,221231,9369,211862,0.9576506005035461,2,3,41731,1321,40410,0.9683448755122092,11.097500444444444,1092.3682453333333,17.7471129396718,127,6.10000000000001E-4
4,test_20231101_135212,10287332.png,216980,12102,204878,0.944225274218822,2,4,22337,1661,20676,0.9256390741818508,9.531660444444444,800.9398453333333,19.09480461289071,127,6.10000000000001E-4
5,test_20231101_135212,11610969.png,368720,23932,344788,0.9350943805597743,2,3,84111,3494,80617,0.9584596545041671,22.325708444444444,3166.5979893333333,13.124874291967245,127,6.10000000000001E-4
6,test_20231101_135212,10350842.png,212614,5762,206852,0.9728992446405222,2,3,42529,847,41682,0.9800841778551106,19.409909333333335,2398.521546666667,14.33136736645771,127,6.10000000000001E-4
7,test_20231101_135212,10863862.png,317432,9872,307560,0.9689004259179919,2,4,66058,1435,64623,0.9782766659602168,26.91376177777778,4100.150074666667,12.002806077074947,127,6.10000000000001E-4
8,test_20231101_135212,11382381.png,312486,707,311779,0.9977374986399391,2,3,46745,94,46651,0.9979890897422184,21.82824,2521.273456,14.11460409284577,127,6.10000000000001E-4
9,test_20231101_135212,11079715.png,443815,115577,328238,0.7395829343307458,3,4,124136,16143,107993,0.8699571437777921,17.25776711111111,2193.2968,14.719829558750817,127,6.10000000000001E-4
10,test_20231101_135212,11551286.png,271883,347,271536,0.9987237157159513,1,4,40092,49,40043,0.9987778110346204,18.003251555555554,1874.2515253333333,15.402524879051395,127,6.10000000000001E-4
1,test_20231101_135213,10404007.png,502730,18927,483803,0.9623515604797804,2,4,61265,2745,58520,0.9551946462090917,25.943144888888888,3493.450917333333,12.698257150325322,127,6.20000000000001E-4
2,test_20231101_135213,1254659.png,342646,71622,271024,0.7909737746829089,2,4,80080,10031,70049,0.8747377622377622,21.243162666666667,3283.60104,12.96729976321864,127,6.20000000000001E-4
3,test_20231101_135213,10188041.png,221231,9369,211862,0.9576506005035461,2,3,41731,1321,40410,0.9683448755122092,11.097500444444444,1092.3682453333333,17.7471129396718,127,6.20000000000001E-4
4,test_20231101_135213,10287332.png,216980,12102,204878,0.944225274218822,2,4,22337,1661,20676,0.9256390741818508,9.531660444444444,800.9398453333333,19.09480461289071,127,6.20000000000001E-4
5,test_20231101_135213,11610969.png,368720,23932,344788,0.9350943805597743,2,4,84111,3494,80617,0.9584596545041671,22.325708444444444,3166.5979893333333,13.124874291967245,127,6.20000000000001E-4
6,test_20231101_135213,10350842.png,212614,5762,206852,0.9728992446405222,1,4,42529,847,41682,0.9800841778551106,19.409909333333335,2398.521546666667,14.33136736645771,127,6.20000000000001E-4
7,test_20231101_135213,10863862.png,317432,9872,307560,0.9689004259179919,2,3,66058,1435,64623,0.9782766659602168,26.91376177777778,4100.150074666667,12.002806077074947,127,6.20000000000001E-4
8,test_20231101_135213,11382381.png,312486,707,311779,0.9977374986399391,2,4,46745,94,46651,0.9979890897422184,21.82824,2521.273456,14.11460409284577,127,6.20000000000001E-4
9,test_20231101_135213,11079715.png,443815,115577,328238,0.7395829343307458,3,4,124136,16143,107993,0.8699571437777921,17.25776711111111,2193.2968,14.719829558750817,127,6.20000000000001E-4
10,test_20231101_135213,11551286.png,271883,347,271536,0.9987237157159513,1,4,40092,49,40043,0.9987778110346204,18.003251555555554,1874.2515253333333,15.402524879051395,127,6.20000000000001E-4
1,test_20231101_135214,10404007.png,502730,18927,483803,0.9623515604797804,2,4,61265,2745,58520,0.9551946462090917,25.943144888888888,3493.450917333333,12.698257150325322,127,6.30000000000001E-4
2,test_20231101_135214,1254659.png,342646,71622,271024,0.7909737746829089,3,4,80080,10031,70049,0.8747377622377622,21.243162666666667,3283.60104,12.96729976321864,127,6.30000000000001E-4
3,test_20231101_135214,10188041.png,221231,9369,211862,0.9576506005035461,3,4,41731,1321,40410,0.9683448755122092,11.097500444444444,1092.3682453333333,17.7471129396718,127,6.30000000000001E-4
4,test_20231101_135214,10287332.png,216980,12102,204878,0.944225274218822,1,5,22337,1661,20676,0.9256390741818508,9.531660444444444,800.9398453333333,19.09480461289071,127,6.30000000000001E-4
5,test_20231101_135214,11610969.png,368720,23932,344788,0.9350943805597743,2,4,84111,3494,80617,0.9584596545041671,22.325708444444444,3166.5979893333333,13.124874291967245,127,6.30000000000001E-4
6,test_20231101_135214,10350842.png,212614,5762,206852,0.9728992446405222,1,4,42529,847,41682,0.9800841778551106,19.409909333333335,2398.521546666667,14.33136736645771,127,6.30000000000001E-4
7,test_20231101_135214,10863862.png,317432,9872,307560,0.9689004259179919,2,4,66058,1435,64623,0.9782766659602168,26.91376177777778,4100.150074666667,12.002806077074947,127,6.30000000000001E-4
8,test_20231101_135214,11382381.png,312486,707,311779,0.9977374986399391,2,4,46745,94,46651,0.9979890897422184,21.82824,2521.273456,14.11460409284577,127,6.30000000000001E-4
9,test_20231101_135214,11079715.png,443815,115577,328238,0.7395829343307458,4,4,124136,16143,107993,0.8699571437777921,17.25776711111111,2193.2968,14.719829558750817,127,6.30000000000001E-4
10,test_20231101_135214,11551286.png,271883,347,271536,0.9987237157159513,1,3,40092,49,40043,0.9987778110346204,18.003251555555554,1874.2515253333333,15.402524879051395,127,6.30000000000001E-4
1,test_20231101_135214,10404007.png,502730,18927,483803,0.9623515604797804,2,4,61265,2745,58520,0.9551946462090917,25.943144888888888,3493.450917333333,12.698257150325322,127,6.40000000000001E-4
2,test_20231101_135214,1254659.png,342646,71622,271024,0.7909737746829089,3,3,80080,10031,70049,0.8747377622377622,21.243162666666667,3283.60104,12.96729976321864,127,6.40000000000001E-4
3,test_20231101_135214,10188041.png,221231,9369,211862,0.9576506005035461,2,4,41731,1321,40410,0.9683448755122092,11.097500444444444,1092.3682453333333,17.7471129396718,127,6.40000000000001E-4
4,test_20231101_135214,10287332.png,216980,12102,204878,0.944225274218822,2,3,22337,1661,20676,0.9256390741818508,9.531660444444444,800.9398453333333,19.09480461289071,127,6.40000000000001E-4
5,test_20231101_135214,11610969.png,368720,23932,344788,0.9350943805597743,3,4,84111,3494,80617,0.9584596545041671,22.325708444444444,3166.5979893333333,13.124874291967245,127,6.40000000000001E-4
6,test_20231101_135214,10350842.png,212614,5762,206852,0.9728992446405222,1,4,42529,847,41682,0.9800841778551106,19.409909333333335,2398.521546666667,14.33136736645771,127,6.40000000000001E-4
7,test_20231101_135214,10863862.png,317432,9872,307560,0.9689004259179919,2,4,66058,1435,64623,0.9782766659602168,26.91376177777778,4100.150074666667,12.002806077074947,127,6.40000000000001E-4
8,test_20231101_135214,11382381.png,312486,707,311779,0.9977374986399391,2,7,46745,94,46651,0.9979890897422184,21.82824,2521.273456,14.11460409284577,127,6.40000000000001E-4
9,test_20231101_135214,11079715.png,443815,115577,328238,0.7395829343307458,4,4,124136,16143,107993,0.8699571437777921,17.25776711111111,2193.2968,14.719829558750817,127,6.40000000000001E-4
10,test_20231101_135214,11551286.png,271883,347,271536,0.9987237157159513,1,4,40092,49,40043,0.9987778110346204,18.003251555555554,1874.2515253333333,15.402524879051395,127,6.40000000000001E-4
1,test_20231101_135215,10404007.png,502730,18927,483803,0.9623515604797804,2,4,61265,2745,58520,0.9551946462090917,25.943144888888888,3493.450917333333,12.698257150325322,127,6.500000000000011E-4
2,test_20231101_135215,1254659.png,342646,71622,271024,0.7909737746829089,3,4,80080,10031,70049,0.8747377622377622,21.243162666666667,3283.60104,12.96729976321864,127,6.500000000000011E-4
3,test_20231101_135215,10188041.png,221231,9369,211862,0.9576506005035461,2,4,41731,1321,40410,0.9683448755122092,11.097500444444444,1092.3682453333333,17.7471129396718,127,6.500000000000011E-4
4,test_20231101_135215,10287332.png,216980,12102,204878,0.944225274218822,2,4,22337,1661,20676,0.9256390741818508,9.531660444444444,800.9398453333333,19.09480461289071,127,6.500000000000011E-4
5,test_20231101_135215,11610969.png,368720,23932,344788,0.9350943805597743,3,4,84111,3494,80617,0.9584596545041671,22.325708444444444,3166.5979893333333,13.124874291967245,127,6.500000000000011E-4
6,test_20231101_135215,10350842.png,212614,5762,206852,0.9728992446405222,2,3,42529,847,41682,0.9800841778551106,19.409909333333335,2398.521546666667,14.33136736645771,127,6.500000000000011E-4
7,test_20231101_135215,10863862.png,317432,9872,307560,0.9689004259179919,2,3,66058,1435,64623,0.9782766659602168,26.91376177777778,4100.150074666667,12.002806077074947,127,6.500000000000011E-4
8,test_20231101_135215,11382381.png,312486,707,311779,0.9977374986399391,2,4,46745,94,46651,0.9979890897422184,21.82824,2521.273456,14.11460409284577,127,6.500000000000011E-4
9,test_20231101_135215,11079715.png,443815,115577,328238,0.7395829343307458,4,4,124136,16143,107993,0.8699571437777921,17.25776711111111,2193.2968,14.719829558750817,127,6.500000000000011E-4
10,test_20231101_135215,11551286.png,271883,347,271536,0.9987237157159513,1,4,40092,49,40043,0.9987778110346204,18.003251555555554,1874.2515253333333,15.402524879051395,127,6.500000000000011E-4
1,test_20231101_135216,10404007.png,502730,18927,483803,0.9623515604797804,2,3,61265,2745,58520,0.9551946462090917,25.943144888888888,3493.450917333333,12.698257150325322,127,6.600000000000011E-4
2,test_20231101_135216,1254659.png,342646,71622,271024,0.7909737746829089,3,4,80080,10031,70049,0.8747377622377622,21.243162666666667,3283.60104,12.96729976321864,127,6.600000000000011E-4
3,test_20231101_135216,10188041.png,221231,9369,211862,0.9576506005035461,2,4,41731,1321,40410,0.9683448755122092,11.097500444444444,1092.3682453333333,17.7471129396718,127,6.600000000000011E-4
4,test_20231101_135216,10287332.png,216980,12102,204878,0.944225274218822,1,3,22337,1661,20676,0.9256390741818508,9.531660444444444,800.9398453333333,19.09480461289071,127,6.600000000000011E-4
5,test_20231101_135216,11610969.png,368720,23932,344788,0.9350943805597743,3,3,84111,3494,80617,0.9584596545041671,22.325708444444444,3166.5979893333333,13.124874291967245,127,6.600000000000011E-4
6,test_20231101_135216,10350842.png,212614,5762,206852,0.9728992446405222,1,3,42529,847,41682,0.9800841778551106,19.409909333333335,2398.521546666667,14.33136736645771,127,6.600000000000011E-4
7,test_20231101_135216,10863862.png,317432,9872,307560,0.9689004259179919,2,4,66058,1435,64623,0.9782766659602168,26.91376177777778,4100.150074666667,12.002806077074947,127,6.600000000000011E-4
8,test_20231101_135216,11382381.png,312486,707,311779,0.9977374986399391,2,7,46745,94,46651,0.9979890897422184,21.82824,2521.273456,14.11460409284577,127,6.600000000000011E-4
9,test_20231101_135216,11079715.png,443815,115577,328238,0.7395829343307458,4,4,124136,16143,107993,0.8699571437777921,17.25776711111111,2193.2968,14.719829558750817,127,6.600000000000011E-4
10,test_20231101_135216,11551286.png,271883,347,271536,0.9987237157159513,1,3,40092,49,40043,0.9987778110346204,18.003251555555554,1874.2515253333333,15.402524879051395,127,6.600000000000011E-4
1,test_20231101_135216,10404007.png,502730,18927,483803,0.9623515604797804,2,3,61265,2745,58520,0.9551946462090917,25.943144888888888,3493.450917333333,12.698257150325322,127,6.700000000000011E-4
2,test_20231101_135216,1254659.png,342646,71622,271024,0.7909737746829089,3,4,80080,10031,70049,0.8747377622377622,21.243162666666667,3283.60104,12.96729976321864,127,6.700000000000011E-4
3,test_20231101_135216,10188041.png,221231,9369,211862,0.9576506005035461,2,3,41731,1321,40410,0.9683448755122092,11.097500444444444,1092.3682453333333,17.7471129396718,127,6.700000000000011E-4
4,test_20231101_135216,10287332.png,216980,12102,204878,0.944225274218822,2,4,22337,1661,20676,0.9256390741818508,9.531660444444444,800.9398453333333,19.09480461289071,127,6.700000000000011E-4
5,test_20231101_135216,11610969.png,368720,23932,344788,0.9350943805597743,3,3,84111,3494,80617,0.9584596545041671,22.325708444444444,3166.5979893333333,13.124874291967245,127,6.700000000000011E-4
6,test_20231101_135216,10350842.png,212614,5762,206852,0.9728992446405222,1,3,42529,847,41682,0.9800841778551106,19.409909333333335,2398.521546666667,14.33136736645771,127,6.700000000000011E-4
7,test_20231101_135216,10863862.png,317432,9872,307560,0.9689004259179919,2,4,66058,1435,64623,0.9782766659602168,26.91376177777778,4100.150074666667,12.002806077074947,127,6.700000000000011E-4
8,test_20231101_135216,11382381.png,312486,707,311779,0.9977374986399391,2,4,46745,94,46651,0.9979890897422184,21.82824,2521.273456,14.11460409284577,127,6.700000000000011E-4
9,test_20231101_135216,11079715.png,443815,115577,328238,0.7395829343307458,3,4,124136,16143,107993,0.8699571437777921,17.25776711111111,2193.2968,14.719829558750817,127,6.700000000000011E-4
10,test_20231101_135216,11551286.png,271883,347,271536,0.9987237157159513,1,3,40092,49,40043,0.9987778110346204,18.003251555555554,1874.2515253333333,15.402524879051395,127,6.700000000000011E-4
1,test_20231101_135217,10404007.png,502730,18927,483803,0.9623515604797804,2,3,61265,2745,58520,0.9551946462090917,25.943144888888888,3493.450917333333,12.698257150325322,127,6.800000000000011E-4
2,test_20231101_135217,1254659.png,342646,71622,271024,0.7909737746829089,3,4,80080,10031,70049,0.8747377622377622,21.243162666666667,3283.60104,12.96729976321864,127,6.800000000000011E-4
3,test_20231101_135217,10188041.png,221231,9369,211862,0.9576506005035461,2,4,41731,1321,40410,0.9683448755122092,11.097500444444444,1092.3682453333333,17.7471129396718,127,6.800000000000011E-4
4,test_20231101_135217,10287332.png,216980,12102,204878,0.944225274218822,1,3,22337,1661,20676,0.9256390741818508,9.531660444444444,800.9398453333333,19.09480461289071,127,6.800000000000011E-4
5,test_20231101_135217,11610969.png,368720,23932,344788,0.9350943805597743,3,3,84111,3494,80617,0.9584596545041671,22.325708444444444,3166.5979893333333,13.124874291967245,127,6.800000000000011E-4
6,test_20231101_135217,10350842.png,212614,5762,206852,0.9728992446405222,2,3,42529,847,41682,0.9800841778551106,19.409909333333335,2398.521546666667,14.33136736645771,127,6.800000000000011E-4
7,test_20231101_135217,10863862.png,317432,9872,307560,0.9689004259179919,1,3,66058,1435,64623,0.9782766659602168,26.91376177777778,4100.150074666667,12.002806077074947,127,6.800000000000011E-4
8,test_20231101_135217,11382381.png,312486,707,311779,0.9977374986399391,2,4,46745,94,46651,0.9979890897422184,21.82824,2521.273456,14.11460409284577,127,6.800000000000011E-4
9,test_20231101_135217,11079715.png,443815,115577,328238,0.7395829343307458,3,4,124136,16143,107993,0.8699571437777921,17.25776711111111,2193.2968,14.719829558750817,127,6.800000000000011E-4
10,test_20231101_135217,11551286.png,271883,347,271536,0.9987237157159513,2,3,40092,49,40043,0.9987778110346204,18.003251555555554,1874.2515253333333,15.402524879051395,127,6.800000000000011E-4
1,test_20231101_135218,10404007.png,502730,18927,483803,0.9623515604797804,3,3,61265,2745,58520,0.9551946462090917,25.943144888888888,3493.450917333333,12.698257150325322,127,6.900000000000012E-4
2,test_20231101_135218,1254659.png,342646,71622,271024,0.7909737746829089,3,4,80080,10031,70049,0.8747377622377622,21.243162666666667,3283.60104,12.96729976321864,127,6.900000000000012E-4
3,test_20231101_135218,10188041.png,221231,9369,211862,0.9576506005035461,2,3,41731,1321,40410,0.9683448755122092,11.097500444444444,1092.3682453333333,17.7471129396718,127,6.900000000000012E-4
4,test_20231101_135218,10287332.png,216980,12102,204878,0.944225274218822,1,3,22337,1661,20676,0.9256390741818508,9.531660444444444,800.9398453333333,19.09480461289071,127,6.900000000000012E-4
5,test_20231101_135218,11610969.png,368720,23932,344788,0.9350943805597743,2,4,84111,3494,80617,0.9584596545041671,22.325708444444444,3166.5979893333333,13.124874291967245,127,6.900000000000012E-4
6,test_20231101_135218,10350842.png,212614,5762,206852,0.9728992446405222,2,4,42529,847,41682,0.9800841778551106,19.409909333333335,2398.521546666667,14.33136736645771,127,6.900000000000012E-4
7,test_20231101_135218,10863862.png,317432,9872,307560,0.9689004259179919,2,4,66058,1435,64623,0.9782766659602168,26.91376177777778,4100.150074666667,12.002806077074947,127,6.900000000000012E-4
8,test_20231101_135218,11382381.png,312486,707,311779,0.9977374986399391,2,4,46745,94,46651,0.9979890897422184,21.82824,2521.273456,14.11460409284577,127,6.900000000000012E-4
9,test_20231101_135218,11079715.png,443815,115577,328238,0.7395829343307458,3,4,124136,16143,107993,0.8699571437777921,17.25776711111111,2193.2968,14.719829558750817,127,6.900000000000012E-4
10,test_20231101_135218,11551286.png,271883,347,271536,0.9987237157159513,1,13,40092,49,40043,0.9987778110346204,18.003251555555554,1874.2515253333333,15.402524879051395,127,6.900000000000012E-4
1,test_20231101_135218,10404007.png,502730,18927,483803,0.9623515604797804,2,3,61265,2745,58520,0.9551946462090917,25.943144888888888,3493.450917333333,12.698257150325322,127,7.000000000000012E-4
2,test_20231101_135218,1254659.png,342646,71622,271024,0.7909737746829089,3,5,80080,10031,70049,0.8747377622377622,21.243162666666667,3283.60104,12.96729976321864,127,7.000000000000012E-4
3,test_20231101_135218,10188041.png,221231,9369,211862,0.9576506005035461,2,3,41731,1321,40410,0.9683448755122092,11.097500444444444,1092.3682453333333,17.7471129396718,127,7.000000000000012E-4
4,test_20231101_135218,10287332.png,216980,12102,204878,0.944225274218822,2,4,22337,1661,20676,0.9256390741818508,9.531660444444444,800.9398453333333,19.09480461289071,127,7.000000000000012E-4
5,test_20231101_135218,11610969.png,368720,23932,344788,0.9350943805597743,2,4,84111,3494,80617,0.9584596545041671,22.325708444444444,3166.5979893333333,13.124874291967245,127,7.000000000000012E-4
6,test_20231101_135218,10350842.png,212614,5762,206852,0.9728992446405222,1,4,42529,847,41682,0.9800841778551106,19.409909333333335,2398.521546666667,14.33136736645771,127,7.000000000000012E-4
7,test_20231101_135218,10863862.png,317432,9872,307560,0.9689004259179919,2,3,66058,1435,64623,0.9782766659602168,26.91376177777778,4100.150074666667,12.002806077074947,127,7.000000000000012E-4
8,test_20231101_135218,11382381.png,312486,707,311779,0.9977374986399391,2,3,46745,94,46651,0.9979890897422184,21.82824,2521.273456,14.11460409284577,127,7.000000000000012E-4
9,test_20231101_135218,11079715.png,443815,115577,328238,0.7395829343307458,3,4,124136,16143,107993,0.8699571437777921,17.25776711111111,2193.2968,14.719829558750817,127,7.000000000000012E-4
10,test_20231101_135218,11551286.png,271883,347,271536,0.9987237157159513,2,4,40092,49,40043,0.9987778110346204,18.003251555555554,1874.2515253333333,15.402524879051395,127,7.000000000000012E-4
1,test_20231101_135219,10404007.png,502730,18927,483803,0.9623515604797804,3,3,61265,2745,58520,0.9551946462090917,25.943144888888888,3493.450917333333,12.698257150325322,127,7.100000000000012E-4
2,test_20231101_135219,1254659.png,342646,71622,271024,0.7909737746829089,3,4,80080,10031,70049,0.8747377622377622,21.243162666666667,3283.60104,12.96729976321864,127,7.100000000000012E-4
3,test_20231101_135219,10188041.png,221231,9369,211862,0.9576506005035461,2,4,41731,1321,40410,0.9683448755122092,11.097500444444444,1092.3682453333333,17.7471129396718,127,7.100000000000012E-4
4,test_20231101_135219,10287332.png,216980,12102,204878,0.944225274218822,2,3,22337,1661,20676,0.9256390741818508,9.531660444444444,800.9398453333333,19.09480461289071,127,7.100000000000012E-4
5,test_20231101_135219,11610969.png,368720,23932,344788,0.9350943805597743,3,3,84111,3494,80617,0.9584596545041671,22.325708444444444,3166.5979893333333,13.124874291967245,127,7.100000000000012E-4
6,test_20231101_135219,10350842.png,212614,5762,206852,0.9728992446405222,2,3,42529,847,41682,0.9800841778551106,19.409909333333335,2398.521546666667,14.33136736645771,127,7.100000000000012E-4
7,test_20231101_135219,10863862.png,317432,9872,307560,0.9689004259179919,2,4,66058,1435,64623,0.9782766659602168,26.91376177777778,4100.150074666667,12.002806077074947,127,7.100000000000012E-4
8,test_20231101_135219,11382381.png,312486,707,311779,0.9977374986399391,2,4,46745,94,46651,0.9979890897422184,21.82824,2521.273456,14.11460409284577,127,7.100000000000012E-4
9,test_20231101_135219,11079715.png,443815,115577,328238,0.7395829343307458,3,4,124136,16143,107993,0.8699571437777921,17.25776711111111,2193.2968,14.719829558750817,127,7.100000000000012E-4
10,test_20231101_135219,11551286.png,271883,347,271536,0.9987237157159513,2,4,40092,49,40043,0.9987778110346204,18.003251555555554,1874.2515253333333,15.402524879051395,127,7.100000000000012E-4
1,test_20231101_135220,10404007.png,502730,18927,483803,0.9623515604797804,2,13,61265,2745,58520,0.9551946462090917,25.943144888888888,3493.450917333333,12.698257150325322,127,7.200000000000012E-4
2,test_20231101_135220,1254659.png,342646,71622,271024,0.7909737746829089,3,4,80080,10031,70049,0.8747377622377622,21.243162666666667,3283.60104,12.96729976321864,127,7.200000000000012E-4
3,test_20231101_135220,10188041.png,221231,9369,211862,0.9576506005035461,2,3,41731,1321,40410,0.9683448755122092,11.097500444444444,1092.3682453333333,17.7471129396718,127,7.200000000000012E-4
4,test_20231101_135220,10287332.png,216980,12102,204878,0.944225274218822,2,4,22337,1661,20676,0.9256390741818508,9.531660444444444,800.9398453333333,19.09480461289071,127,7.200000000000012E-4
5,test_20231101_135220,11610969.png,368720,23932,344788,0.9350943805597743,2,12,84111,3494,80617,0.9584596545041671,22.325708444444444,3166.5979893333333,13.124874291967245,127,7.200000000000012E-4
6,test_20231101_135220,10350842.png,212614,5762,206852,0.9728992446405222,1,4,42529,847,41682,0.9800841778551106,19.409909333333335,2398.521546666667,14.33136736645771,127,7.200000000000012E-4
7,test_20231101_135220,10863862.png,317432,9872,307560,0.9689004259179919,2,4,66058,1435,64623,0.9782766659602168,26.91376177777778,4100.150074666667,12.002806077074947,127,7.200000000000012E-4
8,test_20231101_135220,11382381.png,312486,707,311779,0.9977374986399391,2,4,46745,94,46651,0.9979890897422184,21.82824,2521.273456,14.11460409284577,127,7.200000000000012E-4
9,test_20231101_135220,11079715.png,443815,115577,328238,0.7395829343307458,3,4,124136,16143,107993,0.8699571437777921,17.25776711111111,2193.2968,14.719829558750817,127,7.200000000000012E-4
10,test_20231101_135220,11551286.png,271883,347,271536,0.9987237157159513,1,4,40092,49,40043,0.9987778110346204,18.003251555555554,1874.2515253333333,15.402524879051395,127,7.200000000000012E-4
1,test_20231101_135220,10404007.png,502730,18927,483803,0.9623515604797804,2,3,61265,2745,58520,0.9551946462090917,25.943144888888888,3493.450917333333,12.698257150325322,127,7.300000000000013E-4
2,test_20231101_135220,1254659.png,342646,71622,271024,0.7909737746829089,3,5,80080,10031,70049,0.8747377622377622,21.243162666666667,3283.60104,12.96729976321864,127,7.300000000000013E-4
3,test_20231101_135220,10188041.png,221231,9369,211862,0.9576506005035461,2,4,41731,1321,40410,0.9683448755122092,11.097500444444444,1092.3682453333333,17.7471129396718,127,7.300000000000013E-4
4,test_20231101_135220,10287332.png,216980,12102,204878,0.944225274218822,2,4,22337,1661,20676,0.9256390741818508,9.531660444444444,800.9398453333333,19.09480461289071,127,7.300000000000013E-4
5,test_20231101_135220,11610969.png,368720,23932,344788,0.9350943805597743,3,4,84111,3494,80617,0.9584596545041671,22.325708444444444,3166.5979893333333,13.124874291967245,127,7.300000000000013E-4
6,test_20231101_135220,10350842.png,212614,5762,206852,0.9728992446405222,1,3,42529,847,41682,0.9800841778551106,19.409909333333335,2398.521546666667,14.33136736645771,127,7.300000000000013E-4
7,test_20231101_135220,10863862.png,317432,9872,307560,0.9689004259179919,2,4,66058,1435,64623,0.9782766659602168,26.91376177777778,4100.150074666667,12.002806077074947,127,7.300000000000013E-4
8,test_20231101_135220,11382381.png,312486,707,311779,0.9977374986399391,1,3,46745,94,46651,0.9979890897422184,21.82824,2521.273456,14.11460409284577,127,7.300000000000013E-4
9,test_20231101_135220,11079715.png,443815,115577,328238,0.7395829343307458,3,4,124136,16143,107993,0.8699571437777921,17.25776711111111,2193.2968,14.719829558750817,127,7.300000000000013E-4
10,test_20231101_135220,11551286.png,271883,347,271536,0.9987237157159513,1,3,40092,49,40043,0.9987778110346204,18.003251555555554,1874.2515253333333,15.402524879051395,127,7.300000000000013E-4
1,test_20231101_135221,10404007.png,502730,18927,483803,0.9623515604797804,3,3,61265,2745,58520,0.9551946462090917,25.943144888888888,3493.450917333333,12.698257150325322,127,7.400000000000013E-4
2,test_20231101_135221,1254659.png,342646,71622,271024,0.7909737746829089,3,4,80080,10031,70049,0.8747377622377622,21.243162666666667,3283.60104,12.96729976321864,127,7.400000000000013E-4
3,test_20231101_135221,10188041.png,221231,9369,211862,0.9576506005035461,2,3,41731,1321,40410,0.9683448755122092,11.097500444444444,1092.3682453333333,17.7471129396718,127,7.400000000000013E-4
4,test_20231101_135221,10287332.png,216980,12102,204878,0.944225274218822,1,3,22337,1661,20676,0.9256390741818508,9.531660444444444,800.9398453333333,19.09480461289071,127,7.400000000000013E-4
5,test_20231101_135221,11610969.png,368720,23932,344788,0.9350943805597743,2,4,84111,3494,80617,0.9584596545041671,22.325708444444444,3166.5979893333333,13.124874291967245,127,7.400000000000013E-4
6,test_20231101_135221,10350842.png,212614,5762,206852,0.9728992446405222,1,3,42529,847,41682,0.9800841778551106,19.409909333333335,2398.521546666667,14.33136736645771,127,7.400000000000013E-4
7,test_20231101_135221,10863862.png,317432,9872,307560,0.9689004259179919,2,4,66058,1435,64623,0.9782766659602168,26.91376177777778,4100.150074666667,12.002806077074947,127,7.400000000000013E-4
8,test_20231101_135221,11382381.png,312486,707,311779,0.9977374986399391,2,4,46745,94,46651,0.9979890897422184,21.82824,2521.273456,14.11460409284577,127,7.400000000000013E-4
9,test_20231101_135221,11079715.png,443815,115577,328238,0.7395829343307458,4,5,124136,16143,107993,0.8699571437777921,17.25776711111111,2193.2968,14.719829558750817,127,7.400000000000013E-4
10,test_20231101_135221,11551286.png,271883,347,271536,0.9987237157159513,1,4,40092,49,40043,0.9987778110346204,18.003251555555554,1874.2515253333333,15.402524879051395,127,7.400000000000013E-4
1,test_20231101_135222,10404007.png,502730,18927,483803,0.9623515604797804,3,4,61265,2745,58520,0.9551946462090917,25.943144888888888,3493.450917333333,12.698257150325322,127,7.500000000000013E-4
2,test_20231101_135222,1254659.png,342646,71622,271024,0.7909737746829089,3,4,80080,10031,70049,0.8747377622377622,21.243162666666667,3283.60104,12.96729976321864,127,7.500000000000013E-4
3,test_20231101_135222,10188041.png,221231,9369,211862,0.9576506005035461,2,3,41731,1321,40410,0.9683448755122092,11.097500444444444,1092.3682453333333,17.7471129396718,127,7.500000000000013E-4
4,test_20231101_135222,10287332.png,216980,12102,204878,0.944225274218822,1,4,22337,1661,20676,0.9256390741818508,9.531660444444444,800.9398453333333,19.09480461289071,127,7.500000000000013E-4
5,test_20231101_135222,11610969.png,368720,23932,344788,0.9350943805597743,2,3,84111,3494,80617,0.9584596545041671,22.325708444444444,3166.5979893333333,13.124874291967245,127,7.500000000000013E-4
6,test_20231101_135222,10350842.png,212614,5762,206852,0.9728992446405222,1,4,42529,847,41682,0.9800841778551106,19.409909333333335,2398.521546666667,14.33136736645771,127,7.500000000000013E-4
7,test_20231101_135222,10863862.png,317432,9872,307560,0.9689004259179919,2,4,66058,1435,64623,0.9782766659602168,26.91376177777778,4100.150074666667,12.002806077074947,127,7.500000000000013E-4
8,test_20231101_135222,11382381.png,312486,707,311779,0.9977374986399391,2,4,46745,94,46651,0.9979890897422184,21.82824,2521.273456,14.11460409284577,127,7.500000000000013E-4
9,test_20231101_135222,11079715.png,443815,115577,328238,0.7395829343307458,3,4,124136,16143,107993,0.8699571437777921,17.25776711111111,2193.2968,14.719829558750817,127,7.500000000000013E-4
10,test_20231101_135222,11551286.png,271883,347,271536,0.9987237157159513,1,4,40092,49,40043,0.9987778110346204,18.003251555555554,1874.2515253333333,15.402524879051395,127,7.500000000000013E-4
1,test_20231101_135222,10404007.png,502730,18787,483943,0.9626300399816999,2,3,61265,2725,58540,0.9555210968742349,25.948243555555557,3494.5898933333333,12.69684144309177,127,7.600000000000013E-4
2,test_20231101_135222,1254659.png,342646,71622,271024,0.7909737746829089,3,4,80080,10031,70049,0.8747377622377622,21.243162666666667,3283.60104,12.96729976321864,127,7.600000000000013E-4
3,test_20231101_135222,10188041.png,221231,9247,211984,0.9582020602899232,2,3,41731,1303,40428,0.9687762095324819,11.192359111111111,1116.2391146666666,17.653231241007596,127,7.600000000000013E-4
4,test_20231101_135222,10287332.png,216980,12102,204878,0.944225274218822,2,3,22337,1661,20676,0.9256390741818508,9.531660444444444,800.9398453333333,19.09480461289071,127,7.600000000000013E-4
5,test_20231101_135222,11610969.png,368720,23889,344831,0.9352110002169668,2,3,84111,3492,80619,0.9584834326069123,22.703738666666666,3229.710629333333,13.039167480456243,127,7.600000000000013E-4
6,test_20231101_135222,10350842.png,212614,5762,206852,0.9728992446405222,2,4,42529,847,41682,0.9800841778551106,19.409909333333335,2398.521546666667,14.33136736645771,127,7.600000000000013E-4
7,test_20231101_135222,10863862.png,317432,9872,307560,0.9689004259179919,2,3,66058,1435,64623,0.9782766659602168,26.91376177777778,4100.150074666667,12.002806077074947,127,7.600000000000013E-4
8,test_20231101_135222,11382381.png,312486,707,311779,0.9977374986399391,1,4,46745,94,46651,0.9979890897422184,21.82824,2521.273456,14.11460409284577,127,7.600000000000013E-4
9,test_20231101_135222,11079715.png,443815,115577,328238,0.7395829343307458,3,4,124136,16143,107993,0.8699571437777921,17.25776711111111,2193.2968,14.719829558750817,127,7.600000000000013E-4
10,test_20231101_135222,11551286.png,271883,347,271536,0.9987237157159513,1,3,40092,49,40043,0.9987778110346204,18.003251555555554,1874.2515253333333,15.402524879051395,127,7.600000000000013E-4
1,test_20231101_135223,10404007.png,502730,18787,483943,0.9626300399816999,2,4,61265,2725,58540,0.9555210968742349,25.948243555555557,3494.5898933333333,12.69684144309177,127,7.700000000000014E-4
2,test_20231101_135223,1254659.png,342646,71622,271024,0.7909737746829089,3,4,80080,10031,70049,0.8747377622377622,21.243162666666667,3283.60104,12.96729976321864,127,7.700000000000014E-4
3,test_20231101_135223,10188041.png,221231,9147,212084,0.9586540765082652,2,4,41731,1291,40440,0.9690637655459969,11.23984711111111,1121.446144,17.633019388786877,127,7.700000000000014E-4
4,test_20231101_135223,10287332.png,216980,12102,204878,0.944225274218822,1,3,22337,1661,20676,0.9256390741818508,9.531660444444444,800.9398453333333,19.09480461289071,127,7.700000000000014E-4
5,test_20231101_135223,11610969.png,368720,23889,344831,0.9352110002169668,2,3,84111,3492,80619,0.9584834326069123,22.703738666666666,3229.710629333333,13.039167480456243,127,7.700000000000014E-4
6,test_20231101_135223,10350842.png,212614,5762,206852,0.9728992446405222,2,3,42529,847,41682,0.9800841778551106,19.409909333333335,2398.521546666667,14.33136736645771,127,7.700000000000014E-4
7,test_20231101_135223,10863862.png,317432,9872,307560,0.9689004259179919,1,3,66058,1435,64623,0.9782766659602168,26.91376177777778,4100.150074666667,12.002806077074947,127,7.700000000000014E-4
8,test_20231101_135223,11382381.png,312486,707,311779,0.9977374986399391,1,4,46745,94,46651,0.9979890897422184,21.82824,2521.273456,14.11460409284577,127,7.700000000000014E-4
9,test_20231101_135223,11079715.png,443815,115577,328238,0.7395829343307458,3,4,124136,16143,107993,0.8699571437777921,17.25776711111111,2193.2968,14.719829558750817,127,7.700000000000014E-4
10,test_20231101_135223,11551286.png,271883,347,271536,0.9987237157159513,1,3,40092,49,40043,0.9987778110346204,18.003251555555554,1874.2515253333333,15.402524879051395,127,7.700000000000014E-4
1,test_20231101_135224,10404007.png,502730,18787,483943,0.9626300399816999,2,4,61265,2725,58540,0.9555210968742349,25.948243555555557,3494.5898933333333,12.69684144309177,127,7.800000000000014E-4
2,test_20231101_135224,1254659.png,342646,71622,271024,0.7909737746829089,3,4,80080,10031,70049,0.8747377622377622,21.243162666666667,3283.60104,12.96729976321864,127,7.800000000000014E-4
3,test_20231101_135224,10188041.png,221231,9147,212084,0.9586540765082652,2,4,41731,1291,40440,0.9690637655459969,11.23984711111111,1121.446144,17.633019388786877,127,7.800000000000014E-4
4,test_20231101_135224,10287332.png,216980,12102,204878,0.944225274218822,2,4,22337,1661,20676,0.9256390741818508,9.531660444444444,800.9398453333333,19.09480461289071,127,7.800000000000014E-4
5,test_20231101_135224,11610969.png,368720,23889,344831,0.9352110002169668,2,4,84111,3492,80619,0.9584834326069123,22.703738666666666,3229.710629333333,13.039167480456243,127,7.800000000000014E-4
6,test_20231101_135224,10350842.png,212614,5762,206852,0.9728992446405222,1,3,42529,847,41682,0.9800841778551106,19.409909333333335,2398.521546666667,14.33136736645771,127,7.800000000000014E-4
7,test_20231101_135224,10863862.png,317432,9872,307560,0.9689004259179919,2,4,66058,1435,64623,0.9782766659602168,26.91376177777778,4100.150074666667,12.002806077074947,127,7.800000000000014E-4
8,test_20231101_135224,11382381.png,312486,707,311779,0.9977374986399391,1,3,46745,94,46651,0.9979890897422184,21.82824,2521.273456,14.11460409284577,127,7.800000000000014E-4
9,test_20231101_135224,11079715.png,443815,115577,328238,0.7395829343307458,3,4,124136,16143,107993,0.8699571437777921,17.25776711111111,2193.2968,14.719829558750817,127,7.800000000000014E-4
10,test_20231101_135224,11551286.png,271883,347,271536,0.9987237157159513,1,3,40092,49,40043,0.9987778110346204,18.003251555555554,1874.2515253333333,15.402524879051395,127,7.800000000000014E-4
1,test_20231101_135224,10404007.png,502730,18787,483943,0.9626300399816999,3,3,61265,2725,58540,0.9555210968742349,25.948243555555557,3494.5898933333333,12.69684144309177,127,7.900000000000014E-4
2,test_20231101_135224,1254659.png,342646,71622,271024,0.7909737746829089,3,4,80080,10031,70049,0.8747377622377622,21.243162666666667,3283.60104,12.96729976321864,127,7.900000000000014E-4
3,test_20231101_135224,10188041.png,221231,9147,212084,0.9586540765082652,1,3,41731,1291,40440,0.9690637655459969,11.23984711111111,1121.446144,17.633019388786877,127,7.900000000000014E-4
4,test_20231101_135224,10287332.png,216980,12102,204878,0.944225274218822,2,4,22337,1661,20676,0.9256390741818508,9.531660444444444,800.9398453333333,19.09480461289071,127,7.900000000000014E-4
5,test_20231101_135224,11610969.png,368720,23889,344831,0.9352110002169668,3,4,84111,3492,80619,0.9584834326069123,22.703738666666666,3229.710629333333,13.039167480456243,127,7.900000000000014E-4
6,test_20231101_135224,10350842.png,212614,5762,206852,0.9728992446405222,2,4,42529,847,41682,0.9800841778551106,19.409909333333335,2398.521546666667,14.33136736645771,127,7.900000000000014E-4
7,test_20231101_135224,10863862.png,317432,9872,307560,0.9689004259179919,2,4,66058,1435,64623,0.9782766659602168,26.91376177777778,4100.150074666667,12.002806077074947,127,7.900000000000014E-4
8,test_20231101_135224,11382381.png,312486,707,311779,0.9977374986399391,2,3,46745,94,46651,0.9979890897422184,21.82824,2521.273456,14.11460409284577,127,7.900000000000014E-4
9,test_20231101_135224,11079715.png,443815,115577,328238,0.7395829343307458,4,4,124136,16143,107993,0.8699571437777921,17.25776711111111,2193.2968,14.719829558750817,127,7.900000000000014E-4
10,test_20231101_135224,11551286.png,271883,347,271536,0.9987237157159513,2,3,40092,49,40043,0.9987778110346204,18.003251555555554,1874.2515253333333,15.402524879051395,127,7.900000000000014E-4
1,test_20231101_135225,10404007.png,502730,18787,483943,0.9626300399816999,2,3,61265,2725,58540,0.9555210968742349,25.948243555555557,3494.5898933333333,12.69684144309177,127,8.000000000000014E-4
2,test_20231101_135225,1254659.png,342646,71622,271024,0.7909737746829089,3,4,80080,10031,70049,0.8747377622377622,21.243162666666667,3283.60104,12.96729976321864,127,8.000000000000014E-4
3,test_20231101_135225,10188041.png,221231,9147,212084,0.9586540765082652,2,3,41731,1291,40440,0.9690637655459969,11.23984711111111,1121.446144,17.633019388786877,127,8.000000000000014E-4
4,test_20231101_135225,10287332.png,216980,12102,204878,0.944225274218822,2,4,22337,1661,20676,0.9256390741818508,9.531660444444444,800.9398453333333,19.09480461289071,127,8.000000000000014E-4
5,test_20231101_135225,11610969.png,368720,23889,344831,0.9352110002169668,2,3,84111,3492,80619,0.9584834326069123,22.703738666666666,3229.710629333333,13.039167480456243,127,8.000000000000014E-4
6,test_20231101_135225,10350842.png,212614,5762,206852,0.9728992446405222,2,3,42529,847,41682,0.9800841778551106,19.409909333333335,2398.521546666667,14.33136736645771,127,8.000000000000014E-4
7,test_20231101_135225,10863862.png,317432,9872,307560,0.9689004259179919,2,4,66058,1435,64623,0.9782766659602168,26.91376177777778,4100.150074666667,12.002806077074947,127,8.000000000000014E-4
8,test_20231101_135225,11382381.png,312486,707,311779,0.9977374986399391,1,4,46745,94,46651,0.9979890897422184,21.82824,2521.273456,14.11460409284577,127,8.000000000000014E-4
9,test_20231101_135225,11079715.png,443815,115577,328238,0.7395829343307458,3,4,124136,16143,107993,0.8699571437777921,17.25776711111111,2193.2968,14.719829558750817,127,8.000000000000014E-4
10,test_20231101_135225,11551286.png,271883,347,271536,0.9987237157159513,1,4,40092,49,40043,0.9987778110346204,18.003251555555554,1874.2515253333333,15.402524879051395,127,8.000000000000014E-4
1,test_20231101_135226,10404007.png,502730,18787,483943,0.9626300399816999,2,4,61265,2725,58540,0.9555210968742349,25.948243555555557,3494.5898933333333,12.69684144309177,127,8.100000000000015E-4
2,test_20231101_135226,1254659.png,342646,71622,271024,0.7909737746829089,3,6,80080,10031,70049,0.8747377622377622,21.243162666666667,3283.60104,12.96729976321864,127,8.100000000000015E-4
3,test_20231101_135226,10188041.png,221231,9147,212084,0.9586540765082652,2,4,41731,1291,40440,0.9690637655459969,11.23984711111111,1121.446144,17.633019388786877,127,8.100000000000015E-4
4,test_20231101_135226,10287332.png,216980,12102,204878,0.944225274218822,1,4,22337,1661,20676,0.9256390741818508,9.531660444444444,800.9398453333333,19.09480461289071,127,8.100000000000015E-4
5,test_20231101_135226,11610969.png,368720,23889,344831,0.9352110002169668,3,3,84111,3492,80619,0.9584834326069123,22.703738666666666,3229.710629333333,13.039167480456243,127,8.100000000000015E-4
6,test_20231101_135226,10350842.png,212614,5762,206852,0.9728992446405222,2,4,42529,847,41682,0.9800841778551106,19.409909333333335,2398.521546666667,14.33136736645771,127,8.100000000000015E-4
7,test_20231101_135226,10863862.png,317432,9872,307560,0.9689004259179919,2,4,66058,1435,64623,0.9782766659602168,26.91376177777778,4100.150074666667,12.002806077074947,127,8.100000000000015E-4
8,test_20231101_135226,11382381.png,312486,707,311779,0.9977374986399391,1,4,46745,94,46651,0.9979890897422184,21.82824,2521.273456,14.11460409284577,127,8.100000000000015E-4
9,test_20231101_135226,11079715.png,443815,115577,328238,0.7395829343307458,4,4,124136,16143,107993,0.8699571437777921,17.25776711111111,2193.2968,14.719829558750817,127,8.100000000000015E-4
10,test_20231101_135226,11551286.png,271883,347,271536,0.9987237157159513,1,9,40092,49,40043,0.9987778110346204,18.003251555555554,1874.2515253333333,15.402524879051395,127,8.100000000000015E-4
1,test_20231101_135227,10404007.png,502730,18787,483943,0.9626300399816999,2,3,61265,2725,58540,0.9555210968742349,25.948243555555557,3494.5898933333333,12.69684144309177,127,8.200000000000015E-4
2,test_20231101_135227,1254659.png,342646,71622,271024,0.7909737746829089,3,3,80080,10031,70049,0.8747377622377622,21.243162666666667,3283.60104,12.96729976321864,127,8.200000000000015E-4
3,test_20231101_135227,10188041.png,221231,9147,212084,0.9586540765082652,1,3,41731,1291,40440,0.9690637655459969,11.23984711111111,1121.446144,17.633019388786877,127,8.200000000000015E-4
4,test_20231101_135227,10287332.png,216980,12102,204878,0.944225274218822,2,4,22337,1661,20676,0.9256390741818508,9.531660444444444,800.9398453333333,19.09480461289071,127,8.200000000000015E-4
5,test_20231101_135227,11610969.png,368720,23889,344831,0.9352110002169668,2,5,84111,3492,80619,0.9584834326069123,22.703738666666666,3229.710629333333,13.039167480456243,127,8.200000000000015E-4
6,test_20231101_135227,10350842.png,212614,5762,206852,0.9728992446405222,2,4,42529,847,41682,0.9800841778551106,19.409909333333335,2398.521546666667,14.33136736645771,127,8.200000000000015E-4
7,test_20231101_135227,10863862.png,317432,9872,307560,0.9689004259179919,2,3,66058,1435,64623,0.9782766659602168,26.91376177777778,4100.150074666667,12.002806077074947,127,8.200000000000015E-4
8,test_20231101_135227,11382381.png,312486,707,311779,0.9977374986399391,1,3,46745,94,46651,0.9979890897422184,21.82824,2521.273456,14.11460409284577,127,8.200000000000015E-4
9,test_20231101_135227,11079715.png,443815,115577,328238,0.7395829343307458,4,4,124136,16143,107993,0.8699571437777921,17.25776711111111,2193.2968,14.719829558750817,127,8.200000000000015E-4
10,test_20231101_135227,11551286.png,271883,347,271536,0.9987237157159513,1,4,40092,49,40043,0.9987778110346204,18.003251555555554,1874.2515253333333,15.402524879051395,127,8.200000000000015E-4
1,test_20231101_135227,10404007.png,502730,18787,483943,0.9626300399816999,2,4,61265,2725,58540,0.9555210968742349,25.948243555555557,3494.5898933333333,12.69684144309177,127,8.300000000000015E-4
2,test_20231101_135227,1254659.png,342646,71622,271024,0.7909737746829089,3,4,80080,10031,70049,0.8747377622377622,21.243162666666667,3283.60104,12.96729976321864,127,8.300000000000015E-4
3,test_20231101_135227,10188041.png,221231,9147,212084,0.9586540765082652,2,4,41731,1291,40440,0.9690637655459969,11.23984711111111,1121.446144,17.633019388786877,127,8.300000000000015E-4
4,test_20231101_135227,10287332.png,216980,12102,204878,0.944225274218822,2,4,22337,1661,20676,0.9256390741818508,9.531660444444444,800.9398453333333,19.09480461289071,127,8.300000000000015E-4
5,test_20231101_135227,11610969.png,368720,23889,344831,0.9352110002169668,2,3,84111,3492,80619,0.9584834326069123,22.703738666666666,3229.710629333333,13.039167480456243,127,8.300000000000015E-4
6,test_20231101_135227,10350842.png,212614,5762,206852,0.9728992446405222,1,7,42529,847,41682,0.9800841778551106,19.409909333333335,2398.521546666667,14.33136736645771,127,8.300000000000015E-4
7,test_20231101_135227,10863862.png,317432,9872,307560,0.9689004259179919,2,4,66058,1435,64623,0.9782766659602168,26.91376177777778,4100.150074666667,12.002806077074947,127,8.300000000000015E-4
8,test_20231101_135227,11382381.png,312486,707,311779,0.9977374986399391,1,3,46745,94,46651,0.9979890897422184,21.82824,2521.273456,14.11460409284577,127,8.300000000000015E-4
9,test_20231101_135227,11079715.png,443815,115577,328238,0.7395829343307458,3,5,124136,16143,107993,0.8699571437777921,17.25776711111111,2193.2968,14.719829558750817,127,8.300000000000015E-4
10,test_20231101_135227,11551286.png,271883,347,271536,0.9987237157159513,1,4,40092,49,40043,0.9987778110346204,18.003251555555554,1874.2515253333333,15.402524879051395,127,8.300000000000015E-4
1,test_20231101_135228,10404007.png,502730,18787,483943,0.9626300399816999,3,8,61265,2725,58540,0.9555210968742349,25.948243555555557,3494.5898933333333,12.69684144309177,127,8.400000000000016E-4
2,test_20231101_135228,1254659.png,342646,71622,271024,0.7909737746829089,3,4,80080,10031,70049,0.8747377622377622,21.243162666666667,3283.60104,12.96729976321864,127,8.400000000000016E-4
3,test_20231101_135228,10188041.png,221231,9147,212084,0.9586540765082652,2,4,41731,1291,40440,0.9690637655459969,11.23984711111111,1121.446144,17.633019388786877,127,8.400000000000016E-4
4,test_20231101_135228,10287332.png,216980,12102,204878,0.944225274218822,1,4,22337,1661,20676,0.9256390741818508,9.531660444444444,800.9398453333333,19.09480461289071,127,8.400000000000016E-4
5,test_20231101_135228,11610969.png,368720,23889,344831,0.9352110002169668,2,4,84111,3492,80619,0.9584834326069123,22.703738666666666,3229.710629333333,13.039167480456243,127,8.400000000000016E-4
6,test_20231101_135228,10350842.png,212614,4697,207917,0.9779083221236607,2,4,42529,690,41839,0.9837757765289568,22.476488888888888,3141.140741333333,13.15992965120445,127,8.400000000000016E-4
7,test_20231101_135228,10863862.png,317432,9872,307560,0.9689004259179919,2,3,66058,1435,64623,0.9782766659602168,26.91376177777778,4100.150074666667,12.002806077074947,127,8.400000000000016E-4
8,test_20231101_135228,11382381.png,312486,707,311779,0.9977374986399391,1,4,46745,94,46651,0.9979890897422184,21.82824,2521.273456,14.11460409284577,127,8.400000000000016E-4
9,test_20231101_135228,11079715.png,443815,115577,328238,0.7395829343307458,3,4,124136,16143,107993,0.8699571437777921,17.25776711111111,2193.2968,14.719829558750817,127,8.400000000000016E-4
10,test_20231101_135228,11551286.png,271883,347,271536,0.9987237157159513,1,4,40092,49,40043,0.9987778110346204,18.003251555555554,1874.2515253333333,15.402524879051395,127,8.400000000000016E-4
1,test_20231101_135229,10404007.png,502730,18787,483943,0.9626300399816999,2,4,61265,2725,58540,0.9555210968742349,25.948243555555557,3494.5898933333333,12.69684144309177,127,8.500000000000016E-4
2,test_20231101_135229,1254659.png,342646,71622,271024,0.7909737746829089,2,3,80080,10031,70049,0.8747377622377622,21.243162666666667,3283.60104,12.96729976321864,127,8.500000000000016E-4
3,test_20231101_135229,10188041.png,221231,9147,212084,0.9586540765082652,2,4,41731,1291,40440,0.9690637655459969,11.23984711111111,1121.446144,17.633019388786877,127,8.500000000000016E-4
4,test_20231101_135229,10287332.png,216980,12102,204878,0.944225274218822,2,4,22337,1661,20676,0.9256390741818508,9.531660444444444,800.9398453333333,19.09480461289071,127,8.500000000000016E-4
5,test_20231101_135229,11610969.png,368720,23889,344831,0.9352110002169668,2,4,84111,3492,80619,0.9584834326069123,22.703738666666666,3229.710629333333,13.039167480456243,127,8.500000000000016E-4
6,test_20231101_135229,10350842.png,212614,4697,207917,0.9779083221236607,1,4,42529,690,41839,0.9837757765289568,22.476488888888888,3141.140741333333,13.15992965120445,127,8.500000000000016E-4
7,test_20231101_135229,10863862.png,317432,9872,307560,0.9689004259179919,3,4,66058,1435,64623,0.9782766659602168,26.91376177777778,4100.150074666667,12.002806077074947,127,8.500000000000016E-4
8,test_20231101_135229,11382381.png,312486,707,311779,0.9977374986399391,1,3,46745,94,46651,0.9979890897422184,21.82824,2521.273456,14.11460409284577,127,8.500000000000016E-4
9,test_20231101_135229,11079715.png,443815,115577,328238,0.7395829343307458,3,4,124136,16143,107993,0.8699571437777921,17.25776711111111,2193.2968,14.719829558750817,127,8.500000000000016E-4
10,test_20231101_135229,11551286.png,271883,347,271536,0.9987237157159513,1,3,40092,49,40043,0.9987778110346204,18.003251555555554,1874.2515253333333,15.402524879051395,127,8.500000000000016E-4
1,test_20231101_135229,10404007.png,502730,18787,483943,0.9626300399816999,3,4,61265,2725,58540,0.9555210968742349,25.948243555555557,3494.5898933333333,12.69684144309177,127,8.600000000000016E-4
2,test_20231101_135229,1254659.png,342646,71622,271024,0.7909737746829089,4,4,80080,10031,70049,0.8747377622377622,21.243162666666667,3283.60104,12.96729976321864,127,8.600000000000016E-4
3,test_20231101_135229,10188041.png,221231,9147,212084,0.9586540765082652,2,4,41731,1291,40440,0.9690637655459969,11.23984711111111,1121.446144,17.633019388786877,127,8.600000000000016E-4
4,test_20231101_135229,10287332.png,216980,12102,204878,0.944225274218822,2,4,22337,1661,20676,0.9256390741818508,9.531660444444444,800.9398453333333,19.09480461289071,127,8.600000000000016E-4
5,test_20231101_135229,11610969.png,368720,23889,344831,0.9352110002169668,3,4,84111,3492,80619,0.9584834326069123,22.703738666666666,3229.710629333333,13.039167480456243,127,8.600000000000016E-4
6,test_20231101_135229,10350842.png,212614,4697,207917,0.9779083221236607,2,4,42529,690,41839,0.9837757765289568,22.476488888888888,3141.140741333333,13.15992965120445,127,8.600000000000016E-4
7,test_20231101_135229,10863862.png,317432,9872,307560,0.9689004259179919,2,4,66058,1435,64623,0.9782766659602168,26.91376177777778,4100.150074666667,12.002806077074947,127,8.600000000000016E-4
8,test_20231101_135229,11382381.png,312486,707,311779,0.9977374986399391,1,3,46745,94,46651,0.9979890897422184,21.82824,2521.273456,14.11460409284577,127,8.600000000000016E-4
9,test_20231101_135229,11079715.png,443815,115577,328238,0.7395829343307458,4,5,124136,16143,107993,0.8699571437777921,17.25776711111111,2193.2968,14.719829558750817,127,8.600000000000016E-4
10,test_20231101_135229,11551286.png,271883,347,271536,0.9987237157159513,1,4,40092,49,40043,0.9987778110346204,18.003251555555554,1874.2515253333333,15.402524879051395,127,8.600000000000016E-4
1,test_20231101_135230,10404007.png,502730,18787,483943,0.9626300399816999,2,4,61265,2725,58540,0.9555210968742349,25.948243555555557,3494.5898933333333,12.69684144309177,127,8.700000000000016E-4
2,test_20231101_135230,1254659.png,342646,71622,271024,0.7909737746829089,3,4,80080,10031,70049,0.8747377622377622,21.243162666666667,3283.60104,12.96729976321864,127,8.700000000000016E-4
3,test_20231101_135230,10188041.png,221231,9147,212084,0.9586540765082652,2,3,41731,1291,40440,0.9690637655459969,11.23984711111111,1121.446144,17.633019388786877,127,8.700000000000016E-4
4,test_20231101_135230,10287332.png,216980,12102,204878,0.944225274218822,2,4,22337,1661,20676,0.9256390741818508,9.531660444444444,800.9398453333333,19.09480461289071,127,8.700000000000016E-4
5,test_20231101_135230,11610969.png,368720,23889,344831,0.9352110002169668,3,4,84111,3492,80619,0.9584834326069123,22.703738666666666,3229.710629333333,13.039167480456243,127,8.700000000000016E-4
6,test_20231101_135230,10350842.png,212614,4697,207917,0.9779083221236607,1,4,42529,690,41839,0.9837757765289568,22.476488888888888,3141.140741333333,13.15992965120445,127,8.700000000000016E-4
7,test_20231101_135230,10863862.png,317432,9872,307560,0.9689004259179919,2,4,66058,1435,64623,0.9782766659602168,26.91376177777778,4100.150074666667,12.002806077074947,127,8.700000000000016E-4
8,test_20231101_135230,11382381.png,312486,707,311779,0.9977374986399391,2,4,46745,94,46651,0.9979890897422184,21.82824,2521.273456,14.11460409284577,127,8.700000000000016E-4
9,test_20231101_135230,11079715.png,443815,115577,328238,0.7395829343307458,4,9,124136,16143,107993,0.8699571437777921,17.25776711111111,2193.2968,14.719829558750817,127,8.700000000000016E-4
10,test_20231101_135230,11551286.png,271883,347,271536,0.9987237157159513,2,3,40092,49,40043,0.9987778110346204,18.003251555555554,1874.2515253333333,15.402524879051395,127,8.700000000000016E-4
1,test_20231101_135231,10404007.png,502730,18787,483943,0.9626300399816999,3,3,61265,2725,58540,0.9555210968742349,25.948243555555557,3494.5898933333333,12.69684144309177,127,8.800000000000017E-4
2,test_20231101_135231,1254659.png,342646,71622,271024,0.7909737746829089,3,4,80080,10031,70049,0.8747377622377622,21.243162666666667,3283.60104,12.96729976321864,127,8.800000000000017E-4
3,test_20231101_135231,10188041.png,221231,9147,212084,0.9586540765082652,2,4,41731,1291,40440,0.9690637655459969,11.23984711111111,1121.446144,17.633019388786877,127,8.800000000000017E-4
4,test_20231101_135231,10287332.png,216980,12102,204878,0.944225274218822,1,3,22337,1661,20676,0.9256390741818508,9.531660444444444,800.9398453333333,19.09480461289071,127,8.800000000000017E-4
5,test_20231101_135231,11610969.png,368720,23889,344831,0.9352110002169668,2,3,84111,3492,80619,0.9584834326069123,22.703738666666666,3229.710629333333,13.039167480456243,127,8.800000000000017E-4
6,test_20231101_135231,10350842.png,212614,4697,207917,0.9779083221236607,1,3,42529,690,41839,0.9837757765289568,22.476488888888888,3141.140741333333,13.15992965120445,127,8.800000000000017E-4
7,test_20231101_135231,10863862.png,317432,9872,307560,0.9689004259179919,6,4,66058,1435,64623,0.9782766659602168,26.91376177777778,4100.150074666667,12.002806077074947,127,8.800000000000017E-4
8,test_20231101_135231,11382381.png,312486,707,311779,0.9977374986399391,2,4,46745,94,46651,0.9979890897422184,21.82824,2521.273456,14.11460409284577,127,8.800000000000017E-4
9,test_20231101_135231,11079715.png,443815,115577,328238,0.7395829343307458,4,4,124136,16143,107993,0.8699571437777921,17.25776711111111,2193.2968,14.719829558750817,127,8.800000000000017E-4
10,test_20231101_135231,11551286.png,271883,347,271536,0.9987237157159513,2,3,40092,49,40043,0.9987778110346204,18.003251555555554,1874.2515253333333,15.402524879051395,127,8.800000000000017E-4
1,test_20231101_135231,10404007.png,502730,18787,483943,0.9626300399816999,2,4,61265,2725,58540,0.9555210968742349,25.948243555555557,3494.5898933333333,12.69684144309177,127,8.900000000000017E-4
2,test_20231101_135231,1254659.png,342646,71622,271024,0.7909737746829089,3,4,80080,10031,70049,0.8747377622377622,21.243162666666667,3283.60104,12.96729976321864,127,8.900000000000017E-4
3,test_20231101_135231,10188041.png,221231,9147,212084,0.9586540765082652,2,4,41731,1291,40440,0.9690637655459969,11.23984711111111,1121.446144,17.633019388786877,127,8.900000000000017E-4
4,test_20231101_135231,10287332.png,216980,12102,204878,0.944225274218822,2,4,22337,1661,20676,0.9256390741818508,9.531660444444444,800.9398453333333,19.09480461289071,127,8.900000000000017E-4
5,test_20231101_135231,11610969.png,368720,23889,344831,0.9352110002169668,2,4,84111,3492,80619,0.9584834326069123,22.703738666666666,3229.710629333333,13.039167480456243,127,8.900000000000017E-4
6,test_20231101_135231,10350842.png,212614,4697,207917,0.9779083221236607,2,4,42529,690,41839,0.9837757765289568,22.476488888888888,3141.140741333333,13.15992965120445,127,8.900000000000017E-4
7,test_20231101_135231,10863862.png,317432,9872,307560,0.9689004259179919,2,3,66058,1435,64623,0.9782766659602168,26.91376177777778,4100.150074666667,12.002806077074947,127,8.900000000000017E-4
8,test_20231101_135231,11382381.png,312486,707,311779,0.9977374986399391,2,4,46745,94,46651,0.9979890897422184,21.82824,2521.273456,14.11460409284577,127,8.900000000000017E-4
9,test_20231101_135231,11079715.png,443815,115577,328238,0.7395829343307458,3,4,124136,16143,107993,0.8699571437777921,17.25776711111111,2193.2968,14.719829558750817,127,8.900000000000017E-4
10,test_20231101_135231,11551286.png,271883,347,271536,0.9987237157159513,1,4,40092,49,40043,0.9987778110346204,18.003251555555554,1874.2515253333333,15.402524879051395,127,8.900000000000017E-4
1,test_20231101_135232,10404007.png,502730,18787,483943,0.9626300399816999,2,3,61265,2725,58540,0.9555210968742349,25.948243555555557,3494.5898933333333,12.69684144309177,127,9.000000000000017E-4
2,test_20231101_135232,1254659.png,342646,71622,271024,0.7909737746829089,3,4,80080,10031,70049,0.8747377622377622,21.243162666666667,3283.60104,12.96729976321864,127,9.000000000000017E-4
3,test_20231101_135232,10188041.png,221231,9147,212084,0.9586540765082652,2,3,41731,1291,40440,0.9690637655459969,11.23984711111111,1121.446144,17.633019388786877,127,9.000000000000017E-4
4,test_20231101_135232,10287332.png,216980,12102,204878,0.944225274218822,1,13,22337,1661,20676,0.9256390741818508,9.531660444444444,800.9398453333333,19.09480461289071,127,9.000000000000017E-4
5,test_20231101_135232,11610969.png,368720,23889,344831,0.9352110002169668,2,4,84111,3492,80619,0.9584834326069123,22.703738666666666,3229.710629333333,13.039167480456243,127,9.000000000000017E-4
6,test_20231101_135232,10350842.png,212614,4112,208502,0.9806597872200326,1,4,42529,603,41926,0.9858214394883491,23.584798222222222,3411.2040586666667,12.801726611315217,127,9.000000000000017E-4
7,test_20231101_135232,10863862.png,317432,9872,307560,0.9689004259179919,2,4,66058,1435,64623,0.9782766659602168,26.91376177777778,4100.150074666667,12.002806077074947,127,9.000000000000017E-4
8,test_20231101_135232,11382381.png,312486,707,311779,0.9977374986399391,2,4,46745,94,46651,0.9979890897422184,21.82824,2521.273456,14.11460409284577,127,9.000000000000017E-4
9,test_20231101_135232,11079715.png,443815,115577,328238,0.7395829343307458,3,4,124136,16143,107993,0.8699571437777921,17.25776711111111,2193.2968,14.719829558750817,127,9.000000000000017E-4
10,test_20231101_135232,11551286.png,271883,347,271536,0.9987237157159513,1,3,40092,49,40043,0.9987778110346204,18.003251555555554,1874.2515253333333,15.402524879051395,127,9.000000000000017E-4
1,test_20231101_135233,10404007.png,502730,18787,483943,0.9626300399816999,3,3,61265,2725,58540,0.9555210968742349,25.948243555555557,3494.5898933333333,12.69684144309177,127,9.100000000000017E-4
2,test_20231101_135233,1254659.png,342646,71622,271024,0.7909737746829089,3,4,80080,10031,70049,0.8747377622377622,21.243162666666667,3283.60104,12.96729976321864,127,9.100000000000017E-4
3,test_20231101_135233,10188041.png,221231,9147,212084,0.9586540765082652,2,4,41731,1291,40440,0.9690637655459969,11.23984711111111,1121.446144,17.633019388786877,127,9.100000000000017E-4
4,test_20231101_135233,10287332.png,216980,12102,204878,0.944225274218822,1,3,22337,1661,20676,0.9256390741818508,9.531660444444444,800.9398453333333,19.09480461289071,127,9.100000000000017E-4
5,test_20231101_135233,11610969.png,368720,23889,344831,0.9352110002169668,2,4,84111,3492,80619,0.9584834326069123,22.703738666666666,3229.710629333333,13.039167480456243,127,9.100000000000017E-4
6,test_20231101_135233,10350842.png,212614,4112,208502,0.9806597872200326,2,4,42529,603,41926,0.9858214394883491,23.584798222222222,3411.2040586666667,12.801726611315217,127,9.100000000000017E-4
7,test_20231101_135233,10863862.png,317432,9872,307560,0.9689004259179919,2,4,66058,1435,64623,0.9782766659602168,26.91376177777778,4100.150074666667,12.002806077074947,127,9.100000000000017E-4
8,test_20231101_135233,11382381.png,312486,707,311779,0.9977374986399391,2,4,46745,94,46651,0.9979890897422184,21.82824,2521.273456,14.11460409284577,127,9.100000000000017E-4
9,test_20231101_135233,11079715.png,443815,115577,328238,0.7395829343307458,3,5,124136,16143,107993,0.8699571437777921,17.25776711111111,2193.2968,14.719829558750817,127,9.100000000000017E-4
10,test_20231101_135233,11551286.png,271883,347,271536,0.9987237157159513,1,3,40092,49,40043,0.9987778110346204,18.003251555555554,1874.2515253333333,15.402524879051395,127,9.100000000000017E-4
1,test_20231101_135233,10404007.png,502730,18787,483943,0.9626300399816999,2,3,61265,2725,58540,0.9555210968742349,25.948243555555557,3494.5898933333333,12.69684144309177,127,9.200000000000018E-4
2,test_20231101_135233,1254659.png,342646,71622,271024,0.7909737746829089,3,3,80080,10031,70049,0.8747377622377622,21.243162666666667,3283.60104,12.96729976321864,127,9.200000000000018E-4
3,test_20231101_135233,10188041.png,221231,9147,212084,0.9586540765082652,2,3,41731,1291,40440,0.9690637655459969,11.23984711111111,1121.446144,17.633019388786877,127,9.200000000000018E-4
4,test_20231101_135233,10287332.png,216980,12102,204878,0.944225274218822,2,4,22337,1661,20676,0.9256390741818508,9.531660444444444,800.9398453333333,19.09480461289071,127,9.200000000000018E-4
5,test_20231101_135233,11610969.png,368720,23889,344831,0.9352110002169668,3,3,84111,3492,80619,0.9584834326069123,22.703738666666666,3229.710629333333,13.039167480456243,127,9.200000000000018E-4
6,test_20231101_135233,10350842.png,212614,4112,208502,0.9806597872200326,1,4,42529,603,41926,0.9858214394883491,23.584798222222222,3411.2040586666667,12.801726611315217,127,9.200000000000018E-4
7,test_20231101_135233,10863862.png,317432,9872,307560,0.9689004259179919,1,4,66058,1435,64623,0.9782766659602168,26.91376177777778,4100.150074666667,12.002806077074947,127,9.200000000000018E-4
8,test_20231101_135233,11382381.png,312486,707,311779,0.9977374986399391,2,4,46745,94,46651,0.9979890897422184,21.82824,2521.273456,14.11460409284577,127,9.200000000000018E-4
9,test_20231101_135233,11079715.png,443815,115577,328238,0.7395829343307458,3,5,124136,16143,107993,0.8699571437777921,17.25776711111111,2193.2968,14.719829558750817,127,9.200000000000018E-4
10,test_20231101_135233,11551286.png,271883,347,271536,0.9987237157159513,1,4,40092,49,40043,0.9987778110346204,18.003251555555554,1874.2515253333333,15.402524879051395,127,9.200000000000018E-4
1,test_20231101_135234,10404007.png,502730,18787,483943,0.9626300399816999,2,3,61265,2725,58540,0.9555210968742349,25.948243555555557,3494.5898933333333,12.69684144309177,127,9.300000000000018E-4
2,test_20231101_135234,1254659.png,342646,71622,271024,0.7909737746829089,3,5,80080,10031,70049,0.8747377622377622,21.243162666666667,3283.60104,12.96729976321864,127,9.300000000000018E-4
3,test_20231101_135234,10188041.png,221231,9147,212084,0.9586540765082652,2,4,41731,1291,40440,0.9690637655459969,11.23984711111111,1121.446144,17.633019388786877,127,9.300000000000018E-4
4,test_20231101_135234,10287332.png,216980,12102,204878,0.944225274218822,2,4,22337,1661,20676,0.9256390741818508,9.531660444444444,800.9398453333333,19.09480461289071,127,9.300000000000018E-4
5,test_20231101_135234,11610969.png,368720,23889,344831,0.9352110002169668,3,3,84111,3492,80619,0.9584834326069123,22.703738666666666,3229.710629333333,13.039167480456243,127,9.300000000000018E-4
6,test_20231101_135234,10350842.png,212614,4112,208502,0.9806597872200326,2,3,42529,603,41926,0.9858214394883491,23.584798222222222,3411.2040586666667,12.801726611315217,127,9.300000000000018E-4
7,test_20231101_135234,10863862.png,317432,9872,307560,0.9689004259179919,2,3,66058,1435,64623,0.9782766659602168,26.91376177777778,4100.150074666667,12.002806077074947,127,9.300000000000018E-4
8,test_20231101_135234,11382381.png,312486,707,311779,0.9977374986399391,1,4,46745,94,46651,0.9979890897422184,21.82824,2521.273456,14.11460409284577,127,9.300000000000018E-4
9,test_20231101_135234,11079715.png,443815,115577,328238,0.7395829343307458,6,4,124136,16143,107993,0.8699571437777921,17.25776711111111,2193.2968,14.719829558750817,127,9.300000000000018E-4
10,test_20231101_135234,11551286.png,271883,347,271536,0.9987237157159513,2,3,40092,49,40043,0.9987778110346204,18.003251555555554,1874.2515253333333,15.402524879051395,127,9.300000000000018E-4
1,test_20231101_135235,10404007.png,502730,18787,483943,0.9626300399816999,2,13,61265,2725,58540,0.9555210968742349,25.948243555555557,3494.5898933333333,12.69684144309177,127,9.400000000000018E-4
2,test_20231101_135235,1254659.png,342646,71622,271024,0.7909737746829089,3,3,80080,10031,70049,0.8747377622377622,21.243162666666667,3283.60104,12.96729976321864,127,9.400000000000018E-4
3,test_20231101_135235,10188041.png,221231,9147,212084,0.9586540765082652,2,3,41731,1291,40440,0.9690637655459969,11.23984711111111,1121.446144,17.633019388786877,127,9.400000000000018E-4
4,test_20231101_135235,10287332.png,216980,12102,204878,0.944225274218822,2,4,22337,1661,20676,0.9256390741818508,9.531660444444444,800.9398453333333,19.09480461289071,127,9.400000000000018E-4
5,test_20231101_135235,11610969.png,368720,23889,344831,0.9352110002169668,3,4,84111,3492,80619,0.9584834326069123,22.703738666666666,3229.710629333333,13.039167480456243,127,9.400000000000018E-4
6,test_20231101_135235,10350842.png,212614,4112,208502,0.9806597872200326,1,12,42529,603,41926,0.9858214394883491,23.584798222222222,3411.2040586666667,12.801726611315217,127,9.400000000000018E-4
7,test_20231101_135235,10863862.png,317432,9872,307560,0.9689004259179919,2,3,66058,1435,64623,0.9782766659602168,26.91376177777778,4100.150074666667,12.002806077074947,127,9.400000000000018E-4
8,test_20231101_135235,11382381.png,312486,707,311779,0.9977374986399391,2,4,46745,94,46651,0.9979890897422184,21.82824,2521.273456,14.11460409284577,127,9.400000000000018E-4
9,test_20231101_135235,11079715.png,443815,115577,328238,0.7395829343307458,3,4,124136,16143,107993,0.8699571437777921,17.25776711111111,2193.2968,14.719829558750817,127,9.400000000000018E-4
10,test_20231101_135235,11551286.png,271883,347,271536,0.9987237157159513,1,3,40092,49,40043,0.9987778110346204,18.003251555555554,1874.2515253333333,15.402524879051395,127,9.400000000000018E-4
1,test_20231101_135235,10404007.png,502730,18787,483943,0.9626300399816999,2,3,61265,2725,58540,0.9555210968742349,25.948243555555557,3494.5898933333333,12.69684144309177,127,9.500000000000018E-4
2,test_20231101_135235,1254659.png,342646,71622,271024,0.7909737746829089,3,4,80080,10031,70049,0.8747377622377622,21.243162666666667,3283.60104,12.96729976321864,127,9.500000000000018E-4
3,test_20231101_135235,10188041.png,221231,9147,212084,0.9586540765082652,2,4,41731,1291,40440,0.9690637655459969,11.23984711111111,1121.446144,17.633019388786877,127,9.500000000000018E-4
4,test_20231101_135235,10287332.png,216980,12102,204878,0.944225274218822,2,4,22337,1661,20676,0.9256390741818508,9.531660444444444,800.9398453333333,19.09480461289071,127,9.500000000000018E-4
5,test_20231101_135235,11610969.png,368720,23889,344831,0.9352110002169668,2,4,84111,3492,80619,0.9584834326069123,22.703738666666666,3229.710629333333,13.039167480456243,127,9.500000000000018E-4
6,test_20231101_135235,10350842.png,212614,4112,208502,0.9806597872200326,1,4,42529,603,41926,0.9858214394883491,23.584798222222222,3411.2040586666667,12.801726611315217,127,9.500000000000018E-4
7,test_20231101_135235,10863862.png,317432,9872,307560,0.9689004259179919,2,4,66058,1435,64623,0.9782766659602168,26.91376177777778,4100.150074666667,12.002806077074947,127,9.500000000000018E-4
8,test_20231101_135235,11382381.png,312486,707,311779,0.9977374986399391,1,3,46745,94,46651,0.9979890897422184,21.82824,2521.273456,14.11460409284577,127,9.500000000000018E-4
9,test_20231101_135235,11079715.png,443815,115577,328238,0.7395829343307458,4,4,124136,16143,107993,0.8699571437777921,17.25776711111111,2193.2968,14.719829558750817,127,9.500000000000018E-4
10,test_20231101_135235,11551286.png,271883,347,271536,0.9987237157159513,1,3,40092,49,40043,0.9987778110346204,18.003251555555554,1874.2515253333333,15.402524879051395,127,9.500000000000018E-4
1,test_20231101_135236,10404007.png,502730,18787,483943,0.9626300399816999,2,4,61265,2725,58540,0.9555210968742349,25.948243555555557,3494.5898933333333,12.69684144309177,127,9.600000000000019E-4
2,test_20231101_135236,1254659.png,342646,71622,271024,0.7909737746829089,3,3,80080,10031,70049,0.8747377622377622,21.243162666666667,3283.60104,12.96729976321864,127,9.600000000000019E-4
3,test_20231101_135236,10188041.png,221231,9147,212084,0.9586540765082652,1,3,41731,1291,40440,0.9690637655459969,11.23984711111111,1121.446144,17.633019388786877,127,9.600000000000019E-4
4,test_20231101_135236,10287332.png,216980,12102,204878,0.944225274218822,1,4,22337,1661,20676,0.9256390741818508,9.531660444444444,800.9398453333333,19.09480461289071,127,9.600000000000019E-4
5,test_20231101_135236,11610969.png,368720,23889,344831,0.9352110002169668,3,4,84111,3492,80619,0.9584834326069123,22.703738666666666,3229.710629333333,13.039167480456243,127,9.600000000000019E-4
6,test_20231101_135236,10350842.png,212614,4112,208502,0.9806597872200326,1,3,42529,603,41926,0.9858214394883491,23.584798222222222,3411.2040586666667,12.801726611315217,127,9.600000000000019E-4
7,test_20231101_135236,10863862.png,317432,9872,307560,0.9689004259179919,2,4,66058,1435,64623,0.9782766659602168,26.91376177777778,4100.150074666667,12.002806077074947,127,9.600000000000019E-4
8,test_20231101_135236,11382381.png,312486,707,311779,0.9977374986399391,1,3,46745,94,46651,0.9979890897422184,21.82824,2521.273456,14.11460409284577,127,9.600000000000019E-4
9,test_20231101_135236,11079715.png,443815,115577,328238,0.7395829343307458,4,4,124136,16143,107993,0.8699571437777921,17.25776711111111,2193.2968,14.719829558750817,127,9.600000000000019E-4
10,test_20231101_135236,11551286.png,271883,347,271536,0.9987237157159513,2,3,40092,49,40043,0.9987778110346204,18.003251555555554,1874.2515253333333,15.402524879051395,127,9.600000000000019E-4
1,test_20231101_135237,10404007.png,502730,18787,483943,0.9626300399816999,2,3,61265,2725,58540,0.9555210968742349,25.948243555555557,3494.5898933333333,12.69684144309177,127,9.700000000000019E-4
2,test_20231101_135237,1254659.png,342646,71622,271024,0.7909737746829089,3,13,80080,10031,70049,0.8747377622377622,21.243162666666667,3283.60104,12.96729976321864,127,9.700000000000019E-4
3,test_20231101_135237,10188041.png,221231,9147,212084,0.9586540765082652,2,3,41731,1291,40440,0.9690637655459969,11.23984711111111,1121.446144,17.633019388786877,127,9.700000000000019E-4
4,test_20231101_135237,10287332.png,216980,12102,204878,0.944225274218822,2,4,22337,1661,20676,0.9256390741818508,9.531660444444444,800.9398453333333,19.09480461289071,127,9.700000000000019E-4
5,test_20231101_135237,11610969.png,368720,23889,344831,0.9352110002169668,3,3,84111,3492,80619,0.9584834326069123,22.703738666666666,3229.710629333333,13.039167480456243,127,9.700000000000019E-4
6,test_20231101_135237,10350842.png,212614,4112,208502,0.9806597872200326,2,4,42529,603,41926,0.9858214394883491,23.584798222222222,3411.2040586666667,12.801726611315217,127,9.700000000000019E-4
7,test_20231101_135237,10863862.png,317432,9872,307560,0.9689004259179919,2,4,66058,1435,64623,0.9782766659602168,26.91376177777778,4100.150074666667,12.002806077074947,127,9.700000000000019E-4
8,test_20231101_135237,11382381.png,312486,707,311779,0.9977374986399391,1,4,46745,94,46651,0.9979890897422184,21.82824,2521.273456,14.11460409284577,127,9.700000000000019E-4
9,test_20231101_135237,11079715.png,443815,115577,328238,0.7395829343307458,3,4,124136,16143,107993,0.8699571437777921,17.25776711111111,2193.2968,14.719829558750817,127,9.700000000000019E-4
10,test_20231101_135237,11551286.png,271883,347,271536,0.9987237157159513,2,4,40092,49,40043,0.9987778110346204,18.003251555555554,1874.2515253333333,15.402524879051395,127,9.700000000000019E-4
1,test_20231101_135237,10404007.png,502730,18362,484368,0.9634754241839556,2,4,61265,2667,58598,0.9564678038031502,26.119692444444443,3536.8504693333334,12.644636617306142,127,9.80000000000002E-4
2,test_20231101_135237,1254659.png,342646,71462,271184,0.7914407289155572,3,14,80080,10017,70063,0.8749125874125874,21.31288711111111,3298.2814986666667,12.947926422154241,127,9.80000000000002E-4
3,test_20231101_135237,10188041.png,221231,8967,212264,0.9594677057012806,2,4,41731,1274,40457,0.9694711365651434,11.320529777777777,1135.8477973333333,17.57760220696072,127,9.80000000000002E-4
4,test_20231101_135237,10287332.png,216980,12002,204978,0.9446861461885888,2,4,22337,1646,20691,0.9263106057214487,9.583248,809.530704,19.048470354809375,127,9.80000000000002E-4
5,test_20231101_135237,11610969.png,368720,23627,345093,0.9359215665003254,2,4,84111,3458,80653,0.9588876603535804,22.748001777777777,3235.859728,13.03090673847314,127,9.80000000000002E-4
6,test_20231101_135237,10350842.png,212614,3992,208622,0.9812241903167243,1,3,42529,585,41944,0.9862446801006373,23.73951466666667,3439.8629386666667,12.765392224145835,127,9.80000000000002E-4
7,test_20231101_135237,10863862.png,317432,9732,307700,0.9693414652587011,2,4,66058,1414,64644,0.9785945684095795,26.941274666666665,4106.273744,11.996324627047875,127,9.80000000000002E-4
8,test_20231101_135237,11382381.png,312486,547,311939,0.9982495215785667,1,4,46745,73,46672,0.9984383356508717,22.032236444444443,2581.941392,14.011339809622479,127,9.80000000000002E-4
9,test_20231101_135237,11079715.png,443815,115474,328341,0.7398150130121786,4,4,124136,16133,108003,0.8700377005864536,17.29648,2199.590101333333,14.70738604279775,127,9.80000000000002E-4
10,test_20231101_135237,11551286.png,271883,347,271536,0.9987237157159513,1,3,40092,49,40043,0.9987778110346204,18.003251555555554,1874.2515253333333,15.402524879051395,127,9.80000000000002E-4
1,test_20231101_135238,10404007.png,502730,18362,484368,0.9634754241839556,2,4,61265,2667,58598,0.9564678038031502,26.119692444444443,3536.8504693333334,12.644636617306142,127,9.90000000000002E-4
2,test_20231101_135238,1254659.png,342646,71462,271184,0.7914407289155572,3,4,80080,10017,70063,0.8749125874125874,21.31288711111111,3298.2814986666667,12.947926422154241,127,9.90000000000002E-4
3,test_20231101_135238,10188041.png,221231,8967,212264,0.9594677057012806,2,3,41731,1274,40457,0.9694711365651434,11.320529777777777,1135.8477973333333,17.57760220696072,127,9.90000000000002E-4
4,test_20231101_135238,10287332.png,216980,12002,204978,0.9446861461885888,2,4,22337,1646,20691,0.9263106057214487,9.583248,809.530704,19.048470354809375,127,9.90000000000002E-4
5,test_20231101_135238,11610969.png,368720,23627,345093,0.9359215665003254,2,3,84111,3458,80653,0.9588876603535804,22.748001777777777,3235.859728,13.03090673847314,127,9.90000000000002E-4
6,test_20231101_135238,10350842.png,212614,3992,208622,0.9812241903167243,1,4,42529,585,41944,0.9862446801006373,23.73951466666667,3439.8629386666667,12.765392224145835,127,9.90000000000002E-4
7,test_20231101_135238,10863862.png,317432,9732,307700,0.9693414652587011,2,3,66058,1414,64644,0.9785945684095795,26.941274666666665,4106.273744,11.996324627047875,127,9.90000000000002E-4
8,test_20231101_135238,11382381.png,312486,547,311939,0.9982495215785667,2,3,46745,73,46672,0.9984383356508717,22.032236444444443,2581.941392,14.011339809622479,127,9.90000000000002E-4
9,test_20231101_135238,11079715.png,443815,115474,328341,0.7398150130121786,3,4,124136,16133,108003,0.8700377005864536,17.29648,2199.590101333333,14.70738604279775,127,9.90000000000002E-4
10,test_20231101_135238,11551286.png,271883,347,271536,0.9987237157159513,1,3,40092,49,40043,0.9987778110346204,18.003251555555554,1874.2515253333333,15.402524879051395,127,9.90000000000002E-4
1,test_20231101_135239,10404007.png,502730,18534,484196,0.9631332922244544,2,3,61265,2687,58578,0.956141353138007,25.885536,3487.714848,12.705393906287338,128,0.0
2,test_20231101_135239,1254659.png,342646,69592,273054,0.7968982565096339,3,4,80080,9768,70312,0.878021978021978,21.430725333333335,3345.388144,12.88633847428336,128,0.0
3,test_20231101_135239,10188041.png,221231,9309,211922,0.9579218102345513,2,3,41731,1311,40420,0.9685845055234718,10.629137777777778,1035.1340373333333,17.980837715530228,128,0.0
4,test_20231101_135239,10287332.png,216980,12152,204828,0.9439948382339386,2,4,22337,1664,20673,0.9255047678739311,9.449086222222222,786.1254666666666,19.175884953215455,128,0.0
5,test_20231101_135239,11610969.png,368720,24032,344688,0.9348231720546756,2,3,84111,3509,80602,0.9582813187335782,21.529770666666668,2995.306272,13.366391249809656,128,0.0
6,test_20231101_135239,10350842.png,212614,5642,206972,0.9734636477372139,1,3,42529,830,41699,0.9804839051000493,19.393774222222223,2404.812736,14.319990975752292,128,0.0
7,test_20231101_135239,10863862.png,317432,10677,306755,0.966364449708914,3,3,66058,1554,64504,0.9764752187471616,24.58188977777778,3464.000261333333,12.735024447582767,128,0.0
8,test_20231101_135239,11382381.png,312486,927,311559,0.997033467099326,2,3,46745,127,46618,0.9972831318857632,20.359315555555554,2313.8482506666664,14.487454876951972,128,0.0
9,test_20231101_135239,11079715.png,443815,113162,330653,0.7450243907934613,4,4,124136,15824,108312,0.872526905974093,17.42231111111111,2238.1416106666666,14.631927993255129,128,0.0
10,test_20231101_135239,11551286.png,271883,917,270966,0.9966272256816351,2,4,40092,134,39958,0.9966576873191659,15.950851555555555,1533.329888,16.274447597479135,128,0.0
1,test_20231101_135239,10404007.png,502730,18534,484196,0.9631332922244544,2,4,61265,2687,58578,0.956141353138007,25.885536,3487.714848,12.705393906287338,128,1.0E-5
2,test_20231101_135239,1254659.png,342646,69592,273054,0.7968982565096339,3,4,80080,9768,70312,0.878021978021978,21.430725333333335,3345.388144,12.88633847428336,128,1.0E-5
3,test_20231101_135239,10188041.png,221231,9309,211922,0.9579218102345513,2,3,41731,1311,40420,0.9685845055234718,10.629137777777778,1035.1340373333333,17.980837715530228,128,1.0E-5
4,test_20231101_135239,10287332.png,216980,12152,204828,0.9439948382339386,2,3,22337,1664,20673,0.9255047678739311,9.449086222222222,786.1254666666666,19.175884953215455,128,1.0E-5
5,test_20231101_135239,11610969.png,368720,24032,344688,0.9348231720546756,3,3,84111,3509,80602,0.9582813187335782,21.529770666666668,2995.306272,13.366391249809656,128,1.0E-5
6,test_20231101_135239,10350842.png,212614,5642,206972,0.9734636477372139,2,3,42529,830,41699,0.9804839051000493,19.393774222222223,2404.812736,14.319990975752292,128,1.0E-5
7,test_20231101_135239,10863862.png,317432,10677,306755,0.966364449708914,2,3,66058,1554,64504,0.9764752187471616,24.58188977777778,3464.000261333333,12.735024447582767,128,1.0E-5
8,test_20231101_135239,11382381.png,312486,927,311559,0.997033467099326,2,3,46745,127,46618,0.9972831318857632,20.359315555555554,2313.8482506666664,14.487454876951972,128,1.0E-5
9,test_20231101_135239,11079715.png,443815,113162,330653,0.7450243907934613,4,4,124136,15824,108312,0.872526905974093,17.42231111111111,2238.1416106666666,14.631927993255129,128,1.0E-5
10,test_20231101_135239,11551286.png,271883,917,270966,0.9966272256816351,1,4,40092,134,39958,0.9966576873191659,15.950851555555555,1533.329888,16.274447597479135,128,1.0E-5
1,test_20231101_135240,10404007.png,502730,18534,484196,0.9631332922244544,2,4,61265,2687,58578,0.956141353138007,25.885536,3487.714848,12.705393906287338,128,2.0E-5
2,test_20231101_135240,1254659.png,342646,69592,273054,0.7968982565096339,3,4,80080,9768,70312,0.878021978021978,21.430725333333335,3345.388144,12.88633847428336,128,2.0E-5
3,test_20231101_135240,10188041.png,221231,9309,211922,0.9579218102345513,2,4,41731,1311,40420,0.9685845055234718,10.629137777777778,1035.1340373333333,17.980837715530228,128,2.0E-5
4,test_20231101_135240,10287332.png,216980,12152,204828,0.9439948382339386,2,3,22337,1664,20673,0.9255047678739311,9.449086222222222,786.1254666666666,19.175884953215455,128,2.0E-5
5,test_20231101_135240,11610969.png,368720,24032,344688,0.9348231720546756,2,4,84111,3509,80602,0.9582813187335782,21.529770666666668,2995.306272,13.366391249809656,128,2.0E-5
6,test_20231101_135240,10350842.png,212614,5642,206972,0.9734636477372139,2,3,42529,830,41699,0.9804839051000493,19.393774222222223,2404.812736,14.319990975752292,128,2.0E-5
7,test_20231101_135240,10863862.png,317432,10677,306755,0.966364449708914,2,4,66058,1554,64504,0.9764752187471616,24.58188977777778,3464.000261333333,12.735024447582767,128,2.0E-5
8,test_20231101_135240,11382381.png,312486,927,311559,0.997033467099326,1,3,46745,127,46618,0.9972831318857632,20.359315555555554,2313.8482506666664,14.487454876951972,128,2.0E-5
9,test_20231101_135240,11079715.png,443815,113162,330653,0.7450243907934613,3,4,124136,15824,108312,0.872526905974093,17.42231111111111,2238.1416106666666,14.631927993255129,128,2.0E-5
10,test_20231101_135240,11551286.png,271883,917,270966,0.9966272256816351,2,4,40092,134,39958,0.9966576873191659,15.950851555555555,1533.329888,16.274447597479135,128,2.0E-5
1,test_20231101_135241,10404007.png,502730,18534,484196,0.9631332922244544,2,4,61265,2687,58578,0.956141353138007,25.885536,3487.714848,12.705393906287338,128,3.0000000000000004E-5
2,test_20231101_135241,1254659.png,342646,69592,273054,0.7968982565096339,3,4,80080,9768,70312,0.878021978021978,21.430725333333335,3345.388144,12.88633847428336,128,3.0000000000000004E-5
3,test_20231101_135241,10188041.png,221231,9309,211922,0.9579218102345513,2,4,41731,1311,40420,0.9685845055234718,10.629137777777778,1035.1340373333333,17.980837715530228,128,3.0000000000000004E-5
4,test_20231101_135241,10287332.png,216980,12152,204828,0.9439948382339386,2,4,22337,1664,20673,0.9255047678739311,9.449086222222222,786.1254666666666,19.175884953215455,128,3.0000000000000004E-5
5,test_20231101_135241,11610969.png,368720,24032,344688,0.9348231720546756,2,4,84111,3509,80602,0.9582813187335782,21.529770666666668,2995.306272,13.366391249809656,128,3.0000000000000004E-5
6,test_20231101_135241,10350842.png,212614,5642,206972,0.9734636477372139,2,4,42529,830,41699,0.9804839051000493,19.393774222222223,2404.812736,14.319990975752292,128,3.0000000000000004E-5
7,test_20231101_135241,10863862.png,317432,10677,306755,0.966364449708914,2,4,66058,1554,64504,0.9764752187471616,24.58188977777778,3464.000261333333,12.735024447582767,128,3.0000000000000004E-5
8,test_20231101_135241,11382381.png,312486,927,311559,0.997033467099326,2,4,46745,127,46618,0.9972831318857632,20.359315555555554,2313.8482506666664,14.487454876951972,128,3.0000000000000004E-5
9,test_20231101_135241,11079715.png,443815,113162,330653,0.7450243907934613,3,5,124136,15824,108312,0.872526905974093,17.42231111111111,2238.1416106666666,14.631927993255129,128,3.0000000000000004E-5
10,test_20231101_135241,11551286.png,271883,917,270966,0.9966272256816351,2,4,40092,134,39958,0.9966576873191659,15.950851555555555,1533.329888,16.274447597479135,128,3.0000000000000004E-5
1,test_20231101_135242,10404007.png,502730,18534,484196,0.9631332922244544,2,4,61265,2687,58578,0.956141353138007,25.885536,3487.714848,12.705393906287338,128,4.0E-5
2,test_20231101_135242,1254659.png,342646,69592,273054,0.7968982565096339,3,4,80080,9768,70312,0.878021978021978,21.430725333333335,3345.388144,12.88633847428336,128,4.0E-5
3,test_20231101_135242,10188041.png,221231,9309,211922,0.9579218102345513,2,3,41731,1311,40420,0.9685845055234718,10.629137777777778,1035.1340373333333,17.980837715530228,128,4.0E-5
4,test_20231101_135242,10287332.png,216980,12152,204828,0.9439948382339386,2,4,22337,1664,20673,0.9255047678739311,9.449086222222222,786.1254666666666,19.175884953215455,128,4.0E-5
5,test_20231101_135242,11610969.png,368720,24032,344688,0.9348231720546756,3,4,84111,3509,80602,0.9582813187335782,21.529770666666668,2995.306272,13.366391249809656,128,4.0E-5
6,test_20231101_135242,10350842.png,212614,5642,206972,0.9734636477372139,1,3,42529,830,41699,0.9804839051000493,19.393774222222223,2404.812736,14.319990975752292,128,4.0E-5
7,test_20231101_135242,10863862.png,317432,10677,306755,0.966364449708914,2,4,66058,1554,64504,0.9764752187471616,24.58188977777778,3464.000261333333,12.735024447582767,128,4.0E-5
8,test_20231101_135242,11382381.png,312486,927,311559,0.997033467099326,2,4,46745,127,46618,0.9972831318857632,20.359315555555554,2313.8482506666664,14.487454876951972,128,4.0E-5
9,test_20231101_135242,11079715.png,443815,113162,330653,0.7450243907934613,3,4,124136,15824,108312,0.872526905974093,17.42231111111111,2238.1416106666666,14.631927993255129,128,4.0E-5
10,test_20231101_135242,11551286.png,271883,917,270966,0.9966272256816351,1,4,40092,134,39958,0.9966576873191659,15.950851555555555,1533.329888,16.274447597479135,128,4.0E-5
1,test_20231101_135242,10404007.png,502730,18534,484196,0.9631332922244544,2,4,61265,2687,58578,0.956141353138007,25.885536,3487.714848,12.705393906287338,128,5.0E-5
2,test_20231101_135242,1254659.png,342646,69592,273054,0.7968982565096339,3,4,80080,9768,70312,0.878021978021978,21.430725333333335,3345.388144,12.88633847428336,128,5.0E-5
3,test_20231101_135242,10188041.png,221231,9309,211922,0.9579218102345513,2,4,41731,1311,40420,0.9685845055234718,10.629137777777778,1035.1340373333333,17.980837715530228,128,5.0E-5
4,test_20231101_135242,10287332.png,216980,12152,204828,0.9439948382339386,1,3,22337,1664,20673,0.9255047678739311,9.449086222222222,786.1254666666666,19.175884953215455,128,5.0E-5
5,test_20231101_135242,11610969.png,368720,24032,344688,0.9348231720546756,2,4,84111,3509,80602,0.9582813187335782,21.529770666666668,2995.306272,13.366391249809656,128,5.0E-5
6,test_20231101_135242,10350842.png,212614,5642,206972,0.9734636477372139,2,4,42529,830,41699,0.9804839051000493,19.393774222222223,2404.812736,14.319990975752292,128,5.0E-5
7,test_20231101_135242,10863862.png,317432,10677,306755,0.966364449708914,2,4,66058,1554,64504,0.9764752187471616,24.58188977777778,3464.000261333333,12.735024447582767,128,5.0E-5
8,test_20231101_135242,11382381.png,312486,917,311569,0.9970654685329903,2,4,46745,126,46619,0.99730452454808,21.089132444444445,2412.4090613333333,14.306294097973675,128,5.0E-5
9,test_20231101_135242,11079715.png,443815,113162,330653,0.7450243907934613,4,4,124136,15824,108312,0.872526905974093,17.42231111111111,2238.1416106666666,14.631927993255129,128,5.0E-5
10,test_20231101_135242,11551286.png,271883,917,270966,0.9966272256816351,2,4,40092,134,39958,0.9966576873191659,15.950851555555555,1533.329888,16.274447597479135,128,5.0E-5
1,test_20231101_135243,10404007.png,502730,18534,484196,0.9631332922244544,3,4,61265,2687,58578,0.956141353138007,25.885536,3487.714848,12.705393906287338,128,6.0E-5
2,test_20231101_135243,1254659.png,342646,69592,273054,0.7968982565096339,3,4,80080,9768,70312,0.878021978021978,21.430725333333335,3345.388144,12.88633847428336,128,6.0E-5
3,test_20231101_135243,10188041.png,221231,9309,211922,0.9579218102345513,2,3,41731,1311,40420,0.9685845055234718,10.629137777777778,1035.1340373333333,17.980837715530228,128,6.0E-5
4,test_20231101_135243,10287332.png,216980,12152,204828,0.9439948382339386,2,4,22337,1664,20673,0.9255047678739311,9.449086222222222,786.1254666666666,19.175884953215455,128,6.0E-5
5,test_20231101_135243,11610969.png,368720,24032,344688,0.9348231720546756,2,4,84111,3509,80602,0.9582813187335782,21.529770666666668,2995.306272,13.366391249809656,128,6.0E-5
6,test_20231101_135243,10350842.png,212614,5642,206972,0.9734636477372139,2,4,42529,830,41699,0.9804839051000493,19.393774222222223,2404.812736,14.319990975752292,128,6.0E-5
7,test_20231101_135243,10863862.png,317432,10677,306755,0.966364449708914,2,3,66058,1554,64504,0.9764752187471616,24.58188977777778,3464.000261333333,12.735024447582767,128,6.0E-5
8,test_20231101_135243,11382381.png,312486,917,311569,0.9970654685329903,2,3,46745,126,46619,0.99730452454808,21.089132444444445,2412.4090613333333,14.306294097973675,128,6.0E-5
9,test_20231101_135243,11079715.png,443815,113162,330653,0.7450243907934613,4,4,124136,15824,108312,0.872526905974093,17.42231111111111,2238.1416106666666,14.631927993255129,128,6.0E-5
10,test_20231101_135243,11551286.png,271883,917,270966,0.9966272256816351,2,3,40092,134,39958,0.9966576873191659,15.950851555555555,1533.329888,16.274447597479135,128,6.0E-5
1,test_20231101_135244,10404007.png,502730,18534,484196,0.9631332922244544,2,3,61265,2687,58578,0.956141353138007,25.885536,3487.714848,12.705393906287338,128,7.000000000000001E-5
2,test_20231101_135244,1254659.png,342646,69592,273054,0.7968982565096339,3,4,80080,9768,70312,0.878021978021978,21.430725333333335,3345.388144,12.88633847428336,128,7.000000000000001E-5
3,test_20231101_135244,10188041.png,221231,9309,211922,0.9579218102345513,2,3,41731,1311,40420,0.9685845055234718,10.629137777777778,1035.1340373333333,17.980837715530228,128,7.000000000000001E-5
4,test_20231101_135244,10287332.png,216980,12152,204828,0.9439948382339386,2,4,22337,1664,20673,0.9255047678739311,9.449086222222222,786.1254666666666,19.175884953215455,128,7.000000000000001E-5
5,test_20231101_135244,11610969.png,368720,24032,344688,0.9348231720546756,2,4,84111,3509,80602,0.9582813187335782,21.529770666666668,2995.306272,13.366391249809656,128,7.000000000000001E-5
6,test_20231101_135244,10350842.png,212614,5642,206972,0.9734636477372139,1,4,42529,830,41699,0.9804839051000493,19.393774222222223,2404.812736,14.319990975752292,128,7.000000000000001E-5
7,test_20231101_135244,10863862.png,317432,10677,306755,0.966364449708914,1,3,66058,1554,64504,0.9764752187471616,24.58188977777778,3464.000261333333,12.735024447582767,128,7.000000000000001E-5
8,test_20231101_135244,11382381.png,312486,917,311569,0.9970654685329903,2,3,46745,126,46619,0.99730452454808,21.089132444444445,2412.4090613333333,14.306294097973675,128,7.000000000000001E-5
9,test_20231101_135244,11079715.png,443815,113162,330653,0.7450243907934613,4,4,124136,15824,108312,0.872526905974093,17.42231111111111,2238.1416106666666,14.631927993255129,128,7.000000000000001E-5
10,test_20231101_135244,11551286.png,271883,797,271086,0.997068592004649,2,3,40092,116,39976,0.9971066546942033,16.03718577777778,1539.4418613333332,16.257170689141084,128,7.000000000000001E-5
1,test_20231101_135244,10404007.png,502730,18534,484196,0.9631332922244544,2,4,61265,2687,58578,0.956141353138007,25.885536,3487.714848,12.705393906287338,128,8.0E-5
2,test_20231101_135244,1254659.png,342646,69592,273054,0.7968982565096339,2,4,80080,9768,70312,0.878021978021978,21.430725333333335,3345.388144,12.88633847428336,128,8.0E-5
3,test_20231101_135244,10188041.png,221231,9309,211922,0.9579218102345513,2,3,41731,1311,40420,0.9685845055234718,10.629137777777778,1035.1340373333333,17.980837715530228,128,8.0E-5
4,test_20231101_135244,10287332.png,216980,12152,204828,0.9439948382339386,2,3,22337,1664,20673,0.9255047678739311,9.449086222222222,786.1254666666666,19.175884953215455,128,8.0E-5
5,test_20231101_135244,11610969.png,368720,24032,344688,0.9348231720546756,2,3,84111,3509,80602,0.9582813187335782,21.529770666666668,2995.306272,13.366391249809656,128,8.0E-5
6,test_20231101_135244,10350842.png,212614,5642,206972,0.9734636477372139,2,4,42529,830,41699,0.9804839051000493,19.393774222222223,2404.812736,14.319990975752292,128,8.0E-5
7,test_20231101_135244,10863862.png,317432,10677,306755,0.966364449708914,2,4,66058,1554,64504,0.9764752187471616,24.58188977777778,3464.000261333333,12.735024447582767,128,8.0E-5
8,test_20231101_135244,11382381.png,312486,917,311569,0.9970654685329903,1,3,46745,126,46619,0.99730452454808,21.089132444444445,2412.4090613333333,14.306294097973675,128,8.0E-5
9,test_20231101_135244,11079715.png,443815,113162,330653,0.7450243907934613,4,4,124136,15824,108312,0.872526905974093,17.42231111111111,2238.1416106666666,14.631927993255129,128,8.0E-5
10,test_20231101_135244,11551286.png,271883,797,271086,0.997068592004649,2,3,40092,116,39976,0.9971066546942033,16.03718577777778,1539.4418613333332,16.257170689141084,128,8.0E-5
1,test_20231101_135245,10404007.png,502730,18534,484196,0.9631332922244544,2,4,61265,2687,58578,0.956141353138007,25.885536,3487.714848,12.705393906287338,128,9.0E-5
2,test_20231101_135245,1254659.png,342646,69592,273054,0.7968982565096339,3,4,80080,9768,70312,0.878021978021978,21.430725333333335,3345.388144,12.88633847428336,128,9.0E-5
3,test_20231101_135245,10188041.png,221231,9309,211922,0.9579218102345513,2,4,41731,1311,40420,0.9685845055234718,10.629137777777778,1035.1340373333333,17.980837715530228,128,9.0E-5
4,test_20231101_135245,10287332.png,216980,12152,204828,0.9439948382339386,2,4,22337,1664,20673,0.9255047678739311,9.449086222222222,786.1254666666666,19.175884953215455,128,9.0E-5
5,test_20231101_135245,11610969.png,368720,24032,344688,0.9348231720546756,2,4,84111,3509,80602,0.9582813187335782,21.529770666666668,2995.306272,13.366391249809656,128,9.0E-5
6,test_20231101_135245,10350842.png,212614,5642,206972,0.9734636477372139,1,4,42529,830,41699,0.9804839051000493,19.393774222222223,2404.812736,14.319990975752292,128,9.0E-5
7,test_20231101_135245,10863862.png,317432,10677,306755,0.966364449708914,2,3,66058,1554,64504,0.9764752187471616,24.58188977777778,3464.000261333333,12.735024447582767,128,9.0E-5
8,test_20231101_135245,11382381.png,312486,917,311569,0.9970654685329903,2,3,46745,126,46619,0.99730452454808,21.089132444444445,2412.4090613333333,14.306294097973675,128,9.0E-5
9,test_20231101_135245,11079715.png,443815,113162,330653,0.7450243907934613,3,4,124136,15824,108312,0.872526905974093,17.42231111111111,2238.1416106666666,14.631927993255129,128,9.0E-5
10,test_20231101_135245,11551286.png,271883,797,271086,0.997068592004649,2,4,40092,116,39976,0.9971066546942033,16.03718577777778,1539.4418613333332,16.257170689141084,128,9.0E-5
1,test_20231101_135246,10404007.png,502730,18534,484196,0.9631332922244544,2,4,61265,2687,58578,0.956141353138007,25.885536,3487.714848,12.705393906287338,128,1.0E-4
2,test_20231101_135246,1254659.png,342646,69592,273054,0.7968982565096339,2,3,80080,9768,70312,0.878021978021978,21.430725333333335,3345.388144,12.88633847428336,128,1.0E-4
3,test_20231101_135246,10188041.png,221231,9309,211922,0.9579218102345513,2,3,41731,1311,40420,0.9685845055234718,10.629137777777778,1035.1340373333333,17.980837715530228,128,1.0E-4
4,test_20231101_135246,10287332.png,216980,12152,204828,0.9439948382339386,2,4,22337,1664,20673,0.9255047678739311,9.449086222222222,786.1254666666666,19.175884953215455,128,1.0E-4
5,test_20231101_135246,11610969.png,368720,24032,344688,0.9348231720546756,2,4,84111,3509,80602,0.9582813187335782,21.529770666666668,2995.306272,13.366391249809656,128,1.0E-4
6,test_20231101_135246,10350842.png,212614,5642,206972,0.9734636477372139,2,4,42529,830,41699,0.9804839051000493,19.393774222222223,2404.812736,14.319990975752292,128,1.0E-4
7,test_20231101_135246,10863862.png,317432,10677,306755,0.966364449708914,2,4,66058,1554,64504,0.9764752187471616,24.58188977777778,3464.000261333333,12.735024447582767,128,1.0E-4
8,test_20231101_135246,11382381.png,312486,917,311569,0.9970654685329903,2,4,46745,126,46619,0.99730452454808,21.089132444444445,2412.4090613333333,14.306294097973675,128,1.0E-4
9,test_20231101_135246,11079715.png,443815,113162,330653,0.7450243907934613,3,4,124136,15824,108312,0.872526905974093,17.42231111111111,2238.1416106666666,14.631927993255129,128,1.0E-4
10,test_20231101_135246,11551286.png,271883,797,271086,0.997068592004649,2,5,40092,116,39976,0.9971066546942033,16.03718577777778,1539.4418613333332,16.257170689141084,128,1.0E-4
1,test_20231101_135246,10404007.png,502730,18534,484196,0.9631332922244544,2,4,61265,2687,58578,0.956141353138007,25.885536,3487.714848,12.705393906287338,128,1.1E-4
2,test_20231101_135246,1254659.png,342646,69592,273054,0.7968982565096339,3,4,80080,9768,70312,0.878021978021978,21.430725333333335,3345.388144,12.88633847428336,128,1.1E-4
3,test_20231101_135246,10188041.png,221231,9309,211922,0.9579218102345513,2,4,41731,1311,40420,0.9685845055234718,10.629137777777778,1035.1340373333333,17.980837715530228,128,1.1E-4
4,test_20231101_135246,10287332.png,216980,12152,204828,0.9439948382339386,2,5,22337,1664,20673,0.9255047678739311,9.449086222222222,786.1254666666666,19.175884953215455,128,1.1E-4
5,test_20231101_135246,11610969.png,368720,24032,344688,0.9348231720546756,3,4,84111,3509,80602,0.9582813187335782,21.529770666666668,2995.306272,13.366391249809656,128,1.1E-4
6,test_20231101_135246,10350842.png,212614,5642,206972,0.9734636477372139,1,3,42529,830,41699,0.9804839051000493,19.393774222222223,2404.812736,14.319990975752292,128,1.1E-4
7,test_20231101_135246,10863862.png,317432,10677,306755,0.966364449708914,2,4,66058,1554,64504,0.9764752187471616,24.58188977777778,3464.000261333333,12.735024447582767,128,1.1E-4
8,test_20231101_135246,11382381.png,312486,917,311569,0.9970654685329903,2,4,46745,126,46619,0.99730452454808,21.089132444444445,2412.4090613333333,14.306294097973675,128,1.1E-4
9,test_20231101_135246,11079715.png,443815,113162,330653,0.7450243907934613,3,4,124136,15824,108312,0.872526905974093,17.42231111111111,2238.1416106666666,14.631927993255129,128,1.1E-4
10,test_20231101_135246,11551286.png,271883,797,271086,0.997068592004649,1,4,40092,116,39976,0.9971066546942033,16.03718577777778,1539.4418613333332,16.257170689141084,128,1.1E-4
1,test_20231101_135247,10404007.png,502730,18534,484196,0.9631332922244544,2,4,61265,2687,58578,0.956141353138007,25.885536,3487.714848,12.705393906287338,128,1.2E-4
2,test_20231101_135247,1254659.png,342646,69592,273054,0.7968982565096339,3,4,80080,9768,70312,0.878021978021978,21.430725333333335,3345.388144,12.88633847428336,128,1.2E-4
3,test_20231101_135247,10188041.png,221231,9309,211922,0.9579218102345513,3,4,41731,1311,40420,0.9685845055234718,10.629137777777778,1035.1340373333333,17.980837715530228,128,1.2E-4
4,test_20231101_135247,10287332.png,216980,12152,204828,0.9439948382339386,2,3,22337,1664,20673,0.9255047678739311,9.449086222222222,786.1254666666666,19.175884953215455,128,1.2E-4
5,test_20231101_135247,11610969.png,368720,24032,344688,0.9348231720546756,3,3,84111,3509,80602,0.9582813187335782,21.529770666666668,2995.306272,13.366391249809656,128,1.2E-4
6,test_20231101_135247,10350842.png,212614,5642,206972,0.9734636477372139,1,3,42529,830,41699,0.9804839051000493,19.393774222222223,2404.812736,14.319990975752292,128,1.2E-4
7,test_20231101_135247,10863862.png,317432,10677,306755,0.966364449708914,2,4,66058,1554,64504,0.9764752187471616,24.58188977777778,3464.000261333333,12.735024447582767,128,1.2E-4
8,test_20231101_135247,11382381.png,312486,917,311569,0.9970654685329903,1,3,46745,126,46619,0.99730452454808,21.089132444444445,2412.4090613333333,14.306294097973675,128,1.2E-4
9,test_20231101_135247,11079715.png,443815,113162,330653,0.7450243907934613,3,4,124136,15824,108312,0.872526905974093,17.42231111111111,2238.1416106666666,14.631927993255129,128,1.2E-4
10,test_20231101_135247,11551286.png,271883,797,271086,0.997068592004649,2,3,40092,116,39976,0.9971066546942033,16.03718577777778,1539.4418613333332,16.257170689141084,128,1.2E-4
1,test_20231101_135248,10404007.png,502730,18534,484196,0.9631332922244544,2,4,61265,2687,58578,0.956141353138007,25.885536,3487.714848,12.705393906287338,128,1.3000000000000002E-4
2,test_20231101_135248,1254659.png,342646,69592,273054,0.7968982565096339,3,4,80080,9768,70312,0.878021978021978,21.430725333333335,3345.388144,12.88633847428336,128,1.3000000000000002E-4
3,test_20231101_135248,10188041.png,221231,9309,211922,0.9579218102345513,2,4,41731,1311,40420,0.9685845055234718,10.629137777777778,1035.1340373333333,17.980837715530228,128,1.3000000000000002E-4
4,test_20231101_135248,10287332.png,216980,12152,204828,0.9439948382339386,2,4,22337,1664,20673,0.9255047678739311,9.449086222222222,786.1254666666666,19.175884953215455,128,1.3000000000000002E-4
5,test_20231101_135248,11610969.png,368720,24032,344688,0.9348231720546756,3,3,84111,3509,80602,0.9582813187335782,21.529770666666668,2995.306272,13.366391249809656,128,1.3000000000000002E-4
6,test_20231101_135248,10350842.png,212614,5642,206972,0.9734636477372139,2,3,42529,830,41699,0.9804839051000493,19.393774222222223,2404.812736,14.319990975752292,128,1.3000000000000002E-4
7,test_20231101_135248,10863862.png,317432,10677,306755,0.966364449708914,3,3,66058,1554,64504,0.9764752187471616,24.58188977777778,3464.000261333333,12.735024447582767,128,1.3000000000000002E-4
8,test_20231101_135248,11382381.png,312486,917,311569,0.9970654685329903,2,4,46745,126,46619,0.99730452454808,21.089132444444445,2412.4090613333333,14.306294097973675,128,1.3000000000000002E-4
9,test_20231101_135248,11079715.png,443815,113162,330653,0.7450243907934613,4,5,124136,15824,108312,0.872526905974093,17.42231111111111,2238.1416106666666,14.631927993255129,128,1.3000000000000002E-4
10,test_20231101_135248,11551286.png,271883,717,271166,0.9973628362199917,2,3,40092,104,39988,0.9974059662775616,17.035560888888888,1719.2356853333333,15.777449438530502,128,1.3000000000000002E-4
1,test_20231101_135248,10404007.png,502730,18534,484196,0.9631332922244544,2,4,61265,2687,58578,0.956141353138007,25.885536,3487.714848,12.705393906287338,128,1.4000000000000001E-4
2,test_20231101_135248,1254659.png,342646,69592,273054,0.7968982565096339,2,3,80080,9768,70312,0.878021978021978,21.430725333333335,3345.388144,12.88633847428336,128,1.4000000000000001E-4
3,test_20231101_135248,10188041.png,221231,9309,211922,0.9579218102345513,2,3,41731,1311,40420,0.9685845055234718,10.629137777777778,1035.1340373333333,17.980837715530228,128,1.4000000000000001E-4
4,test_20231101_135248,10287332.png,216980,12152,204828,0.9439948382339386,2,4,22337,1664,20673,0.9255047678739311,9.449086222222222,786.1254666666666,19.175884953215455,128,1.4000000000000001E-4
5,test_20231101_135248,11610969.png,368720,24032,344688,0.9348231720546756,2,3,84111,3509,80602,0.9582813187335782,21.529770666666668,2995.306272,13.366391249809656,128,1.4000000000000001E-4
6,test_20231101_135248,10350842.png,212614,5642,206972,0.9734636477372139,2,4,42529,830,41699,0.9804839051000493,19.393774222222223,2404.812736,14.319990975752292,128,1.4000000000000001E-4
7,test_20231101_135248,10863862.png,317432,10677,306755,0.966364449708914,2,4,66058,1554,64504,0.9764752187471616,24.58188977777778,3464.000261333333,12.735024447582767,128,1.4000000000000001E-4
8,test_20231101_135248,11382381.png,312486,917,311569,0.9970654685329903,2,3,46745,126,46619,0.99730452454808,21.089132444444445,2412.4090613333333,14.306294097973675,128,1.4000000000000001E-4
9,test_20231101_135248,11079715.png,443815,113162,330653,0.7450243907934613,4,4,124136,15824,108312,0.872526905974093,17.42231111111111,2238.1416106666666,14.631927993255129,128,1.4000000000000001E-4
10,test_20231101_135248,11551286.png,271883,717,271166,0.9973628362199917,1,3,40092,104,39988,0.9974059662775616,17.035560888888888,1719.2356853333333,15.777449438530502,128,1.4000000000000001E-4
1,test_20231101_135249,10404007.png,502730,18534,484196,0.9631332922244544,2,4,61265,2687,58578,0.956141353138007,25.885536,3487.714848,12.705393906287338,128,1.5000000000000001E-4
2,test_20231101_135249,1254659.png,342646,69592,273054,0.7968982565096339,2,4,80080,9768,70312,0.878021978021978,21.430725333333335,3345.388144,12.88633847428336,128,1.5000000000000001E-4
3,test_20231101_135249,10188041.png,221231,9309,211922,0.9579218102345513,2,3,41731,1311,40420,0.9685845055234718,10.629137777777778,1035.1340373333333,17.980837715530228,128,1.5000000000000001E-4
4,test_20231101_135249,10287332.png,216980,12152,204828,0.9439948382339386,2,4,22337,1664,20673,0.9255047678739311,9.449086222222222,786.1254666666666,19.175884953215455,128,1.5000000000000001E-4
5,test_20231101_135249,11610969.png,368720,24032,344688,0.9348231720546756,3,4,84111,3509,80602,0.9582813187335782,21.529770666666668,2995.306272,13.366391249809656,128,1.5000000000000001E-4
6,test_20231101_135249,10350842.png,212614,5642,206972,0.9734636477372139,2,3,42529,830,41699,0.9804839051000493,19.393774222222223,2404.812736,14.319990975752292,128,1.5000000000000001E-4
7,test_20231101_135249,10863862.png,317432,10677,306755,0.966364449708914,2,4,66058,1554,64504,0.9764752187471616,24.58188977777778,3464.000261333333,12.735024447582767,128,1.5000000000000001E-4
8,test_20231101_135249,11382381.png,312486,787,311699,0.9974814871706252,2,3,46745,107,46638,0.9977109851320997,21.347548444444445,2452.9523093333332,14.233912561978928,128,1.5000000000000001E-4
9,test_20231101_135249,11079715.png,443815,113162,330653,0.7450243907934613,3,4,124136,15824,108312,0.872526905974093,17.42231111111111,2238.1416106666666,14.631927993255129,128,1.5000000000000001E-4
10,test_20231101_135249,11551286.png,271883,717,271166,0.9973628362199917,2,4,40092,104,39988,0.9974059662775616,17.035560888888888,1719.2356853333333,15.777449438530502,128,1.5000000000000001E-4
1,test_20231101_135250,10404007.png,502730,18534,484196,0.9631332922244544,2,4,61265,2687,58578,0.956141353138007,25.885536,3487.714848,12.705393906287338,128,1.6E-4
2,test_20231101_135250,1254659.png,342646,69592,273054,0.7968982565096339,3,4,80080,9768,70312,0.878021978021978,21.430725333333335,3345.388144,12.88633847428336,128,1.6E-4
3,test_20231101_135250,10188041.png,221231,9309,211922,0.9579218102345513,2,3,41731,1311,40420,0.9685845055234718,10.629137777777778,1035.1340373333333,17.980837715530228,128,1.6E-4
4,test_20231101_135250,10287332.png,216980,11942,205038,0.9449626693704489,2,4,22337,1637,20700,0.9267135246452075,9.578848,812.8562133333334,19.03066631114696,128,1.6E-4
5,test_20231101_135250,11610969.png,368720,24032,344688,0.9348231720546756,2,4,84111,3509,80602,0.9582813187335782,21.529770666666668,2995.306272,13.366391249809656,128,1.6E-4
6,test_20231101_135250,10350842.png,212614,5642,206972,0.9734636477372139,1,4,42529,830,41699,0.9804839051000493,19.393774222222223,2404.812736,14.319990975752292,128,1.6E-4
7,test_20231101_135250,10863862.png,317432,10677,306755,0.966364449708914,2,3,66058,1554,64504,0.9764752187471616,24.58188977777778,3464.000261333333,12.735024447582767,128,1.6E-4
8,test_20231101_135250,11382381.png,312486,787,311699,0.9974814871706252,2,4,46745,107,46638,0.9977109851320997,21.347548444444445,2452.9523093333332,14.233912561978928,128,1.6E-4
9,test_20231101_135250,11079715.png,443815,113162,330653,0.7450243907934613,3,4,124136,15824,108312,0.872526905974093,17.42231111111111,2238.1416106666666,14.631927993255129,128,1.6E-4
10,test_20231101_135250,11551286.png,271883,717,271166,0.9973628362199917,2,4,40092,104,39988,0.9974059662775616,17.035560888888888,1719.2356853333333,15.777449438530502,128,1.6E-4
1,test_20231101_135250,10404007.png,502730,18534,484196,0.9631332922244544,2,3,61265,2687,58578,0.956141353138007,25.885536,3487.714848,12.705393906287338,128,1.7E-4
2,test_20231101_135250,1254659.png,342646,69592,273054,0.7968982565096339,2,4,80080,9768,70312,0.878021978021978,21.430725333333335,3345.388144,12.88633847428336,128,1.7E-4
3,test_20231101_135250,10188041.png,221231,9309,211922,0.9579218102345513,2,3,41731,1311,40420,0.9685845055234718,10.629137777777778,1035.1340373333333,17.980837715530228,128,1.7E-4
4,test_20231101_135250,10287332.png,216980,11942,205038,0.9449626693704489,1,4,22337,1637,20700,0.9267135246452075,9.578848,812.8562133333334,19.03066631114696,128,1.7E-4
5,test_20231101_135250,11610969.png,368720,24032,344688,0.9348231720546756,2,3,84111,3509,80602,0.9582813187335782,21.529770666666668,2995.306272,13.366391249809656,128,1.7E-4
6,test_20231101_135250,10350842.png,212614,5642,206972,0.9734636477372139,2,3,42529,830,41699,0.9804839051000493,19.393774222222223,2404.812736,14.319990975752292,128,1.7E-4
7,test_20231101_135250,10863862.png,317432,10677,306755,0.966364449708914,2,3,66058,1554,64504,0.9764752187471616,24.58188977777778,3464.000261333333,12.735024447582767,128,1.7E-4
8,test_20231101_135250,11382381.png,312486,787,311699,0.9974814871706252,2,3,46745,107,46638,0.9977109851320997,21.347548444444445,2452.9523093333332,14.233912561978928,128,1.7E-4
9,test_20231101_135250,11079715.png,443815,113162,330653,0.7450243907934613,3,4,124136,15824,108312,0.872526905974093,17.42231111111111,2238.1416106666666,14.631927993255129,128,1.7E-4
10,test_20231101_135250,11551286.png,271883,717,271166,0.9973628362199917,1,3,40092,104,39988,0.9974059662775616,17.035560888888888,1719.2356853333333,15.777449438530502,128,1.7E-4
1,test_20231101_135251,10404007.png,502730,18534,484196,0.9631332922244544,2,4,61265,2687,58578,0.956141353138007,25.885536,3487.714848,12.705393906287338,128,1.8E-4
2,test_20231101_135251,1254659.png,342646,69592,273054,0.7968982565096339,2,4,80080,9768,70312,0.878021978021978,21.430725333333335,3345.388144,12.88633847428336,128,1.8E-4
3,test_20231101_135251,10188041.png,221231,9309,211922,0.9579218102345513,2,4,41731,1311,40420,0.9685845055234718,10.629137777777778,1035.1340373333333,17.980837715530228,128,1.8E-4
4,test_20231101_135251,10287332.png,216980,11942,205038,0.9449626693704489,2,3,22337,1637,20700,0.9267135246452075,9.578848,812.8562133333334,19.03066631114696,128,1.8E-4
5,test_20231101_135251,11610969.png,368720,24032,344688,0.9348231720546756,8,5,84111,3509,80602,0.9582813187335782,21.529770666666668,2995.306272,13.366391249809656,128,1.8E-4
6,test_20231101_135251,10350842.png,212614,5642,206972,0.9734636477372139,1,4,42529,830,41699,0.9804839051000493,19.393774222222223,2404.812736,14.319990975752292,128,1.8E-4
7,test_20231101_135251,10863862.png,317432,10677,306755,0.966364449708914,2,4,66058,1554,64504,0.9764752187471616,24.58188977777778,3464.000261333333,12.735024447582767,128,1.8E-4
8,test_20231101_135251,11382381.png,312486,787,311699,0.9974814871706252,2,4,46745,107,46638,0.9977109851320997,21.347548444444445,2452.9523093333332,14.233912561978928,128,1.8E-4
9,test_20231101_135251,11079715.png,443815,113162,330653,0.7450243907934613,4,4,124136,15824,108312,0.872526905974093,17.42231111111111,2238.1416106666666,14.631927993255129,128,1.8E-4
10,test_20231101_135251,11551286.png,271883,717,271166,0.9973628362199917,2,3,40092,104,39988,0.9974059662775616,17.035560888888888,1719.2356853333333,15.777449438530502,128,1.8E-4
1,test_20231101_135252,10404007.png,502730,18534,484196,0.9631332922244544,3,3,61265,2687,58578,0.956141353138007,25.885536,3487.714848,12.705393906287338,128,1.9E-4
2,test_20231101_135252,1254659.png,342646,69592,273054,0.7968982565096339,3,5,80080,9768,70312,0.878021978021978,21.430725333333335,3345.388144,12.88633847428336,128,1.9E-4
3,test_20231101_135252,10188041.png,221231,9309,211922,0.9579218102345513,3,3,41731,1311,40420,0.9685845055234718,10.629137777777778,1035.1340373333333,17.980837715530228,128,1.9E-4
4,test_20231101_135252,10287332.png,216980,11942,205038,0.9449626693704489,1,4,22337,1637,20700,0.9267135246452075,9.578848,812.8562133333334,19.03066631114696,128,1.9E-4
5,test_20231101_135252,11610969.png,368720,24032,344688,0.9348231720546756,2,3,84111,3509,80602,0.9582813187335782,21.529770666666668,2995.306272,13.366391249809656,128,1.9E-4
6,test_20231101_135252,10350842.png,212614,5642,206972,0.9734636477372139,1,4,42529,830,41699,0.9804839051000493,19.393774222222223,2404.812736,14.319990975752292,128,1.9E-4
7,test_20231101_135252,10863862.png,317432,10677,306755,0.966364449708914,2,4,66058,1554,64504,0.9764752187471616,24.58188977777778,3464.000261333333,12.735024447582767,128,1.9E-4
8,test_20231101_135252,11382381.png,312486,787,311699,0.9974814871706252,2,4,46745,107,46638,0.9977109851320997,21.347548444444445,2452.9523093333332,14.233912561978928,128,1.9E-4
9,test_20231101_135252,11079715.png,443815,113162,330653,0.7450243907934613,3,4,124136,15824,108312,0.872526905974093,17.42231111111111,2238.1416106666666,14.631927993255129,128,1.9E-4
10,test_20231101_135252,11551286.png,271883,717,271166,0.9973628362199917,1,4,40092,104,39988,0.9974059662775616,17.035560888888888,1719.2356853333333,15.777449438530502,128,1.9E-4
1,test_20231101_135252,10404007.png,502730,18534,484196,0.9631332922244544,3,4,61265,2687,58578,0.956141353138007,25.885536,3487.714848,12.705393906287338,128,2.0E-4
2,test_20231101_135252,1254659.png,342646,69592,273054,0.7968982565096339,3,4,80080,9768,70312,0.878021978021978,21.430725333333335,3345.388144,12.88633847428336,128,2.0E-4
3,test_20231101_135252,10188041.png,221231,9309,211922,0.9579218102345513,2,4,41731,1311,40420,0.9685845055234718,10.629137777777778,1035.1340373333333,17.980837715530228,128,2.0E-4
4,test_20231101_135252,10287332.png,216980,11942,205038,0.9449626693704489,1,4,22337,1637,20700,0.9267135246452075,9.578848,812.8562133333334,19.03066631114696,128,2.0E-4
5,test_20231101_135252,11610969.png,368720,24032,344688,0.9348231720546756,10,5,84111,3509,80602,0.9582813187335782,21.529770666666668,2995.306272,13.366391249809656,128,2.0E-4
6,test_20231101_135252,10350842.png,212614,5642,206972,0.9734636477372139,1,3,42529,830,41699,0.9804839051000493,19.393774222222223,2404.812736,14.319990975752292,128,2.0E-4
7,test_20231101_135252,10863862.png,317432,10677,306755,0.966364449708914,2,4,66058,1554,64504,0.9764752187471616,24.58188977777778,3464.000261333333,12.735024447582767,128,2.0E-4
8,test_20231101_135252,11382381.png,312486,787,311699,0.9974814871706252,2,4,46745,107,46638,0.9977109851320997,21.347548444444445,2452.9523093333332,14.233912561978928,128,2.0E-4
9,test_20231101_135252,11079715.png,443815,113162,330653,0.7450243907934613,3,5,124136,15824,108312,0.872526905974093,17.42231111111111,2238.1416106666666,14.631927993255129,128,2.0E-4
10,test_20231101_135252,11551286.png,271883,597,271286,0.9978042025430056,1,8,40092,86,40006,0.997854933652599,17.58564977777778,1815.0887466666666,15.541824966498465,128,2.0E-4
1,test_20231101_135253,10404007.png,502730,18534,484196,0.9631332922244544,3,3,61265,2687,58578,0.956141353138007,25.885536,3487.714848,12.705393906287338,128,2.1E-4
2,test_20231101_135253,1254659.png,342646,69592,273054,0.7968982565096339,2,4,80080,9768,70312,0.878021978021978,21.430725333333335,3345.388144,12.88633847428336,128,2.1E-4
3,test_20231101_135253,10188041.png,221231,9309,211922,0.9579218102345513,2,3,41731,1311,40420,0.9685845055234718,10.629137777777778,1035.1340373333333,17.980837715530228,128,2.1E-4
4,test_20231101_135253,10287332.png,216980,11942,205038,0.9449626693704489,2,4,22337,1637,20700,0.9267135246452075,9.578848,812.8562133333334,19.03066631114696,128,2.1E-4
5,test_20231101_135253,11610969.png,368720,24032,344688,0.9348231720546756,4,4,84111,3509,80602,0.9582813187335782,21.529770666666668,2995.306272,13.366391249809656,128,2.1E-4
6,test_20231101_135253,10350842.png,212614,5642,206972,0.9734636477372139,2,6,42529,830,41699,0.9804839051000493,19.393774222222223,2404.812736,14.319990975752292,128,2.1E-4
7,test_20231101_135253,10863862.png,317432,10677,306755,0.966364449708914,2,4,66058,1554,64504,0.9764752187471616,24.58188977777778,3464.000261333333,12.735024447582767,128,2.1E-4
8,test_20231101_135253,11382381.png,312486,787,311699,0.9974814871706252,2,3,46745,107,46638,0.9977109851320997,21.347548444444445,2452.9523093333332,14.233912561978928,128,2.1E-4
9,test_20231101_135253,11079715.png,443815,113162,330653,0.7450243907934613,3,4,124136,15824,108312,0.872526905974093,17.42231111111111,2238.1416106666666,14.631927993255129,128,2.1E-4
10,test_20231101_135253,11551286.png,271883,597,271286,0.9978042025430056,1,3,40092,86,40006,0.997854933652599,17.58564977777778,1815.0887466666666,15.541824966498465,128,2.1E-4
1,test_20231101_135254,10404007.png,502730,18534,484196,0.9631332922244544,2,4,61265,2687,58578,0.956141353138007,25.885536,3487.714848,12.705393906287338,128,2.2E-4
2,test_20231101_135254,1254659.png,342646,69592,273054,0.7968982565096339,3,4,80080,9768,70312,0.878021978021978,21.430725333333335,3345.388144,12.88633847428336,128,2.2E-4
3,test_20231101_135254,10188041.png,221231,9309,211922,0.9579218102345513,2,4,41731,1311,40420,0.9685845055234718,10.629137777777778,1035.1340373333333,17.980837715530228,128,2.2E-4
4,test_20231101_135254,10287332.png,216980,11942,205038,0.9449626693704489,4,4,22337,1637,20700,0.9267135246452075,9.578848,812.8562133333334,19.03066631114696,128,2.2E-4
5,test_20231101_135254,11610969.png,368720,24032,344688,0.9348231720546756,3,8,84111,3509,80602,0.9582813187335782,21.529770666666668,2995.306272,13.366391249809656,128,2.2E-4
6,test_20231101_135254,10350842.png,212614,5642,206972,0.9734636477372139,1,3,42529,830,41699,0.9804839051000493,19.393774222222223,2404.812736,14.319990975752292,128,2.2E-4
7,test_20231101_135254,10863862.png,317432,10677,306755,0.966364449708914,2,3,66058,1554,64504,0.9764752187471616,24.58188977777778,3464.000261333333,12.735024447582767,128,2.2E-4
8,test_20231101_135254,11382381.png,312486,787,311699,0.9974814871706252,2,4,46745,107,46638,0.9977109851320997,21.347548444444445,2452.9523093333332,14.233912561978928,128,2.2E-4
9,test_20231101_135254,11079715.png,443815,113162,330653,0.7450243907934613,3,5,124136,15824,108312,0.872526905974093,17.42231111111111,2238.1416106666666,14.631927993255129,128,2.2E-4
10,test_20231101_135254,11551286.png,271883,597,271286,0.9978042025430056,1,3,40092,86,40006,0.997854933652599,17.58564977777778,1815.0887466666666,15.541824966498465,128,2.2E-4
1,test_20231101_135254,10404007.png,502730,18534,484196,0.9631332922244544,2,4,61265,2687,58578,0.956141353138007,25.885536,3487.714848,12.705393906287338,128,2.3E-4
2,test_20231101_135254,1254659.png,342646,69592,273054,0.7968982565096339,3,5,80080,9768,70312,0.878021978021978,21.430725333333335,3345.388144,12.88633847428336,128,2.3E-4
3,test_20231101_135254,10188041.png,221231,9309,211922,0.9579218102345513,2,3,41731,1311,40420,0.9685845055234718,10.629137777777778,1035.1340373333333,17.980837715530228,128,2.3E-4
4,test_20231101_135254,10287332.png,216980,11942,205038,0.9449626693704489,1,4,22337,1637,20700,0.9267135246452075,9.578848,812.8562133333334,19.03066631114696,128,2.3E-4
5,test_20231101_135254,11610969.png,368720,24032,344688,0.9348231720546756,2,4,84111,3509,80602,0.9582813187335782,21.529770666666668,2995.306272,13.366391249809656,128,2.3E-4
6,test_20231101_135254,10350842.png,212614,5642,206972,0.9734636477372139,2,3,42529,830,41699,0.9804839051000493,19.393774222222223,2404.812736,14.319990975752292,128,2.3E-4
7,test_20231101_135254,10863862.png,317432,10677,306755,0.966364449708914,2,4,66058,1554,64504,0.9764752187471616,24.58188977777778,3464.000261333333,12.735024447582767,128,2.3E-4
8,test_20231101_135254,11382381.png,312486,787,311699,0.9974814871706252,1,4,46745,107,46638,0.9977109851320997,21.347548444444445,2452.9523093333332,14.233912561978928,128,2.3E-4
9,test_20231101_135254,11079715.png,443815,113162,330653,0.7450243907934613,3,4,124136,15824,108312,0.872526905974093,17.42231111111111,2238.1416106666666,14.631927993255129,128,2.3E-4
10,test_20231101_135254,11551286.png,271883,327,271556,0.998797276769787,2,3,40092,46,40046,0.99885263893046,17.867866666666668,1859.2518453333332,15.437421396648572,128,2.3E-4
1,test_20231101_135255,10404007.png,502730,18534,484196,0.9631332922244544,2,3,61265,2687,58578,0.956141353138007,25.885536,3487.714848,12.705393906287338,128,2.4E-4
2,test_20231101_135255,1254659.png,342646,69592,273054,0.7968982565096339,4,7,80080,9768,70312,0.878021978021978,21.430725333333335,3345.388144,12.88633847428336,128,2.4E-4
3,test_20231101_135255,10188041.png,221231,9309,211922,0.9579218102345513,2,3,41731,1311,40420,0.9685845055234718,10.629137777777778,1035.1340373333333,17.980837715530228,128,2.4E-4
4,test_20231101_135255,10287332.png,216980,11942,205038,0.9449626693704489,2,4,22337,1637,20700,0.9267135246452075,9.578848,812.8562133333334,19.03066631114696,128,2.4E-4
5,test_20231101_135255,11610969.png,368720,24032,344688,0.9348231720546756,2,4,84111,3509,80602,0.9582813187335782,21.529770666666668,2995.306272,13.366391249809656,128,2.4E-4
6,test_20231101_135255,10350842.png,212614,5642,206972,0.9734636477372139,1,3,42529,830,41699,0.9804839051000493,19.393774222222223,2404.812736,14.319990975752292,128,2.4E-4
7,test_20231101_135255,10863862.png,317432,10677,306755,0.966364449708914,2,3,66058,1554,64504,0.9764752187471616,24.58188977777778,3464.000261333333,12.735024447582767,128,2.4E-4
8,test_20231101_135255,11382381.png,312486,787,311699,0.9974814871706252,1,4,46745,107,46638,0.9977109851320997,21.347548444444445,2452.9523093333332,14.233912561978928,128,2.4E-4
9,test_20231101_135255,11079715.png,443815,113162,330653,0.7450243907934613,3,5,124136,15824,108312,0.872526905974093,17.42231111111111,2238.1416106666666,14.631927993255129,128,2.4E-4
10,test_20231101_135255,11551286.png,271883,327,271556,0.998797276769787,1,11,40092,46,40046,0.99885263893046,17.867866666666668,1859.2518453333332,15.437421396648572,128,2.4E-4
1,test_20231101_135256,10404007.png,502730,18534,484196,0.9631332922244544,2,4,61265,2687,58578,0.956141353138007,25.885536,3487.714848,12.705393906287338,128,2.5E-4
2,test_20231101_135256,1254659.png,342646,69592,273054,0.7968982565096339,3,4,80080,9768,70312,0.878021978021978,21.430725333333335,3345.388144,12.88633847428336,128,2.5E-4
3,test_20231101_135256,10188041.png,221231,9309,211922,0.9579218102345513,2,4,41731,1311,40420,0.9685845055234718,10.629137777777778,1035.1340373333333,17.980837715530228,128,2.5E-4
4,test_20231101_135256,10287332.png,216980,11942,205038,0.9449626693704489,1,3,22337,1637,20700,0.9267135246452075,9.578848,812.8562133333334,19.03066631114696,128,2.5E-4
5,test_20231101_135256,11610969.png,368720,24032,344688,0.9348231720546756,3,4,84111,3509,80602,0.9582813187335782,21.529770666666668,2995.306272,13.366391249809656,128,2.5E-4
6,test_20231101_135256,10350842.png,212614,5642,206972,0.9734636477372139,2,4,42529,830,41699,0.9804839051000493,19.393774222222223,2404.812736,14.319990975752292,128,2.5E-4
7,test_20231101_135256,10863862.png,317432,10677,306755,0.966364449708914,2,3,66058,1554,64504,0.9764752187471616,24.58188977777778,3464.000261333333,12.735024447582767,128,2.5E-4
8,test_20231101_135256,11382381.png,312486,787,311699,0.9974814871706252,2,4,46745,107,46638,0.9977109851320997,21.347548444444445,2452.9523093333332,14.233912561978928,128,2.5E-4
9,test_20231101_135256,11079715.png,443815,113162,330653,0.7450243907934613,5,5,124136,15824,108312,0.872526905974093,17.42231111111111,2238.1416106666666,14.631927993255129,128,2.5E-4
10,test_20231101_135256,11551286.png,271883,327,271556,0.998797276769787,2,4,40092,46,40046,0.99885263893046,17.867866666666668,1859.2518453333332,15.437421396648572,128,2.5E-4
1,test_20231101_135257,10404007.png,502730,18032,484698,0.9641318401527659,3,4,61265,2618,58647,0.9572676079327511,25.992037333333332,3511.230128,12.676210665648235,128,2.6000000000000003E-4
2,test_20231101_135257,1254659.png,342646,69532,273114,0.7970733643468769,4,4,80080,9762,70318,0.8780969030969031,21.44027911111111,3346.4703306666665,12.884933819048644,128,2.6000000000000003E-4
3,test_20231101_135257,10188041.png,221231,9269,211962,0.958102616721888,3,4,41731,1305,40426,0.9687282835302293,10.994965333333333,1087.4147413333333,17.76685144730885,128,2.6000000000000003E-4
4,test_20231101_135257,10287332.png,216980,11942,205038,0.9449626693704489,2,4,22337,1637,20700,0.9267135246452075,9.578848,812.8562133333334,19.03066631114696,128,2.6000000000000003E-4
5,test_20231101_135257,11610969.png,368720,23467,345253,0.9363555001084833,2,3,84111,3427,80684,0.9592562209461307,22.418577777777777,3189.8884373333335,13.093048664934157,128,2.6000000000000003E-4
6,test_20231101_135257,10350842.png,212614,5562,207052,0.9738399164683417,1,4,42529,818,41711,0.9807660655082414,19.46256711111111,2410.5704426666666,14.30960533734045,128,2.6000000000000003E-4
7,test_20231101_135257,10863862.png,317432,10557,306875,0.966742483429522,2,3,66058,1536,64522,0.976747706560901,24.63304711111111,3467.3115253333335,12.730874976784207,128,2.6000000000000003E-4
8,test_20231101_135257,11382381.png,312486,667,311819,0.997865504374596,2,4,46745,89,46656,0.9980960530538026,21.842074666666665,2522.8946186666667,14.11181250456314,128,2.6000000000000003E-4
9,test_20231101_135257,11079715.png,443815,113162,330653,0.7450243907934613,4,4,124136,15824,108312,0.872526905974093,17.42231111111111,2238.1416106666666,14.631927993255129,128,2.6000000000000003E-4
10,test_20231101_135257,11551286.png,271883,267,271616,0.9990179599312939,1,14,40092,37,40055,0.9990771226179787,18.016108444444445,1877.54488,15.394900338849709,128,2.6000000000000003E-4
1,test_20231101_135257,10404007.png,502730,18032,484698,0.9641318401527659,2,4,61265,2618,58647,0.9572676079327511,25.992037333333332,3511.230128,12.676210665648235,128,2.7000000000000006E-4
2,test_20231101_135257,1254659.png,342646,69532,273114,0.7970733643468769,3,4,80080,9762,70318,0.8780969030969031,21.44027911111111,3346.4703306666665,12.884933819048644,128,2.7000000000000006E-4
3,test_20231101_135257,10188041.png,221231,9269,211962,0.958102616721888,2,3,41731,1305,40426,0.9687282835302293,10.994965333333333,1087.4147413333333,17.76685144730885,128,2.7000000000000006E-4
4,test_20231101_135257,10287332.png,216980,11942,205038,0.9449626693704489,2,4,22337,1637,20700,0.9267135246452075,9.578848,812.8562133333334,19.03066631114696,128,2.7000000000000006E-4
5,test_20231101_135257,11610969.png,368720,23467,345253,0.9363555001084833,2,3,84111,3427,80684,0.9592562209461307,22.418577777777777,3189.8884373333335,13.093048664934157,128,2.7000000000000006E-4
6,test_20231101_135257,10350842.png,212614,5562,207052,0.9738399164683417,2,4,42529,818,41711,0.9807660655082414,19.46256711111111,2410.5704426666666,14.30960533734045,128,2.7000000000000006E-4
7,test_20231101_135257,10863862.png,317432,10557,306875,0.966742483429522,2,3,66058,1536,64522,0.976747706560901,24.63304711111111,3467.3115253333335,12.730874976784207,128,2.7000000000000006E-4
8,test_20231101_135257,11382381.png,312486,667,311819,0.997865504374596,1,4,46745,89,46656,0.9980960530538026,21.842074666666665,2522.8946186666667,14.11181250456314,128,2.7000000000000006E-4
9,test_20231101_135257,11079715.png,443815,113162,330653,0.7450243907934613,4,4,124136,15824,108312,0.872526905974093,17.42231111111111,2238.1416106666666,14.631927993255129,128,2.7000000000000006E-4
10,test_20231101_135257,11551286.png,271883,267,271616,0.9990179599312939,2,4,40092,37,40055,0.9990771226179787,18.016108444444445,1877.54488,15.394900338849709,128,2.7000000000000006E-4
1,test_20231101_135258,10404007.png,502730,18032,484698,0.9641318401527659,2,3,61265,2618,58647,0.9572676079327511,25.992037333333332,3511.230128,12.676210665648235,128,2.800000000000001E-4
2,test_20231101_135258,1254659.png,342646,69532,273114,0.7970733643468769,3,4,80080,9762,70318,0.8780969030969031,21.44027911111111,3346.4703306666665,12.884933819048644,128,2.800000000000001E-4
3,test_20231101_135258,10188041.png,221231,9269,211962,0.958102616721888,1,3,41731,1305,40426,0.9687282835302293,10.994965333333333,1087.4147413333333,17.76685144730885,128,2.800000000000001E-4
4,test_20231101_135258,10287332.png,216980,11942,205038,0.9449626693704489,1,4,22337,1637,20700,0.9267135246452075,9.578848,812.8562133333334,19.03066631114696,128,2.800000000000001E-4
5,test_20231101_135258,11610969.png,368720,23467,345253,0.9363555001084833,2,3,84111,3427,80684,0.9592562209461307,22.418577777777777,3189.8884373333335,13.093048664934157,128,2.800000000000001E-4
6,test_20231101_135258,10350842.png,212614,5562,207052,0.9738399164683417,1,4,42529,818,41711,0.9807660655082414,19.46256711111111,2410.5704426666666,14.30960533734045,128,2.800000000000001E-4
7,test_20231101_135258,10863862.png,317432,10557,306875,0.966742483429522,2,4,66058,1536,64522,0.976747706560901,24.63304711111111,3467.3115253333335,12.730874976784207,128,2.800000000000001E-4
8,test_20231101_135258,11382381.png,312486,667,311819,0.997865504374596,2,4,46745,89,46656,0.9980960530538026,21.842074666666665,2522.8946186666667,14.11181250456314,128,2.800000000000001E-4
9,test_20231101_135258,11079715.png,443815,113162,330653,0.7450243907934613,3,4,124136,15824,108312,0.872526905974093,17.42231111111111,2238.1416106666666,14.631927993255129,128,2.800000000000001E-4
10,test_20231101_135258,11551286.png,271883,267,271616,0.9990179599312939,1,3,40092,37,40055,0.9990771226179787,18.016108444444445,1877.54488,15.394900338849709,128,2.800000000000001E-4
1,test_20231101_135259,10404007.png,502730,18032,484698,0.9641318401527659,2,4,61265,2618,58647,0.9572676079327511,25.992037333333332,3511.230128,12.676210665648235,128,2.900000000000001E-4
2,test_20231101_135259,1254659.png,342646,69532,273114,0.7970733643468769,3,4,80080,9762,70318,0.8780969030969031,21.44027911111111,3346.4703306666665,12.884933819048644,128,2.900000000000001E-4
3,test_20231101_135259,10188041.png,221231,9269,211962,0.958102616721888,2,4,41731,1305,40426,0.9687282835302293,10.994965333333333,1087.4147413333333,17.76685144730885,128,2.900000000000001E-4
4,test_20231101_135259,10287332.png,216980,11942,205038,0.9449626693704489,2,4,22337,1637,20700,0.9267135246452075,9.578848,812.8562133333334,19.03066631114696,128,2.900000000000001E-4
5,test_20231101_135259,11610969.png,368720,23467,345253,0.9363555001084833,3,3,84111,3427,80684,0.9592562209461307,22.418577777777777,3189.8884373333335,13.093048664934157,128,2.900000000000001E-4
6,test_20231101_135259,10350842.png,212614,5562,207052,0.9738399164683417,1,4,42529,818,41711,0.9807660655082414,19.46256711111111,2410.5704426666666,14.30960533734045,128,2.900000000000001E-4
7,test_20231101_135259,10863862.png,317432,10557,306875,0.966742483429522,2,4,66058,1536,64522,0.976747706560901,24.63304711111111,3467.3115253333335,12.730874976784207,128,2.900000000000001E-4
8,test_20231101_135259,11382381.png,312486,667,311819,0.997865504374596,2,3,46745,89,46656,0.9980960530538026,21.842074666666665,2522.8946186666667,14.11181250456314,128,2.900000000000001E-4
9,test_20231101_135259,11079715.png,443815,113162,330653,0.7450243907934613,3,4,124136,15824,108312,0.872526905974093,17.42231111111111,2238.1416106666666,14.631927993255129,128,2.900000000000001E-4
10,test_20231101_135259,11551286.png,271883,267,271616,0.9990179599312939,1,3,40092,37,40055,0.9990771226179787,18.016108444444445,1877.54488,15.394900338849709,128,2.900000000000001E-4
1,test_20231101_135259,10404007.png,502730,18032,484698,0.9641318401527659,2,3,61265,2618,58647,0.9572676079327511,25.992037333333332,3511.230128,12.676210665648235,128,3.0000000000000014E-4
2,test_20231101_135259,1254659.png,342646,69532,273114,0.7970733643468769,3,4,80080,9762,70318,0.8780969030969031,21.44027911111111,3346.4703306666665,12.884933819048644,128,3.0000000000000014E-4
3,test_20231101_135259,10188041.png,221231,9269,211962,0.958102616721888,3,3,41731,1305,40426,0.9687282835302293,10.994965333333333,1087.4147413333333,17.76685144730885,128,3.0000000000000014E-4
4,test_20231101_135259,10287332.png,216980,11942,205038,0.9449626693704489,2,3,22337,1637,20700,0.9267135246452075,9.578848,812.8562133333334,19.03066631114696,128,3.0000000000000014E-4
5,test_20231101_135259,11610969.png,368720,23467,345253,0.9363555001084833,3,3,84111,3427,80684,0.9592562209461307,22.418577777777777,3189.8884373333335,13.093048664934157,128,3.0000000000000014E-4
6,test_20231101_135259,10350842.png,212614,5562,207052,0.9738399164683417,2,4,42529,818,41711,0.9807660655082414,19.46256711111111,2410.5704426666666,14.30960533734045,128,3.0000000000000014E-4
7,test_20231101_135259,10863862.png,317432,10557,306875,0.966742483429522,2,3,66058,1536,64522,0.976747706560901,24.63304711111111,3467.3115253333335,12.730874976784207,128,3.0000000000000014E-4
8,test_20231101_135259,11382381.png,312486,667,311819,0.997865504374596,1,3,46745,89,46656,0.9980960530538026,21.842074666666665,2522.8946186666667,14.11181250456314,128,3.0000000000000014E-4
9,test_20231101_135259,11079715.png,443815,113162,330653,0.7450243907934613,3,4,124136,15824,108312,0.872526905974093,17.42231111111111,2238.1416106666666,14.631927993255129,128,3.0000000000000014E-4
10,test_20231101_135259,11551286.png,271883,267,271616,0.9990179599312939,1,3,40092,37,40055,0.9990771226179787,18.016108444444445,1877.54488,15.394900338849709,128,3.0000000000000014E-4
1,test_20231101_135300,10404007.png,502730,18032,484698,0.9641318401527659,2,4,61265,2618,58647,0.9572676079327511,25.992037333333332,3511.230128,12.676210665648235,128,3.1000000000000016E-4
2,test_20231101_135300,1254659.png,342646,69532,273114,0.7970733643468769,2,4,80080,9762,70318,0.8780969030969031,21.44027911111111,3346.4703306666665,12.884933819048644,128,3.1000000000000016E-4
3,test_20231101_135300,10188041.png,221231,9269,211962,0.958102616721888,2,4,41731,1305,40426,0.9687282835302293,10.994965333333333,1087.4147413333333,17.76685144730885,128,3.1000000000000016E-4
4,test_20231101_135300,10287332.png,216980,11942,205038,0.9449626693704489,2,4,22337,1637,20700,0.9267135246452075,9.578848,812.8562133333334,19.03066631114696,128,3.1000000000000016E-4
5,test_20231101_135300,11610969.png,368720,23467,345253,0.9363555001084833,2,4,84111,3427,80684,0.9592562209461307,22.418577777777777,3189.8884373333335,13.093048664934157,128,3.1000000000000016E-4
6,test_20231101_135300,10350842.png,212614,5562,207052,0.9738399164683417,2,3,42529,818,41711,0.9807660655082414,19.46256711111111,2410.5704426666666,14.30960533734045,128,3.1000000000000016E-4
7,test_20231101_135300,10863862.png,317432,10557,306875,0.966742483429522,2,4,66058,1536,64522,0.976747706560901,24.63304711111111,3467.3115253333335,12.730874976784207,128,3.1000000000000016E-4
8,test_20231101_135300,11382381.png,312486,667,311819,0.997865504374596,1,7,46745,89,46656,0.9980960530538026,21.842074666666665,2522.8946186666667,14.11181250456314,128,3.1000000000000016E-4
9,test_20231101_135300,11079715.png,443815,113162,330653,0.7450243907934613,3,4,124136,15824,108312,0.872526905974093,17.42231111111111,2238.1416106666666,14.631927993255129,128,3.1000000000000016E-4
10,test_20231101_135300,11551286.png,271883,267,271616,0.9990179599312939,1,3,40092,37,40055,0.9990771226179787,18.016108444444445,1877.54488,15.394900338849709,128,3.1000000000000016E-4
1,test_20231101_135301,10404007.png,502730,18032,484698,0.9641318401527659,2,3,61265,2618,58647,0.9572676079327511,25.992037333333332,3511.230128,12.676210665648235,128,3.200000000000002E-4
2,test_20231101_135301,1254659.png,342646,69532,273114,0.7970733643468769,3,4,80080,9762,70318,0.8780969030969031,21.44027911111111,3346.4703306666665,12.884933819048644,128,3.200000000000002E-4
3,test_20231101_135301,10188041.png,221231,9269,211962,0.958102616721888,2,4,41731,1305,40426,0.9687282835302293,10.994965333333333,1087.4147413333333,17.76685144730885,128,3.200000000000002E-4
4,test_20231101_135301,10287332.png,216980,11942,205038,0.9449626693704489,2,4,22337,1637,20700,0.9267135246452075,9.578848,812.8562133333334,19.03066631114696,128,3.200000000000002E-4
5,test_20231101_135301,11610969.png,368720,23467,345253,0.9363555001084833,3,3,84111,3427,80684,0.9592562209461307,22.418577777777777,3189.8884373333335,13.093048664934157,128,3.200000000000002E-4
6,test_20231101_135301,10350842.png,212614,5562,207052,0.9738399164683417,1,3,42529,818,41711,0.9807660655082414,19.46256711111111,2410.5704426666666,14.30960533734045,128,3.200000000000002E-4
7,test_20231101_135301,10863862.png,317432,10557,306875,0.966742483429522,2,4,66058,1536,64522,0.976747706560901,24.63304711111111,3467.3115253333335,12.730874976784207,128,3.200000000000002E-4
8,test_20231101_135301,11382381.png,312486,667,311819,0.997865504374596,2,4,46745,89,46656,0.9980960530538026,21.842074666666665,2522.8946186666667,14.11181250456314,128,3.200000000000002E-4
9,test_20231101_135301,11079715.png,443815,113162,330653,0.7450243907934613,3,4,124136,15824,108312,0.872526905974093,17.42231111111111,2238.1416106666666,14.631927993255129,128,3.200000000000002E-4
10,test_20231101_135301,11551286.png,271883,267,271616,0.9990179599312939,1,3,40092,37,40055,0.9990771226179787,18.016108444444445,1877.54488,15.394900338849709,128,3.200000000000002E-4
1,test_20231101_135301,10404007.png,502730,18032,484698,0.9641318401527659,2,4,61265,2618,58647,0.9572676079327511,25.992037333333332,3511.230128,12.676210665648235,128,3.300000000000002E-4
2,test_20231101_135301,1254659.png,342646,69532,273114,0.7970733643468769,3,14,80080,9762,70318,0.8780969030969031,21.44027911111111,3346.4703306666665,12.884933819048644,128,3.300000000000002E-4
3,test_20231101_135301,10188041.png,221231,9269,211962,0.958102616721888,2,3,41731,1305,40426,0.9687282835302293,10.994965333333333,1087.4147413333333,17.76685144730885,128,3.300000000000002E-4
4,test_20231101_135301,10287332.png,216980,11942,205038,0.9449626693704489,1,4,22337,1637,20700,0.9267135246452075,9.578848,812.8562133333334,19.03066631114696,128,3.300000000000002E-4
5,test_20231101_135301,11610969.png,368720,23467,345253,0.9363555001084833,2,4,84111,3427,80684,0.9592562209461307,22.418577777777777,3189.8884373333335,13.093048664934157,128,3.300000000000002E-4
6,test_20231101_135301,10350842.png,212614,5562,207052,0.9738399164683417,2,3,42529,818,41711,0.9807660655082414,19.46256711111111,2410.5704426666666,14.30960533734045,128,3.300000000000002E-4
7,test_20231101_135301,10863862.png,317432,10557,306875,0.966742483429522,1,3,66058,1536,64522,0.976747706560901,24.63304711111111,3467.3115253333335,12.730874976784207,128,3.300000000000002E-4
8,test_20231101_135301,11382381.png,312486,667,311819,0.997865504374596,2,4,46745,89,46656,0.9980960530538026,21.842074666666665,2522.8946186666667,14.11181250456314,128,3.300000000000002E-4
9,test_20231101_135301,11079715.png,443815,113162,330653,0.7450243907934613,3,5,124136,15824,108312,0.872526905974093,17.42231111111111,2238.1416106666666,14.631927993255129,128,3.300000000000002E-4
10,test_20231101_135301,11551286.png,271883,267,271616,0.9990179599312939,1,4,40092,37,40055,0.9990771226179787,18.016108444444445,1877.54488,15.394900338849709,128,3.300000000000002E-4
1,test_20231101_135302,10404007.png,502730,18032,484698,0.9641318401527659,2,3,61265,2618,58647,0.9572676079327511,25.992037333333332,3511.230128,12.676210665648235,128,3.4000000000000024E-4
2,test_20231101_135302,1254659.png,342646,69532,273114,0.7970733643468769,3,4,80080,9762,70318,0.8780969030969031,21.44027911111111,3346.4703306666665,12.884933819048644,128,3.4000000000000024E-4
3,test_20231101_135302,10188041.png,221231,9269,211962,0.958102616721888,2,4,41731,1305,40426,0.9687282835302293,10.994965333333333,1087.4147413333333,17.76685144730885,128,3.4000000000000024E-4
4,test_20231101_135302,10287332.png,216980,11942,205038,0.9449626693704489,2,3,22337,1637,20700,0.9267135246452075,9.578848,812.8562133333334,19.03066631114696,128,3.4000000000000024E-4
5,test_20231101_135302,11610969.png,368720,23467,345253,0.9363555001084833,2,4,84111,3427,80684,0.9592562209461307,22.418577777777777,3189.8884373333335,13.093048664934157,128,3.4000000000000024E-4
6,test_20231101_135302,10350842.png,212614,5562,207052,0.9738399164683417,2,4,42529,818,41711,0.9807660655082414,19.46256711111111,2410.5704426666666,14.30960533734045,128,3.4000000000000024E-4
7,test_20231101_135302,10863862.png,317432,10557,306875,0.966742483429522,2,3,66058,1536,64522,0.976747706560901,24.63304711111111,3467.3115253333335,12.730874976784207,128,3.4000000000000024E-4
8,test_20231101_135302,11382381.png,312486,667,311819,0.997865504374596,1,3,46745,89,46656,0.9980960530538026,21.842074666666665,2522.8946186666667,14.11181250456314,128,3.4000000000000024E-4
9,test_20231101_135302,11079715.png,443815,113162,330653,0.7450243907934613,4,4,124136,15824,108312,0.872526905974093,17.42231111111111,2238.1416106666666,14.631927993255129,128,3.4000000000000024E-4
10,test_20231101_135302,11551286.png,271883,267,271616,0.9990179599312939,1,3,40092,37,40055,0.9990771226179787,18.016108444444445,1877.54488,15.394900338849709,128,3.4000000000000024E-4
1,test_20231101_135303,10404007.png,502730,18032,484698,0.9641318401527659,2,4,61265,2618,58647,0.9572676079327511,25.992037333333332,3511.230128,12.676210665648235,128,3.5000000000000027E-4
2,test_20231101_135303,1254659.png,342646,69532,273114,0.7970733643468769,3,4,80080,9762,70318,0.8780969030969031,21.44027911111111,3346.4703306666665,12.884933819048644,128,3.5000000000000027E-4
3,test_20231101_135303,10188041.png,221231,9269,211962,0.958102616721888,2,3,41731,1305,40426,0.9687282835302293,10.994965333333333,1087.4147413333333,17.76685144730885,128,3.5000000000000027E-4
4,test_20231101_135303,10287332.png,216980,11942,205038,0.9449626693704489,2,4,22337,1637,20700,0.9267135246452075,9.578848,812.8562133333334,19.03066631114696,128,3.5000000000000027E-4
5,test_20231101_135303,11610969.png,368720,23467,345253,0.9363555001084833,3,4,84111,3427,80684,0.9592562209461307,22.418577777777777,3189.8884373333335,13.093048664934157,128,3.5000000000000027E-4
6,test_20231101_135303,10350842.png,212614,5562,207052,0.9738399164683417,1,4,42529,818,41711,0.9807660655082414,19.46256711111111,2410.5704426666666,14.30960533734045,128,3.5000000000000027E-4
7,test_20231101_135303,10863862.png,317432,10557,306875,0.966742483429522,2,3,66058,1536,64522,0.976747706560901,24.63304711111111,3467.3115253333335,12.730874976784207,128,3.5000000000000027E-4
8,test_20231101_135303,11382381.png,312486,667,311819,0.997865504374596,1,14,46745,89,46656,0.9980960530538026,21.842074666666665,2522.8946186666667,14.11181250456314,128,3.5000000000000027E-4
9,test_20231101_135303,11079715.png,443815,113162,330653,0.7450243907934613,4,4,124136,15824,108312,0.872526905974093,17.42231111111111,2238.1416106666666,14.631927993255129,128,3.5000000000000027E-4
10,test_20231101_135303,11551286.png,271883,267,271616,0.9990179599312939,1,3,40092,37,40055,0.9990771226179787,18.016108444444445,1877.54488,15.394900338849709,128,3.5000000000000027E-4
1,test_20231101_135303,10404007.png,502730,18032,484698,0.9641318401527659,2,4,61265,2618,58647,0.9572676079327511,25.992037333333332,3511.230128,12.676210665648235,128,3.600000000000003E-4
2,test_20231101_135303,1254659.png,342646,69532,273114,0.7970733643468769,3,4,80080,9762,70318,0.8780969030969031,21.44027911111111,3346.4703306666665,12.884933819048644,128,3.600000000000003E-4
3,test_20231101_135303,10188041.png,221231,9269,211962,0.958102616721888,3,4,41731,1305,40426,0.9687282835302293,10.994965333333333,1087.4147413333333,17.76685144730885,128,3.600000000000003E-4
4,test_20231101_135303,10287332.png,216980,11942,205038,0.9449626693704489,2,4,22337,1637,20700,0.9267135246452075,9.578848,812.8562133333334,19.03066631114696,128,3.600000000000003E-4
5,test_20231101_135303,11610969.png,368720,23467,345253,0.9363555001084833,2,3,84111,3427,80684,0.9592562209461307,22.418577777777777,3189.8884373333335,13.093048664934157,128,3.600000000000003E-4
6,test_20231101_135303,10350842.png,212614,5562,207052,0.9738399164683417,2,4,42529,818,41711,0.9807660655082414,19.46256711111111,2410.5704426666666,14.30960533734045,128,3.600000000000003E-4
7,test_20231101_135303,10863862.png,317432,10557,306875,0.966742483429522,2,3,66058,1536,64522,0.976747706560901,24.63304711111111,3467.3115253333335,12.730874976784207,128,3.600000000000003E-4
8,test_20231101_135303,11382381.png,312486,667,311819,0.997865504374596,1,4,46745,89,46656,0.9980960530538026,21.842074666666665,2522.8946186666667,14.11181250456314,128,3.600000000000003E-4
9,test_20231101_135303,11079715.png,443815,113162,330653,0.7450243907934613,3,4,124136,15824,108312,0.872526905974093,17.42231111111111,2238.1416106666666,14.631927993255129,128,3.600000000000003E-4
10,test_20231101_135303,11551286.png,271883,267,271616,0.9990179599312939,1,3,40092,37,40055,0.9990771226179787,18.016108444444445,1877.54488,15.394900338849709,128,3.600000000000003E-4
1,test_20231101_135304,10404007.png,502730,18032,484698,0.9641318401527659,2,4,61265,2618,58647,0.9572676079327511,25.992037333333332,3511.230128,12.676210665648235,128,3.700000000000003E-4
2,test_20231101_135304,1254659.png,342646,69532,273114,0.7970733643468769,4,3,80080,9762,70318,0.8780969030969031,21.44027911111111,3346.4703306666665,12.884933819048644,128,3.700000000000003E-4
3,test_20231101_135304,10188041.png,221231,9269,211962,0.958102616721888,2,3,41731,1305,40426,0.9687282835302293,10.994965333333333,1087.4147413333333,17.76685144730885,128,3.700000000000003E-4
4,test_20231101_135304,10287332.png,216980,11942,205038,0.9449626693704489,1,4,22337,1637,20700,0.9267135246452075,9.578848,812.8562133333334,19.03066631114696,128,3.700000000000003E-4
5,test_20231101_135304,11610969.png,368720,23467,345253,0.9363555001084833,2,4,84111,3427,80684,0.9592562209461307,22.418577777777777,3189.8884373333335,13.093048664934157,128,3.700000000000003E-4
6,test_20231101_135304,10350842.png,212614,5562,207052,0.9738399164683417,2,3,42529,818,41711,0.9807660655082414,19.46256711111111,2410.5704426666666,14.30960533734045,128,3.700000000000003E-4
7,test_20231101_135304,10863862.png,317432,10557,306875,0.966742483429522,2,4,66058,1536,64522,0.976747706560901,24.63304711111111,3467.3115253333335,12.730874976784207,128,3.700000000000003E-4
8,test_20231101_135304,11382381.png,312486,667,311819,0.997865504374596,1,10,46745,89,46656,0.9980960530538026,21.842074666666665,2522.8946186666667,14.11181250456314,128,3.700000000000003E-4
9,test_20231101_135304,11079715.png,443815,113162,330653,0.7450243907934613,4,4,124136,15824,108312,0.872526905974093,17.42231111111111,2238.1416106666666,14.631927993255129,128,3.700000000000003E-4
10,test_20231101_135304,11551286.png,271883,267,271616,0.9990179599312939,1,3,40092,37,40055,0.9990771226179787,18.016108444444445,1877.54488,15.394900338849709,128,3.700000000000003E-4
1,test_20231101_135305,10404007.png,502730,18032,484698,0.9641318401527659,2,4,61265,2618,58647,0.9572676079327511,25.992037333333332,3511.230128,12.676210665648235,128,3.8000000000000035E-4
2,test_20231101_135305,1254659.png,342646,69532,273114,0.7970733643468769,3,4,80080,9762,70318,0.8780969030969031,21.44027911111111,3346.4703306666665,12.884933819048644,128,3.8000000000000035E-4
3,test_20231101_135305,10188041.png,221231,9269,211962,0.958102616721888,2,4,41731,1305,40426,0.9687282835302293,10.994965333333333,1087.4147413333333,17.76685144730885,128,3.8000000000000035E-4
4,test_20231101_135305,10287332.png,216980,11942,205038,0.9449626693704489,2,3,22337,1637,20700,0.9267135246452075,9.578848,812.8562133333334,19.03066631114696,128,3.8000000000000035E-4
5,test_20231101_135305,11610969.png,368720,23467,345253,0.9363555001084833,2,4,84111,3427,80684,0.9592562209461307,22.418577777777777,3189.8884373333335,13.093048664934157,128,3.8000000000000035E-4
6,test_20231101_135305,10350842.png,212614,5562,207052,0.9738399164683417,1,3,42529,818,41711,0.9807660655082414,19.46256711111111,2410.5704426666666,14.30960533734045,128,3.8000000000000035E-4
7,test_20231101_135305,10863862.png,317432,10557,306875,0.966742483429522,2,4,66058,1536,64522,0.976747706560901,24.63304711111111,3467.3115253333335,12.730874976784207,128,3.8000000000000035E-4
8,test_20231101_135305,11382381.png,312486,667,311819,0.997865504374596,1,3,46745,89,46656,0.9980960530538026,21.842074666666665,2522.8946186666667,14.11181250456314,128,3.8000000000000035E-4
9,test_20231101_135305,11079715.png,443815,113162,330653,0.7450243907934613,3,4,124136,15824,108312,0.872526905974093,17.42231111111111,2238.1416106666666,14.631927993255129,128,3.8000000000000035E-4
10,test_20231101_135305,11551286.png,271883,267,271616,0.9990179599312939,1,4,40092,37,40055,0.9990771226179787,18.016108444444445,1877.54488,15.394900338849709,128,3.8000000000000035E-4
1,test_20231101_135305,10404007.png,502730,18032,484698,0.9641318401527659,2,4,61265,2618,58647,0.9572676079327511,25.992037333333332,3511.230128,12.676210665648235,128,3.9000000000000037E-4
2,test_20231101_135305,1254659.png,342646,69532,273114,0.7970733643468769,2,4,80080,9762,70318,0.8780969030969031,21.44027911111111,3346.4703306666665,12.884933819048644,128,3.9000000000000037E-4
3,test_20231101_135305,10188041.png,221231,9269,211962,0.958102616721888,1,3,41731,1305,40426,0.9687282835302293,10.994965333333333,1087.4147413333333,17.76685144730885,128,3.9000000000000037E-4
4,test_20231101_135305,10287332.png,216980,11942,205038,0.9449626693704489,2,4,22337,1637,20700,0.9267135246452075,9.578848,812.8562133333334,19.03066631114696,128,3.9000000000000037E-4
5,test_20231101_135305,11610969.png,368720,23467,345253,0.9363555001084833,2,3,84111,3427,80684,0.9592562209461307,22.418577777777777,3189.8884373333335,13.093048664934157,128,3.9000000000000037E-4
6,test_20231101_135305,10350842.png,212614,5562,207052,0.9738399164683417,1,4,42529,818,41711,0.9807660655082414,19.46256711111111,2410.5704426666666,14.30960533734045,128,3.9000000000000037E-4
7,test_20231101_135305,10863862.png,317432,9612,307820,0.969719498979309,2,4,66058,1397,64661,0.9788519180114444,27.040947555555555,4133.234704,11.967902936558898,128,3.9000000000000037E-4
8,test_20231101_135305,11382381.png,312486,667,311819,0.997865504374596,1,4,46745,89,46656,0.9980960530538026,21.842074666666665,2522.8946186666667,14.11181250456314,128,3.9000000000000037E-4
9,test_20231101_135305,11079715.png,443815,113162,330653,0.7450243907934613,4,4,124136,15824,108312,0.872526905974093,17.42231111111111,2238.1416106666666,14.631927993255129,128,3.9000000000000037E-4
10,test_20231101_135305,11551286.png,271883,267,271616,0.9990179599312939,1,4,40092,37,40055,0.9990771226179787,18.016108444444445,1877.54488,15.394900338849709,128,3.9000000000000037E-4
1,test_20231101_135306,10404007.png,502730,18032,484698,0.9641318401527659,2,4,61265,2618,58647,0.9572676079327511,25.992037333333332,3511.230128,12.676210665648235,128,4.000000000000004E-4
2,test_20231101_135306,1254659.png,342646,69532,273114,0.7970733643468769,3,4,80080,9762,70318,0.8780969030969031,21.44027911111111,3346.4703306666665,12.884933819048644,128,4.000000000000004E-4
3,test_20231101_135306,10188041.png,221231,9269,211962,0.958102616721888,2,3,41731,1305,40426,0.9687282835302293,10.994965333333333,1087.4147413333333,17.76685144730885,128,4.000000000000004E-4
4,test_20231101_135306,10287332.png,216980,11942,205038,0.9449626693704489,2,3,22337,1637,20700,0.9267135246452075,9.578848,812.8562133333334,19.03066631114696,128,4.000000000000004E-4
5,test_20231101_135306,11610969.png,368720,23467,345253,0.9363555001084833,2,4,84111,3427,80684,0.9592562209461307,22.418577777777777,3189.8884373333335,13.093048664934157,128,4.000000000000004E-4
6,test_20231101_135306,10350842.png,212614,5562,207052,0.9738399164683417,2,7,42529,818,41711,0.9807660655082414,19.46256711111111,2410.5704426666666,14.30960533734045,128,4.000000000000004E-4
7,test_20231101_135306,10863862.png,317432,9612,307820,0.969719498979309,2,4,66058,1397,64661,0.9788519180114444,27.040947555555555,4133.234704,11.967902936558898,128,4.000000000000004E-4
8,test_20231101_135306,11382381.png,312486,667,311819,0.997865504374596,1,3,46745,89,46656,0.9980960530538026,21.842074666666665,2522.8946186666667,14.11181250456314,128,4.000000000000004E-4
9,test_20231101_135306,11079715.png,443815,113162,330653,0.7450243907934613,4,4,124136,15824,108312,0.872526905974093,17.42231111111111,2238.1416106666666,14.631927993255129,128,4.000000000000004E-4
10,test_20231101_135306,11551286.png,271883,267,271616,0.9990179599312939,2,4,40092,37,40055,0.9990771226179787,18.016108444444445,1877.54488,15.394900338849709,128,4.000000000000004E-4
1,test_20231101_135307,10404007.png,502730,18032,484698,0.9641318401527659,2,4,61265,2618,58647,0.9572676079327511,25.992037333333332,3511.230128,12.676210665648235,128,4.100000000000004E-4
2,test_20231101_135307,1254659.png,342646,69532,273114,0.7970733643468769,4,4,80080,9762,70318,0.8780969030969031,21.44027911111111,3346.4703306666665,12.884933819048644,128,4.100000000000004E-4
3,test_20231101_135307,10188041.png,221231,9269,211962,0.958102616721888,2,4,41731,1305,40426,0.9687282835302293,10.994965333333333,1087.4147413333333,17.76685144730885,128,4.100000000000004E-4
4,test_20231101_135307,10287332.png,216980,11942,205038,0.9449626693704489,2,4,22337,1637,20700,0.9267135246452075,9.578848,812.8562133333334,19.03066631114696,128,4.100000000000004E-4
5,test_20231101_135307,11610969.png,368720,23467,345253,0.9363555001084833,2,4,84111,3427,80684,0.9592562209461307,22.418577777777777,3189.8884373333335,13.093048664934157,128,4.100000000000004E-4
6,test_20231101_135307,10350842.png,212614,5562,207052,0.9738399164683417,1,4,42529,818,41711,0.9807660655082414,19.46256711111111,2410.5704426666666,14.30960533734045,128,4.100000000000004E-4
7,test_20231101_135307,10863862.png,317432,9612,307820,0.969719498979309,2,4,66058,1397,64661,0.9788519180114444,27.040947555555555,4133.234704,11.967902936558898,128,4.100000000000004E-4
8,test_20231101_135307,11382381.png,312486,667,311819,0.997865504374596,1,4,46745,89,46656,0.9980960530538026,21.842074666666665,2522.8946186666667,14.11181250456314,128,4.100000000000004E-4
9,test_20231101_135307,11079715.png,443815,113162,330653,0.7450243907934613,3,4,124136,15824,108312,0.872526905974093,17.42231111111111,2238.1416106666666,14.631927993255129,128,4.100000000000004E-4
10,test_20231101_135307,11551286.png,271883,267,271616,0.9990179599312939,2,3,40092,37,40055,0.9990771226179787,18.016108444444445,1877.54488,15.394900338849709,128,4.100000000000004E-4
1,test_20231101_135307,10404007.png,502730,18032,484698,0.9641318401527659,2,3,61265,2618,58647,0.9572676079327511,25.992037333333332,3511.230128,12.676210665648235,128,4.2000000000000045E-4
2,test_20231101_135307,1254659.png,342646,69532,273114,0.7970733643468769,3,4,80080,9762,70318,0.8780969030969031,21.44027911111111,3346.4703306666665,12.884933819048644,128,4.2000000000000045E-4
3,test_20231101_135307,10188041.png,221231,9269,211962,0.958102616721888,2,4,41731,1305,40426,0.9687282835302293,10.994965333333333,1087.4147413333333,17.76685144730885,128,4.2000000000000045E-4
4,test_20231101_135307,10287332.png,216980,11942,205038,0.9449626693704489,2,4,22337,1637,20700,0.9267135246452075,9.578848,812.8562133333334,19.03066631114696,128,4.2000000000000045E-4
5,test_20231101_135307,11610969.png,368720,23467,345253,0.9363555001084833,2,4,84111,3427,80684,0.9592562209461307,22.418577777777777,3189.8884373333335,13.093048664934157,128,4.2000000000000045E-4
6,test_20231101_135307,10350842.png,212614,5562,207052,0.9738399164683417,1,4,42529,818,41711,0.9807660655082414,19.46256711111111,2410.5704426666666,14.30960533734045,128,4.2000000000000045E-4
7,test_20231101_135307,10863862.png,317432,9612,307820,0.969719498979309,2,4,66058,1397,64661,0.9788519180114444,27.040947555555555,4133.234704,11.967902936558898,128,4.2000000000000045E-4
8,test_20231101_135307,11382381.png,312486,667,311819,0.997865504374596,2,3,46745,89,46656,0.9980960530538026,21.842074666666665,2522.8946186666667,14.11181250456314,128,4.2000000000000045E-4
9,test_20231101_135307,11079715.png,443815,113162,330653,0.7450243907934613,4,8,124136,15824,108312,0.872526905974093,17.42231111111111,2238.1416106666666,14.631927993255129,128,4.2000000000000045E-4
10,test_20231101_135307,11551286.png,271883,267,271616,0.9990179599312939,1,4,40092,37,40055,0.9990771226179787,18.016108444444445,1877.54488,15.394900338849709,128,4.2000000000000045E-4
1,test_20231101_135308,10404007.png,502730,18032,484698,0.9641318401527659,2,3,61265,2618,58647,0.9572676079327511,25.992037333333332,3511.230128,12.676210665648235,128,4.300000000000005E-4
2,test_20231101_135308,1254659.png,342646,69532,273114,0.7970733643468769,3,4,80080,9762,70318,0.8780969030969031,21.44027911111111,3346.4703306666665,12.884933819048644,128,4.300000000000005E-4
3,test_20231101_135308,10188041.png,221231,9269,211962,0.958102616721888,2,3,41731,1305,40426,0.9687282835302293,10.994965333333333,1087.4147413333333,17.76685144730885,128,4.300000000000005E-4
4,test_20231101_135308,10287332.png,216980,11942,205038,0.9449626693704489,1,3,22337,1637,20700,0.9267135246452075,9.578848,812.8562133333334,19.03066631114696,128,4.300000000000005E-4
5,test_20231101_135308,11610969.png,368720,23467,345253,0.9363555001084833,2,4,84111,3427,80684,0.9592562209461307,22.418577777777777,3189.8884373333335,13.093048664934157,128,4.300000000000005E-4
6,test_20231101_135308,10350842.png,212614,5562,207052,0.9738399164683417,2,3,42529,818,41711,0.9807660655082414,19.46256711111111,2410.5704426666666,14.30960533734045,128,4.300000000000005E-4
7,test_20231101_135308,10863862.png,317432,9612,307820,0.969719498979309,2,3,66058,1397,64661,0.9788519180114444,27.040947555555555,4133.234704,11.967902936558898,128,4.300000000000005E-4
8,test_20231101_135308,11382381.png,312486,667,311819,0.997865504374596,1,4,46745,89,46656,0.9980960530538026,21.842074666666665,2522.8946186666667,14.11181250456314,128,4.300000000000005E-4
9,test_20231101_135308,11079715.png,443815,113162,330653,0.7450243907934613,3,5,124136,15824,108312,0.872526905974093,17.42231111111111,2238.1416106666666,14.631927993255129,128,4.300000000000005E-4
10,test_20231101_135308,11551286.png,271883,267,271616,0.9990179599312939,1,3,40092,37,40055,0.9990771226179787,18.016108444444445,1877.54488,15.394900338849709,128,4.300000000000005E-4
1,test_20231101_135309,10404007.png,502730,18032,484698,0.9641318401527659,2,4,61265,2618,58647,0.9572676079327511,25.992037333333332,3511.230128,12.676210665648235,128,4.400000000000005E-4
2,test_20231101_135309,1254659.png,342646,69532,273114,0.7970733643468769,3,4,80080,9762,70318,0.8780969030969031,21.44027911111111,3346.4703306666665,12.884933819048644,128,4.400000000000005E-4
3,test_20231101_135309,10188041.png,221231,9269,211962,0.958102616721888,2,4,41731,1305,40426,0.9687282835302293,10.994965333333333,1087.4147413333333,17.76685144730885,128,4.400000000000005E-4
4,test_20231101_135309,10287332.png,216980,11942,205038,0.9449626693704489,1,4,22337,1637,20700,0.9267135246452075,9.578848,812.8562133333334,19.03066631114696,128,4.400000000000005E-4
5,test_20231101_135309,11610969.png,368720,23467,345253,0.9363555001084833,3,4,84111,3427,80684,0.9592562209461307,22.418577777777777,3189.8884373333335,13.093048664934157,128,4.400000000000005E-4
6,test_20231101_135309,10350842.png,212614,5562,207052,0.9738399164683417,2,4,42529,818,41711,0.9807660655082414,19.46256711111111,2410.5704426666666,14.30960533734045,128,4.400000000000005E-4
7,test_20231101_135309,10863862.png,317432,9612,307820,0.969719498979309,2,4,66058,1397,64661,0.9788519180114444,27.040947555555555,4133.234704,11.967902936558898,128,4.400000000000005E-4
8,test_20231101_135309,11382381.png,312486,667,311819,0.997865504374596,2,3,46745,89,46656,0.9980960530538026,21.842074666666665,2522.8946186666667,14.11181250456314,128,4.400000000000005E-4
9,test_20231101_135309,11079715.png,443815,113162,330653,0.7450243907934613,4,4,124136,15824,108312,0.872526905974093,17.42231111111111,2238.1416106666666,14.631927993255129,128,4.400000000000005E-4
10,test_20231101_135309,11551286.png,271883,267,271616,0.9990179599312939,2,4,40092,37,40055,0.9990771226179787,18.016108444444445,1877.54488,15.394900338849709,128,4.400000000000005E-4
1,test_20231101_135310,10404007.png,502730,18032,484698,0.9641318401527659,2,4,61265,2618,58647,0.9572676079327511,25.992037333333332,3511.230128,12.676210665648235,128,4.5000000000000053E-4
2,test_20231101_135310,1254659.png,342646,69532,273114,0.7970733643468769,3,4,80080,9762,70318,0.8780969030969031,21.44027911111111,3346.4703306666665,12.884933819048644,128,4.5000000000000053E-4
3,test_20231101_135310,10188041.png,221231,9269,211962,0.958102616721888,2,3,41731,1305,40426,0.9687282835302293,10.994965333333333,1087.4147413333333,17.76685144730885,128,4.5000000000000053E-4
4,test_20231101_135310,10287332.png,216980,11942,205038,0.9449626693704489,1,4,22337,1637,20700,0.9267135246452075,9.578848,812.8562133333334,19.03066631114696,128,4.5000000000000053E-4
5,test_20231101_135310,11610969.png,368720,23467,345253,0.9363555001084833,3,4,84111,3427,80684,0.9592562209461307,22.418577777777777,3189.8884373333335,13.093048664934157,128,4.5000000000000053E-4
6,test_20231101_135310,10350842.png,212614,5562,207052,0.9738399164683417,6,3,42529,818,41711,0.9807660655082414,19.46256711111111,2410.5704426666666,14.30960533734045,128,4.5000000000000053E-4
7,test_20231101_135310,10863862.png,317432,9612,307820,0.969719498979309,2,4,66058,1397,64661,0.9788519180114444,27.040947555555555,4133.234704,11.967902936558898,128,4.5000000000000053E-4
8,test_20231101_135310,11382381.png,312486,667,311819,0.997865504374596,1,4,46745,89,46656,0.9980960530538026,21.842074666666665,2522.8946186666667,14.11181250456314,128,4.5000000000000053E-4
9,test_20231101_135310,11079715.png,443815,113162,330653,0.7450243907934613,3,4,124136,15824,108312,0.872526905974093,17.42231111111111,2238.1416106666666,14.631927993255129,128,4.5000000000000053E-4
10,test_20231101_135310,11551286.png,271883,267,271616,0.9990179599312939,1,3,40092,37,40055,0.9990771226179787,18.016108444444445,1877.54488,15.394900338849709,128,4.5000000000000053E-4
1,test_20231101_135310,10404007.png,502730,18032,484698,0.9641318401527659,3,4,61265,2618,58647,0.9572676079327511,25.992037333333332,3511.230128,12.676210665648235,128,4.6000000000000056E-4
2,test_20231101_135310,1254659.png,342646,69532,273114,0.7970733643468769,4,4,80080,9762,70318,0.8780969030969031,21.44027911111111,3346.4703306666665,12.884933819048644,128,4.6000000000000056E-4
3,test_20231101_135310,10188041.png,221231,9269,211962,0.958102616721888,2,4,41731,1305,40426,0.9687282835302293,10.994965333333333,1087.4147413333333,17.76685144730885,128,4.6000000000000056E-4
4,test_20231101_135310,10287332.png,216980,11942,205038,0.9449626693704489,1,4,22337,1637,20700,0.9267135246452075,9.578848,812.8562133333334,19.03066631114696,128,4.6000000000000056E-4
5,test_20231101_135310,11610969.png,368720,23467,345253,0.9363555001084833,2,4,84111,3427,80684,0.9592562209461307,22.418577777777777,3189.8884373333335,13.093048664934157,128,4.6000000000000056E-4
6,test_20231101_135310,10350842.png,212614,5562,207052,0.9738399164683417,2,4,42529,818,41711,0.9807660655082414,19.46256711111111,2410.5704426666666,14.30960533734045,128,4.6000000000000056E-4
7,test_20231101_135310,10863862.png,317432,9612,307820,0.969719498979309,2,9,66058,1397,64661,0.9788519180114444,27.040947555555555,4133.234704,11.967902936558898,128,4.6000000000000056E-4
8,test_20231101_135310,11382381.png,312486,667,311819,0.997865504374596,1,3,46745,89,46656,0.9980960530538026,21.842074666666665,2522.8946186666667,14.11181250456314,128,4.6000000000000056E-4
9,test_20231101_135310,11079715.png,443815,113162,330653,0.7450243907934613,3,4,124136,15824,108312,0.872526905974093,17.42231111111111,2238.1416106666666,14.631927993255129,128,4.6000000000000056E-4
10,test_20231101_135310,11551286.png,271883,267,271616,0.9990179599312939,2,3,40092,37,40055,0.9990771226179787,18.016108444444445,1877.54488,15.394900338849709,128,4.6000000000000056E-4
1,test_20231101_135311,10404007.png,502730,18032,484698,0.9641318401527659,2,3,61265,2618,58647,0.9572676079327511,25.992037333333332,3511.230128,12.676210665648235,128,4.700000000000006E-4
2,test_20231101_135311,1254659.png,342646,69532,273114,0.7970733643468769,3,4,80080,9762,70318,0.8780969030969031,21.44027911111111,3346.4703306666665,12.884933819048644,128,4.700000000000006E-4
3,test_20231101_135311,10188041.png,221231,9269,211962,0.958102616721888,2,4,41731,1305,40426,0.9687282835302293,10.994965333333333,1087.4147413333333,17.76685144730885,128,4.700000000000006E-4
4,test_20231101_135311,10287332.png,216980,11942,205038,0.9449626693704489,5,3,22337,1637,20700,0.9267135246452075,9.578848,812.8562133333334,19.03066631114696,128,4.700000000000006E-4
5,test_20231101_135311,11610969.png,368720,23467,345253,0.9363555001084833,2,3,84111,3427,80684,0.9592562209461307,22.418577777777777,3189.8884373333335,13.093048664934157,128,4.700000000000006E-4
6,test_20231101_135311,10350842.png,212614,5562,207052,0.9738399164683417,2,3,42529,818,41711,0.9807660655082414,19.46256711111111,2410.5704426666666,14.30960533734045,128,4.700000000000006E-4
7,test_20231101_135311,10863862.png,317432,9612,307820,0.969719498979309,2,3,66058,1397,64661,0.9788519180114444,27.040947555555555,4133.234704,11.967902936558898,128,4.700000000000006E-4
8,test_20231101_135311,11382381.png,312486,667,311819,0.997865504374596,2,4,46745,89,46656,0.9980960530538026,21.842074666666665,2522.8946186666667,14.11181250456314,128,4.700000000000006E-4
9,test_20231101_135311,11079715.png,443815,113162,330653,0.7450243907934613,3,4,124136,15824,108312,0.872526905974093,17.42231111111111,2238.1416106666666,14.631927993255129,128,4.700000000000006E-4
10,test_20231101_135311,11551286.png,271883,267,271616,0.9990179599312939,2,4,40092,37,40055,0.9990771226179787,18.016108444444445,1877.54488,15.394900338849709,128,4.700000000000006E-4
1,test_20231101_135312,10404007.png,502730,18032,484698,0.9641318401527659,3,4,61265,2618,58647,0.9572676079327511,25.992037333333332,3511.230128,12.676210665648235,128,4.800000000000006E-4
2,test_20231101_135312,1254659.png,342646,69532,273114,0.7970733643468769,3,4,80080,9762,70318,0.8780969030969031,21.44027911111111,3346.4703306666665,12.884933819048644,128,4.800000000000006E-4
3,test_20231101_135312,10188041.png,221231,9269,211962,0.958102616721888,2,3,41731,1305,40426,0.9687282835302293,10.994965333333333,1087.4147413333333,17.76685144730885,128,4.800000000000006E-4
4,test_20231101_135312,10287332.png,216980,11942,205038,0.9449626693704489,1,4,22337,1637,20700,0.9267135246452075,9.578848,812.8562133333334,19.03066631114696,128,4.800000000000006E-4
5,test_20231101_135312,11610969.png,368720,23467,345253,0.9363555001084833,3,4,84111,3427,80684,0.9592562209461307,22.418577777777777,3189.8884373333335,13.093048664934157,128,4.800000000000006E-4
6,test_20231101_135312,10350842.png,212614,5562,207052,0.9738399164683417,2,3,42529,818,41711,0.9807660655082414,19.46256711111111,2410.5704426666666,14.30960533734045,128,4.800000000000006E-4
7,test_20231101_135312,10863862.png,317432,9612,307820,0.969719498979309,2,4,66058,1397,64661,0.9788519180114444,27.040947555555555,4133.234704,11.967902936558898,128,4.800000000000006E-4
8,test_20231101_135312,11382381.png,312486,667,311819,0.997865504374596,1,4,46745,89,46656,0.9980960530538026,21.842074666666665,2522.8946186666667,14.11181250456314,128,4.800000000000006E-4
9,test_20231101_135312,11079715.png,443815,113162,330653,0.7450243907934613,4,5,124136,15824,108312,0.872526905974093,17.42231111111111,2238.1416106666666,14.631927993255129,128,4.800000000000006E-4
10,test_20231101_135312,11551286.png,271883,267,271616,0.9990179599312939,2,3,40092,37,40055,0.9990771226179787,18.016108444444445,1877.54488,15.394900338849709,128,4.800000000000006E-4
1,test_20231101_135312,10404007.png,502730,18032,484698,0.9641318401527659,2,4,61265,2618,58647,0.9572676079327511,25.992037333333332,3511.230128,12.676210665648235,128,4.900000000000006E-4
2,test_20231101_135312,1254659.png,342646,69532,273114,0.7970733643468769,3,4,80080,9762,70318,0.8780969030969031,21.44027911111111,3346.4703306666665,12.884933819048644,128,4.900000000000006E-4
3,test_20231101_135312,10188041.png,221231,9269,211962,0.958102616721888,2,4,41731,1305,40426,0.9687282835302293,10.994965333333333,1087.4147413333333,17.76685144730885,128,4.900000000000006E-4
4,test_20231101_135312,10287332.png,216980,11942,205038,0.9449626693704489,2,4,22337,1637,20700,0.9267135246452075,9.578848,812.8562133333334,19.03066631114696,128,4.900000000000006E-4
5,test_20231101_135312,11610969.png,368720,23467,345253,0.9363555001084833,2,4,84111,3427,80684,0.9592562209461307,22.418577777777777,3189.8884373333335,13.093048664934157,128,4.900000000000006E-4
6,test_20231101_135312,10350842.png,212614,5562,207052,0.9738399164683417,2,4,42529,818,41711,0.9807660655082414,19.46256711111111,2410.5704426666666,14.30960533734045,128,4.900000000000006E-4
7,test_20231101_135312,10863862.png,317432,9612,307820,0.969719498979309,2,3,66058,1397,64661,0.9788519180114444,27.040947555555555,4133.234704,11.967902936558898,128,4.900000000000006E-4
8,test_20231101_135312,11382381.png,312486,667,311819,0.997865504374596,2,4,46745,89,46656,0.9980960530538026,21.842074666666665,2522.8946186666667,14.11181250456314,128,4.900000000000006E-4
9,test_20231101_135312,11079715.png,443815,113162,330653,0.7450243907934613,3,4,124136,15824,108312,0.872526905974093,17.42231111111111,2238.1416106666666,14.631927993255129,128,4.900000000000006E-4
10,test_20231101_135312,11551286.png,271883,267,271616,0.9990179599312939,1,4,40092,37,40055,0.9990771226179787,18.016108444444445,1877.54488,15.394900338849709,128,4.900000000000006E-4
1,test_20231101_135313,10404007.png,502730,18032,484698,0.9641318401527659,3,3,61265,2618,58647,0.9572676079327511,25.992037333333332,3511.230128,12.676210665648235,128,5.000000000000007E-4
2,test_20231101_135313,1254659.png,342646,69532,273114,0.7970733643468769,3,11,80080,9762,70318,0.8780969030969031,21.44027911111111,3346.4703306666665,12.884933819048644,128,5.000000000000007E-4
3,test_20231101_135313,10188041.png,221231,9269,211962,0.958102616721888,2,4,41731,1305,40426,0.9687282835302293,10.994965333333333,1087.4147413333333,17.76685144730885,128,5.000000000000007E-4
4,test_20231101_135313,10287332.png,216980,11942,205038,0.9449626693704489,1,3,22337,1637,20700,0.9267135246452075,9.578848,812.8562133333334,19.03066631114696,128,5.000000000000007E-4
5,test_20231101_135313,11610969.png,368720,23467,345253,0.9363555001084833,2,4,84111,3427,80684,0.9592562209461307,22.418577777777777,3189.8884373333335,13.093048664934157,128,5.000000000000007E-4
6,test_20231101_135313,10350842.png,212614,5562,207052,0.9738399164683417,1,4,42529,818,41711,0.9807660655082414,19.46256711111111,2410.5704426666666,14.30960533734045,128,5.000000000000007E-4
7,test_20231101_135313,10863862.png,317432,9612,307820,0.969719498979309,2,4,66058,1397,64661,0.9788519180114444,27.040947555555555,4133.234704,11.967902936558898,128,5.000000000000007E-4
8,test_20231101_135313,11382381.png,312486,667,311819,0.997865504374596,2,3,46745,89,46656,0.9980960530538026,21.842074666666665,2522.8946186666667,14.11181250456314,128,5.000000000000007E-4
9,test_20231101_135313,11079715.png,443815,113162,330653,0.7450243907934613,4,4,124136,15824,108312,0.872526905974093,17.42231111111111,2238.1416106666666,14.631927993255129,128,5.000000000000007E-4
10,test_20231101_135313,11551286.png,271883,267,271616,0.9990179599312939,1,3,40092,37,40055,0.9990771226179787,18.016108444444445,1877.54488,15.394900338849709,128,5.000000000000007E-4
1,test_20231101_135314,10404007.png,502730,18032,484698,0.9641318401527659,3,4,61265,2618,58647,0.9572676079327511,25.992037333333332,3511.230128,12.676210665648235,128,5.100000000000007E-4
2,test_20231101_135314,1254659.png,342646,69532,273114,0.7970733643468769,3,5,80080,9762,70318,0.8780969030969031,21.44027911111111,3346.4703306666665,12.884933819048644,128,5.100000000000007E-4
3,test_20231101_135314,10188041.png,221231,9207,212024,0.9583828667772599,2,4,41731,1298,40433,0.9688960245381132,11.120924444444444,1098.1147306666667,17.724326434383556,128,5.100000000000007E-4
4,test_20231101_135314,10287332.png,216980,11942,205038,0.9449626693704489,1,3,22337,1637,20700,0.9267135246452075,9.578848,812.8562133333334,19.03066631114696,128,5.100000000000007E-4
5,test_20231101_135314,11610969.png,368720,23427,345293,0.9364639835105228,2,3,84111,3425,80686,0.9592799990488758,22.796608,3253.0010773333333,13.007961537557941,128,5.100000000000007E-4
6,test_20231101_135314,10350842.png,212614,5562,207052,0.9738399164683417,2,3,42529,818,41711,0.9807660655082414,19.46256711111111,2410.5704426666666,14.30960533734045,128,5.100000000000007E-4
7,test_20231101_135314,10863862.png,317432,9612,307820,0.969719498979309,2,4,66058,1397,64661,0.9788519180114444,27.040947555555555,4133.234704,11.967902936558898,128,5.100000000000007E-4
8,test_20231101_135314,11382381.png,312486,667,311819,0.997865504374596,1,3,46745,89,46656,0.9980960530538026,21.842074666666665,2522.8946186666667,14.11181250456314,128,5.100000000000007E-4
9,test_20231101_135314,11079715.png,443815,113162,330653,0.7450243907934613,3,4,124136,15824,108312,0.872526905974093,17.42231111111111,2238.1416106666666,14.631927993255129,128,5.100000000000007E-4
10,test_20231101_135314,11551286.png,271883,267,271616,0.9990179599312939,1,4,40092,37,40055,0.9990771226179787,18.016108444444445,1877.54488,15.394900338849709,128,5.100000000000007E-4
1,test_20231101_135314,10404007.png,502730,17872,484858,0.964450102440674,2,3,61265,2595,58670,0.9576430261976658,26.03386666666667,3518.705610666667,12.666974273692194,128,5.200000000000007E-4
2,test_20231101_135314,1254659.png,342646,69532,273114,0.7970733643468769,3,4,80080,9762,70318,0.8780969030969031,21.44027911111111,3346.4703306666665,12.884933819048644,128,5.200000000000007E-4
3,test_20231101_135314,10188041.png,221231,9207,212024,0.9583828667772599,2,4,41731,1298,40433,0.9688960245381132,11.120924444444444,1098.1147306666667,17.724326434383556,128,5.200000000000007E-4
4,test_20231101_135314,10287332.png,216980,11942,205038,0.9449626693704489,2,4,22337,1637,20700,0.9267135246452075,9.578848,812.8562133333334,19.03066631114696,128,5.200000000000007E-4
5,test_20231101_135314,11610969.png,368720,23427,345293,0.9364639835105228,2,4,84111,3425,80686,0.9592799990488758,22.796608,3253.0010773333333,13.007961537557941,128,5.200000000000007E-4
6,test_20231101_135314,10350842.png,212614,5562,207052,0.9738399164683417,1,3,42529,818,41711,0.9807660655082414,19.46256711111111,2410.5704426666666,14.30960533734045,128,5.200000000000007E-4
7,test_20231101_135314,10863862.png,317432,9612,307820,0.969719498979309,2,3,66058,1397,64661,0.9788519180114444,27.040947555555555,4133.234704,11.967902936558898,128,5.200000000000007E-4
8,test_20231101_135314,11382381.png,312486,667,311819,0.997865504374596,1,3,46745,89,46656,0.9980960530538026,21.842074666666665,2522.8946186666667,14.11181250456314,128,5.200000000000007E-4
9,test_20231101_135314,11079715.png,443815,113162,330653,0.7450243907934613,3,5,124136,15824,108312,0.872526905974093,17.42231111111111,2238.1416106666666,14.631927993255129,128,5.200000000000007E-4
10,test_20231101_135314,11551286.png,271883,267,271616,0.9990179599312939,2,3,40092,37,40055,0.9990771226179787,18.016108444444445,1877.54488,15.394900338849709,128,5.200000000000007E-4
1,test_20231101_135315,10404007.png,502730,17872,484858,0.964450102440674,3,3,61265,2595,58670,0.9576430261976658,26.03386666666667,3518.705610666667,12.666974273692194,128,5.300000000000007E-4
2,test_20231101_135315,1254659.png,342646,69532,273114,0.7970733643468769,3,4,80080,9762,70318,0.8780969030969031,21.44027911111111,3346.4703306666665,12.884933819048644,128,5.300000000000007E-4
3,test_20231101_135315,10188041.png,221231,9207,212024,0.9583828667772599,2,4,41731,1298,40433,0.9688960245381132,11.120924444444444,1098.1147306666667,17.724326434383556,128,5.300000000000007E-4
4,test_20231101_135315,10287332.png,216980,11942,205038,0.9449626693704489,1,4,22337,1637,20700,0.9267135246452075,9.578848,812.8562133333334,19.03066631114696,128,5.300000000000007E-4
5,test_20231101_135315,11610969.png,368720,23427,345293,0.9364639835105228,3,4,84111,3425,80686,0.9592799990488758,22.796608,3253.0010773333333,13.007961537557941,128,5.300000000000007E-4
6,test_20231101_135315,10350842.png,212614,5562,207052,0.9738399164683417,1,3,42529,818,41711,0.9807660655082414,19.46256711111111,2410.5704426666666,14.30960533734045,128,5.300000000000007E-4
7,test_20231101_135315,10863862.png,317432,9612,307820,0.969719498979309,2,4,66058,1397,64661,0.9788519180114444,27.040947555555555,4133.234704,11.967902936558898,128,5.300000000000007E-4
8,test_20231101_135315,11382381.png,312486,667,311819,0.997865504374596,1,4,46745,89,46656,0.9980960530538026,21.842074666666665,2522.8946186666667,14.11181250456314,128,5.300000000000007E-4
9,test_20231101_135315,11079715.png,443815,113162,330653,0.7450243907934613,4,4,124136,15824,108312,0.872526905974093,17.42231111111111,2238.1416106666666,14.631927993255129,128,5.300000000000007E-4
10,test_20231101_135315,11551286.png,271883,267,271616,0.9990179599312939,2,3,40092,37,40055,0.9990771226179787,18.016108444444445,1877.54488,15.394900338849709,128,5.300000000000007E-4
1,test_20231101_135316,10404007.png,502730,17872,484858,0.964450102440674,2,4,61265,2595,58670,0.9576430261976658,26.03386666666667,3518.705610666667,12.666974273692194,128,5.400000000000008E-4
2,test_20231101_135316,1254659.png,342646,69532,273114,0.7970733643468769,3,4,80080,9762,70318,0.8780969030969031,21.44027911111111,3346.4703306666665,12.884933819048644,128,5.400000000000008E-4
3,test_20231101_135316,10188041.png,221231,9207,212024,0.9583828667772599,2,4,41731,1298,40433,0.9688960245381132,11.120924444444444,1098.1147306666667,17.724326434383556,128,5.400000000000008E-4
4,test_20231101_135316,10287332.png,216980,11942,205038,0.9449626693704489,2,4,22337,1637,20700,0.9267135246452075,9.578848,812.8562133333334,19.03066631114696,128,5.400000000000008E-4
5,test_20231101_135316,11610969.png,368720,23427,345293,0.9364639835105228,2,4,84111,3425,80686,0.9592799990488758,22.796608,3253.0010773333333,13.007961537557941,128,5.400000000000008E-4
6,test_20231101_135316,10350842.png,212614,5562,207052,0.9738399164683417,1,3,42529,818,41711,0.9807660655082414,19.46256711111111,2410.5704426666666,14.30960533734045,128,5.400000000000008E-4
7,test_20231101_135316,10863862.png,317432,9612,307820,0.969719498979309,2,4,66058,1397,64661,0.9788519180114444,27.040947555555555,4133.234704,11.967902936558898,128,5.400000000000008E-4
8,test_20231101_135316,11382381.png,312486,667,311819,0.997865504374596,2,3,46745,89,46656,0.9980960530538026,21.842074666666665,2522.8946186666667,14.11181250456314,128,5.400000000000008E-4
9,test_20231101_135316,11079715.png,443815,113162,330653,0.7450243907934613,3,4,124136,15824,108312,0.872526905974093,17.42231111111111,2238.1416106666666,14.631927993255129,128,5.400000000000008E-4
10,test_20231101_135316,11551286.png,271883,267,271616,0.9990179599312939,1,3,40092,37,40055,0.9990771226179787,18.016108444444445,1877.54488,15.394900338849709,128,5.400000000000008E-4
1,test_20231101_135316,10404007.png,502730,17872,484858,0.964450102440674,3,4,61265,2595,58670,0.9576430261976658,26.03386666666667,3518.705610666667,12.666974273692194,128,5.500000000000008E-4
2,test_20231101_135316,1254659.png,342646,69532,273114,0.7970733643468769,3,3,80080,9762,70318,0.8780969030969031,21.44027911111111,3346.4703306666665,12.884933819048644,128,5.500000000000008E-4
3,test_20231101_135316,10188041.png,221231,9207,212024,0.9583828667772599,2,3,41731,1298,40433,0.9688960245381132,11.120924444444444,1098.1147306666667,17.724326434383556,128,5.500000000000008E-4
4,test_20231101_135316,10287332.png,216980,11942,205038,0.9449626693704489,2,4,22337,1637,20700,0.9267135246452075,9.578848,812.8562133333334,19.03066631114696,128,5.500000000000008E-4
5,test_20231101_135316,11610969.png,368720,23427,345293,0.9364639835105228,2,3,84111,3425,80686,0.9592799990488758,22.796608,3253.0010773333333,13.007961537557941,128,5.500000000000008E-4
6,test_20231101_135316,10350842.png,212614,5562,207052,0.9738399164683417,1,3,42529,818,41711,0.9807660655082414,19.46256711111111,2410.5704426666666,14.30960533734045,128,5.500000000000008E-4
7,test_20231101_135316,10863862.png,317432,9612,307820,0.969719498979309,2,3,66058,1397,64661,0.9788519180114444,27.040947555555555,4133.234704,11.967902936558898,128,5.500000000000008E-4
8,test_20231101_135316,11382381.png,312486,667,311819,0.997865504374596,1,4,46745,89,46656,0.9980960530538026,21.842074666666665,2522.8946186666667,14.11181250456314,128,5.500000000000008E-4
9,test_20231101_135316,11079715.png,443815,113162,330653,0.7450243907934613,3,4,124136,15824,108312,0.872526905974093,17.42231111111111,2238.1416106666666,14.631927993255129,128,5.500000000000008E-4
10,test_20231101_135316,11551286.png,271883,267,271616,0.9990179599312939,1,3,40092,37,40055,0.9990771226179787,18.016108444444445,1877.54488,15.394900338849709,128,5.500000000000008E-4
1,test_20231101_135317,10404007.png,502730,17872,484858,0.964450102440674,2,3,61265,2595,58670,0.9576430261976658,26.03386666666667,3518.705610666667,12.666974273692194,128,5.600000000000008E-4
2,test_20231101_135317,1254659.png,342646,69532,273114,0.7970733643468769,2,3,80080,9762,70318,0.8780969030969031,21.44027911111111,3346.4703306666665,12.884933819048644,128,5.600000000000008E-4
3,test_20231101_135317,10188041.png,221231,9207,212024,0.9583828667772599,2,3,41731,1298,40433,0.9688960245381132,11.120924444444444,1098.1147306666667,17.724326434383556,128,5.600000000000008E-4
4,test_20231101_135317,10287332.png,216980,11942,205038,0.9449626693704489,1,4,22337,1637,20700,0.9267135246452075,9.578848,812.8562133333334,19.03066631114696,128,5.600000000000008E-4
5,test_20231101_135317,11610969.png,368720,23427,345293,0.9364639835105228,2,4,84111,3425,80686,0.9592799990488758,22.796608,3253.0010773333333,13.007961537557941,128,5.600000000000008E-4
6,test_20231101_135317,10350842.png,212614,5562,207052,0.9738399164683417,2,4,42529,818,41711,0.9807660655082414,19.46256711111111,2410.5704426666666,14.30960533734045,128,5.600000000000008E-4
7,test_20231101_135317,10863862.png,317432,9612,307820,0.969719498979309,2,4,66058,1397,64661,0.9788519180114444,27.040947555555555,4133.234704,11.967902936558898,128,5.600000000000008E-4
8,test_20231101_135317,11382381.png,312486,667,311819,0.997865504374596,1,3,46745,89,46656,0.9980960530538026,21.842074666666665,2522.8946186666667,14.11181250456314,128,5.600000000000008E-4
9,test_20231101_135317,11079715.png,443815,113162,330653,0.7450243907934613,4,4,124136,15824,108312,0.872526905974093,17.42231111111111,2238.1416106666666,14.631927993255129,128,5.600000000000008E-4
10,test_20231101_135317,11551286.png,271883,267,271616,0.9990179599312939,1,3,40092,37,40055,0.9990771226179787,18.016108444444445,1877.54488,15.394900338849709,128,5.600000000000008E-4
1,test_20231101_135318,10404007.png,502730,17872,484858,0.964450102440674,2,3,61265,2595,58670,0.9576430261976658,26.03386666666667,3518.705610666667,12.666974273692194,128,5.700000000000008E-4
2,test_20231101_135318,1254659.png,342646,69532,273114,0.7970733643468769,3,4,80080,9762,70318,0.8780969030969031,21.44027911111111,3346.4703306666665,12.884933819048644,128,5.700000000000008E-4
3,test_20231101_135318,10188041.png,221231,9207,212024,0.9583828667772599,2,4,41731,1298,40433,0.9688960245381132,11.120924444444444,1098.1147306666667,17.724326434383556,128,5.700000000000008E-4
4,test_20231101_135318,10287332.png,216980,11942,205038,0.9449626693704489,2,4,22337,1637,20700,0.9267135246452075,9.578848,812.8562133333334,19.03066631114696,128,5.700000000000008E-4
5,test_20231101_135318,11610969.png,368720,23427,345293,0.9364639835105228,2,3,84111,3425,80686,0.9592799990488758,22.796608,3253.0010773333333,13.007961537557941,128,5.700000000000008E-4
6,test_20231101_135318,10350842.png,212614,5562,207052,0.9738399164683417,2,3,42529,818,41711,0.9807660655082414,19.46256711111111,2410.5704426666666,14.30960533734045,128,5.700000000000008E-4
7,test_20231101_135318,10863862.png,317432,9612,307820,0.969719498979309,2,3,66058,1397,64661,0.9788519180114444,27.040947555555555,4133.234704,11.967902936558898,128,5.700000000000008E-4
8,test_20231101_135318,11382381.png,312486,667,311819,0.997865504374596,1,3,46745,89,46656,0.9980960530538026,21.842074666666665,2522.8946186666667,14.11181250456314,128,5.700000000000008E-4
9,test_20231101_135318,11079715.png,443815,113162,330653,0.7450243907934613,4,18,124136,15824,108312,0.872526905974093,17.42231111111111,2238.1416106666666,14.631927993255129,128,5.700000000000008E-4
10,test_20231101_135318,11551286.png,271883,267,271616,0.9990179599312939,1,4,40092,37,40055,0.9990771226179787,18.016108444444445,1877.54488,15.394900338849709,128,5.700000000000008E-4
1,test_20231101_135318,10404007.png,502730,17872,484858,0.964450102440674,3,4,61265,2595,58670,0.9576430261976658,26.03386666666667,3518.705610666667,12.666974273692194,128,5.800000000000009E-4
2,test_20231101_135318,1254659.png,342646,69532,273114,0.7970733643468769,3,4,80080,9762,70318,0.8780969030969031,21.44027911111111,3346.4703306666665,12.884933819048644,128,5.800000000000009E-4
3,test_20231101_135318,10188041.png,221231,9207,212024,0.9583828667772599,2,3,41731,1298,40433,0.9688960245381132,11.120924444444444,1098.1147306666667,17.724326434383556,128,5.800000000000009E-4
4,test_20231101_135318,10287332.png,216980,11942,205038,0.9449626693704489,2,3,22337,1637,20700,0.9267135246452075,9.578848,812.8562133333334,19.03066631114696,128,5.800000000000009E-4
5,test_20231101_135318,11610969.png,368720,23427,345293,0.9364639835105228,2,3,84111,3425,80686,0.9592799990488758,22.796608,3253.0010773333333,13.007961537557941,128,5.800000000000009E-4
6,test_20231101_135318,10350842.png,212614,5562,207052,0.9738399164683417,2,4,42529,818,41711,0.9807660655082414,19.46256711111111,2410.5704426666666,14.30960533734045,128,5.800000000000009E-4
7,test_20231101_135318,10863862.png,317432,9612,307820,0.969719498979309,2,4,66058,1397,64661,0.9788519180114444,27.040947555555555,4133.234704,11.967902936558898,128,5.800000000000009E-4
8,test_20231101_135318,11382381.png,312486,667,311819,0.997865504374596,1,3,46745,89,46656,0.9980960530538026,21.842074666666665,2522.8946186666667,14.11181250456314,128,5.800000000000009E-4
9,test_20231101_135318,11079715.png,443815,113162,330653,0.7450243907934613,3,5,124136,15824,108312,0.872526905974093,17.42231111111111,2238.1416106666666,14.631927993255129,128,5.800000000000009E-4
10,test_20231101_135318,11551286.png,271883,267,271616,0.9990179599312939,1,3,40092,37,40055,0.9990771226179787,18.016108444444445,1877.54488,15.394900338849709,128,5.800000000000009E-4
1,test_20231101_135319,10404007.png,502730,17872,484858,0.964450102440674,2,3,61265,2595,58670,0.9576430261976658,26.03386666666667,3518.705610666667,12.666974273692194,128,5.900000000000009E-4
2,test_20231101_135319,1254659.png,342646,69532,273114,0.7970733643468769,3,4,80080,9762,70318,0.8780969030969031,21.44027911111111,3346.4703306666665,12.884933819048644,128,5.900000000000009E-4
3,test_20231101_135319,10188041.png,221231,9207,212024,0.9583828667772599,2,4,41731,1298,40433,0.9688960245381132,11.120924444444444,1098.1147306666667,17.724326434383556,128,5.900000000000009E-4
4,test_20231101_135319,10287332.png,216980,11942,205038,0.9449626693704489,2,3,22337,1637,20700,0.9267135246452075,9.578848,812.8562133333334,19.03066631114696,128,5.900000000000009E-4
5,test_20231101_135319,11610969.png,368720,23427,345293,0.9364639835105228,3,3,84111,3425,80686,0.9592799990488758,22.796608,3253.0010773333333,13.007961537557941,128,5.900000000000009E-4
6,test_20231101_135319,10350842.png,212614,5562,207052,0.9738399164683417,1,3,42529,818,41711,0.9807660655082414,19.46256711111111,2410.5704426666666,14.30960533734045,128,5.900000000000009E-4
7,test_20231101_135319,10863862.png,317432,9612,307820,0.969719498979309,2,4,66058,1397,64661,0.9788519180114444,27.040947555555555,4133.234704,11.967902936558898,128,5.900000000000009E-4
8,test_20231101_135319,11382381.png,312486,667,311819,0.997865504374596,1,3,46745,89,46656,0.9980960530538026,21.842074666666665,2522.8946186666667,14.11181250456314,128,5.900000000000009E-4
9,test_20231101_135319,11079715.png,443815,113162,330653,0.7450243907934613,4,4,124136,15824,108312,0.872526905974093,17.42231111111111,2238.1416106666666,14.631927993255129,128,5.900000000000009E-4
10,test_20231101_135319,11551286.png,271883,267,271616,0.9990179599312939,1,3,40092,37,40055,0.9990771226179787,18.016108444444445,1877.54488,15.394900338849709,128,5.900000000000009E-4
1,test_20231101_135320,10404007.png,502730,17872,484858,0.964450102440674,2,3,61265,2595,58670,0.9576430261976658,26.03386666666667,3518.705610666667,12.666974273692194,128,6.000000000000009E-4
2,test_20231101_135320,1254659.png,342646,69532,273114,0.7970733643468769,3,4,80080,9762,70318,0.8780969030969031,21.44027911111111,3346.4703306666665,12.884933819048644,128,6.000000000000009E-4
3,test_20231101_135320,10188041.png,221231,9207,212024,0.9583828667772599,2,4,41731,1298,40433,0.9688960245381132,11.120924444444444,1098.1147306666667,17.724326434383556,128,6.000000000000009E-4
4,test_20231101_135320,10287332.png,216980,11942,205038,0.9449626693704489,1,3,22337,1637,20700,0.9267135246452075,9.578848,812.8562133333334,19.03066631114696,128,6.000000000000009E-4
5,test_20231101_135320,11610969.png,368720,23427,345293,0.9364639835105228,2,4,84111,3425,80686,0.9592799990488758,22.796608,3253.0010773333333,13.007961537557941,128,6.000000000000009E-4
6,test_20231101_135320,10350842.png,212614,5562,207052,0.9738399164683417,2,4,42529,818,41711,0.9807660655082414,19.46256711111111,2410.5704426666666,14.30960533734045,128,6.000000000000009E-4
7,test_20231101_135320,10863862.png,317432,9612,307820,0.969719498979309,2,4,66058,1397,64661,0.9788519180114444,27.040947555555555,4133.234704,11.967902936558898,128,6.000000000000009E-4
8,test_20231101_135320,11382381.png,312486,667,311819,0.997865504374596,2,3,46745,89,46656,0.9980960530538026,21.842074666666665,2522.8946186666667,14.11181250456314,128,6.000000000000009E-4
9,test_20231101_135320,11079715.png,443815,113162,330653,0.7450243907934613,3,4,124136,15824,108312,0.872526905974093,17.42231111111111,2238.1416106666666,14.631927993255129,128,6.000000000000009E-4
10,test_20231101_135320,11551286.png,271883,267,271616,0.9990179599312939,1,4,40092,37,40055,0.9990771226179787,18.016108444444445,1877.54488,15.394900338849709,128,6.000000000000009E-4
1,test_20231101_135320,10404007.png,502730,17872,484858,0.964450102440674,2,4,61265,2595,58670,0.9576430261976658,26.03386666666667,3518.705610666667,12.666974273692194,128,6.10000000000001E-4
2,test_20231101_135320,1254659.png,342646,69532,273114,0.7970733643468769,3,4,80080,9762,70318,0.8780969030969031,21.44027911111111,3346.4703306666665,12.884933819048644,128,6.10000000000001E-4
3,test_20231101_135320,10188041.png,221231,9207,212024,0.9583828667772599,2,3,41731,1298,40433,0.9688960245381132,11.120924444444444,1098.1147306666667,17.724326434383556,128,6.10000000000001E-4
4,test_20231101_135320,10287332.png,216980,11942,205038,0.9449626693704489,2,3,22337,1637,20700,0.9267135246452075,9.578848,812.8562133333334,19.03066631114696,128,6.10000000000001E-4
5,test_20231101_135320,11610969.png,368720,23427,345293,0.9364639835105228,2,3,84111,3425,80686,0.9592799990488758,22.796608,3253.0010773333333,13.007961537557941,128,6.10000000000001E-4
6,test_20231101_135320,10350842.png,212614,5562,207052,0.9738399164683417,1,4,42529,818,41711,0.9807660655082414,19.46256711111111,2410.5704426666666,14.30960533734045,128,6.10000000000001E-4
7,test_20231101_135320,10863862.png,317432,9612,307820,0.969719498979309,2,4,66058,1397,64661,0.9788519180114444,27.040947555555555,4133.234704,11.967902936558898,128,6.10000000000001E-4
8,test_20231101_135320,11382381.png,312486,667,311819,0.997865504374596,1,3,46745,89,46656,0.9980960530538026,21.842074666666665,2522.8946186666667,14.11181250456314,128,6.10000000000001E-4
9,test_20231101_135320,11079715.png,443815,113162,330653,0.7450243907934613,4,4,124136,15824,108312,0.872526905974093,17.42231111111111,2238.1416106666666,14.631927993255129,128,6.10000000000001E-4
10,test_20231101_135320,11551286.png,271883,267,271616,0.9990179599312939,1,4,40092,37,40055,0.9990771226179787,18.016108444444445,1877.54488,15.394900338849709,128,6.10000000000001E-4
1,test_20231101_135321,10404007.png,502730,17872,484858,0.964450102440674,3,3,61265,2595,58670,0.9576430261976658,26.03386666666667,3518.705610666667,12.666974273692194,128,6.20000000000001E-4
2,test_20231101_135321,1254659.png,342646,69532,273114,0.7970733643468769,4,4,80080,9762,70318,0.8780969030969031,21.44027911111111,3346.4703306666665,12.884933819048644,128,6.20000000000001E-4
3,test_20231101_135321,10188041.png,221231,9207,212024,0.9583828667772599,2,3,41731,1298,40433,0.9688960245381132,11.120924444444444,1098.1147306666667,17.724326434383556,128,6.20000000000001E-4
4,test_20231101_135321,10287332.png,216980,11942,205038,0.9449626693704489,2,3,22337,1637,20700,0.9267135246452075,9.578848,812.8562133333334,19.03066631114696,128,6.20000000000001E-4
5,test_20231101_135321,11610969.png,368720,23427,345293,0.9364639835105228,2,4,84111,3425,80686,0.9592799990488758,22.796608,3253.0010773333333,13.007961537557941,128,6.20000000000001E-4
6,test_20231101_135321,10350842.png,212614,5562,207052,0.9738399164683417,2,3,42529,818,41711,0.9807660655082414,19.46256711111111,2410.5704426666666,14.30960533734045,128,6.20000000000001E-4
7,test_20231101_135321,10863862.png,317432,9612,307820,0.969719498979309,2,3,66058,1397,64661,0.9788519180114444,27.040947555555555,4133.234704,11.967902936558898,128,6.20000000000001E-4
8,test_20231101_135321,11382381.png,312486,667,311819,0.997865504374596,2,3,46745,89,46656,0.9980960530538026,21.842074666666665,2522.8946186666667,14.11181250456314,128,6.20000000000001E-4
9,test_20231101_135321,11079715.png,443815,113162,330653,0.7450243907934613,4,4,124136,15824,108312,0.872526905974093,17.42231111111111,2238.1416106666666,14.631927993255129,128,6.20000000000001E-4
10,test_20231101_135321,11551286.png,271883,267,271616,0.9990179599312939,2,4,40092,37,40055,0.9990771226179787,18.016108444444445,1877.54488,15.394900338849709,128,6.20000000000001E-4
1,test_20231101_135322,10404007.png,502730,17872,484858,0.964450102440674,3,4,61265,2595,58670,0.9576430261976658,26.03386666666667,3518.705610666667,12.666974273692194,128,6.30000000000001E-4
2,test_20231101_135322,1254659.png,342646,69532,273114,0.7970733643468769,4,4,80080,9762,70318,0.8780969030969031,21.44027911111111,3346.4703306666665,12.884933819048644,128,6.30000000000001E-4
3,test_20231101_135322,10188041.png,221231,9207,212024,0.9583828667772599,3,3,41731,1298,40433,0.9688960245381132,11.120924444444444,1098.1147306666667,17.724326434383556,128,6.30000000000001E-4
4,test_20231101_135322,10287332.png,216980,11942,205038,0.9449626693704489,1,4,22337,1637,20700,0.9267135246452075,9.578848,812.8562133333334,19.03066631114696,128,6.30000000000001E-4
5,test_20231101_135322,11610969.png,368720,23427,345293,0.9364639835105228,3,4,84111,3425,80686,0.9592799990488758,22.796608,3253.0010773333333,13.007961537557941,128,6.30000000000001E-4
6,test_20231101_135322,10350842.png,212614,5562,207052,0.9738399164683417,2,4,42529,818,41711,0.9807660655082414,19.46256711111111,2410.5704426666666,14.30960533734045,128,6.30000000000001E-4
7,test_20231101_135322,10863862.png,317432,9612,307820,0.969719498979309,2,3,66058,1397,64661,0.9788519180114444,27.040947555555555,4133.234704,11.967902936558898,128,6.30000000000001E-4
8,test_20231101_135322,11382381.png,312486,667,311819,0.997865504374596,4,4,46745,89,46656,0.9980960530538026,21.842074666666665,2522.8946186666667,14.11181250456314,128,6.30000000000001E-4
9,test_20231101_135322,11079715.png,443815,113162,330653,0.7450243907934613,4,4,124136,15824,108312,0.872526905974093,17.42231111111111,2238.1416106666666,14.631927993255129,128,6.30000000000001E-4
10,test_20231101_135322,11551286.png,271883,267,271616,0.9990179599312939,1,4,40092,37,40055,0.9990771226179787,18.016108444444445,1877.54488,15.394900338849709,128,6.30000000000001E-4
1,test_20231101_135323,10404007.png,502730,17872,484858,0.964450102440674,2,9,61265,2595,58670,0.9576430261976658,26.03386666666667,3518.705610666667,12.666974273692194,128,6.40000000000001E-4
2,test_20231101_135323,1254659.png,342646,69532,273114,0.7970733643468769,3,4,80080,9762,70318,0.8780969030969031,21.44027911111111,3346.4703306666665,12.884933819048644,128,6.40000000000001E-4
3,test_20231101_135323,10188041.png,221231,9207,212024,0.9583828667772599,2,4,41731,1298,40433,0.9688960245381132,11.120924444444444,1098.1147306666667,17.724326434383556,128,6.40000000000001E-4
4,test_20231101_135323,10287332.png,216980,11942,205038,0.9449626693704489,2,4,22337,1637,20700,0.9267135246452075,9.578848,812.8562133333334,19.03066631114696,128,6.40000000000001E-4
5,test_20231101_135323,11610969.png,368720,23427,345293,0.9364639835105228,2,4,84111,3425,80686,0.9592799990488758,22.796608,3253.0010773333333,13.007961537557941,128,6.40000000000001E-4
6,test_20231101_135323,10350842.png,212614,5562,207052,0.9738399164683417,2,3,42529,818,41711,0.9807660655082414,19.46256711111111,2410.5704426666666,14.30960533734045,128,6.40000000000001E-4
7,test_20231101_135323,10863862.png,317432,9612,307820,0.969719498979309,2,4,66058,1397,64661,0.9788519180114444,27.040947555555555,4133.234704,11.967902936558898,128,6.40000000000001E-4
8,test_20231101_135323,11382381.png,312486,667,311819,0.997865504374596,1,4,46745,89,46656,0.9980960530538026,21.842074666666665,2522.8946186666667,14.11181250456314,128,6.40000000000001E-4
9,test_20231101_135323,11079715.png,443815,113162,330653,0.7450243907934613,4,4,124136,15824,108312,0.872526905974093,17.42231111111111,2238.1416106666666,14.631927993255129,128,6.40000000000001E-4
10,test_20231101_135323,11551286.png,271883,267,271616,0.9990179599312939,2,4,40092,37,40055,0.9990771226179787,18.016108444444445,1877.54488,15.394900338849709,128,6.40000000000001E-4
1,test_20231101_135323,10404007.png,502730,17872,484858,0.964450102440674,2,4,61265,2595,58670,0.9576430261976658,26.03386666666667,3518.705610666667,12.666974273692194,128,6.500000000000011E-4
2,test_20231101_135323,1254659.png,342646,69532,273114,0.7970733643468769,3,4,80080,9762,70318,0.8780969030969031,21.44027911111111,3346.4703306666665,12.884933819048644,128,6.500000000000011E-4
3,test_20231101_135323,10188041.png,221231,9207,212024,0.9583828667772599,2,3,41731,1298,40433,0.9688960245381132,11.120924444444444,1098.1147306666667,17.724326434383556,128,6.500000000000011E-4
4,test_20231101_135323,10287332.png,216980,11942,205038,0.9449626693704489,2,4,22337,1637,20700,0.9267135246452075,9.578848,812.8562133333334,19.03066631114696,128,6.500000000000011E-4
5,test_20231101_135323,11610969.png,368720,23427,345293,0.9364639835105228,2,3,84111,3425,80686,0.9592799990488758,22.796608,3253.0010773333333,13.007961537557941,128,6.500000000000011E-4
6,test_20231101_135323,10350842.png,212614,5562,207052,0.9738399164683417,2,3,42529,818,41711,0.9807660655082414,19.46256711111111,2410.5704426666666,14.30960533734045,128,6.500000000000011E-4
7,test_20231101_135323,10863862.png,317432,9612,307820,0.969719498979309,2,4,66058,1397,64661,0.9788519180114444,27.040947555555555,4133.234704,11.967902936558898,128,6.500000000000011E-4
8,test_20231101_135323,11382381.png,312486,667,311819,0.997865504374596,1,4,46745,89,46656,0.9980960530538026,21.842074666666665,2522.8946186666667,14.11181250456314,128,6.500000000000011E-4
9,test_20231101_135323,11079715.png,443815,113162,330653,0.7450243907934613,3,4,124136,15824,108312,0.872526905974093,17.42231111111111,2238.1416106666666,14.631927993255129,128,6.500000000000011E-4
10,test_20231101_135323,11551286.png,271883,267,271616,0.9990179599312939,1,3,40092,37,40055,0.9990771226179787,18.016108444444445,1877.54488,15.394900338849709,128,6.500000000000011E-4
1,test_20231101_135324,10404007.png,502730,17872,484858,0.964450102440674,3,3,61265,2595,58670,0.9576430261976658,26.03386666666667,3518.705610666667,12.666974273692194,128,6.600000000000011E-4
2,test_20231101_135324,1254659.png,342646,69532,273114,0.7970733643468769,3,4,80080,9762,70318,0.8780969030969031,21.44027911111111,3346.4703306666665,12.884933819048644,128,6.600000000000011E-4
3,test_20231101_135324,10188041.png,221231,9207,212024,0.9583828667772599,2,4,41731,1298,40433,0.9688960245381132,11.120924444444444,1098.1147306666667,17.724326434383556,128,6.600000000000011E-4
4,test_20231101_135324,10287332.png,216980,11942,205038,0.9449626693704489,1,4,22337,1637,20700,0.9267135246452075,9.578848,812.8562133333334,19.03066631114696,128,6.600000000000011E-4
5,test_20231101_135324,11610969.png,368720,23427,345293,0.9364639835105228,2,4,84111,3425,80686,0.9592799990488758,22.796608,3253.0010773333333,13.007961537557941,128,6.600000000000011E-4
6,test_20231101_135324,10350842.png,212614,5562,207052,0.9738399164683417,2,4,42529,818,41711,0.9807660655082414,19.46256711111111,2410.5704426666666,14.30960533734045,128,6.600000000000011E-4
7,test_20231101_135324,10863862.png,317432,9612,307820,0.969719498979309,2,4,66058,1397,64661,0.9788519180114444,27.040947555555555,4133.234704,11.967902936558898,128,6.600000000000011E-4
8,test_20231101_135324,11382381.png,312486,667,311819,0.997865504374596,1,4,46745,89,46656,0.9980960530538026,21.842074666666665,2522.8946186666667,14.11181250456314,128,6.600000000000011E-4
9,test_20231101_135324,11079715.png,443815,113162,330653,0.7450243907934613,3,4,124136,15824,108312,0.872526905974093,17.42231111111111,2238.1416106666666,14.631927993255129,128,6.600000000000011E-4
10,test_20231101_135324,11551286.png,271883,267,271616,0.9990179599312939,1,4,40092,37,40055,0.9990771226179787,18.016108444444445,1877.54488,15.394900338849709,128,6.600000000000011E-4
1,test_20231101_135325,10404007.png,502730,17872,484858,0.964450102440674,3,3,61265,2595,58670,0.9576430261976658,26.03386666666667,3518.705610666667,12.666974273692194,128,6.700000000000011E-4
2,test_20231101_135325,1254659.png,342646,69532,273114,0.7970733643468769,2,3,80080,9762,70318,0.8780969030969031,21.44027911111111,3346.4703306666665,12.884933819048644,128,6.700000000000011E-4
3,test_20231101_135325,10188041.png,221231,9207,212024,0.9583828667772599,2,3,41731,1298,40433,0.9688960245381132,11.120924444444444,1098.1147306666667,17.724326434383556,128,6.700000000000011E-4
4,test_20231101_135325,10287332.png,216980,11942,205038,0.9449626693704489,2,4,22337,1637,20700,0.9267135246452075,9.578848,812.8562133333334,19.03066631114696,128,6.700000000000011E-4
5,test_20231101_135325,11610969.png,368720,23427,345293,0.9364639835105228,2,4,84111,3425,80686,0.9592799990488758,22.796608,3253.0010773333333,13.007961537557941,128,6.700000000000011E-4
6,test_20231101_135325,10350842.png,212614,5562,207052,0.9738399164683417,1,4,42529,818,41711,0.9807660655082414,19.46256711111111,2410.5704426666666,14.30960533734045,128,6.700000000000011E-4
7,test_20231101_135325,10863862.png,317432,9612,307820,0.969719498979309,2,3,66058,1397,64661,0.9788519180114444,27.040947555555555,4133.234704,11.967902936558898,128,6.700000000000011E-4
8,test_20231101_135325,11382381.png,312486,667,311819,0.997865504374596,2,4,46745,89,46656,0.9980960530538026,21.842074666666665,2522.8946186666667,14.11181250456314,128,6.700000000000011E-4
9,test_20231101_135325,11079715.png,443815,113162,330653,0.7450243907934613,3,4,124136,15824,108312,0.872526905974093,17.42231111111111,2238.1416106666666,14.631927993255129,128,6.700000000000011E-4
10,test_20231101_135325,11551286.png,271883,267,271616,0.9990179599312939,1,3,40092,37,40055,0.9990771226179787,18.016108444444445,1877.54488,15.394900338849709,128,6.700000000000011E-4
1,test_20231101_135325,10404007.png,502730,17872,484858,0.964450102440674,2,4,61265,2595,58670,0.9576430261976658,26.03386666666667,3518.705610666667,12.666974273692194,128,6.800000000000011E-4
2,test_20231101_135325,1254659.png,342646,69532,273114,0.7970733643468769,2,4,80080,9762,70318,0.8780969030969031,21.44027911111111,3346.4703306666665,12.884933819048644,128,6.800000000000011E-4
3,test_20231101_135325,10188041.png,221231,9207,212024,0.9583828667772599,2,3,41731,1298,40433,0.9688960245381132,11.120924444444444,1098.1147306666667,17.724326434383556,128,6.800000000000011E-4
4,test_20231101_135325,10287332.png,216980,11942,205038,0.9449626693704489,2,4,22337,1637,20700,0.9267135246452075,9.578848,812.8562133333334,19.03066631114696,128,6.800000000000011E-4
5,test_20231101_135325,11610969.png,368720,23427,345293,0.9364639835105228,2,4,84111,3425,80686,0.9592799990488758,22.796608,3253.0010773333333,13.007961537557941,128,6.800000000000011E-4
6,test_20231101_135325,10350842.png,212614,5562,207052,0.9738399164683417,2,4,42529,818,41711,0.9807660655082414,19.46256711111111,2410.5704426666666,14.30960533734045,128,6.800000000000011E-4
7,test_20231101_135325,10863862.png,317432,9612,307820,0.969719498979309,2,3,66058,1397,64661,0.9788519180114444,27.040947555555555,4133.234704,11.967902936558898,128,6.800000000000011E-4
8,test_20231101_135325,11382381.png,312486,667,311819,0.997865504374596,1,4,46745,89,46656,0.9980960530538026,21.842074666666665,2522.8946186666667,14.11181250456314,128,6.800000000000011E-4
9,test_20231101_135325,11079715.png,443815,113162,330653,0.7450243907934613,4,4,124136,15824,108312,0.872526905974093,17.42231111111111,2238.1416106666666,14.631927993255129,128,6.800000000000011E-4
10,test_20231101_135325,11551286.png,271883,267,271616,0.9990179599312939,1,4,40092,37,40055,0.9990771226179787,18.016108444444445,1877.54488,15.394900338849709,128,6.800000000000011E-4
1,test_20231101_135326,10404007.png,502730,17872,484858,0.964450102440674,2,4,61265,2595,58670,0.9576430261976658,26.03386666666667,3518.705610666667,12.666974273692194,128,6.900000000000012E-4
2,test_20231101_135326,1254659.png,342646,69532,273114,0.7970733643468769,3,4,80080,9762,70318,0.8780969030969031,21.44027911111111,3346.4703306666665,12.884933819048644,128,6.900000000000012E-4
3,test_20231101_135326,10188041.png,221231,9207,212024,0.9583828667772599,2,3,41731,1298,40433,0.9688960245381132,11.120924444444444,1098.1147306666667,17.724326434383556,128,6.900000000000012E-4
4,test_20231101_135326,10287332.png,216980,11942,205038,0.9449626693704489,2,4,22337,1637,20700,0.9267135246452075,9.578848,812.8562133333334,19.03066631114696,128,6.900000000000012E-4
5,test_20231101_135326,11610969.png,368720,23427,345293,0.9364639835105228,3,4,84111,3425,80686,0.9592799990488758,22.796608,3253.0010773333333,13.007961537557941,128,6.900000000000012E-4
6,test_20231101_135326,10350842.png,212614,5562,207052,0.9738399164683417,2,3,42529,818,41711,0.9807660655082414,19.46256711111111,2410.5704426666666,14.30960533734045,128,6.900000000000012E-4
7,test_20231101_135326,10863862.png,317432,9612,307820,0.969719498979309,2,4,66058,1397,64661,0.9788519180114444,27.040947555555555,4133.234704,11.967902936558898,128,6.900000000000012E-4
8,test_20231101_135326,11382381.png,312486,667,311819,0.997865504374596,2,3,46745,89,46656,0.9980960530538026,21.842074666666665,2522.8946186666667,14.11181250456314,128,6.900000000000012E-4
9,test_20231101_135326,11079715.png,443815,113162,330653,0.7450243907934613,4,4,124136,15824,108312,0.872526905974093,17.42231111111111,2238.1416106666666,14.631927993255129,128,6.900000000000012E-4
10,test_20231101_135326,11551286.png,271883,267,271616,0.9990179599312939,1,3,40092,37,40055,0.9990771226179787,18.016108444444445,1877.54488,15.394900338849709,128,6.900000000000012E-4
1,test_20231101_135327,10404007.png,502730,17872,484858,0.964450102440674,2,4,61265,2595,58670,0.9576430261976658,26.03386666666667,3518.705610666667,12.666974273692194,128,7.000000000000012E-4
2,test_20231101_135327,1254659.png,342646,69532,273114,0.7970733643468769,3,4,80080,9762,70318,0.8780969030969031,21.44027911111111,3346.4703306666665,12.884933819048644,128,7.000000000000012E-4
3,test_20231101_135327,10188041.png,221231,9207,212024,0.9583828667772599,2,3,41731,1298,40433,0.9688960245381132,11.120924444444444,1098.1147306666667,17.724326434383556,128,7.000000000000012E-4
4,test_20231101_135327,10287332.png,216980,11942,205038,0.9449626693704489,2,4,22337,1637,20700,0.9267135246452075,9.578848,812.8562133333334,19.03066631114696,128,7.000000000000012E-4
5,test_20231101_135327,11610969.png,368720,23427,345293,0.9364639835105228,3,4,84111,3425,80686,0.9592799990488758,22.796608,3253.0010773333333,13.007961537557941,128,7.000000000000012E-4
6,test_20231101_135327,10350842.png,212614,5562,207052,0.9738399164683417,2,10,42529,818,41711,0.9807660655082414,19.46256711111111,2410.5704426666666,14.30960533734045,128,7.000000000000012E-4
7,test_20231101_135327,10863862.png,317432,9612,307820,0.969719498979309,2,5,66058,1397,64661,0.9788519180114444,27.040947555555555,4133.234704,11.967902936558898,128,7.000000000000012E-4
8,test_20231101_135327,11382381.png,312486,667,311819,0.997865504374596,2,3,46745,89,46656,0.9980960530538026,21.842074666666665,2522.8946186666667,14.11181250456314,128,7.000000000000012E-4
9,test_20231101_135327,11079715.png,443815,113162,330653,0.7450243907934613,3,4,124136,15824,108312,0.872526905974093,17.42231111111111,2238.1416106666666,14.631927993255129,128,7.000000000000012E-4
10,test_20231101_135327,11551286.png,271883,267,271616,0.9990179599312939,2,3,40092,37,40055,0.9990771226179787,18.016108444444445,1877.54488,15.394900338849709,128,7.000000000000012E-4
1,test_20231101_135327,10404007.png,502730,17872,484858,0.964450102440674,2,3,61265,2595,58670,0.9576430261976658,26.03386666666667,3518.705610666667,12.666974273692194,128,7.100000000000012E-4
2,test_20231101_135327,1254659.png,342646,69532,273114,0.7970733643468769,3,4,80080,9762,70318,0.8780969030969031,21.44027911111111,3346.4703306666665,12.884933819048644,128,7.100000000000012E-4
3,test_20231101_135327,10188041.png,221231,9207,212024,0.9583828667772599,2,4,41731,1298,40433,0.9688960245381132,11.120924444444444,1098.1147306666667,17.724326434383556,128,7.100000000000012E-4
4,test_20231101_135327,10287332.png,216980,11942,205038,0.9449626693704489,2,4,22337,1637,20700,0.9267135246452075,9.578848,812.8562133333334,19.03066631114696,128,7.100000000000012E-4
5,test_20231101_135327,11610969.png,368720,23427,345293,0.9364639835105228,3,4,84111,3425,80686,0.9592799990488758,22.796608,3253.0010773333333,13.007961537557941,128,7.100000000000012E-4
6,test_20231101_135327,10350842.png,212614,5562,207052,0.9738399164683417,2,4,42529,818,41711,0.9807660655082414,19.46256711111111,2410.5704426666666,14.30960533734045,128,7.100000000000012E-4
7,test_20231101_135327,10863862.png,317432,9612,307820,0.969719498979309,2,4,66058,1397,64661,0.9788519180114444,27.040947555555555,4133.234704,11.967902936558898,128,7.100000000000012E-4
8,test_20231101_135327,11382381.png,312486,667,311819,0.997865504374596,1,3,46745,89,46656,0.9980960530538026,21.842074666666665,2522.8946186666667,14.11181250456314,128,7.100000000000012E-4
9,test_20231101_135327,11079715.png,443815,113162,330653,0.7450243907934613,3,4,124136,15824,108312,0.872526905974093,17.42231111111111,2238.1416106666666,14.631927993255129,128,7.100000000000012E-4
10,test_20231101_135327,11551286.png,271883,267,271616,0.9990179599312939,2,3,40092,37,40055,0.9990771226179787,18.016108444444445,1877.54488,15.394900338849709,128,7.100000000000012E-4
1,test_20231101_135328,10404007.png,502730,17872,484858,0.964450102440674,2,3,61265,2595,58670,0.9576430261976658,26.03386666666667,3518.705610666667,12.666974273692194,128,7.200000000000012E-4
2,test_20231101_135328,1254659.png,342646,69532,273114,0.7970733643468769,3,4,80080,9762,70318,0.8780969030969031,21.44027911111111,3346.4703306666665,12.884933819048644,128,7.200000000000012E-4
3,test_20231101_135328,10188041.png,221231,9207,212024,0.9583828667772599,2,3,41731,1298,40433,0.9688960245381132,11.120924444444444,1098.1147306666667,17.724326434383556,128,7.200000000000012E-4
4,test_20231101_135328,10287332.png,216980,11942,205038,0.9449626693704489,2,3,22337,1637,20700,0.9267135246452075,9.578848,812.8562133333334,19.03066631114696,128,7.200000000000012E-4
5,test_20231101_135328,11610969.png,368720,23427,345293,0.9364639835105228,2,4,84111,3425,80686,0.9592799990488758,22.796608,3253.0010773333333,13.007961537557941,128,7.200000000000012E-4
6,test_20231101_135328,10350842.png,212614,5562,207052,0.9738399164683417,1,3,42529,818,41711,0.9807660655082414,19.46256711111111,2410.5704426666666,14.30960533734045,128,7.200000000000012E-4
7,test_20231101_135328,10863862.png,317432,9612,307820,0.969719498979309,2,3,66058,1397,64661,0.9788519180114444,27.040947555555555,4133.234704,11.967902936558898,128,7.200000000000012E-4
8,test_20231101_135328,11382381.png,312486,667,311819,0.997865504374596,2,3,46745,89,46656,0.9980960530538026,21.842074666666665,2522.8946186666667,14.11181250456314,128,7.200000000000012E-4
9,test_20231101_135328,11079715.png,443815,113162,330653,0.7450243907934613,4,4,124136,15824,108312,0.872526905974093,17.42231111111111,2238.1416106666666,14.631927993255129,128,7.200000000000012E-4
10,test_20231101_135328,11551286.png,271883,267,271616,0.9990179599312939,2,4,40092,37,40055,0.9990771226179787,18.016108444444445,1877.54488,15.394900338849709,128,7.200000000000012E-4
1,test_20231101_135329,10404007.png,502730,17872,484858,0.964450102440674,2,4,61265,2595,58670,0.9576430261976658,26.03386666666667,3518.705610666667,12.666974273692194,128,7.300000000000013E-4
2,test_20231101_135329,1254659.png,342646,69532,273114,0.7970733643468769,2,4,80080,9762,70318,0.8780969030969031,21.44027911111111,3346.4703306666665,12.884933819048644,128,7.300000000000013E-4
3,test_20231101_135329,10188041.png,221231,9207,212024,0.9583828667772599,2,3,41731,1298,40433,0.9688960245381132,11.120924444444444,1098.1147306666667,17.724326434383556,128,7.300000000000013E-4
4,test_20231101_135329,10287332.png,216980,11942,205038,0.9449626693704489,2,4,22337,1637,20700,0.9267135246452075,9.578848,812.8562133333334,19.03066631114696,128,7.300000000000013E-4
5,test_20231101_135329,11610969.png,368720,23427,345293,0.9364639835105228,2,3,84111,3425,80686,0.9592799990488758,22.796608,3253.0010773333333,13.007961537557941,128,7.300000000000013E-4
6,test_20231101_135329,10350842.png,212614,5562,207052,0.9738399164683417,1,4,42529,818,41711,0.9807660655082414,19.46256711111111,2410.5704426666666,14.30960533734045,128,7.300000000000013E-4
7,test_20231101_135329,10863862.png,317432,9612,307820,0.969719498979309,2,4,66058,1397,64661,0.9788519180114444,27.040947555555555,4133.234704,11.967902936558898,128,7.300000000000013E-4
8,test_20231101_135329,11382381.png,312486,667,311819,0.997865504374596,2,4,46745,89,46656,0.9980960530538026,21.842074666666665,2522.8946186666667,14.11181250456314,128,7.300000000000013E-4
9,test_20231101_135329,11079715.png,443815,113162,330653,0.7450243907934613,3,4,124136,15824,108312,0.872526905974093,17.42231111111111,2238.1416106666666,14.631927993255129,128,7.300000000000013E-4
10,test_20231101_135329,11551286.png,271883,267,271616,0.9990179599312939,1,3,40092,37,40055,0.9990771226179787,18.016108444444445,1877.54488,15.394900338849709,128,7.300000000000013E-4
1,test_20231101_135329,10404007.png,502730,17872,484858,0.964450102440674,2,4,61265,2595,58670,0.9576430261976658,26.03386666666667,3518.705610666667,12.666974273692194,128,7.400000000000013E-4
2,test_20231101_135329,1254659.png,342646,69532,273114,0.7970733643468769,3,4,80080,9762,70318,0.8780969030969031,21.44027911111111,3346.4703306666665,12.884933819048644,128,7.400000000000013E-4
3,test_20231101_135329,10188041.png,221231,9207,212024,0.9583828667772599,2,3,41731,1298,40433,0.9688960245381132,11.120924444444444,1098.1147306666667,17.724326434383556,128,7.400000000000013E-4
4,test_20231101_135329,10287332.png,216980,11942,205038,0.9449626693704489,2,4,22337,1637,20700,0.9267135246452075,9.578848,812.8562133333334,19.03066631114696,128,7.400000000000013E-4
5,test_20231101_135329,11610969.png,368720,23427,345293,0.9364639835105228,3,4,84111,3425,80686,0.9592799990488758,22.796608,3253.0010773333333,13.007961537557941,128,7.400000000000013E-4
6,test_20231101_135329,10350842.png,212614,5562,207052,0.9738399164683417,1,3,42529,818,41711,0.9807660655082414,19.46256711111111,2410.5704426666666,14.30960533734045,128,7.400000000000013E-4
7,test_20231101_135329,10863862.png,317432,9612,307820,0.969719498979309,2,3,66058,1397,64661,0.9788519180114444,27.040947555555555,4133.234704,11.967902936558898,128,7.400000000000013E-4
8,test_20231101_135329,11382381.png,312486,667,311819,0.997865504374596,1,3,46745,89,46656,0.9980960530538026,21.842074666666665,2522.8946186666667,14.11181250456314,128,7.400000000000013E-4
9,test_20231101_135329,11079715.png,443815,113162,330653,0.7450243907934613,3,4,124136,15824,108312,0.872526905974093,17.42231111111111,2238.1416106666666,14.631927993255129,128,7.400000000000013E-4
10,test_20231101_135329,11551286.png,271883,267,271616,0.9990179599312939,1,3,40092,37,40055,0.9990771226179787,18.016108444444445,1877.54488,15.394900338849709,128,7.400000000000013E-4
1,test_20231101_135330,10404007.png,502730,17872,484858,0.964450102440674,3,3,61265,2595,58670,0.9576430261976658,26.03386666666667,3518.705610666667,12.666974273692194,128,7.500000000000013E-4
2,test_20231101_135330,1254659.png,342646,69532,273114,0.7970733643468769,3,4,80080,9762,70318,0.8780969030969031,21.44027911111111,3346.4703306666665,12.884933819048644,128,7.500000000000013E-4
3,test_20231101_135330,10188041.png,221231,9207,212024,0.9583828667772599,2,4,41731,1298,40433,0.9688960245381132,11.120924444444444,1098.1147306666667,17.724326434383556,128,7.500000000000013E-4
4,test_20231101_135330,10287332.png,216980,11942,205038,0.9449626693704489,1,3,22337,1637,20700,0.9267135246452075,9.578848,812.8562133333334,19.03066631114696,128,7.500000000000013E-4
5,test_20231101_135330,11610969.png,368720,23427,345293,0.9364639835105228,3,4,84111,3425,80686,0.9592799990488758,22.796608,3253.0010773333333,13.007961537557941,128,7.500000000000013E-4
6,test_20231101_135330,10350842.png,212614,5562,207052,0.9738399164683417,1,3,42529,818,41711,0.9807660655082414,19.46256711111111,2410.5704426666666,14.30960533734045,128,7.500000000000013E-4
7,test_20231101_135330,10863862.png,317432,9612,307820,0.969719498979309,2,4,66058,1397,64661,0.9788519180114444,27.040947555555555,4133.234704,11.967902936558898,128,7.500000000000013E-4
8,test_20231101_135330,11382381.png,312486,667,311819,0.997865504374596,1,5,46745,89,46656,0.9980960530538026,21.842074666666665,2522.8946186666667,14.11181250456314,128,7.500000000000013E-4
9,test_20231101_135330,11079715.png,443815,113162,330653,0.7450243907934613,3,4,124136,15824,108312,0.872526905974093,17.42231111111111,2238.1416106666666,14.631927993255129,128,7.500000000000013E-4
10,test_20231101_135330,11551286.png,271883,267,271616,0.9990179599312939,2,3,40092,37,40055,0.9990771226179787,18.016108444444445,1877.54488,15.394900338849709,128,7.500000000000013E-4
1,test_20231101_135331,10404007.png,502730,17792,484938,0.9646092335846279,2,3,61265,2583,58682,0.9578388965967518,26.03775288888889,3519.475594666667,12.666024028752677,128,7.600000000000013E-4
2,test_20231101_135331,1254659.png,342646,69532,273114,0.7970733643468769,3,3,80080,9762,70318,0.8780969030969031,21.44027911111111,3346.4703306666665,12.884933819048644,128,7.600000000000013E-4
3,test_20231101_135331,10188041.png,221231,9087,212144,0.9589252862392703,2,4,41731,1280,40451,0.9693273585583858,11.215783111111111,1121.9856,17.630930778164586,128,7.600000000000013E-4
4,test_20231101_135331,10287332.png,216980,11942,205038,0.9449626693704489,2,3,22337,1637,20700,0.9267135246452075,9.578848,812.8562133333334,19.03066631114696,128,7.600000000000013E-4
5,test_20231101_135331,11610969.png,368720,23407,345313,0.9365182252115426,2,3,84111,3424,80687,0.9592918881002485,22.902257777777777,3263.1791573333335,12.994394424875402,128,7.600000000000013E-4
6,test_20231101_135331,10350842.png,212614,5522,207092,0.9740280508339055,1,4,42529,812,41717,0.9809071457123375,19.516519111111112,2419.365386666667,14.293788978678773,128,7.600000000000013E-4
7,test_20231101_135331,10863862.png,317432,9509,307923,0.9700439779228307,2,3,66058,1384,64674,0.9790487147658119,27.16096888888889,4153.414896,11.94675044724713,128,7.600000000000013E-4
8,test_20231101_135331,11382381.png,312486,667,311819,0.997865504374596,2,4,46745,89,46656,0.9980960530538026,21.842074666666665,2522.8946186666667,14.11181250456314,128,7.600000000000013E-4
9,test_20231101_135331,11079715.png,443815,112982,330833,0.7454299651881977,3,4,124136,15797,108339,0.8727444093574789,17.65957511111111,2280.1507466666667,14.551168005861816,128,7.600000000000013E-4
10,test_20231101_135331,11551286.png,271883,267,271616,0.9990179599312939,2,3,40092,37,40055,0.9990771226179787,18.016108444444445,1877.54488,15.394900338849709,128,7.600000000000013E-4
1,test_20231101_135331,10404007.png,502730,17792,484938,0.9646092335846279,2,4,61265,2583,58682,0.9578388965967518,26.03775288888889,3519.475594666667,12.666024028752677,128,7.700000000000014E-4
2,test_20231101_135331,1254659.png,342646,69532,273114,0.7970733643468769,3,4,80080,9762,70318,0.8780969030969031,21.44027911111111,3346.4703306666665,12.884933819048644,128,7.700000000000014E-4
3,test_20231101_135331,10188041.png,221231,8987,212244,0.9593773024576122,2,3,41731,1268,40463,0.969614914571901,11.263271111111111,1127.1926293333333,17.61082220591244,128,7.700000000000014E-4
4,test_20231101_135331,10287332.png,216980,11942,205038,0.9449626693704489,2,4,22337,1637,20700,0.9267135246452075,9.578848,812.8562133333334,19.03066631114696,128,7.700000000000014E-4
5,test_20231101_135331,11610969.png,368720,23407,345313,0.9365182252115426,2,4,84111,3424,80687,0.9592918881002485,22.902257777777777,3263.1791573333335,12.994394424875402,128,7.700000000000014E-4
6,test_20231101_135331,10350842.png,212614,5522,207092,0.9740280508339055,1,4,42529,812,41717,0.9809071457123375,19.516519111111112,2419.365386666667,14.293788978678773,128,7.700000000000014E-4
7,test_20231101_135331,10863862.png,317432,9509,307923,0.9700439779228307,2,3,66058,1384,64674,0.9790487147658119,27.16096888888889,4153.414896,11.94675044724713,128,7.700000000000014E-4
8,test_20231101_135331,11382381.png,312486,667,311819,0.997865504374596,1,4,46745,89,46656,0.9980960530538026,21.842074666666665,2522.8946186666667,14.11181250456314,128,7.700000000000014E-4
9,test_20231101_135331,11079715.png,443815,112982,330833,0.7454299651881977,3,4,124136,15797,108339,0.8727444093574789,17.65957511111111,2280.1507466666667,14.551168005861816,128,7.700000000000014E-4
10,test_20231101_135331,11551286.png,271883,267,271616,0.9990179599312939,2,3,40092,37,40055,0.9990771226179787,18.016108444444445,1877.54488,15.394900338849709,128,7.700000000000014E-4
1,test_20231101_135332,10404007.png,502730,17792,484938,0.9646092335846279,2,4,61265,2583,58682,0.9578388965967518,26.03775288888889,3519.475594666667,12.666024028752677,128,7.800000000000014E-4
2,test_20231101_135332,1254659.png,342646,69532,273114,0.7970733643468769,3,4,80080,9762,70318,0.8780969030969031,21.44027911111111,3346.4703306666665,12.884933819048644,128,7.800000000000014E-4
3,test_20231101_135332,10188041.png,221231,8987,212244,0.9593773024576122,2,4,41731,1268,40463,0.969614914571901,11.263271111111111,1127.1926293333333,17.61082220591244,128,7.800000000000014E-4
4,test_20231101_135332,10287332.png,216980,11942,205038,0.9449626693704489,1,4,22337,1637,20700,0.9267135246452075,9.578848,812.8562133333334,19.03066631114696,128,7.800000000000014E-4
5,test_20231101_135332,11610969.png,368720,23407,345313,0.9365182252115426,3,3,84111,3424,80687,0.9592918881002485,22.902257777777777,3263.1791573333335,12.994394424875402,128,7.800000000000014E-4
6,test_20231101_135332,10350842.png,212614,5522,207092,0.9740280508339055,1,4,42529,812,41717,0.9809071457123375,19.516519111111112,2419.365386666667,14.293788978678773,128,7.800000000000014E-4
7,test_20231101_135332,10863862.png,317432,9509,307923,0.9700439779228307,2,4,66058,1384,64674,0.9790487147658119,27.16096888888889,4153.414896,11.94675044724713,128,7.800000000000014E-4
8,test_20231101_135332,11382381.png,312486,667,311819,0.997865504374596,1,3,46745,89,46656,0.9980960530538026,21.842074666666665,2522.8946186666667,14.11181250456314,128,7.800000000000014E-4
9,test_20231101_135332,11079715.png,443815,112982,330833,0.7454299651881977,3,4,124136,15797,108339,0.8727444093574789,17.65957511111111,2280.1507466666667,14.551168005861816,128,7.800000000000014E-4
10,test_20231101_135332,11551286.png,271883,267,271616,0.9990179599312939,1,12,40092,37,40055,0.9990771226179787,18.016108444444445,1877.54488,15.394900338849709,128,7.800000000000014E-4
1,test_20231101_135333,10404007.png,502730,17792,484938,0.9646092335846279,2,3,61265,2583,58682,0.9578388965967518,26.03775288888889,3519.475594666667,12.666024028752677,128,7.900000000000014E-4
2,test_20231101_135333,1254659.png,342646,69532,273114,0.7970733643468769,3,4,80080,9762,70318,0.8780969030969031,21.44027911111111,3346.4703306666665,12.884933819048644,128,7.900000000000014E-4
3,test_20231101_135333,10188041.png,221231,8987,212244,0.9593773024576122,2,4,41731,1268,40463,0.969614914571901,11.263271111111111,1127.1926293333333,17.61082220591244,128,7.900000000000014E-4
4,test_20231101_135333,10287332.png,216980,11942,205038,0.9449626693704489,2,4,22337,1637,20700,0.9267135246452075,9.578848,812.8562133333334,19.03066631114696,128,7.900000000000014E-4
5,test_20231101_135333,11610969.png,368720,23407,345313,0.9365182252115426,3,4,84111,3424,80687,0.9592918881002485,22.902257777777777,3263.1791573333335,12.994394424875402,128,7.900000000000014E-4
6,test_20231101_135333,10350842.png,212614,5522,207092,0.9740280508339055,2,3,42529,812,41717,0.9809071457123375,19.516519111111112,2419.365386666667,14.293788978678773,128,7.900000000000014E-4
7,test_20231101_135333,10863862.png,317432,9509,307923,0.9700439779228307,2,4,66058,1384,64674,0.9790487147658119,27.16096888888889,4153.414896,11.94675044724713,128,7.900000000000014E-4
8,test_20231101_135333,11382381.png,312486,667,311819,0.997865504374596,1,4,46745,89,46656,0.9980960530538026,21.842074666666665,2522.8946186666667,14.11181250456314,128,7.900000000000014E-4
9,test_20231101_135333,11079715.png,443815,112982,330833,0.7454299651881977,3,4,124136,15797,108339,0.8727444093574789,17.65957511111111,2280.1507466666667,14.551168005861816,128,7.900000000000014E-4
10,test_20231101_135333,11551286.png,271883,267,271616,0.9990179599312939,1,3,40092,37,40055,0.9990771226179787,18.016108444444445,1877.54488,15.394900338849709,128,7.900000000000014E-4
1,test_20231101_135333,10404007.png,502730,17792,484938,0.9646092335846279,2,4,61265,2583,58682,0.9578388965967518,26.03775288888889,3519.475594666667,12.666024028752677,128,8.000000000000014E-4
2,test_20231101_135333,1254659.png,342646,69532,273114,0.7970733643468769,3,4,80080,9762,70318,0.8780969030969031,21.44027911111111,3346.4703306666665,12.884933819048644,128,8.000000000000014E-4
3,test_20231101_135333,10188041.png,221231,8987,212244,0.9593773024576122,2,3,41731,1268,40463,0.969614914571901,11.263271111111111,1127.1926293333333,17.61082220591244,128,8.000000000000014E-4
4,test_20231101_135333,10287332.png,216980,11942,205038,0.9449626693704489,1,3,22337,1637,20700,0.9267135246452075,9.578848,812.8562133333334,19.03066631114696,128,8.000000000000014E-4
5,test_20231101_135333,11610969.png,368720,23407,345313,0.9365182252115426,2,4,84111,3424,80687,0.9592918881002485,22.902257777777777,3263.1791573333335,12.994394424875402,128,8.000000000000014E-4
6,test_20231101_135333,10350842.png,212614,5522,207092,0.9740280508339055,2,4,42529,812,41717,0.9809071457123375,19.516519111111112,2419.365386666667,14.293788978678773,128,8.000000000000014E-4
7,test_20231101_135333,10863862.png,317432,9509,307923,0.9700439779228307,2,4,66058,1384,64674,0.9790487147658119,27.16096888888889,4153.414896,11.94675044724713,128,8.000000000000014E-4
8,test_20231101_135333,11382381.png,312486,667,311819,0.997865504374596,2,3,46745,89,46656,0.9980960530538026,21.842074666666665,2522.8946186666667,14.11181250456314,128,8.000000000000014E-4
9,test_20231101_135333,11079715.png,443815,112982,330833,0.7454299651881977,3,4,124136,15797,108339,0.8727444093574789,17.65957511111111,2280.1507466666667,14.551168005861816,128,8.000000000000014E-4
10,test_20231101_135333,11551286.png,271883,267,271616,0.9990179599312939,1,3,40092,37,40055,0.9990771226179787,18.016108444444445,1877.54488,15.394900338849709,128,8.000000000000014E-4
1,test_20231101_135334,10404007.png,502730,17792,484938,0.9646092335846279,2,4,61265,2583,58682,0.9578388965967518,26.03775288888889,3519.475594666667,12.666024028752677,128,8.100000000000015E-4
2,test_20231101_135334,1254659.png,342646,69532,273114,0.7970733643468769,3,4,80080,9762,70318,0.8780969030969031,21.44027911111111,3346.4703306666665,12.884933819048644,128,8.100000000000015E-4
3,test_20231101_135334,10188041.png,221231,8987,212244,0.9593773024576122,2,3,41731,1268,40463,0.969614914571901,11.263271111111111,1127.1926293333333,17.61082220591244,128,8.100000000000015E-4
4,test_20231101_135334,10287332.png,216980,11942,205038,0.9449626693704489,1,3,22337,1637,20700,0.9267135246452075,9.578848,812.8562133333334,19.03066631114696,128,8.100000000000015E-4
5,test_20231101_135334,11610969.png,368720,23407,345313,0.9365182252115426,3,3,84111,3424,80687,0.9592918881002485,22.902257777777777,3263.1791573333335,12.994394424875402,128,8.100000000000015E-4
6,test_20231101_135334,10350842.png,212614,5522,207092,0.9740280508339055,2,3,42529,812,41717,0.9809071457123375,19.516519111111112,2419.365386666667,14.293788978678773,128,8.100000000000015E-4
7,test_20231101_135334,10863862.png,317432,9509,307923,0.9700439779228307,3,4,66058,1384,64674,0.9790487147658119,27.16096888888889,4153.414896,11.94675044724713,128,8.100000000000015E-4
8,test_20231101_135334,11382381.png,312486,667,311819,0.997865504374596,2,3,46745,89,46656,0.9980960530538026,21.842074666666665,2522.8946186666667,14.11181250456314,128,8.100000000000015E-4
9,test_20231101_135334,11079715.png,443815,112982,330833,0.7454299651881977,3,4,124136,15797,108339,0.8727444093574789,17.65957511111111,2280.1507466666667,14.551168005861816,128,8.100000000000015E-4
10,test_20231101_135334,11551286.png,271883,267,271616,0.9990179599312939,2,4,40092,37,40055,0.9990771226179787,18.016108444444445,1877.54488,15.394900338849709,128,8.100000000000015E-4
1,test_20231101_135335,10404007.png,502730,17792,484938,0.9646092335846279,2,4,61265,2583,58682,0.9578388965967518,26.03775288888889,3519.475594666667,12.666024028752677,128,8.200000000000015E-4
2,test_20231101_135335,1254659.png,342646,69532,273114,0.7970733643468769,4,4,80080,9762,70318,0.8780969030969031,21.44027911111111,3346.4703306666665,12.884933819048644,128,8.200000000000015E-4
3,test_20231101_135335,10188041.png,221231,8987,212244,0.9593773024576122,3,4,41731,1268,40463,0.969614914571901,11.263271111111111,1127.1926293333333,17.61082220591244,128,8.200000000000015E-4
4,test_20231101_135335,10287332.png,216980,11942,205038,0.9449626693704489,2,4,22337,1637,20700,0.9267135246452075,9.578848,812.8562133333334,19.03066631114696,128,8.200000000000015E-4
5,test_20231101_135335,11610969.png,368720,23407,345313,0.9365182252115426,2,4,84111,3424,80687,0.9592918881002485,22.902257777777777,3263.1791573333335,12.994394424875402,128,8.200000000000015E-4
6,test_20231101_135335,10350842.png,212614,5522,207092,0.9740280508339055,1,3,42529,812,41717,0.9809071457123375,19.516519111111112,2419.365386666667,14.293788978678773,128,8.200000000000015E-4
7,test_20231101_135335,10863862.png,317432,9509,307923,0.9700439779228307,2,3,66058,1384,64674,0.9790487147658119,27.16096888888889,4153.414896,11.94675044724713,128,8.200000000000015E-4
8,test_20231101_135335,11382381.png,312486,667,311819,0.997865504374596,1,4,46745,89,46656,0.9980960530538026,21.842074666666665,2522.8946186666667,14.11181250456314,128,8.200000000000015E-4
9,test_20231101_135335,11079715.png,443815,112982,330833,0.7454299651881977,3,4,124136,15797,108339,0.8727444093574789,17.65957511111111,2280.1507466666667,14.551168005861816,128,8.200000000000015E-4
10,test_20231101_135335,11551286.png,271883,267,271616,0.9990179599312939,1,4,40092,37,40055,0.9990771226179787,18.016108444444445,1877.54488,15.394900338849709,128,8.200000000000015E-4
1,test_20231101_135336,10404007.png,502730,17792,484938,0.9646092335846279,2,4,61265,2583,58682,0.9578388965967518,26.03775288888889,3519.475594666667,12.666024028752677,128,8.300000000000015E-4
2,test_20231101_135336,1254659.png,342646,69532,273114,0.7970733643468769,3,4,80080,9762,70318,0.8780969030969031,21.44027911111111,3346.4703306666665,12.884933819048644,128,8.300000000000015E-4
3,test_20231101_135336,10188041.png,221231,8987,212244,0.9593773024576122,2,4,41731,1268,40463,0.969614914571901,11.263271111111111,1127.1926293333333,17.61082220591244,128,8.300000000000015E-4
4,test_20231101_135336,10287332.png,216980,11942,205038,0.9449626693704489,2,3,22337,1637,20700,0.9267135246452075,9.578848,812.8562133333334,19.03066631114696,128,8.300000000000015E-4
5,test_20231101_135336,11610969.png,368720,23407,345313,0.9365182252115426,2,4,84111,3424,80687,0.9592918881002485,22.902257777777777,3263.1791573333335,12.994394424875402,128,8.300000000000015E-4
6,test_20231101_135336,10350842.png,212614,5522,207092,0.9740280508339055,2,3,42529,812,41717,0.9809071457123375,19.516519111111112,2419.365386666667,14.293788978678773,128,8.300000000000015E-4
7,test_20231101_135336,10863862.png,317432,9509,307923,0.9700439779228307,2,4,66058,1384,64674,0.9790487147658119,27.16096888888889,4153.414896,11.94675044724713,128,8.300000000000015E-4
8,test_20231101_135336,11382381.png,312486,667,311819,0.997865504374596,1,4,46745,89,46656,0.9980960530538026,21.842074666666665,2522.8946186666667,14.11181250456314,128,8.300000000000015E-4
9,test_20231101_135336,11079715.png,443815,112982,330833,0.7454299651881977,3,5,124136,15797,108339,0.8727444093574789,17.65957511111111,2280.1507466666667,14.551168005861816,128,8.300000000000015E-4
10,test_20231101_135336,11551286.png,271883,267,271616,0.9990179599312939,1,4,40092,37,40055,0.9990771226179787,18.016108444444445,1877.54488,15.394900338849709,128,8.300000000000015E-4
1,test_20231101_135336,10404007.png,502730,17792,484938,0.9646092335846279,2,4,61265,2583,58682,0.9578388965967518,26.03775288888889,3519.475594666667,12.666024028752677,128,8.400000000000016E-4
2,test_20231101_135336,1254659.png,342646,69532,273114,0.7970733643468769,2,4,80080,9762,70318,0.8780969030969031,21.44027911111111,3346.4703306666665,12.884933819048644,128,8.400000000000016E-4
3,test_20231101_135336,10188041.png,221231,8987,212244,0.9593773024576122,2,4,41731,1268,40463,0.969614914571901,11.263271111111111,1127.1926293333333,17.61082220591244,128,8.400000000000016E-4
4,test_20231101_135336,10287332.png,216980,11942,205038,0.9449626693704489,2,7,22337,1637,20700,0.9267135246452075,9.578848,812.8562133333334,19.03066631114696,128,8.400000000000016E-4
5,test_20231101_135336,11610969.png,368720,23407,345313,0.9365182252115426,2,4,84111,3424,80687,0.9592918881002485,22.902257777777777,3263.1791573333335,12.994394424875402,128,8.400000000000016E-4
6,test_20231101_135336,10350842.png,212614,3932,208682,0.98150639186507,2,4,42529,576,41953,0.9864563004067812,23.636912,3423.166224,12.786523725061926,128,8.400000000000016E-4
7,test_20231101_135336,10863862.png,317432,9509,307923,0.9700439779228307,2,4,66058,1384,64674,0.9790487147658119,27.16096888888889,4153.414896,11.94675044724713,128,8.400000000000016E-4
8,test_20231101_135336,11382381.png,312486,667,311819,0.997865504374596,1,3,46745,89,46656,0.9980960530538026,21.842074666666665,2522.8946186666667,14.11181250456314,128,8.400000000000016E-4
9,test_20231101_135336,11079715.png,443815,112982,330833,0.7454299651881977,3,4,124136,15797,108339,0.8727444093574789,17.65957511111111,2280.1507466666667,14.551168005861816,128,8.400000000000016E-4
10,test_20231101_135336,11551286.png,271883,267,271616,0.9990179599312939,1,3,40092,37,40055,0.9990771226179787,18.016108444444445,1877.54488,15.394900338849709,128,8.400000000000016E-4
1,test_20231101_135337,10404007.png,502730,17792,484938,0.9646092335846279,3,4,61265,2583,58682,0.9578388965967518,26.03775288888889,3519.475594666667,12.666024028752677,128,8.500000000000016E-4
2,test_20231101_135337,1254659.png,342646,69532,273114,0.7970733643468769,3,4,80080,9762,70318,0.8780969030969031,21.44027911111111,3346.4703306666665,12.884933819048644,128,8.500000000000016E-4
3,test_20231101_135337,10188041.png,221231,8987,212244,0.9593773024576122,2,4,41731,1268,40463,0.969614914571901,11.263271111111111,1127.1926293333333,17.61082220591244,128,8.500000000000016E-4
4,test_20231101_135337,10287332.png,216980,11942,205038,0.9449626693704489,2,4,22337,1637,20700,0.9267135246452075,9.578848,812.8562133333334,19.03066631114696,128,8.500000000000016E-4
5,test_20231101_135337,11610969.png,368720,23407,345313,0.9365182252115426,3,4,84111,3424,80687,0.9592918881002485,22.902257777777777,3263.1791573333335,12.994394424875402,128,8.500000000000016E-4
6,test_20231101_135337,10350842.png,212614,3932,208682,0.98150639186507,2,4,42529,576,41953,0.9864563004067812,23.636912,3423.166224,12.786523725061926,128,8.500000000000016E-4
7,test_20231101_135337,10863862.png,317432,9509,307923,0.9700439779228307,2,8,66058,1384,64674,0.9790487147658119,27.16096888888889,4153.414896,11.94675044724713,128,8.500000000000016E-4
8,test_20231101_135337,11382381.png,312486,667,311819,0.997865504374596,2,3,46745,89,46656,0.9980960530538026,21.842074666666665,2522.8946186666667,14.11181250456314,128,8.500000000000016E-4
9,test_20231101_135337,11079715.png,443815,112982,330833,0.7454299651881977,3,4,124136,15797,108339,0.8727444093574789,17.65957511111111,2280.1507466666667,14.551168005861816,128,8.500000000000016E-4
10,test_20231101_135337,11551286.png,271883,267,271616,0.9990179599312939,2,3,40092,37,40055,0.9990771226179787,18.016108444444445,1877.54488,15.394900338849709,128,8.500000000000016E-4
1,test_20231101_135338,10404007.png,502730,17792,484938,0.9646092335846279,2,4,61265,2583,58682,0.9578388965967518,26.03775288888889,3519.475594666667,12.666024028752677,128,8.600000000000016E-4
2,test_20231101_135338,1254659.png,342646,69532,273114,0.7970733643468769,2,4,80080,9762,70318,0.8780969030969031,21.44027911111111,3346.4703306666665,12.884933819048644,128,8.600000000000016E-4
3,test_20231101_135338,10188041.png,221231,8987,212244,0.9593773024576122,2,3,41731,1268,40463,0.969614914571901,11.263271111111111,1127.1926293333333,17.61082220591244,128,8.600000000000016E-4
4,test_20231101_135338,10287332.png,216980,11942,205038,0.9449626693704489,2,4,22337,1637,20700,0.9267135246452075,9.578848,812.8562133333334,19.03066631114696,128,8.600000000000016E-4
5,test_20231101_135338,11610969.png,368720,23407,345313,0.9365182252115426,2,4,84111,3424,80687,0.9592918881002485,22.902257777777777,3263.1791573333335,12.994394424875402,128,8.600000000000016E-4
6,test_20231101_135338,10350842.png,212614,3932,208682,0.98150639186507,2,6,42529,576,41953,0.9864563004067812,23.636912,3423.166224,12.786523725061926,128,8.600000000000016E-4
7,test_20231101_135338,10863862.png,317432,9509,307923,0.9700439779228307,2,4,66058,1384,64674,0.9790487147658119,27.16096888888889,4153.414896,11.94675044724713,128,8.600000000000016E-4
8,test_20231101_135338,11382381.png,312486,667,311819,0.997865504374596,1,3,46745,89,46656,0.9980960530538026,21.842074666666665,2522.8946186666667,14.11181250456314,128,8.600000000000016E-4
9,test_20231101_135338,11079715.png,443815,112982,330833,0.7454299651881977,3,4,124136,15797,108339,0.8727444093574789,17.65957511111111,2280.1507466666667,14.551168005861816,128,8.600000000000016E-4
10,test_20231101_135338,11551286.png,271883,267,271616,0.9990179599312939,2,3,40092,37,40055,0.9990771226179787,18.016108444444445,1877.54488,15.394900338849709,128,8.600000000000016E-4
1,test_20231101_135338,10404007.png,502730,17792,484938,0.9646092335846279,2,3,61265,2583,58682,0.9578388965967518,26.03775288888889,3519.475594666667,12.666024028752677,128,8.700000000000016E-4
2,test_20231101_135338,1254659.png,342646,69532,273114,0.7970733643468769,3,4,80080,9762,70318,0.8780969030969031,21.44027911111111,3346.4703306666665,12.884933819048644,128,8.700000000000016E-4
3,test_20231101_135338,10188041.png,221231,8987,212244,0.9593773024576122,2,3,41731,1268,40463,0.969614914571901,11.263271111111111,1127.1926293333333,17.61082220591244,128,8.700000000000016E-4
4,test_20231101_135338,10287332.png,216980,11942,205038,0.9449626693704489,2,3,22337,1637,20700,0.9267135246452075,9.578848,812.8562133333334,19.03066631114696,128,8.700000000000016E-4
5,test_20231101_135338,11610969.png,368720,23407,345313,0.9365182252115426,2,9,84111,3424,80687,0.9592918881002485,22.902257777777777,3263.1791573333335,12.994394424875402,128,8.700000000000016E-4
6,test_20231101_135338,10350842.png,212614,3932,208682,0.98150639186507,1,5,42529,576,41953,0.9864563004067812,23.636912,3423.166224,12.786523725061926,128,8.700000000000016E-4
7,test_20231101_135338,10863862.png,317432,9509,307923,0.9700439779228307,3,4,66058,1384,64674,0.9790487147658119,27.16096888888889,4153.414896,11.94675044724713,128,8.700000000000016E-4
8,test_20231101_135338,11382381.png,312486,667,311819,0.997865504374596,2,3,46745,89,46656,0.9980960530538026,21.842074666666665,2522.8946186666667,14.11181250456314,128,8.700000000000016E-4
9,test_20231101_135338,11079715.png,443815,112982,330833,0.7454299651881977,3,5,124136,15797,108339,0.8727444093574789,17.65957511111111,2280.1507466666667,14.551168005861816,128,8.700000000000016E-4
10,test_20231101_135338,11551286.png,271883,267,271616,0.9990179599312939,1,4,40092,37,40055,0.9990771226179787,18.016108444444445,1877.54488,15.394900338849709,128,8.700000000000016E-4
1,test_20231101_135339,10404007.png,502730,17792,484938,0.9646092335846279,2,3,61265,2583,58682,0.9578388965967518,26.03775288888889,3519.475594666667,12.666024028752677,128,8.800000000000017E-4
2,test_20231101_135339,1254659.png,342646,69532,273114,0.7970733643468769,4,4,80080,9762,70318,0.8780969030969031,21.44027911111111,3346.4703306666665,12.884933819048644,128,8.800000000000017E-4
3,test_20231101_135339,10188041.png,221231,8987,212244,0.9593773024576122,2,3,41731,1268,40463,0.969614914571901,11.263271111111111,1127.1926293333333,17.61082220591244,128,8.800000000000017E-4
4,test_20231101_135339,10287332.png,216980,11942,205038,0.9449626693704489,2,4,22337,1637,20700,0.9267135246452075,9.578848,812.8562133333334,19.03066631114696,128,8.800000000000017E-4
5,test_20231101_135339,11610969.png,368720,23407,345313,0.9365182252115426,2,4,84111,3424,80687,0.9592918881002485,22.902257777777777,3263.1791573333335,12.994394424875402,128,8.800000000000017E-4
6,test_20231101_135339,10350842.png,212614,3932,208682,0.98150639186507,1,4,42529,576,41953,0.9864563004067812,23.636912,3423.166224,12.786523725061926,128,8.800000000000017E-4
7,test_20231101_135339,10863862.png,317432,9509,307923,0.9700439779228307,2,3,66058,1384,64674,0.9790487147658119,27.16096888888889,4153.414896,11.94675044724713,128,8.800000000000017E-4
8,test_20231101_135339,11382381.png,312486,667,311819,0.997865504374596,2,4,46745,89,46656,0.9980960530538026,21.842074666666665,2522.8946186666667,14.11181250456314,128,8.800000000000017E-4
9,test_20231101_135339,11079715.png,443815,112982,330833,0.7454299651881977,3,4,124136,15797,108339,0.8727444093574789,17.65957511111111,2280.1507466666667,14.551168005861816,128,8.800000000000017E-4
10,test_20231101_135339,11551286.png,271883,267,271616,0.9990179599312939,1,4,40092,37,40055,0.9990771226179787,18.016108444444445,1877.54488,15.394900338849709,128,8.800000000000017E-4
1,test_20231101_135340,10404007.png,502730,17792,484938,0.9646092335846279,3,3,61265,2583,58682,0.9578388965967518,26.03775288888889,3519.475594666667,12.666024028752677,128,8.900000000000017E-4
2,test_20231101_135340,1254659.png,342646,69532,273114,0.7970733643468769,2,3,80080,9762,70318,0.8780969030969031,21.44027911111111,3346.4703306666665,12.884933819048644,128,8.900000000000017E-4
3,test_20231101_135340,10188041.png,221231,8987,212244,0.9593773024576122,2,4,41731,1268,40463,0.969614914571901,11.263271111111111,1127.1926293333333,17.61082220591244,128,8.900000000000017E-4
4,test_20231101_135340,10287332.png,216980,11942,205038,0.9449626693704489,1,3,22337,1637,20700,0.9267135246452075,9.578848,812.8562133333334,19.03066631114696,128,8.900000000000017E-4
5,test_20231101_135340,11610969.png,368720,23407,345313,0.9365182252115426,2,4,84111,3424,80687,0.9592918881002485,22.902257777777777,3263.1791573333335,12.994394424875402,128,8.900000000000017E-4
6,test_20231101_135340,10350842.png,212614,3932,208682,0.98150639186507,1,3,42529,576,41953,0.9864563004067812,23.636912,3423.166224,12.786523725061926,128,8.900000000000017E-4
7,test_20231101_135340,10863862.png,317432,9509,307923,0.9700439779228307,2,4,66058,1384,64674,0.9790487147658119,27.16096888888889,4153.414896,11.94675044724713,128,8.900000000000017E-4
8,test_20231101_135340,11382381.png,312486,667,311819,0.997865504374596,1,3,46745,89,46656,0.9980960530538026,21.842074666666665,2522.8946186666667,14.11181250456314,128,8.900000000000017E-4
9,test_20231101_135340,11079715.png,443815,112982,330833,0.7454299651881977,4,4,124136,15797,108339,0.8727444093574789,17.65957511111111,2280.1507466666667,14.551168005861816,128,8.900000000000017E-4
10,test_20231101_135340,11551286.png,271883,267,271616,0.9990179599312939,2,3,40092,37,40055,0.9990771226179787,18.016108444444445,1877.54488,15.394900338849709,128,8.900000000000017E-4
1,test_20231101_135340,10404007.png,502730,17792,484938,0.9646092335846279,2,4,61265,2583,58682,0.9578388965967518,26.03775288888889,3519.475594666667,12.666024028752677,128,9.000000000000017E-4
2,test_20231101_135340,1254659.png,342646,69532,273114,0.7970733643468769,4,4,80080,9762,70318,0.8780969030969031,21.44027911111111,3346.4703306666665,12.884933819048644,128,9.000000000000017E-4
3,test_20231101_135340,10188041.png,221231,8987,212244,0.9593773024576122,2,4,41731,1268,40463,0.969614914571901,11.263271111111111,1127.1926293333333,17.61082220591244,128,9.000000000000017E-4
4,test_20231101_135340,10287332.png,216980,11942,205038,0.9449626693704489,2,4,22337,1637,20700,0.9267135246452075,9.578848,812.8562133333334,19.03066631114696,128,9.000000000000017E-4
5,test_20231101_135340,11610969.png,368720,23407,345313,0.9365182252115426,2,10,84111,3424,80687,0.9592918881002485,22.902257777777777,3263.1791573333335,12.994394424875402,128,9.000000000000017E-4
6,test_20231101_135340,10350842.png,212614,3932,208682,0.98150639186507,1,4,42529,576,41953,0.9864563004067812,23.636912,3423.166224,12.786523725061926,128,9.000000000000017E-4
7,test_20231101_135340,10863862.png,317432,9509,307923,0.9700439779228307,2,3,66058,1384,64674,0.9790487147658119,27.16096888888889,4153.414896,11.94675044724713,128,9.000000000000017E-4
8,test_20231101_135340,11382381.png,312486,667,311819,0.997865504374596,1,3,46745,89,46656,0.9980960530538026,21.842074666666665,2522.8946186666667,14.11181250456314,128,9.000000000000017E-4
9,test_20231101_135340,11079715.png,443815,112982,330833,0.7454299651881977,3,4,124136,15797,108339,0.8727444093574789,17.65957511111111,2280.1507466666667,14.551168005861816,128,9.000000000000017E-4
10,test_20231101_135340,11551286.png,271883,267,271616,0.9990179599312939,1,3,40092,37,40055,0.9990771226179787,18.016108444444445,1877.54488,15.394900338849709,128,9.000000000000017E-4
1,test_20231101_135341,10404007.png,502730,17792,484938,0.9646092335846279,3,3,61265,2583,58682,0.9578388965967518,26.03775288888889,3519.475594666667,12.666024028752677,128,9.100000000000017E-4
2,test_20231101_135341,1254659.png,342646,69532,273114,0.7970733643468769,2,3,80080,9762,70318,0.8780969030969031,21.44027911111111,3346.4703306666665,12.884933819048644,128,9.100000000000017E-4
3,test_20231101_135341,10188041.png,221231,8987,212244,0.9593773024576122,1,3,41731,1268,40463,0.969614914571901,11.263271111111111,1127.1926293333333,17.61082220591244,128,9.100000000000017E-4
4,test_20231101_135341,10287332.png,216980,11942,205038,0.9449626693704489,1,3,22337,1637,20700,0.9267135246452075,9.578848,812.8562133333334,19.03066631114696,128,9.100000000000017E-4
5,test_20231101_135341,11610969.png,368720,23407,345313,0.9365182252115426,2,4,84111,3424,80687,0.9592918881002485,22.902257777777777,3263.1791573333335,12.994394424875402,128,9.100000000000017E-4
6,test_20231101_135341,10350842.png,212614,3932,208682,0.98150639186507,1,4,42529,576,41953,0.9864563004067812,23.636912,3423.166224,12.786523725061926,128,9.100000000000017E-4
7,test_20231101_135341,10863862.png,317432,9509,307923,0.9700439779228307,3,3,66058,1384,64674,0.9790487147658119,27.16096888888889,4153.414896,11.94675044724713,128,9.100000000000017E-4
8,test_20231101_135341,11382381.png,312486,667,311819,0.997865504374596,2,4,46745,89,46656,0.9980960530538026,21.842074666666665,2522.8946186666667,14.11181250456314,128,9.100000000000017E-4
9,test_20231101_135341,11079715.png,443815,112982,330833,0.7454299651881977,3,5,124136,15797,108339,0.8727444093574789,17.65957511111111,2280.1507466666667,14.551168005861816,128,9.100000000000017E-4
10,test_20231101_135341,11551286.png,271883,267,271616,0.9990179599312939,2,4,40092,37,40055,0.9990771226179787,18.016108444444445,1877.54488,15.394900338849709,128,9.100000000000017E-4
1,test_20231101_135342,10404007.png,502730,17792,484938,0.9646092335846279,3,4,61265,2583,58682,0.9578388965967518,26.03775288888889,3519.475594666667,12.666024028752677,128,9.200000000000018E-4
2,test_20231101_135342,1254659.png,342646,69532,273114,0.7970733643468769,3,4,80080,9762,70318,0.8780969030969031,21.44027911111111,3346.4703306666665,12.884933819048644,128,9.200000000000018E-4
3,test_20231101_135342,10188041.png,221231,8987,212244,0.9593773024576122,2,4,41731,1268,40463,0.969614914571901,11.263271111111111,1127.1926293333333,17.61082220591244,128,9.200000000000018E-4
4,test_20231101_135342,10287332.png,216980,11942,205038,0.9449626693704489,2,4,22337,1637,20700,0.9267135246452075,9.578848,812.8562133333334,19.03066631114696,128,9.200000000000018E-4
5,test_20231101_135342,11610969.png,368720,23407,345313,0.9365182252115426,2,3,84111,3424,80687,0.9592918881002485,22.902257777777777,3263.1791573333335,12.994394424875402,128,9.200000000000018E-4
6,test_20231101_135342,10350842.png,212614,3932,208682,0.98150639186507,1,4,42529,576,41953,0.9864563004067812,23.636912,3423.166224,12.786523725061926,128,9.200000000000018E-4
7,test_20231101_135342,10863862.png,317432,9509,307923,0.9700439779228307,2,3,66058,1384,64674,0.9790487147658119,27.16096888888889,4153.414896,11.94675044724713,128,9.200000000000018E-4
8,test_20231101_135342,11382381.png,312486,647,311839,0.9979295072419244,2,3,46745,86,46659,0.998160231040753,22.598771555555555,2668.5678666666668,13.868021086677665,128,9.200000000000018E-4
9,test_20231101_135342,11079715.png,443815,112982,330833,0.7454299651881977,3,4,124136,15797,108339,0.8727444093574789,17.65957511111111,2280.1507466666667,14.551168005861816,128,9.200000000000018E-4
10,test_20231101_135342,11551286.png,271883,267,271616,0.9990179599312939,1,3,40092,37,40055,0.9990771226179787,18.016108444444445,1877.54488,15.394900338849709,128,9.200000000000018E-4
1,test_20231101_135342,10404007.png,502730,17792,484938,0.9646092335846279,3,4,61265,2583,58682,0.9578388965967518,26.03775288888889,3519.475594666667,12.666024028752677,128,9.300000000000018E-4
2,test_20231101_135342,1254659.png,342646,69532,273114,0.7970733643468769,2,4,80080,9762,70318,0.8780969030969031,21.44027911111111,3346.4703306666665,12.884933819048644,128,9.300000000000018E-4
3,test_20231101_135342,10188041.png,221231,8987,212244,0.9593773024576122,1,3,41731,1268,40463,0.969614914571901,11.263271111111111,1127.1926293333333,17.61082220591244,128,9.300000000000018E-4
4,test_20231101_135342,10287332.png,216980,11942,205038,0.9449626693704489,2,4,22337,1637,20700,0.9267135246452075,9.578848,812.8562133333334,19.03066631114696,128,9.300000000000018E-4
5,test_20231101_135342,11610969.png,368720,23407,345313,0.9365182252115426,2,3,84111,3424,80687,0.9592918881002485,22.902257777777777,3263.1791573333335,12.994394424875402,128,9.300000000000018E-4
6,test_20231101_135342,10350842.png,212614,3932,208682,0.98150639186507,2,4,42529,576,41953,0.9864563004067812,23.636912,3423.166224,12.786523725061926,128,9.300000000000018E-4
7,test_20231101_135342,10863862.png,317432,9509,307923,0.9700439779228307,3,4,66058,1384,64674,0.9790487147658119,27.16096888888889,4153.414896,11.94675044724713,128,9.300000000000018E-4
8,test_20231101_135342,11382381.png,312486,647,311839,0.9979295072419244,1,3,46745,86,46659,0.998160231040753,22.598771555555555,2668.5678666666668,13.868021086677665,128,9.300000000000018E-4
9,test_20231101_135342,11079715.png,443815,112982,330833,0.7454299651881977,3,4,124136,15797,108339,0.8727444093574789,17.65957511111111,2280.1507466666667,14.551168005861816,128,9.300000000000018E-4
10,test_20231101_135342,11551286.png,271883,267,271616,0.9990179599312939,1,3,40092,37,40055,0.9990771226179787,18.016108444444445,1877.54488,15.394900338849709,128,9.300000000000018E-4
1,test_20231101_135343,10404007.png,502730,17792,484938,0.9646092335846279,3,3,61265,2583,58682,0.9578388965967518,26.03775288888889,3519.475594666667,12.666024028752677,128,9.400000000000018E-4
2,test_20231101_135343,1254659.png,342646,69532,273114,0.7970733643468769,3,4,80080,9762,70318,0.8780969030969031,21.44027911111111,3346.4703306666665,12.884933819048644,128,9.400000000000018E-4
3,test_20231101_135343,10188041.png,221231,8987,212244,0.9593773024576122,1,3,41731,1268,40463,0.969614914571901,11.263271111111111,1127.1926293333333,17.61082220591244,128,9.400000000000018E-4
4,test_20231101_135343,10287332.png,216980,11942,205038,0.9449626693704489,2,4,22337,1637,20700,0.9267135246452075,9.578848,812.8562133333334,19.03066631114696,128,9.400000000000018E-4
5,test_20231101_135343,11610969.png,368720,23407,345313,0.9365182252115426,2,4,84111,3424,80687,0.9592918881002485,22.902257777777777,3263.1791573333335,12.994394424875402,128,9.400000000000018E-4
6,test_20231101_135343,10350842.png,212614,3932,208682,0.98150639186507,2,4,42529,576,41953,0.9864563004067812,23.636912,3423.166224,12.786523725061926,128,9.400000000000018E-4
7,test_20231101_135343,10863862.png,317432,9509,307923,0.9700439779228307,2,4,66058,1384,64674,0.9790487147658119,27.16096888888889,4153.414896,11.94675044724713,128,9.400000000000018E-4
8,test_20231101_135343,11382381.png,312486,647,311839,0.9979295072419244,1,4,46745,86,46659,0.998160231040753,22.598771555555555,2668.5678666666668,13.868021086677665,128,9.400000000000018E-4
9,test_20231101_135343,11079715.png,443815,112982,330833,0.7454299651881977,4,4,124136,15797,108339,0.8727444093574789,17.65957511111111,2280.1507466666667,14.551168005861816,128,9.400000000000018E-4
10,test_20231101_135343,11551286.png,271883,267,271616,0.9990179599312939,1,13,40092,37,40055,0.9990771226179787,18.016108444444445,1877.54488,15.394900338849709,128,9.400000000000018E-4
1,test_20231101_135344,10404007.png,502730,17792,484938,0.9646092335846279,3,4,61265,2583,58682,0.9578388965967518,26.03775288888889,3519.475594666667,12.666024028752677,128,9.500000000000018E-4
2,test_20231101_135344,1254659.png,342646,69532,273114,0.7970733643468769,3,4,80080,9762,70318,0.8780969030969031,21.44027911111111,3346.4703306666665,12.884933819048644,128,9.500000000000018E-4
3,test_20231101_135344,10188041.png,221231,8987,212244,0.9593773024576122,2,4,41731,1268,40463,0.969614914571901,11.263271111111111,1127.1926293333333,17.61082220591244,128,9.500000000000018E-4
4,test_20231101_135344,10287332.png,216980,11942,205038,0.9449626693704489,2,4,22337,1637,20700,0.9267135246452075,9.578848,812.8562133333334,19.03066631114696,128,9.500000000000018E-4
5,test_20231101_135344,11610969.png,368720,23407,345313,0.9365182252115426,2,4,84111,3424,80687,0.9592918881002485,22.902257777777777,3263.1791573333335,12.994394424875402,128,9.500000000000018E-4
6,test_20231101_135344,10350842.png,212614,3932,208682,0.98150639186507,1,3,42529,576,41953,0.9864563004067812,23.636912,3423.166224,12.786523725061926,128,9.500000000000018E-4
7,test_20231101_135344,10863862.png,317432,9509,307923,0.9700439779228307,2,3,66058,1384,64674,0.9790487147658119,27.16096888888889,4153.414896,11.94675044724713,128,9.500000000000018E-4
8,test_20231101_135344,11382381.png,312486,647,311839,0.9979295072419244,2,4,46745,86,46659,0.998160231040753,22.598771555555555,2668.5678666666668,13.868021086677665,128,9.500000000000018E-4
9,test_20231101_135344,11079715.png,443815,112982,330833,0.7454299651881977,5,5,124136,15797,108339,0.8727444093574789,17.65957511111111,2280.1507466666667,14.551168005861816,128,9.500000000000018E-4
10,test_20231101_135344,11551286.png,271883,267,271616,0.9990179599312939,2,3,40092,37,40055,0.9990771226179787,18.016108444444445,1877.54488,15.394900338849709,128,9.500000000000018E-4
1,test_20231101_135344,10404007.png,502730,17792,484938,0.9646092335846279,2,4,61265,2583,58682,0.9578388965967518,26.03775288888889,3519.475594666667,12.666024028752677,128,9.600000000000019E-4
2,test_20231101_135344,1254659.png,342646,69532,273114,0.7970733643468769,3,4,80080,9762,70318,0.8780969030969031,21.44027911111111,3346.4703306666665,12.884933819048644,128,9.600000000000019E-4
3,test_20231101_135344,10188041.png,221231,8987,212244,0.9593773024576122,2,4,41731,1268,40463,0.969614914571901,11.263271111111111,1127.1926293333333,17.61082220591244,128,9.600000000000019E-4
4,test_20231101_135344,10287332.png,216980,11942,205038,0.9449626693704489,1,3,22337,1637,20700,0.9267135246452075,9.578848,812.8562133333334,19.03066631114696,128,9.600000000000019E-4
5,test_20231101_135344,11610969.png,368720,23407,345313,0.9365182252115426,2,3,84111,3424,80687,0.9592918881002485,22.902257777777777,3263.1791573333335,12.994394424875402,128,9.600000000000019E-4
6,test_20231101_135344,10350842.png,212614,3932,208682,0.98150639186507,1,3,42529,576,41953,0.9864563004067812,23.636912,3423.166224,12.786523725061926,128,9.600000000000019E-4
7,test_20231101_135344,10863862.png,317432,9509,307923,0.9700439779228307,2,4,66058,1384,64674,0.9790487147658119,27.16096888888889,4153.414896,11.94675044724713,128,9.600000000000019E-4
8,test_20231101_135344,11382381.png,312486,647,311839,0.9979295072419244,1,3,46745,86,46659,0.998160231040753,22.598771555555555,2668.5678666666668,13.868021086677665,128,9.600000000000019E-4
9,test_20231101_135344,11079715.png,443815,112982,330833,0.7454299651881977,3,5,124136,15797,108339,0.8727444093574789,17.65957511111111,2280.1507466666667,14.551168005861816,128,9.600000000000019E-4
10,test_20231101_135344,11551286.png,271883,267,271616,0.9990179599312939,2,3,40092,37,40055,0.9990771226179787,18.016108444444445,1877.54488,15.394900338849709,128,9.600000000000019E-4
1,test_20231101_135345,10404007.png,502730,17792,484938,0.9646092335846279,2,3,61265,2583,58682,0.9578388965967518,26.03775288888889,3519.475594666667,12.666024028752677,128,9.700000000000019E-4
2,test_20231101_135345,1254659.png,342646,69532,273114,0.7970733643468769,4,4,80080,9762,70318,0.8780969030969031,21.44027911111111,3346.4703306666665,12.884933819048644,128,9.700000000000019E-4
3,test_20231101_135345,10188041.png,221231,8987,212244,0.9593773024576122,2,4,41731,1268,40463,0.969614914571901,11.263271111111111,1127.1926293333333,17.61082220591244,128,9.700000000000019E-4
4,test_20231101_135345,10287332.png,216980,11942,205038,0.9449626693704489,2,4,22337,1637,20700,0.9267135246452075,9.578848,812.8562133333334,19.03066631114696,128,9.700000000000019E-4
5,test_20231101_135345,11610969.png,368720,23407,345313,0.9365182252115426,2,4,84111,3424,80687,0.9592918881002485,22.902257777777777,3263.1791573333335,12.994394424875402,128,9.700000000000019E-4
6,test_20231101_135345,10350842.png,212614,3932,208682,0.98150639186507,2,5,42529,576,41953,0.9864563004067812,23.636912,3423.166224,12.786523725061926,128,9.700000000000019E-4
7,test_20231101_135345,10863862.png,317432,9509,307923,0.9700439779228307,2,4,66058,1384,64674,0.9790487147658119,27.16096888888889,4153.414896,11.94675044724713,128,9.700000000000019E-4
8,test_20231101_135345,11382381.png,312486,647,311839,0.9979295072419244,1,3,46745,86,46659,0.998160231040753,22.598771555555555,2668.5678666666668,13.868021086677665,128,9.700000000000019E-4
9,test_20231101_135345,11079715.png,443815,112982,330833,0.7454299651881977,3,5,124136,15797,108339,0.8727444093574789,17.65957511111111,2280.1507466666667,14.551168005861816,128,9.700000000000019E-4
10,test_20231101_135345,11551286.png,271883,267,271616,0.9990179599312939,1,3,40092,37,40055,0.9990771226179787,18.016108444444445,1877.54488,15.394900338849709,128,9.700000000000019E-4
1,test_20231101_135346,10404007.png,502730,17227,485503,0.9657330972888032,2,4,61265,2508,58757,0.9590630865910389,26.18104177777778,3556.778357333333,12.620235581466272,128,9.80000000000002E-4
2,test_20231101_135346,1254659.png,342646,69372,273274,0.7975403185795252,3,3,80080,9748,70332,0.8782717282717283,21.510003555555556,3361.1507893333333,12.865923644631687,128,9.80000000000002E-4
3,test_20231101_135346,10188041.png,221231,8827,212404,0.9601005284069593,2,4,41731,1254,40477,0.9699503965876687,11.451015111111111,1179.3955306666667,17.414208831870877,128,9.80000000000002E-4
4,test_20231101_135346,10287332.png,216980,11862,205118,0.9453313669462623,2,3,22337,1625,20712,0.9272507498768858,9.604408888888889,817.0261866666667,19.008443844547408,128,9.80000000000002E-4
5,test_20231101_135346,11610969.png,368720,22907,345813,0.9378742677370362,3,8,84111,3354,80757,0.9601241216963299,22.99936,3283.6162026666666,12.96727970887227,128,9.80000000000002E-4
6,test_20231101_135346,10350842.png,212614,3832,208782,0.9819767277789797,2,4,42529,561,41968,0.9868090009170213,23.791479111111112,3451.5819786666666,12.750621680748441,128,9.80000000000002E-4
7,test_20231101_135346,10863862.png,317432,9309,308123,0.9706740341238439,2,4,66058,1355,64703,0.9794877229101698,27.314110222222222,4188.082469333333,11.91065135897458,128,9.80000000000002E-4
8,test_20231101_135346,11382381.png,312486,527,311959,0.9983135244458952,1,4,46745,70,46675,0.9985025136378223,22.788933333333333,2727.61464,13.772973480885131,128,9.80000000000002E-4
9,test_20231101_135346,11079715.png,443815,112882,330933,0.7456552842963848,3,4,124136,15787,108349,0.8728249661661404,17.698288,2286.444048,14.539197827226813,128,9.80000000000002E-4
10,test_20231101_135346,11551286.png,271883,267,271616,0.9990179599312939,1,4,40092,37,40055,0.9990771226179787,18.016108444444445,1877.54488,15.394900338849709,128,9.80000000000002E-4
1,test_20231101_135347,10404007.png,502730,17227,485503,0.9657330972888032,3,4,61265,2508,58757,0.9590630865910389,26.18104177777778,3556.778357333333,12.620235581466272,128,9.90000000000002E-4
2,test_20231101_135347,1254659.png,342646,69372,273274,0.7975403185795252,4,4,80080,9748,70332,0.8782717282717283,21.510003555555556,3361.1507893333333,12.865923644631687,128,9.90000000000002E-4
3,test_20231101_135347,10188041.png,221231,8827,212404,0.9601005284069593,2,4,41731,1254,40477,0.9699503965876687,11.451015111111111,1179.3955306666667,17.414208831870877,128,9.90000000000002E-4
4,test_20231101_135347,10287332.png,216980,11862,205118,0.9453313669462623,2,4,22337,1625,20712,0.9272507498768858,9.604408888888889,817.0261866666667,19.008443844547408,128,9.90000000000002E-4
5,test_20231101_135347,11610969.png,368720,22907,345813,0.9378742677370362,2,4,84111,3354,80757,0.9601241216963299,22.99936,3283.6162026666666,12.96727970887227,128,9.90000000000002E-4
6,test_20231101_135347,10350842.png,212614,3832,208782,0.9819767277789797,2,4,42529,561,41968,0.9868090009170213,23.791479111111112,3451.5819786666666,12.750621680748441,128,9.90000000000002E-4
7,test_20231101_135347,10863862.png,317432,9309,308123,0.9706740341238439,3,4,66058,1355,64703,0.9794877229101698,27.314110222222222,4188.082469333333,11.91065135897458,128,9.90000000000002E-4
8,test_20231101_135347,11382381.png,312486,527,311959,0.9983135244458952,2,4,46745,70,46675,0.9985025136378223,22.788933333333333,2727.61464,13.772973480885131,128,9.90000000000002E-4
9,test_20231101_135347,11079715.png,443815,112882,330933,0.7456552842963848,4,5,124136,15787,108349,0.8728249661661404,17.698288,2286.444048,14.539197827226813,128,9.90000000000002E-4
10,test_20231101_135347,11551286.png,271883,267,271616,0.9990179599312939,1,4,40092,37,40055,0.9990771226179787,18.016108444444445,1877.54488,15.394900338849709,128,9.90000000000002E-4
1,test_20231101_135347,10404007.png,502730,17447,485283,0.9652954866429296,2,4,61265,2534,58731,0.9586387007263527,26.03058311111111,3527.0062986666667,12.656741256195492,129,0.0
2,test_20231101_135347,1254659.png,342646,67202,275444,0.8038733853598174,4,4,80080,9440,70640,0.8821178821178821,21.685260444444445,3425.6872266666664,12.78332652540119,129,0.0
3,test_20231101_135347,10188041.png,221231,8907,212324,0.9597389154322857,2,3,41731,1262,40469,0.9697586925786585,10.89088711111111,1117.198944,17.64949844343051,129,0.0
4,test_20231101_135347,10287332.png,216980,11792,205188,0.945653977325099,2,4,22337,1617,20720,0.9276089000313381,9.499649777777778,803.2418826666667,19.082340154783257,129,0.0
5,test_20231101_135347,11610969.png,368720,22372,346348,0.9393252332393144,2,4,84111,3270,80841,0.9611228020116275,22.074186666666666,3125.7853333333333,13.18121211800863,129,0.0
6,test_20231101_135347,10350842.png,212614,5359,207255,0.9747946983735785,1,4,42529,788,41741,0.9814714665287215,19.497994666666667,2427.775552,14.27871827160568,129,0.0
7,test_20231101_135347,10863862.png,317432,9932,307500,0.9687114090576879,2,3,66058,1452,64606,0.9780193163583517,25.005619555555555,3556.4882826666667,12.620589786737968,129,0.0
8,test_20231101_135347,11382381.png,312486,827,311659,0.9973534814359684,1,3,46745,113,46632,0.9975826291581987,20.486714666666668,2360.4332106666666,14.400886444502593,129,0.0
9,test_20231101_135347,11079715.png,443815,110349,333466,0.7513626173067607,4,4,124136,15456,108680,0.8754913965328349,17.57312,2279.878944,14.551685732308561,129,0.0
10,test_20231101_135347,11551286.png,271883,917,270966,0.9966272256816351,1,3,40092,134,39958,0.9966576873191659,15.950851555555555,1533.329888,16.274447597479135,129,0.0
1,test_20231101_135348,10404007.png,502730,17447,485283,0.9652954866429296,3,3,61265,2534,58731,0.9586387007263527,26.03058311111111,3527.0062986666667,12.656741256195492,129,1.0E-5
2,test_20231101_135348,1254659.png,342646,67202,275444,0.8038733853598174,4,4,80080,9440,70640,0.8821178821178821,21.685260444444445,3425.6872266666664,12.78332652540119,129,1.0E-5
3,test_20231101_135348,10188041.png,221231,8907,212324,0.9597389154322857,2,3,41731,1262,40469,0.9697586925786585,10.89088711111111,1117.198944,17.64949844343051,129,1.0E-5
4,test_20231101_135348,10287332.png,216980,11792,205188,0.945653977325099,1,3,22337,1617,20720,0.9276089000313381,9.499649777777778,803.2418826666667,19.082340154783257,129,1.0E-5
5,test_20231101_135348,11610969.png,368720,22372,346348,0.9393252332393144,2,3,84111,3270,80841,0.9611228020116275,22.074186666666666,3125.7853333333333,13.18121211800863,129,1.0E-5
6,test_20231101_135348,10350842.png,212614,5359,207255,0.9747946983735785,2,4,42529,788,41741,0.9814714665287215,19.497994666666667,2427.775552,14.27871827160568,129,1.0E-5
7,test_20231101_135348,10863862.png,317432,9932,307500,0.9687114090576879,2,4,66058,1452,64606,0.9780193163583517,25.005619555555555,3556.4882826666667,12.620589786737968,129,1.0E-5
8,test_20231101_135348,11382381.png,312486,827,311659,0.9973534814359684,2,4,46745,113,46632,0.9975826291581987,20.486714666666668,2360.4332106666666,14.400886444502593,129,1.0E-5
9,test_20231101_135348,11079715.png,443815,110349,333466,0.7513626173067607,3,5,124136,15456,108680,0.8754913965328349,17.57312,2279.878944,14.551685732308561,129,1.0E-5
10,test_20231101_135348,11551286.png,271883,917,270966,0.9966272256816351,1,4,40092,134,39958,0.9966576873191659,15.950851555555555,1533.329888,16.274447597479135,129,1.0E-5
1,test_20231101_135349,10404007.png,502730,17447,485283,0.9652954866429296,3,3,61265,2534,58731,0.9586387007263527,26.03058311111111,3527.0062986666667,12.656741256195492,129,2.0E-5
2,test_20231101_135349,1254659.png,342646,67202,275444,0.8038733853598174,2,4,80080,9440,70640,0.8821178821178821,21.685260444444445,3425.6872266666664,12.78332652540119,129,2.0E-5
3,test_20231101_135349,10188041.png,221231,8907,212324,0.9597389154322857,2,4,41731,1262,40469,0.9697586925786585,10.89088711111111,1117.198944,17.64949844343051,129,2.0E-5
4,test_20231101_135349,10287332.png,216980,11792,205188,0.945653977325099,2,3,22337,1617,20720,0.9276089000313381,9.499649777777778,803.2418826666667,19.082340154783257,129,2.0E-5
5,test_20231101_135349,11610969.png,368720,22372,346348,0.9393252332393144,2,4,84111,3270,80841,0.9611228020116275,22.074186666666666,3125.7853333333333,13.18121211800863,129,2.0E-5
6,test_20231101_135349,10350842.png,212614,5359,207255,0.9747946983735785,2,4,42529,788,41741,0.9814714665287215,19.497994666666667,2427.775552,14.27871827160568,129,2.0E-5
7,test_20231101_135349,10863862.png,317432,7622,309810,0.9759885581793896,1,4,66058,1113,64945,0.9831511701837778,35.65140977777778,6505.424832,9.998046977614175,129,2.0E-5
8,test_20231101_135349,11382381.png,312486,827,311659,0.9973534814359684,2,4,46745,113,46632,0.9975826291581987,20.486714666666668,2360.4332106666666,14.400886444502593,129,2.0E-5
9,test_20231101_135349,11079715.png,443815,110349,333466,0.7513626173067607,3,4,124136,15456,108680,0.8754913965328349,17.57312,2279.878944,14.551685732308561,129,2.0E-5
10,test_20231101_135349,11551286.png,271883,917,270966,0.9966272256816351,1,3,40092,134,39958,0.9966576873191659,15.950851555555555,1533.329888,16.274447597479135,129,2.0E-5
1,test_20231101_135350,10404007.png,502730,17447,485283,0.9652954866429296,2,4,61265,2534,58731,0.9586387007263527,26.03058311111111,3527.0062986666667,12.656741256195492,129,3.0000000000000004E-5
2,test_20231101_135350,1254659.png,342646,67202,275444,0.8038733853598174,2,4,80080,9440,70640,0.8821178821178821,21.685260444444445,3425.6872266666664,12.78332652540119,129,3.0000000000000004E-5
3,test_20231101_135350,10188041.png,221231,8907,212324,0.9597389154322857,2,3,41731,1262,40469,0.9697586925786585,10.89088711111111,1117.198944,17.64949844343051,129,3.0000000000000004E-5
4,test_20231101_135350,10287332.png,216980,11792,205188,0.945653977325099,2,3,22337,1617,20720,0.9276089000313381,9.499649777777778,803.2418826666667,19.082340154783257,129,3.0000000000000004E-5
5,test_20231101_135350,11610969.png,368720,22372,346348,0.9393252332393144,2,5,84111,3270,80841,0.9611228020116275,22.074186666666666,3125.7853333333333,13.18121211800863,129,3.0000000000000004E-5
6,test_20231101_135350,10350842.png,212614,5359,207255,0.9747946983735785,1,4,42529,788,41741,0.9814714665287215,19.497994666666667,2427.775552,14.27871827160568,129,3.0000000000000004E-5
7,test_20231101_135350,10863862.png,317432,7622,309810,0.9759885581793896,2,4,66058,1113,64945,0.9831511701837778,35.65140977777778,6505.424832,9.998046977614175,129,3.0000000000000004E-5
8,test_20231101_135350,11382381.png,312486,827,311659,0.9973534814359684,1,3,46745,113,46632,0.9975826291581987,20.486714666666668,2360.4332106666666,14.400886444502593,129,3.0000000000000004E-5
9,test_20231101_135350,11079715.png,443815,110349,333466,0.7513626173067607,4,4,124136,15456,108680,0.8754913965328349,17.57312,2279.878944,14.551685732308561,129,3.0000000000000004E-5
10,test_20231101_135350,11551286.png,271883,917,270966,0.9966272256816351,1,3,40092,134,39958,0.9966576873191659,15.950851555555555,1533.329888,16.274447597479135,129,3.0000000000000004E-5
1,test_20231101_135350,10404007.png,502730,17447,485283,0.9652954866429296,3,3,61265,2534,58731,0.9586387007263527,26.03058311111111,3527.0062986666667,12.656741256195492,129,4.0E-5
2,test_20231101_135350,1254659.png,342646,67202,275444,0.8038733853598174,4,4,80080,9440,70640,0.8821178821178821,21.685260444444445,3425.6872266666664,12.78332652540119,129,4.0E-5
3,test_20231101_135350,10188041.png,221231,8907,212324,0.9597389154322857,2,4,41731,1262,40469,0.9697586925786585,10.89088711111111,1117.198944,17.64949844343051,129,4.0E-5
4,test_20231101_135350,10287332.png,216980,11792,205188,0.945653977325099,2,4,22337,1617,20720,0.9276089000313381,9.499649777777778,803.2418826666667,19.082340154783257,129,4.0E-5
5,test_20231101_135350,11610969.png,368720,22372,346348,0.9393252332393144,2,4,84111,3270,80841,0.9611228020116275,22.074186666666666,3125.7853333333333,13.18121211800863,129,4.0E-5
6,test_20231101_135350,10350842.png,212614,5359,207255,0.9747946983735785,2,4,42529,788,41741,0.9814714665287215,19.497994666666667,2427.775552,14.27871827160568,129,4.0E-5
7,test_20231101_135350,10863862.png,317432,7622,309810,0.9759885581793896,2,4,66058,1113,64945,0.9831511701837778,35.65140977777778,6505.424832,9.998046977614175,129,4.0E-5
8,test_20231101_135350,11382381.png,312486,827,311659,0.9973534814359684,2,3,46745,113,46632,0.9975826291581987,20.486714666666668,2360.4332106666666,14.400886444502593,129,4.0E-5
9,test_20231101_135350,11079715.png,443815,110349,333466,0.7513626173067607,4,5,124136,15456,108680,0.8754913965328349,17.57312,2279.878944,14.551685732308561,129,4.0E-5
10,test_20231101_135350,11551286.png,271883,917,270966,0.9966272256816351,1,4,40092,134,39958,0.9966576873191659,15.950851555555555,1533.329888,16.274447597479135,129,4.0E-5
1,test_20231101_135351,10404007.png,502730,17447,485283,0.9652954866429296,3,4,61265,2534,58731,0.9586387007263527,26.03058311111111,3527.0062986666667,12.656741256195492,129,5.0E-5
2,test_20231101_135351,1254659.png,342646,67202,275444,0.8038733853598174,3,4,80080,9440,70640,0.8821178821178821,21.685260444444445,3425.6872266666664,12.78332652540119,129,5.0E-5
3,test_20231101_135351,10188041.png,221231,8907,212324,0.9597389154322857,2,3,41731,1262,40469,0.9697586925786585,10.89088711111111,1117.198944,17.64949844343051,129,5.0E-5
4,test_20231101_135351,10287332.png,216980,11792,205188,0.945653977325099,2,4,22337,1617,20720,0.9276089000313381,9.499649777777778,803.2418826666667,19.082340154783257,129,5.0E-5
5,test_20231101_135351,11610969.png,368720,22372,346348,0.9393252332393144,2,4,84111,3270,80841,0.9611228020116275,22.074186666666666,3125.7853333333333,13.18121211800863,129,5.0E-5
6,test_20231101_135351,10350842.png,212614,5359,207255,0.9747946983735785,2,4,42529,788,41741,0.9814714665287215,19.497994666666667,2427.775552,14.27871827160568,129,5.0E-5
7,test_20231101_135351,10863862.png,317432,7622,309810,0.9759885581793896,2,4,66058,1113,64945,0.9831511701837778,35.65140977777778,6505.424832,9.998046977614175,129,5.0E-5
8,test_20231101_135351,11382381.png,312486,817,311669,0.9973854828696326,1,4,46745,112,46633,0.9976040218205156,21.216531555555555,2458.9940213333334,14.223228880483061,129,5.0E-5
9,test_20231101_135351,11079715.png,443815,110349,333466,0.7513626173067607,3,9,124136,15456,108680,0.8754913965328349,17.57312,2279.878944,14.551685732308561,129,5.0E-5
10,test_20231101_135351,11551286.png,271883,917,270966,0.9966272256816351,2,4,40092,134,39958,0.9966576873191659,15.950851555555555,1533.329888,16.274447597479135,129,5.0E-5
1,test_20231101_135352,10404007.png,502730,17447,485283,0.9652954866429296,2,4,61265,2534,58731,0.9586387007263527,26.03058311111111,3527.0062986666667,12.656741256195492,129,6.0E-5
2,test_20231101_135352,1254659.png,342646,67202,275444,0.8038733853598174,3,4,80080,9440,70640,0.8821178821178821,21.685260444444445,3425.6872266666664,12.78332652540119,129,6.0E-5
3,test_20231101_135352,10188041.png,221231,8907,212324,0.9597389154322857,2,4,41731,1262,40469,0.9697586925786585,10.89088711111111,1117.198944,17.64949844343051,129,6.0E-5
4,test_20231101_135352,10287332.png,216980,11792,205188,0.945653977325099,2,3,22337,1617,20720,0.9276089000313381,9.499649777777778,803.2418826666667,19.082340154783257,129,6.0E-5
5,test_20231101_135352,11610969.png,368720,22372,346348,0.9393252332393144,3,4,84111,3270,80841,0.9611228020116275,22.074186666666666,3125.7853333333333,13.18121211800863,129,6.0E-5
6,test_20231101_135352,10350842.png,212614,5359,207255,0.9747946983735785,1,4,42529,788,41741,0.9814714665287215,19.497994666666667,2427.775552,14.27871827160568,129,6.0E-5
7,test_20231101_135352,10863862.png,317432,7622,309810,0.9759885581793896,2,4,66058,1113,64945,0.9831511701837778,35.65140977777778,6505.424832,9.998046977614175,129,6.0E-5
8,test_20231101_135352,11382381.png,312486,817,311669,0.9973854828696326,2,3,46745,112,46633,0.9976040218205156,21.216531555555555,2458.9940213333334,14.223228880483061,129,6.0E-5
9,test_20231101_135352,11079715.png,443815,110349,333466,0.7513626173067607,4,4,124136,15456,108680,0.8754913965328349,17.57312,2279.878944,14.551685732308561,129,6.0E-5
10,test_20231101_135352,11551286.png,271883,917,270966,0.9966272256816351,2,12,40092,134,39958,0.9966576873191659,15.950851555555555,1533.329888,16.274447597479135,129,6.0E-5
1,test_20231101_135353,10404007.png,502730,17207,485523,0.9657728800747917,2,4,61265,2499,58766,0.9592099893903534,26.117214222222223,3546.187088,12.633187167032132,129,7.000000000000001E-5
2,test_20231101_135353,1254659.png,342646,67202,275444,0.8038733853598174,3,4,80080,9440,70640,0.8821178821178821,21.685260444444445,3425.6872266666664,12.78332652540119,129,7.000000000000001E-5
3,test_20231101_135353,10188041.png,221231,8907,212324,0.9597389154322857,2,4,41731,1262,40469,0.9697586925786585,10.89088711111111,1117.198944,17.64949844343051,129,7.000000000000001E-5
4,test_20231101_135353,10287332.png,216980,11792,205188,0.945653977325099,5,4,22337,1617,20720,0.9276089000313381,9.499649777777778,803.2418826666667,19.082340154783257,129,7.000000000000001E-5
5,test_20231101_135353,11610969.png,368720,22372,346348,0.9393252332393144,2,3,84111,3270,80841,0.9611228020116275,22.074186666666666,3125.7853333333333,13.18121211800863,129,7.000000000000001E-5
6,test_20231101_135353,10350842.png,212614,5359,207255,0.9747946983735785,1,3,42529,788,41741,0.9814714665287215,19.497994666666667,2427.775552,14.27871827160568,129,7.000000000000001E-5
7,test_20231101_135353,10863862.png,317432,7622,309810,0.9759885581793896,2,4,66058,1113,64945,0.9831511701837778,35.65140977777778,6505.424832,9.998046977614175,129,7.000000000000001E-5
8,test_20231101_135353,11382381.png,312486,817,311669,0.9973854828696326,2,4,46745,112,46633,0.9976040218205156,21.216531555555555,2458.9940213333334,14.223228880483061,129,7.000000000000001E-5
9,test_20231101_135353,11079715.png,443815,110349,333466,0.7513626173067607,3,4,124136,15456,108680,0.8754913965328349,17.57312,2279.878944,14.551685732308561,129,7.000000000000001E-5
10,test_20231101_135353,11551286.png,271883,737,271146,0.9972892751661561,1,4,40092,107,39985,0.997331138381722,16.330346666666667,1599.3003733333333,16.09150322243563,129,7.000000000000001E-5
1,test_20231101_135353,10404007.png,502730,17207,485523,0.9657728800747917,2,4,61265,2499,58766,0.9592099893903534,26.117214222222223,3546.187088,12.633187167032132,129,8.0E-5
2,test_20231101_135353,1254659.png,342646,67202,275444,0.8038733853598174,3,4,80080,9440,70640,0.8821178821178821,21.685260444444445,3425.6872266666664,12.78332652540119,129,8.0E-5
3,test_20231101_135353,10188041.png,221231,8907,212324,0.9597389154322857,2,4,41731,1262,40469,0.9697586925786585,10.89088711111111,1117.198944,17.64949844343051,129,8.0E-5
4,test_20231101_135353,10287332.png,216980,11792,205188,0.945653977325099,3,4,22337,1617,20720,0.9276089000313381,9.499649777777778,803.2418826666667,19.082340154783257,129,8.0E-5
5,test_20231101_135353,11610969.png,368720,22372,346348,0.9393252332393144,2,4,84111,3270,80841,0.9611228020116275,22.074186666666666,3125.7853333333333,13.18121211800863,129,8.0E-5
6,test_20231101_135353,10350842.png,212614,5359,207255,0.9747946983735785,2,3,42529,788,41741,0.9814714665287215,19.497994666666667,2427.775552,14.27871827160568,129,8.0E-5
7,test_20231101_135353,10863862.png,317432,7622,309810,0.9759885581793896,5,4,66058,1113,64945,0.9831511701837778,35.65140977777778,6505.424832,9.998046977614175,129,8.0E-5
8,test_20231101_135353,11382381.png,312486,817,311669,0.9973854828696326,1,3,46745,112,46633,0.9976040218205156,21.216531555555555,2458.9940213333334,14.223228880483061,129,8.0E-5
9,test_20231101_135353,11079715.png,443815,110349,333466,0.7513626173067607,3,4,124136,15456,108680,0.8754913965328349,17.57312,2279.878944,14.551685732308561,129,8.0E-5
10,test_20231101_135353,11551286.png,271883,737,271146,0.9972892751661561,2,4,40092,107,39985,0.997331138381722,16.330346666666667,1599.3003733333333,16.09150322243563,129,8.0E-5
1,test_20231101_135354,10404007.png,502730,17207,485523,0.9657728800747917,2,14,61265,2499,58766,0.9592099893903534,26.117214222222223,3546.187088,12.633187167032132,129,9.0E-5
2,test_20231101_135354,1254659.png,342646,67202,275444,0.8038733853598174,4,5,80080,9440,70640,0.8821178821178821,21.685260444444445,3425.6872266666664,12.78332652540119,129,9.0E-5
3,test_20231101_135354,10188041.png,221231,8907,212324,0.9597389154322857,2,4,41731,1262,40469,0.9697586925786585,10.89088711111111,1117.198944,17.64949844343051,129,9.0E-5
4,test_20231101_135354,10287332.png,216980,11792,205188,0.945653977325099,2,4,22337,1617,20720,0.9276089000313381,9.499649777777778,803.2418826666667,19.082340154783257,129,9.0E-5
5,test_20231101_135354,11610969.png,368720,22372,346348,0.9393252332393144,3,4,84111,3270,80841,0.9611228020116275,22.074186666666666,3125.7853333333333,13.18121211800863,129,9.0E-5
6,test_20231101_135354,10350842.png,212614,5359,207255,0.9747946983735785,1,3,42529,788,41741,0.9814714665287215,19.497994666666667,2427.775552,14.27871827160568,129,9.0E-5
7,test_20231101_135354,10863862.png,317432,7622,309810,0.9759885581793896,1,4,66058,1113,64945,0.9831511701837778,35.65140977777778,6505.424832,9.998046977614175,129,9.0E-5
8,test_20231101_135354,11382381.png,312486,817,311669,0.9973854828696326,1,3,46745,112,46633,0.9976040218205156,21.216531555555555,2458.9940213333334,14.223228880483061,129,9.0E-5
9,test_20231101_135354,11079715.png,443815,110349,333466,0.7513626173067607,3,5,124136,15456,108680,0.8754913965328349,17.57312,2279.878944,14.551685732308561,129,9.0E-5
10,test_20231101_135354,11551286.png,271883,737,271146,0.9972892751661561,2,3,40092,107,39985,0.997331138381722,16.330346666666667,1599.3003733333333,16.09150322243563,129,9.0E-5
1,test_20231101_135355,10404007.png,502730,17207,485523,0.9657728800747917,2,3,61265,2499,58766,0.9592099893903534,26.117214222222223,3546.187088,12.633187167032132,129,1.0E-4
2,test_20231101_135355,1254659.png,342646,67202,275444,0.8038733853598174,3,4,80080,9440,70640,0.8821178821178821,21.685260444444445,3425.6872266666664,12.78332652540119,129,1.0E-4
3,test_20231101_135355,10188041.png,221231,8907,212324,0.9597389154322857,2,4,41731,1262,40469,0.9697586925786585,10.89088711111111,1117.198944,17.64949844343051,129,1.0E-4
4,test_20231101_135355,10287332.png,216980,11792,205188,0.945653977325099,2,4,22337,1617,20720,0.9276089000313381,9.499649777777778,803.2418826666667,19.082340154783257,129,1.0E-4
5,test_20231101_135355,11610969.png,368720,22372,346348,0.9393252332393144,2,4,84111,3270,80841,0.9611228020116275,22.074186666666666,3125.7853333333333,13.18121211800863,129,1.0E-4
6,test_20231101_135355,10350842.png,212614,5359,207255,0.9747946983735785,1,4,42529,788,41741,0.9814714665287215,19.497994666666667,2427.775552,14.27871827160568,129,1.0E-4
7,test_20231101_135355,10863862.png,317432,7622,309810,0.9759885581793896,2,4,66058,1113,64945,0.9831511701837778,35.65140977777778,6505.424832,9.998046977614175,129,1.0E-4
8,test_20231101_135355,11382381.png,312486,817,311669,0.9973854828696326,1,5,46745,112,46633,0.9976040218205156,21.216531555555555,2458.9940213333334,14.223228880483061,129,1.0E-4
9,test_20231101_135355,11079715.png,443815,110349,333466,0.7513626173067607,3,4,124136,15456,108680,0.8754913965328349,17.57312,2279.878944,14.551685732308561,129,1.0E-4
10,test_20231101_135355,11551286.png,271883,737,271146,0.9972892751661561,1,4,40092,107,39985,0.997331138381722,16.330346666666667,1599.3003733333333,16.09150322243563,129,1.0E-4
1,test_20231101_135355,10404007.png,502730,17207,485523,0.9657728800747917,2,4,61265,2499,58766,0.9592099893903534,26.117214222222223,3546.187088,12.633187167032132,129,1.1E-4
2,test_20231101_135355,1254659.png,342646,67202,275444,0.8038733853598174,3,4,80080,9440,70640,0.8821178821178821,21.685260444444445,3425.6872266666664,12.78332652540119,129,1.1E-4
3,test_20231101_135355,10188041.png,221231,8907,212324,0.9597389154322857,2,3,41731,1262,40469,0.9697586925786585,10.89088711111111,1117.198944,17.64949844343051,129,1.1E-4
4,test_20231101_135355,10287332.png,216980,11792,205188,0.945653977325099,2,4,22337,1617,20720,0.9276089000313381,9.499649777777778,803.2418826666667,19.082340154783257,129,1.1E-4
5,test_20231101_135355,11610969.png,368720,22372,346348,0.9393252332393144,3,4,84111,3270,80841,0.9611228020116275,22.074186666666666,3125.7853333333333,13.18121211800863,129,1.1E-4
6,test_20231101_135355,10350842.png,212614,5359,207255,0.9747946983735785,1,4,42529,788,41741,0.9814714665287215,19.497994666666667,2427.775552,14.27871827160568,129,1.1E-4
7,test_20231101_135355,10863862.png,317432,7622,309810,0.9759885581793896,1,3,66058,1113,64945,0.9831511701837778,35.65140977777778,6505.424832,9.998046977614175,129,1.1E-4
8,test_20231101_135355,11382381.png,312486,817,311669,0.9973854828696326,2,4,46745,112,46633,0.9976040218205156,21.216531555555555,2458.9940213333334,14.223228880483061,129,1.1E-4
9,test_20231101_135355,11079715.png,443815,110349,333466,0.7513626173067607,3,4,124136,15456,108680,0.8754913965328349,17.57312,2279.878944,14.551685732308561,129,1.1E-4
10,test_20231101_135355,11551286.png,271883,737,271146,0.9972892751661561,2,4,40092,107,39985,0.997331138381722,16.330346666666667,1599.3003733333333,16.09150322243563,129,1.1E-4
1,test_20231101_135356,10404007.png,502730,17207,485523,0.9657728800747917,2,4,61265,2499,58766,0.9592099893903534,26.117214222222223,3546.187088,12.633187167032132,129,1.2E-4
2,test_20231101_135356,1254659.png,342646,67202,275444,0.8038733853598174,3,4,80080,9440,70640,0.8821178821178821,21.685260444444445,3425.6872266666664,12.78332652540119,129,1.2E-4
3,test_20231101_135356,10188041.png,221231,8907,212324,0.9597389154322857,6,3,41731,1262,40469,0.9697586925786585,10.89088711111111,1117.198944,17.64949844343051,129,1.2E-4
4,test_20231101_135356,10287332.png,216980,11792,205188,0.945653977325099,2,4,22337,1617,20720,0.9276089000313381,9.499649777777778,803.2418826666667,19.082340154783257,129,1.2E-4
5,test_20231101_135356,11610969.png,368720,22372,346348,0.9393252332393144,2,3,84111,3270,80841,0.9611228020116275,22.074186666666666,3125.7853333333333,13.18121211800863,129,1.2E-4
6,test_20231101_135356,10350842.png,212614,5359,207255,0.9747946983735785,2,4,42529,788,41741,0.9814714665287215,19.497994666666667,2427.775552,14.27871827160568,129,1.2E-4
7,test_20231101_135356,10863862.png,317432,7622,309810,0.9759885581793896,2,4,66058,1113,64945,0.9831511701837778,35.65140977777778,6505.424832,9.998046977614175,129,1.2E-4
8,test_20231101_135356,11382381.png,312486,817,311669,0.9973854828696326,1,3,46745,112,46633,0.9976040218205156,21.216531555555555,2458.9940213333334,14.223228880483061,129,1.2E-4
9,test_20231101_135356,11079715.png,443815,110349,333466,0.7513626173067607,3,4,124136,15456,108680,0.8754913965328349,17.57312,2279.878944,14.551685732308561,129,1.2E-4
10,test_20231101_135356,11551286.png,271883,737,271146,0.9972892751661561,2,4,40092,107,39985,0.997331138381722,16.330346666666667,1599.3003733333333,16.09150322243563,129,1.2E-4
1,test_20231101_135357,10404007.png,502730,17207,485523,0.9657728800747917,2,4,61265,2499,58766,0.9592099893903534,26.117214222222223,3546.187088,12.633187167032132,129,1.3000000000000002E-4
2,test_20231101_135357,1254659.png,342646,67202,275444,0.8038733853598174,3,4,80080,9440,70640,0.8821178821178821,21.685260444444445,3425.6872266666664,12.78332652540119,129,1.3000000000000002E-4
3,test_20231101_135357,10188041.png,221231,8907,212324,0.9597389154322857,2,3,41731,1262,40469,0.9697586925786585,10.89088711111111,1117.198944,17.64949844343051,129,1.3000000000000002E-4
4,test_20231101_135357,10287332.png,216980,11792,205188,0.945653977325099,1,3,22337,1617,20720,0.9276089000313381,9.499649777777778,803.2418826666667,19.082340154783257,129,1.3000000000000002E-4
5,test_20231101_135357,11610969.png,368720,22372,346348,0.9393252332393144,2,4,84111,3270,80841,0.9611228020116275,22.074186666666666,3125.7853333333333,13.18121211800863,129,1.3000000000000002E-4
6,test_20231101_135357,10350842.png,212614,5359,207255,0.9747946983735785,1,3,42529,788,41741,0.9814714665287215,19.497994666666667,2427.775552,14.27871827160568,129,1.3000000000000002E-4
7,test_20231101_135357,10863862.png,317432,7622,309810,0.9759885581793896,2,3,66058,1113,64945,0.9831511701837778,35.65140977777778,6505.424832,9.998046977614175,129,1.3000000000000002E-4
8,test_20231101_135357,11382381.png,312486,817,311669,0.9973854828696326,2,3,46745,112,46633,0.9976040218205156,21.216531555555555,2458.9940213333334,14.223228880483061,129,1.3000000000000002E-4
9,test_20231101_135357,11079715.png,443815,110349,333466,0.7513626173067607,3,4,124136,15456,108680,0.8754913965328349,17.57312,2279.878944,14.551685732308561,129,1.3000000000000002E-4
10,test_20231101_135357,11551286.png,271883,717,271166,0.9973628362199917,1,4,40092,104,39988,0.9974059662775616,17.035560888888888,1719.2356853333333,15.777449438530502,129,1.3000000000000002E-4
1,test_20231101_135358,10404007.png,502730,17207,485523,0.9657728800747917,2,3,61265,2499,58766,0.9592099893903534,26.117214222222223,3546.187088,12.633187167032132,129,1.4000000000000001E-4
2,test_20231101_135358,1254659.png,342646,67202,275444,0.8038733853598174,3,4,80080,9440,70640,0.8821178821178821,21.685260444444445,3425.6872266666664,12.78332652540119,129,1.4000000000000001E-4
3,test_20231101_135358,10188041.png,221231,8907,212324,0.9597389154322857,2,4,41731,1262,40469,0.9697586925786585,10.89088711111111,1117.198944,17.64949844343051,129,1.4000000000000001E-4
4,test_20231101_135358,10287332.png,216980,11792,205188,0.945653977325099,2,4,22337,1617,20720,0.9276089000313381,9.499649777777778,803.2418826666667,19.082340154783257,129,1.4000000000000001E-4
5,test_20231101_135358,11610969.png,368720,22372,346348,0.9393252332393144,2,4,84111,3270,80841,0.9611228020116275,22.074186666666666,3125.7853333333333,13.18121211800863,129,1.4000000000000001E-4
6,test_20231101_135358,10350842.png,212614,5359,207255,0.9747946983735785,1,3,42529,788,41741,0.9814714665287215,19.497994666666667,2427.775552,14.27871827160568,129,1.4000000000000001E-4
7,test_20231101_135358,10863862.png,317432,7622,309810,0.9759885581793896,1,4,66058,1113,64945,0.9831511701837778,35.65140977777778,6505.424832,9.998046977614175,129,1.4000000000000001E-4
8,test_20231101_135358,11382381.png,312486,817,311669,0.9973854828696326,1,4,46745,112,46633,0.9976040218205156,21.216531555555555,2458.9940213333334,14.223228880483061,129,1.4000000000000001E-4
9,test_20231101_135358,11079715.png,443815,110349,333466,0.7513626173067607,3,5,124136,15456,108680,0.8754913965328349,17.57312,2279.878944,14.551685732308561,129,1.4000000000000001E-4
10,test_20231101_135358,11551286.png,271883,717,271166,0.9973628362199917,1,4,40092,104,39988,0.9974059662775616,17.035560888888888,1719.2356853333333,15.777449438530502,129,1.4000000000000001E-4
1,test_20231101_135358,10404007.png,502730,17207,485523,0.9657728800747917,2,3,61265,2499,58766,0.9592099893903534,26.117214222222223,3546.187088,12.633187167032132,129,1.5000000000000001E-4
2,test_20231101_135358,1254659.png,342646,67202,275444,0.8038733853598174,2,4,80080,9440,70640,0.8821178821178821,21.685260444444445,3425.6872266666664,12.78332652540119,129,1.5000000000000001E-4
3,test_20231101_135358,10188041.png,221231,8907,212324,0.9597389154322857,2,3,41731,1262,40469,0.9697586925786585,10.89088711111111,1117.198944,17.64949844343051,129,1.5000000000000001E-4
4,test_20231101_135358,10287332.png,216980,11792,205188,0.945653977325099,2,13,22337,1617,20720,0.9276089000313381,9.499649777777778,803.2418826666667,19.082340154783257,129,1.5000000000000001E-4
5,test_20231101_135358,11610969.png,368720,22372,346348,0.9393252332393144,2,4,84111,3270,80841,0.9611228020116275,22.074186666666666,3125.7853333333333,13.18121211800863,129,1.5000000000000001E-4
6,test_20231101_135358,10350842.png,212614,5359,207255,0.9747946983735785,2,3,42529,788,41741,0.9814714665287215,19.497994666666667,2427.775552,14.27871827160568,129,1.5000000000000001E-4
7,test_20231101_135358,10863862.png,317432,7622,309810,0.9759885581793896,2,4,66058,1113,64945,0.9831511701837778,35.65140977777778,6505.424832,9.998046977614175,129,1.5000000000000001E-4
8,test_20231101_135358,11382381.png,312486,707,311779,0.9977374986399391,2,4,46745,96,46649,0.9979463044175848,21.47300977777778,2499.126186666667,14.152921756540431,129,1.5000000000000001E-4
9,test_20231101_135358,11079715.png,443815,110349,333466,0.7513626173067607,4,4,124136,15456,108680,0.8754913965328349,17.57312,2279.878944,14.551685732308561,129,1.5000000000000001E-4
10,test_20231101_135358,11551286.png,271883,717,271166,0.9973628362199917,1,4,40092,104,39988,0.9974059662775616,17.035560888888888,1719.2356853333333,15.777449438530502,129,1.5000000000000001E-4
1,test_20231101_135359,10404007.png,502730,17207,485523,0.9657728800747917,2,4,61265,2499,58766,0.9592099893903534,26.117214222222223,3546.187088,12.633187167032132,129,1.6E-4
2,test_20231101_135359,1254659.png,342646,67202,275444,0.8038733853598174,2,4,80080,9440,70640,0.8821178821178821,21.685260444444445,3425.6872266666664,12.78332652540119,129,1.6E-4
3,test_20231101_135359,10188041.png,221231,8907,212324,0.9597389154322857,2,3,41731,1262,40469,0.9697586925786585,10.89088711111111,1117.198944,17.64949844343051,129,1.6E-4
4,test_20231101_135359,10287332.png,216980,11579,205401,0.9466356346207023,1,3,22337,1590,20747,0.9288176568026145,9.629411555555556,829.9726293333333,18.940165903297878,129,1.6E-4
5,test_20231101_135359,11610969.png,368720,22372,346348,0.9393252332393144,2,4,84111,3270,80841,0.9611228020116275,22.074186666666666,3125.7853333333333,13.18121211800863,129,1.6E-4
6,test_20231101_135359,10350842.png,212614,5359,207255,0.9747946983735785,1,4,42529,788,41741,0.9814714665287215,19.497994666666667,2427.775552,14.27871827160568,129,1.6E-4
7,test_20231101_135359,10863862.png,317432,7622,309810,0.9759885581793896,2,4,66058,1113,64945,0.9831511701837778,35.65140977777778,6505.424832,9.998046977614175,129,1.6E-4
8,test_20231101_135359,11382381.png,312486,707,311779,0.9977374986399391,1,3,46745,96,46649,0.9979463044175848,21.47300977777778,2499.126186666667,14.152921756540431,129,1.6E-4
9,test_20231101_135359,11079715.png,443815,110349,333466,0.7513626173067607,3,4,124136,15456,108680,0.8754913965328349,17.57312,2279.878944,14.551685732308561,129,1.6E-4
10,test_20231101_135359,11551286.png,271883,717,271166,0.9973628362199917,1,4,40092,104,39988,0.9974059662775616,17.035560888888888,1719.2356853333333,15.777449438530502,129,1.6E-4
1,test_20231101_135400,10404007.png,502730,17207,485523,0.9657728800747917,2,4,61265,2499,58766,0.9592099893903534,26.117214222222223,3546.187088,12.633187167032132,129,1.7E-4
2,test_20231101_135400,1254659.png,342646,67202,275444,0.8038733853598174,3,4,80080,9440,70640,0.8821178821178821,21.685260444444445,3425.6872266666664,12.78332652540119,129,1.7E-4
3,test_20231101_135400,10188041.png,221231,8907,212324,0.9597389154322857,2,4,41731,1262,40469,0.9697586925786585,10.89088711111111,1117.198944,17.64949844343051,129,1.7E-4
4,test_20231101_135400,10287332.png,216980,11579,205401,0.9466356346207023,2,3,22337,1590,20747,0.9288176568026145,9.629411555555556,829.9726293333333,18.940165903297878,129,1.7E-4
5,test_20231101_135400,11610969.png,368720,22372,346348,0.9393252332393144,3,4,84111,3270,80841,0.9611228020116275,22.074186666666666,3125.7853333333333,13.18121211800863,129,1.7E-4
6,test_20231101_135400,10350842.png,212614,5359,207255,0.9747946983735785,2,4,42529,788,41741,0.9814714665287215,19.497994666666667,2427.775552,14.27871827160568,129,1.7E-4
7,test_20231101_135400,10863862.png,317432,7622,309810,0.9759885581793896,2,4,66058,1113,64945,0.9831511701837778,35.65140977777778,6505.424832,9.998046977614175,129,1.7E-4
8,test_20231101_135400,11382381.png,312486,707,311779,0.9977374986399391,1,3,46745,96,46649,0.9979463044175848,21.47300977777778,2499.126186666667,14.152921756540431,129,1.7E-4
9,test_20231101_135400,11079715.png,443815,110349,333466,0.7513626173067607,4,4,124136,15456,108680,0.8754913965328349,17.57312,2279.878944,14.551685732308561,129,1.7E-4
10,test_20231101_135400,11551286.png,271883,717,271166,0.9973628362199917,2,4,40092,104,39988,0.9974059662775616,17.035560888888888,1719.2356853333333,15.777449438530502,129,1.7E-4
1,test_20231101_135400,10404007.png,502730,17207,485523,0.9657728800747917,2,4,61265,2499,58766,0.9592099893903534,26.117214222222223,3546.187088,12.633187167032132,129,1.8E-4
2,test_20231101_135400,1254659.png,342646,67202,275444,0.8038733853598174,3,4,80080,9440,70640,0.8821178821178821,21.685260444444445,3425.6872266666664,12.78332652540119,129,1.8E-4
3,test_20231101_135400,10188041.png,221231,8907,212324,0.9597389154322857,2,4,41731,1262,40469,0.9697586925786585,10.89088711111111,1117.198944,17.64949844343051,129,1.8E-4
4,test_20231101_135400,10287332.png,216980,11579,205401,0.9466356346207023,2,4,22337,1590,20747,0.9288176568026145,9.629411555555556,829.9726293333333,18.940165903297878,129,1.8E-4
5,test_20231101_135400,11610969.png,368720,22372,346348,0.9393252332393144,2,3,84111,3270,80841,0.9611228020116275,22.074186666666666,3125.7853333333333,13.18121211800863,129,1.8E-4
6,test_20231101_135400,10350842.png,212614,5359,207255,0.9747946983735785,2,4,42529,788,41741,0.9814714665287215,19.497994666666667,2427.775552,14.27871827160568,129,1.8E-4
7,test_20231101_135400,10863862.png,317432,7622,309810,0.9759885581793896,1,3,66058,1113,64945,0.9831511701837778,35.65140977777778,6505.424832,9.998046977614175,129,1.8E-4
8,test_20231101_135400,11382381.png,312486,707,311779,0.9977374986399391,2,3,46745,96,46649,0.9979463044175848,21.47300977777778,2499.126186666667,14.152921756540431,129,1.8E-4
9,test_20231101_135400,11079715.png,443815,110349,333466,0.7513626173067607,4,4,124136,15456,108680,0.8754913965328349,17.57312,2279.878944,14.551685732308561,129,1.8E-4
10,test_20231101_135400,11551286.png,271883,717,271166,0.9973628362199917,1,4,40092,104,39988,0.9974059662775616,17.035560888888888,1719.2356853333333,15.777449438530502,129,1.8E-4
1,test_20231101_135401,10404007.png,502730,17207,485523,0.9657728800747917,2,3,61265,2499,58766,0.9592099893903534,26.117214222222223,3546.187088,12.633187167032132,129,1.9E-4
2,test_20231101_135401,1254659.png,342646,67202,275444,0.8038733853598174,3,4,80080,9440,70640,0.8821178821178821,21.685260444444445,3425.6872266666664,12.78332652540119,129,1.9E-4
3,test_20231101_135401,10188041.png,221231,8907,212324,0.9597389154322857,2,4,41731,1262,40469,0.9697586925786585,10.89088711111111,1117.198944,17.64949844343051,129,1.9E-4
4,test_20231101_135401,10287332.png,216980,11579,205401,0.9466356346207023,1,3,22337,1590,20747,0.9288176568026145,9.629411555555556,829.9726293333333,18.940165903297878,129,1.9E-4
5,test_20231101_135401,11610969.png,368720,22372,346348,0.9393252332393144,2,4,84111,3270,80841,0.9611228020116275,22.074186666666666,3125.7853333333333,13.18121211800863,129,1.9E-4
6,test_20231101_135401,10350842.png,212614,5359,207255,0.9747946983735785,2,4,42529,788,41741,0.9814714665287215,19.497994666666667,2427.775552,14.27871827160568,129,1.9E-4
7,test_20231101_135401,10863862.png,317432,7622,309810,0.9759885581793896,2,4,66058,1113,64945,0.9831511701837778,35.65140977777778,6505.424832,9.998046977614175,129,1.9E-4
8,test_20231101_135401,11382381.png,312486,707,311779,0.9977374986399391,2,4,46745,96,46649,0.9979463044175848,21.47300977777778,2499.126186666667,14.152921756540431,129,1.9E-4
9,test_20231101_135401,11079715.png,443815,110349,333466,0.7513626173067607,3,4,124136,15456,108680,0.8754913965328349,17.57312,2279.878944,14.551685732308561,129,1.9E-4
10,test_20231101_135401,11551286.png,271883,717,271166,0.9973628362199917,2,3,40092,104,39988,0.9974059662775616,17.035560888888888,1719.2356853333333,15.777449438530502,129,1.9E-4
1,test_20231101_135402,10404007.png,502730,17207,485523,0.9657728800747917,2,3,61265,2499,58766,0.9592099893903534,26.117214222222223,3546.187088,12.633187167032132,129,2.0E-4
2,test_20231101_135402,1254659.png,342646,67202,275444,0.8038733853598174,2,4,80080,9440,70640,0.8821178821178821,21.685260444444445,3425.6872266666664,12.78332652540119,129,2.0E-4
3,test_20231101_135402,10188041.png,221231,8907,212324,0.9597389154322857,1,3,41731,1262,40469,0.9697586925786585,10.89088711111111,1117.198944,17.64949844343051,129,2.0E-4
4,test_20231101_135402,10287332.png,216980,11579,205401,0.9466356346207023,2,3,22337,1590,20747,0.9288176568026145,9.629411555555556,829.9726293333333,18.940165903297878,129,2.0E-4
5,test_20231101_135402,11610969.png,368720,22372,346348,0.9393252332393144,3,3,84111,3270,80841,0.9611228020116275,22.074186666666666,3125.7853333333333,13.18121211800863,129,2.0E-4
6,test_20231101_135402,10350842.png,212614,5359,207255,0.9747946983735785,1,3,42529,788,41741,0.9814714665287215,19.497994666666667,2427.775552,14.27871827160568,129,2.0E-4
7,test_20231101_135402,10863862.png,317432,7622,309810,0.9759885581793896,1,3,66058,1113,64945,0.9831511701837778,35.65140977777778,6505.424832,9.998046977614175,129,2.0E-4
8,test_20231101_135402,11382381.png,312486,707,311779,0.9977374986399391,2,3,46745,96,46649,0.9979463044175848,21.47300977777778,2499.126186666667,14.152921756540431,129,2.0E-4
9,test_20231101_135402,11079715.png,443815,110349,333466,0.7513626173067607,3,4,124136,15456,108680,0.8754913965328349,17.57312,2279.878944,14.551685732308561,129,2.0E-4
10,test_20231101_135402,11551286.png,271883,597,271286,0.9978042025430056,2,3,40092,86,40006,0.997854933652599,17.58564977777778,1815.0887466666666,15.541824966498465,129,2.0E-4
1,test_20231101_135402,10404007.png,502730,17207,485523,0.9657728800747917,2,4,61265,2499,58766,0.9592099893903534,26.117214222222223,3546.187088,12.633187167032132,129,2.1E-4
2,test_20231101_135402,1254659.png,342646,67202,275444,0.8038733853598174,2,3,80080,9440,70640,0.8821178821178821,21.685260444444445,3425.6872266666664,12.78332652540119,129,2.1E-4
3,test_20231101_135402,10188041.png,221231,8907,212324,0.9597389154322857,2,3,41731,1262,40469,0.9697586925786585,10.89088711111111,1117.198944,17.64949844343051,129,2.1E-4
4,test_20231101_135402,10287332.png,216980,11579,205401,0.9466356346207023,2,4,22337,1590,20747,0.9288176568026145,9.629411555555556,829.9726293333333,18.940165903297878,129,2.1E-4
5,test_20231101_135402,11610969.png,368720,22372,346348,0.9393252332393144,2,4,84111,3270,80841,0.9611228020116275,22.074186666666666,3125.7853333333333,13.18121211800863,129,2.1E-4
6,test_20231101_135402,10350842.png,212614,5359,207255,0.9747946983735785,1,11,42529,788,41741,0.9814714665287215,19.497994666666667,2427.775552,14.27871827160568,129,2.1E-4
7,test_20231101_135402,10863862.png,317432,7622,309810,0.9759885581793896,2,4,66058,1113,64945,0.9831511701837778,35.65140977777778,6505.424832,9.998046977614175,129,2.1E-4
8,test_20231101_135402,11382381.png,312486,707,311779,0.9977374986399391,1,3,46745,96,46649,0.9979463044175848,21.47300977777778,2499.126186666667,14.152921756540431,129,2.1E-4
9,test_20231101_135402,11079715.png,443815,110349,333466,0.7513626173067607,3,5,124136,15456,108680,0.8754913965328349,17.57312,2279.878944,14.551685732308561,129,2.1E-4
10,test_20231101_135402,11551286.png,271883,597,271286,0.9978042025430056,1,4,40092,86,40006,0.997854933652599,17.58564977777778,1815.0887466666666,15.541824966498465,129,2.1E-4
1,test_20231101_135403,10404007.png,502730,17207,485523,0.9657728800747917,3,3,61265,2499,58766,0.9592099893903534,26.117214222222223,3546.187088,12.633187167032132,129,2.2E-4
2,test_20231101_135403,1254659.png,342646,67202,275444,0.8038733853598174,3,4,80080,9440,70640,0.8821178821178821,21.685260444444445,3425.6872266666664,12.78332652540119,129,2.2E-4
3,test_20231101_135403,10188041.png,221231,8907,212324,0.9597389154322857,2,3,41731,1262,40469,0.9697586925786585,10.89088711111111,1117.198944,17.64949844343051,129,2.2E-4
4,test_20231101_135403,10287332.png,216980,11579,205401,0.9466356346207023,1,3,22337,1590,20747,0.9288176568026145,9.629411555555556,829.9726293333333,18.940165903297878,129,2.2E-4
5,test_20231101_135403,11610969.png,368720,22372,346348,0.9393252332393144,2,4,84111,3270,80841,0.9611228020116275,22.074186666666666,3125.7853333333333,13.18121211800863,129,2.2E-4
6,test_20231101_135403,10350842.png,212614,5359,207255,0.9747946983735785,2,7,42529,788,41741,0.9814714665287215,19.497994666666667,2427.775552,14.27871827160568,129,2.2E-4
7,test_20231101_135403,10863862.png,317432,7622,309810,0.9759885581793896,2,4,66058,1113,64945,0.9831511701837778,35.65140977777778,6505.424832,9.998046977614175,129,2.2E-4
8,test_20231101_135403,11382381.png,312486,707,311779,0.9977374986399391,2,4,46745,96,46649,0.9979463044175848,21.47300977777778,2499.126186666667,14.152921756540431,129,2.2E-4
9,test_20231101_135403,11079715.png,443815,110349,333466,0.7513626173067607,4,5,124136,15456,108680,0.8754913965328349,17.57312,2279.878944,14.551685732308561,129,2.2E-4
10,test_20231101_135403,11551286.png,271883,597,271286,0.9978042025430056,2,4,40092,86,40006,0.997854933652599,17.58564977777778,1815.0887466666666,15.541824966498465,129,2.2E-4
1,test_20231101_135404,10404007.png,502730,17207,485523,0.9657728800747917,3,4,61265,2499,58766,0.9592099893903534,26.117214222222223,3546.187088,12.633187167032132,129,2.3E-4
2,test_20231101_135404,1254659.png,342646,67202,275444,0.8038733853598174,3,3,80080,9440,70640,0.8821178821178821,21.685260444444445,3425.6872266666664,12.78332652540119,129,2.3E-4
3,test_20231101_135404,10188041.png,221231,8907,212324,0.9597389154322857,2,3,41731,1262,40469,0.9697586925786585,10.89088711111111,1117.198944,17.64949844343051,129,2.3E-4
4,test_20231101_135404,10287332.png,216980,11579,205401,0.9466356346207023,2,4,22337,1590,20747,0.9288176568026145,9.629411555555556,829.9726293333333,18.940165903297878,129,2.3E-4
5,test_20231101_135404,11610969.png,368720,22372,346348,0.9393252332393144,2,4,84111,3270,80841,0.9611228020116275,22.074186666666666,3125.7853333333333,13.18121211800863,129,2.3E-4
6,test_20231101_135404,10350842.png,212614,5359,207255,0.9747946983735785,1,4,42529,788,41741,0.9814714665287215,19.497994666666667,2427.775552,14.27871827160568,129,2.3E-4
7,test_20231101_135404,10863862.png,317432,7622,309810,0.9759885581793896,1,4,66058,1113,64945,0.9831511701837778,35.65140977777778,6505.424832,9.998046977614175,129,2.3E-4
8,test_20231101_135404,11382381.png,312486,707,311779,0.9977374986399391,1,4,46745,96,46649,0.9979463044175848,21.47300977777778,2499.126186666667,14.152921756540431,129,2.3E-4
9,test_20231101_135404,11079715.png,443815,110349,333466,0.7513626173067607,3,4,124136,15456,108680,0.8754913965328349,17.57312,2279.878944,14.551685732308561,129,2.3E-4
10,test_20231101_135404,11551286.png,271883,327,271556,0.998797276769787,1,4,40092,46,40046,0.99885263893046,17.867866666666668,1859.2518453333332,15.437421396648572,129,2.3E-4
1,test_20231101_135404,10404007.png,502730,17207,485523,0.9657728800747917,2,4,61265,2499,58766,0.9592099893903534,26.117214222222223,3546.187088,12.633187167032132,129,2.4E-4
2,test_20231101_135404,1254659.png,342646,67202,275444,0.8038733853598174,3,4,80080,9440,70640,0.8821178821178821,21.685260444444445,3425.6872266666664,12.78332652540119,129,2.4E-4
3,test_20231101_135404,10188041.png,221231,8907,212324,0.9597389154322857,2,4,41731,1262,40469,0.9697586925786585,10.89088711111111,1117.198944,17.64949844343051,129,2.4E-4
4,test_20231101_135404,10287332.png,216980,11579,205401,0.9466356346207023,2,3,22337,1590,20747,0.9288176568026145,9.629411555555556,829.9726293333333,18.940165903297878,129,2.4E-4
5,test_20231101_135404,11610969.png,368720,22372,346348,0.9393252332393144,2,4,84111,3270,80841,0.9611228020116275,22.074186666666666,3125.7853333333333,13.18121211800863,129,2.4E-4
6,test_20231101_135404,10350842.png,212614,5359,207255,0.9747946983735785,2,3,42529,788,41741,0.9814714665287215,19.497994666666667,2427.775552,14.27871827160568,129,2.4E-4
7,test_20231101_135404,10863862.png,317432,7622,309810,0.9759885581793896,1,3,66058,1113,64945,0.9831511701837778,35.65140977777778,6505.424832,9.998046977614175,129,2.4E-4
8,test_20231101_135404,11382381.png,312486,707,311779,0.9977374986399391,1,4,46745,96,46649,0.9979463044175848,21.47300977777778,2499.126186666667,14.152921756540431,129,2.4E-4
9,test_20231101_135404,11079715.png,443815,110349,333466,0.7513626173067607,4,5,124136,15456,108680,0.8754913965328349,17.57312,2279.878944,14.551685732308561,129,2.4E-4
10,test_20231101_135404,11551286.png,271883,327,271556,0.998797276769787,2,3,40092,46,40046,0.99885263893046,17.867866666666668,1859.2518453333332,15.437421396648572,129,2.4E-4
1,test_20231101_135405,10404007.png,502730,17207,485523,0.9657728800747917,2,4,61265,2499,58766,0.9592099893903534,26.117214222222223,3546.187088,12.633187167032132,129,2.5E-4
2,test_20231101_135405,1254659.png,342646,67202,275444,0.8038733853598174,3,4,80080,9440,70640,0.8821178821178821,21.685260444444445,3425.6872266666664,12.78332652540119,129,2.5E-4
3,test_20231101_135405,10188041.png,221231,8907,212324,0.9597389154322857,2,4,41731,1262,40469,0.9697586925786585,10.89088711111111,1117.198944,17.64949844343051,129,2.5E-4
4,test_20231101_135405,10287332.png,216980,11579,205401,0.9466356346207023,1,4,22337,1590,20747,0.9288176568026145,9.629411555555556,829.9726293333333,18.940165903297878,129,2.5E-4
5,test_20231101_135405,11610969.png,368720,22372,346348,0.9393252332393144,2,4,84111,3270,80841,0.9611228020116275,22.074186666666666,3125.7853333333333,13.18121211800863,129,2.5E-4
6,test_20231101_135405,10350842.png,212614,5359,207255,0.9747946983735785,1,4,42529,788,41741,0.9814714665287215,19.497994666666667,2427.775552,14.27871827160568,129,2.5E-4
7,test_20231101_135405,10863862.png,317432,7622,309810,0.9759885581793896,2,3,66058,1113,64945,0.9831511701837778,35.65140977777778,6505.424832,9.998046977614175,129,2.5E-4
8,test_20231101_135405,11382381.png,312486,707,311779,0.9977374986399391,2,4,46745,96,46649,0.9979463044175848,21.47300977777778,2499.126186666667,14.152921756540431,129,2.5E-4
9,test_20231101_135405,11079715.png,443815,110349,333466,0.7513626173067607,3,4,124136,15456,108680,0.8754913965328349,17.57312,2279.878944,14.551685732308561,129,2.5E-4
10,test_20231101_135405,11551286.png,271883,327,271556,0.998797276769787,1,4,40092,46,40046,0.99885263893046,17.867866666666668,1859.2518453333332,15.437421396648572,129,2.5E-4
1,test_20231101_135406,10404007.png,502730,17007,485723,0.9661707079346766,3,3,61265,2473,58792,0.9596343752550396,26.13115911111111,3549.4145653333335,12.629236337316815,129,2.6000000000000003E-4
2,test_20231101_135406,1254659.png,342646,67139,275507,0.8040572485889227,2,4,80080,9434,70646,0.8821928071928072,21.694814222222224,3426.7694133333334,12.781954790485319,129,2.6000000000000003E-4
3,test_20231101_135406,10188041.png,221231,8867,212364,0.9599197219196225,2,4,41731,1256,40475,0.9699024705854161,11.256714666666667,1169.479648,17.450876925151316,129,2.6000000000000003E-4
4,test_20231101_135406,10287332.png,216980,11579,205401,0.9466356346207023,2,4,22337,1590,20747,0.9288176568026145,9.629411555555556,829.9726293333333,18.940165903297878,129,2.6000000000000003E-4
5,test_20231101_135406,11610969.png,368720,21849,346871,0.9407436537209807,4,4,84111,3194,80917,0.9620263699159444,22.960643555555556,3319.495392,12.920082907559944,129,2.6000000000000003E-4
6,test_20231101_135406,10350842.png,212614,5279,207335,0.9751709671047062,1,4,42529,776,41753,0.9817536269369136,19.566787555555557,2433.533258666667,14.268430748223048,129,2.6000000000000003E-4
7,test_20231101_135406,10863862.png,317432,7562,309870,0.9761775750396935,2,3,66058,1104,64954,0.9832874140906476,35.66071822222222,6506.869162666667,9.99708286653367,129,2.6000000000000003E-4
8,test_20231101_135406,11382381.png,312486,587,311899,0.9981215158439098,2,3,46745,78,46667,0.9983313723392876,21.967536,2569.068496,14.03304677372966,129,2.6000000000000003E-4
9,test_20231101_135406,11079715.png,443815,110349,333466,0.7513626173067607,3,4,124136,15456,108680,0.8754913965328349,17.57312,2279.878944,14.551685732308561,129,2.6000000000000003E-4
10,test_20231101_135406,11551286.png,271883,267,271616,0.9990179599312939,1,3,40092,37,40055,0.9990771226179787,18.016108444444445,1877.54488,15.394900338849709,129,2.6000000000000003E-4
1,test_20231101_135406,10404007.png,502730,17007,485723,0.9661707079346766,2,4,61265,2473,58792,0.9596343752550396,26.13115911111111,3549.4145653333335,12.629236337316815,129,2.7000000000000006E-4
2,test_20231101_135406,1254659.png,342646,67139,275507,0.8040572485889227,3,4,80080,9434,70646,0.8821928071928072,21.694814222222224,3426.7694133333334,12.781954790485319,129,2.7000000000000006E-4
3,test_20231101_135406,10188041.png,221231,8867,212364,0.9599197219196225,2,3,41731,1256,40475,0.9699024705854161,11.256714666666667,1169.479648,17.450876925151316,129,2.7000000000000006E-4
4,test_20231101_135406,10287332.png,216980,11579,205401,0.9466356346207023,1,3,22337,1590,20747,0.9288176568026145,9.629411555555556,829.9726293333333,18.940165903297878,129,2.7000000000000006E-4
5,test_20231101_135406,11610969.png,368720,21849,346871,0.9407436537209807,2,3,84111,3194,80917,0.9620263699159444,22.960643555555556,3319.495392,12.920082907559944,129,2.7000000000000006E-4
6,test_20231101_135406,10350842.png,212614,5279,207335,0.9751709671047062,1,4,42529,776,41753,0.9817536269369136,19.566787555555557,2433.533258666667,14.268430748223048,129,2.7000000000000006E-4
7,test_20231101_135406,10863862.png,317432,7562,309870,0.9761775750396935,2,4,66058,1104,64954,0.9832874140906476,35.66071822222222,6506.869162666667,9.99708286653367,129,2.7000000000000006E-4
8,test_20231101_135406,11382381.png,312486,587,311899,0.9981215158439098,1,3,46745,78,46667,0.9983313723392876,21.967536,2569.068496,14.03304677372966,129,2.7000000000000006E-4
9,test_20231101_135406,11079715.png,443815,110349,333466,0.7513626173067607,4,5,124136,15456,108680,0.8754913965328349,17.57312,2279.878944,14.551685732308561,129,2.7000000000000006E-4
10,test_20231101_135406,11551286.png,271883,267,271616,0.9990179599312939,1,4,40092,37,40055,0.9990771226179787,18.016108444444445,1877.54488,15.394900338849709,129,2.7000000000000006E-4
1,test_20231101_135407,10404007.png,502730,17007,485723,0.9661707079346766,2,4,61265,2473,58792,0.9596343752550396,26.13115911111111,3549.4145653333335,12.629236337316815,129,2.800000000000001E-4
2,test_20231101_135407,1254659.png,342646,67139,275507,0.8040572485889227,3,4,80080,9434,70646,0.8821928071928072,21.694814222222224,3426.7694133333334,12.781954790485319,129,2.800000000000001E-4
3,test_20231101_135407,10188041.png,221231,8867,212364,0.9599197219196225,2,4,41731,1256,40475,0.9699024705854161,11.256714666666667,1169.479648,17.450876925151316,129,2.800000000000001E-4
4,test_20231101_135407,10287332.png,216980,11579,205401,0.9466356346207023,2,4,22337,1590,20747,0.9288176568026145,9.629411555555556,829.9726293333333,18.940165903297878,129,2.800000000000001E-4
5,test_20231101_135407,11610969.png,368720,21849,346871,0.9407436537209807,2,4,84111,3194,80917,0.9620263699159444,22.960643555555556,3319.495392,12.920082907559944,129,2.800000000000001E-4
6,test_20231101_135407,10350842.png,212614,5279,207335,0.9751709671047062,2,4,42529,776,41753,0.9817536269369136,19.566787555555557,2433.533258666667,14.268430748223048,129,2.800000000000001E-4
7,test_20231101_135407,10863862.png,317432,7562,309870,0.9761775750396935,1,3,66058,1104,64954,0.9832874140906476,35.66071822222222,6506.869162666667,9.99708286653367,129,2.800000000000001E-4
8,test_20231101_135407,11382381.png,312486,587,311899,0.9981215158439098,1,4,46745,78,46667,0.9983313723392876,21.967536,2569.068496,14.03304677372966,129,2.800000000000001E-4
9,test_20231101_135407,11079715.png,443815,110349,333466,0.7513626173067607,3,4,124136,15456,108680,0.8754913965328349,17.57312,2279.878944,14.551685732308561,129,2.800000000000001E-4
10,test_20231101_135407,11551286.png,271883,267,271616,0.9990179599312939,1,3,40092,37,40055,0.9990771226179787,18.016108444444445,1877.54488,15.394900338849709,129,2.800000000000001E-4
1,test_20231101_135408,10404007.png,502730,17007,485723,0.9661707079346766,2,4,61265,2473,58792,0.9596343752550396,26.13115911111111,3549.4145653333335,12.629236337316815,129,2.900000000000001E-4
2,test_20231101_135408,1254659.png,342646,67139,275507,0.8040572485889227,3,4,80080,9434,70646,0.8821928071928072,21.694814222222224,3426.7694133333334,12.781954790485319,129,2.900000000000001E-4
3,test_20231101_135408,10188041.png,221231,8867,212364,0.9599197219196225,2,4,41731,1256,40475,0.9699024705854161,11.256714666666667,1169.479648,17.450876925151316,129,2.900000000000001E-4
4,test_20231101_135408,10287332.png,216980,11579,205401,0.9466356346207023,2,4,22337,1590,20747,0.9288176568026145,9.629411555555556,829.9726293333333,18.940165903297878,129,2.900000000000001E-4
5,test_20231101_135408,11610969.png,368720,21849,346871,0.9407436537209807,2,4,84111,3194,80917,0.9620263699159444,22.960643555555556,3319.495392,12.920082907559944,129,2.900000000000001E-4
6,test_20231101_135408,10350842.png,212614,5279,207335,0.9751709671047062,1,4,42529,776,41753,0.9817536269369136,19.566787555555557,2433.533258666667,14.268430748223048,129,2.900000000000001E-4
7,test_20231101_135408,10863862.png,317432,7562,309870,0.9761775750396935,1,3,66058,1104,64954,0.9832874140906476,35.66071822222222,6506.869162666667,9.99708286653367,129,2.900000000000001E-4
8,test_20231101_135408,11382381.png,312486,587,311899,0.9981215158439098,1,4,46745,78,46667,0.9983313723392876,21.967536,2569.068496,14.03304677372966,129,2.900000000000001E-4
9,test_20231101_135408,11079715.png,443815,110349,333466,0.7513626173067607,3,4,124136,15456,108680,0.8754913965328349,17.57312,2279.878944,14.551685732308561,129,2.900000000000001E-4
10,test_20231101_135408,11551286.png,271883,267,271616,0.9990179599312939,1,3,40092,37,40055,0.9990771226179787,18.016108444444445,1877.54488,15.394900338849709,129,2.900000000000001E-4
1,test_20231101_135408,10404007.png,502730,17007,485723,0.9661707079346766,2,3,61265,2473,58792,0.9596343752550396,26.13115911111111,3549.4145653333335,12.629236337316815,129,3.0000000000000014E-4
2,test_20231101_135408,1254659.png,342646,67139,275507,0.8040572485889227,3,4,80080,9434,70646,0.8821928071928072,21.694814222222224,3426.7694133333334,12.781954790485319,129,3.0000000000000014E-4
3,test_20231101_135408,10188041.png,221231,8867,212364,0.9599197219196225,2,4,41731,1256,40475,0.9699024705854161,11.256714666666667,1169.479648,17.450876925151316,129,3.0000000000000014E-4
4,test_20231101_135408,10287332.png,216980,11579,205401,0.9466356346207023,1,3,22337,1590,20747,0.9288176568026145,9.629411555555556,829.9726293333333,18.940165903297878,129,3.0000000000000014E-4
5,test_20231101_135408,11610969.png,368720,21849,346871,0.9407436537209807,3,3,84111,3194,80917,0.9620263699159444,22.960643555555556,3319.495392,12.920082907559944,129,3.0000000000000014E-4
6,test_20231101_135408,10350842.png,212614,5279,207335,0.9751709671047062,1,4,42529,776,41753,0.9817536269369136,19.566787555555557,2433.533258666667,14.268430748223048,129,3.0000000000000014E-4
7,test_20231101_135408,10863862.png,317432,7562,309870,0.9761775750396935,2,3,66058,1104,64954,0.9832874140906476,35.66071822222222,6506.869162666667,9.99708286653367,129,3.0000000000000014E-4
8,test_20231101_135408,11382381.png,312486,587,311899,0.9981215158439098,2,3,46745,78,46667,0.9983313723392876,21.967536,2569.068496,14.03304677372966,129,3.0000000000000014E-4
9,test_20231101_135408,11079715.png,443815,110349,333466,0.7513626173067607,3,4,124136,15456,108680,0.8754913965328349,17.57312,2279.878944,14.551685732308561,129,3.0000000000000014E-4
10,test_20231101_135408,11551286.png,271883,267,271616,0.9990179599312939,2,4,40092,37,40055,0.9990771226179787,18.016108444444445,1877.54488,15.394900338849709,129,3.0000000000000014E-4
1,test_20231101_135409,10404007.png,502730,17007,485723,0.9661707079346766,2,3,61265,2473,58792,0.9596343752550396,26.13115911111111,3549.4145653333335,12.629236337316815,129,3.1000000000000016E-4
2,test_20231101_135409,1254659.png,342646,67139,275507,0.8040572485889227,3,4,80080,9434,70646,0.8821928071928072,21.694814222222224,3426.7694133333334,12.781954790485319,129,3.1000000000000016E-4
3,test_20231101_135409,10188041.png,221231,8867,212364,0.9599197219196225,2,4,41731,1256,40475,0.9699024705854161,11.256714666666667,1169.479648,17.450876925151316,129,3.1000000000000016E-4
4,test_20231101_135409,10287332.png,216980,11579,205401,0.9466356346207023,1,4,22337,1590,20747,0.9288176568026145,9.629411555555556,829.9726293333333,18.940165903297878,129,3.1000000000000016E-4
5,test_20231101_135409,11610969.png,368720,21849,346871,0.9407436537209807,3,4,84111,3194,80917,0.9620263699159444,22.960643555555556,3319.495392,12.920082907559944,129,3.1000000000000016E-4
6,test_20231101_135409,10350842.png,212614,5279,207335,0.9751709671047062,1,3,42529,776,41753,0.9817536269369136,19.566787555555557,2433.533258666667,14.268430748223048,129,3.1000000000000016E-4
7,test_20231101_135409,10863862.png,317432,7562,309870,0.9761775750396935,2,4,66058,1104,64954,0.9832874140906476,35.66071822222222,6506.869162666667,9.99708286653367,129,3.1000000000000016E-4
8,test_20231101_135409,11382381.png,312486,587,311899,0.9981215158439098,1,4,46745,78,46667,0.9983313723392876,21.967536,2569.068496,14.03304677372966,129,3.1000000000000016E-4
9,test_20231101_135409,11079715.png,443815,110349,333466,0.7513626173067607,3,4,124136,15456,108680,0.8754913965328349,17.57312,2279.878944,14.551685732308561,129,3.1000000000000016E-4
10,test_20231101_135409,11551286.png,271883,267,271616,0.9990179599312939,2,3,40092,37,40055,0.9990771226179787,18.016108444444445,1877.54488,15.394900338849709,129,3.1000000000000016E-4
1,test_20231101_135410,10404007.png,502730,17007,485723,0.9661707079346766,3,3,61265,2473,58792,0.9596343752550396,26.13115911111111,3549.4145653333335,12.629236337316815,129,3.200000000000002E-4
2,test_20231101_135410,1254659.png,342646,67139,275507,0.8040572485889227,3,4,80080,9434,70646,0.8821928071928072,21.694814222222224,3426.7694133333334,12.781954790485319,129,3.200000000000002E-4
3,test_20231101_135410,10188041.png,221231,8867,212364,0.9599197219196225,2,3,41731,1256,40475,0.9699024705854161,11.256714666666667,1169.479648,17.450876925151316,129,3.200000000000002E-4
4,test_20231101_135410,10287332.png,216980,11579,205401,0.9466356346207023,2,4,22337,1590,20747,0.9288176568026145,9.629411555555556,829.9726293333333,18.940165903297878,129,3.200000000000002E-4
5,test_20231101_135410,11610969.png,368720,21849,346871,0.9407436537209807,2,4,84111,3194,80917,0.9620263699159444,22.960643555555556,3319.495392,12.920082907559944,129,3.200000000000002E-4
6,test_20231101_135410,10350842.png,212614,5279,207335,0.9751709671047062,2,4,42529,776,41753,0.9817536269369136,19.566787555555557,2433.533258666667,14.268430748223048,129,3.200000000000002E-4
7,test_20231101_135410,10863862.png,317432,7562,309870,0.9761775750396935,2,3,66058,1104,64954,0.9832874140906476,35.66071822222222,6506.869162666667,9.99708286653367,129,3.200000000000002E-4
8,test_20231101_135410,11382381.png,312486,587,311899,0.9981215158439098,2,3,46745,78,46667,0.9983313723392876,21.967536,2569.068496,14.03304677372966,129,3.200000000000002E-4
9,test_20231101_135410,11079715.png,443815,110349,333466,0.7513626173067607,3,5,124136,15456,108680,0.8754913965328349,17.57312,2279.878944,14.551685732308561,129,3.200000000000002E-4
10,test_20231101_135410,11551286.png,271883,267,271616,0.9990179599312939,1,12,40092,37,40055,0.9990771226179787,18.016108444444445,1877.54488,15.394900338849709,129,3.200000000000002E-4
1,test_20231101_135411,10404007.png,502730,17007,485723,0.9661707079346766,3,4,61265,2473,58792,0.9596343752550396,26.13115911111111,3549.4145653333335,12.629236337316815,129,3.300000000000002E-4
2,test_20231101_135411,1254659.png,342646,67139,275507,0.8040572485889227,2,4,80080,9434,70646,0.8821928071928072,21.694814222222224,3426.7694133333334,12.781954790485319,129,3.300000000000002E-4
3,test_20231101_135411,10188041.png,221231,8867,212364,0.9599197219196225,2,4,41731,1256,40475,0.9699024705854161,11.256714666666667,1169.479648,17.450876925151316,129,3.300000000000002E-4
4,test_20231101_135411,10287332.png,216980,11579,205401,0.9466356346207023,2,4,22337,1590,20747,0.9288176568026145,9.629411555555556,829.9726293333333,18.940165903297878,129,3.300000000000002E-4
5,test_20231101_135411,11610969.png,368720,21849,346871,0.9407436537209807,2,10,84111,3194,80917,0.9620263699159444,22.960643555555556,3319.495392,12.920082907559944,129,3.300000000000002E-4
6,test_20231101_135411,10350842.png,212614,5279,207335,0.9751709671047062,1,4,42529,776,41753,0.9817536269369136,19.566787555555557,2433.533258666667,14.268430748223048,129,3.300000000000002E-4
7,test_20231101_135411,10863862.png,317432,7562,309870,0.9761775750396935,1,3,66058,1104,64954,0.9832874140906476,35.66071822222222,6506.869162666667,9.99708286653367,129,3.300000000000002E-4
8,test_20231101_135411,11382381.png,312486,587,311899,0.9981215158439098,2,4,46745,78,46667,0.9983313723392876,21.967536,2569.068496,14.03304677372966,129,3.300000000000002E-4
9,test_20231101_135411,11079715.png,443815,110349,333466,0.7513626173067607,3,4,124136,15456,108680,0.8754913965328349,17.57312,2279.878944,14.551685732308561,129,3.300000000000002E-4
10,test_20231101_135411,11551286.png,271883,267,271616,0.9990179599312939,2,3,40092,37,40055,0.9990771226179787,18.016108444444445,1877.54488,15.394900338849709,129,3.300000000000002E-4
1,test_20231101_135411,10404007.png,502730,17007,485723,0.9661707079346766,2,4,61265,2473,58792,0.9596343752550396,26.13115911111111,3549.4145653333335,12.629236337316815,129,3.4000000000000024E-4
2,test_20231101_135411,1254659.png,342646,67139,275507,0.8040572485889227,4,4,80080,9434,70646,0.8821928071928072,21.694814222222224,3426.7694133333334,12.781954790485319,129,3.4000000000000024E-4
3,test_20231101_135411,10188041.png,221231,8867,212364,0.9599197219196225,2,4,41731,1256,40475,0.9699024705854161,11.256714666666667,1169.479648,17.450876925151316,129,3.4000000000000024E-4
4,test_20231101_135411,10287332.png,216980,11579,205401,0.9466356346207023,1,4,22337,1590,20747,0.9288176568026145,9.629411555555556,829.9726293333333,18.940165903297878,129,3.4000000000000024E-4
5,test_20231101_135411,11610969.png,368720,21849,346871,0.9407436537209807,3,3,84111,3194,80917,0.9620263699159444,22.960643555555556,3319.495392,12.920082907559944,129,3.4000000000000024E-4
6,test_20231101_135411,10350842.png,212614,5279,207335,0.9751709671047062,2,4,42529,776,41753,0.9817536269369136,19.566787555555557,2433.533258666667,14.268430748223048,129,3.4000000000000024E-4
7,test_20231101_135411,10863862.png,317432,7562,309870,0.9761775750396935,2,4,66058,1104,64954,0.9832874140906476,35.66071822222222,6506.869162666667,9.99708286653367,129,3.4000000000000024E-4
8,test_20231101_135411,11382381.png,312486,587,311899,0.9981215158439098,1,4,46745,78,46667,0.9983313723392876,21.967536,2569.068496,14.03304677372966,129,3.4000000000000024E-4
9,test_20231101_135411,11079715.png,443815,110349,333466,0.7513626173067607,3,4,124136,15456,108680,0.8754913965328349,17.57312,2279.878944,14.551685732308561,129,3.4000000000000024E-4
10,test_20231101_135411,11551286.png,271883,267,271616,0.9990179599312939,1,3,40092,37,40055,0.9990771226179787,18.016108444444445,1877.54488,15.394900338849709,129,3.4000000000000024E-4
1,test_20231101_135412,10404007.png,502730,17007,485723,0.9661707079346766,2,4,61265,2473,58792,0.9596343752550396,26.13115911111111,3549.4145653333335,12.629236337316815,129,3.5000000000000027E-4
2,test_20231101_135412,1254659.png,342646,67139,275507,0.8040572485889227,3,4,80080,9434,70646,0.8821928071928072,21.694814222222224,3426.7694133333334,12.781954790485319,129,3.5000000000000027E-4
3,test_20231101_135412,10188041.png,221231,8867,212364,0.9599197219196225,2,4,41731,1256,40475,0.9699024705854161,11.256714666666667,1169.479648,17.450876925151316,129,3.5000000000000027E-4
4,test_20231101_135412,10287332.png,216980,11579,205401,0.9466356346207023,1,3,22337,1590,20747,0.9288176568026145,9.629411555555556,829.9726293333333,18.940165903297878,129,3.5000000000000027E-4
5,test_20231101_135412,11610969.png,368720,21849,346871,0.9407436537209807,2,3,84111,3194,80917,0.9620263699159444,22.960643555555556,3319.495392,12.920082907559944,129,3.5000000000000027E-4
6,test_20231101_135412,10350842.png,212614,5279,207335,0.9751709671047062,2,4,42529,776,41753,0.9817536269369136,19.566787555555557,2433.533258666667,14.268430748223048,129,3.5000000000000027E-4
7,test_20231101_135412,10863862.png,317432,7562,309870,0.9761775750396935,2,3,66058,1104,64954,0.9832874140906476,35.66071822222222,6506.869162666667,9.99708286653367,129,3.5000000000000027E-4
8,test_20231101_135412,11382381.png,312486,587,311899,0.9981215158439098,1,3,46745,78,46667,0.9983313723392876,21.967536,2569.068496,14.03304677372966,129,3.5000000000000027E-4
9,test_20231101_135412,11079715.png,443815,110349,333466,0.7513626173067607,3,4,124136,15456,108680,0.8754913965328349,17.57312,2279.878944,14.551685732308561,129,3.5000000000000027E-4
10,test_20231101_135412,11551286.png,271883,267,271616,0.9990179599312939,1,4,40092,37,40055,0.9990771226179787,18.016108444444445,1877.54488,15.394900338849709,129,3.5000000000000027E-4
1,test_20231101_135413,10404007.png,502730,17007,485723,0.9661707079346766,2,3,61265,2473,58792,0.9596343752550396,26.13115911111111,3549.4145653333335,12.629236337316815,129,3.600000000000003E-4
2,test_20231101_135413,1254659.png,342646,67139,275507,0.8040572485889227,2,3,80080,9434,70646,0.8821928071928072,21.694814222222224,3426.7694133333334,12.781954790485319,129,3.600000000000003E-4
3,test_20231101_135413,10188041.png,221231,8867,212364,0.9599197219196225,2,3,41731,1256,40475,0.9699024705854161,11.256714666666667,1169.479648,17.450876925151316,129,3.600000000000003E-4
4,test_20231101_135413,10287332.png,216980,11579,205401,0.9466356346207023,2,3,22337,1590,20747,0.9288176568026145,9.629411555555556,829.9726293333333,18.940165903297878,129,3.600000000000003E-4
5,test_20231101_135413,11610969.png,368720,21849,346871,0.9407436537209807,2,4,84111,3194,80917,0.9620263699159444,22.960643555555556,3319.495392,12.920082907559944,129,3.600000000000003E-4
6,test_20231101_135413,10350842.png,212614,5279,207335,0.9751709671047062,1,4,42529,776,41753,0.9817536269369136,19.566787555555557,2433.533258666667,14.268430748223048,129,3.600000000000003E-4
7,test_20231101_135413,10863862.png,317432,7562,309870,0.9761775750396935,1,3,66058,1104,64954,0.9832874140906476,35.66071822222222,6506.869162666667,9.99708286653367,129,3.600000000000003E-4
8,test_20231101_135413,11382381.png,312486,587,311899,0.9981215158439098,1,4,46745,78,46667,0.9983313723392876,21.967536,2569.068496,14.03304677372966,129,3.600000000000003E-4
9,test_20231101_135413,11079715.png,443815,110349,333466,0.7513626173067607,4,4,124136,15456,108680,0.8754913965328349,17.57312,2279.878944,14.551685732308561,129,3.600000000000003E-4
10,test_20231101_135413,11551286.png,271883,267,271616,0.9990179599312939,2,4,40092,37,40055,0.9990771226179787,18.016108444444445,1877.54488,15.394900338849709,129,3.600000000000003E-4
1,test_20231101_135413,10404007.png,502730,17007,485723,0.9661707079346766,2,4,61265,2473,58792,0.9596343752550396,26.13115911111111,3549.4145653333335,12.629236337316815,129,3.700000000000003E-4
2,test_20231101_135413,1254659.png,342646,67139,275507,0.8040572485889227,3,4,80080,9434,70646,0.8821928071928072,21.694814222222224,3426.7694133333334,12.781954790485319,129,3.700000000000003E-4
3,test_20231101_135413,10188041.png,221231,8867,212364,0.9599197219196225,3,3,41731,1256,40475,0.9699024705854161,11.256714666666667,1169.479648,17.450876925151316,129,3.700000000000003E-4
4,test_20231101_135413,10287332.png,216980,11579,205401,0.9466356346207023,2,3,22337,1590,20747,0.9288176568026145,9.629411555555556,829.9726293333333,18.940165903297878,129,3.700000000000003E-4
5,test_20231101_135413,11610969.png,368720,21849,346871,0.9407436537209807,2,4,84111,3194,80917,0.9620263699159444,22.960643555555556,3319.495392,12.920082907559944,129,3.700000000000003E-4
6,test_20231101_135413,10350842.png,212614,5279,207335,0.9751709671047062,2,4,42529,776,41753,0.9817536269369136,19.566787555555557,2433.533258666667,14.268430748223048,129,3.700000000000003E-4
7,test_20231101_135413,10863862.png,317432,7562,309870,0.9761775750396935,1,3,66058,1104,64954,0.9832874140906476,35.66071822222222,6506.869162666667,9.99708286653367,129,3.700000000000003E-4
8,test_20231101_135413,11382381.png,312486,587,311899,0.9981215158439098,2,4,46745,78,46667,0.9983313723392876,21.967536,2569.068496,14.03304677372966,129,3.700000000000003E-4
9,test_20231101_135413,11079715.png,443815,110349,333466,0.7513626173067607,4,4,124136,15456,108680,0.8754913965328349,17.57312,2279.878944,14.551685732308561,129,3.700000000000003E-4
10,test_20231101_135413,11551286.png,271883,267,271616,0.9990179599312939,1,4,40092,37,40055,0.9990771226179787,18.016108444444445,1877.54488,15.394900338849709,129,3.700000000000003E-4
1,test_20231101_135414,10404007.png,502730,17007,485723,0.9661707079346766,2,4,61265,2473,58792,0.9596343752550396,26.13115911111111,3549.4145653333335,12.629236337316815,129,3.8000000000000035E-4
2,test_20231101_135414,1254659.png,342646,67139,275507,0.8040572485889227,3,4,80080,9434,70646,0.8821928071928072,21.694814222222224,3426.7694133333334,12.781954790485319,129,3.8000000000000035E-4
3,test_20231101_135414,10188041.png,221231,8867,212364,0.9599197219196225,2,3,41731,1256,40475,0.9699024705854161,11.256714666666667,1169.479648,17.450876925151316,129,3.8000000000000035E-4
4,test_20231101_135414,10287332.png,216980,11579,205401,0.9466356346207023,2,5,22337,1590,20747,0.9288176568026145,9.629411555555556,829.9726293333333,18.940165903297878,129,3.8000000000000035E-4
5,test_20231101_135414,11610969.png,368720,21849,346871,0.9407436537209807,3,3,84111,3194,80917,0.9620263699159444,22.960643555555556,3319.495392,12.920082907559944,129,3.8000000000000035E-4
6,test_20231101_135414,10350842.png,212614,5279,207335,0.9751709671047062,1,3,42529,776,41753,0.9817536269369136,19.566787555555557,2433.533258666667,14.268430748223048,129,3.8000000000000035E-4
7,test_20231101_135414,10863862.png,317432,7562,309870,0.9761775750396935,1,4,66058,1104,64954,0.9832874140906476,35.66071822222222,6506.869162666667,9.99708286653367,129,3.8000000000000035E-4
8,test_20231101_135414,11382381.png,312486,587,311899,0.9981215158439098,1,3,46745,78,46667,0.9983313723392876,21.967536,2569.068496,14.03304677372966,129,3.8000000000000035E-4
9,test_20231101_135414,11079715.png,443815,110349,333466,0.7513626173067607,3,4,124136,15456,108680,0.8754913965328349,17.57312,2279.878944,14.551685732308561,129,3.8000000000000035E-4
10,test_20231101_135414,11551286.png,271883,267,271616,0.9990179599312939,1,3,40092,37,40055,0.9990771226179787,18.016108444444445,1877.54488,15.394900338849709,129,3.8000000000000035E-4
1,test_20231101_135415,10404007.png,502730,17007,485723,0.9661707079346766,2,3,61265,2473,58792,0.9596343752550396,26.13115911111111,3549.4145653333335,12.629236337316815,129,3.9000000000000037E-4
2,test_20231101_135415,1254659.png,342646,67139,275507,0.8040572485889227,3,4,80080,9434,70646,0.8821928071928072,21.694814222222224,3426.7694133333334,12.781954790485319,129,3.9000000000000037E-4
3,test_20231101_135415,10188041.png,221231,8867,212364,0.9599197219196225,2,4,41731,1256,40475,0.9699024705854161,11.256714666666667,1169.479648,17.450876925151316,129,3.9000000000000037E-4
4,test_20231101_135415,10287332.png,216980,11579,205401,0.9466356346207023,2,3,22337,1590,20747,0.9288176568026145,9.629411555555556,829.9726293333333,18.940165903297878,129,3.9000000000000037E-4
5,test_20231101_135415,11610969.png,368720,21849,346871,0.9407436537209807,2,4,84111,3194,80917,0.9620263699159444,22.960643555555556,3319.495392,12.920082907559944,129,3.9000000000000037E-4
6,test_20231101_135415,10350842.png,212614,5279,207335,0.9751709671047062,2,4,42529,776,41753,0.9817536269369136,19.566787555555557,2433.533258666667,14.268430748223048,129,3.9000000000000037E-4
7,test_20231101_135415,10863862.png,317432,7562,309870,0.9761775750396935,2,4,66058,1104,64954,0.9832874140906476,35.66071822222222,6506.869162666667,9.99708286653367,129,3.9000000000000037E-4
8,test_20231101_135415,11382381.png,312486,587,311899,0.9981215158439098,2,3,46745,78,46667,0.9983313723392876,21.967536,2569.068496,14.03304677372966,129,3.9000000000000037E-4
9,test_20231101_135415,11079715.png,443815,110349,333466,0.7513626173067607,3,4,124136,15456,108680,0.8754913965328349,17.57312,2279.878944,14.551685732308561,129,3.9000000000000037E-4
10,test_20231101_135415,11551286.png,271883,267,271616,0.9990179599312939,1,3,40092,37,40055,0.9990771226179787,18.016108444444445,1877.54488,15.394900338849709,129,3.9000000000000037E-4
1,test_20231101_135415,10404007.png,502730,17007,485723,0.9661707079346766,2,4,61265,2473,58792,0.9596343752550396,26.13115911111111,3549.4145653333335,12.629236337316815,129,4.000000000000004E-4
2,test_20231101_135415,1254659.png,342646,67139,275507,0.8040572485889227,3,4,80080,9434,70646,0.8821928071928072,21.694814222222224,3426.7694133333334,12.781954790485319,129,4.000000000000004E-4
3,test_20231101_135415,10188041.png,221231,8867,212364,0.9599197219196225,2,4,41731,1256,40475,0.9699024705854161,11.256714666666667,1169.479648,17.450876925151316,129,4.000000000000004E-4
4,test_20231101_135415,10287332.png,216980,11579,205401,0.9466356346207023,2,4,22337,1590,20747,0.9288176568026145,9.629411555555556,829.9726293333333,18.940165903297878,129,4.000000000000004E-4
5,test_20231101_135415,11610969.png,368720,21849,346871,0.9407436537209807,2,3,84111,3194,80917,0.9620263699159444,22.960643555555556,3319.495392,12.920082907559944,129,4.000000000000004E-4
6,test_20231101_135415,10350842.png,212614,5279,207335,0.9751709671047062,1,4,42529,776,41753,0.9817536269369136,19.566787555555557,2433.533258666667,14.268430748223048,129,4.000000000000004E-4
7,test_20231101_135415,10863862.png,317432,7562,309870,0.9761775750396935,1,4,66058,1104,64954,0.9832874140906476,35.66071822222222,6506.869162666667,9.99708286653367,129,4.000000000000004E-4
8,test_20231101_135415,11382381.png,312486,587,311899,0.9981215158439098,1,4,46745,78,46667,0.9983313723392876,21.967536,2569.068496,14.03304677372966,129,4.000000000000004E-4
9,test_20231101_135415,11079715.png,443815,110349,333466,0.7513626173067607,3,4,124136,15456,108680,0.8754913965328349,17.57312,2279.878944,14.551685732308561,129,4.000000000000004E-4
10,test_20231101_135415,11551286.png,271883,267,271616,0.9990179599312939,1,4,40092,37,40055,0.9990771226179787,18.016108444444445,1877.54488,15.394900338849709,129,4.000000000000004E-4
1,test_20231101_135416,10404007.png,502730,17007,485723,0.9661707079346766,2,4,61265,2473,58792,0.9596343752550396,26.13115911111111,3549.4145653333335,12.629236337316815,129,4.100000000000004E-4
2,test_20231101_135416,1254659.png,342646,67139,275507,0.8040572485889227,3,5,80080,9434,70646,0.8821928071928072,21.694814222222224,3426.7694133333334,12.781954790485319,129,4.100000000000004E-4
3,test_20231101_135416,10188041.png,221231,8867,212364,0.9599197219196225,2,4,41731,1256,40475,0.9699024705854161,11.256714666666667,1169.479648,17.450876925151316,129,4.100000000000004E-4
4,test_20231101_135416,10287332.png,216980,11579,205401,0.9466356346207023,1,4,22337,1590,20747,0.9288176568026145,9.629411555555556,829.9726293333333,18.940165903297878,129,4.100000000000004E-4
5,test_20231101_135416,11610969.png,368720,21849,346871,0.9407436537209807,3,7,84111,3194,80917,0.9620263699159444,22.960643555555556,3319.495392,12.920082907559944,129,4.100000000000004E-4
6,test_20231101_135416,10350842.png,212614,5279,207335,0.9751709671047062,2,4,42529,776,41753,0.9817536269369136,19.566787555555557,2433.533258666667,14.268430748223048,129,4.100000000000004E-4
7,test_20231101_135416,10863862.png,317432,7562,309870,0.9761775750396935,1,4,66058,1104,64954,0.9832874140906476,35.66071822222222,6506.869162666667,9.99708286653367,129,4.100000000000004E-4
8,test_20231101_135416,11382381.png,312486,587,311899,0.9981215158439098,1,4,46745,78,46667,0.9983313723392876,21.967536,2569.068496,14.03304677372966,129,4.100000000000004E-4
9,test_20231101_135416,11079715.png,443815,110349,333466,0.7513626173067607,3,4,124136,15456,108680,0.8754913965328349,17.57312,2279.878944,14.551685732308561,129,4.100000000000004E-4
10,test_20231101_135416,11551286.png,271883,267,271616,0.9990179599312939,1,3,40092,37,40055,0.9990771226179787,18.016108444444445,1877.54488,15.394900338849709,129,4.100000000000004E-4
1,test_20231101_135417,10404007.png,502730,17007,485723,0.9661707079346766,2,3,61265,2473,58792,0.9596343752550396,26.13115911111111,3549.4145653333335,12.629236337316815,129,4.2000000000000045E-4
2,test_20231101_135417,1254659.png,342646,67139,275507,0.8040572485889227,3,4,80080,9434,70646,0.8821928071928072,21.694814222222224,3426.7694133333334,12.781954790485319,129,4.2000000000000045E-4
3,test_20231101_135417,10188041.png,221231,8867,212364,0.9599197219196225,2,4,41731,1256,40475,0.9699024705854161,11.256714666666667,1169.479648,17.450876925151316,129,4.2000000000000045E-4
4,test_20231101_135417,10287332.png,216980,11579,205401,0.9466356346207023,2,4,22337,1590,20747,0.9288176568026145,9.629411555555556,829.9726293333333,18.940165903297878,129,4.2000000000000045E-4
5,test_20231101_135417,11610969.png,368720,21849,346871,0.9407436537209807,3,4,84111,3194,80917,0.9620263699159444,22.960643555555556,3319.495392,12.920082907559944,129,4.2000000000000045E-4
6,test_20231101_135417,10350842.png,212614,5279,207335,0.9751709671047062,1,4,42529,776,41753,0.9817536269369136,19.566787555555557,2433.533258666667,14.268430748223048,129,4.2000000000000045E-4
7,test_20231101_135417,10863862.png,317432,7562,309870,0.9761775750396935,1,4,66058,1104,64954,0.9832874140906476,35.66071822222222,6506.869162666667,9.99708286653367,129,4.2000000000000045E-4
8,test_20231101_135417,11382381.png,312486,587,311899,0.9981215158439098,2,3,46745,78,46667,0.9983313723392876,21.967536,2569.068496,14.03304677372966,129,4.2000000000000045E-4
9,test_20231101_135417,11079715.png,443815,110349,333466,0.7513626173067607,4,5,124136,15456,108680,0.8754913965328349,17.57312,2279.878944,14.551685732308561,129,4.2000000000000045E-4
10,test_20231101_135417,11551286.png,271883,267,271616,0.9990179599312939,1,3,40092,37,40055,0.9990771226179787,18.016108444444445,1877.54488,15.394900338849709,129,4.2000000000000045E-4
1,test_20231101_135417,10404007.png,502730,17007,485723,0.9661707079346766,2,4,61265,2473,58792,0.9596343752550396,26.13115911111111,3549.4145653333335,12.629236337316815,129,4.300000000000005E-4
2,test_20231101_135417,1254659.png,342646,67139,275507,0.8040572485889227,2,4,80080,9434,70646,0.8821928071928072,21.694814222222224,3426.7694133333334,12.781954790485319,129,4.300000000000005E-4
3,test_20231101_135417,10188041.png,221231,8867,212364,0.9599197219196225,2,3,41731,1256,40475,0.9699024705854161,11.256714666666667,1169.479648,17.450876925151316,129,4.300000000000005E-4
4,test_20231101_135417,10287332.png,216980,11579,205401,0.9466356346207023,1,3,22337,1590,20747,0.9288176568026145,9.629411555555556,829.9726293333333,18.940165903297878,129,4.300000000000005E-4
5,test_20231101_135417,11610969.png,368720,21849,346871,0.9407436537209807,2,4,84111,3194,80917,0.9620263699159444,22.960643555555556,3319.495392,12.920082907559944,129,4.300000000000005E-4
6,test_20231101_135417,10350842.png,212614,5279,207335,0.9751709671047062,2,4,42529,776,41753,0.9817536269369136,19.566787555555557,2433.533258666667,14.268430748223048,129,4.300000000000005E-4
7,test_20231101_135417,10863862.png,317432,7562,309870,0.9761775750396935,2,4,66058,1104,64954,0.9832874140906476,35.66071822222222,6506.869162666667,9.99708286653367,129,4.300000000000005E-4
8,test_20231101_135417,11382381.png,312486,587,311899,0.9981215158439098,2,4,46745,78,46667,0.9983313723392876,21.967536,2569.068496,14.03304677372966,129,4.300000000000005E-4
9,test_20231101_135417,11079715.png,443815,110349,333466,0.7513626173067607,3,4,124136,15456,108680,0.8754913965328349,17.57312,2279.878944,14.551685732308561,129,4.300000000000005E-4
10,test_20231101_135417,11551286.png,271883,267,271616,0.9990179599312939,1,4,40092,37,40055,0.9990771226179787,18.016108444444445,1877.54488,15.394900338849709,129,4.300000000000005E-4
1,test_20231101_135418,10404007.png,502730,17007,485723,0.9661707079346766,2,3,61265,2473,58792,0.9596343752550396,26.13115911111111,3549.4145653333335,12.629236337316815,129,4.400000000000005E-4
2,test_20231101_135418,1254659.png,342646,67139,275507,0.8040572485889227,3,4,80080,9434,70646,0.8821928071928072,21.694814222222224,3426.7694133333334,12.781954790485319,129,4.400000000000005E-4
3,test_20231101_135418,10188041.png,221231,8867,212364,0.9599197219196225,2,4,41731,1256,40475,0.9699024705854161,11.256714666666667,1169.479648,17.450876925151316,129,4.400000000000005E-4
4,test_20231101_135418,10287332.png,216980,11579,205401,0.9466356346207023,2,4,22337,1590,20747,0.9288176568026145,9.629411555555556,829.9726293333333,18.940165903297878,129,4.400000000000005E-4
5,test_20231101_135418,11610969.png,368720,21849,346871,0.9407436537209807,3,4,84111,3194,80917,0.9620263699159444,22.960643555555556,3319.495392,12.920082907559944,129,4.400000000000005E-4
6,test_20231101_135418,10350842.png,212614,5279,207335,0.9751709671047062,2,4,42529,776,41753,0.9817536269369136,19.566787555555557,2433.533258666667,14.268430748223048,129,4.400000000000005E-4
7,test_20231101_135418,10863862.png,317432,7562,309870,0.9761775750396935,1,3,66058,1104,64954,0.9832874140906476,35.66071822222222,6506.869162666667,9.99708286653367,129,4.400000000000005E-4
8,test_20231101_135418,11382381.png,312486,587,311899,0.9981215158439098,2,4,46745,78,46667,0.9983313723392876,21.967536,2569.068496,14.03304677372966,129,4.400000000000005E-4
9,test_20231101_135418,11079715.png,443815,110349,333466,0.7513626173067607,4,5,124136,15456,108680,0.8754913965328349,17.57312,2279.878944,14.551685732308561,129,4.400000000000005E-4
10,test_20231101_135418,11551286.png,271883,267,271616,0.9990179599312939,1,4,40092,37,40055,0.9990771226179787,18.016108444444445,1877.54488,15.394900338849709,129,4.400000000000005E-4
1,test_20231101_135419,10404007.png,502730,16847,485883,0.9664889702225847,2,4,61265,2450,58815,0.9600097935199543,26.172988444444446,3556.890048,12.62009920558409,129,4.5000000000000053E-4
2,test_20231101_135419,1254659.png,342646,67139,275507,0.8040572485889227,4,4,80080,9434,70646,0.8821928071928072,21.694814222222224,3426.7694133333334,12.781954790485319,129,4.5000000000000053E-4
3,test_20231101_135419,10188041.png,221231,8867,212364,0.9599197219196225,5,3,41731,1256,40475,0.9699024705854161,11.256714666666667,1169.479648,17.450876925151316,129,4.5000000000000053E-4
4,test_20231101_135419,10287332.png,216980,11579,205401,0.9466356346207023,1,3,22337,1590,20747,0.9288176568026145,9.629411555555556,829.9726293333333,18.940165903297878,129,4.5000000000000053E-4
5,test_20231101_135419,11610969.png,368720,21849,346871,0.9407436537209807,3,4,84111,3194,80917,0.9620263699159444,22.960643555555556,3319.495392,12.920082907559944,129,4.5000000000000053E-4
6,test_20231101_135419,10350842.png,212614,5279,207335,0.9751709671047062,1,3,42529,776,41753,0.9817536269369136,19.566787555555557,2433.533258666667,14.268430748223048,129,4.5000000000000053E-4
7,test_20231101_135419,10863862.png,317432,7562,309870,0.9761775750396935,2,4,66058,1104,64954,0.9832874140906476,35.66071822222222,6506.869162666667,9.99708286653367,129,4.5000000000000053E-4
8,test_20231101_135419,11382381.png,312486,587,311899,0.9981215158439098,2,4,46745,78,46667,0.9983313723392876,21.967536,2569.068496,14.03304677372966,129,4.5000000000000053E-4
9,test_20231101_135419,11079715.png,443815,110349,333466,0.7513626173067607,3,4,124136,15456,108680,0.8754913965328349,17.57312,2279.878944,14.551685732308561,129,4.5000000000000053E-4
10,test_20231101_135419,11551286.png,271883,267,271616,0.9990179599312939,2,4,40092,37,40055,0.9990771226179787,18.016108444444445,1877.54488,15.394900338849709,129,4.5000000000000053E-4
1,test_20231101_135419,10404007.png,502730,16847,485883,0.9664889702225847,2,3,61265,2450,58815,0.9600097935199543,26.172988444444446,3556.890048,12.62009920558409,129,4.6000000000000056E-4
2,test_20231101_135419,1254659.png,342646,67139,275507,0.8040572485889227,3,4,80080,9434,70646,0.8821928071928072,21.694814222222224,3426.7694133333334,12.781954790485319,129,4.6000000000000056E-4
3,test_20231101_135419,10188041.png,221231,8867,212364,0.9599197219196225,2,4,41731,1256,40475,0.9699024705854161,11.256714666666667,1169.479648,17.450876925151316,129,4.6000000000000056E-4
4,test_20231101_135419,10287332.png,216980,11579,205401,0.9466356346207023,1,4,22337,1590,20747,0.9288176568026145,9.629411555555556,829.9726293333333,18.940165903297878,129,4.6000000000000056E-4
5,test_20231101_135419,11610969.png,368720,21849,346871,0.9407436537209807,2,4,84111,3194,80917,0.9620263699159444,22.960643555555556,3319.495392,12.920082907559944,129,4.6000000000000056E-4
6,test_20231101_135419,10350842.png,212614,5279,207335,0.9751709671047062,1,3,42529,776,41753,0.9817536269369136,19.566787555555557,2433.533258666667,14.268430748223048,129,4.6000000000000056E-4
7,test_20231101_135419,10863862.png,317432,7562,309870,0.9761775750396935,1,4,66058,1104,64954,0.9832874140906476,35.66071822222222,6506.869162666667,9.99708286653367,129,4.6000000000000056E-4
8,test_20231101_135419,11382381.png,312486,587,311899,0.9981215158439098,1,8,46745,78,46667,0.9983313723392876,21.967536,2569.068496,14.03304677372966,129,4.6000000000000056E-4
9,test_20231101_135419,11079715.png,443815,110349,333466,0.7513626173067607,3,5,124136,15456,108680,0.8754913965328349,17.57312,2279.878944,14.551685732308561,129,4.6000000000000056E-4
10,test_20231101_135419,11551286.png,271883,267,271616,0.9990179599312939,2,3,40092,37,40055,0.9990771226179787,18.016108444444445,1877.54488,15.394900338849709,129,4.6000000000000056E-4
1,test_20231101_135420,10404007.png,502730,16847,485883,0.9664889702225847,3,3,61265,2450,58815,0.9600097935199543,26.172988444444446,3556.890048,12.62009920558409,129,4.700000000000006E-4
2,test_20231101_135420,1254659.png,342646,67139,275507,0.8040572485889227,3,4,80080,9434,70646,0.8821928071928072,21.694814222222224,3426.7694133333334,12.781954790485319,129,4.700000000000006E-4
3,test_20231101_135420,10188041.png,221231,8867,212364,0.9599197219196225,2,3,41731,1256,40475,0.9699024705854161,11.256714666666667,1169.479648,17.450876925151316,129,4.700000000000006E-4
4,test_20231101_135420,10287332.png,216980,11579,205401,0.9466356346207023,1,4,22337,1590,20747,0.9288176568026145,9.629411555555556,829.9726293333333,18.940165903297878,129,4.700000000000006E-4
5,test_20231101_135420,11610969.png,368720,21849,346871,0.9407436537209807,2,4,84111,3194,80917,0.9620263699159444,22.960643555555556,3319.495392,12.920082907559944,129,4.700000000000006E-4
6,test_20231101_135420,10350842.png,212614,5279,207335,0.9751709671047062,1,3,42529,776,41753,0.9817536269369136,19.566787555555557,2433.533258666667,14.268430748223048,129,4.700000000000006E-4
7,test_20231101_135420,10863862.png,317432,7562,309870,0.9761775750396935,1,4,66058,1104,64954,0.9832874140906476,35.66071822222222,6506.869162666667,9.99708286653367,129,4.700000000000006E-4
8,test_20231101_135420,11382381.png,312486,587,311899,0.9981215158439098,1,3,46745,78,46667,0.9983313723392876,21.967536,2569.068496,14.03304677372966,129,4.700000000000006E-4
9,test_20231101_135420,11079715.png,443815,110349,333466,0.7513626173067607,3,4,124136,15456,108680,0.8754913965328349,17.57312,2279.878944,14.551685732308561,129,4.700000000000006E-4
10,test_20231101_135420,11551286.png,271883,267,271616,0.9990179599312939,1,3,40092,37,40055,0.9990771226179787,18.016108444444445,1877.54488,15.394900338849709,129,4.700000000000006E-4
1,test_20231101_135421,10404007.png,502730,16847,485883,0.9664889702225847,2,4,61265,2450,58815,0.9600097935199543,26.172988444444446,3556.890048,12.62009920558409,129,4.800000000000006E-4
2,test_20231101_135421,1254659.png,342646,67139,275507,0.8040572485889227,3,4,80080,9434,70646,0.8821928071928072,21.694814222222224,3426.7694133333334,12.781954790485319,129,4.800000000000006E-4
3,test_20231101_135421,10188041.png,221231,8867,212364,0.9599197219196225,2,4,41731,1256,40475,0.9699024705854161,11.256714666666667,1169.479648,17.450876925151316,129,4.800000000000006E-4
4,test_20231101_135421,10287332.png,216980,11579,205401,0.9466356346207023,1,3,22337,1590,20747,0.9288176568026145,9.629411555555556,829.9726293333333,18.940165903297878,129,4.800000000000006E-4
5,test_20231101_135421,11610969.png,368720,21849,346871,0.9407436537209807,2,4,84111,3194,80917,0.9620263699159444,22.960643555555556,3319.495392,12.920082907559944,129,4.800000000000006E-4
6,test_20231101_135421,10350842.png,212614,5279,207335,0.9751709671047062,2,3,42529,776,41753,0.9817536269369136,19.566787555555557,2433.533258666667,14.268430748223048,129,4.800000000000006E-4
7,test_20231101_135421,10863862.png,317432,7562,309870,0.9761775750396935,2,3,66058,1104,64954,0.9832874140906476,35.66071822222222,6506.869162666667,9.99708286653367,129,4.800000000000006E-4
8,test_20231101_135421,11382381.png,312486,587,311899,0.9981215158439098,2,4,46745,78,46667,0.9983313723392876,21.967536,2569.068496,14.03304677372966,129,4.800000000000006E-4
9,test_20231101_135421,11079715.png,443815,110349,333466,0.7513626173067607,4,4,124136,15456,108680,0.8754913965328349,17.57312,2279.878944,14.551685732308561,129,4.800000000000006E-4
10,test_20231101_135421,11551286.png,271883,267,271616,0.9990179599312939,1,4,40092,37,40055,0.9990771226179787,18.016108444444445,1877.54488,15.394900338849709,129,4.800000000000006E-4
1,test_20231101_135421,10404007.png,502730,16847,485883,0.9664889702225847,2,4,61265,2450,58815,0.9600097935199543,26.172988444444446,3556.890048,12.62009920558409,129,4.900000000000006E-4
2,test_20231101_135421,1254659.png,342646,67139,275507,0.8040572485889227,3,5,80080,9434,70646,0.8821928071928072,21.694814222222224,3426.7694133333334,12.781954790485319,129,4.900000000000006E-4
3,test_20231101_135421,10188041.png,221231,8867,212364,0.9599197219196225,2,4,41731,1256,40475,0.9699024705854161,11.256714666666667,1169.479648,17.450876925151316,129,4.900000000000006E-4
4,test_20231101_135421,10287332.png,216980,11579,205401,0.9466356346207023,4,4,22337,1590,20747,0.9288176568026145,9.629411555555556,829.9726293333333,18.940165903297878,129,4.900000000000006E-4
5,test_20231101_135421,11610969.png,368720,21849,346871,0.9407436537209807,2,4,84111,3194,80917,0.9620263699159444,22.960643555555556,3319.495392,12.920082907559944,129,4.900000000000006E-4
6,test_20231101_135421,10350842.png,212614,5279,207335,0.9751709671047062,1,4,42529,776,41753,0.9817536269369136,19.566787555555557,2433.533258666667,14.268430748223048,129,4.900000000000006E-4
7,test_20231101_135421,10863862.png,317432,7562,309870,0.9761775750396935,2,4,66058,1104,64954,0.9832874140906476,35.66071822222222,6506.869162666667,9.99708286653367,129,4.900000000000006E-4
8,test_20231101_135421,11382381.png,312486,587,311899,0.9981215158439098,1,4,46745,78,46667,0.9983313723392876,21.967536,2569.068496,14.03304677372966,129,4.900000000000006E-4
9,test_20231101_135421,11079715.png,443815,110349,333466,0.7513626173067607,3,5,124136,15456,108680,0.8754913965328349,17.57312,2279.878944,14.551685732308561,129,4.900000000000006E-4
10,test_20231101_135421,11551286.png,271883,267,271616,0.9990179599312939,1,3,40092,37,40055,0.9990771226179787,18.016108444444445,1877.54488,15.394900338849709,129,4.900000000000006E-4
1,test_20231101_135422,10404007.png,502730,16847,485883,0.9664889702225847,2,4,61265,2450,58815,0.9600097935199543,26.172988444444446,3556.890048,12.62009920558409,129,5.000000000000007E-4
2,test_20231101_135422,1254659.png,342646,67139,275507,0.8040572485889227,3,4,80080,9434,70646,0.8821928071928072,21.694814222222224,3426.7694133333334,12.781954790485319,129,5.000000000000007E-4
3,test_20231101_135422,10188041.png,221231,8867,212364,0.9599197219196225,3,4,41731,1256,40475,0.9699024705854161,11.256714666666667,1169.479648,17.450876925151316,129,5.000000000000007E-4
4,test_20231101_135422,10287332.png,216980,11579,205401,0.9466356346207023,2,3,22337,1590,20747,0.9288176568026145,9.629411555555556,829.9726293333333,18.940165903297878,129,5.000000000000007E-4
5,test_20231101_135422,11610969.png,368720,21849,346871,0.9407436537209807,2,3,84111,3194,80917,0.9620263699159444,22.960643555555556,3319.495392,12.920082907559944,129,5.000000000000007E-4
6,test_20231101_135422,10350842.png,212614,5279,207335,0.9751709671047062,2,12,42529,776,41753,0.9817536269369136,19.566787555555557,2433.533258666667,14.268430748223048,129,5.000000000000007E-4
7,test_20231101_135422,10863862.png,317432,7562,309870,0.9761775750396935,2,3,66058,1104,64954,0.9832874140906476,35.66071822222222,6506.869162666667,9.99708286653367,129,5.000000000000007E-4
8,test_20231101_135422,11382381.png,312486,587,311899,0.9981215158439098,1,3,46745,78,46667,0.9983313723392876,21.967536,2569.068496,14.03304677372966,129,5.000000000000007E-4
9,test_20231101_135422,11079715.png,443815,110349,333466,0.7513626173067607,3,4,124136,15456,108680,0.8754913965328349,17.57312,2279.878944,14.551685732308561,129,5.000000000000007E-4
10,test_20231101_135422,11551286.png,271883,267,271616,0.9990179599312939,1,3,40092,37,40055,0.9990771226179787,18.016108444444445,1877.54488,15.394900338849709,129,5.000000000000007E-4
1,test_20231101_135423,10404007.png,502730,16847,485883,0.9664889702225847,2,3,61265,2450,58815,0.9600097935199543,26.172988444444446,3556.890048,12.62009920558409,129,5.100000000000007E-4
2,test_20231101_135423,1254659.png,342646,67139,275507,0.8040572485889227,3,4,80080,9434,70646,0.8821928071928072,21.694814222222224,3426.7694133333334,12.781954790485319,129,5.100000000000007E-4
3,test_20231101_135423,10188041.png,221231,8687,212544,0.9607333511126379,2,4,41731,1231,40500,0.9705015456135726,11.477532444444444,1204.0505066666667,17.324356560835014,129,5.100000000000007E-4
4,test_20231101_135423,10287332.png,216980,11579,205401,0.9466356346207023,2,3,22337,1590,20747,0.9288176568026145,9.629411555555556,829.9726293333333,18.940165903297878,129,5.100000000000007E-4
5,test_20231101_135423,11610969.png,368720,21809,346911,0.9408521371230202,2,3,84111,3190,80921,0.9620739261214347,23.338673777777778,3382.608032,12.838286851023904,129,5.100000000000007E-4
6,test_20231101_135423,10350842.png,212614,5279,207335,0.9751709671047062,2,4,42529,776,41753,0.9817536269369136,19.566787555555557,2433.533258666667,14.268430748223048,129,5.100000000000007E-4
7,test_20231101_135423,10863862.png,317432,7459,309973,0.9765020539832153,2,3,66058,1091,64967,0.983484210845015,35.780739555555556,6527.049354666667,9.983634642163107,129,5.100000000000007E-4
8,test_20231101_135423,11382381.png,312486,587,311899,0.9981215158439098,1,4,46745,78,46667,0.9983313723392876,21.967536,2569.068496,14.03304677372966,129,5.100000000000007E-4
9,test_20231101_135423,11079715.png,443815,110169,333646,0.7517681917014972,3,4,124136,15429,108707,0.8757088999162209,17.810384,2321.88808,14.47239078889067,129,5.100000000000007E-4
10,test_20231101_135423,11551286.png,271883,267,271616,0.9990179599312939,1,3,40092,37,40055,0.9990771226179787,18.016108444444445,1877.54488,15.394900338849709,129,5.100000000000007E-4
1,test_20231101_135424,10404007.png,502730,16847,485883,0.9664889702225847,2,4,61265,2450,58815,0.9600097935199543,26.172988444444446,3556.890048,12.62009920558409,129,5.200000000000007E-4
2,test_20231101_135424,1254659.png,342646,67139,275507,0.8040572485889227,2,3,80080,9434,70646,0.8821928071928072,21.694814222222224,3426.7694133333334,12.781954790485319,129,5.200000000000007E-4
3,test_20231101_135424,10188041.png,221231,8687,212544,0.9607333511126379,2,3,41731,1231,40500,0.9705015456135726,11.477532444444444,1204.0505066666667,17.324356560835014,129,5.200000000000007E-4
4,test_20231101_135424,10287332.png,216980,11579,205401,0.9466356346207023,2,4,22337,1590,20747,0.9288176568026145,9.629411555555556,829.9726293333333,18.940165903297878,129,5.200000000000007E-4
5,test_20231101_135424,11610969.png,368720,21809,346911,0.9408521371230202,3,4,84111,3190,80921,0.9620739261214347,23.338673777777778,3382.608032,12.838286851023904,129,5.200000000000007E-4
6,test_20231101_135424,10350842.png,212614,5279,207335,0.9751709671047062,2,4,42529,776,41753,0.9817536269369136,19.566787555555557,2433.533258666667,14.268430748223048,129,5.200000000000007E-4
7,test_20231101_135424,10863862.png,317432,7459,309973,0.9765020539832153,2,4,66058,1091,64967,0.983484210845015,35.780739555555556,6527.049354666667,9.983634642163107,129,5.200000000000007E-4
8,test_20231101_135424,11382381.png,312486,587,311899,0.9981215158439098,1,4,46745,78,46667,0.9983313723392876,21.967536,2569.068496,14.03304677372966,129,5.200000000000007E-4
9,test_20231101_135424,11079715.png,443815,110169,333646,0.7517681917014972,3,4,124136,15429,108707,0.8757088999162209,17.810384,2321.88808,14.47239078889067,129,5.200000000000007E-4
10,test_20231101_135424,11551286.png,271883,267,271616,0.9990179599312939,2,3,40092,37,40055,0.9990771226179787,18.016108444444445,1877.54488,15.394900338849709,129,5.200000000000007E-4
1,test_20231101_135424,10404007.png,502730,16847,485883,0.9664889702225847,2,3,61265,2450,58815,0.9600097935199543,26.172988444444446,3556.890048,12.62009920558409,129,5.300000000000007E-4
2,test_20231101_135424,1254659.png,342646,67139,275507,0.8040572485889227,3,4,80080,9434,70646,0.8821928071928072,21.694814222222224,3426.7694133333334,12.781954790485319,129,5.300000000000007E-4
3,test_20231101_135424,10188041.png,221231,8687,212544,0.9607333511126379,2,4,41731,1231,40500,0.9705015456135726,11.477532444444444,1204.0505066666667,17.324356560835014,129,5.300000000000007E-4
4,test_20231101_135424,10287332.png,216980,11579,205401,0.9466356346207023,2,4,22337,1590,20747,0.9288176568026145,9.629411555555556,829.9726293333333,18.940165903297878,129,5.300000000000007E-4
5,test_20231101_135424,11610969.png,368720,21809,346911,0.9408521371230202,2,4,84111,3190,80921,0.9620739261214347,23.338673777777778,3382.608032,12.838286851023904,129,5.300000000000007E-4
6,test_20231101_135424,10350842.png,212614,5279,207335,0.9751709671047062,1,3,42529,776,41753,0.9817536269369136,19.566787555555557,2433.533258666667,14.268430748223048,129,5.300000000000007E-4
7,test_20231101_135424,10863862.png,317432,7459,309973,0.9765020539832153,1,4,66058,1091,64967,0.983484210845015,35.780739555555556,6527.049354666667,9.983634642163107,129,5.300000000000007E-4
8,test_20231101_135424,11382381.png,312486,587,311899,0.9981215158439098,2,3,46745,78,46667,0.9983313723392876,21.967536,2569.068496,14.03304677372966,129,5.300000000000007E-4
9,test_20231101_135424,11079715.png,443815,110169,333646,0.7517681917014972,3,4,124136,15429,108707,0.8757088999162209,17.810384,2321.88808,14.47239078889067,129,5.300000000000007E-4
10,test_20231101_135424,11551286.png,271883,267,271616,0.9990179599312939,1,4,40092,37,40055,0.9990771226179787,18.016108444444445,1877.54488,15.394900338849709,129,5.300000000000007E-4
1,test_20231101_135425,10404007.png,502730,16847,485883,0.9664889702225847,2,3,61265,2450,58815,0.9600097935199543,26.172988444444446,3556.890048,12.62009920558409,129,5.400000000000008E-4
2,test_20231101_135425,1254659.png,342646,67139,275507,0.8040572485889227,3,4,80080,9434,70646,0.8821928071928072,21.694814222222224,3426.7694133333334,12.781954790485319,129,5.400000000000008E-4
3,test_20231101_135425,10188041.png,221231,8687,212544,0.9607333511126379,2,3,41731,1231,40500,0.9705015456135726,11.477532444444444,1204.0505066666667,17.324356560835014,129,5.400000000000008E-4
4,test_20231101_135425,10287332.png,216980,11579,205401,0.9466356346207023,1,3,22337,1590,20747,0.9288176568026145,9.629411555555556,829.9726293333333,18.940165903297878,129,5.400000000000008E-4
5,test_20231101_135425,11610969.png,368720,21809,346911,0.9408521371230202,2,4,84111,3190,80921,0.9620739261214347,23.338673777777778,3382.608032,12.838286851023904,129,5.400000000000008E-4
6,test_20231101_135425,10350842.png,212614,5279,207335,0.9751709671047062,1,4,42529,776,41753,0.9817536269369136,19.566787555555557,2433.533258666667,14.268430748223048,129,5.400000000000008E-4
7,test_20231101_135425,10863862.png,317432,7459,309973,0.9765020539832153,2,3,66058,1091,64967,0.983484210845015,35.780739555555556,6527.049354666667,9.983634642163107,129,5.400000000000008E-4
8,test_20231101_135425,11382381.png,312486,587,311899,0.9981215158439098,2,4,46745,78,46667,0.9983313723392876,21.967536,2569.068496,14.03304677372966,129,5.400000000000008E-4
9,test_20231101_135425,11079715.png,443815,110169,333646,0.7517681917014972,3,5,124136,15429,108707,0.8757088999162209,17.810384,2321.88808,14.47239078889067,129,5.400000000000008E-4
10,test_20231101_135425,11551286.png,271883,267,271616,0.9990179599312939,1,4,40092,37,40055,0.9990771226179787,18.016108444444445,1877.54488,15.394900338849709,129,5.400000000000008E-4
1,test_20231101_135426,10404007.png,502730,16847,485883,0.9664889702225847,2,4,61265,2450,58815,0.9600097935199543,26.172988444444446,3556.890048,12.62009920558409,129,5.500000000000008E-4
2,test_20231101_135426,1254659.png,342646,67139,275507,0.8040572485889227,3,4,80080,9434,70646,0.8821928071928072,21.694814222222224,3426.7694133333334,12.781954790485319,129,5.500000000000008E-4
3,test_20231101_135426,10188041.png,221231,8687,212544,0.9607333511126379,2,4,41731,1231,40500,0.9705015456135726,11.477532444444444,1204.0505066666667,17.324356560835014,129,5.500000000000008E-4
4,test_20231101_135426,10287332.png,216980,11579,205401,0.9466356346207023,2,3,22337,1590,20747,0.9288176568026145,9.629411555555556,829.9726293333333,18.940165903297878,129,5.500000000000008E-4
5,test_20231101_135426,11610969.png,368720,21809,346911,0.9408521371230202,3,4,84111,3190,80921,0.9620739261214347,23.338673777777778,3382.608032,12.838286851023904,129,5.500000000000008E-4
6,test_20231101_135426,10350842.png,212614,5279,207335,0.9751709671047062,2,4,42529,776,41753,0.9817536269369136,19.566787555555557,2433.533258666667,14.268430748223048,129,5.500000000000008E-4
7,test_20231101_135426,10863862.png,317432,7459,309973,0.9765020539832153,2,3,66058,1091,64967,0.983484210845015,35.780739555555556,6527.049354666667,9.983634642163107,129,5.500000000000008E-4
8,test_20231101_135426,11382381.png,312486,587,311899,0.9981215158439098,1,3,46745,78,46667,0.9983313723392876,21.967536,2569.068496,14.03304677372966,129,5.500000000000008E-4
9,test_20231101_135426,11079715.png,443815,110169,333646,0.7517681917014972,3,4,124136,15429,108707,0.8757088999162209,17.810384,2321.88808,14.47239078889067,129,5.500000000000008E-4
10,test_20231101_135426,11551286.png,271883,267,271616,0.9990179599312939,1,4,40092,37,40055,0.9990771226179787,18.016108444444445,1877.54488,15.394900338849709,129,5.500000000000008E-4
1,test_20231101_135426,10404007.png,502730,16847,485883,0.9664889702225847,2,4,61265,2450,58815,0.9600097935199543,26.172988444444446,3556.890048,12.62009920558409,129,5.600000000000008E-4
2,test_20231101_135426,1254659.png,342646,67139,275507,0.8040572485889227,3,4,80080,9434,70646,0.8821928071928072,21.694814222222224,3426.7694133333334,12.781954790485319,129,5.600000000000008E-4
3,test_20231101_135426,10188041.png,221231,8687,212544,0.9607333511126379,2,3,41731,1231,40500,0.9705015456135726,11.477532444444444,1204.0505066666667,17.324356560835014,129,5.600000000000008E-4
4,test_20231101_135426,10287332.png,216980,11579,205401,0.9466356346207023,1,3,22337,1590,20747,0.9288176568026145,9.629411555555556,829.9726293333333,18.940165903297878,129,5.600000000000008E-4
5,test_20231101_135426,11610969.png,368720,21809,346911,0.9408521371230202,2,4,84111,3190,80921,0.9620739261214347,23.338673777777778,3382.608032,12.838286851023904,129,5.600000000000008E-4
6,test_20231101_135426,10350842.png,212614,5279,207335,0.9751709671047062,2,4,42529,776,41753,0.9817536269369136,19.566787555555557,2433.533258666667,14.268430748223048,129,5.600000000000008E-4
7,test_20231101_135426,10863862.png,317432,7459,309973,0.9765020539832153,2,3,66058,1091,64967,0.983484210845015,35.780739555555556,6527.049354666667,9.983634642163107,129,5.600000000000008E-4
8,test_20231101_135426,11382381.png,312486,587,311899,0.9981215158439098,2,3,46745,78,46667,0.9983313723392876,21.967536,2569.068496,14.03304677372966,129,5.600000000000008E-4
9,test_20231101_135426,11079715.png,443815,110169,333646,0.7517681917014972,4,4,124136,15429,108707,0.8757088999162209,17.810384,2321.88808,14.47239078889067,129,5.600000000000008E-4
10,test_20231101_135426,11551286.png,271883,267,271616,0.9990179599312939,2,4,40092,37,40055,0.9990771226179787,18.016108444444445,1877.54488,15.394900338849709,129,5.600000000000008E-4
1,test_20231101_135427,10404007.png,502730,16847,485883,0.9664889702225847,3,3,61265,2450,58815,0.9600097935199543,26.172988444444446,3556.890048,12.62009920558409,129,5.700000000000008E-4
2,test_20231101_135427,1254659.png,342646,67139,275507,0.8040572485889227,3,4,80080,9434,70646,0.8821928071928072,21.694814222222224,3426.7694133333334,12.781954790485319,129,5.700000000000008E-4
3,test_20231101_135427,10188041.png,221231,8687,212544,0.9607333511126379,2,4,41731,1231,40500,0.9705015456135726,11.477532444444444,1204.0505066666667,17.324356560835014,129,5.700000000000008E-4
4,test_20231101_135427,10287332.png,216980,11579,205401,0.9466356346207023,2,3,22337,1590,20747,0.9288176568026145,9.629411555555556,829.9726293333333,18.940165903297878,129,5.700000000000008E-4
5,test_20231101_135427,11610969.png,368720,21809,346911,0.9408521371230202,2,4,84111,3190,80921,0.9620739261214347,23.338673777777778,3382.608032,12.838286851023904,129,5.700000000000008E-4
6,test_20231101_135427,10350842.png,212614,5279,207335,0.9751709671047062,2,3,42529,776,41753,0.9817536269369136,19.566787555555557,2433.533258666667,14.268430748223048,129,5.700000000000008E-4
7,test_20231101_135427,10863862.png,317432,7459,309973,0.9765020539832153,2,3,66058,1091,64967,0.983484210845015,35.780739555555556,6527.049354666667,9.983634642163107,129,5.700000000000008E-4
8,test_20231101_135427,11382381.png,312486,587,311899,0.9981215158439098,1,4,46745,78,46667,0.9983313723392876,21.967536,2569.068496,14.03304677372966,129,5.700000000000008E-4
9,test_20231101_135427,11079715.png,443815,110169,333646,0.7517681917014972,3,4,124136,15429,108707,0.8757088999162209,17.810384,2321.88808,14.47239078889067,129,5.700000000000008E-4
10,test_20231101_135427,11551286.png,271883,267,271616,0.9990179599312939,1,3,40092,37,40055,0.9990771226179787,18.016108444444445,1877.54488,15.394900338849709,129,5.700000000000008E-4
1,test_20231101_135428,10404007.png,502730,16847,485883,0.9664889702225847,2,4,61265,2450,58815,0.9600097935199543,26.172988444444446,3556.890048,12.62009920558409,129,5.800000000000009E-4
2,test_20231101_135428,1254659.png,342646,67139,275507,0.8040572485889227,4,4,80080,9434,70646,0.8821928071928072,21.694814222222224,3426.7694133333334,12.781954790485319,129,5.800000000000009E-4
3,test_20231101_135428,10188041.png,221231,8687,212544,0.9607333511126379,2,3,41731,1231,40500,0.9705015456135726,11.477532444444444,1204.0505066666667,17.324356560835014,129,5.800000000000009E-4
4,test_20231101_135428,10287332.png,216980,11579,205401,0.9466356346207023,1,3,22337,1590,20747,0.9288176568026145,9.629411555555556,829.9726293333333,18.940165903297878,129,5.800000000000009E-4
5,test_20231101_135428,11610969.png,368720,21809,346911,0.9408521371230202,2,3,84111,3190,80921,0.9620739261214347,23.338673777777778,3382.608032,12.838286851023904,129,5.800000000000009E-4
6,test_20231101_135428,10350842.png,212614,5279,207335,0.9751709671047062,1,3,42529,776,41753,0.9817536269369136,19.566787555555557,2433.533258666667,14.268430748223048,129,5.800000000000009E-4
7,test_20231101_135428,10863862.png,317432,7459,309973,0.9765020539832153,1,3,66058,1091,64967,0.983484210845015,35.780739555555556,6527.049354666667,9.983634642163107,129,5.800000000000009E-4
8,test_20231101_135428,11382381.png,312486,567,311919,0.9981855187112383,2,4,46745,75,46670,0.9983955503262381,22.72423288888889,2714.741744,13.793518398308729,129,5.800000000000009E-4
9,test_20231101_135428,11079715.png,443815,110169,333646,0.7517681917014972,4,5,124136,15429,108707,0.8757088999162209,17.810384,2321.88808,14.47239078889067,129,5.800000000000009E-4
10,test_20231101_135428,11551286.png,271883,267,271616,0.9990179599312939,1,4,40092,37,40055,0.9990771226179787,18.016108444444445,1877.54488,15.394900338849709,129,5.800000000000009E-4
1,test_20231101_135428,10404007.png,502730,16847,485883,0.9664889702225847,3,4,61265,2450,58815,0.9600097935199543,26.172988444444446,3556.890048,12.62009920558409,129,5.900000000000009E-4
2,test_20231101_135428,1254659.png,342646,67139,275507,0.8040572485889227,4,4,80080,9434,70646,0.8821928071928072,21.694814222222224,3426.7694133333334,12.781954790485319,129,5.900000000000009E-4
3,test_20231101_135428,10188041.png,221231,8687,212544,0.9607333511126379,2,4,41731,1231,40500,0.9705015456135726,11.477532444444444,1204.0505066666667,17.324356560835014,129,5.900000000000009E-4
4,test_20231101_135428,10287332.png,216980,11579,205401,0.9466356346207023,2,13,22337,1590,20747,0.9288176568026145,9.629411555555556,829.9726293333333,18.940165903297878,129,5.900000000000009E-4
5,test_20231101_135428,11610969.png,368720,21809,346911,0.9408521371230202,3,4,84111,3190,80921,0.9620739261214347,23.338673777777778,3382.608032,12.838286851023904,129,5.900000000000009E-4
6,test_20231101_135428,10350842.png,212614,5279,207335,0.9751709671047062,2,4,42529,776,41753,0.9817536269369136,19.566787555555557,2433.533258666667,14.268430748223048,129,5.900000000000009E-4
7,test_20231101_135428,10863862.png,317432,7459,309973,0.9765020539832153,1,4,66058,1091,64967,0.983484210845015,35.780739555555556,6527.049354666667,9.983634642163107,129,5.900000000000009E-4
8,test_20231101_135428,11382381.png,312486,567,311919,0.9981855187112383,2,4,46745,75,46670,0.9983955503262381,22.72423288888889,2714.741744,13.793518398308729,129,5.900000000000009E-4
9,test_20231101_135428,11079715.png,443815,110169,333646,0.7517681917014972,4,4,124136,15429,108707,0.8757088999162209,17.810384,2321.88808,14.47239078889067,129,5.900000000000009E-4
10,test_20231101_135428,11551286.png,271883,267,271616,0.9990179599312939,2,4,40092,37,40055,0.9990771226179787,18.016108444444445,1877.54488,15.394900338849709,129,5.900000000000009E-4
1,test_20231101_135429,10404007.png,502730,16847,485883,0.9664889702225847,2,4,61265,2450,58815,0.9600097935199543,26.172988444444446,3556.890048,12.62009920558409,129,6.000000000000009E-4
2,test_20231101_135429,1254659.png,342646,67139,275507,0.8040572485889227,3,4,80080,9434,70646,0.8821928071928072,21.694814222222224,3426.7694133333334,12.781954790485319,129,6.000000000000009E-4
3,test_20231101_135429,10188041.png,221231,8687,212544,0.9607333511126379,3,4,41731,1231,40500,0.9705015456135726,11.477532444444444,1204.0505066666667,17.324356560835014,129,6.000000000000009E-4
4,test_20231101_135429,10287332.png,216980,11579,205401,0.9466356346207023,2,4,22337,1590,20747,0.9288176568026145,9.629411555555556,829.9726293333333,18.940165903297878,129,6.000000000000009E-4
5,test_20231101_135429,11610969.png,368720,21809,346911,0.9408521371230202,2,4,84111,3190,80921,0.9620739261214347,23.338673777777778,3382.608032,12.838286851023904,129,6.000000000000009E-4
6,test_20231101_135429,10350842.png,212614,5279,207335,0.9751709671047062,2,4,42529,776,41753,0.9817536269369136,19.566787555555557,2433.533258666667,14.268430748223048,129,6.000000000000009E-4
7,test_20231101_135429,10863862.png,317432,7459,309973,0.9765020539832153,2,4,66058,1091,64967,0.983484210845015,35.780739555555556,6527.049354666667,9.983634642163107,129,6.000000000000009E-4
8,test_20231101_135429,11382381.png,312486,567,311919,0.9981855187112383,1,3,46745,75,46670,0.9983955503262381,22.72423288888889,2714.741744,13.793518398308729,129,6.000000000000009E-4
9,test_20231101_135429,11079715.png,443815,110169,333646,0.7517681917014972,3,4,124136,15429,108707,0.8757088999162209,17.810384,2321.88808,14.47239078889067,129,6.000000000000009E-4
10,test_20231101_135429,11551286.png,271883,267,271616,0.9990179599312939,2,3,40092,37,40055,0.9990771226179787,18.016108444444445,1877.54488,15.394900338849709,129,6.000000000000009E-4
1,test_20231101_135430,10404007.png,502730,16847,485883,0.9664889702225847,2,3,61265,2450,58815,0.9600097935199543,26.172988444444446,3556.890048,12.62009920558409,129,6.10000000000001E-4
2,test_20231101_135430,1254659.png,342646,67139,275507,0.8040572485889227,3,4,80080,9434,70646,0.8821928071928072,21.694814222222224,3426.7694133333334,12.781954790485319,129,6.10000000000001E-4
3,test_20231101_135430,10188041.png,221231,8687,212544,0.9607333511126379,2,4,41731,1231,40500,0.9705015456135726,11.477532444444444,1204.0505066666667,17.324356560835014,129,6.10000000000001E-4
4,test_20231101_135430,10287332.png,216980,11579,205401,0.9466356346207023,1,4,22337,1590,20747,0.9288176568026145,9.629411555555556,829.9726293333333,18.940165903297878,129,6.10000000000001E-4
5,test_20231101_135430,11610969.png,368720,21809,346911,0.9408521371230202,2,4,84111,3190,80921,0.9620739261214347,23.338673777777778,3382.608032,12.838286851023904,129,6.10000000000001E-4
6,test_20231101_135430,10350842.png,212614,5279,207335,0.9751709671047062,2,4,42529,776,41753,0.9817536269369136,19.566787555555557,2433.533258666667,14.268430748223048,129,6.10000000000001E-4
7,test_20231101_135430,10863862.png,317432,7459,309973,0.9765020539832153,2,4,66058,1091,64967,0.983484210845015,35.780739555555556,6527.049354666667,9.983634642163107,129,6.10000000000001E-4
8,test_20231101_135430,11382381.png,312486,567,311919,0.9981855187112383,1,3,46745,75,46670,0.9983955503262381,22.72423288888889,2714.741744,13.793518398308729,129,6.10000000000001E-4
9,test_20231101_135430,11079715.png,443815,110169,333646,0.7517681917014972,5,5,124136,15429,108707,0.8757088999162209,17.810384,2321.88808,14.47239078889067,129,6.10000000000001E-4
10,test_20231101_135430,11551286.png,271883,267,271616,0.9990179599312939,2,3,40092,37,40055,0.9990771226179787,18.016108444444445,1877.54488,15.394900338849709,129,6.10000000000001E-4
1,test_20231101_135431,10404007.png,502730,16847,485883,0.9664889702225847,3,4,61265,2450,58815,0.9600097935199543,26.172988444444446,3556.890048,12.62009920558409,129,6.20000000000001E-4
2,test_20231101_135431,1254659.png,342646,67139,275507,0.8040572485889227,3,12,80080,9434,70646,0.8821928071928072,21.694814222222224,3426.7694133333334,12.781954790485319,129,6.20000000000001E-4
3,test_20231101_135431,10188041.png,221231,8687,212544,0.9607333511126379,2,4,41731,1231,40500,0.9705015456135726,11.477532444444444,1204.0505066666667,17.324356560835014,129,6.20000000000001E-4
4,test_20231101_135431,10287332.png,216980,11579,205401,0.9466356346207023,2,3,22337,1590,20747,0.9288176568026145,9.629411555555556,829.9726293333333,18.940165903297878,129,6.20000000000001E-4
5,test_20231101_135431,11610969.png,368720,21809,346911,0.9408521371230202,2,4,84111,3190,80921,0.9620739261214347,23.338673777777778,3382.608032,12.838286851023904,129,6.20000000000001E-4
6,test_20231101_135431,10350842.png,212614,5279,207335,0.9751709671047062,1,4,42529,776,41753,0.9817536269369136,19.566787555555557,2433.533258666667,14.268430748223048,129,6.20000000000001E-4
7,test_20231101_135431,10863862.png,317432,7459,309973,0.9765020539832153,1,4,66058,1091,64967,0.983484210845015,35.780739555555556,6527.049354666667,9.983634642163107,129,6.20000000000001E-4
8,test_20231101_135431,11382381.png,312486,567,311919,0.9981855187112383,1,4,46745,75,46670,0.9983955503262381,22.72423288888889,2714.741744,13.793518398308729,129,6.20000000000001E-4
9,test_20231101_135431,11079715.png,443815,110169,333646,0.7517681917014972,3,4,124136,15429,108707,0.8757088999162209,17.810384,2321.88808,14.47239078889067,129,6.20000000000001E-4
10,test_20231101_135431,11551286.png,271883,267,271616,0.9990179599312939,1,3,40092,37,40055,0.9990771226179787,18.016108444444445,1877.54488,15.394900338849709,129,6.20000000000001E-4
1,test_20231101_135431,10404007.png,502730,16847,485883,0.9664889702225847,3,4,61265,2450,58815,0.9600097935199543,26.172988444444446,3556.890048,12.62009920558409,129,6.30000000000001E-4
2,test_20231101_135431,1254659.png,342646,67139,275507,0.8040572485889227,2,4,80080,9434,70646,0.8821928071928072,21.694814222222224,3426.7694133333334,12.781954790485319,129,6.30000000000001E-4
3,test_20231101_135431,10188041.png,221231,8687,212544,0.9607333511126379,2,3,41731,1231,40500,0.9705015456135726,11.477532444444444,1204.0505066666667,17.324356560835014,129,6.30000000000001E-4
4,test_20231101_135431,10287332.png,216980,11579,205401,0.9466356346207023,1,3,22337,1590,20747,0.9288176568026145,9.629411555555556,829.9726293333333,18.940165903297878,129,6.30000000000001E-4
5,test_20231101_135431,11610969.png,368720,21809,346911,0.9408521371230202,2,4,84111,3190,80921,0.9620739261214347,23.338673777777778,3382.608032,12.838286851023904,129,6.30000000000001E-4
6,test_20231101_135431,10350842.png,212614,5279,207335,0.9751709671047062,1,4,42529,776,41753,0.9817536269369136,19.566787555555557,2433.533258666667,14.268430748223048,129,6.30000000000001E-4
7,test_20231101_135431,10863862.png,317432,7459,309973,0.9765020539832153,2,4,66058,1091,64967,0.983484210845015,35.780739555555556,6527.049354666667,9.983634642163107,129,6.30000000000001E-4
8,test_20231101_135431,11382381.png,312486,567,311919,0.9981855187112383,1,3,46745,75,46670,0.9983955503262381,22.72423288888889,2714.741744,13.793518398308729,129,6.30000000000001E-4
9,test_20231101_135431,11079715.png,443815,110169,333646,0.7517681917014972,4,8,124136,15429,108707,0.8757088999162209,17.810384,2321.88808,14.47239078889067,129,6.30000000000001E-4
10,test_20231101_135431,11551286.png,271883,267,271616,0.9990179599312939,2,3,40092,37,40055,0.9990771226179787,18.016108444444445,1877.54488,15.394900338849709,129,6.30000000000001E-4
1,test_20231101_135432,10404007.png,502730,16847,485883,0.9664889702225847,6,3,61265,2450,58815,0.9600097935199543,26.172988444444446,3556.890048,12.62009920558409,129,6.40000000000001E-4
2,test_20231101_135432,1254659.png,342646,67139,275507,0.8040572485889227,6,4,80080,9434,70646,0.8821928071928072,21.694814222222224,3426.7694133333334,12.781954790485319,129,6.40000000000001E-4
3,test_20231101_135432,10188041.png,221231,8687,212544,0.9607333511126379,2,5,41731,1231,40500,0.9705015456135726,11.477532444444444,1204.0505066666667,17.324356560835014,129,6.40000000000001E-4
4,test_20231101_135432,10287332.png,216980,11579,205401,0.9466356346207023,2,4,22337,1590,20747,0.9288176568026145,9.629411555555556,829.9726293333333,18.940165903297878,129,6.40000000000001E-4
5,test_20231101_135432,11610969.png,368720,21809,346911,0.9408521371230202,3,4,84111,3190,80921,0.9620739261214347,23.338673777777778,3382.608032,12.838286851023904,129,6.40000000000001E-4
6,test_20231101_135432,10350842.png,212614,5279,207335,0.9751709671047062,2,4,42529,776,41753,0.9817536269369136,19.566787555555557,2433.533258666667,14.268430748223048,129,6.40000000000001E-4
7,test_20231101_135432,10863862.png,317432,7459,309973,0.9765020539832153,1,3,66058,1091,64967,0.983484210845015,35.780739555555556,6527.049354666667,9.983634642163107,129,6.40000000000001E-4
8,test_20231101_135432,11382381.png,312486,567,311919,0.9981855187112383,2,4,46745,75,46670,0.9983955503262381,22.72423288888889,2714.741744,13.793518398308729,129,6.40000000000001E-4
9,test_20231101_135432,11079715.png,443815,110169,333646,0.7517681917014972,4,4,124136,15429,108707,0.8757088999162209,17.810384,2321.88808,14.47239078889067,129,6.40000000000001E-4
10,test_20231101_135432,11551286.png,271883,267,271616,0.9990179599312939,1,3,40092,37,40055,0.9990771226179787,18.016108444444445,1877.54488,15.394900338849709,129,6.40000000000001E-4
1,test_20231101_135433,10404007.png,502730,16847,485883,0.9664889702225847,2,3,61265,2450,58815,0.9600097935199543,26.172988444444446,3556.890048,12.62009920558409,129,6.500000000000011E-4
2,test_20231101_135433,1254659.png,342646,67139,275507,0.8040572485889227,3,4,80080,9434,70646,0.8821928071928072,21.694814222222224,3426.7694133333334,12.781954790485319,129,6.500000000000011E-4
3,test_20231101_135433,10188041.png,221231,8687,212544,0.9607333511126379,2,4,41731,1231,40500,0.9705015456135726,11.477532444444444,1204.0505066666667,17.324356560835014,129,6.500000000000011E-4
4,test_20231101_135433,10287332.png,216980,11579,205401,0.9466356346207023,2,3,22337,1590,20747,0.9288176568026145,9.629411555555556,829.9726293333333,18.940165903297878,129,6.500000000000011E-4
5,test_20231101_135433,11610969.png,368720,21809,346911,0.9408521371230202,2,3,84111,3190,80921,0.9620739261214347,23.338673777777778,3382.608032,12.838286851023904,129,6.500000000000011E-4
6,test_20231101_135433,10350842.png,212614,5279,207335,0.9751709671047062,2,5,42529,776,41753,0.9817536269369136,19.566787555555557,2433.533258666667,14.268430748223048,129,6.500000000000011E-4
7,test_20231101_135433,10863862.png,317432,7459,309973,0.9765020539832153,1,3,66058,1091,64967,0.983484210845015,35.780739555555556,6527.049354666667,9.983634642163107,129,6.500000000000011E-4
8,test_20231101_135433,11382381.png,312486,567,311919,0.9981855187112383,2,4,46745,75,46670,0.9983955503262381,22.72423288888889,2714.741744,13.793518398308729,129,6.500000000000011E-4
9,test_20231101_135433,11079715.png,443815,110169,333646,0.7517681917014972,4,4,124136,15429,108707,0.8757088999162209,17.810384,2321.88808,14.47239078889067,129,6.500000000000011E-4
10,test_20231101_135433,11551286.png,271883,267,271616,0.9990179599312939,1,3,40092,37,40055,0.9990771226179787,18.016108444444445,1877.54488,15.394900338849709,129,6.500000000000011E-4
1,test_20231101_135433,10404007.png,502730,16847,485883,0.9664889702225847,3,4,61265,2450,58815,0.9600097935199543,26.172988444444446,3556.890048,12.62009920558409,129,6.600000000000011E-4
2,test_20231101_135433,1254659.png,342646,67139,275507,0.8040572485889227,4,4,80080,9434,70646,0.8821928071928072,21.694814222222224,3426.7694133333334,12.781954790485319,129,6.600000000000011E-4
3,test_20231101_135433,10188041.png,221231,8687,212544,0.9607333511126379,2,3,41731,1231,40500,0.9705015456135726,11.477532444444444,1204.0505066666667,17.324356560835014,129,6.600000000000011E-4
4,test_20231101_135433,10287332.png,216980,11579,205401,0.9466356346207023,2,4,22337,1590,20747,0.9288176568026145,9.629411555555556,829.9726293333333,18.940165903297878,129,6.600000000000011E-4
5,test_20231101_135433,11610969.png,368720,21809,346911,0.9408521371230202,2,3,84111,3190,80921,0.9620739261214347,23.338673777777778,3382.608032,12.838286851023904,129,6.600000000000011E-4
6,test_20231101_135433,10350842.png,212614,5279,207335,0.9751709671047062,1,3,42529,776,41753,0.9817536269369136,19.566787555555557,2433.533258666667,14.268430748223048,129,6.600000000000011E-4
7,test_20231101_135433,10863862.png,317432,7459,309973,0.9765020539832153,2,4,66058,1091,64967,0.983484210845015,35.780739555555556,6527.049354666667,9.983634642163107,129,6.600000000000011E-4
8,test_20231101_135433,11382381.png,312486,567,311919,0.9981855187112383,1,4,46745,75,46670,0.9983955503262381,22.72423288888889,2714.741744,13.793518398308729,129,6.600000000000011E-4
9,test_20231101_135433,11079715.png,443815,110169,333646,0.7517681917014972,3,4,124136,15429,108707,0.8757088999162209,17.810384,2321.88808,14.47239078889067,129,6.600000000000011E-4
10,test_20231101_135433,11551286.png,271883,267,271616,0.9990179599312939,1,3,40092,37,40055,0.9990771226179787,18.016108444444445,1877.54488,15.394900338849709,129,6.600000000000011E-4
1,test_20231101_135434,10404007.png,502730,16847,485883,0.9664889702225847,2,3,61265,2450,58815,0.9600097935199543,26.172988444444446,3556.890048,12.62009920558409,129,6.700000000000011E-4
2,test_20231101_135434,1254659.png,342646,67139,275507,0.8040572485889227,2,3,80080,9434,70646,0.8821928071928072,21.694814222222224,3426.7694133333334,12.781954790485319,129,6.700000000000011E-4
3,test_20231101_135434,10188041.png,221231,8687,212544,0.9607333511126379,2,4,41731,1231,40500,0.9705015456135726,11.477532444444444,1204.0505066666667,17.324356560835014,129,6.700000000000011E-4
4,test_20231101_135434,10287332.png,216980,11579,205401,0.9466356346207023,2,4,22337,1590,20747,0.9288176568026145,9.629411555555556,829.9726293333333,18.940165903297878,129,6.700000000000011E-4
5,test_20231101_135434,11610969.png,368720,21809,346911,0.9408521371230202,3,4,84111,3190,80921,0.9620739261214347,23.338673777777778,3382.608032,12.838286851023904,129,6.700000000000011E-4
6,test_20231101_135434,10350842.png,212614,5279,207335,0.9751709671047062,2,4,42529,776,41753,0.9817536269369136,19.566787555555557,2433.533258666667,14.268430748223048,129,6.700000000000011E-4
7,test_20231101_135434,10863862.png,317432,7459,309973,0.9765020539832153,2,4,66058,1091,64967,0.983484210845015,35.780739555555556,6527.049354666667,9.983634642163107,129,6.700000000000011E-4
8,test_20231101_135434,11382381.png,312486,567,311919,0.9981855187112383,2,6,46745,75,46670,0.9983955503262381,22.72423288888889,2714.741744,13.793518398308729,129,6.700000000000011E-4
9,test_20231101_135434,11079715.png,443815,110169,333646,0.7517681917014972,3,4,124136,15429,108707,0.8757088999162209,17.810384,2321.88808,14.47239078889067,129,6.700000000000011E-4
10,test_20231101_135434,11551286.png,271883,267,271616,0.9990179599312939,1,4,40092,37,40055,0.9990771226179787,18.016108444444445,1877.54488,15.394900338849709,129,6.700000000000011E-4
1,test_20231101_135435,10404007.png,502730,16847,485883,0.9664889702225847,2,3,61265,2450,58815,0.9600097935199543,26.172988444444446,3556.890048,12.62009920558409,129,6.800000000000011E-4
2,test_20231101_135435,1254659.png,342646,67139,275507,0.8040572485889227,2,3,80080,9434,70646,0.8821928071928072,21.694814222222224,3426.7694133333334,12.781954790485319,129,6.800000000000011E-4
3,test_20231101_135435,10188041.png,221231,8687,212544,0.9607333511126379,2,3,41731,1231,40500,0.9705015456135726,11.477532444444444,1204.0505066666667,17.324356560835014,129,6.800000000000011E-4
4,test_20231101_135435,10287332.png,216980,11579,205401,0.9466356346207023,1,3,22337,1590,20747,0.9288176568026145,9.629411555555556,829.9726293333333,18.940165903297878,129,6.800000000000011E-4
5,test_20231101_135435,11610969.png,368720,21809,346911,0.9408521371230202,2,4,84111,3190,80921,0.9620739261214347,23.338673777777778,3382.608032,12.838286851023904,129,6.800000000000011E-4
6,test_20231101_135435,10350842.png,212614,5279,207335,0.9751709671047062,1,3,42529,776,41753,0.9817536269369136,19.566787555555557,2433.533258666667,14.268430748223048,129,6.800000000000011E-4
7,test_20231101_135435,10863862.png,317432,7459,309973,0.9765020539832153,1,3,66058,1091,64967,0.983484210845015,35.780739555555556,6527.049354666667,9.983634642163107,129,6.800000000000011E-4
8,test_20231101_135435,11382381.png,312486,567,311919,0.9981855187112383,1,4,46745,75,46670,0.9983955503262381,22.72423288888889,2714.741744,13.793518398308729,129,6.800000000000011E-4
9,test_20231101_135435,11079715.png,443815,110169,333646,0.7517681917014972,3,9,124136,15429,108707,0.8757088999162209,17.810384,2321.88808,14.47239078889067,129,6.800000000000011E-4
10,test_20231101_135435,11551286.png,271883,267,271616,0.9990179599312939,1,4,40092,37,40055,0.9990771226179787,18.016108444444445,1877.54488,15.394900338849709,129,6.800000000000011E-4
1,test_20231101_135435,10404007.png,502730,16847,485883,0.9664889702225847,2,4,61265,2450,58815,0.9600097935199543,26.172988444444446,3556.890048,12.62009920558409,129,6.900000000000012E-4
2,test_20231101_135435,1254659.png,342646,67139,275507,0.8040572485889227,3,4,80080,9434,70646,0.8821928071928072,21.694814222222224,3426.7694133333334,12.781954790485319,129,6.900000000000012E-4
3,test_20231101_135435,10188041.png,221231,8687,212544,0.9607333511126379,2,3,41731,1231,40500,0.9705015456135726,11.477532444444444,1204.0505066666667,17.324356560835014,129,6.900000000000012E-4
4,test_20231101_135435,10287332.png,216980,11579,205401,0.9466356346207023,2,4,22337,1590,20747,0.9288176568026145,9.629411555555556,829.9726293333333,18.940165903297878,129,6.900000000000012E-4
5,test_20231101_135435,11610969.png,368720,21809,346911,0.9408521371230202,2,3,84111,3190,80921,0.9620739261214347,23.338673777777778,3382.608032,12.838286851023904,129,6.900000000000012E-4
6,test_20231101_135435,10350842.png,212614,5279,207335,0.9751709671047062,2,4,42529,776,41753,0.9817536269369136,19.566787555555557,2433.533258666667,14.268430748223048,129,6.900000000000012E-4
7,test_20231101_135435,10863862.png,317432,7459,309973,0.9765020539832153,2,4,66058,1091,64967,0.983484210845015,35.780739555555556,6527.049354666667,9.983634642163107,129,6.900000000000012E-4
8,test_20231101_135435,11382381.png,312486,567,311919,0.9981855187112383,1,3,46745,75,46670,0.9983955503262381,22.72423288888889,2714.741744,13.793518398308729,129,6.900000000000012E-4
9,test_20231101_135435,11079715.png,443815,110169,333646,0.7517681917014972,4,4,124136,15429,108707,0.8757088999162209,17.810384,2321.88808,14.47239078889067,129,6.900000000000012E-4
10,test_20231101_135435,11551286.png,271883,267,271616,0.9990179599312939,1,4,40092,37,40055,0.9990771226179787,18.016108444444445,1877.54488,15.394900338849709,129,6.900000000000012E-4
1,test_20231101_135436,10404007.png,502730,16847,485883,0.9664889702225847,2,4,61265,2450,58815,0.9600097935199543,26.172988444444446,3556.890048,12.62009920558409,129,7.000000000000012E-4
2,test_20231101_135436,1254659.png,342646,67139,275507,0.8040572485889227,3,4,80080,9434,70646,0.8821928071928072,21.694814222222224,3426.7694133333334,12.781954790485319,129,7.000000000000012E-4
3,test_20231101_135436,10188041.png,221231,8687,212544,0.9607333511126379,2,3,41731,1231,40500,0.9705015456135726,11.477532444444444,1204.0505066666667,17.324356560835014,129,7.000000000000012E-4
4,test_20231101_135436,10287332.png,216980,11579,205401,0.9466356346207023,2,4,22337,1590,20747,0.9288176568026145,9.629411555555556,829.9726293333333,18.940165903297878,129,7.000000000000012E-4
5,test_20231101_135436,11610969.png,368720,21809,346911,0.9408521371230202,3,4,84111,3190,80921,0.9620739261214347,23.338673777777778,3382.608032,12.838286851023904,129,7.000000000000012E-4
6,test_20231101_135436,10350842.png,212614,5279,207335,0.9751709671047062,1,4,42529,776,41753,0.9817536269369136,19.566787555555557,2433.533258666667,14.268430748223048,129,7.000000000000012E-4
7,test_20231101_135436,10863862.png,317432,7459,309973,0.9765020539832153,2,4,66058,1091,64967,0.983484210845015,35.780739555555556,6527.049354666667,9.983634642163107,129,7.000000000000012E-4
8,test_20231101_135436,11382381.png,312486,567,311919,0.9981855187112383,1,3,46745,75,46670,0.9983955503262381,22.72423288888889,2714.741744,13.793518398308729,129,7.000000000000012E-4
9,test_20231101_135436,11079715.png,443815,110169,333646,0.7517681917014972,4,4,124136,15429,108707,0.8757088999162209,17.810384,2321.88808,14.47239078889067,129,7.000000000000012E-4
10,test_20231101_135436,11551286.png,271883,267,271616,0.9990179599312939,1,4,40092,37,40055,0.9990771226179787,18.016108444444445,1877.54488,15.394900338849709,129,7.000000000000012E-4
1,test_20231101_135437,10404007.png,502730,16847,485883,0.9664889702225847,2,4,61265,2450,58815,0.9600097935199543,26.172988444444446,3556.890048,12.62009920558409,129,7.100000000000012E-4
2,test_20231101_135437,1254659.png,342646,67139,275507,0.8040572485889227,3,4,80080,9434,70646,0.8821928071928072,21.694814222222224,3426.7694133333334,12.781954790485319,129,7.100000000000012E-4
3,test_20231101_135437,10188041.png,221231,8607,212624,0.9610949640873114,1,3,41731,1221,40510,0.9707411756248353,11.516433777777777,1208.135008,17.30964891853339,129,7.100000000000012E-4
4,test_20231101_135437,10287332.png,216980,11579,205401,0.9466356346207023,1,4,22337,1590,20747,0.9288176568026145,9.629411555555556,829.9726293333333,18.940165903297878,129,7.100000000000012E-4
5,test_20231101_135437,11610969.png,368720,21809,346911,0.9408521371230202,3,4,84111,3190,80921,0.9620739261214347,23.338673777777778,3382.608032,12.838286851023904,129,7.100000000000012E-4
6,test_20231101_135437,10350842.png,212614,5279,207335,0.9751709671047062,2,4,42529,776,41753,0.9817536269369136,19.566787555555557,2433.533258666667,14.268430748223048,129,7.100000000000012E-4
7,test_20231101_135437,10863862.png,317432,7459,309973,0.9765020539832153,2,3,66058,1091,64967,0.983484210845015,35.780739555555556,6527.049354666667,9.983634642163107,129,7.100000000000012E-4
8,test_20231101_135437,11382381.png,312486,567,311919,0.9981855187112383,1,4,46745,75,46670,0.9983955503262381,22.72423288888889,2714.741744,13.793518398308729,129,7.100000000000012E-4
9,test_20231101_135437,11079715.png,443815,110169,333646,0.7517681917014972,3,4,124136,15429,108707,0.8757088999162209,17.810384,2321.88808,14.47239078889067,129,7.100000000000012E-4
10,test_20231101_135437,11551286.png,271883,267,271616,0.9990179599312939,1,3,40092,37,40055,0.9990771226179787,18.016108444444445,1877.54488,15.394900338849709,129,7.100000000000012E-4
1,test_20231101_135437,10404007.png,502730,16847,485883,0.9664889702225847,2,3,61265,2450,58815,0.9600097935199543,26.172988444444446,3556.890048,12.62009920558409,129,7.200000000000012E-4
2,test_20231101_135437,1254659.png,342646,67139,275507,0.8040572485889227,3,4,80080,9434,70646,0.8821928071928072,21.694814222222224,3426.7694133333334,12.781954790485319,129,7.200000000000012E-4
3,test_20231101_135437,10188041.png,221231,8607,212624,0.9610949640873114,2,3,41731,1221,40510,0.9707411756248353,11.516433777777777,1208.135008,17.30964891853339,129,7.200000000000012E-4
4,test_20231101_135437,10287332.png,216980,11579,205401,0.9466356346207023,1,4,22337,1590,20747,0.9288176568026145,9.629411555555556,829.9726293333333,18.940165903297878,129,7.200000000000012E-4
5,test_20231101_135437,11610969.png,368720,21809,346911,0.9408521371230202,3,4,84111,3190,80921,0.9620739261214347,23.338673777777778,3382.608032,12.838286851023904,129,7.200000000000012E-4
6,test_20231101_135437,10350842.png,212614,5279,207335,0.9751709671047062,1,3,42529,776,41753,0.9817536269369136,19.566787555555557,2433.533258666667,14.268430748223048,129,7.200000000000012E-4
7,test_20231101_135437,10863862.png,317432,7459,309973,0.9765020539832153,1,4,66058,1091,64967,0.983484210845015,35.780739555555556,6527.049354666667,9.983634642163107,129,7.200000000000012E-4
8,test_20231101_135437,11382381.png,312486,567,311919,0.9981855187112383,1,4,46745,75,46670,0.9983955503262381,22.72423288888889,2714.741744,13.793518398308729,129,7.200000000000012E-4
9,test_20231101_135437,11079715.png,443815,110169,333646,0.7517681917014972,3,5,124136,15429,108707,0.8757088999162209,17.810384,2321.88808,14.47239078889067,129,7.200000000000012E-4
10,test_20231101_135437,11551286.png,271883,267,271616,0.9990179599312939,2,3,40092,37,40055,0.9990771226179787,18.016108444444445,1877.54488,15.394900338849709,129,7.200000000000012E-4
1,test_20231101_135438,10404007.png,502730,16847,485883,0.9664889702225847,2,4,61265,2450,58815,0.9600097935199543,26.172988444444446,3556.890048,12.62009920558409,129,7.300000000000013E-4
2,test_20231101_135438,1254659.png,342646,67139,275507,0.8040572485889227,3,4,80080,9434,70646,0.8821928071928072,21.694814222222224,3426.7694133333334,12.781954790485319,129,7.300000000000013E-4
3,test_20231101_135438,10188041.png,221231,8607,212624,0.9610949640873114,2,4,41731,1221,40510,0.9707411756248353,11.516433777777777,1208.135008,17.30964891853339,129,7.300000000000013E-4
4,test_20231101_135438,10287332.png,216980,11579,205401,0.9466356346207023,1,4,22337,1590,20747,0.9288176568026145,9.629411555555556,829.9726293333333,18.940165903297878,129,7.300000000000013E-4
5,test_20231101_135438,11610969.png,368720,21809,346911,0.9408521371230202,2,4,84111,3190,80921,0.9620739261214347,23.338673777777778,3382.608032,12.838286851023904,129,7.300000000000013E-4
6,test_20231101_135438,10350842.png,212614,5279,207335,0.9751709671047062,1,4,42529,776,41753,0.9817536269369136,19.566787555555557,2433.533258666667,14.268430748223048,129,7.300000000000013E-4
7,test_20231101_135438,10863862.png,317432,7459,309973,0.9765020539832153,1,3,66058,1091,64967,0.983484210845015,35.780739555555556,6527.049354666667,9.983634642163107,129,7.300000000000013E-4
8,test_20231101_135438,11382381.png,312486,567,311919,0.9981855187112383,2,4,46745,75,46670,0.9983955503262381,22.72423288888889,2714.741744,13.793518398308729,129,7.300000000000013E-4
9,test_20231101_135438,11079715.png,443815,110169,333646,0.7517681917014972,3,4,124136,15429,108707,0.8757088999162209,17.810384,2321.88808,14.47239078889067,129,7.300000000000013E-4
10,test_20231101_135438,11551286.png,271883,267,271616,0.9990179599312939,1,4,40092,37,40055,0.9990771226179787,18.016108444444445,1877.54488,15.394900338849709,129,7.300000000000013E-4
1,test_20231101_135439,10404007.png,502730,16847,485883,0.9664889702225847,2,4,61265,2450,58815,0.9600097935199543,26.172988444444446,3556.890048,12.62009920558409,129,7.400000000000013E-4
2,test_20231101_135439,1254659.png,342646,67139,275507,0.8040572485889227,3,4,80080,9434,70646,0.8821928071928072,21.694814222222224,3426.7694133333334,12.781954790485319,129,7.400000000000013E-4
3,test_20231101_135439,10188041.png,221231,8607,212624,0.9610949640873114,2,4,41731,1221,40510,0.9707411756248353,11.516433777777777,1208.135008,17.30964891853339,129,7.400000000000013E-4
4,test_20231101_135439,10287332.png,216980,11579,205401,0.9466356346207023,2,4,22337,1590,20747,0.9288176568026145,9.629411555555556,829.9726293333333,18.940165903297878,129,7.400000000000013E-4
5,test_20231101_135439,11610969.png,368720,21809,346911,0.9408521371230202,2,4,84111,3190,80921,0.9620739261214347,23.338673777777778,3382.608032,12.838286851023904,129,7.400000000000013E-4
6,test_20231101_135439,10350842.png,212614,5279,207335,0.9751709671047062,2,4,42529,776,41753,0.9817536269369136,19.566787555555557,2433.533258666667,14.268430748223048,129,7.400000000000013E-4
7,test_20231101_135439,10863862.png,317432,7459,309973,0.9765020539832153,2,4,66058,1091,64967,0.983484210845015,35.780739555555556,6527.049354666667,9.983634642163107,129,7.400000000000013E-4
8,test_20231101_135439,11382381.png,312486,567,311919,0.9981855187112383,1,4,46745,75,46670,0.9983955503262381,22.72423288888889,2714.741744,13.793518398308729,129,7.400000000000013E-4
9,test_20231101_135439,11079715.png,443815,110169,333646,0.7517681917014972,3,4,124136,15429,108707,0.8757088999162209,17.810384,2321.88808,14.47239078889067,129,7.400000000000013E-4
10,test_20231101_135439,11551286.png,271883,267,271616,0.9990179599312939,1,4,40092,37,40055,0.9990771226179787,18.016108444444445,1877.54488,15.394900338849709,129,7.400000000000013E-4
1,test_20231101_135439,10404007.png,502730,16847,485883,0.9664889702225847,2,4,61265,2450,58815,0.9600097935199543,26.172988444444446,3556.890048,12.62009920558409,129,7.500000000000013E-4
2,test_20231101_135439,1254659.png,342646,67139,275507,0.8040572485889227,3,4,80080,9434,70646,0.8821928071928072,21.694814222222224,3426.7694133333334,12.781954790485319,129,7.500000000000013E-4
3,test_20231101_135439,10188041.png,221231,8607,212624,0.9610949640873114,2,4,41731,1221,40510,0.9707411756248353,11.516433777777777,1208.135008,17.30964891853339,129,7.500000000000013E-4
4,test_20231101_135439,10287332.png,216980,11579,205401,0.9466356346207023,2,3,22337,1590,20747,0.9288176568026145,9.629411555555556,829.9726293333333,18.940165903297878,129,7.500000000000013E-4
5,test_20231101_135439,11610969.png,368720,21809,346911,0.9408521371230202,3,3,84111,3190,80921,0.9620739261214347,23.338673777777778,3382.608032,12.838286851023904,129,7.500000000000013E-4
6,test_20231101_135439,10350842.png,212614,5279,207335,0.9751709671047062,2,3,42529,776,41753,0.9817536269369136,19.566787555555557,2433.533258666667,14.268430748223048,129,7.500000000000013E-4
7,test_20231101_135439,10863862.png,317432,7459,309973,0.9765020539832153,1,4,66058,1091,64967,0.983484210845015,35.780739555555556,6527.049354666667,9.983634642163107,129,7.500000000000013E-4
8,test_20231101_135439,11382381.png,312486,567,311919,0.9981855187112383,1,4,46745,75,46670,0.9983955503262381,22.72423288888889,2714.741744,13.793518398308729,129,7.500000000000013E-4
9,test_20231101_135439,11079715.png,443815,110169,333646,0.7517681917014972,4,4,124136,15429,108707,0.8757088999162209,17.810384,2321.88808,14.47239078889067,129,7.500000000000013E-4
10,test_20231101_135439,11551286.png,271883,267,271616,0.9990179599312939,2,3,40092,37,40055,0.9990771226179787,18.016108444444445,1877.54488,15.394900338849709,129,7.500000000000013E-4
1,test_20231101_135440,10404007.png,502730,16787,485943,0.9666083185805502,2,4,61265,2441,58824,0.9601566963192687,26.176508444444444,3557.550464,12.61929291582764,129,7.600000000000013E-4
2,test_20231101_135440,1254659.png,342646,67139,275507,0.8040572485889227,3,4,80080,9434,70646,0.8821928071928072,21.694814222222224,3426.7694133333334,12.781954790485319,129,7.600000000000013E-4
3,test_20231101_135440,10188041.png,221231,8607,212624,0.9610949640873114,1,3,41731,1221,40510,0.9707411756248353,11.516433777777777,1208.135008,17.30964891853339,129,7.600000000000013E-4
4,test_20231101_135440,10287332.png,216980,11579,205401,0.9466356346207023,2,3,22337,1590,20747,0.9288176568026145,9.629411555555556,829.9726293333333,18.940165903297878,129,7.600000000000013E-4
5,test_20231101_135440,11610969.png,368720,21789,346931,0.9409063788240399,2,4,84111,3189,80922,0.9620858151728073,23.444323555555556,3392.786112,12.825238791497249,129,7.600000000000013E-4
6,test_20231101_135440,10350842.png,212614,5219,207395,0.975453168653052,2,4,42529,767,41762,0.9819652472430577,20.083477333333335,2523.518314666667,14.110738998545528,129,7.600000000000013E-4
7,test_20231101_135440,10863862.png,317432,7459,309973,0.9765020539832153,2,4,66058,1091,64967,0.983484210845015,35.780739555555556,6527.049354666667,9.983634642163107,129,7.600000000000013E-4
8,test_20231101_135440,11382381.png,312486,567,311919,0.9981855187112383,2,3,46745,75,46670,0.9983955503262381,22.72423288888889,2714.741744,13.793518398308729,129,7.600000000000013E-4
9,test_20231101_135440,11079715.png,443815,110169,333646,0.7517681917014972,3,4,124136,15429,108707,0.8757088999162209,17.810384,2321.88808,14.47239078889067,129,7.600000000000013E-4
10,test_20231101_135440,11551286.png,271883,267,271616,0.9990179599312939,1,4,40092,37,40055,0.9990771226179787,18.016108444444445,1877.54488,15.394900338849709,129,7.600000000000013E-4
1,test_20231101_135441,10404007.png,502730,16787,485943,0.9666083185805502,3,3,61265,2441,58824,0.9601566963192687,26.176508444444444,3557.550464,12.61929291582764,129,7.700000000000014E-4
2,test_20231101_135441,1254659.png,342646,67139,275507,0.8040572485889227,3,4,80080,9434,70646,0.8821928071928072,21.694814222222224,3426.7694133333334,12.781954790485319,129,7.700000000000014E-4
3,test_20231101_135441,10188041.png,221231,8607,212624,0.9610949640873114,2,4,41731,1221,40510,0.9707411756248353,11.516433777777777,1208.135008,17.30964891853339,129,7.700000000000014E-4
4,test_20231101_135441,10287332.png,216980,11579,205401,0.9466356346207023,2,4,22337,1590,20747,0.9288176568026145,9.629411555555556,829.9726293333333,18.940165903297878,129,7.700000000000014E-4
5,test_20231101_135441,11610969.png,368720,21789,346931,0.9409063788240399,4,8,84111,3189,80922,0.9620858151728073,23.444323555555556,3392.786112,12.825238791497249,129,7.700000000000014E-4
6,test_20231101_135441,10350842.png,212614,4254,208360,0.9799919102222807,1,4,42529,624,41905,0.9853276587740131,23.09414577777778,3256.7716213333333,13.002930558100143,129,7.700000000000014E-4
7,test_20231101_135441,10863862.png,317432,7459,309973,0.9765020539832153,1,4,66058,1091,64967,0.983484210845015,35.780739555555556,6527.049354666667,9.983634642163107,129,7.700000000000014E-4
8,test_20231101_135441,11382381.png,312486,567,311919,0.9981855187112383,1,3,46745,75,46670,0.9983955503262381,22.72423288888889,2714.741744,13.793518398308729,129,7.700000000000014E-4
9,test_20231101_135441,11079715.png,443815,110169,333646,0.7517681917014972,4,4,124136,15429,108707,0.8757088999162209,17.810384,2321.88808,14.47239078889067,129,7.700000000000014E-4
10,test_20231101_135441,11551286.png,271883,267,271616,0.9990179599312939,1,3,40092,37,40055,0.9990771226179787,18.016108444444445,1877.54488,15.394900338849709,129,7.700000000000014E-4
1,test_20231101_135442,10404007.png,502730,16787,485943,0.9666083185805502,2,3,61265,2441,58824,0.9601566963192687,26.176508444444444,3557.550464,12.61929291582764,129,7.800000000000014E-4
2,test_20231101_135442,1254659.png,342646,67139,275507,0.8040572485889227,4,4,80080,9434,70646,0.8821928071928072,21.694814222222224,3426.7694133333334,12.781954790485319,129,7.800000000000014E-4
3,test_20231101_135442,10188041.png,221231,8607,212624,0.9610949640873114,2,4,41731,1221,40510,0.9707411756248353,11.516433777777777,1208.135008,17.30964891853339,129,7.800000000000014E-4
4,test_20231101_135442,10287332.png,216980,11579,205401,0.9466356346207023,2,4,22337,1590,20747,0.9288176568026145,9.629411555555556,829.9726293333333,18.940165903297878,129,7.800000000000014E-4
5,test_20231101_135442,11610969.png,368720,21789,346931,0.9409063788240399,3,4,84111,3189,80922,0.9620858151728073,23.444323555555556,3392.786112,12.825238791497249,129,7.800000000000014E-4
6,test_20231101_135442,10350842.png,212614,4254,208360,0.9799919102222807,2,3,42529,624,41905,0.9853276587740131,23.09414577777778,3256.7716213333333,13.002930558100143,129,7.800000000000014E-4
7,test_20231101_135442,10863862.png,317432,7459,309973,0.9765020539832153,2,4,66058,1091,64967,0.983484210845015,35.780739555555556,6527.049354666667,9.983634642163107,129,7.800000000000014E-4
8,test_20231101_135442,11382381.png,312486,567,311919,0.9981855187112383,1,4,46745,75,46670,0.9983955503262381,22.72423288888889,2714.741744,13.793518398308729,129,7.800000000000014E-4
9,test_20231101_135442,11079715.png,443815,110169,333646,0.7517681917014972,3,5,124136,15429,108707,0.8757088999162209,17.810384,2321.88808,14.47239078889067,129,7.800000000000014E-4
10,test_20231101_135442,11551286.png,271883,267,271616,0.9990179599312939,2,4,40092,37,40055,0.9990771226179787,18.016108444444445,1877.54488,15.394900338849709,129,7.800000000000014E-4
1,test_20231101_135442,10404007.png,502730,16787,485943,0.9666083185805502,3,3,61265,2441,58824,0.9601566963192687,26.176508444444444,3557.550464,12.61929291582764,129,7.900000000000014E-4
2,test_20231101_135442,1254659.png,342646,67139,275507,0.8040572485889227,4,4,80080,9434,70646,0.8821928071928072,21.694814222222224,3426.7694133333334,12.781954790485319,129,7.900000000000014E-4
3,test_20231101_135442,10188041.png,221231,8607,212624,0.9610949640873114,2,4,41731,1221,40510,0.9707411756248353,11.516433777777777,1208.135008,17.30964891853339,129,7.900000000000014E-4
4,test_20231101_135442,10287332.png,216980,11579,205401,0.9466356346207023,1,3,22337,1590,20747,0.9288176568026145,9.629411555555556,829.9726293333333,18.940165903297878,129,7.900000000000014E-4
5,test_20231101_135442,11610969.png,368720,21789,346931,0.9409063788240399,2,3,84111,3189,80922,0.9620858151728073,23.444323555555556,3392.786112,12.825238791497249,129,7.900000000000014E-4
6,test_20231101_135442,10350842.png,212614,4254,208360,0.9799919102222807,2,3,42529,624,41905,0.9853276587740131,23.09414577777778,3256.7716213333333,13.002930558100143,129,7.900000000000014E-4
7,test_20231101_135442,10863862.png,317432,7459,309973,0.9765020539832153,2,3,66058,1091,64967,0.983484210845015,35.780739555555556,6527.049354666667,9.983634642163107,129,7.900000000000014E-4
8,test_20231101_135442,11382381.png,312486,567,311919,0.9981855187112383,1,4,46745,75,46670,0.9983955503262381,22.72423288888889,2714.741744,13.793518398308729,129,7.900000000000014E-4
9,test_20231101_135442,11079715.png,443815,110169,333646,0.7517681917014972,3,5,124136,15429,108707,0.8757088999162209,17.810384,2321.88808,14.47239078889067,129,7.900000000000014E-4
10,test_20231101_135442,11551286.png,271883,267,271616,0.9990179599312939,1,4,40092,37,40055,0.9990771226179787,18.016108444444445,1877.54488,15.394900338849709,129,7.900000000000014E-4
1,test_20231101_135443,10404007.png,502730,16787,485943,0.9666083185805502,2,4,61265,2441,58824,0.9601566963192687,26.176508444444444,3557.550464,12.61929291582764,129,8.000000000000014E-4
2,test_20231101_135443,1254659.png,342646,67139,275507,0.8040572485889227,3,4,80080,9434,70646,0.8821928071928072,21.694814222222224,3426.7694133333334,12.781954790485319,129,8.000000000000014E-4
3,test_20231101_135443,10188041.png,221231,8607,212624,0.9610949640873114,2,4,41731,1221,40510,0.9707411756248353,11.516433777777777,1208.135008,17.30964891853339,129,8.000000000000014E-4
4,test_20231101_135443,10287332.png,216980,11579,205401,0.9466356346207023,2,4,22337,1590,20747,0.9288176568026145,9.629411555555556,829.9726293333333,18.940165903297878,129,8.000000000000014E-4
5,test_20231101_135443,11610969.png,368720,21789,346931,0.9409063788240399,2,4,84111,3189,80922,0.9620858151728073,23.444323555555556,3392.786112,12.825238791497249,129,8.000000000000014E-4
6,test_20231101_135443,10350842.png,212614,4254,208360,0.9799919102222807,2,4,42529,624,41905,0.9853276587740131,23.09414577777778,3256.7716213333333,13.002930558100143,129,8.000000000000014E-4
7,test_20231101_135443,10863862.png,317432,7459,309973,0.9765020539832153,2,4,66058,1091,64967,0.983484210845015,35.780739555555556,6527.049354666667,9.983634642163107,129,8.000000000000014E-4
8,test_20231101_135443,11382381.png,312486,567,311919,0.9981855187112383,1,3,46745,75,46670,0.9983955503262381,22.72423288888889,2714.741744,13.793518398308729,129,8.000000000000014E-4
9,test_20231101_135443,11079715.png,443815,110169,333646,0.7517681917014972,3,4,124136,15429,108707,0.8757088999162209,17.810384,2321.88808,14.47239078889067,129,8.000000000000014E-4
10,test_20231101_135443,11551286.png,271883,267,271616,0.9990179599312939,2,3,40092,37,40055,0.9990771226179787,18.016108444444445,1877.54488,15.394900338849709,129,8.000000000000014E-4
1,test_20231101_135444,10404007.png,502730,16787,485943,0.9666083185805502,2,3,61265,2441,58824,0.9601566963192687,26.176508444444444,3557.550464,12.61929291582764,129,8.100000000000015E-4
2,test_20231101_135444,1254659.png,342646,67139,275507,0.8040572485889227,3,4,80080,9434,70646,0.8821928071928072,21.694814222222224,3426.7694133333334,12.781954790485319,129,8.100000000000015E-4
3,test_20231101_135444,10188041.png,221231,8607,212624,0.9610949640873114,2,4,41731,1221,40510,0.9707411756248353,11.516433777777777,1208.135008,17.30964891853339,129,8.100000000000015E-4
4,test_20231101_135444,10287332.png,216980,11579,205401,0.9466356346207023,2,4,22337,1590,20747,0.9288176568026145,9.629411555555556,829.9726293333333,18.940165903297878,129,8.100000000000015E-4
5,test_20231101_135444,11610969.png,368720,21789,346931,0.9409063788240399,3,4,84111,3189,80922,0.9620858151728073,23.444323555555556,3392.786112,12.825238791497249,129,8.100000000000015E-4
6,test_20231101_135444,10350842.png,212614,4254,208360,0.9799919102222807,2,3,42529,624,41905,0.9853276587740131,23.09414577777778,3256.7716213333333,13.002930558100143,129,8.100000000000015E-4
7,test_20231101_135444,10863862.png,317432,7459,309973,0.9765020539832153,2,3,66058,1091,64967,0.983484210845015,35.780739555555556,6527.049354666667,9.983634642163107,129,8.100000000000015E-4
8,test_20231101_135444,11382381.png,312486,567,311919,0.9981855187112383,1,4,46745,75,46670,0.9983955503262381,22.72423288888889,2714.741744,13.793518398308729,129,8.100000000000015E-4
9,test_20231101_135444,11079715.png,443815,110169,333646,0.7517681917014972,3,4,124136,15429,108707,0.8757088999162209,17.810384,2321.88808,14.47239078889067,129,8.100000000000015E-4
10,test_20231101_135444,11551286.png,271883,267,271616,0.9990179599312939,1,4,40092,37,40055,0.9990771226179787,18.016108444444445,1877.54488,15.394900338849709,129,8.100000000000015E-4
1,test_20231101_135444,10404007.png,502730,16787,485943,0.9666083185805502,2,4,61265,2441,58824,0.9601566963192687,26.176508444444444,3557.550464,12.61929291582764,129,8.200000000000015E-4
2,test_20231101_135444,1254659.png,342646,67139,275507,0.8040572485889227,3,4,80080,9434,70646,0.8821928071928072,21.694814222222224,3426.7694133333334,12.781954790485319,129,8.200000000000015E-4
3,test_20231101_135444,10188041.png,221231,8607,212624,0.9610949640873114,1,3,41731,1221,40510,0.9707411756248353,11.516433777777777,1208.135008,17.30964891853339,129,8.200000000000015E-4
4,test_20231101_135444,10287332.png,216980,11579,205401,0.9466356346207023,2,3,22337,1590,20747,0.9288176568026145,9.629411555555556,829.9726293333333,18.940165903297878,129,8.200000000000015E-4
5,test_20231101_135444,11610969.png,368720,21789,346931,0.9409063788240399,2,6,84111,3189,80922,0.9620858151728073,23.444323555555556,3392.786112,12.825238791497249,129,8.200000000000015E-4
6,test_20231101_135444,10350842.png,212614,4254,208360,0.9799919102222807,1,4,42529,624,41905,0.9853276587740131,23.09414577777778,3256.7716213333333,13.002930558100143,129,8.200000000000015E-4
7,test_20231101_135444,10863862.png,317432,7459,309973,0.9765020539832153,1,4,66058,1091,64967,0.983484210845015,35.780739555555556,6527.049354666667,9.983634642163107,129,8.200000000000015E-4
8,test_20231101_135444,11382381.png,312486,567,311919,0.9981855187112383,1,4,46745,75,46670,0.9983955503262381,22.72423288888889,2714.741744,13.793518398308729,129,8.200000000000015E-4
9,test_20231101_135444,11079715.png,443815,110169,333646,0.7517681917014972,3,4,124136,15429,108707,0.8757088999162209,17.810384,2321.88808,14.47239078889067,129,8.200000000000015E-4
10,test_20231101_135444,11551286.png,271883,267,271616,0.9990179599312939,2,4,40092,37,40055,0.9990771226179787,18.016108444444445,1877.54488,15.394900338849709,129,8.200000000000015E-4
1,test_20231101_135445,10404007.png,502730,16787,485943,0.9666083185805502,2,4,61265,2441,58824,0.9601566963192687,26.176508444444444,3557.550464,12.61929291582764,129,8.300000000000015E-4
2,test_20231101_135445,1254659.png,342646,67139,275507,0.8040572485889227,2,3,80080,9434,70646,0.8821928071928072,21.694814222222224,3426.7694133333334,12.781954790485319,129,8.300000000000015E-4
3,test_20231101_135445,10188041.png,221231,8607,212624,0.9610949640873114,2,3,41731,1221,40510,0.9707411756248353,11.516433777777777,1208.135008,17.30964891853339,129,8.300000000000015E-4
4,test_20231101_135445,10287332.png,216980,11579,205401,0.9466356346207023,2,4,22337,1590,20747,0.9288176568026145,9.629411555555556,829.9726293333333,18.940165903297878,129,8.300000000000015E-4
5,test_20231101_135445,11610969.png,368720,21789,346931,0.9409063788240399,3,4,84111,3189,80922,0.9620858151728073,23.444323555555556,3392.786112,12.825238791497249,129,8.300000000000015E-4
6,test_20231101_135445,10350842.png,212614,4254,208360,0.9799919102222807,1,4,42529,624,41905,0.9853276587740131,23.09414577777778,3256.7716213333333,13.002930558100143,129,8.300000000000015E-4
7,test_20231101_135445,10863862.png,317432,7459,309973,0.9765020539832153,1,3,66058,1091,64967,0.983484210845015,35.780739555555556,6527.049354666667,9.983634642163107,129,8.300000000000015E-4
8,test_20231101_135445,11382381.png,312486,567,311919,0.9981855187112383,1,4,46745,75,46670,0.9983955503262381,22.72423288888889,2714.741744,13.793518398308729,129,8.300000000000015E-4
9,test_20231101_135445,11079715.png,443815,110169,333646,0.7517681917014972,3,4,124136,15429,108707,0.8757088999162209,17.810384,2321.88808,14.47239078889067,129,8.300000000000015E-4
10,test_20231101_135445,11551286.png,271883,267,271616,0.9990179599312939,1,3,40092,37,40055,0.9990771226179787,18.016108444444445,1877.54488,15.394900338849709,129,8.300000000000015E-4
1,test_20231101_135446,10404007.png,502730,16787,485943,0.9666083185805502,3,4,61265,2441,58824,0.9601566963192687,26.176508444444444,3557.550464,12.61929291582764,129,8.400000000000016E-4
2,test_20231101_135446,1254659.png,342646,67139,275507,0.8040572485889227,3,4,80080,9434,70646,0.8821928071928072,21.694814222222224,3426.7694133333334,12.781954790485319,129,8.400000000000016E-4
3,test_20231101_135446,10188041.png,221231,8607,212624,0.9610949640873114,2,4,41731,1221,40510,0.9707411756248353,11.516433777777777,1208.135008,17.30964891853339,129,8.400000000000016E-4
4,test_20231101_135446,10287332.png,216980,11579,205401,0.9466356346207023,1,3,22337,1590,20747,0.9288176568026145,9.629411555555556,829.9726293333333,18.940165903297878,129,8.400000000000016E-4
5,test_20231101_135446,11610969.png,368720,21789,346931,0.9409063788240399,3,4,84111,3189,80922,0.9620858151728073,23.444323555555556,3392.786112,12.825238791497249,129,8.400000000000016E-4
6,test_20231101_135446,10350842.png,212614,3732,208882,0.9824470636928895,2,3,42529,546,41983,0.9871617014272615,24.194565333333333,3524.7187893333335,12.659558872319822,129,8.400000000000016E-4
7,test_20231101_135446,10863862.png,317432,7459,309973,0.9765020539832153,2,6,66058,1091,64967,0.983484210845015,35.780739555555556,6527.049354666667,9.983634642163107,129,8.400000000000016E-4
8,test_20231101_135446,11382381.png,312486,567,311919,0.9981855187112383,1,4,46745,75,46670,0.9983955503262381,22.72423288888889,2714.741744,13.793518398308729,129,8.400000000000016E-4
9,test_20231101_135446,11079715.png,443815,110169,333646,0.7517681917014972,4,5,124136,15429,108707,0.8757088999162209,17.810384,2321.88808,14.47239078889067,129,8.400000000000016E-4
10,test_20231101_135446,11551286.png,271883,267,271616,0.9990179599312939,1,4,40092,37,40055,0.9990771226179787,18.016108444444445,1877.54488,15.394900338849709,129,8.400000000000016E-4
1,test_20231101_135446,10404007.png,502730,16787,485943,0.9666083185805502,2,4,61265,2441,58824,0.9601566963192687,26.176508444444444,3557.550464,12.61929291582764,129,8.500000000000016E-4
2,test_20231101_135446,1254659.png,342646,67139,275507,0.8040572485889227,3,4,80080,9434,70646,0.8821928071928072,21.694814222222224,3426.7694133333334,12.781954790485319,129,8.500000000000016E-4
3,test_20231101_135446,10188041.png,221231,8607,212624,0.9610949640873114,2,4,41731,1221,40510,0.9707411756248353,11.516433777777777,1208.135008,17.30964891853339,129,8.500000000000016E-4
4,test_20231101_135446,10287332.png,216980,11579,205401,0.9466356346207023,2,4,22337,1590,20747,0.9288176568026145,9.629411555555556,829.9726293333333,18.940165903297878,129,8.500000000000016E-4
5,test_20231101_135446,11610969.png,368720,21789,346931,0.9409063788240399,3,4,84111,3189,80922,0.9620858151728073,23.444323555555556,3392.786112,12.825238791497249,129,8.500000000000016E-4
6,test_20231101_135446,10350842.png,212614,3732,208882,0.9824470636928895,2,4,42529,546,41983,0.9871617014272615,24.194565333333333,3524.7187893333335,12.659558872319822,129,8.500000000000016E-4
7,test_20231101_135446,10863862.png,317432,7459,309973,0.9765020539832153,2,4,66058,1091,64967,0.983484210845015,35.780739555555556,6527.049354666667,9.983634642163107,129,8.500000000000016E-4
8,test_20231101_135446,11382381.png,312486,567,311919,0.9981855187112383,1,4,46745,75,46670,0.9983955503262381,22.72423288888889,2714.741744,13.793518398308729,129,8.500000000000016E-4
9,test_20231101_135446,11079715.png,443815,110169,333646,0.7517681917014972,3,5,124136,15429,108707,0.8757088999162209,17.810384,2321.88808,14.47239078889067,129,8.500000000000016E-4
10,test_20231101_135446,11551286.png,271883,267,271616,0.9990179599312939,1,4,40092,37,40055,0.9990771226179787,18.016108444444445,1877.54488,15.394900338849709,129,8.500000000000016E-4
1,test_20231101_135447,10404007.png,502730,16787,485943,0.9666083185805502,2,4,61265,2441,58824,0.9601566963192687,26.176508444444444,3557.550464,12.61929291582764,129,8.600000000000016E-4
2,test_20231101_135447,1254659.png,342646,67139,275507,0.8040572485889227,3,4,80080,9434,70646,0.8821928071928072,21.694814222222224,3426.7694133333334,12.781954790485319,129,8.600000000000016E-4
3,test_20231101_135447,10188041.png,221231,8607,212624,0.9610949640873114,1,4,41731,1221,40510,0.9707411756248353,11.516433777777777,1208.135008,17.30964891853339,129,8.600000000000016E-4
4,test_20231101_135447,10287332.png,216980,11579,205401,0.9466356346207023,1,3,22337,1590,20747,0.9288176568026145,9.629411555555556,829.9726293333333,18.940165903297878,129,8.600000000000016E-4
5,test_20231101_135447,11610969.png,368720,21789,346931,0.9409063788240399,3,4,84111,3189,80922,0.9620858151728073,23.444323555555556,3392.786112,12.825238791497249,129,8.600000000000016E-4
6,test_20231101_135447,10350842.png,212614,3732,208882,0.9824470636928895,1,3,42529,546,41983,0.9871617014272615,24.194565333333333,3524.7187893333335,12.659558872319822,129,8.600000000000016E-4
7,test_20231101_135447,10863862.png,317432,7459,309973,0.9765020539832153,1,3,66058,1091,64967,0.983484210845015,35.780739555555556,6527.049354666667,9.983634642163107,129,8.600000000000016E-4
8,test_20231101_135447,11382381.png,312486,567,311919,0.9981855187112383,2,4,46745,75,46670,0.9983955503262381,22.72423288888889,2714.741744,13.793518398308729,129,8.600000000000016E-4
9,test_20231101_135447,11079715.png,443815,110169,333646,0.7517681917014972,4,5,124136,15429,108707,0.8757088999162209,17.810384,2321.88808,14.47239078889067,129,8.600000000000016E-4
10,test_20231101_135447,11551286.png,271883,267,271616,0.9990179599312939,1,4,40092,37,40055,0.9990771226179787,18.016108444444445,1877.54488,15.394900338849709,129,8.600000000000016E-4
1,test_20231101_135448,10404007.png,502730,16787,485943,0.9666083185805502,2,4,61265,2441,58824,0.9601566963192687,26.176508444444444,3557.550464,12.61929291582764,129,8.700000000000016E-4
2,test_20231101_135448,1254659.png,342646,67139,275507,0.8040572485889227,3,9,80080,9434,70646,0.8821928071928072,21.694814222222224,3426.7694133333334,12.781954790485319,129,8.700000000000016E-4
3,test_20231101_135448,10188041.png,221231,8607,212624,0.9610949640873114,2,4,41731,1221,40510,0.9707411756248353,11.516433777777777,1208.135008,17.30964891853339,129,8.700000000000016E-4
4,test_20231101_135448,10287332.png,216980,11579,205401,0.9466356346207023,2,3,22337,1590,20747,0.9288176568026145,9.629411555555556,829.9726293333333,18.940165903297878,129,8.700000000000016E-4
5,test_20231101_135448,11610969.png,368720,21789,346931,0.9409063788240399,3,3,84111,3189,80922,0.9620858151728073,23.444323555555556,3392.786112,12.825238791497249,129,8.700000000000016E-4
6,test_20231101_135448,10350842.png,212614,3732,208882,0.9824470636928895,2,4,42529,546,41983,0.9871617014272615,24.194565333333333,3524.7187893333335,12.659558872319822,129,8.700000000000016E-4
7,test_20231101_135448,10863862.png,317432,7459,309973,0.9765020539832153,2,3,66058,1091,64967,0.983484210845015,35.780739555555556,6527.049354666667,9.983634642163107,129,8.700000000000016E-4
8,test_20231101_135448,11382381.png,312486,567,311919,0.9981855187112383,1,4,46745,75,46670,0.9983955503262381,22.72423288888889,2714.741744,13.793518398308729,129,8.700000000000016E-4
9,test_20231101_135448,11079715.png,443815,110169,333646,0.7517681917014972,4,13,124136,15429,108707,0.8757088999162209,17.810384,2321.88808,14.47239078889067,129,8.700000000000016E-4
10,test_20231101_135448,11551286.png,271883,267,271616,0.9990179599312939,2,4,40092,37,40055,0.9990771226179787,18.016108444444445,1877.54488,15.394900338849709,129,8.700000000000016E-4
1,test_20231101_135448,10404007.png,502730,16787,485943,0.9666083185805502,3,4,61265,2441,58824,0.9601566963192687,26.176508444444444,3557.550464,12.61929291582764,129,8.800000000000017E-4
2,test_20231101_135448,1254659.png,342646,67139,275507,0.8040572485889227,3,4,80080,9434,70646,0.8821928071928072,21.694814222222224,3426.7694133333334,12.781954790485319,129,8.800000000000017E-4
3,test_20231101_135448,10188041.png,221231,8607,212624,0.9610949640873114,1,4,41731,1221,40510,0.9707411756248353,11.516433777777777,1208.135008,17.30964891853339,129,8.800000000000017E-4
4,test_20231101_135448,10287332.png,216980,11579,205401,0.9466356346207023,2,3,22337,1590,20747,0.9288176568026145,9.629411555555556,829.9726293333333,18.940165903297878,129,8.800000000000017E-4
5,test_20231101_135448,11610969.png,368720,21789,346931,0.9409063788240399,2,4,84111,3189,80922,0.9620858151728073,23.444323555555556,3392.786112,12.825238791497249,129,8.800000000000017E-4
6,test_20231101_135448,10350842.png,212614,3732,208882,0.9824470636928895,2,3,42529,546,41983,0.9871617014272615,24.194565333333333,3524.7187893333335,12.659558872319822,129,8.800000000000017E-4
7,test_20231101_135448,10863862.png,317432,7459,309973,0.9765020539832153,1,4,66058,1091,64967,0.983484210845015,35.780739555555556,6527.049354666667,9.983634642163107,129,8.800000000000017E-4
8,test_20231101_135448,11382381.png,312486,567,311919,0.9981855187112383,1,4,46745,75,46670,0.9983955503262381,22.72423288888889,2714.741744,13.793518398308729,129,8.800000000000017E-4
9,test_20231101_135448,11079715.png,443815,110169,333646,0.7517681917014972,3,4,124136,15429,108707,0.8757088999162209,17.810384,2321.88808,14.47239078889067,129,8.800000000000017E-4
10,test_20231101_135448,11551286.png,271883,267,271616,0.9990179599312939,1,4,40092,37,40055,0.9990771226179787,18.016108444444445,1877.54488,15.394900338849709,129,8.800000000000017E-4
1,test_20231101_135449,10404007.png,502730,16787,485943,0.9666083185805502,2,4,61265,2441,58824,0.9601566963192687,26.176508444444444,3557.550464,12.61929291582764,129,8.900000000000017E-4
2,test_20231101_135449,1254659.png,342646,67139,275507,0.8040572485889227,2,3,80080,9434,70646,0.8821928071928072,21.694814222222224,3426.7694133333334,12.781954790485319,129,8.900000000000017E-4
3,test_20231101_135449,10188041.png,221231,8607,212624,0.9610949640873114,2,3,41731,1221,40510,0.9707411756248353,11.516433777777777,1208.135008,17.30964891853339,129,8.900000000000017E-4
4,test_20231101_135449,10287332.png,216980,11579,205401,0.9466356346207023,2,3,22337,1590,20747,0.9288176568026145,9.629411555555556,829.9726293333333,18.940165903297878,129,8.900000000000017E-4
5,test_20231101_135449,11610969.png,368720,21789,346931,0.9409063788240399,3,3,84111,3189,80922,0.9620858151728073,23.444323555555556,3392.786112,12.825238791497249,129,8.900000000000017E-4
6,test_20231101_135449,10350842.png,212614,3732,208882,0.9824470636928895,1,3,42529,546,41983,0.9871617014272615,24.194565333333333,3524.7187893333335,12.659558872319822,129,8.900000000000017E-4
7,test_20231101_135449,10863862.png,317432,7459,309973,0.9765020539832153,1,4,66058,1091,64967,0.983484210845015,35.780739555555556,6527.049354666667,9.983634642163107,129,8.900000000000017E-4
8,test_20231101_135449,11382381.png,312486,567,311919,0.9981855187112383,2,4,46745,75,46670,0.9983955503262381,22.72423288888889,2714.741744,13.793518398308729,129,8.900000000000017E-4
9,test_20231101_135449,11079715.png,443815,110169,333646,0.7517681917014972,4,10,124136,15429,108707,0.8757088999162209,17.810384,2321.88808,14.47239078889067,129,8.900000000000017E-4
10,test_20231101_135449,11551286.png,271883,267,271616,0.9990179599312939,1,3,40092,37,40055,0.9990771226179787,18.016108444444445,1877.54488,15.394900338849709,129,8.900000000000017E-4
1,test_20231101_135450,10404007.png,502730,16787,485943,0.9666083185805502,3,3,61265,2441,58824,0.9601566963192687,26.176508444444444,3557.550464,12.61929291582764,129,9.000000000000017E-4
2,test_20231101_135450,1254659.png,342646,67139,275507,0.8040572485889227,3,4,80080,9434,70646,0.8821928071928072,21.694814222222224,3426.7694133333334,12.781954790485319,129,9.000000000000017E-4
3,test_20231101_135450,10188041.png,221231,8607,212624,0.9610949640873114,2,11,41731,1221,40510,0.9707411756248353,11.516433777777777,1208.135008,17.30964891853339,129,9.000000000000017E-4
4,test_20231101_135450,10287332.png,216980,11579,205401,0.9466356346207023,1,4,22337,1590,20747,0.9288176568026145,9.629411555555556,829.9726293333333,18.940165903297878,129,9.000000000000017E-4
5,test_20231101_135450,11610969.png,368720,21789,346931,0.9409063788240399,2,4,84111,3189,80922,0.9620858151728073,23.444323555555556,3392.786112,12.825238791497249,129,9.000000000000017E-4
6,test_20231101_135450,10350842.png,212614,3732,208882,0.9824470636928895,1,4,42529,546,41983,0.9871617014272615,24.194565333333333,3524.7187893333335,12.659558872319822,129,9.000000000000017E-4
7,test_20231101_135450,10863862.png,317432,7459,309973,0.9765020539832153,1,9,66058,1091,64967,0.983484210845015,35.780739555555556,6527.049354666667,9.983634642163107,129,9.000000000000017E-4
8,test_20231101_135450,11382381.png,312486,567,311919,0.9981855187112383,1,3,46745,75,46670,0.9983955503262381,22.72423288888889,2714.741744,13.793518398308729,129,9.000000000000017E-4
9,test_20231101_135450,11079715.png,443815,110169,333646,0.7517681917014972,3,4,124136,15429,108707,0.8757088999162209,17.810384,2321.88808,14.47239078889067,129,9.000000000000017E-4
10,test_20231101_135450,11551286.png,271883,267,271616,0.9990179599312939,1,4,40092,37,40055,0.9990771226179787,18.016108444444445,1877.54488,15.394900338849709,129,9.000000000000017E-4
1,test_20231101_135450,10404007.png,502730,16787,485943,0.9666083185805502,2,11,61265,2441,58824,0.9601566963192687,26.176508444444444,3557.550464,12.61929291582764,129,9.100000000000017E-4
2,test_20231101_135450,1254659.png,342646,67139,275507,0.8040572485889227,3,4,80080,9434,70646,0.8821928071928072,21.694814222222224,3426.7694133333334,12.781954790485319,129,9.100000000000017E-4
3,test_20231101_135450,10188041.png,221231,8607,212624,0.9610949640873114,2,3,41731,1221,40510,0.9707411756248353,11.516433777777777,1208.135008,17.30964891853339,129,9.100000000000017E-4
4,test_20231101_135450,10287332.png,216980,11579,205401,0.9466356346207023,1,3,22337,1590,20747,0.9288176568026145,9.629411555555556,829.9726293333333,18.940165903297878,129,9.100000000000017E-4
5,test_20231101_135450,11610969.png,368720,21789,346931,0.9409063788240399,8,4,84111,3189,80922,0.9620858151728073,23.444323555555556,3392.786112,12.825238791497249,129,9.100000000000017E-4
6,test_20231101_135450,10350842.png,212614,3732,208882,0.9824470636928895,1,4,42529,546,41983,0.9871617014272615,24.194565333333333,3524.7187893333335,12.659558872319822,129,9.100000000000017E-4
7,test_20231101_135450,10863862.png,317432,7459,309973,0.9765020539832153,1,3,66058,1091,64967,0.983484210845015,35.780739555555556,6527.049354666667,9.983634642163107,129,9.100000000000017E-4
8,test_20231101_135450,11382381.png,312486,567,311919,0.9981855187112383,2,3,46745,75,46670,0.9983955503262381,22.72423288888889,2714.741744,13.793518398308729,129,9.100000000000017E-4
9,test_20231101_135450,11079715.png,443815,110169,333646,0.7517681917014972,3,4,124136,15429,108707,0.8757088999162209,17.810384,2321.88808,14.47239078889067,129,9.100000000000017E-4
10,test_20231101_135450,11551286.png,271883,267,271616,0.9990179599312939,1,4,40092,37,40055,0.9990771226179787,18.016108444444445,1877.54488,15.394900338849709,129,9.100000000000017E-4
1,test_20231101_135451,10404007.png,502730,16787,485943,0.9666083185805502,3,3,61265,2441,58824,0.9601566963192687,26.176508444444444,3557.550464,12.61929291582764,129,9.200000000000018E-4
2,test_20231101_135451,1254659.png,342646,67139,275507,0.8040572485889227,2,3,80080,9434,70646,0.8821928071928072,21.694814222222224,3426.7694133333334,12.781954790485319,129,9.200000000000018E-4
3,test_20231101_135451,10188041.png,221231,8607,212624,0.9610949640873114,2,3,41731,1221,40510,0.9707411756248353,11.516433777777777,1208.135008,17.30964891853339,129,9.200000000000018E-4
4,test_20231101_135451,10287332.png,216980,11579,205401,0.9466356346207023,1,4,22337,1590,20747,0.9288176568026145,9.629411555555556,829.9726293333333,18.940165903297878,129,9.200000000000018E-4
5,test_20231101_135451,11610969.png,368720,21789,346931,0.9409063788240399,2,4,84111,3189,80922,0.9620858151728073,23.444323555555556,3392.786112,12.825238791497249,129,9.200000000000018E-4
6,test_20231101_135451,10350842.png,212614,3732,208882,0.9824470636928895,2,3,42529,546,41983,0.9871617014272615,24.194565333333333,3524.7187893333335,12.659558872319822,129,9.200000000000018E-4
7,test_20231101_135451,10863862.png,317432,7459,309973,0.9765020539832153,2,4,66058,1091,64967,0.983484210845015,35.780739555555556,6527.049354666667,9.983634642163107,129,9.200000000000018E-4
8,test_20231101_135451,11382381.png,312486,567,311919,0.9981855187112383,1,4,46745,75,46670,0.9983955503262381,22.72423288888889,2714.741744,13.793518398308729,129,9.200000000000018E-4
9,test_20231101_135451,11079715.png,443815,110169,333646,0.7517681917014972,4,4,124136,15429,108707,0.8757088999162209,17.810384,2321.88808,14.47239078889067,129,9.200000000000018E-4
10,test_20231101_135451,11551286.png,271883,267,271616,0.9990179599312939,1,11,40092,37,40055,0.9990771226179787,18.016108444444445,1877.54488,15.394900338849709,129,9.200000000000018E-4
1,test_20231101_135452,10404007.png,502730,16787,485943,0.9666083185805502,3,3,61265,2441,58824,0.9601566963192687,26.176508444444444,3557.550464,12.61929291582764,129,9.300000000000018E-4
2,test_20231101_135452,1254659.png,342646,67139,275507,0.8040572485889227,3,4,80080,9434,70646,0.8821928071928072,21.694814222222224,3426.7694133333334,12.781954790485319,129,9.300000000000018E-4
3,test_20231101_135452,10188041.png,221231,8607,212624,0.9610949640873114,2,4,41731,1221,40510,0.9707411756248353,11.516433777777777,1208.135008,17.30964891853339,129,9.300000000000018E-4
4,test_20231101_135452,10287332.png,216980,11579,205401,0.9466356346207023,1,3,22337,1590,20747,0.9288176568026145,9.629411555555556,829.9726293333333,18.940165903297878,129,9.300000000000018E-4
5,test_20231101_135452,11610969.png,368720,21789,346931,0.9409063788240399,3,4,84111,3189,80922,0.9620858151728073,23.444323555555556,3392.786112,12.825238791497249,129,9.300000000000018E-4
6,test_20231101_135452,10350842.png,212614,3732,208882,0.9824470636928895,2,4,42529,546,41983,0.9871617014272615,24.194565333333333,3524.7187893333335,12.659558872319822,129,9.300000000000018E-4
7,test_20231101_135452,10863862.png,317432,7459,309973,0.9765020539832153,1,4,66058,1091,64967,0.983484210845015,35.780739555555556,6527.049354666667,9.983634642163107,129,9.300000000000018E-4
8,test_20231101_135452,11382381.png,312486,567,311919,0.9981855187112383,2,3,46745,75,46670,0.9983955503262381,22.72423288888889,2714.741744,13.793518398308729,129,9.300000000000018E-4
9,test_20231101_135452,11079715.png,443815,110169,333646,0.7517681917014972,8,5,124136,15429,108707,0.8757088999162209,17.810384,2321.88808,14.47239078889067,129,9.300000000000018E-4
10,test_20231101_135452,11551286.png,271883,267,271616,0.9990179599312939,1,3,40092,37,40055,0.9990771226179787,18.016108444444445,1877.54488,15.394900338849709,129,9.300000000000018E-4
1,test_20231101_135453,10404007.png,502730,16787,485943,0.9666083185805502,2,4,61265,2441,58824,0.9601566963192687,26.176508444444444,3557.550464,12.61929291582764,129,9.400000000000018E-4
2,test_20231101_135453,1254659.png,342646,67139,275507,0.8040572485889227,2,4,80080,9434,70646,0.8821928071928072,21.694814222222224,3426.7694133333334,12.781954790485319,129,9.400000000000018E-4
3,test_20231101_135453,10188041.png,221231,8607,212624,0.9610949640873114,2,4,41731,1221,40510,0.9707411756248353,11.516433777777777,1208.135008,17.30964891853339,129,9.400000000000018E-4
4,test_20231101_135453,10287332.png,216980,11579,205401,0.9466356346207023,2,4,22337,1590,20747,0.9288176568026145,9.629411555555556,829.9726293333333,18.940165903297878,129,9.400000000000018E-4
5,test_20231101_135453,11610969.png,368720,21789,346931,0.9409063788240399,2,3,84111,3189,80922,0.9620858151728073,23.444323555555556,3392.786112,12.825238791497249,129,9.400000000000018E-4
6,test_20231101_135453,10350842.png,212614,3732,208882,0.9824470636928895,1,3,42529,546,41983,0.9871617014272615,24.194565333333333,3524.7187893333335,12.659558872319822,129,9.400000000000018E-4
7,test_20231101_135453,10863862.png,317432,7459,309973,0.9765020539832153,2,4,66058,1091,64967,0.983484210845015,35.780739555555556,6527.049354666667,9.983634642163107,129,9.400000000000018E-4
8,test_20231101_135453,11382381.png,312486,567,311919,0.9981855187112383,1,4,46745,75,46670,0.9983955503262381,22.72423288888889,2714.741744,13.793518398308729,129,9.400000000000018E-4
9,test_20231101_135453,11079715.png,443815,110169,333646,0.7517681917014972,4,4,124136,15429,108707,0.8757088999162209,17.810384,2321.88808,14.47239078889067,129,9.400000000000018E-4
10,test_20231101_135453,11551286.png,271883,267,271616,0.9990179599312939,1,3,40092,37,40055,0.9990771226179787,18.016108444444445,1877.54488,15.394900338849709,129,9.400000000000018E-4
1,test_20231101_135453,10404007.png,502730,16787,485943,0.9666083185805502,3,4,61265,2441,58824,0.9601566963192687,26.176508444444444,3557.550464,12.61929291582764,129,9.500000000000018E-4
2,test_20231101_135453,1254659.png,342646,67139,275507,0.8040572485889227,4,4,80080,9434,70646,0.8821928071928072,21.694814222222224,3426.7694133333334,12.781954790485319,129,9.500000000000018E-4
3,test_20231101_135453,10188041.png,221231,8607,212624,0.9610949640873114,2,4,41731,1221,40510,0.9707411756248353,11.516433777777777,1208.135008,17.30964891853339,129,9.500000000000018E-4
4,test_20231101_135453,10287332.png,216980,11579,205401,0.9466356346207023,1,3,22337,1590,20747,0.9288176568026145,9.629411555555556,829.9726293333333,18.940165903297878,129,9.500000000000018E-4
5,test_20231101_135453,11610969.png,368720,21789,346931,0.9409063788240399,2,3,84111,3189,80922,0.9620858151728073,23.444323555555556,3392.786112,12.825238791497249,129,9.500000000000018E-4
6,test_20231101_135453,10350842.png,212614,3732,208882,0.9824470636928895,1,3,42529,546,41983,0.9871617014272615,24.194565333333333,3524.7187893333335,12.659558872319822,129,9.500000000000018E-4
7,test_20231101_135453,10863862.png,317432,7459,309973,0.9765020539832153,1,3,66058,1091,64967,0.983484210845015,35.780739555555556,6527.049354666667,9.983634642163107,129,9.500000000000018E-4
8,test_20231101_135453,11382381.png,312486,567,311919,0.9981855187112383,1,3,46745,75,46670,0.9983955503262381,22.72423288888889,2714.741744,13.793518398308729,129,9.500000000000018E-4
9,test_20231101_135453,11079715.png,443815,110169,333646,0.7517681917014972,3,4,124136,15429,108707,0.8757088999162209,17.810384,2321.88808,14.47239078889067,129,9.500000000000018E-4
10,test_20231101_135453,11551286.png,271883,267,271616,0.9990179599312939,1,4,40092,37,40055,0.9990771226179787,18.016108444444445,1877.54488,15.394900338849709,129,9.500000000000018E-4
1,test_20231101_135454,10404007.png,502730,16787,485943,0.9666083185805502,3,3,61265,2441,58824,0.9601566963192687,26.176508444444444,3557.550464,12.61929291582764,129,9.600000000000019E-4
2,test_20231101_135454,1254659.png,342646,67139,275507,0.8040572485889227,3,4,80080,9434,70646,0.8821928071928072,21.694814222222224,3426.7694133333334,12.781954790485319,129,9.600000000000019E-4
3,test_20231101_135454,10188041.png,221231,8607,212624,0.9610949640873114,1,3,41731,1221,40510,0.9707411756248353,11.516433777777777,1208.135008,17.30964891853339,129,9.600000000000019E-4
4,test_20231101_135454,10287332.png,216980,11579,205401,0.9466356346207023,2,4,22337,1590,20747,0.9288176568026145,9.629411555555556,829.9726293333333,18.940165903297878,129,9.600000000000019E-4
5,test_20231101_135454,11610969.png,368720,21789,346931,0.9409063788240399,3,4,84111,3189,80922,0.9620858151728073,23.444323555555556,3392.786112,12.825238791497249,129,9.600000000000019E-4
6,test_20231101_135454,10350842.png,212614,3732,208882,0.9824470636928895,1,3,42529,546,41983,0.9871617014272615,24.194565333333333,3524.7187893333335,12.659558872319822,129,9.600000000000019E-4
7,test_20231101_135454,10863862.png,317432,7459,309973,0.9765020539832153,2,3,66058,1091,64967,0.983484210845015,35.780739555555556,6527.049354666667,9.983634642163107,129,9.600000000000019E-4
8,test_20231101_135454,11382381.png,312486,567,311919,0.9981855187112383,2,4,46745,75,46670,0.9983955503262381,22.72423288888889,2714.741744,13.793518398308729,129,9.600000000000019E-4
9,test_20231101_135454,11079715.png,443815,110169,333646,0.7517681917014972,3,5,124136,15429,108707,0.8757088999162209,17.810384,2321.88808,14.47239078889067,129,9.600000000000019E-4
10,test_20231101_135454,11551286.png,271883,267,271616,0.9990179599312939,1,4,40092,37,40055,0.9990771226179787,18.016108444444445,1877.54488,15.394900338849709,129,9.600000000000019E-4
1,test_20231101_135455,10404007.png,502730,16787,485943,0.9666083185805502,2,4,61265,2441,58824,0.9601566963192687,26.176508444444444,3557.550464,12.61929291582764,129,9.700000000000019E-4
2,test_20231101_135455,1254659.png,342646,67139,275507,0.8040572485889227,3,4,80080,9434,70646,0.8821928071928072,21.694814222222224,3426.7694133333334,12.781954790485319,129,9.700000000000019E-4
3,test_20231101_135455,10188041.png,221231,8607,212624,0.9610949640873114,2,4,41731,1221,40510,0.9707411756248353,11.516433777777777,1208.135008,17.30964891853339,129,9.700000000000019E-4
4,test_20231101_135455,10287332.png,216980,11579,205401,0.9466356346207023,2,4,22337,1590,20747,0.9288176568026145,9.629411555555556,829.9726293333333,18.940165903297878,129,9.700000000000019E-4
5,test_20231101_135455,11610969.png,368720,21789,346931,0.9409063788240399,3,4,84111,3189,80922,0.9620858151728073,23.444323555555556,3392.786112,12.825238791497249,129,9.700000000000019E-4
6,test_20231101_135455,10350842.png,212614,3732,208882,0.9824470636928895,1,4,42529,546,41983,0.9871617014272615,24.194565333333333,3524.7187893333335,12.659558872319822,129,9.700000000000019E-4
7,test_20231101_135455,10863862.png,317432,7459,309973,0.9765020539832153,1,3,66058,1091,64967,0.983484210845015,35.780739555555556,6527.049354666667,9.983634642163107,129,9.700000000000019E-4
8,test_20231101_135455,11382381.png,312486,567,311919,0.9981855187112383,1,4,46745,75,46670,0.9983955503262381,22.72423288888889,2714.741744,13.793518398308729,129,9.700000000000019E-4
9,test_20231101_135455,11079715.png,443815,110169,333646,0.7517681917014972,4,4,124136,15429,108707,0.8757088999162209,17.810384,2321.88808,14.47239078889067,129,9.700000000000019E-4
10,test_20231101_135455,11551286.png,271883,267,271616,0.9990179599312939,1,4,40092,37,40055,0.9990771226179787,18.016108444444445,1877.54488,15.394900338849709,129,9.700000000000019E-4
1,test_20231101_135455,10404007.png,502730,16102,486628,0.9679708790006564,3,3,61265,2344,58921,0.9617399820452134,26.247559111111112,3577.6051413333334,12.594879548777731,129,9.80000000000002E-4
2,test_20231101_135455,1254659.png,342646,66959,275687,0.804582572100652,3,4,80080,9417,70663,0.8824050949050949,21.778970666666666,3445.463738666667,12.758326772687315,129,9.80000000000002E-4
3,test_20231101_135455,10188041.png,221231,8364,212867,0.9621933634978823,2,4,41731,1196,40535,0.9713402506529918,11.78519111111111,1274.0269866666667,17.079017334680383,129,9.80000000000002E-4
4,test_20231101_135455,10287332.png,216980,11499,205481,0.9470043321965158,1,3,22337,1578,20759,0.9293548820342928,9.654972444444445,834.1426026666667,18.918400581233193,129,9.80000000000002E-4
5,test_20231101_135455,11610969.png,368720,21487,347233,0.9417254285094381,2,3,84111,3149,80962,0.962561377227711,23.572757333333332,3412.3761066666666,12.800234684873093,129,9.80000000000002E-4
6,test_20231101_135455,10350842.png,212614,3472,209142,0.9836699370690547,1,3,42529,507,42022,0.9880787227538855,24.338956444444445,3551.941168,12.626145970678104,129,9.80000000000002E-4
7,test_20231101_135455,10863862.png,317432,7339,310093,0.9768800877038232,2,4,66058,1073,64985,0.9837566986587545,35.80773688888889,6532.084981333333,9.980285346679377,129,9.80000000000002E-4
8,test_20231101_135455,11382381.png,312486,367,312119,0.9988255473845228,1,3,46745,48,46697,0.9989731522087923,23.28773511111111,2886.24232,13.527475705549977,129,9.80000000000002E-4
9,test_20231101_135455,11079715.png,443815,110067,333748,0.7519980171918479,4,4,124136,15419,108717,0.8757894567248824,17.849096888888887,2328.1813813333333,14.460635490465751,129,9.80000000000002E-4
10,test_20231101_135455,11551286.png,271883,224,271659,0.9991761161970406,2,3,40092,31,40061,0.9992267784096578,18.06671822222222,1885.25176,15.377110059665014,129,9.80000000000002E-4
1,test_20231101_135456,10404007.png,502730,16102,486628,0.9679708790006564,2,4,61265,2344,58921,0.9617399820452134,26.247559111111112,3577.6051413333334,12.594879548777731,129,9.90000000000002E-4
2,test_20231101_135456,1254659.png,342646,66959,275687,0.804582572100652,3,4,80080,9417,70663,0.8824050949050949,21.778970666666666,3445.463738666667,12.758326772687315,129,9.90000000000002E-4
3,test_20231101_135456,10188041.png,221231,8364,212867,0.9621933634978823,2,3,41731,1196,40535,0.9713402506529918,11.78519111111111,1274.0269866666667,17.079017334680383,129,9.90000000000002E-4
4,test_20231101_135456,10287332.png,216980,11499,205481,0.9470043321965158,2,4,22337,1578,20759,0.9293548820342928,9.654972444444445,834.1426026666667,18.918400581233193,129,9.90000000000002E-4
5,test_20231101_135456,11610969.png,368720,21487,347233,0.9417254285094381,2,4,84111,3149,80962,0.962561377227711,23.572757333333332,3412.3761066666666,12.800234684873093,129,9.90000000000002E-4
6,test_20231101_135456,10350842.png,212614,3472,209142,0.9836699370690547,2,3,42529,507,42022,0.9880787227538855,24.338956444444445,3551.941168,12.626145970678104,129,9.90000000000002E-4
7,test_20231101_135456,10863862.png,317432,7339,310093,0.9768800877038232,1,4,66058,1073,64985,0.9837566986587545,35.80773688888889,6532.084981333333,9.980285346679377,129,9.90000000000002E-4
8,test_20231101_135456,11382381.png,312486,367,312119,0.9988255473845228,2,4,46745,48,46697,0.9989731522087923,23.28773511111111,2886.24232,13.527475705549977,129,9.90000000000002E-4
9,test_20231101_135456,11079715.png,443815,110067,333748,0.7519980171918479,3,4,124136,15419,108717,0.8757894567248824,17.849096888888887,2328.1813813333333,14.460635490465751,129,9.90000000000002E-4
10,test_20231101_135456,11551286.png,271883,224,271659,0.9991761161970406,1,4,40092,31,40061,0.9992267784096578,18.06671822222222,1885.25176,15.377110059665014,129,9.90000000000002E-4
1,test_20231101_135457,10404007.png,502730,16624,486106,0.9669325482863564,2,4,61265,2416,58849,0.9605647596506978,26.07669511111111,3540.964474666667,12.639587912218095,130,0.0
2,test_20231101_135457,1254659.png,342646,65252,277394,0.8095643900702183,3,4,80080,9171,70909,0.885477022977023,21.881578666666666,3492.428917333333,12.699527853441253,130,0.0
3,test_20231101_135457,10188041.png,221231,8404,212827,0.9620125570105456,2,14,41731,1193,40538,0.9714121396563705,11.447850666666668,1280.5076586666667,17.056981805572335,130,0.0
4,test_20231101_135457,10287332.png,216980,11449,205531,0.9472347681813992,2,4,22337,1574,20763,0.929533957111519,9.561258666666667,823.894464,18.97208776158452,130,0.0
5,test_20231101_135457,11610969.png,368720,21407,347313,0.9419423953135171,2,3,84111,3130,80981,0.9627872692037902,22.610574222222223,3255.403008,13.004756004317752,130,0.0
6,test_20231101_135457,10350842.png,212614,4817,207797,0.977343919026969,2,4,42529,707,41822,0.983376049284018,19.67007111111111,2460.5717813333335,14.22044321803745,130,0.0
7,test_20231101_135457,10863862.png,317432,7439,309993,0.9765650596033166,2,4,66058,1092,64966,0.9834690726331405,35.67820088888889,6511.628522666667,9.993907440417022,130,0.0
8,test_20231101_135457,11382381.png,312486,827,311659,0.9973534814359684,1,3,46745,113,46632,0.9975826291581987,20.486714666666668,2360.4332106666666,14.400886444502593,130,0.0
9,test_20231101_135457,11079715.png,443815,107837,335978,0.7570226333044174,3,4,124136,15131,109005,0.8781094928143327,17.708771555555554,2317.625856,14.480370335498858,130,0.0
10,test_20231101_135457,11551286.png,271883,837,271046,0.9969214698969777,1,4,40092,122,39970,0.9969569989025242,16.70746488888889,1661.188816,15.926613623199302,130,0.0
1,test_20231101_135457,10404007.png,502730,16624,486106,0.9669325482863564,2,4,61265,2416,58849,0.9605647596506978,26.07669511111111,3540.964474666667,12.639587912218095,130,1.0E-5
2,test_20231101_135457,1254659.png,342646,65252,277394,0.8095643900702183,3,4,80080,9171,70909,0.885477022977023,21.881578666666666,3492.428917333333,12.699527853441253,130,1.0E-5
3,test_20231101_135457,10188041.png,221231,8404,212827,0.9620125570105456,3,4,41731,1193,40538,0.9714121396563705,11.447850666666668,1280.5076586666667,17.056981805572335,130,1.0E-5
4,test_20231101_135457,10287332.png,216980,11449,205531,0.9472347681813992,2,4,22337,1574,20763,0.929533957111519,9.561258666666667,823.894464,18.97208776158452,130,1.0E-5
5,test_20231101_135457,11610969.png,368720,21407,347313,0.9419423953135171,3,3,84111,3130,80981,0.9627872692037902,22.610574222222223,3255.403008,13.004756004317752,130,1.0E-5
6,test_20231101_135457,10350842.png,212614,4817,207797,0.977343919026969,2,4,42529,707,41822,0.983376049284018,19.67007111111111,2460.5717813333335,14.22044321803745,130,1.0E-5
7,test_20231101_135457,10863862.png,317432,7439,309993,0.9765650596033166,1,3,66058,1092,64966,0.9834690726331405,35.67820088888889,6511.628522666667,9.993907440417022,130,1.0E-5
8,test_20231101_135457,11382381.png,312486,827,311659,0.9973534814359684,2,3,46745,113,46632,0.9975826291581987,20.486714666666668,2360.4332106666666,14.400886444502593,130,1.0E-5
9,test_20231101_135457,11079715.png,443815,107837,335978,0.7570226333044174,3,4,124136,15131,109005,0.8781094928143327,17.708771555555554,2317.625856,14.480370335498858,130,1.0E-5
10,test_20231101_135457,11551286.png,271883,837,271046,0.9969214698969777,1,3,40092,122,39970,0.9969569989025242,16.70746488888889,1661.188816,15.926613623199302,130,1.0E-5
1,test_20231101_135458,10404007.png,502730,16624,486106,0.9669325482863564,2,3,61265,2416,58849,0.9605647596506978,26.07669511111111,3540.964474666667,12.639587912218095,130,2.0E-5
2,test_20231101_135458,1254659.png,342646,65252,277394,0.8095643900702183,3,4,80080,9171,70909,0.885477022977023,21.881578666666666,3492.428917333333,12.699527853441253,130,2.0E-5
3,test_20231101_135458,10188041.png,221231,8404,212827,0.9620125570105456,2,4,41731,1193,40538,0.9714121396563705,11.447850666666668,1280.5076586666667,17.056981805572335,130,2.0E-5
4,test_20231101_135458,10287332.png,216980,11449,205531,0.9472347681813992,1,4,22337,1574,20763,0.929533957111519,9.561258666666667,823.894464,18.97208776158452,130,2.0E-5
5,test_20231101_135458,11610969.png,368720,21407,347313,0.9419423953135171,2,3,84111,3130,80981,0.9627872692037902,22.610574222222223,3255.403008,13.004756004317752,130,2.0E-5
6,test_20231101_135458,10350842.png,212614,4817,207797,0.977343919026969,2,4,42529,707,41822,0.983376049284018,19.67007111111111,2460.5717813333335,14.22044321803745,130,2.0E-5
7,test_20231101_135458,10863862.png,317432,7439,309993,0.9765650596033166,1,3,66058,1092,64966,0.9834690726331405,35.67820088888889,6511.628522666667,9.993907440417022,130,2.0E-5
8,test_20231101_135458,11382381.png,312486,827,311659,0.9973534814359684,1,4,46745,113,46632,0.9975826291581987,20.486714666666668,2360.4332106666666,14.400886444502593,130,2.0E-5
9,test_20231101_135458,11079715.png,443815,107837,335978,0.7570226333044174,3,4,124136,15131,109005,0.8781094928143327,17.708771555555554,2317.625856,14.480370335498858,130,2.0E-5
10,test_20231101_135458,11551286.png,271883,837,271046,0.9969214698969777,1,3,40092,122,39970,0.9969569989025242,16.70746488888889,1661.188816,15.926613623199302,130,2.0E-5
1,test_20231101_135459,10404007.png,502730,16624,486106,0.9669325482863564,2,4,61265,2416,58849,0.9605647596506978,26.07669511111111,3540.964474666667,12.639587912218095,130,3.0000000000000004E-5
2,test_20231101_135459,1254659.png,342646,65252,277394,0.8095643900702183,2,3,80080,9171,70909,0.885477022977023,21.881578666666666,3492.428917333333,12.699527853441253,130,3.0000000000000004E-5
3,test_20231101_135459,10188041.png,221231,8404,212827,0.9620125570105456,2,4,41731,1193,40538,0.9714121396563705,11.447850666666668,1280.5076586666667,17.056981805572335,130,3.0000000000000004E-5
4,test_20231101_135459,10287332.png,216980,11449,205531,0.9472347681813992,2,4,22337,1574,20763,0.929533957111519,9.561258666666667,823.894464,18.97208776158452,130,3.0000000000000004E-5
5,test_20231101_135459,11610969.png,368720,21407,347313,0.9419423953135171,3,3,84111,3130,80981,0.9627872692037902,22.610574222222223,3255.403008,13.004756004317752,130,3.0000000000000004E-5
6,test_20231101_135459,10350842.png,212614,4817,207797,0.977343919026969,1,3,42529,707,41822,0.983376049284018,19.67007111111111,2460.5717813333335,14.22044321803745,130,3.0000000000000004E-5
7,test_20231101_135459,10863862.png,317432,7439,309993,0.9765650596033166,1,4,66058,1092,64966,0.9834690726331405,35.67820088888889,6511.628522666667,9.993907440417022,130,3.0000000000000004E-5
8,test_20231101_135459,11382381.png,312486,827,311659,0.9973534814359684,1,3,46745,113,46632,0.9975826291581987,20.486714666666668,2360.4332106666666,14.400886444502593,130,3.0000000000000004E-5
9,test_20231101_135459,11079715.png,443815,107837,335978,0.7570226333044174,3,5,124136,15131,109005,0.8781094928143327,17.708771555555554,2317.625856,14.480370335498858,130,3.0000000000000004E-5
10,test_20231101_135459,11551286.png,271883,837,271046,0.9969214698969777,2,3,40092,122,39970,0.9969569989025242,16.70746488888889,1661.188816,15.926613623199302,130,3.0000000000000004E-5
1,test_20231101_135459,10404007.png,502730,16624,486106,0.9669325482863564,2,4,61265,2416,58849,0.9605647596506978,26.07669511111111,3540.964474666667,12.639587912218095,130,4.0E-5
2,test_20231101_135459,1254659.png,342646,65252,277394,0.8095643900702183,3,4,80080,9171,70909,0.885477022977023,21.881578666666666,3492.428917333333,12.699527853441253,130,4.0E-5
3,test_20231101_135459,10188041.png,221231,8404,212827,0.9620125570105456,2,4,41731,1193,40538,0.9714121396563705,11.447850666666668,1280.5076586666667,17.056981805572335,130,4.0E-5
4,test_20231101_135459,10287332.png,216980,11449,205531,0.9472347681813992,2,3,22337,1574,20763,0.929533957111519,9.561258666666667,823.894464,18.97208776158452,130,4.0E-5
5,test_20231101_135459,11610969.png,368720,21407,347313,0.9419423953135171,2,4,84111,3130,80981,0.9627872692037902,22.610574222222223,3255.403008,13.004756004317752,130,4.0E-5
6,test_20231101_135459,10350842.png,212614,4817,207797,0.977343919026969,1,3,42529,707,41822,0.983376049284018,19.67007111111111,2460.5717813333335,14.22044321803745,130,4.0E-5
7,test_20231101_135459,10863862.png,317432,7439,309993,0.9765650596033166,1,4,66058,1092,64966,0.9834690726331405,35.67820088888889,6511.628522666667,9.993907440417022,130,4.0E-5
8,test_20231101_135459,11382381.png,312486,827,311659,0.9973534814359684,2,4,46745,113,46632,0.9975826291581987,20.486714666666668,2360.4332106666666,14.400886444502593,130,4.0E-5
9,test_20231101_135459,11079715.png,443815,107837,335978,0.7570226333044174,3,4,124136,15131,109005,0.8781094928143327,17.708771555555554,2317.625856,14.480370335498858,130,4.0E-5
10,test_20231101_135459,11551286.png,271883,837,271046,0.9969214698969777,1,4,40092,122,39970,0.9969569989025242,16.70746488888889,1661.188816,15.926613623199302,130,4.0E-5
1,test_20231101_135500,10404007.png,502730,16624,486106,0.9669325482863564,2,3,61265,2416,58849,0.9605647596506978,26.07669511111111,3540.964474666667,12.639587912218095,130,5.0E-5
2,test_20231101_135500,1254659.png,342646,65252,277394,0.8095643900702183,2,4,80080,9171,70909,0.885477022977023,21.881578666666666,3492.428917333333,12.699527853441253,130,5.0E-5
3,test_20231101_135500,10188041.png,221231,8404,212827,0.9620125570105456,2,4,41731,1193,40538,0.9714121396563705,11.447850666666668,1280.5076586666667,17.056981805572335,130,5.0E-5
4,test_20231101_135500,10287332.png,216980,11449,205531,0.9472347681813992,2,3,22337,1574,20763,0.929533957111519,9.561258666666667,823.894464,18.97208776158452,130,5.0E-5
5,test_20231101_135500,11610969.png,368720,21407,347313,0.9419423953135171,2,4,84111,3130,80981,0.9627872692037902,22.610574222222223,3255.403008,13.004756004317752,130,5.0E-5
6,test_20231101_135500,10350842.png,212614,4817,207797,0.977343919026969,1,4,42529,707,41822,0.983376049284018,19.67007111111111,2460.5717813333335,14.22044321803745,130,5.0E-5
7,test_20231101_135500,10863862.png,317432,7439,309993,0.9765650596033166,2,3,66058,1092,64966,0.9834690726331405,35.67820088888889,6511.628522666667,9.993907440417022,130,5.0E-5
8,test_20231101_135500,11382381.png,312486,817,311669,0.9973854828696326,2,4,46745,112,46633,0.9976040218205156,21.216531555555555,2458.9940213333334,14.223228880483061,130,5.0E-5
9,test_20231101_135500,11079715.png,443815,107837,335978,0.7570226333044174,3,5,124136,15131,109005,0.8781094928143327,17.708771555555554,2317.625856,14.480370335498858,130,5.0E-5
10,test_20231101_135500,11551286.png,271883,837,271046,0.9969214698969777,1,3,40092,122,39970,0.9969569989025242,16.70746488888889,1661.188816,15.926613623199302,130,5.0E-5
1,test_20231101_135501,10404007.png,502730,16624,486106,0.9669325482863564,2,3,61265,2416,58849,0.9605647596506978,26.07669511111111,3540.964474666667,12.639587912218095,130,6.0E-5
2,test_20231101_135501,1254659.png,342646,65252,277394,0.8095643900702183,3,10,80080,9171,70909,0.885477022977023,21.881578666666666,3492.428917333333,12.699527853441253,130,6.0E-5
3,test_20231101_135501,10188041.png,221231,8404,212827,0.9620125570105456,2,4,41731,1193,40538,0.9714121396563705,11.447850666666668,1280.5076586666667,17.056981805572335,130,6.0E-5
4,test_20231101_135501,10287332.png,216980,11449,205531,0.9472347681813992,2,4,22337,1574,20763,0.929533957111519,9.561258666666667,823.894464,18.97208776158452,130,6.0E-5
5,test_20231101_135501,11610969.png,368720,21407,347313,0.9419423953135171,2,4,84111,3130,80981,0.9627872692037902,22.610574222222223,3255.403008,13.004756004317752,130,6.0E-5
6,test_20231101_135501,10350842.png,212614,4817,207797,0.977343919026969,1,3,42529,707,41822,0.983376049284018,19.67007111111111,2460.5717813333335,14.22044321803745,130,6.0E-5
7,test_20231101_135501,10863862.png,317432,7439,309993,0.9765650596033166,1,4,66058,1092,64966,0.9834690726331405,35.67820088888889,6511.628522666667,9.993907440417022,130,6.0E-5
8,test_20231101_135501,11382381.png,312486,817,311669,0.9973854828696326,1,3,46745,112,46633,0.9976040218205156,21.216531555555555,2458.9940213333334,14.223228880483061,130,6.0E-5
9,test_20231101_135501,11079715.png,443815,107837,335978,0.7570226333044174,3,4,124136,15131,109005,0.8781094928143327,17.708771555555554,2317.625856,14.480370335498858,130,6.0E-5
10,test_20231101_135501,11551286.png,271883,837,271046,0.9969214698969777,2,4,40092,122,39970,0.9969569989025242,16.70746488888889,1661.188816,15.926613623199302,130,6.0E-5
1,test_20231101_135501,10404007.png,502730,16402,486328,0.9673741372108289,2,8,61265,2384,58881,0.961087080714927,26.161904,3559.777616,12.61657492996368,130,7.000000000000001E-5
2,test_20231101_135501,1254659.png,342646,65252,277394,0.8095643900702183,3,5,80080,9171,70909,0.885477022977023,21.881578666666666,3492.428917333333,12.699527853441253,130,7.000000000000001E-5
3,test_20231101_135501,10188041.png,221231,8404,212827,0.9620125570105456,2,4,41731,1193,40538,0.9714121396563705,11.447850666666668,1280.5076586666667,17.056981805572335,130,7.000000000000001E-5
4,test_20231101_135501,10287332.png,216980,11449,205531,0.9472347681813992,2,4,22337,1574,20763,0.929533957111519,9.561258666666667,823.894464,18.97208776158452,130,7.000000000000001E-5
5,test_20231101_135501,11610969.png,368720,21407,347313,0.9419423953135171,2,4,84111,3130,80981,0.9627872692037902,22.610574222222223,3255.403008,13.004756004317752,130,7.000000000000001E-5
6,test_20231101_135501,10350842.png,212614,4817,207797,0.977343919026969,1,3,42529,707,41822,0.983376049284018,19.67007111111111,2460.5717813333335,14.22044321803745,130,7.000000000000001E-5
7,test_20231101_135501,10863862.png,317432,7439,309993,0.9765650596033166,1,4,66058,1092,64966,0.9834690726331405,35.67820088888889,6511.628522666667,9.993907440417022,130,7.000000000000001E-5
8,test_20231101_135501,11382381.png,312486,817,311669,0.9973854828696326,1,3,46745,112,46633,0.9976040218205156,21.216531555555555,2458.9940213333334,14.223228880483061,130,7.000000000000001E-5
9,test_20231101_135501,11079715.png,443815,107837,335978,0.7570226333044174,3,4,124136,15131,109005,0.8781094928143327,17.708771555555554,2317.625856,14.480370335498858,130,7.000000000000001E-5
10,test_20231101_135501,11551286.png,271883,657,271226,0.9975835193814987,2,4,40092,95,39997,0.9976304499650803,17.08696,1727.1593013333334,15.75747965107392,130,7.000000000000001E-5
1,test_20231101_135502,10404007.png,502730,16402,486328,0.9673741372108289,2,3,61265,2384,58881,0.961087080714927,26.161904,3559.777616,12.61657492996368,130,8.0E-5
2,test_20231101_135502,1254659.png,342646,65252,277394,0.8095643900702183,3,4,80080,9171,70909,0.885477022977023,21.881578666666666,3492.428917333333,12.699527853441253,130,8.0E-5
3,test_20231101_135502,10188041.png,221231,8404,212827,0.9620125570105456,2,4,41731,1193,40538,0.9714121396563705,11.447850666666668,1280.5076586666667,17.056981805572335,130,8.0E-5
4,test_20231101_135502,10287332.png,216980,11449,205531,0.9472347681813992,2,4,22337,1574,20763,0.929533957111519,9.561258666666667,823.894464,18.97208776158452,130,8.0E-5
5,test_20231101_135502,11610969.png,368720,21407,347313,0.9419423953135171,2,4,84111,3130,80981,0.9627872692037902,22.610574222222223,3255.403008,13.004756004317752,130,8.0E-5
6,test_20231101_135502,10350842.png,212614,4817,207797,0.977343919026969,2,4,42529,707,41822,0.983376049284018,19.67007111111111,2460.5717813333335,14.22044321803745,130,8.0E-5
7,test_20231101_135502,10863862.png,317432,7439,309993,0.9765650596033166,1,3,66058,1092,64966,0.9834690726331405,35.67820088888889,6511.628522666667,9.993907440417022,130,8.0E-5
8,test_20231101_135502,11382381.png,312486,817,311669,0.9973854828696326,2,3,46745,112,46633,0.9976040218205156,21.216531555555555,2458.9940213333334,14.223228880483061,130,8.0E-5
9,test_20231101_135502,11079715.png,443815,107837,335978,0.7570226333044174,5,5,124136,15131,109005,0.8781094928143327,17.708771555555554,2317.625856,14.480370335498858,130,8.0E-5
10,test_20231101_135502,11551286.png,271883,657,271226,0.9975835193814987,1,4,40092,95,39997,0.9976304499650803,17.08696,1727.1593013333334,15.75747965107392,130,8.0E-5
1,test_20231101_135503,10404007.png,502730,16402,486328,0.9673741372108289,3,4,61265,2384,58881,0.961087080714927,26.161904,3559.777616,12.61657492996368,130,9.0E-5
2,test_20231101_135503,1254659.png,342646,65252,277394,0.8095643900702183,3,4,80080,9171,70909,0.885477022977023,21.881578666666666,3492.428917333333,12.699527853441253,130,9.0E-5
3,test_20231101_135503,10188041.png,221231,8404,212827,0.9620125570105456,2,4,41731,1193,40538,0.9714121396563705,11.447850666666668,1280.5076586666667,17.056981805572335,130,9.0E-5
4,test_20231101_135503,10287332.png,216980,11449,205531,0.9472347681813992,2,3,22337,1574,20763,0.929533957111519,9.561258666666667,823.894464,18.97208776158452,130,9.0E-5
5,test_20231101_135503,11610969.png,368720,21407,347313,0.9419423953135171,2,4,84111,3130,80981,0.9627872692037902,22.610574222222223,3255.403008,13.004756004317752,130,9.0E-5
6,test_20231101_135503,10350842.png,212614,4817,207797,0.977343919026969,1,3,42529,707,41822,0.983376049284018,19.67007111111111,2460.5717813333335,14.22044321803745,130,9.0E-5
7,test_20231101_135503,10863862.png,317432,7439,309993,0.9765650596033166,2,3,66058,1092,64966,0.9834690726331405,35.67820088888889,6511.628522666667,9.993907440417022,130,9.0E-5
8,test_20231101_135503,11382381.png,312486,817,311669,0.9973854828696326,2,3,46745,112,46633,0.9976040218205156,21.216531555555555,2458.9940213333334,14.223228880483061,130,9.0E-5
9,test_20231101_135503,11079715.png,443815,107837,335978,0.7570226333044174,3,4,124136,15131,109005,0.8781094928143327,17.708771555555554,2317.625856,14.480370335498858,130,9.0E-5
10,test_20231101_135503,11551286.png,271883,657,271226,0.9975835193814987,1,3,40092,95,39997,0.9976304499650803,17.08696,1727.1593013333334,15.75747965107392,130,9.0E-5
1,test_20231101_135503,10404007.png,502730,16402,486328,0.9673741372108289,2,4,61265,2384,58881,0.961087080714927,26.161904,3559.777616,12.61657492996368,130,1.0E-4
2,test_20231101_135503,1254659.png,342646,65252,277394,0.8095643900702183,2,4,80080,9171,70909,0.885477022977023,21.881578666666666,3492.428917333333,12.699527853441253,130,1.0E-4
3,test_20231101_135503,10188041.png,221231,8404,212827,0.9620125570105456,2,4,41731,1193,40538,0.9714121396563705,11.447850666666668,1280.5076586666667,17.056981805572335,130,1.0E-4
4,test_20231101_135503,10287332.png,216980,11449,205531,0.9472347681813992,2,8,22337,1574,20763,0.929533957111519,9.561258666666667,823.894464,18.97208776158452,130,1.0E-4
5,test_20231101_135503,11610969.png,368720,21407,347313,0.9419423953135171,2,3,84111,3130,80981,0.9627872692037902,22.610574222222223,3255.403008,13.004756004317752,130,1.0E-4
6,test_20231101_135503,10350842.png,212614,4817,207797,0.977343919026969,2,4,42529,707,41822,0.983376049284018,19.67007111111111,2460.5717813333335,14.22044321803745,130,1.0E-4
7,test_20231101_135503,10863862.png,317432,7439,309993,0.9765650596033166,1,3,66058,1092,64966,0.9834690726331405,35.67820088888889,6511.628522666667,9.993907440417022,130,1.0E-4
8,test_20231101_135503,11382381.png,312486,817,311669,0.9973854828696326,1,5,46745,112,46633,0.9976040218205156,21.216531555555555,2458.9940213333334,14.223228880483061,130,1.0E-4
9,test_20231101_135503,11079715.png,443815,107837,335978,0.7570226333044174,3,4,124136,15131,109005,0.8781094928143327,17.708771555555554,2317.625856,14.480370335498858,130,1.0E-4
10,test_20231101_135503,11551286.png,271883,657,271226,0.9975835193814987,2,3,40092,95,39997,0.9976304499650803,17.08696,1727.1593013333334,15.75747965107392,130,1.0E-4
1,test_20231101_135504,10404007.png,502730,16402,486328,0.9673741372108289,2,4,61265,2384,58881,0.961087080714927,26.161904,3559.777616,12.61657492996368,130,1.1E-4
2,test_20231101_135504,1254659.png,342646,65252,277394,0.8095643900702183,3,4,80080,9171,70909,0.885477022977023,21.881578666666666,3492.428917333333,12.699527853441253,130,1.1E-4
3,test_20231101_135504,10188041.png,221231,8404,212827,0.9620125570105456,2,4,41731,1193,40538,0.9714121396563705,11.447850666666668,1280.5076586666667,17.056981805572335,130,1.1E-4
4,test_20231101_135504,10287332.png,216980,11449,205531,0.9472347681813992,2,4,22337,1574,20763,0.929533957111519,9.561258666666667,823.894464,18.97208776158452,130,1.1E-4
5,test_20231101_135504,11610969.png,368720,21407,347313,0.9419423953135171,3,3,84111,3130,80981,0.9627872692037902,22.610574222222223,3255.403008,13.004756004317752,130,1.1E-4
6,test_20231101_135504,10350842.png,212614,4817,207797,0.977343919026969,1,3,42529,707,41822,0.983376049284018,19.67007111111111,2460.5717813333335,14.22044321803745,130,1.1E-4
7,test_20231101_135504,10863862.png,317432,7439,309993,0.9765650596033166,2,4,66058,1092,64966,0.9834690726331405,35.67820088888889,6511.628522666667,9.993907440417022,130,1.1E-4
8,test_20231101_135504,11382381.png,312486,817,311669,0.9973854828696326,2,4,46745,112,46633,0.9976040218205156,21.216531555555555,2458.9940213333334,14.223228880483061,130,1.1E-4
9,test_20231101_135504,11079715.png,443815,107837,335978,0.7570226333044174,3,4,124136,15131,109005,0.8781094928143327,17.708771555555554,2317.625856,14.480370335498858,130,1.1E-4
10,test_20231101_135504,11551286.png,271883,657,271226,0.9975835193814987,1,4,40092,95,39997,0.9976304499650803,17.08696,1727.1593013333334,15.75747965107392,130,1.1E-4
1,test_20231101_135505,10404007.png,502730,16402,486328,0.9673741372108289,3,4,61265,2384,58881,0.961087080714927,26.161904,3559.777616,12.61657492996368,130,1.2E-4
2,test_20231101_135505,1254659.png,342646,65252,277394,0.8095643900702183,3,4,80080,9171,70909,0.885477022977023,21.881578666666666,3492.428917333333,12.699527853441253,130,1.2E-4
3,test_20231101_135505,10188041.png,221231,8404,212827,0.9620125570105456,2,3,41731,1193,40538,0.9714121396563705,11.447850666666668,1280.5076586666667,17.056981805572335,130,1.2E-4
4,test_20231101_135505,10287332.png,216980,11449,205531,0.9472347681813992,2,4,22337,1574,20763,0.929533957111519,9.561258666666667,823.894464,18.97208776158452,130,1.2E-4
5,test_20231101_135505,11610969.png,368720,21407,347313,0.9419423953135171,2,4,84111,3130,80981,0.9627872692037902,22.610574222222223,3255.403008,13.004756004317752,130,1.2E-4
6,test_20231101_135505,10350842.png,212614,4817,207797,0.977343919026969,1,4,42529,707,41822,0.983376049284018,19.67007111111111,2460.5717813333335,14.22044321803745,130,1.2E-4
7,test_20231101_135505,10863862.png,317432,7439,309993,0.9765650596033166,1,4,66058,1092,64966,0.9834690726331405,35.67820088888889,6511.628522666667,9.993907440417022,130,1.2E-4
8,test_20231101_135505,11382381.png,312486,817,311669,0.9973854828696326,1,4,46745,112,46633,0.9976040218205156,21.216531555555555,2458.9940213333334,14.223228880483061,130,1.2E-4
9,test_20231101_135505,11079715.png,443815,107837,335978,0.7570226333044174,4,4,124136,15131,109005,0.8781094928143327,17.708771555555554,2317.625856,14.480370335498858,130,1.2E-4
10,test_20231101_135505,11551286.png,271883,657,271226,0.9975835193814987,1,3,40092,95,39997,0.9976304499650803,17.08696,1727.1593013333334,15.75747965107392,130,1.2E-4
1,test_20231101_135505,10404007.png,502730,16402,486328,0.9673741372108289,2,4,61265,2384,58881,0.961087080714927,26.161904,3559.777616,12.61657492996368,130,1.3000000000000002E-4
2,test_20231101_135505,1254659.png,342646,65252,277394,0.8095643900702183,3,4,80080,9171,70909,0.885477022977023,21.881578666666666,3492.428917333333,12.699527853441253,130,1.3000000000000002E-4
3,test_20231101_135505,10188041.png,221231,8404,212827,0.9620125570105456,3,3,41731,1193,40538,0.9714121396563705,11.447850666666668,1280.5076586666667,17.056981805572335,130,1.3000000000000002E-4
4,test_20231101_135505,10287332.png,216980,11449,205531,0.9472347681813992,2,4,22337,1574,20763,0.929533957111519,9.561258666666667,823.894464,18.97208776158452,130,1.3000000000000002E-4
5,test_20231101_135505,11610969.png,368720,21407,347313,0.9419423953135171,2,4,84111,3130,80981,0.9627872692037902,22.610574222222223,3255.403008,13.004756004317752,130,1.3000000000000002E-4
6,test_20231101_135505,10350842.png,212614,4817,207797,0.977343919026969,1,4,42529,707,41822,0.983376049284018,19.67007111111111,2460.5717813333335,14.22044321803745,130,1.3000000000000002E-4
7,test_20231101_135505,10863862.png,317432,7439,309993,0.9765650596033166,2,3,66058,1092,64966,0.9834690726331405,35.67820088888889,6511.628522666667,9.993907440417022,130,1.3000000000000002E-4
8,test_20231101_135505,11382381.png,312486,817,311669,0.9973854828696326,1,4,46745,112,46633,0.9976040218205156,21.216531555555555,2458.9940213333334,14.223228880483061,130,1.3000000000000002E-4
9,test_20231101_135505,11079715.png,443815,107837,335978,0.7570226333044174,3,8,124136,15131,109005,0.8781094928143327,17.708771555555554,2317.625856,14.480370335498858,130,1.3000000000000002E-4
10,test_20231101_135505,11551286.png,271883,537,271346,0.9980248857045126,1,4,40092,77,40015,0.9980794173401177,17.637048888888888,1823.0123626666666,15.522907470567574,130,1.3000000000000002E-4
1,test_20231101_135506,10404007.png,502730,16402,486328,0.9673741372108289,2,4,61265,2384,58881,0.961087080714927,26.161904,3559.777616,12.61657492996368,130,1.4000000000000001E-4
2,test_20231101_135506,1254659.png,342646,65252,277394,0.8095643900702183,3,4,80080,9171,70909,0.885477022977023,21.881578666666666,3492.428917333333,12.699527853441253,130,1.4000000000000001E-4
3,test_20231101_135506,10188041.png,221231,8404,212827,0.9620125570105456,2,4,41731,1193,40538,0.9714121396563705,11.447850666666668,1280.5076586666667,17.056981805572335,130,1.4000000000000001E-4
4,test_20231101_135506,10287332.png,216980,11449,205531,0.9472347681813992,2,4,22337,1574,20763,0.929533957111519,9.561258666666667,823.894464,18.97208776158452,130,1.4000000000000001E-4
5,test_20231101_135506,11610969.png,368720,21407,347313,0.9419423953135171,3,4,84111,3130,80981,0.9627872692037902,22.610574222222223,3255.403008,13.004756004317752,130,1.4000000000000001E-4
6,test_20231101_135506,10350842.png,212614,4817,207797,0.977343919026969,1,4,42529,707,41822,0.983376049284018,19.67007111111111,2460.5717813333335,14.22044321803745,130,1.4000000000000001E-4
7,test_20231101_135506,10863862.png,317432,7439,309993,0.9765650596033166,1,4,66058,1092,64966,0.9834690726331405,35.67820088888889,6511.628522666667,9.993907440417022,130,1.4000000000000001E-4
8,test_20231101_135506,11382381.png,312486,817,311669,0.9973854828696326,2,4,46745,112,46633,0.9976040218205156,21.216531555555555,2458.9940213333334,14.223228880483061,130,1.4000000000000001E-4
9,test_20231101_135506,11079715.png,443815,107837,335978,0.7570226333044174,3,4,124136,15131,109005,0.8781094928143327,17.708771555555554,2317.625856,14.480370335498858,130,1.4000000000000001E-4
10,test_20231101_135506,11551286.png,271883,537,271346,0.9980248857045126,1,3,40092,77,40015,0.9980794173401177,17.637048888888888,1823.0123626666666,15.522907470567574,130,1.4000000000000001E-4
1,test_20231101_135507,10404007.png,502730,16402,486328,0.9673741372108289,2,3,61265,2384,58881,0.961087080714927,26.161904,3559.777616,12.61657492996368,130,1.5000000000000001E-4
2,test_20231101_135507,1254659.png,342646,65252,277394,0.8095643900702183,3,4,80080,9171,70909,0.885477022977023,21.881578666666666,3492.428917333333,12.699527853441253,130,1.5000000000000001E-4
3,test_20231101_135507,10188041.png,221231,8404,212827,0.9620125570105456,2,3,41731,1193,40538,0.9714121396563705,11.447850666666668,1280.5076586666667,17.056981805572335,130,1.5000000000000001E-4
4,test_20231101_135507,10287332.png,216980,11449,205531,0.9472347681813992,2,3,22337,1574,20763,0.929533957111519,9.561258666666667,823.894464,18.97208776158452,130,1.5000000000000001E-4
5,test_20231101_135507,11610969.png,368720,21407,347313,0.9419423953135171,2,4,84111,3130,80981,0.9627872692037902,22.610574222222223,3255.403008,13.004756004317752,130,1.5000000000000001E-4
6,test_20231101_135507,10350842.png,212614,4817,207797,0.977343919026969,2,4,42529,707,41822,0.983376049284018,19.67007111111111,2460.5717813333335,14.22044321803745,130,1.5000000000000001E-4
7,test_20231101_135507,10863862.png,317432,7439,309993,0.9765650596033166,2,4,66058,1092,64966,0.9834690726331405,35.67820088888889,6511.628522666667,9.993907440417022,130,1.5000000000000001E-4
8,test_20231101_135507,11382381.png,312486,707,311779,0.9977374986399391,2,4,46745,96,46649,0.9979463044175848,21.47300977777778,2499.126186666667,14.152921756540431,130,1.5000000000000001E-4
9,test_20231101_135507,11079715.png,443815,107837,335978,0.7570226333044174,3,4,124136,15131,109005,0.8781094928143327,17.708771555555554,2317.625856,14.480370335498858,130,1.5000000000000001E-4
10,test_20231101_135507,11551286.png,271883,537,271346,0.9980248857045126,1,3,40092,77,40015,0.9980794173401177,17.637048888888888,1823.0123626666666,15.522907470567574,130,1.5000000000000001E-4
1,test_20231101_135508,10404007.png,502730,16402,486328,0.9673741372108289,2,3,61265,2384,58881,0.961087080714927,26.161904,3559.777616,12.61657492996368,130,1.6E-4
2,test_20231101_135508,1254659.png,342646,65252,277394,0.8095643900702183,2,3,80080,9171,70909,0.885477022977023,21.881578666666666,3492.428917333333,12.699527853441253,130,1.6E-4
3,test_20231101_135508,10188041.png,221231,8404,212827,0.9620125570105456,2,4,41731,1193,40538,0.9714121396563705,11.447850666666668,1280.5076586666667,17.056981805572335,130,1.6E-4
4,test_20231101_135508,10287332.png,216980,11257,205723,0.9481196423633514,2,4,22337,1550,20787,0.9306084075748757,9.689633777777777,850.2091146666667,18.835546043579313,130,1.6E-4
5,test_20231101_135508,11610969.png,368720,21407,347313,0.9419423953135171,3,4,84111,3130,80981,0.9627872692037902,22.610574222222223,3255.403008,13.004756004317752,130,1.6E-4
6,test_20231101_135508,10350842.png,212614,4817,207797,0.977343919026969,2,3,42529,707,41822,0.983376049284018,19.67007111111111,2460.5717813333335,14.22044321803745,130,1.6E-4
7,test_20231101_135508,10863862.png,317432,7439,309993,0.9765650596033166,2,4,66058,1092,64966,0.9834690726331405,35.67820088888889,6511.628522666667,9.993907440417022,130,1.6E-4
8,test_20231101_135508,11382381.png,312486,707,311779,0.9977374986399391,2,3,46745,96,46649,0.9979463044175848,21.47300977777778,2499.126186666667,14.152921756540431,130,1.6E-4
9,test_20231101_135508,11079715.png,443815,107837,335978,0.7570226333044174,4,4,124136,15131,109005,0.8781094928143327,17.708771555555554,2317.625856,14.480370335498858,130,1.6E-4
10,test_20231101_135508,11551286.png,271883,537,271346,0.9980248857045126,2,3,40092,77,40015,0.9980794173401177,17.637048888888888,1823.0123626666666,15.522907470567574,130,1.6E-4
1,test_20231101_135508,10404007.png,502730,16402,486328,0.9673741372108289,2,4,61265,2384,58881,0.961087080714927,26.161904,3559.777616,12.61657492996368,130,1.7E-4
2,test_20231101_135508,1254659.png,342646,65252,277394,0.8095643900702183,3,4,80080,9171,70909,0.885477022977023,21.881578666666666,3492.428917333333,12.699527853441253,130,1.7E-4
3,test_20231101_135508,10188041.png,221231,8404,212827,0.9620125570105456,2,4,41731,1193,40538,0.9714121396563705,11.447850666666668,1280.5076586666667,17.056981805572335,130,1.7E-4
4,test_20231101_135508,10287332.png,216980,11257,205723,0.9481196423633514,1,3,22337,1550,20787,0.9306084075748757,9.689633777777777,850.2091146666667,18.835546043579313,130,1.7E-4
5,test_20231101_135508,11610969.png,368720,21407,347313,0.9419423953135171,2,4,84111,3130,80981,0.9627872692037902,22.610574222222223,3255.403008,13.004756004317752,130,1.7E-4
6,test_20231101_135508,10350842.png,212614,4817,207797,0.977343919026969,2,3,42529,707,41822,0.983376049284018,19.67007111111111,2460.5717813333335,14.22044321803745,130,1.7E-4
7,test_20231101_135508,10863862.png,317432,7439,309993,0.9765650596033166,2,3,66058,1092,64966,0.9834690726331405,35.67820088888889,6511.628522666667,9.993907440417022,130,1.7E-4
8,test_20231101_135508,11382381.png,312486,707,311779,0.9977374986399391,1,3,46745,96,46649,0.9979463044175848,21.47300977777778,2499.126186666667,14.152921756540431,130,1.7E-4
9,test_20231101_135508,11079715.png,443815,107837,335978,0.7570226333044174,3,4,124136,15131,109005,0.8781094928143327,17.708771555555554,2317.625856,14.480370335498858,130,1.7E-4
10,test_20231101_135508,11551286.png,271883,537,271346,0.9980248857045126,2,4,40092,77,40015,0.9980794173401177,17.637048888888888,1823.0123626666666,15.522907470567574,130,1.7E-4
1,test_20231101_135509,10404007.png,502730,16402,486328,0.9673741372108289,2,4,61265,2384,58881,0.961087080714927,26.161904,3559.777616,12.61657492996368,130,1.8E-4
2,test_20231101_135509,1254659.png,342646,65252,277394,0.8095643900702183,3,4,80080,9171,70909,0.885477022977023,21.881578666666666,3492.428917333333,12.699527853441253,130,1.8E-4
3,test_20231101_135509,10188041.png,221231,8404,212827,0.9620125570105456,2,4,41731,1193,40538,0.9714121396563705,11.447850666666668,1280.5076586666667,17.056981805572335,130,1.8E-4
4,test_20231101_135509,10287332.png,216980,11257,205723,0.9481196423633514,2,4,22337,1550,20787,0.9306084075748757,9.689633777777777,850.2091146666667,18.835546043579313,130,1.8E-4
5,test_20231101_135509,11610969.png,368720,21407,347313,0.9419423953135171,2,4,84111,3130,80981,0.9627872692037902,22.610574222222223,3255.403008,13.004756004317752,130,1.8E-4
6,test_20231101_135509,10350842.png,212614,4817,207797,0.977343919026969,2,4,42529,707,41822,0.983376049284018,19.67007111111111,2460.5717813333335,14.22044321803745,130,1.8E-4
7,test_20231101_135509,10863862.png,317432,7439,309993,0.9765650596033166,1,3,66058,1092,64966,0.9834690726331405,35.67820088888889,6511.628522666667,9.993907440417022,130,1.8E-4
8,test_20231101_135509,11382381.png,312486,707,311779,0.9977374986399391,1,3,46745,96,46649,0.9979463044175848,21.47300977777778,2499.126186666667,14.152921756540431,130,1.8E-4
9,test_20231101_135509,11079715.png,443815,107837,335978,0.7570226333044174,3,4,124136,15131,109005,0.8781094928143327,17.708771555555554,2317.625856,14.480370335498858,130,1.8E-4
10,test_20231101_135509,11551286.png,271883,537,271346,0.9980248857045126,1,3,40092,77,40015,0.9980794173401177,17.637048888888888,1823.0123626666666,15.522907470567574,130,1.8E-4
1,test_20231101_135510,10404007.png,502730,16402,486328,0.9673741372108289,2,4,61265,2384,58881,0.961087080714927,26.161904,3559.777616,12.61657492996368,130,1.9E-4
2,test_20231101_135510,1254659.png,342646,65252,277394,0.8095643900702183,2,4,80080,9171,70909,0.885477022977023,21.881578666666666,3492.428917333333,12.699527853441253,130,1.9E-4
3,test_20231101_135510,10188041.png,221231,8404,212827,0.9620125570105456,2,3,41731,1193,40538,0.9714121396563705,11.447850666666668,1280.5076586666667,17.056981805572335,130,1.9E-4
4,test_20231101_135510,10287332.png,216980,11257,205723,0.9481196423633514,2,3,22337,1550,20787,0.9306084075748757,9.689633777777777,850.2091146666667,18.835546043579313,130,1.9E-4
5,test_20231101_135510,11610969.png,368720,21407,347313,0.9419423953135171,2,4,84111,3130,80981,0.9627872692037902,22.610574222222223,3255.403008,13.004756004317752,130,1.9E-4
6,test_20231101_135510,10350842.png,212614,4817,207797,0.977343919026969,1,4,42529,707,41822,0.983376049284018,19.67007111111111,2460.5717813333335,14.22044321803745,130,1.9E-4
7,test_20231101_135510,10863862.png,317432,7439,309993,0.9765650596033166,1,3,66058,1092,64966,0.9834690726331405,35.67820088888889,6511.628522666667,9.993907440417022,130,1.9E-4
8,test_20231101_135510,11382381.png,312486,707,311779,0.9977374986399391,1,3,46745,96,46649,0.9979463044175848,21.47300977777778,2499.126186666667,14.152921756540431,130,1.9E-4
9,test_20231101_135510,11079715.png,443815,107837,335978,0.7570226333044174,3,5,124136,15131,109005,0.8781094928143327,17.708771555555554,2317.625856,14.480370335498858,130,1.9E-4
10,test_20231101_135510,11551286.png,271883,537,271346,0.9980248857045126,1,4,40092,77,40015,0.9980794173401177,17.637048888888888,1823.0123626666666,15.522907470567574,130,1.9E-4
1,test_20231101_135510,10404007.png,502730,16402,486328,0.9673741372108289,2,4,61265,2384,58881,0.961087080714927,26.161904,3559.777616,12.61657492996368,130,2.0E-4
2,test_20231101_135510,1254659.png,342646,65252,277394,0.8095643900702183,3,4,80080,9171,70909,0.885477022977023,21.881578666666666,3492.428917333333,12.699527853441253,130,2.0E-4
3,test_20231101_135510,10188041.png,221231,8404,212827,0.9620125570105456,2,4,41731,1193,40538,0.9714121396563705,11.447850666666668,1280.5076586666667,17.056981805572335,130,2.0E-4
4,test_20231101_135510,10287332.png,216980,11257,205723,0.9481196423633514,2,4,22337,1550,20787,0.9306084075748757,9.689633777777777,850.2091146666667,18.835546043579313,130,2.0E-4
5,test_20231101_135510,11610969.png,368720,21407,347313,0.9419423953135171,2,4,84111,3130,80981,0.9627872692037902,22.610574222222223,3255.403008,13.004756004317752,130,2.0E-4
6,test_20231101_135510,10350842.png,212614,4817,207797,0.977343919026969,2,3,42529,707,41822,0.983376049284018,19.67007111111111,2460.5717813333335,14.22044321803745,130,2.0E-4
7,test_20231101_135510,10863862.png,317432,7439,309993,0.9765650596033166,2,3,66058,1092,64966,0.9834690726331405,35.67820088888889,6511.628522666667,9.993907440417022,130,2.0E-4
8,test_20231101_135510,11382381.png,312486,707,311779,0.9977374986399391,1,4,46745,96,46649,0.9979463044175848,21.47300977777778,2499.126186666667,14.152921756540431,130,2.0E-4
9,test_20231101_135510,11079715.png,443815,107837,335978,0.7570226333044174,4,4,124136,15131,109005,0.8781094928143327,17.708771555555554,2317.625856,14.480370335498858,130,2.0E-4
10,test_20231101_135510,11551286.png,271883,267,271616,0.9990179599312939,1,4,40092,37,40055,0.9990771226179787,17.919265777777778,1867.1754613333333,15.418952296845859,130,2.0E-4
1,test_20231101_135511,10404007.png,502730,16402,486328,0.9673741372108289,2,3,61265,2384,58881,0.961087080714927,26.161904,3559.777616,12.61657492996368,130,2.1E-4
2,test_20231101_135511,1254659.png,342646,65252,277394,0.8095643900702183,3,4,80080,9171,70909,0.885477022977023,21.881578666666666,3492.428917333333,12.699527853441253,130,2.1E-4
3,test_20231101_135511,10188041.png,221231,8404,212827,0.9620125570105456,2,3,41731,1193,40538,0.9714121396563705,11.447850666666668,1280.5076586666667,17.056981805572335,130,2.1E-4
4,test_20231101_135511,10287332.png,216980,11257,205723,0.9481196423633514,2,4,22337,1550,20787,0.9306084075748757,9.689633777777777,850.2091146666667,18.835546043579313,130,2.1E-4
5,test_20231101_135511,11610969.png,368720,21407,347313,0.9419423953135171,2,4,84111,3130,80981,0.9627872692037902,22.610574222222223,3255.403008,13.004756004317752,130,2.1E-4
6,test_20231101_135511,10350842.png,212614,4817,207797,0.977343919026969,2,4,42529,707,41822,0.983376049284018,19.67007111111111,2460.5717813333335,14.22044321803745,130,2.1E-4
7,test_20231101_135511,10863862.png,317432,7439,309993,0.9765650596033166,2,4,66058,1092,64966,0.9834690726331405,35.67820088888889,6511.628522666667,9.993907440417022,130,2.1E-4
8,test_20231101_135511,11382381.png,312486,707,311779,0.9977374986399391,2,4,46745,96,46649,0.9979463044175848,21.47300977777778,2499.126186666667,14.152921756540431,130,2.1E-4
9,test_20231101_135511,11079715.png,443815,107837,335978,0.7570226333044174,3,4,124136,15131,109005,0.8781094928143327,17.708771555555554,2317.625856,14.480370335498858,130,2.1E-4
10,test_20231101_135511,11551286.png,271883,267,271616,0.9990179599312939,1,4,40092,37,40055,0.9990771226179787,17.919265777777778,1867.1754613333333,15.418952296845859,130,2.1E-4
1,test_20231101_135512,10404007.png,502730,16402,486328,0.9673741372108289,2,3,61265,2384,58881,0.961087080714927,26.161904,3559.777616,12.61657492996368,130,2.2E-4
2,test_20231101_135512,1254659.png,342646,65252,277394,0.8095643900702183,3,4,80080,9171,70909,0.885477022977023,21.881578666666666,3492.428917333333,12.699527853441253,130,2.2E-4
3,test_20231101_135512,10188041.png,221231,8404,212827,0.9620125570105456,2,4,41731,1193,40538,0.9714121396563705,11.447850666666668,1280.5076586666667,17.056981805572335,130,2.2E-4
4,test_20231101_135512,10287332.png,216980,11257,205723,0.9481196423633514,2,4,22337,1550,20787,0.9306084075748757,9.689633777777777,850.2091146666667,18.835546043579313,130,2.2E-4
5,test_20231101_135512,11610969.png,368720,21407,347313,0.9419423953135171,2,4,84111,3130,80981,0.9627872692037902,22.610574222222223,3255.403008,13.004756004317752,130,2.2E-4
6,test_20231101_135512,10350842.png,212614,4817,207797,0.977343919026969,2,3,42529,707,41822,0.983376049284018,19.67007111111111,2460.5717813333335,14.22044321803745,130,2.2E-4
7,test_20231101_135512,10863862.png,317432,7439,309993,0.9765650596033166,1,4,66058,1092,64966,0.9834690726331405,35.67820088888889,6511.628522666667,9.993907440417022,130,2.2E-4
8,test_20231101_135512,11382381.png,312486,707,311779,0.9977374986399391,2,3,46745,96,46649,0.9979463044175848,21.47300977777778,2499.126186666667,14.152921756540431,130,2.2E-4
9,test_20231101_135512,11079715.png,443815,107837,335978,0.7570226333044174,3,4,124136,15131,109005,0.8781094928143327,17.708771555555554,2317.625856,14.480370335498858,130,2.2E-4
10,test_20231101_135512,11551286.png,271883,267,271616,0.9990179599312939,2,3,40092,37,40055,0.9990771226179787,17.919265777777778,1867.1754613333333,15.418952296845859,130,2.2E-4
1,test_20231101_135512,10404007.png,502730,16402,486328,0.9673741372108289,2,3,61265,2384,58881,0.961087080714927,26.161904,3559.777616,12.61657492996368,130,2.3E-4
2,test_20231101_135512,1254659.png,342646,65252,277394,0.8095643900702183,2,3,80080,9171,70909,0.885477022977023,21.881578666666666,3492.428917333333,12.699527853441253,130,2.3E-4
3,test_20231101_135512,10188041.png,221231,8404,212827,0.9620125570105456,2,4,41731,1193,40538,0.9714121396563705,11.447850666666668,1280.5076586666667,17.056981805572335,130,2.3E-4
4,test_20231101_135512,10287332.png,216980,11257,205723,0.9481196423633514,1,3,22337,1550,20787,0.9306084075748757,9.689633777777777,850.2091146666667,18.835546043579313,130,2.3E-4
5,test_20231101_135512,11610969.png,368720,21407,347313,0.9419423953135171,2,4,84111,3130,80981,0.9627872692037902,22.610574222222223,3255.403008,13.004756004317752,130,2.3E-4
6,test_20231101_135512,10350842.png,212614,4817,207797,0.977343919026969,2,3,42529,707,41822,0.983376049284018,19.67007111111111,2460.5717813333335,14.22044321803745,130,2.3E-4
7,test_20231101_135512,10863862.png,317432,7439,309993,0.9765650596033166,1,3,66058,1092,64966,0.9834690726331405,35.67820088888889,6511.628522666667,9.993907440417022,130,2.3E-4
8,test_20231101_135512,11382381.png,312486,707,311779,0.9977374986399391,2,3,46745,96,46649,0.9979463044175848,21.47300977777778,2499.126186666667,14.152921756540431,130,2.3E-4
9,test_20231101_135512,11079715.png,443815,107837,335978,0.7570226333044174,3,22,124136,15131,109005,0.8781094928143327,17.708771555555554,2317.625856,14.480370335498858,130,2.3E-4
10,test_20231101_135512,11551286.png,271883,267,271616,0.9990179599312939,2,3,40092,37,40055,0.9990771226179787,17.919265777777778,1867.1754613333333,15.418952296845859,130,2.3E-4
1,test_20231101_135513,10404007.png,502730,16402,486328,0.9673741372108289,2,4,61265,2384,58881,0.961087080714927,26.161904,3559.777616,12.61657492996368,130,2.4E-4
2,test_20231101_135513,1254659.png,342646,65252,277394,0.8095643900702183,3,4,80080,9171,70909,0.885477022977023,21.881578666666666,3492.428917333333,12.699527853441253,130,2.4E-4
3,test_20231101_135513,10188041.png,221231,8404,212827,0.9620125570105456,2,4,41731,1193,40538,0.9714121396563705,11.447850666666668,1280.5076586666667,17.056981805572335,130,2.4E-4
4,test_20231101_135513,10287332.png,216980,11257,205723,0.9481196423633514,2,4,22337,1550,20787,0.9306084075748757,9.689633777777777,850.2091146666667,18.835546043579313,130,2.4E-4
5,test_20231101_135513,11610969.png,368720,21407,347313,0.9419423953135171,2,4,84111,3130,80981,0.9627872692037902,22.610574222222223,3255.403008,13.004756004317752,130,2.4E-4
6,test_20231101_135513,10350842.png,212614,4817,207797,0.977343919026969,1,3,42529,707,41822,0.983376049284018,19.67007111111111,2460.5717813333335,14.22044321803745,130,2.4E-4
7,test_20231101_135513,10863862.png,317432,7439,309993,0.9765650596033166,1,3,66058,1092,64966,0.9834690726331405,35.67820088888889,6511.628522666667,9.993907440417022,130,2.4E-4
8,test_20231101_135513,11382381.png,312486,707,311779,0.9977374986399391,1,3,46745,96,46649,0.9979463044175848,21.47300977777778,2499.126186666667,14.152921756540431,130,2.4E-4
9,test_20231101_135513,11079715.png,443815,107837,335978,0.7570226333044174,3,4,124136,15131,109005,0.8781094928143327,17.708771555555554,2317.625856,14.480370335498858,130,2.4E-4
10,test_20231101_135513,11551286.png,271883,267,271616,0.9990179599312939,1,3,40092,37,40055,0.9990771226179787,17.919265777777778,1867.1754613333333,15.418952296845859,130,2.4E-4
1,test_20231101_135514,10404007.png,502730,16402,486328,0.9673741372108289,2,4,61265,2384,58881,0.961087080714927,26.161904,3559.777616,12.61657492996368,130,2.5E-4
2,test_20231101_135514,1254659.png,342646,65252,277394,0.8095643900702183,3,4,80080,9171,70909,0.885477022977023,21.881578666666666,3492.428917333333,12.699527853441253,130,2.5E-4
3,test_20231101_135514,10188041.png,221231,8404,212827,0.9620125570105456,2,3,41731,1193,40538,0.9714121396563705,11.447850666666668,1280.5076586666667,17.056981805572335,130,2.5E-4
4,test_20231101_135514,10287332.png,216980,11257,205723,0.9481196423633514,2,4,22337,1550,20787,0.9306084075748757,9.689633777777777,850.2091146666667,18.835546043579313,130,2.5E-4
5,test_20231101_135514,11610969.png,368720,21407,347313,0.9419423953135171,2,4,84111,3130,80981,0.9627872692037902,22.610574222222223,3255.403008,13.004756004317752,130,2.5E-4
6,test_20231101_135514,10350842.png,212614,4817,207797,0.977343919026969,2,4,42529,707,41822,0.983376049284018,19.67007111111111,2460.5717813333335,14.22044321803745,130,2.5E-4
7,test_20231101_135514,10863862.png,317432,7439,309993,0.9765650596033166,2,4,66058,1092,64966,0.9834690726331405,35.67820088888889,6511.628522666667,9.993907440417022,130,2.5E-4
8,test_20231101_135514,11382381.png,312486,707,311779,0.9977374986399391,2,3,46745,96,46649,0.9979463044175848,21.47300977777778,2499.126186666667,14.152921756540431,130,2.5E-4
9,test_20231101_135514,11079715.png,443815,107837,335978,0.7570226333044174,4,4,124136,15131,109005,0.8781094928143327,17.708771555555554,2317.625856,14.480370335498858,130,2.5E-4
10,test_20231101_135514,11551286.png,271883,267,271616,0.9990179599312939,1,14,40092,37,40055,0.9990771226179787,17.919265777777778,1867.1754613333333,15.418952296845859,130,2.5E-4
1,test_20231101_135514,10404007.png,502730,16282,486448,0.9676128339267599,2,3,61265,2367,58898,0.9613645637802987,26.166622222222223,3560.861381333333,12.615252932576213,130,2.6000000000000003E-4
2,test_20231101_135514,1254659.png,342646,65192,277454,0.8097394979074614,3,4,80080,9165,70915,0.885551948051948,21.891132444444445,3493.511104,12.698182328858888,130,2.6000000000000003E-4
3,test_20231101_135514,10188041.png,221231,8364,212867,0.9621933634978823,2,4,41731,1187,40544,0.9715559176631281,11.813678222222222,1332.7883626666667,16.88319168860807,130,2.6000000000000003E-4
4,test_20231101_135514,10287332.png,216980,11257,205723,0.9481196423633514,2,4,22337,1550,20787,0.9306084075748757,9.689633777777777,850.2091146666667,18.835546043579313,130,2.6000000000000003E-4
5,test_20231101_135514,11610969.png,368720,21127,347593,0.9427017791277934,2,4,84111,3090,81021,0.9632628312586938,23.026140444444444,3340.5999893333333,12.892558854769415,130,2.6000000000000003E-4
6,test_20231101_135514,10350842.png,212614,4817,207797,0.977343919026969,1,4,42529,707,41822,0.983376049284018,19.67007111111111,2460.5717813333335,14.22044321803745,130,2.6000000000000003E-4
7,test_20231101_135514,10863862.png,317432,7399,310033,0.9766910708435192,2,4,66058,1086,64972,0.983559901904387,35.68389688888889,6512.697578666666,9.993194489713737,130,2.6000000000000003E-4
8,test_20231101_135514,11382381.png,312486,587,311899,0.9981215158439098,2,3,46745,78,46667,0.9983313723392876,21.967536,2569.068496,14.03304677372966,130,2.6000000000000003E-4
9,test_20231101_135514,11079715.png,443815,107837,335978,0.7570226333044174,3,4,124136,15131,109005,0.8781094928143327,17.708771555555554,2317.625856,14.480370335498858,130,2.6000000000000003E-4
10,test_20231101_135514,11551286.png,271883,204,271679,0.9992496772508763,2,3,40092,28,40064,0.9993016063054974,18.067507555555554,1885.468496,15.37661080624634,130,2.6000000000000003E-4
1,test_20231101_135515,10404007.png,502730,16282,486448,0.9676128339267599,2,4,61265,2367,58898,0.9613645637802987,26.166622222222223,3560.861381333333,12.615252932576213,130,2.7000000000000006E-4
2,test_20231101_135515,1254659.png,342646,65192,277454,0.8097394979074614,3,4,80080,9165,70915,0.885551948051948,21.891132444444445,3493.511104,12.698182328858888,130,2.7000000000000006E-4
3,test_20231101_135515,10188041.png,221231,8364,212867,0.9621933634978823,2,3,41731,1187,40544,0.9715559176631281,11.813678222222222,1332.7883626666667,16.88319168860807,130,2.7000000000000006E-4
4,test_20231101_135515,10287332.png,216980,11257,205723,0.9481196423633514,3,4,22337,1550,20787,0.9306084075748757,9.689633777777777,850.2091146666667,18.835546043579313,130,2.7000000000000006E-4
5,test_20231101_135515,11610969.png,368720,21127,347593,0.9427017791277934,2,5,84111,3090,81021,0.9632628312586938,23.026140444444444,3340.5999893333333,12.892558854769415,130,2.7000000000000006E-4
6,test_20231101_135515,10350842.png,212614,4817,207797,0.977343919026969,2,4,42529,707,41822,0.983376049284018,19.67007111111111,2460.5717813333335,14.22044321803745,130,2.7000000000000006E-4
7,test_20231101_135515,10863862.png,317432,7399,310033,0.9766910708435192,2,4,66058,1086,64972,0.983559901904387,35.68389688888889,6512.697578666666,9.993194489713737,130,2.7000000000000006E-4
8,test_20231101_135515,11382381.png,312486,587,311899,0.9981215158439098,1,3,46745,78,46667,0.9983313723392876,21.967536,2569.068496,14.03304677372966,130,2.7000000000000006E-4
9,test_20231101_135515,11079715.png,443815,107837,335978,0.7570226333044174,3,4,124136,15131,109005,0.8781094928143327,17.708771555555554,2317.625856,14.480370335498858,130,2.7000000000000006E-4
10,test_20231101_135515,11551286.png,271883,204,271679,0.9992496772508763,2,4,40092,28,40064,0.9993016063054974,18.067507555555554,1885.468496,15.37661080624634,130,2.7000000000000006E-4
1,test_20231101_135516,10404007.png,502730,16282,486448,0.9676128339267599,2,4,61265,2367,58898,0.9613645637802987,26.166622222222223,3560.861381333333,12.615252932576213,130,2.800000000000001E-4
2,test_20231101_135516,1254659.png,342646,65192,277454,0.8097394979074614,3,4,80080,9165,70915,0.885551948051948,21.891132444444445,3493.511104,12.698182328858888,130,2.800000000000001E-4
3,test_20231101_135516,10188041.png,221231,8364,212867,0.9621933634978823,2,9,41731,1187,40544,0.9715559176631281,11.813678222222222,1332.7883626666667,16.88319168860807,130,2.800000000000001E-4
4,test_20231101_135516,10287332.png,216980,11257,205723,0.9481196423633514,2,4,22337,1550,20787,0.9306084075748757,9.689633777777777,850.2091146666667,18.835546043579313,130,2.800000000000001E-4
5,test_20231101_135516,11610969.png,368720,21127,347593,0.9427017791277934,2,3,84111,3090,81021,0.9632628312586938,23.026140444444444,3340.5999893333333,12.892558854769415,130,2.800000000000001E-4
6,test_20231101_135516,10350842.png,212614,4817,207797,0.977343919026969,1,4,42529,707,41822,0.983376049284018,19.67007111111111,2460.5717813333335,14.22044321803745,130,2.800000000000001E-4
7,test_20231101_135516,10863862.png,317432,7399,310033,0.9766910708435192,2,4,66058,1086,64972,0.983559901904387,35.68389688888889,6512.697578666666,9.993194489713737,130,2.800000000000001E-4
8,test_20231101_135516,11382381.png,312486,587,311899,0.9981215158439098,1,3,46745,78,46667,0.9983313723392876,21.967536,2569.068496,14.03304677372966,130,2.800000000000001E-4
9,test_20231101_135516,11079715.png,443815,107837,335978,0.7570226333044174,4,4,124136,15131,109005,0.8781094928143327,17.708771555555554,2317.625856,14.480370335498858,130,2.800000000000001E-4
10,test_20231101_135516,11551286.png,271883,204,271679,0.9992496772508763,1,3,40092,28,40064,0.9993016063054974,18.067507555555554,1885.468496,15.37661080624634,130,2.800000000000001E-4
1,test_20231101_135516,10404007.png,502730,16282,486448,0.9676128339267599,3,4,61265,2367,58898,0.9613645637802987,26.166622222222223,3560.861381333333,12.615252932576213,130,2.900000000000001E-4
2,test_20231101_135516,1254659.png,342646,65192,277454,0.8097394979074614,4,4,80080,9165,70915,0.885551948051948,21.891132444444445,3493.511104,12.698182328858888,130,2.900000000000001E-4
3,test_20231101_135516,10188041.png,221231,8364,212867,0.9621933634978823,2,4,41731,1187,40544,0.9715559176631281,11.813678222222222,1332.7883626666667,16.88319168860807,130,2.900000000000001E-4
4,test_20231101_135516,10287332.png,216980,11257,205723,0.9481196423633514,2,4,22337,1550,20787,0.9306084075748757,9.689633777777777,850.2091146666667,18.835546043579313,130,2.900000000000001E-4
5,test_20231101_135516,11610969.png,368720,21127,347593,0.9427017791277934,3,4,84111,3090,81021,0.9632628312586938,23.026140444444444,3340.5999893333333,12.892558854769415,130,2.900000000000001E-4
6,test_20231101_135516,10350842.png,212614,4817,207797,0.977343919026969,1,3,42529,707,41822,0.983376049284018,19.67007111111111,2460.5717813333335,14.22044321803745,130,2.900000000000001E-4
7,test_20231101_135516,10863862.png,317432,7399,310033,0.9766910708435192,2,4,66058,1086,64972,0.983559901904387,35.68389688888889,6512.697578666666,9.993194489713737,130,2.900000000000001E-4
8,test_20231101_135516,11382381.png,312486,587,311899,0.9981215158439098,1,3,46745,78,46667,0.9983313723392876,21.967536,2569.068496,14.03304677372966,130,2.900000000000001E-4
9,test_20231101_135516,11079715.png,443815,107837,335978,0.7570226333044174,4,5,124136,15131,109005,0.8781094928143327,17.708771555555554,2317.625856,14.480370335498858,130,2.900000000000001E-4
10,test_20231101_135516,11551286.png,271883,204,271679,0.9992496772508763,1,3,40092,28,40064,0.9993016063054974,18.067507555555554,1885.468496,15.37661080624634,130,2.900000000000001E-4
1,test_20231101_135517,10404007.png,502730,16282,486448,0.9676128339267599,2,4,61265,2367,58898,0.9613645637802987,26.166622222222223,3560.861381333333,12.615252932576213,130,3.0000000000000014E-4
2,test_20231101_135517,1254659.png,342646,65192,277454,0.8097394979074614,3,4,80080,9165,70915,0.885551948051948,21.891132444444445,3493.511104,12.698182328858888,130,3.0000000000000014E-4
3,test_20231101_135517,10188041.png,221231,8364,212867,0.9621933634978823,2,4,41731,1187,40544,0.9715559176631281,11.813678222222222,1332.7883626666667,16.88319168860807,130,3.0000000000000014E-4
4,test_20231101_135517,10287332.png,216980,11257,205723,0.9481196423633514,1,3,22337,1550,20787,0.9306084075748757,9.689633777777777,850.2091146666667,18.835546043579313,130,3.0000000000000014E-4
5,test_20231101_135517,11610969.png,368720,21127,347593,0.9427017791277934,4,4,84111,3090,81021,0.9632628312586938,23.026140444444444,3340.5999893333333,12.892558854769415,130,3.0000000000000014E-4
6,test_20231101_135517,10350842.png,212614,4817,207797,0.977343919026969,1,4,42529,707,41822,0.983376049284018,19.67007111111111,2460.5717813333335,14.22044321803745,130,3.0000000000000014E-4
7,test_20231101_135517,10863862.png,317432,7399,310033,0.9766910708435192,1,4,66058,1086,64972,0.983559901904387,35.68389688888889,6512.697578666666,9.993194489713737,130,3.0000000000000014E-4
8,test_20231101_135517,11382381.png,312486,587,311899,0.9981215158439098,2,3,46745,78,46667,0.9983313723392876,21.967536,2569.068496,14.03304677372966,130,3.0000000000000014E-4
9,test_20231101_135517,11079715.png,443815,107837,335978,0.7570226333044174,3,4,124136,15131,109005,0.8781094928143327,17.708771555555554,2317.625856,14.480370335498858,130,3.0000000000000014E-4
10,test_20231101_135517,11551286.png,271883,204,271679,0.9992496772508763,1,3,40092,28,40064,0.9993016063054974,18.067507555555554,1885.468496,15.37661080624634,130,3.0000000000000014E-4
1,test_20231101_135518,10404007.png,502730,16282,486448,0.9676128339267599,3,3,61265,2367,58898,0.9613645637802987,26.166622222222223,3560.861381333333,12.615252932576213,130,3.1000000000000016E-4
2,test_20231101_135518,1254659.png,342646,65192,277454,0.8097394979074614,3,4,80080,9165,70915,0.885551948051948,21.891132444444445,3493.511104,12.698182328858888,130,3.1000000000000016E-4
3,test_20231101_135518,10188041.png,221231,8364,212867,0.9621933634978823,3,8,41731,1187,40544,0.9715559176631281,11.813678222222222,1332.7883626666667,16.88319168860807,130,3.1000000000000016E-4
4,test_20231101_135518,10287332.png,216980,11257,205723,0.9481196423633514,2,3,22337,1550,20787,0.9306084075748757,9.689633777777777,850.2091146666667,18.835546043579313,130,3.1000000000000016E-4
5,test_20231101_135518,11610969.png,368720,21127,347593,0.9427017791277934,3,3,84111,3090,81021,0.9632628312586938,23.026140444444444,3340.5999893333333,12.892558854769415,130,3.1000000000000016E-4
6,test_20231101_135518,10350842.png,212614,4817,207797,0.977343919026969,2,4,42529,707,41822,0.983376049284018,19.67007111111111,2460.5717813333335,14.22044321803745,130,3.1000000000000016E-4
7,test_20231101_135518,10863862.png,317432,7399,310033,0.9766910708435192,1,3,66058,1086,64972,0.983559901904387,35.68389688888889,6512.697578666666,9.993194489713737,130,3.1000000000000016E-4
8,test_20231101_135518,11382381.png,312486,587,311899,0.9981215158439098,2,3,46745,78,46667,0.9983313723392876,21.967536,2569.068496,14.03304677372966,130,3.1000000000000016E-4
9,test_20231101_135518,11079715.png,443815,107837,335978,0.7570226333044174,4,4,124136,15131,109005,0.8781094928143327,17.708771555555554,2317.625856,14.480370335498858,130,3.1000000000000016E-4
10,test_20231101_135518,11551286.png,271883,204,271679,0.9992496772508763,1,8,40092,28,40064,0.9993016063054974,18.067507555555554,1885.468496,15.37661080624634,130,3.1000000000000016E-4
1,test_20231101_135518,10404007.png,502730,16282,486448,0.9676128339267599,2,4,61265,2367,58898,0.9613645637802987,26.166622222222223,3560.861381333333,12.615252932576213,130,3.200000000000002E-4
2,test_20231101_135518,1254659.png,342646,65192,277454,0.8097394979074614,3,4,80080,9165,70915,0.885551948051948,21.891132444444445,3493.511104,12.698182328858888,130,3.200000000000002E-4
3,test_20231101_135518,10188041.png,221231,8364,212867,0.9621933634978823,2,3,41731,1187,40544,0.9715559176631281,11.813678222222222,1332.7883626666667,16.88319168860807,130,3.200000000000002E-4
4,test_20231101_135518,10287332.png,216980,11257,205723,0.9481196423633514,2,4,22337,1550,20787,0.9306084075748757,9.689633777777777,850.2091146666667,18.835546043579313,130,3.200000000000002E-4
5,test_20231101_135518,11610969.png,368720,21127,347593,0.9427017791277934,2,3,84111,3090,81021,0.9632628312586938,23.026140444444444,3340.5999893333333,12.892558854769415,130,3.200000000000002E-4
6,test_20231101_135518,10350842.png,212614,4817,207797,0.977343919026969,2,4,42529,707,41822,0.983376049284018,19.67007111111111,2460.5717813333335,14.22044321803745,130,3.200000000000002E-4
7,test_20231101_135518,10863862.png,317432,7399,310033,0.9766910708435192,2,4,66058,1086,64972,0.983559901904387,35.68389688888889,6512.697578666666,9.993194489713737,130,3.200000000000002E-4
8,test_20231101_135518,11382381.png,312486,587,311899,0.9981215158439098,2,4,46745,78,46667,0.9983313723392876,21.967536,2569.068496,14.03304677372966,130,3.200000000000002E-4
9,test_20231101_135518,11079715.png,443815,107837,335978,0.7570226333044174,4,4,124136,15131,109005,0.8781094928143327,17.708771555555554,2317.625856,14.480370335498858,130,3.200000000000002E-4
10,test_20231101_135518,11551286.png,271883,204,271679,0.9992496772508763,1,3,40092,28,40064,0.9993016063054974,18.067507555555554,1885.468496,15.37661080624634,130,3.200000000000002E-4
1,test_20231101_135519,10404007.png,502730,16282,486448,0.9676128339267599,2,3,61265,2367,58898,0.9613645637802987,26.166622222222223,3560.861381333333,12.615252932576213,130,3.300000000000002E-4
2,test_20231101_135519,1254659.png,342646,65192,277454,0.8097394979074614,2,4,80080,9165,70915,0.885551948051948,21.891132444444445,3493.511104,12.698182328858888,130,3.300000000000002E-4
3,test_20231101_135519,10188041.png,221231,8364,212867,0.9621933634978823,2,4,41731,1187,40544,0.9715559176631281,11.813678222222222,1332.7883626666667,16.88319168860807,130,3.300000000000002E-4
4,test_20231101_135519,10287332.png,216980,11257,205723,0.9481196423633514,1,4,22337,1550,20787,0.9306084075748757,9.689633777777777,850.2091146666667,18.835546043579313,130,3.300000000000002E-4
5,test_20231101_135519,11610969.png,368720,21127,347593,0.9427017791277934,2,3,84111,3090,81021,0.9632628312586938,23.026140444444444,3340.5999893333333,12.892558854769415,130,3.300000000000002E-4
6,test_20231101_135519,10350842.png,212614,4817,207797,0.977343919026969,1,3,42529,707,41822,0.983376049284018,19.67007111111111,2460.5717813333335,14.22044321803745,130,3.300000000000002E-4
7,test_20231101_135519,10863862.png,317432,7399,310033,0.9766910708435192,1,3,66058,1086,64972,0.983559901904387,35.68389688888889,6512.697578666666,9.993194489713737,130,3.300000000000002E-4
8,test_20231101_135519,11382381.png,312486,587,311899,0.9981215158439098,2,4,46745,78,46667,0.9983313723392876,21.967536,2569.068496,14.03304677372966,130,3.300000000000002E-4
9,test_20231101_135519,11079715.png,443815,107837,335978,0.7570226333044174,3,4,124136,15131,109005,0.8781094928143327,17.708771555555554,2317.625856,14.480370335498858,130,3.300000000000002E-4
10,test_20231101_135519,11551286.png,271883,204,271679,0.9992496772508763,1,3,40092,28,40064,0.9993016063054974,18.067507555555554,1885.468496,15.37661080624634,130,3.300000000000002E-4
1,test_20231101_135520,10404007.png,502730,16282,486448,0.9676128339267599,3,3,61265,2367,58898,0.9613645637802987,26.166622222222223,3560.861381333333,12.615252932576213,130,3.4000000000000024E-4
2,test_20231101_135520,1254659.png,342646,65192,277454,0.8097394979074614,3,4,80080,9165,70915,0.885551948051948,21.891132444444445,3493.511104,12.698182328858888,130,3.4000000000000024E-4
3,test_20231101_135520,10188041.png,221231,8364,212867,0.9621933634978823,2,4,41731,1187,40544,0.9715559176631281,11.813678222222222,1332.7883626666667,16.88319168860807,130,3.4000000000000024E-4
4,test_20231101_135520,10287332.png,216980,11257,205723,0.9481196423633514,2,4,22337,1550,20787,0.9306084075748757,9.689633777777777,850.2091146666667,18.835546043579313,130,3.4000000000000024E-4
5,test_20231101_135520,11610969.png,368720,21127,347593,0.9427017791277934,2,3,84111,3090,81021,0.9632628312586938,23.026140444444444,3340.5999893333333,12.892558854769415,130,3.4000000000000024E-4
6,test_20231101_135520,10350842.png,212614,4817,207797,0.977343919026969,2,3,42529,707,41822,0.983376049284018,19.67007111111111,2460.5717813333335,14.22044321803745,130,3.4000000000000024E-4
7,test_20231101_135520,10863862.png,317432,7399,310033,0.9766910708435192,1,3,66058,1086,64972,0.983559901904387,35.68389688888889,6512.697578666666,9.993194489713737,130,3.4000000000000024E-4
8,test_20231101_135520,11382381.png,312486,587,311899,0.9981215158439098,1,3,46745,78,46667,0.9983313723392876,21.967536,2569.068496,14.03304677372966,130,3.4000000000000024E-4
9,test_20231101_135520,11079715.png,443815,107837,335978,0.7570226333044174,3,4,124136,15131,109005,0.8781094928143327,17.708771555555554,2317.625856,14.480370335498858,130,3.4000000000000024E-4
10,test_20231101_135520,11551286.png,271883,204,271679,0.9992496772508763,2,4,40092,28,40064,0.9993016063054974,18.067507555555554,1885.468496,15.37661080624634,130,3.4000000000000024E-4
1,test_20231101_135520,10404007.png,502730,16282,486448,0.9676128339267599,2,4,61265,2367,58898,0.9613645637802987,26.166622222222223,3560.861381333333,12.615252932576213,130,3.5000000000000027E-4
2,test_20231101_135520,1254659.png,342646,65192,277454,0.8097394979074614,3,4,80080,9165,70915,0.885551948051948,21.891132444444445,3493.511104,12.698182328858888,130,3.5000000000000027E-4
3,test_20231101_135520,10188041.png,221231,8364,212867,0.9621933634978823,1,10,41731,1187,40544,0.9715559176631281,11.813678222222222,1332.7883626666667,16.88319168860807,130,3.5000000000000027E-4
4,test_20231101_135520,10287332.png,216980,11257,205723,0.9481196423633514,1,4,22337,1550,20787,0.9306084075748757,9.689633777777777,850.2091146666667,18.835546043579313,130,3.5000000000000027E-4
5,test_20231101_135520,11610969.png,368720,21127,347593,0.9427017791277934,2,3,84111,3090,81021,0.9632628312586938,23.026140444444444,3340.5999893333333,12.892558854769415,130,3.5000000000000027E-4
6,test_20231101_135520,10350842.png,212614,4817,207797,0.977343919026969,2,3,42529,707,41822,0.983376049284018,19.67007111111111,2460.5717813333335,14.22044321803745,130,3.5000000000000027E-4
7,test_20231101_135520,10863862.png,317432,7399,310033,0.9766910708435192,2,10,66058,1086,64972,0.983559901904387,35.68389688888889,6512.697578666666,9.993194489713737,130,3.5000000000000027E-4
8,test_20231101_135520,11382381.png,312486,587,311899,0.9981215158439098,1,4,46745,78,46667,0.9983313723392876,21.967536,2569.068496,14.03304677372966,130,3.5000000000000027E-4
9,test_20231101_135520,11079715.png,443815,107837,335978,0.7570226333044174,5,4,124136,15131,109005,0.8781094928143327,17.708771555555554,2317.625856,14.480370335498858,130,3.5000000000000027E-4
10,test_20231101_135520,11551286.png,271883,204,271679,0.9992496772508763,1,4,40092,28,40064,0.9993016063054974,18.067507555555554,1885.468496,15.37661080624634,130,3.5000000000000027E-4
1,test_20231101_135521,10404007.png,502730,16282,486448,0.9676128339267599,2,4,61265,2367,58898,0.9613645637802987,26.166622222222223,3560.861381333333,12.615252932576213,130,3.600000000000003E-4
2,test_20231101_135521,1254659.png,342646,65192,277454,0.8097394979074614,3,4,80080,9165,70915,0.885551948051948,21.891132444444445,3493.511104,12.698182328858888,130,3.600000000000003E-4
3,test_20231101_135521,10188041.png,221231,8364,212867,0.9621933634978823,2,4,41731,1187,40544,0.9715559176631281,11.813678222222222,1332.7883626666667,16.88319168860807,130,3.600000000000003E-4
4,test_20231101_135521,10287332.png,216980,11257,205723,0.9481196423633514,2,3,22337,1550,20787,0.9306084075748757,9.689633777777777,850.2091146666667,18.835546043579313,130,3.600000000000003E-4
5,test_20231101_135521,11610969.png,368720,21127,347593,0.9427017791277934,2,4,84111,3090,81021,0.9632628312586938,23.026140444444444,3340.5999893333333,12.892558854769415,130,3.600000000000003E-4
6,test_20231101_135521,10350842.png,212614,4817,207797,0.977343919026969,1,4,42529,707,41822,0.983376049284018,19.67007111111111,2460.5717813333335,14.22044321803745,130,3.600000000000003E-4
7,test_20231101_135521,10863862.png,317432,7399,310033,0.9766910708435192,2,4,66058,1086,64972,0.983559901904387,35.68389688888889,6512.697578666666,9.993194489713737,130,3.600000000000003E-4
8,test_20231101_135521,11382381.png,312486,587,311899,0.9981215158439098,2,3,46745,78,46667,0.9983313723392876,21.967536,2569.068496,14.03304677372966,130,3.600000000000003E-4
9,test_20231101_135521,11079715.png,443815,107837,335978,0.7570226333044174,4,4,124136,15131,109005,0.8781094928143327,17.708771555555554,2317.625856,14.480370335498858,130,3.600000000000003E-4
10,test_20231101_135521,11551286.png,271883,204,271679,0.9992496772508763,1,3,40092,28,40064,0.9993016063054974,18.067507555555554,1885.468496,15.37661080624634,130,3.600000000000003E-4
1,test_20231101_135522,10404007.png,502730,16282,486448,0.9676128339267599,3,4,61265,2367,58898,0.9613645637802987,26.166622222222223,3560.861381333333,12.615252932576213,130,3.700000000000003E-4
2,test_20231101_135522,1254659.png,342646,65192,277454,0.8097394979074614,3,4,80080,9165,70915,0.885551948051948,21.891132444444445,3493.511104,12.698182328858888,130,3.700000000000003E-4
3,test_20231101_135522,10188041.png,221231,8364,212867,0.9621933634978823,2,3,41731,1187,40544,0.9715559176631281,11.813678222222222,1332.7883626666667,16.88319168860807,130,3.700000000000003E-4
4,test_20231101_135522,10287332.png,216980,11257,205723,0.9481196423633514,2,4,22337,1550,20787,0.9306084075748757,9.689633777777777,850.2091146666667,18.835546043579313,130,3.700000000000003E-4
5,test_20231101_135522,11610969.png,368720,21127,347593,0.9427017791277934,2,3,84111,3090,81021,0.9632628312586938,23.026140444444444,3340.5999893333333,12.892558854769415,130,3.700000000000003E-4
6,test_20231101_135522,10350842.png,212614,4817,207797,0.977343919026969,1,3,42529,707,41822,0.983376049284018,19.67007111111111,2460.5717813333335,14.22044321803745,130,3.700000000000003E-4
7,test_20231101_135522,10863862.png,317432,7399,310033,0.9766910708435192,2,3,66058,1086,64972,0.983559901904387,35.68389688888889,6512.697578666666,9.993194489713737,130,3.700000000000003E-4
8,test_20231101_135522,11382381.png,312486,587,311899,0.9981215158439098,1,4,46745,78,46667,0.9983313723392876,21.967536,2569.068496,14.03304677372966,130,3.700000000000003E-4
9,test_20231101_135522,11079715.png,443815,107837,335978,0.7570226333044174,3,4,124136,15131,109005,0.8781094928143327,17.708771555555554,2317.625856,14.480370335498858,130,3.700000000000003E-4
10,test_20231101_135522,11551286.png,271883,204,271679,0.9992496772508763,1,3,40092,28,40064,0.9993016063054974,18.067507555555554,1885.468496,15.37661080624634,130,3.700000000000003E-4
1,test_20231101_135523,10404007.png,502730,16282,486448,0.9676128339267599,3,4,61265,2367,58898,0.9613645637802987,26.166622222222223,3560.861381333333,12.615252932576213,130,3.8000000000000035E-4
2,test_20231101_135523,1254659.png,342646,65192,277454,0.8097394979074614,3,4,80080,9165,70915,0.885551948051948,21.891132444444445,3493.511104,12.698182328858888,130,3.8000000000000035E-4
3,test_20231101_135523,10188041.png,221231,8364,212867,0.9621933634978823,3,4,41731,1187,40544,0.9715559176631281,11.813678222222222,1332.7883626666667,16.88319168860807,130,3.8000000000000035E-4
4,test_20231101_135523,10287332.png,216980,11257,205723,0.9481196423633514,2,3,22337,1550,20787,0.9306084075748757,9.689633777777777,850.2091146666667,18.835546043579313,130,3.8000000000000035E-4
5,test_20231101_135523,11610969.png,368720,21127,347593,0.9427017791277934,2,4,84111,3090,81021,0.9632628312586938,23.026140444444444,3340.5999893333333,12.892558854769415,130,3.8000000000000035E-4
6,test_20231101_135523,10350842.png,212614,4817,207797,0.977343919026969,2,4,42529,707,41822,0.983376049284018,19.67007111111111,2460.5717813333335,14.22044321803745,130,3.8000000000000035E-4
7,test_20231101_135523,10863862.png,317432,7399,310033,0.9766910708435192,2,4,66058,1086,64972,0.983559901904387,35.68389688888889,6512.697578666666,9.993194489713737,130,3.8000000000000035E-4
8,test_20231101_135523,11382381.png,312486,587,311899,0.9981215158439098,1,3,46745,78,46667,0.9983313723392876,21.967536,2569.068496,14.03304677372966,130,3.8000000000000035E-4
9,test_20231101_135523,11079715.png,443815,107837,335978,0.7570226333044174,3,4,124136,15131,109005,0.8781094928143327,17.708771555555554,2317.625856,14.480370335498858,130,3.8000000000000035E-4
10,test_20231101_135523,11551286.png,271883,204,271679,0.9992496772508763,1,12,40092,28,40064,0.9993016063054974,18.067507555555554,1885.468496,15.37661080624634,130,3.8000000000000035E-4
1,test_20231101_135523,10404007.png,502730,16122,486608,0.9679310962146679,2,4,61265,2344,58921,0.9617399820452134,26.208451555555556,3568.336864,12.606145142471787,130,3.9000000000000037E-4
2,test_20231101_135523,1254659.png,342646,65192,277454,0.8097394979074614,2,4,80080,9165,70915,0.885551948051948,21.891132444444445,3493.511104,12.698182328858888,130,3.9000000000000037E-4
3,test_20231101_135523,10188041.png,221231,8364,212867,0.9621933634978823,2,4,41731,1187,40544,0.9715559176631281,11.813678222222222,1332.7883626666667,16.88319168860807,130,3.9000000000000037E-4
4,test_20231101_135523,10287332.png,216980,11257,205723,0.9481196423633514,1,4,22337,1550,20787,0.9306084075748757,9.689633777777777,850.2091146666667,18.835546043579313,130,3.9000000000000037E-4
5,test_20231101_135523,11610969.png,368720,21127,347593,0.9427017791277934,2,4,84111,3090,81021,0.9632628312586938,23.026140444444444,3340.5999893333333,12.892558854769415,130,3.9000000000000037E-4
6,test_20231101_135523,10350842.png,212614,4817,207797,0.977343919026969,2,4,42529,707,41822,0.983376049284018,19.67007111111111,2460.5717813333335,14.22044321803745,130,3.9000000000000037E-4
7,test_20231101_135523,10863862.png,317432,7399,310033,0.9766910708435192,1,4,66058,1086,64972,0.983559901904387,35.68389688888889,6512.697578666666,9.993194489713737,130,3.9000000000000037E-4
8,test_20231101_135523,11382381.png,312486,587,311899,0.9981215158439098,2,4,46745,78,46667,0.9983313723392876,21.967536,2569.068496,14.03304677372966,130,3.9000000000000037E-4
9,test_20231101_135523,11079715.png,443815,107837,335978,0.7570226333044174,4,4,124136,15131,109005,0.8781094928143327,17.708771555555554,2317.625856,14.480370335498858,130,3.9000000000000037E-4
10,test_20231101_135523,11551286.png,271883,204,271679,0.9992496772508763,2,3,40092,28,40064,0.9993016063054974,18.067507555555554,1885.468496,15.37661080624634,130,3.9000000000000037E-4
1,test_20231101_135524,10404007.png,502730,16122,486608,0.9679310962146679,2,3,61265,2344,58921,0.9617399820452134,26.208451555555556,3568.336864,12.606145142471787,130,4.000000000000004E-4
2,test_20231101_135524,1254659.png,342646,65192,277454,0.8097394979074614,3,4,80080,9165,70915,0.885551948051948,21.891132444444445,3493.511104,12.698182328858888,130,4.000000000000004E-4
3,test_20231101_135524,10188041.png,221231,8364,212867,0.9621933634978823,2,3,41731,1187,40544,0.9715559176631281,11.813678222222222,1332.7883626666667,16.88319168860807,130,4.000000000000004E-4
4,test_20231101_135524,10287332.png,216980,11257,205723,0.9481196423633514,2,3,22337,1550,20787,0.9306084075748757,9.689633777777777,850.2091146666667,18.835546043579313,130,4.000000000000004E-4
5,test_20231101_135524,11610969.png,368720,21127,347593,0.9427017791277934,2,4,84111,3090,81021,0.9632628312586938,23.026140444444444,3340.5999893333333,12.892558854769415,130,4.000000000000004E-4
6,test_20231101_135524,10350842.png,212614,4817,207797,0.977343919026969,1,4,42529,707,41822,0.983376049284018,19.67007111111111,2460.5717813333335,14.22044321803745,130,4.000000000000004E-4
7,test_20231101_135524,10863862.png,317432,7399,310033,0.9766910708435192,2,4,66058,1086,64972,0.983559901904387,35.68389688888889,6512.697578666666,9.993194489713737,130,4.000000000000004E-4
8,test_20231101_135524,11382381.png,312486,587,311899,0.9981215158439098,2,4,46745,78,46667,0.9983313723392876,21.967536,2569.068496,14.03304677372966,130,4.000000000000004E-4
9,test_20231101_135524,11079715.png,443815,107837,335978,0.7570226333044174,4,4,124136,15131,109005,0.8781094928143327,17.708771555555554,2317.625856,14.480370335498858,130,4.000000000000004E-4
10,test_20231101_135524,11551286.png,271883,204,271679,0.9992496772508763,2,4,40092,28,40064,0.9993016063054974,18.067507555555554,1885.468496,15.37661080624634,130,4.000000000000004E-4
1,test_20231101_135525,10404007.png,502730,16122,486608,0.9679310962146679,2,4,61265,2344,58921,0.9617399820452134,26.208451555555556,3568.336864,12.606145142471787,130,4.100000000000004E-4
2,test_20231101_135525,1254659.png,342646,65192,277454,0.8097394979074614,3,4,80080,9165,70915,0.885551948051948,21.891132444444445,3493.511104,12.698182328858888,130,4.100000000000004E-4
3,test_20231101_135525,10188041.png,221231,8364,212867,0.9621933634978823,2,4,41731,1187,40544,0.9715559176631281,11.813678222222222,1332.7883626666667,16.88319168860807,130,4.100000000000004E-4
4,test_20231101_135525,10287332.png,216980,11257,205723,0.9481196423633514,2,4,22337,1550,20787,0.9306084075748757,9.689633777777777,850.2091146666667,18.835546043579313,130,4.100000000000004E-4
5,test_20231101_135525,11610969.png,368720,21127,347593,0.9427017791277934,2,4,84111,3090,81021,0.9632628312586938,23.026140444444444,3340.5999893333333,12.892558854769415,130,4.100000000000004E-4
6,test_20231101_135525,10350842.png,212614,4817,207797,0.977343919026969,2,4,42529,707,41822,0.983376049284018,19.67007111111111,2460.5717813333335,14.22044321803745,130,4.100000000000004E-4
7,test_20231101_135525,10863862.png,317432,7399,310033,0.9766910708435192,1,4,66058,1086,64972,0.983559901904387,35.68389688888889,6512.697578666666,9.993194489713737,130,4.100000000000004E-4
8,test_20231101_135525,11382381.png,312486,587,311899,0.9981215158439098,1,4,46745,78,46667,0.9983313723392876,21.967536,2569.068496,14.03304677372966,130,4.100000000000004E-4
9,test_20231101_135525,11079715.png,443815,107837,335978,0.7570226333044174,4,4,124136,15131,109005,0.8781094928143327,17.708771555555554,2317.625856,14.480370335498858,130,4.100000000000004E-4
10,test_20231101_135525,11551286.png,271883,204,271679,0.9992496772508763,2,3,40092,28,40064,0.9993016063054974,18.067507555555554,1885.468496,15.37661080624634,130,4.100000000000004E-4
1,test_20231101_135525,10404007.png,502730,16122,486608,0.9679310962146679,2,3,61265,2344,58921,0.9617399820452134,26.208451555555556,3568.336864,12.606145142471787,130,4.2000000000000045E-4
2,test_20231101_135525,1254659.png,342646,65192,277454,0.8097394979074614,3,4,80080,9165,70915,0.885551948051948,21.891132444444445,3493.511104,12.698182328858888,130,4.2000000000000045E-4
3,test_20231101_135525,10188041.png,221231,8364,212867,0.9621933634978823,2,4,41731,1187,40544,0.9715559176631281,11.813678222222222,1332.7883626666667,16.88319168860807,130,4.2000000000000045E-4
4,test_20231101_135525,10287332.png,216980,11257,205723,0.9481196423633514,2,3,22337,1550,20787,0.9306084075748757,9.689633777777777,850.2091146666667,18.835546043579313,130,4.2000000000000045E-4
5,test_20231101_135525,11610969.png,368720,21127,347593,0.9427017791277934,2,4,84111,3090,81021,0.9632628312586938,23.026140444444444,3340.5999893333333,12.892558854769415,130,4.2000000000000045E-4
6,test_20231101_135525,10350842.png,212614,4817,207797,0.977343919026969,2,4,42529,707,41822,0.983376049284018,19.67007111111111,2460.5717813333335,14.22044321803745,130,4.2000000000000045E-4
7,test_20231101_135525,10863862.png,317432,7399,310033,0.9766910708435192,1,4,66058,1086,64972,0.983559901904387,35.68389688888889,6512.697578666666,9.993194489713737,130,4.2000000000000045E-4
8,test_20231101_135525,11382381.png,312486,587,311899,0.9981215158439098,2,3,46745,78,46667,0.9983313723392876,21.967536,2569.068496,14.03304677372966,130,4.2000000000000045E-4
9,test_20231101_135525,11079715.png,443815,107837,335978,0.7570226333044174,3,4,124136,15131,109005,0.8781094928143327,17.708771555555554,2317.625856,14.480370335498858,130,4.2000000000000045E-4
10,test_20231101_135525,11551286.png,271883,204,271679,0.9992496772508763,2,3,40092,28,40064,0.9993016063054974,18.067507555555554,1885.468496,15.37661080624634,130,4.2000000000000045E-4
1,test_20231101_135526,10404007.png,502730,16122,486608,0.9679310962146679,2,4,61265,2344,58921,0.9617399820452134,26.208451555555556,3568.336864,12.606145142471787,130,4.300000000000005E-4
2,test_20231101_135526,1254659.png,342646,65192,277454,0.8097394979074614,3,4,80080,9165,70915,0.885551948051948,21.891132444444445,3493.511104,12.698182328858888,130,4.300000000000005E-4
3,test_20231101_135526,10188041.png,221231,8364,212867,0.9621933634978823,2,4,41731,1187,40544,0.9715559176631281,11.813678222222222,1332.7883626666667,16.88319168860807,130,4.300000000000005E-4
4,test_20231101_135526,10287332.png,216980,11257,205723,0.9481196423633514,2,4,22337,1550,20787,0.9306084075748757,9.689633777777777,850.2091146666667,18.835546043579313,130,4.300000000000005E-4
5,test_20231101_135526,11610969.png,368720,21127,347593,0.9427017791277934,2,4,84111,3090,81021,0.9632628312586938,23.026140444444444,3340.5999893333333,12.892558854769415,130,4.300000000000005E-4
6,test_20231101_135526,10350842.png,212614,4817,207797,0.977343919026969,2,3,42529,707,41822,0.983376049284018,19.67007111111111,2460.5717813333335,14.22044321803745,130,4.300000000000005E-4
7,test_20231101_135526,10863862.png,317432,7399,310033,0.9766910708435192,2,4,66058,1086,64972,0.983559901904387,35.68389688888889,6512.697578666666,9.993194489713737,130,4.300000000000005E-4
8,test_20231101_135526,11382381.png,312486,587,311899,0.9981215158439098,1,4,46745,78,46667,0.9983313723392876,21.967536,2569.068496,14.03304677372966,130,4.300000000000005E-4
9,test_20231101_135526,11079715.png,443815,107837,335978,0.7570226333044174,3,5,124136,15131,109005,0.8781094928143327,17.708771555555554,2317.625856,14.480370335498858,130,4.300000000000005E-4
10,test_20231101_135526,11551286.png,271883,204,271679,0.9992496772508763,2,3,40092,28,40064,0.9993016063054974,18.067507555555554,1885.468496,15.37661080624634,130,4.300000000000005E-4
1,test_20231101_135527,10404007.png,502730,16122,486608,0.9679310962146679,2,4,61265,2344,58921,0.9617399820452134,26.208451555555556,3568.336864,12.606145142471787,130,4.400000000000005E-4
2,test_20231101_135527,1254659.png,342646,65192,277454,0.8097394979074614,2,3,80080,9165,70915,0.885551948051948,21.891132444444445,3493.511104,12.698182328858888,130,4.400000000000005E-4
3,test_20231101_135527,10188041.png,221231,8364,212867,0.9621933634978823,2,4,41731,1187,40544,0.9715559176631281,11.813678222222222,1332.7883626666667,16.88319168860807,130,4.400000000000005E-4
4,test_20231101_135527,10287332.png,216980,11257,205723,0.9481196423633514,1,4,22337,1550,20787,0.9306084075748757,9.689633777777777,850.2091146666667,18.835546043579313,130,4.400000000000005E-4
5,test_20231101_135527,11610969.png,368720,21127,347593,0.9427017791277934,2,4,84111,3090,81021,0.9632628312586938,23.026140444444444,3340.5999893333333,12.892558854769415,130,4.400000000000005E-4
6,test_20231101_135527,10350842.png,212614,4817,207797,0.977343919026969,1,4,42529,707,41822,0.983376049284018,19.67007111111111,2460.5717813333335,14.22044321803745,130,4.400000000000005E-4
7,test_20231101_135527,10863862.png,317432,7399,310033,0.9766910708435192,2,4,66058,1086,64972,0.983559901904387,35.68389688888889,6512.697578666666,9.993194489713737,130,4.400000000000005E-4
8,test_20231101_135527,11382381.png,312486,567,311919,0.9981855187112383,1,4,46745,75,46670,0.9983955503262381,22.72423288888889,2714.741744,13.793518398308729,130,4.400000000000005E-4
9,test_20231101_135527,11079715.png,443815,107837,335978,0.7570226333044174,3,4,124136,15131,109005,0.8781094928143327,17.708771555555554,2317.625856,14.480370335498858,130,4.400000000000005E-4
10,test_20231101_135527,11551286.png,271883,204,271679,0.9992496772508763,1,4,40092,28,40064,0.9993016063054974,18.067507555555554,1885.468496,15.37661080624634,130,4.400000000000005E-4
1,test_20231101_135527,10404007.png,502730,16122,486608,0.9679310962146679,2,4,61265,2344,58921,0.9617399820452134,26.208451555555556,3568.336864,12.606145142471787,130,4.5000000000000053E-4
2,test_20231101_135527,1254659.png,342646,65192,277454,0.8097394979074614,2,4,80080,9165,70915,0.885551948051948,21.891132444444445,3493.511104,12.698182328858888,130,4.5000000000000053E-4
3,test_20231101_135527,10188041.png,221231,8364,212867,0.9621933634978823,2,4,41731,1187,40544,0.9715559176631281,11.813678222222222,1332.7883626666667,16.88319168860807,130,4.5000000000000053E-4
4,test_20231101_135527,10287332.png,216980,11257,205723,0.9481196423633514,1,3,22337,1550,20787,0.9306084075748757,9.689633777777777,850.2091146666667,18.835546043579313,130,4.5000000000000053E-4
5,test_20231101_135527,11610969.png,368720,21127,347593,0.9427017791277934,2,3,84111,3090,81021,0.9632628312586938,23.026140444444444,3340.5999893333333,12.892558854769415,130,4.5000000000000053E-4
6,test_20231101_135527,10350842.png,212614,4817,207797,0.977343919026969,2,4,42529,707,41822,0.983376049284018,19.67007111111111,2460.5717813333335,14.22044321803745,130,4.5000000000000053E-4
7,test_20231101_135527,10863862.png,317432,7399,310033,0.9766910708435192,2,4,66058,1086,64972,0.983559901904387,35.68389688888889,6512.697578666666,9.993194489713737,130,4.5000000000000053E-4
8,test_20231101_135527,11382381.png,312486,567,311919,0.9981855187112383,1,4,46745,75,46670,0.9983955503262381,22.72423288888889,2714.741744,13.793518398308729,130,4.5000000000000053E-4
9,test_20231101_135527,11079715.png,443815,107837,335978,0.7570226333044174,3,4,124136,15131,109005,0.8781094928143327,17.708771555555554,2317.625856,14.480370335498858,130,4.5000000000000053E-4
10,test_20231101_135527,11551286.png,271883,204,271679,0.9992496772508763,1,3,40092,28,40064,0.9993016063054974,18.067507555555554,1885.468496,15.37661080624634,130,4.5000000000000053E-4
1,test_20231101_135528,10404007.png,502730,16122,486608,0.9679310962146679,2,3,61265,2344,58921,0.9617399820452134,26.208451555555556,3568.336864,12.606145142471787,130,4.6000000000000056E-4
2,test_20231101_135528,1254659.png,342646,65192,277454,0.8097394979074614,2,3,80080,9165,70915,0.885551948051948,21.891132444444445,3493.511104,12.698182328858888,130,4.6000000000000056E-4
3,test_20231101_135528,10188041.png,221231,8364,212867,0.9621933634978823,2,4,41731,1187,40544,0.9715559176631281,11.813678222222222,1332.7883626666667,16.88319168860807,130,4.6000000000000056E-4
4,test_20231101_135528,10287332.png,216980,11257,205723,0.9481196423633514,2,3,22337,1550,20787,0.9306084075748757,9.689633777777777,850.2091146666667,18.835546043579313,130,4.6000000000000056E-4
5,test_20231101_135528,11610969.png,368720,21127,347593,0.9427017791277934,3,4,84111,3090,81021,0.9632628312586938,23.026140444444444,3340.5999893333333,12.892558854769415,130,4.6000000000000056E-4
6,test_20231101_135528,10350842.png,212614,4817,207797,0.977343919026969,1,4,42529,707,41822,0.983376049284018,19.67007111111111,2460.5717813333335,14.22044321803745,130,4.6000000000000056E-4
7,test_20231101_135528,10863862.png,317432,7399,310033,0.9766910708435192,2,4,66058,1086,64972,0.983559901904387,35.68389688888889,6512.697578666666,9.993194489713737,130,4.6000000000000056E-4
8,test_20231101_135528,11382381.png,312486,567,311919,0.9981855187112383,1,4,46745,75,46670,0.9983955503262381,22.72423288888889,2714.741744,13.793518398308729,130,4.6000000000000056E-4
9,test_20231101_135528,11079715.png,443815,107837,335978,0.7570226333044174,4,4,124136,15131,109005,0.8781094928143327,17.708771555555554,2317.625856,14.480370335498858,130,4.6000000000000056E-4
10,test_20231101_135528,11551286.png,271883,204,271679,0.9992496772508763,1,3,40092,28,40064,0.9993016063054974,18.067507555555554,1885.468496,15.37661080624634,130,4.6000000000000056E-4
1,test_20231101_135529,10404007.png,502730,16122,486608,0.9679310962146679,3,3,61265,2344,58921,0.9617399820452134,26.208451555555556,3568.336864,12.606145142471787,130,4.700000000000006E-4
2,test_20231101_135529,1254659.png,342646,65192,277454,0.8097394979074614,3,4,80080,9165,70915,0.885551948051948,21.891132444444445,3493.511104,12.698182328858888,130,4.700000000000006E-4
3,test_20231101_135529,10188041.png,221231,8364,212867,0.9621933634978823,2,4,41731,1187,40544,0.9715559176631281,11.813678222222222,1332.7883626666667,16.88319168860807,130,4.700000000000006E-4
4,test_20231101_135529,10287332.png,216980,11257,205723,0.9481196423633514,1,3,22337,1550,20787,0.9306084075748757,9.689633777777777,850.2091146666667,18.835546043579313,130,4.700000000000006E-4
5,test_20231101_135529,11610969.png,368720,21127,347593,0.9427017791277934,3,4,84111,3090,81021,0.9632628312586938,23.026140444444444,3340.5999893333333,12.892558854769415,130,4.700000000000006E-4
6,test_20231101_135529,10350842.png,212614,4817,207797,0.977343919026969,2,4,42529,707,41822,0.983376049284018,19.67007111111111,2460.5717813333335,14.22044321803745,130,4.700000000000006E-4
7,test_20231101_135529,10863862.png,317432,7399,310033,0.9766910708435192,3,4,66058,1086,64972,0.983559901904387,35.68389688888889,6512.697578666666,9.993194489713737,130,4.700000000000006E-4
8,test_20231101_135529,11382381.png,312486,567,311919,0.9981855187112383,1,3,46745,75,46670,0.9983955503262381,22.72423288888889,2714.741744,13.793518398308729,130,4.700000000000006E-4
9,test_20231101_135529,11079715.png,443815,107837,335978,0.7570226333044174,4,5,124136,15131,109005,0.8781094928143327,17.708771555555554,2317.625856,14.480370335498858,130,4.700000000000006E-4
10,test_20231101_135529,11551286.png,271883,204,271679,0.9992496772508763,1,4,40092,28,40064,0.9993016063054974,18.067507555555554,1885.468496,15.37661080624634,130,4.700000000000006E-4
1,test_20231101_135529,10404007.png,502730,16122,486608,0.9679310962146679,2,3,61265,2344,58921,0.9617399820452134,26.208451555555556,3568.336864,12.606145142471787,130,4.800000000000006E-4
2,test_20231101_135529,1254659.png,342646,65192,277454,0.8097394979074614,3,4,80080,9165,70915,0.885551948051948,21.891132444444445,3493.511104,12.698182328858888,130,4.800000000000006E-4
3,test_20231101_135529,10188041.png,221231,8364,212867,0.9621933634978823,2,4,41731,1187,40544,0.9715559176631281,11.813678222222222,1332.7883626666667,16.88319168860807,130,4.800000000000006E-4
4,test_20231101_135529,10287332.png,216980,11257,205723,0.9481196423633514,2,4,22337,1550,20787,0.9306084075748757,9.689633777777777,850.2091146666667,18.835546043579313,130,4.800000000000006E-4
5,test_20231101_135529,11610969.png,368720,21127,347593,0.9427017791277934,3,3,84111,3090,81021,0.9632628312586938,23.026140444444444,3340.5999893333333,12.892558854769415,130,4.800000000000006E-4
6,test_20231101_135529,10350842.png,212614,4817,207797,0.977343919026969,1,3,42529,707,41822,0.983376049284018,19.67007111111111,2460.5717813333335,14.22044321803745,130,4.800000000000006E-4
7,test_20231101_135529,10863862.png,317432,7399,310033,0.9766910708435192,2,4,66058,1086,64972,0.983559901904387,35.68389688888889,6512.697578666666,9.993194489713737,130,4.800000000000006E-4
8,test_20231101_135529,11382381.png,312486,567,311919,0.9981855187112383,1,4,46745,75,46670,0.9983955503262381,22.72423288888889,2714.741744,13.793518398308729,130,4.800000000000006E-4
9,test_20231101_135529,11079715.png,443815,107837,335978,0.7570226333044174,4,4,124136,15131,109005,0.8781094928143327,17.708771555555554,2317.625856,14.480370335498858,130,4.800000000000006E-4
10,test_20231101_135529,11551286.png,271883,204,271679,0.9992496772508763,2,4,40092,28,40064,0.9993016063054974,18.067507555555554,1885.468496,15.37661080624634,130,4.800000000000006E-4
1,test_20231101_135530,10404007.png,502730,16122,486608,0.9679310962146679,4,5,61265,2344,58921,0.9617399820452134,26.208451555555556,3568.336864,12.606145142471787,130,4.900000000000006E-4
2,test_20231101_135530,1254659.png,342646,65192,277454,0.8097394979074614,3,4,80080,9165,70915,0.885551948051948,21.891132444444445,3493.511104,12.698182328858888,130,4.900000000000006E-4
3,test_20231101_135530,10188041.png,221231,8364,212867,0.9621933634978823,2,4,41731,1187,40544,0.9715559176631281,11.813678222222222,1332.7883626666667,16.88319168860807,130,4.900000000000006E-4
4,test_20231101_135530,10287332.png,216980,11257,205723,0.9481196423633514,6,4,22337,1550,20787,0.9306084075748757,9.689633777777777,850.2091146666667,18.835546043579313,130,4.900000000000006E-4
5,test_20231101_135530,11610969.png,368720,21127,347593,0.9427017791277934,2,4,84111,3090,81021,0.9632628312586938,23.026140444444444,3340.5999893333333,12.892558854769415,130,4.900000000000006E-4
6,test_20231101_135530,10350842.png,212614,4817,207797,0.977343919026969,2,3,42529,707,41822,0.983376049284018,19.67007111111111,2460.5717813333335,14.22044321803745,130,4.900000000000006E-4
7,test_20231101_135530,10863862.png,317432,7399,310033,0.9766910708435192,1,3,66058,1086,64972,0.983559901904387,35.68389688888889,6512.697578666666,9.993194489713737,130,4.900000000000006E-4
8,test_20231101_135530,11382381.png,312486,567,311919,0.9981855187112383,2,3,46745,75,46670,0.9983955503262381,22.72423288888889,2714.741744,13.793518398308729,130,4.900000000000006E-4
9,test_20231101_135530,11079715.png,443815,107837,335978,0.7570226333044174,3,4,124136,15131,109005,0.8781094928143327,17.708771555555554,2317.625856,14.480370335498858,130,4.900000000000006E-4
10,test_20231101_135530,11551286.png,271883,204,271679,0.9992496772508763,1,4,40092,28,40064,0.9993016063054974,18.067507555555554,1885.468496,15.37661080624634,130,4.900000000000006E-4
1,test_20231101_135531,10404007.png,502730,16122,486608,0.9679310962146679,2,4,61265,2344,58921,0.9617399820452134,26.208451555555556,3568.336864,12.606145142471787,130,5.000000000000007E-4
2,test_20231101_135531,1254659.png,342646,65192,277454,0.8097394979074614,3,10,80080,9165,70915,0.885551948051948,21.891132444444445,3493.511104,12.698182328858888,130,5.000000000000007E-4
3,test_20231101_135531,10188041.png,221231,8364,212867,0.9621933634978823,2,4,41731,1187,40544,0.9715559176631281,11.813678222222222,1332.7883626666667,16.88319168860807,130,5.000000000000007E-4
4,test_20231101_135531,10287332.png,216980,11257,205723,0.9481196423633514,1,3,22337,1550,20787,0.9306084075748757,9.689633777777777,850.2091146666667,18.835546043579313,130,5.000000000000007E-4
5,test_20231101_135531,11610969.png,368720,21127,347593,0.9427017791277934,3,4,84111,3090,81021,0.9632628312586938,23.026140444444444,3340.5999893333333,12.892558854769415,130,5.000000000000007E-4
6,test_20231101_135531,10350842.png,212614,4817,207797,0.977343919026969,1,3,42529,707,41822,0.983376049284018,19.67007111111111,2460.5717813333335,14.22044321803745,130,5.000000000000007E-4
7,test_20231101_135531,10863862.png,317432,7399,310033,0.9766910708435192,2,4,66058,1086,64972,0.983559901904387,35.68389688888889,6512.697578666666,9.993194489713737,130,5.000000000000007E-4
8,test_20231101_135531,11382381.png,312486,567,311919,0.9981855187112383,1,4,46745,75,46670,0.9983955503262381,22.72423288888889,2714.741744,13.793518398308729,130,5.000000000000007E-4
9,test_20231101_135531,11079715.png,443815,107837,335978,0.7570226333044174,3,4,124136,15131,109005,0.8781094928143327,17.708771555555554,2317.625856,14.480370335498858,130,5.000000000000007E-4
10,test_20231101_135531,11551286.png,271883,204,271679,0.9992496772508763,1,4,40092,28,40064,0.9993016063054974,18.067507555555554,1885.468496,15.37661080624634,130,5.000000000000007E-4
1,test_20231101_135531,10404007.png,502730,16122,486608,0.9679310962146679,2,3,61265,2344,58921,0.9617399820452134,26.208451555555556,3568.336864,12.606145142471787,130,5.100000000000007E-4
2,test_20231101_135531,1254659.png,342646,65192,277454,0.8097394979074614,3,4,80080,9165,70915,0.885551948051948,21.891132444444445,3493.511104,12.698182328858888,130,5.100000000000007E-4
3,test_20231101_135531,10188041.png,221231,8202,213029,0.9629256297715962,2,4,41731,1165,40566,0.9720831036879058,12.03271111111111,1366.8562453333334,16.7735751941011,130,5.100000000000007E-4
4,test_20231101_135531,10287332.png,216980,11257,205723,0.9481196423633514,2,4,22337,1550,20787,0.9306084075748757,9.689633777777777,850.2091146666667,18.835546043579313,130,5.100000000000007E-4
5,test_20231101_135531,11610969.png,368720,21087,347633,0.9428102625298329,2,4,84111,3086,81025,0.9633103874641842,23.404170666666666,3403.7126293333336,12.811274747794313,130,5.100000000000007E-4
6,test_20231101_135531,10350842.png,212614,4737,207877,0.9777201877580969,2,4,42529,695,41834,0.9836582096922101,19.730252444444446,2470.973925333333,14.202121982839607,130,5.100000000000007E-4
7,test_20231101_135531,10863862.png,317432,7319,310113,0.9769430933239245,3,4,66058,1074,64984,0.98374156044688,35.801813333333335,6532.50336,9.980007190886644,130,5.100000000000007E-4
8,test_20231101_135531,11382381.png,312486,567,311919,0.9981855187112383,2,3,46745,75,46670,0.9983955503262381,22.72423288888889,2714.741744,13.793518398308729,130,5.100000000000007E-4
9,test_20231101_135531,11079715.png,443815,107657,336158,0.7574282076991539,3,4,124136,15104,109032,0.8783269961977186,17.946035555555557,2359.634992,14.402355329911469,130,5.100000000000007E-4
10,test_20231101_135531,11551286.png,271883,164,271719,0.9993967993585476,1,4,40092,22,40070,0.9994512620971765,18.120286222222223,1899.5769013333334,15.344234809036362,130,5.100000000000007E-4
1,test_20231101_135532,10404007.png,502730,16122,486608,0.9679310962146679,2,3,61265,2344,58921,0.9617399820452134,26.208451555555556,3568.336864,12.606145142471787,130,5.200000000000007E-4
2,test_20231101_135532,1254659.png,342646,65192,277454,0.8097394979074614,4,4,80080,9165,70915,0.885551948051948,21.891132444444445,3493.511104,12.698182328858888,130,5.200000000000007E-4
3,test_20231101_135532,10188041.png,221231,8202,213029,0.9629256297715962,2,4,41731,1165,40566,0.9720831036879058,12.03271111111111,1366.8562453333334,16.7735751941011,130,5.200000000000007E-4
4,test_20231101_135532,10287332.png,216980,11257,205723,0.9481196423633514,2,4,22337,1550,20787,0.9306084075748757,9.689633777777777,850.2091146666667,18.835546043579313,130,5.200000000000007E-4
5,test_20231101_135532,11610969.png,368720,21087,347633,0.9428102625298329,2,4,84111,3086,81025,0.9633103874641842,23.404170666666666,3403.7126293333336,12.811274747794313,130,5.200000000000007E-4
6,test_20231101_135532,10350842.png,212614,4737,207877,0.9777201877580969,1,3,42529,695,41834,0.9836582096922101,19.730252444444446,2470.973925333333,14.202121982839607,130,5.200000000000007E-4
7,test_20231101_135532,10863862.png,317432,7319,310113,0.9769430933239245,2,4,66058,1074,64984,0.98374156044688,35.801813333333335,6532.50336,9.980007190886644,130,5.200000000000007E-4
8,test_20231101_135532,11382381.png,312486,567,311919,0.9981855187112383,1,3,46745,75,46670,0.9983955503262381,22.72423288888889,2714.741744,13.793518398308729,130,5.200000000000007E-4
9,test_20231101_135532,11079715.png,443815,107657,336158,0.7574282076991539,3,4,124136,15104,109032,0.8783269961977186,17.946035555555557,2359.634992,14.402355329911469,130,5.200000000000007E-4
10,test_20231101_135532,11551286.png,271883,164,271719,0.9993967993585476,1,3,40092,22,40070,0.9994512620971765,18.120286222222223,1899.5769013333334,15.344234809036362,130,5.200000000000007E-4
1,test_20231101_135533,10404007.png,502730,16122,486608,0.9679310962146679,2,10,61265,2344,58921,0.9617399820452134,26.208451555555556,3568.336864,12.606145142471787,130,5.300000000000007E-4
2,test_20231101_135533,1254659.png,342646,65192,277454,0.8097394979074614,3,4,80080,9165,70915,0.885551948051948,21.891132444444445,3493.511104,12.698182328858888,130,5.300000000000007E-4
3,test_20231101_135533,10188041.png,221231,8202,213029,0.9629256297715962,2,4,41731,1165,40566,0.9720831036879058,12.03271111111111,1366.8562453333334,16.7735751941011,130,5.300000000000007E-4
4,test_20231101_135533,10287332.png,216980,11257,205723,0.9481196423633514,2,3,22337,1550,20787,0.9306084075748757,9.689633777777777,850.2091146666667,18.835546043579313,130,5.300000000000007E-4
5,test_20231101_135533,11610969.png,368720,21087,347633,0.9428102625298329,3,3,84111,3086,81025,0.9633103874641842,23.404170666666666,3403.7126293333336,12.811274747794313,130,5.300000000000007E-4
6,test_20231101_135533,10350842.png,212614,4737,207877,0.9777201877580969,1,4,42529,695,41834,0.9836582096922101,19.730252444444446,2470.973925333333,14.202121982839607,130,5.300000000000007E-4
7,test_20231101_135533,10863862.png,317432,7319,310113,0.9769430933239245,1,3,66058,1074,64984,0.98374156044688,35.801813333333335,6532.50336,9.980007190886644,130,5.300000000000007E-4
8,test_20231101_135533,11382381.png,312486,567,311919,0.9981855187112383,2,3,46745,75,46670,0.9983955503262381,22.72423288888889,2714.741744,13.793518398308729,130,5.300000000000007E-4
9,test_20231101_135533,11079715.png,443815,107657,336158,0.7574282076991539,4,5,124136,15104,109032,0.8783269961977186,17.946035555555557,2359.634992,14.402355329911469,130,5.300000000000007E-4
10,test_20231101_135533,11551286.png,271883,164,271719,0.9993967993585476,2,4,40092,22,40070,0.9994512620971765,18.120286222222223,1899.5769013333334,15.344234809036362,130,5.300000000000007E-4
1,test_20231101_135533,10404007.png,502730,16122,486608,0.9679310962146679,3,4,61265,2344,58921,0.9617399820452134,26.208451555555556,3568.336864,12.606145142471787,130,5.400000000000008E-4
2,test_20231101_135533,1254659.png,342646,65192,277454,0.8097394979074614,3,3,80080,9165,70915,0.885551948051948,21.891132444444445,3493.511104,12.698182328858888,130,5.400000000000008E-4
3,test_20231101_135533,10188041.png,221231,8202,213029,0.9629256297715962,2,4,41731,1165,40566,0.9720831036879058,12.03271111111111,1366.8562453333334,16.7735751941011,130,5.400000000000008E-4
4,test_20231101_135533,10287332.png,216980,11257,205723,0.9481196423633514,2,3,22337,1550,20787,0.9306084075748757,9.689633777777777,850.2091146666667,18.835546043579313,130,5.400000000000008E-4
5,test_20231101_135533,11610969.png,368720,21087,347633,0.9428102625298329,2,4,84111,3086,81025,0.9633103874641842,23.404170666666666,3403.7126293333336,12.811274747794313,130,5.400000000000008E-4
6,test_20231101_135533,10350842.png,212614,4737,207877,0.9777201877580969,2,4,42529,695,41834,0.9836582096922101,19.730252444444446,2470.973925333333,14.202121982839607,130,5.400000000000008E-4
7,test_20231101_135533,10863862.png,317432,7319,310113,0.9769430933239245,2,3,66058,1074,64984,0.98374156044688,35.801813333333335,6532.50336,9.980007190886644,130,5.400000000000008E-4
8,test_20231101_135533,11382381.png,312486,567,311919,0.9981855187112383,1,4,46745,75,46670,0.9983955503262381,22.72423288888889,2714.741744,13.793518398308729,130,5.400000000000008E-4
9,test_20231101_135533,11079715.png,443815,107657,336158,0.7574282076991539,3,4,124136,15104,109032,0.8783269961977186,17.946035555555557,2359.634992,14.402355329911469,130,5.400000000000008E-4
10,test_20231101_135533,11551286.png,271883,164,271719,0.9993967993585476,2,3,40092,22,40070,0.9994512620971765,18.120286222222223,1899.5769013333334,15.344234809036362,130,5.400000000000008E-4
1,test_20231101_135534,10404007.png,502730,16122,486608,0.9679310962146679,2,4,61265,2344,58921,0.9617399820452134,26.208451555555556,3568.336864,12.606145142471787,130,5.500000000000008E-4
2,test_20231101_135534,1254659.png,342646,65192,277454,0.8097394979074614,3,4,80080,9165,70915,0.885551948051948,21.891132444444445,3493.511104,12.698182328858888,130,5.500000000000008E-4
3,test_20231101_135534,10188041.png,221231,8202,213029,0.9629256297715962,2,3,41731,1165,40566,0.9720831036879058,12.03271111111111,1366.8562453333334,16.7735751941011,130,5.500000000000008E-4
4,test_20231101_135534,10287332.png,216980,11257,205723,0.9481196423633514,2,3,22337,1550,20787,0.9306084075748757,9.689633777777777,850.2091146666667,18.835546043579313,130,5.500000000000008E-4
5,test_20231101_135534,11610969.png,368720,21087,347633,0.9428102625298329,2,4,84111,3086,81025,0.9633103874641842,23.404170666666666,3403.7126293333336,12.811274747794313,130,5.500000000000008E-4
6,test_20231101_135534,10350842.png,212614,4737,207877,0.9777201877580969,2,3,42529,695,41834,0.9836582096922101,19.730252444444446,2470.973925333333,14.202121982839607,130,5.500000000000008E-4
7,test_20231101_135534,10863862.png,317432,7319,310113,0.9769430933239245,2,3,66058,1074,64984,0.98374156044688,35.801813333333335,6532.50336,9.980007190886644,130,5.500000000000008E-4
8,test_20231101_135534,11382381.png,312486,567,311919,0.9981855187112383,1,3,46745,75,46670,0.9983955503262381,22.72423288888889,2714.741744,13.793518398308729,130,5.500000000000008E-4
9,test_20231101_135534,11079715.png,443815,107657,336158,0.7574282076991539,3,4,124136,15104,109032,0.8783269961977186,17.946035555555557,2359.634992,14.402355329911469,130,5.500000000000008E-4
10,test_20231101_135534,11551286.png,271883,164,271719,0.9993967993585476,1,4,40092,22,40070,0.9994512620971765,18.120286222222223,1899.5769013333334,15.344234809036362,130,5.500000000000008E-4
1,test_20231101_135535,10404007.png,502730,16122,486608,0.9679310962146679,2,3,61265,2344,58921,0.9617399820452134,26.208451555555556,3568.336864,12.606145142471787,130,5.600000000000008E-4
2,test_20231101_135535,1254659.png,342646,65192,277454,0.8097394979074614,3,3,80080,9165,70915,0.885551948051948,21.891132444444445,3493.511104,12.698182328858888,130,5.600000000000008E-4
3,test_20231101_135535,10188041.png,221231,8202,213029,0.9629256297715962,2,3,41731,1165,40566,0.9720831036879058,12.03271111111111,1366.8562453333334,16.7735751941011,130,5.600000000000008E-4
4,test_20231101_135535,10287332.png,216980,11257,205723,0.9481196423633514,1,3,22337,1550,20787,0.9306084075748757,9.689633777777777,850.2091146666667,18.835546043579313,130,5.600000000000008E-4
5,test_20231101_135535,11610969.png,368720,21087,347633,0.9428102625298329,2,3,84111,3086,81025,0.9633103874641842,23.404170666666666,3403.7126293333336,12.811274747794313,130,5.600000000000008E-4
6,test_20231101_135535,10350842.png,212614,4737,207877,0.9777201877580969,1,4,42529,695,41834,0.9836582096922101,19.730252444444446,2470.973925333333,14.202121982839607,130,5.600000000000008E-4
7,test_20231101_135535,10863862.png,317432,7319,310113,0.9769430933239245,1,4,66058,1074,64984,0.98374156044688,35.801813333333335,6532.50336,9.980007190886644,130,5.600000000000008E-4
8,test_20231101_135535,11382381.png,312486,567,311919,0.9981855187112383,1,4,46745,75,46670,0.9983955503262381,22.72423288888889,2714.741744,13.793518398308729,130,5.600000000000008E-4
9,test_20231101_135535,11079715.png,443815,107657,336158,0.7574282076991539,4,4,124136,15104,109032,0.8783269961977186,17.946035555555557,2359.634992,14.402355329911469,130,5.600000000000008E-4
10,test_20231101_135535,11551286.png,271883,164,271719,0.9993967993585476,1,4,40092,22,40070,0.9994512620971765,18.120286222222223,1899.5769013333334,15.344234809036362,130,5.600000000000008E-4
1,test_20231101_135535,10404007.png,502730,16122,486608,0.9679310962146679,2,3,61265,2344,58921,0.9617399820452134,26.208451555555556,3568.336864,12.606145142471787,130,5.700000000000008E-4
2,test_20231101_135535,1254659.png,342646,65192,277454,0.8097394979074614,2,3,80080,9165,70915,0.885551948051948,21.891132444444445,3493.511104,12.698182328858888,130,5.700000000000008E-4
3,test_20231101_135535,10188041.png,221231,8202,213029,0.9629256297715962,2,4,41731,1165,40566,0.9720831036879058,12.03271111111111,1366.8562453333334,16.7735751941011,130,5.700000000000008E-4
4,test_20231101_135535,10287332.png,216980,11257,205723,0.9481196423633514,1,4,22337,1550,20787,0.9306084075748757,9.689633777777777,850.2091146666667,18.835546043579313,130,5.700000000000008E-4
5,test_20231101_135535,11610969.png,368720,21087,347633,0.9428102625298329,3,4,84111,3086,81025,0.9633103874641842,23.404170666666666,3403.7126293333336,12.811274747794313,130,5.700000000000008E-4
6,test_20231101_135535,10350842.png,212614,4737,207877,0.9777201877580969,1,4,42529,695,41834,0.9836582096922101,19.730252444444446,2470.973925333333,14.202121982839607,130,5.700000000000008E-4
7,test_20231101_135535,10863862.png,317432,7319,310113,0.9769430933239245,2,4,66058,1074,64984,0.98374156044688,35.801813333333335,6532.50336,9.980007190886644,130,5.700000000000008E-4
8,test_20231101_135535,11382381.png,312486,567,311919,0.9981855187112383,1,3,46745,75,46670,0.9983955503262381,22.72423288888889,2714.741744,13.793518398308729,130,5.700000000000008E-4
9,test_20231101_135535,11079715.png,443815,107657,336158,0.7574282076991539,3,4,124136,15104,109032,0.8783269961977186,17.946035555555557,2359.634992,14.402355329911469,130,5.700000000000008E-4
10,test_20231101_135535,11551286.png,271883,164,271719,0.9993967993585476,1,3,40092,22,40070,0.9994512620971765,18.120286222222223,1899.5769013333334,15.344234809036362,130,5.700000000000008E-4
1,test_20231101_135536,10404007.png,502730,16122,486608,0.9679310962146679,3,4,61265,2344,58921,0.9617399820452134,26.208451555555556,3568.336864,12.606145142471787,130,5.800000000000009E-4
2,test_20231101_135536,1254659.png,342646,65192,277454,0.8097394979074614,2,3,80080,9165,70915,0.885551948051948,21.891132444444445,3493.511104,12.698182328858888,130,5.800000000000009E-4
3,test_20231101_135536,10188041.png,221231,8202,213029,0.9629256297715962,2,4,41731,1165,40566,0.9720831036879058,12.03271111111111,1366.8562453333334,16.7735751941011,130,5.800000000000009E-4
4,test_20231101_135536,10287332.png,216980,11257,205723,0.9481196423633514,2,3,22337,1550,20787,0.9306084075748757,9.689633777777777,850.2091146666667,18.835546043579313,130,5.800000000000009E-4
5,test_20231101_135536,11610969.png,368720,21087,347633,0.9428102625298329,3,4,84111,3086,81025,0.9633103874641842,23.404170666666666,3403.7126293333336,12.811274747794313,130,5.800000000000009E-4
6,test_20231101_135536,10350842.png,212614,4737,207877,0.9777201877580969,2,4,42529,695,41834,0.9836582096922101,19.730252444444446,2470.973925333333,14.202121982839607,130,5.800000000000009E-4
7,test_20231101_135536,10863862.png,317432,7319,310113,0.9769430933239245,2,4,66058,1074,64984,0.98374156044688,35.801813333333335,6532.50336,9.980007190886644,130,5.800000000000009E-4
8,test_20231101_135536,11382381.png,312486,567,311919,0.9981855187112383,2,3,46745,75,46670,0.9983955503262381,22.72423288888889,2714.741744,13.793518398308729,130,5.800000000000009E-4
9,test_20231101_135536,11079715.png,443815,107657,336158,0.7574282076991539,3,5,124136,15104,109032,0.8783269961977186,17.946035555555557,2359.634992,14.402355329911469,130,5.800000000000009E-4
10,test_20231101_135536,11551286.png,271883,164,271719,0.9993967993585476,1,10,40092,22,40070,0.9994512620971765,18.120286222222223,1899.5769013333334,15.344234809036362,130,5.800000000000009E-4
1,test_20231101_135537,10404007.png,502730,16122,486608,0.9679310962146679,2,3,61265,2344,58921,0.9617399820452134,26.208451555555556,3568.336864,12.606145142471787,130,5.900000000000009E-4
2,test_20231101_135537,1254659.png,342646,65192,277454,0.8097394979074614,3,4,80080,9165,70915,0.885551948051948,21.891132444444445,3493.511104,12.698182328858888,130,5.900000000000009E-4
3,test_20231101_135537,10188041.png,221231,8202,213029,0.9629256297715962,2,3,41731,1165,40566,0.9720831036879058,12.03271111111111,1366.8562453333334,16.7735751941011,130,5.900000000000009E-4
4,test_20231101_135537,10287332.png,216980,11257,205723,0.9481196423633514,1,3,22337,1550,20787,0.9306084075748757,9.689633777777777,850.2091146666667,18.835546043579313,130,5.900000000000009E-4
5,test_20231101_135537,11610969.png,368720,21087,347633,0.9428102625298329,3,10,84111,3086,81025,0.9633103874641842,23.404170666666666,3403.7126293333336,12.811274747794313,130,5.900000000000009E-4
6,test_20231101_135537,10350842.png,212614,4737,207877,0.9777201877580969,2,4,42529,695,41834,0.9836582096922101,19.730252444444446,2470.973925333333,14.202121982839607,130,5.900000000000009E-4
7,test_20231101_135537,10863862.png,317432,7319,310113,0.9769430933239245,1,3,66058,1074,64984,0.98374156044688,35.801813333333335,6532.50336,9.980007190886644,130,5.900000000000009E-4
8,test_20231101_135537,11382381.png,312486,567,311919,0.9981855187112383,1,3,46745,75,46670,0.9983955503262381,22.72423288888889,2714.741744,13.793518398308729,130,5.900000000000009E-4
9,test_20231101_135537,11079715.png,443815,107657,336158,0.7574282076991539,4,5,124136,15104,109032,0.8783269961977186,17.946035555555557,2359.634992,14.402355329911469,130,5.900000000000009E-4
10,test_20231101_135537,11551286.png,271883,164,271719,0.9993967993585476,1,11,40092,22,40070,0.9994512620971765,18.120286222222223,1899.5769013333334,15.344234809036362,130,5.900000000000009E-4
1,test_20231101_135538,10404007.png,502730,16122,486608,0.9679310962146679,2,3,61265,2344,58921,0.9617399820452134,26.208451555555556,3568.336864,12.606145142471787,130,6.000000000000009E-4
2,test_20231101_135538,1254659.png,342646,65192,277454,0.8097394979074614,3,4,80080,9165,70915,0.885551948051948,21.891132444444445,3493.511104,12.698182328858888,130,6.000000000000009E-4
3,test_20231101_135538,10188041.png,221231,8202,213029,0.9629256297715962,2,3,41731,1165,40566,0.9720831036879058,12.03271111111111,1366.8562453333334,16.7735751941011,130,6.000000000000009E-4
4,test_20231101_135538,10287332.png,216980,11257,205723,0.9481196423633514,2,4,22337,1550,20787,0.9306084075748757,9.689633777777777,850.2091146666667,18.835546043579313,130,6.000000000000009E-4
5,test_20231101_135538,11610969.png,368720,21087,347633,0.9428102625298329,2,10,84111,3086,81025,0.9633103874641842,23.404170666666666,3403.7126293333336,12.811274747794313,130,6.000000000000009E-4
6,test_20231101_135538,10350842.png,212614,4737,207877,0.9777201877580969,2,4,42529,695,41834,0.9836582096922101,19.730252444444446,2470.973925333333,14.202121982839607,130,6.000000000000009E-4
7,test_20231101_135538,10863862.png,317432,7319,310113,0.9769430933239245,2,4,66058,1074,64984,0.98374156044688,35.801813333333335,6532.50336,9.980007190886644,130,6.000000000000009E-4
8,test_20231101_135538,11382381.png,312486,567,311919,0.9981855187112383,1,4,46745,75,46670,0.9983955503262381,22.72423288888889,2714.741744,13.793518398308729,130,6.000000000000009E-4
9,test_20231101_135538,11079715.png,443815,107657,336158,0.7574282076991539,3,4,124136,15104,109032,0.8783269961977186,17.946035555555557,2359.634992,14.402355329911469,130,6.000000000000009E-4
10,test_20231101_135538,11551286.png,271883,164,271719,0.9993967993585476,1,4,40092,22,40070,0.9994512620971765,18.120286222222223,1899.5769013333334,15.344234809036362,130,6.000000000000009E-4
1,test_20231101_135538,10404007.png,502730,16122,486608,0.9679310962146679,3,3,61265,2344,58921,0.9617399820452134,26.208451555555556,3568.336864,12.606145142471787,130,6.10000000000001E-4
2,test_20231101_135538,1254659.png,342646,65192,277454,0.8097394979074614,3,4,80080,9165,70915,0.885551948051948,21.891132444444445,3493.511104,12.698182328858888,130,6.10000000000001E-4
3,test_20231101_135538,10188041.png,221231,8202,213029,0.9629256297715962,2,4,41731,1165,40566,0.9720831036879058,12.03271111111111,1366.8562453333334,16.7735751941011,130,6.10000000000001E-4
4,test_20231101_135538,10287332.png,216980,11257,205723,0.9481196423633514,2,4,22337,1550,20787,0.9306084075748757,9.689633777777777,850.2091146666667,18.835546043579313,130,6.10000000000001E-4
5,test_20231101_135538,11610969.png,368720,21087,347633,0.9428102625298329,2,10,84111,3086,81025,0.9633103874641842,23.404170666666666,3403.7126293333336,12.811274747794313,130,6.10000000000001E-4
6,test_20231101_135538,10350842.png,212614,4737,207877,0.9777201877580969,1,4,42529,695,41834,0.9836582096922101,19.730252444444446,2470.973925333333,14.202121982839607,130,6.10000000000001E-4
7,test_20231101_135538,10863862.png,317432,7319,310113,0.9769430933239245,2,4,66058,1074,64984,0.98374156044688,35.801813333333335,6532.50336,9.980007190886644,130,6.10000000000001E-4
8,test_20231101_135538,11382381.png,312486,567,311919,0.9981855187112383,1,4,46745,75,46670,0.9983955503262381,22.72423288888889,2714.741744,13.793518398308729,130,6.10000000000001E-4
9,test_20231101_135538,11079715.png,443815,107657,336158,0.7574282076991539,4,4,124136,15104,109032,0.8783269961977186,17.946035555555557,2359.634992,14.402355329911469,130,6.10000000000001E-4
10,test_20231101_135538,11551286.png,271883,164,271719,0.9993967993585476,1,3,40092,22,40070,0.9994512620971765,18.120286222222223,1899.5769013333334,15.344234809036362,130,6.10000000000001E-4
1,test_20231101_135539,10404007.png,502730,16122,486608,0.9679310962146679,2,4,61265,2344,58921,0.9617399820452134,26.208451555555556,3568.336864,12.606145142471787,130,6.20000000000001E-4
2,test_20231101_135539,1254659.png,342646,65192,277454,0.8097394979074614,2,4,80080,9165,70915,0.885551948051948,21.891132444444445,3493.511104,12.698182328858888,130,6.20000000000001E-4
3,test_20231101_135539,10188041.png,221231,8202,213029,0.9629256297715962,2,4,41731,1165,40566,0.9720831036879058,12.03271111111111,1366.8562453333334,16.7735751941011,130,6.20000000000001E-4
4,test_20231101_135539,10287332.png,216980,11257,205723,0.9481196423633514,2,4,22337,1550,20787,0.9306084075748757,9.689633777777777,850.2091146666667,18.835546043579313,130,6.20000000000001E-4
5,test_20231101_135539,11610969.png,368720,21087,347633,0.9428102625298329,2,3,84111,3086,81025,0.9633103874641842,23.404170666666666,3403.7126293333336,12.811274747794313,130,6.20000000000001E-4
6,test_20231101_135539,10350842.png,212614,4737,207877,0.9777201877580969,1,3,42529,695,41834,0.9836582096922101,19.730252444444446,2470.973925333333,14.202121982839607,130,6.20000000000001E-4
7,test_20231101_135539,10863862.png,317432,7319,310113,0.9769430933239245,2,3,66058,1074,64984,0.98374156044688,35.801813333333335,6532.50336,9.980007190886644,130,6.20000000000001E-4
8,test_20231101_135539,11382381.png,312486,567,311919,0.9981855187112383,1,4,46745,75,46670,0.9983955503262381,22.72423288888889,2714.741744,13.793518398308729,130,6.20000000000001E-4
9,test_20231101_135539,11079715.png,443815,107657,336158,0.7574282076991539,4,4,124136,15104,109032,0.8783269961977186,17.946035555555557,2359.634992,14.402355329911469,130,6.20000000000001E-4
10,test_20231101_135539,11551286.png,271883,164,271719,0.9993967993585476,1,4,40092,22,40070,0.9994512620971765,18.120286222222223,1899.5769013333334,15.344234809036362,130,6.20000000000001E-4
1,test_20231101_135540,10404007.png,502730,16122,486608,0.9679310962146679,2,4,61265,2344,58921,0.9617399820452134,26.208451555555556,3568.336864,12.606145142471787,130,6.30000000000001E-4
2,test_20231101_135540,1254659.png,342646,65192,277454,0.8097394979074614,3,4,80080,9165,70915,0.885551948051948,21.891132444444445,3493.511104,12.698182328858888,130,6.30000000000001E-4
3,test_20231101_135540,10188041.png,221231,8202,213029,0.9629256297715962,2,3,41731,1165,40566,0.9720831036879058,12.03271111111111,1366.8562453333334,16.7735751941011,130,6.30000000000001E-4
4,test_20231101_135540,10287332.png,216980,11257,205723,0.9481196423633514,2,4,22337,1550,20787,0.9306084075748757,9.689633777777777,850.2091146666667,18.835546043579313,130,6.30000000000001E-4
5,test_20231101_135540,11610969.png,368720,21087,347633,0.9428102625298329,2,4,84111,3086,81025,0.9633103874641842,23.404170666666666,3403.7126293333336,12.811274747794313,130,6.30000000000001E-4
6,test_20231101_135540,10350842.png,212614,4737,207877,0.9777201877580969,1,4,42529,695,41834,0.9836582096922101,19.730252444444446,2470.973925333333,14.202121982839607,130,6.30000000000001E-4
7,test_20231101_135540,10863862.png,317432,7319,310113,0.9769430933239245,2,4,66058,1074,64984,0.98374156044688,35.801813333333335,6532.50336,9.980007190886644,130,6.30000000000001E-4
8,test_20231101_135540,11382381.png,312486,567,311919,0.9981855187112383,1,3,46745,75,46670,0.9983955503262381,22.72423288888889,2714.741744,13.793518398308729,130,6.30000000000001E-4
9,test_20231101_135540,11079715.png,443815,107657,336158,0.7574282076991539,3,4,124136,15104,109032,0.8783269961977186,17.946035555555557,2359.634992,14.402355329911469,130,6.30000000000001E-4
10,test_20231101_135540,11551286.png,271883,164,271719,0.9993967993585476,1,4,40092,22,40070,0.9994512620971765,18.120286222222223,1899.5769013333334,15.344234809036362,130,6.30000000000001E-4
1,test_20231101_135540,10404007.png,502730,16122,486608,0.9679310962146679,2,3,61265,2344,58921,0.9617399820452134,26.208451555555556,3568.336864,12.606145142471787,130,6.40000000000001E-4
2,test_20231101_135540,1254659.png,342646,65192,277454,0.8097394979074614,3,3,80080,9165,70915,0.885551948051948,21.891132444444445,3493.511104,12.698182328858888,130,6.40000000000001E-4
3,test_20231101_135540,10188041.png,221231,8122,213109,0.9632872427462698,2,3,41731,1155,40576,0.9723227336991684,12.071612444444444,1370.9407466666667,16.760616762839437,130,6.40000000000001E-4
4,test_20231101_135540,10287332.png,216980,11257,205723,0.9481196423633514,1,3,22337,1550,20787,0.9306084075748757,9.689633777777777,850.2091146666667,18.835546043579313,130,6.40000000000001E-4
5,test_20231101_135540,11610969.png,368720,21087,347633,0.9428102625298329,2,4,84111,3086,81025,0.9633103874641842,23.404170666666666,3403.7126293333336,12.811274747794313,130,6.40000000000001E-4
6,test_20231101_135540,10350842.png,212614,4737,207877,0.9777201877580969,1,3,42529,695,41834,0.9836582096922101,19.730252444444446,2470.973925333333,14.202121982839607,130,6.40000000000001E-4
7,test_20231101_135540,10863862.png,317432,7319,310113,0.9769430933239245,2,3,66058,1074,64984,0.98374156044688,35.801813333333335,6532.50336,9.980007190886644,130,6.40000000000001E-4
8,test_20231101_135540,11382381.png,312486,567,311919,0.9981855187112383,1,3,46745,75,46670,0.9983955503262381,22.72423288888889,2714.741744,13.793518398308729,130,6.40000000000001E-4
9,test_20231101_135540,11079715.png,443815,107657,336158,0.7574282076991539,3,4,124136,15104,109032,0.8783269961977186,17.946035555555557,2359.634992,14.402355329911469,130,6.40000000000001E-4
10,test_20231101_135540,11551286.png,271883,164,271719,0.9993967993585476,1,8,40092,22,40070,0.9994512620971765,18.120286222222223,1899.5769013333334,15.344234809036362,130,6.40000000000001E-4
1,test_20231101_135541,10404007.png,502730,16122,486608,0.9679310962146679,2,4,61265,2344,58921,0.9617399820452134,26.208451555555556,3568.336864,12.606145142471787,130,6.500000000000011E-4
2,test_20231101_135541,1254659.png,342646,65192,277454,0.8097394979074614,3,4,80080,9165,70915,0.885551948051948,21.891132444444445,3493.511104,12.698182328858888,130,6.500000000000011E-4
3,test_20231101_135541,10188041.png,221231,8122,213109,0.9632872427462698,1,3,41731,1155,40576,0.9723227336991684,12.071612444444444,1370.9407466666667,16.760616762839437,130,6.500000000000011E-4
4,test_20231101_135541,10287332.png,216980,11257,205723,0.9481196423633514,2,3,22337,1550,20787,0.9306084075748757,9.689633777777777,850.2091146666667,18.835546043579313,130,6.500000000000011E-4
5,test_20231101_135541,11610969.png,368720,21087,347633,0.9428102625298329,2,4,84111,3086,81025,0.9633103874641842,23.404170666666666,3403.7126293333336,12.811274747794313,130,6.500000000000011E-4
6,test_20231101_135541,10350842.png,212614,4737,207877,0.9777201877580969,1,4,42529,695,41834,0.9836582096922101,19.730252444444446,2470.973925333333,14.202121982839607,130,6.500000000000011E-4
7,test_20231101_135541,10863862.png,317432,7319,310113,0.9769430933239245,2,7,66058,1074,64984,0.98374156044688,35.801813333333335,6532.50336,9.980007190886644,130,6.500000000000011E-4
8,test_20231101_135541,11382381.png,312486,567,311919,0.9981855187112383,2,3,46745,75,46670,0.9983955503262381,22.72423288888889,2714.741744,13.793518398308729,130,6.500000000000011E-4
9,test_20231101_135541,11079715.png,443815,107657,336158,0.7574282076991539,4,5,124136,15104,109032,0.8783269961977186,17.946035555555557,2359.634992,14.402355329911469,130,6.500000000000011E-4
10,test_20231101_135541,11551286.png,271883,164,271719,0.9993967993585476,1,3,40092,22,40070,0.9994512620971765,18.120286222222223,1899.5769013333334,15.344234809036362,130,6.500000000000011E-4
1,test_20231101_135542,10404007.png,502730,16122,486608,0.9679310962146679,2,4,61265,2344,58921,0.9617399820452134,26.208451555555556,3568.336864,12.606145142471787,130,6.600000000000011E-4
2,test_20231101_135542,1254659.png,342646,65192,277454,0.8097394979074614,3,9,80080,9165,70915,0.885551948051948,21.891132444444445,3493.511104,12.698182328858888,130,6.600000000000011E-4
3,test_20231101_135542,10188041.png,221231,8122,213109,0.9632872427462698,2,4,41731,1155,40576,0.9723227336991684,12.071612444444444,1370.9407466666667,16.760616762839437,130,6.600000000000011E-4
4,test_20231101_135542,10287332.png,216980,11257,205723,0.9481196423633514,2,3,22337,1550,20787,0.9306084075748757,9.689633777777777,850.2091146666667,18.835546043579313,130,6.600000000000011E-4
5,test_20231101_135542,11610969.png,368720,21087,347633,0.9428102625298329,2,3,84111,3086,81025,0.9633103874641842,23.404170666666666,3403.7126293333336,12.811274747794313,130,6.600000000000011E-4
6,test_20231101_135542,10350842.png,212614,4737,207877,0.9777201877580969,2,4,42529,695,41834,0.9836582096922101,19.730252444444446,2470.973925333333,14.202121982839607,130,6.600000000000011E-4
7,test_20231101_135542,10863862.png,317432,7319,310113,0.9769430933239245,1,4,66058,1074,64984,0.98374156044688,35.801813333333335,6532.50336,9.980007190886644,130,6.600000000000011E-4
8,test_20231101_135542,11382381.png,312486,567,311919,0.9981855187112383,1,3,46745,75,46670,0.9983955503262381,22.72423288888889,2714.741744,13.793518398308729,130,6.600000000000011E-4
9,test_20231101_135542,11079715.png,443815,107657,336158,0.7574282076991539,3,5,124136,15104,109032,0.8783269961977186,17.946035555555557,2359.634992,14.402355329911469,130,6.600000000000011E-4
10,test_20231101_135542,11551286.png,271883,164,271719,0.9993967993585476,1,3,40092,22,40070,0.9994512620971765,18.120286222222223,1899.5769013333334,15.344234809036362,130,6.600000000000011E-4
1,test_20231101_135542,10404007.png,502730,16122,486608,0.9679310962146679,2,4,61265,2344,58921,0.9617399820452134,26.208451555555556,3568.336864,12.606145142471787,130,6.700000000000011E-4
2,test_20231101_135542,1254659.png,342646,65192,277454,0.8097394979074614,3,4,80080,9165,70915,0.885551948051948,21.891132444444445,3493.511104,12.698182328858888,130,6.700000000000011E-4
3,test_20231101_135542,10188041.png,221231,8122,213109,0.9632872427462698,2,4,41731,1155,40576,0.9723227336991684,12.071612444444444,1370.9407466666667,16.760616762839437,130,6.700000000000011E-4
4,test_20231101_135542,10287332.png,216980,11257,205723,0.9481196423633514,2,4,22337,1550,20787,0.9306084075748757,9.689633777777777,850.2091146666667,18.835546043579313,130,6.700000000000011E-4
5,test_20231101_135542,11610969.png,368720,21087,347633,0.9428102625298329,2,3,84111,3086,81025,0.9633103874641842,23.404170666666666,3403.7126293333336,12.811274747794313,130,6.700000000000011E-4
6,test_20231101_135542,10350842.png,212614,4737,207877,0.9777201877580969,1,3,42529,695,41834,0.9836582096922101,19.730252444444446,2470.973925333333,14.202121982839607,130,6.700000000000011E-4
7,test_20231101_135542,10863862.png,317432,7319,310113,0.9769430933239245,2,3,66058,1074,64984,0.98374156044688,35.801813333333335,6532.50336,9.980007190886644,130,6.700000000000011E-4
8,test_20231101_135542,11382381.png,312486,567,311919,0.9981855187112383,2,3,46745,75,46670,0.9983955503262381,22.72423288888889,2714.741744,13.793518398308729,130,6.700000000000011E-4
9,test_20231101_135542,11079715.png,443815,107657,336158,0.7574282076991539,4,4,124136,15104,109032,0.8783269961977186,17.946035555555557,2359.634992,14.402355329911469,130,6.700000000000011E-4
10,test_20231101_135542,11551286.png,271883,164,271719,0.9993967993585476,1,3,40092,22,40070,0.9994512620971765,18.120286222222223,1899.5769013333334,15.344234809036362,130,6.700000000000011E-4
1,test_20231101_135543,10404007.png,502730,16122,486608,0.9679310962146679,2,4,61265,2344,58921,0.9617399820452134,26.208451555555556,3568.336864,12.606145142471787,130,6.800000000000011E-4
2,test_20231101_135543,1254659.png,342646,65192,277454,0.8097394979074614,3,4,80080,9165,70915,0.885551948051948,21.891132444444445,3493.511104,12.698182328858888,130,6.800000000000011E-4
3,test_20231101_135543,10188041.png,221231,8122,213109,0.9632872427462698,2,4,41731,1155,40576,0.9723227336991684,12.071612444444444,1370.9407466666667,16.760616762839437,130,6.800000000000011E-4
4,test_20231101_135543,10287332.png,216980,11257,205723,0.9481196423633514,2,4,22337,1550,20787,0.9306084075748757,9.689633777777777,850.2091146666667,18.835546043579313,130,6.800000000000011E-4
5,test_20231101_135543,11610969.png,368720,21087,347633,0.9428102625298329,2,3,84111,3086,81025,0.9633103874641842,23.404170666666666,3403.7126293333336,12.811274747794313,130,6.800000000000011E-4
6,test_20231101_135543,10350842.png,212614,4737,207877,0.9777201877580969,1,3,42529,695,41834,0.9836582096922101,19.730252444444446,2470.973925333333,14.202121982839607,130,6.800000000000011E-4
7,test_20231101_135543,10863862.png,317432,7319,310113,0.9769430933239245,1,3,66058,1074,64984,0.98374156044688,35.801813333333335,6532.50336,9.980007190886644,130,6.800000000000011E-4
8,test_20231101_135543,11382381.png,312486,567,311919,0.9981855187112383,2,3,46745,75,46670,0.9983955503262381,22.72423288888889,2714.741744,13.793518398308729,130,6.800000000000011E-4
9,test_20231101_135543,11079715.png,443815,107657,336158,0.7574282076991539,4,4,124136,15104,109032,0.8783269961977186,17.946035555555557,2359.634992,14.402355329911469,130,6.800000000000011E-4
10,test_20231101_135543,11551286.png,271883,164,271719,0.9993967993585476,1,4,40092,22,40070,0.9994512620971765,18.120286222222223,1899.5769013333334,15.344234809036362,130,6.800000000000011E-4
1,test_20231101_135544,10404007.png,502730,16122,486608,0.9679310962146679,2,3,61265,2344,58921,0.9617399820452134,26.208451555555556,3568.336864,12.606145142471787,130,6.900000000000012E-4
2,test_20231101_135544,1254659.png,342646,65192,277454,0.8097394979074614,3,4,80080,9165,70915,0.885551948051948,21.891132444444445,3493.511104,12.698182328858888,130,6.900000000000012E-4
3,test_20231101_135544,10188041.png,221231,8122,213109,0.9632872427462698,2,4,41731,1155,40576,0.9723227336991684,12.071612444444444,1370.9407466666667,16.760616762839437,130,6.900000000000012E-4
4,test_20231101_135544,10287332.png,216980,11257,205723,0.9481196423633514,2,12,22337,1550,20787,0.9306084075748757,9.689633777777777,850.2091146666667,18.835546043579313,130,6.900000000000012E-4
5,test_20231101_135544,11610969.png,368720,21087,347633,0.9428102625298329,2,4,84111,3086,81025,0.9633103874641842,23.404170666666666,3403.7126293333336,12.811274747794313,130,6.900000000000012E-4
6,test_20231101_135544,10350842.png,212614,4737,207877,0.9777201877580969,2,4,42529,695,41834,0.9836582096922101,19.730252444444446,2470.973925333333,14.202121982839607,130,6.900000000000012E-4
7,test_20231101_135544,10863862.png,317432,7319,310113,0.9769430933239245,2,4,66058,1074,64984,0.98374156044688,35.801813333333335,6532.50336,9.980007190886644,130,6.900000000000012E-4
8,test_20231101_135544,11382381.png,312486,567,311919,0.9981855187112383,1,3,46745,75,46670,0.9983955503262381,22.72423288888889,2714.741744,13.793518398308729,130,6.900000000000012E-4
9,test_20231101_135544,11079715.png,443815,107657,336158,0.7574282076991539,4,4,124136,15104,109032,0.8783269961977186,17.946035555555557,2359.634992,14.402355329911469,130,6.900000000000012E-4
10,test_20231101_135544,11551286.png,271883,164,271719,0.9993967993585476,2,4,40092,22,40070,0.9994512620971765,18.120286222222223,1899.5769013333334,15.344234809036362,130,6.900000000000012E-4
1,test_20231101_135544,10404007.png,502730,16122,486608,0.9679310962146679,2,4,61265,2344,58921,0.9617399820452134,26.208451555555556,3568.336864,12.606145142471787,130,7.000000000000012E-4
2,test_20231101_135544,1254659.png,342646,65192,277454,0.8097394979074614,3,4,80080,9165,70915,0.885551948051948,21.891132444444445,3493.511104,12.698182328858888,130,7.000000000000012E-4
3,test_20231101_135544,10188041.png,221231,8122,213109,0.9632872427462698,2,3,41731,1155,40576,0.9723227336991684,12.071612444444444,1370.9407466666667,16.760616762839437,130,7.000000000000012E-4
4,test_20231101_135544,10287332.png,216980,11257,205723,0.9481196423633514,2,4,22337,1550,20787,0.9306084075748757,9.689633777777777,850.2091146666667,18.835546043579313,130,7.000000000000012E-4
5,test_20231101_135544,11610969.png,368720,21087,347633,0.9428102625298329,2,4,84111,3086,81025,0.9633103874641842,23.404170666666666,3403.7126293333336,12.811274747794313,130,7.000000000000012E-4
6,test_20231101_135544,10350842.png,212614,4737,207877,0.9777201877580969,2,3,42529,695,41834,0.9836582096922101,19.730252444444446,2470.973925333333,14.202121982839607,130,7.000000000000012E-4
7,test_20231101_135544,10863862.png,317432,7319,310113,0.9769430933239245,2,4,66058,1074,64984,0.98374156044688,35.801813333333335,6532.50336,9.980007190886644,130,7.000000000000012E-4
8,test_20231101_135544,11382381.png,312486,567,311919,0.9981855187112383,1,4,46745,75,46670,0.9983955503262381,22.72423288888889,2714.741744,13.793518398308729,130,7.000000000000012E-4
9,test_20231101_135544,11079715.png,443815,107657,336158,0.7574282076991539,3,4,124136,15104,109032,0.8783269961977186,17.946035555555557,2359.634992,14.402355329911469,130,7.000000000000012E-4
10,test_20231101_135544,11551286.png,271883,164,271719,0.9993967993585476,1,10,40092,22,40070,0.9994512620971765,18.120286222222223,1899.5769013333334,15.344234809036362,130,7.000000000000012E-4
1,test_20231101_135545,10404007.png,502730,16122,486608,0.9679310962146679,3,3,61265,2344,58921,0.9617399820452134,26.208451555555556,3568.336864,12.606145142471787,130,7.100000000000012E-4
2,test_20231101_135545,1254659.png,342646,65192,277454,0.8097394979074614,2,3,80080,9165,70915,0.885551948051948,21.891132444444445,3493.511104,12.698182328858888,130,7.100000000000012E-4
3,test_20231101_135545,10188041.png,221231,8122,213109,0.9632872427462698,2,4,41731,1155,40576,0.9723227336991684,12.071612444444444,1370.9407466666667,16.760616762839437,130,7.100000000000012E-4
4,test_20231101_135545,10287332.png,216980,11257,205723,0.9481196423633514,9,3,22337,1550,20787,0.9306084075748757,9.689633777777777,850.2091146666667,18.835546043579313,130,7.100000000000012E-4
5,test_20231101_135545,11610969.png,368720,21087,347633,0.9428102625298329,2,3,84111,3086,81025,0.9633103874641842,23.404170666666666,3403.7126293333336,12.811274747794313,130,7.100000000000012E-4
6,test_20231101_135545,10350842.png,212614,3752,208862,0.9823529965101075,1,3,42529,549,41980,0.9870911613252134,22.791978666666665,3212.1519146666665,13.062842843667122,130,7.100000000000012E-4
7,test_20231101_135545,10863862.png,317432,7319,310113,0.9769430933239245,2,4,66058,1074,64984,0.98374156044688,35.801813333333335,6532.50336,9.980007190886644,130,7.100000000000012E-4
8,test_20231101_135545,11382381.png,312486,567,311919,0.9981855187112383,1,3,46745,75,46670,0.9983955503262381,22.72423288888889,2714.741744,13.793518398308729,130,7.100000000000012E-4
9,test_20231101_135545,11079715.png,443815,107657,336158,0.7574282076991539,4,4,124136,15104,109032,0.8783269961977186,17.946035555555557,2359.634992,14.402355329911469,130,7.100000000000012E-4
10,test_20231101_135545,11551286.png,271883,164,271719,0.9993967993585476,1,4,40092,22,40070,0.9994512620971765,18.120286222222223,1899.5769013333334,15.344234809036362,130,7.100000000000012E-4
1,test_20231101_135546,10404007.png,502730,16122,486608,0.9679310962146679,2,3,61265,2344,58921,0.9617399820452134,26.208451555555556,3568.336864,12.606145142471787,130,7.200000000000012E-4
2,test_20231101_135546,1254659.png,342646,65192,277454,0.8097394979074614,2,3,80080,9165,70915,0.885551948051948,21.891132444444445,3493.511104,12.698182328858888,130,7.200000000000012E-4
3,test_20231101_135546,10188041.png,221231,8122,213109,0.9632872427462698,2,4,41731,1155,40576,0.9723227336991684,12.071612444444444,1370.9407466666667,16.760616762839437,130,7.200000000000012E-4
4,test_20231101_135546,10287332.png,216980,11257,205723,0.9481196423633514,1,4,22337,1550,20787,0.9306084075748757,9.689633777777777,850.2091146666667,18.835546043579313,130,7.200000000000012E-4
5,test_20231101_135546,11610969.png,368720,21087,347633,0.9428102625298329,2,4,84111,3086,81025,0.9633103874641842,23.404170666666666,3403.7126293333336,12.811274747794313,130,7.200000000000012E-4
6,test_20231101_135546,10350842.png,212614,3752,208862,0.9823529965101075,1,3,42529,549,41980,0.9870911613252134,22.791978666666665,3212.1519146666665,13.062842843667122,130,7.200000000000012E-4
7,test_20231101_135546,10863862.png,317432,7319,310113,0.9769430933239245,2,3,66058,1074,64984,0.98374156044688,35.801813333333335,6532.50336,9.980007190886644,130,7.200000000000012E-4
8,test_20231101_135546,11382381.png,312486,567,311919,0.9981855187112383,1,3,46745,75,46670,0.9983955503262381,22.72423288888889,2714.741744,13.793518398308729,130,7.200000000000012E-4
9,test_20231101_135546,11079715.png,443815,107657,336158,0.7574282076991539,3,4,124136,15104,109032,0.8783269961977186,17.946035555555557,2359.634992,14.402355329911469,130,7.200000000000012E-4
10,test_20231101_135546,11551286.png,271883,164,271719,0.9993967993585476,1,4,40092,22,40070,0.9994512620971765,18.120286222222223,1899.5769013333334,15.344234809036362,130,7.200000000000012E-4
1,test_20231101_135546,10404007.png,502730,16122,486608,0.9679310962146679,3,3,61265,2344,58921,0.9617399820452134,26.208451555555556,3568.336864,12.606145142471787,130,7.300000000000013E-4
2,test_20231101_135546,1254659.png,342646,65192,277454,0.8097394979074614,3,4,80080,9165,70915,0.885551948051948,21.891132444444445,3493.511104,12.698182328858888,130,7.300000000000013E-4
3,test_20231101_135546,10188041.png,221231,8122,213109,0.9632872427462698,2,3,41731,1155,40576,0.9723227336991684,12.071612444444444,1370.9407466666667,16.760616762839437,130,7.300000000000013E-4
4,test_20231101_135546,10287332.png,216980,11257,205723,0.9481196423633514,1,3,22337,1550,20787,0.9306084075748757,9.689633777777777,850.2091146666667,18.835546043579313,130,7.300000000000013E-4
5,test_20231101_135546,11610969.png,368720,21087,347633,0.9428102625298329,2,9,84111,3086,81025,0.9633103874641842,23.404170666666666,3403.7126293333336,12.811274747794313,130,7.300000000000013E-4
6,test_20231101_135546,10350842.png,212614,3752,208862,0.9823529965101075,1,3,42529,549,41980,0.9870911613252134,22.791978666666665,3212.1519146666665,13.062842843667122,130,7.300000000000013E-4
7,test_20231101_135546,10863862.png,317432,7319,310113,0.9769430933239245,2,3,66058,1074,64984,0.98374156044688,35.801813333333335,6532.50336,9.980007190886644,130,7.300000000000013E-4
8,test_20231101_135546,11382381.png,312486,567,311919,0.9981855187112383,1,4,46745,75,46670,0.9983955503262381,22.72423288888889,2714.741744,13.793518398308729,130,7.300000000000013E-4
9,test_20231101_135546,11079715.png,443815,107657,336158,0.7574282076991539,3,4,124136,15104,109032,0.8783269961977186,17.946035555555557,2359.634992,14.402355329911469,130,7.300000000000013E-4
10,test_20231101_135546,11551286.png,271883,164,271719,0.9993967993585476,1,3,40092,22,40070,0.9994512620971765,18.120286222222223,1899.5769013333334,15.344234809036362,130,7.300000000000013E-4
1,test_20231101_135547,10404007.png,502730,16122,486608,0.9679310962146679,2,4,61265,2344,58921,0.9617399820452134,26.208451555555556,3568.336864,12.606145142471787,130,7.400000000000013E-4
2,test_20231101_135547,1254659.png,342646,65192,277454,0.8097394979074614,3,4,80080,9165,70915,0.885551948051948,21.891132444444445,3493.511104,12.698182328858888,130,7.400000000000013E-4
3,test_20231101_135547,10188041.png,221231,8122,213109,0.9632872427462698,1,3,41731,1155,40576,0.9723227336991684,12.071612444444444,1370.9407466666667,16.760616762839437,130,7.400000000000013E-4
4,test_20231101_135547,10287332.png,216980,11257,205723,0.9481196423633514,1,3,22337,1550,20787,0.9306084075748757,9.689633777777777,850.2091146666667,18.835546043579313,130,7.400000000000013E-4
5,test_20231101_135547,11610969.png,368720,21087,347633,0.9428102625298329,3,3,84111,3086,81025,0.9633103874641842,23.404170666666666,3403.7126293333336,12.811274747794313,130,7.400000000000013E-4
6,test_20231101_135547,10350842.png,212614,3752,208862,0.9823529965101075,1,3,42529,549,41980,0.9870911613252134,22.791978666666665,3212.1519146666665,13.062842843667122,130,7.400000000000013E-4
7,test_20231101_135547,10863862.png,317432,7319,310113,0.9769430933239245,2,4,66058,1074,64984,0.98374156044688,35.801813333333335,6532.50336,9.980007190886644,130,7.400000000000013E-4
8,test_20231101_135547,11382381.png,312486,567,311919,0.9981855187112383,2,3,46745,75,46670,0.9983955503262381,22.72423288888889,2714.741744,13.793518398308729,130,7.400000000000013E-4
9,test_20231101_135547,11079715.png,443815,107657,336158,0.7574282076991539,3,4,124136,15104,109032,0.8783269961977186,17.946035555555557,2359.634992,14.402355329911469,130,7.400000000000013E-4
10,test_20231101_135547,11551286.png,271883,164,271719,0.9993967993585476,1,4,40092,22,40070,0.9994512620971765,18.120286222222223,1899.5769013333334,15.344234809036362,130,7.400000000000013E-4
1,test_20231101_135548,10404007.png,502730,16122,486608,0.9679310962146679,3,3,61265,2344,58921,0.9617399820452134,26.208451555555556,3568.336864,12.606145142471787,130,7.500000000000013E-4
2,test_20231101_135548,1254659.png,342646,65192,277454,0.8097394979074614,3,4,80080,9165,70915,0.885551948051948,21.891132444444445,3493.511104,12.698182328858888,130,7.500000000000013E-4
3,test_20231101_135548,10188041.png,221231,8122,213109,0.9632872427462698,2,4,41731,1155,40576,0.9723227336991684,12.071612444444444,1370.9407466666667,16.760616762839437,130,7.500000000000013E-4
4,test_20231101_135548,10287332.png,216980,11257,205723,0.9481196423633514,2,3,22337,1550,20787,0.9306084075748757,9.689633777777777,850.2091146666667,18.835546043579313,130,7.500000000000013E-4
5,test_20231101_135548,11610969.png,368720,21087,347633,0.9428102625298329,2,4,84111,3086,81025,0.9633103874641842,23.404170666666666,3403.7126293333336,12.811274747794313,130,7.500000000000013E-4
6,test_20231101_135548,10350842.png,212614,3752,208862,0.9823529965101075,2,3,42529,549,41980,0.9870911613252134,22.791978666666665,3212.1519146666665,13.062842843667122,130,7.500000000000013E-4
7,test_20231101_135548,10863862.png,317432,7319,310113,0.9769430933239245,2,4,66058,1074,64984,0.98374156044688,35.801813333333335,6532.50336,9.980007190886644,130,7.500000000000013E-4
8,test_20231101_135548,11382381.png,312486,567,311919,0.9981855187112383,1,4,46745,75,46670,0.9983955503262381,22.72423288888889,2714.741744,13.793518398308729,130,7.500000000000013E-4
9,test_20231101_135548,11079715.png,443815,107657,336158,0.7574282076991539,3,4,124136,15104,109032,0.8783269961977186,17.946035555555557,2359.634992,14.402355329911469,130,7.500000000000013E-4
10,test_20231101_135548,11551286.png,271883,164,271719,0.9993967993585476,1,3,40092,22,40070,0.9994512620971765,18.120286222222223,1899.5769013333334,15.344234809036362,130,7.500000000000013E-4
1,test_20231101_135548,10404007.png,502730,16062,486668,0.9680504445726335,2,3,61265,2335,58930,0.9618868848445279,26.211971555555557,3568.99728,12.605341438961224,130,7.600000000000013E-4
2,test_20231101_135548,1254659.png,342646,65192,277454,0.8097394979074614,2,4,80080,9165,70915,0.885551948051948,21.891132444444445,3493.511104,12.698182328858888,130,7.600000000000013E-4
3,test_20231101_135548,10188041.png,221231,8122,213109,0.9632872427462698,2,3,41731,1155,40576,0.9723227336991684,12.071612444444444,1370.9407466666667,16.760616762839437,130,7.600000000000013E-4
4,test_20231101_135548,10287332.png,216980,11257,205723,0.9481196423633514,2,4,22337,1550,20787,0.9306084075748757,9.689633777777777,850.2091146666667,18.835546043579313,130,7.600000000000013E-4
5,test_20231101_135548,11610969.png,368720,21067,347653,0.9428645042308527,3,3,84111,3085,81026,0.9633222765155568,23.509820444444443,3413.8907093333332,12.798307471627746,130,7.600000000000013E-4
6,test_20231101_135548,10350842.png,212614,3732,208882,0.9824470636928895,2,3,42529,546,41983,0.9871617014272615,23.254716444444444,3293.3420266666667,12.954435246046875,130,7.600000000000013E-4
7,test_20231101_135548,10863862.png,317432,7077,310355,0.9777054613271504,1,4,66058,1039,65019,0.9842713978624845,36.419152,6690.678650666667,9.87610189394349,130,7.600000000000013E-4
8,test_20231101_135548,11382381.png,312486,567,311919,0.9981855187112383,1,4,46745,75,46670,0.9983955503262381,22.72423288888889,2714.741744,13.793518398308729,130,7.600000000000013E-4
9,test_20231101_135548,11079715.png,443815,107637,336178,0.7574732715207914,3,4,124136,15102,109034,0.8783431075594509,17.963148444444446,2364.288805333333,14.393798349777816,130,7.600000000000013E-4
10,test_20231101_135548,11551286.png,271883,164,271719,0.9993967993585476,1,4,40092,22,40070,0.9994512620971765,18.120286222222223,1899.5769013333334,15.344234809036362,130,7.600000000000013E-4
1,test_20231101_135549,10404007.png,502730,16062,486668,0.9680504445726335,2,3,61265,2335,58930,0.9618868848445279,26.211971555555557,3568.99728,12.605341438961224,130,7.700000000000014E-4
2,test_20231101_135549,1254659.png,342646,65192,277454,0.8097394979074614,3,4,80080,9165,70915,0.885551948051948,21.891132444444445,3493.511104,12.698182328858888,130,7.700000000000014E-4
3,test_20231101_135549,10188041.png,221231,8122,213109,0.9632872427462698,2,4,41731,1155,40576,0.9723227336991684,12.071612444444444,1370.9407466666667,16.760616762839437,130,7.700000000000014E-4
4,test_20231101_135549,10287332.png,216980,11257,205723,0.9481196423633514,1,3,22337,1550,20787,0.9306084075748757,9.689633777777777,850.2091146666667,18.835546043579313,130,7.700000000000014E-4
5,test_20231101_135549,11610969.png,368720,21067,347653,0.9428645042308527,2,5,84111,3085,81026,0.9633222765155568,23.509820444444443,3413.8907093333332,12.798307471627746,130,7.700000000000014E-4
6,test_20231101_135549,10350842.png,212614,3732,208882,0.9824470636928895,2,4,42529,546,41983,0.9871617014272615,23.254716444444444,3293.3420266666667,12.954435246046875,130,7.700000000000014E-4
7,test_20231101_135549,10863862.png,317432,7077,310355,0.9777054613271504,1,3,66058,1039,65019,0.9842713978624845,36.419152,6690.678650666667,9.87610189394349,130,7.700000000000014E-4
8,test_20231101_135549,11382381.png,312486,567,311919,0.9981855187112383,1,4,46745,75,46670,0.9983955503262381,22.72423288888889,2714.741744,13.793518398308729,130,7.700000000000014E-4
9,test_20231101_135549,11079715.png,443815,107637,336178,0.7574732715207914,4,4,124136,15102,109034,0.8783431075594509,17.963148444444446,2364.288805333333,14.393798349777816,130,7.700000000000014E-4
10,test_20231101_135549,11551286.png,271883,164,271719,0.9993967993585476,2,4,40092,22,40070,0.9994512620971765,18.120286222222223,1899.5769013333334,15.344234809036362,130,7.700000000000014E-4
1,test_20231101_135550,10404007.png,502730,16062,486668,0.9680504445726335,3,4,61265,2335,58930,0.9618868848445279,26.211971555555557,3568.99728,12.605341438961224,130,7.800000000000014E-4
2,test_20231101_135550,1254659.png,342646,65192,277454,0.8097394979074614,4,4,80080,9165,70915,0.885551948051948,21.891132444444445,3493.511104,12.698182328858888,130,7.800000000000014E-4
3,test_20231101_135550,10188041.png,221231,8122,213109,0.9632872427462698,2,4,41731,1155,40576,0.9723227336991684,12.071612444444444,1370.9407466666667,16.760616762839437,130,7.800000000000014E-4
4,test_20231101_135550,10287332.png,216980,11257,205723,0.9481196423633514,2,4,22337,1550,20787,0.9306084075748757,9.689633777777777,850.2091146666667,18.835546043579313,130,7.800000000000014E-4
5,test_20231101_135550,11610969.png,368720,21067,347653,0.9428645042308527,2,3,84111,3085,81026,0.9633222765155568,23.509820444444443,3413.8907093333332,12.798307471627746,130,7.800000000000014E-4
6,test_20231101_135550,10350842.png,212614,3732,208882,0.9824470636928895,1,3,42529,546,41983,0.9871617014272615,23.254716444444444,3293.3420266666667,12.954435246046875,130,7.800000000000014E-4
7,test_20231101_135550,10863862.png,317432,7077,310355,0.9777054613271504,1,4,66058,1039,65019,0.9842713978624845,36.419152,6690.678650666667,9.87610189394349,130,7.800000000000014E-4
8,test_20231101_135550,11382381.png,312486,567,311919,0.9981855187112383,1,3,46745,75,46670,0.9983955503262381,22.72423288888889,2714.741744,13.793518398308729,130,7.800000000000014E-4
9,test_20231101_135550,11079715.png,443815,107637,336178,0.7574732715207914,4,4,124136,15102,109034,0.8783431075594509,17.963148444444446,2364.288805333333,14.393798349777816,130,7.800000000000014E-4
10,test_20231101_135550,11551286.png,271883,164,271719,0.9993967993585476,1,4,40092,22,40070,0.9994512620971765,18.120286222222223,1899.5769013333334,15.344234809036362,130,7.800000000000014E-4
1,test_20231101_135551,10404007.png,502730,16062,486668,0.9680504445726335,2,5,61265,2335,58930,0.9618868848445279,26.211971555555557,3568.99728,12.605341438961224,130,7.900000000000014E-4
2,test_20231101_135551,1254659.png,342646,65192,277454,0.8097394979074614,3,6,80080,9165,70915,0.885551948051948,21.891132444444445,3493.511104,12.698182328858888,130,7.900000000000014E-4
3,test_20231101_135551,10188041.png,221231,8122,213109,0.9632872427462698,2,4,41731,1155,40576,0.9723227336991684,12.071612444444444,1370.9407466666667,16.760616762839437,130,7.900000000000014E-4
4,test_20231101_135551,10287332.png,216980,11257,205723,0.9481196423633514,2,4,22337,1550,20787,0.9306084075748757,9.689633777777777,850.2091146666667,18.835546043579313,130,7.900000000000014E-4
5,test_20231101_135551,11610969.png,368720,21067,347653,0.9428645042308527,2,4,84111,3085,81026,0.9633222765155568,23.509820444444443,3413.8907093333332,12.798307471627746,130,7.900000000000014E-4
6,test_20231101_135551,10350842.png,212614,3732,208882,0.9824470636928895,2,4,42529,546,41983,0.9871617014272615,23.254716444444444,3293.3420266666667,12.954435246046875,130,7.900000000000014E-4
7,test_20231101_135551,10863862.png,317432,7077,310355,0.9777054613271504,2,4,66058,1039,65019,0.9842713978624845,36.419152,6690.678650666667,9.87610189394349,130,7.900000000000014E-4
8,test_20231101_135551,11382381.png,312486,567,311919,0.9981855187112383,1,3,46745,75,46670,0.9983955503262381,22.72423288888889,2714.741744,13.793518398308729,130,7.900000000000014E-4
9,test_20231101_135551,11079715.png,443815,107637,336178,0.7574732715207914,3,5,124136,15102,109034,0.8783431075594509,17.963148444444446,2364.288805333333,14.393798349777816,130,7.900000000000014E-4
10,test_20231101_135551,11551286.png,271883,164,271719,0.9993967993585476,1,4,40092,22,40070,0.9994512620971765,18.120286222222223,1899.5769013333334,15.344234809036362,130,7.900000000000014E-4
1,test_20231101_135551,10404007.png,502730,16062,486668,0.9680504445726335,3,5,61265,2335,58930,0.9618868848445279,26.211971555555557,3568.99728,12.605341438961224,130,8.000000000000014E-4
2,test_20231101_135551,1254659.png,342646,65192,277454,0.8097394979074614,4,5,80080,9165,70915,0.885551948051948,21.891132444444445,3493.511104,12.698182328858888,130,8.000000000000014E-4
3,test_20231101_135551,10188041.png,221231,8122,213109,0.9632872427462698,2,4,41731,1155,40576,0.9723227336991684,12.071612444444444,1370.9407466666667,16.760616762839437,130,8.000000000000014E-4
4,test_20231101_135551,10287332.png,216980,11257,205723,0.9481196423633514,2,4,22337,1550,20787,0.9306084075748757,9.689633777777777,850.2091146666667,18.835546043579313,130,8.000000000000014E-4
5,test_20231101_135551,11610969.png,368720,21067,347653,0.9428645042308527,8,4,84111,3085,81026,0.9633222765155568,23.509820444444443,3413.8907093333332,12.798307471627746,130,8.000000000000014E-4
6,test_20231101_135551,10350842.png,212614,3732,208882,0.9824470636928895,2,4,42529,546,41983,0.9871617014272615,23.254716444444444,3293.3420266666667,12.954435246046875,130,8.000000000000014E-4
7,test_20231101_135551,10863862.png,317432,7077,310355,0.9777054613271504,2,4,66058,1039,65019,0.9842713978624845,36.419152,6690.678650666667,9.87610189394349,130,8.000000000000014E-4
8,test_20231101_135551,11382381.png,312486,567,311919,0.9981855187112383,1,4,46745,75,46670,0.9983955503262381,22.72423288888889,2714.741744,13.793518398308729,130,8.000000000000014E-4
9,test_20231101_135551,11079715.png,443815,107637,336178,0.7574732715207914,3,4,124136,15102,109034,0.8783431075594509,17.963148444444446,2364.288805333333,14.393798349777816,130,8.000000000000014E-4
10,test_20231101_135551,11551286.png,271883,164,271719,0.9993967993585476,1,4,40092,22,40070,0.9994512620971765,18.120286222222223,1899.5769013333334,15.344234809036362,130,8.000000000000014E-4
1,test_20231101_135552,10404007.png,502730,16062,486668,0.9680504445726335,2,4,61265,2335,58930,0.9618868848445279,26.211971555555557,3568.99728,12.605341438961224,130,8.100000000000015E-4
2,test_20231101_135552,1254659.png,342646,65192,277454,0.8097394979074614,3,4,80080,9165,70915,0.885551948051948,21.891132444444445,3493.511104,12.698182328858888,130,8.100000000000015E-4
3,test_20231101_135552,10188041.png,221231,8122,213109,0.9632872427462698,2,4,41731,1155,40576,0.9723227336991684,12.071612444444444,1370.9407466666667,16.760616762839437,130,8.100000000000015E-4
4,test_20231101_135552,10287332.png,216980,11257,205723,0.9481196423633514,2,4,22337,1550,20787,0.9306084075748757,9.689633777777777,850.2091146666667,18.835546043579313,130,8.100000000000015E-4
5,test_20231101_135552,11610969.png,368720,21067,347653,0.9428645042308527,4,4,84111,3085,81026,0.9633222765155568,23.509820444444443,3413.8907093333332,12.798307471627746,130,8.100000000000015E-4
6,test_20231101_135552,10350842.png,212614,3732,208882,0.9824470636928895,2,3,42529,546,41983,0.9871617014272615,23.254716444444444,3293.3420266666667,12.954435246046875,130,8.100000000000015E-4
7,test_20231101_135552,10863862.png,317432,7077,310355,0.9777054613271504,2,4,66058,1039,65019,0.9842713978624845,36.419152,6690.678650666667,9.87610189394349,130,8.100000000000015E-4
8,test_20231101_135552,11382381.png,312486,567,311919,0.9981855187112383,2,4,46745,75,46670,0.9983955503262381,22.72423288888889,2714.741744,13.793518398308729,130,8.100000000000015E-4
9,test_20231101_135552,11079715.png,443815,107637,336178,0.7574732715207914,3,4,124136,15102,109034,0.8783431075594509,17.963148444444446,2364.288805333333,14.393798349777816,130,8.100000000000015E-4
10,test_20231101_135552,11551286.png,271883,164,271719,0.9993967993585476,1,4,40092,22,40070,0.9994512620971765,18.120286222222223,1899.5769013333334,15.344234809036362,130,8.100000000000015E-4
1,test_20231101_135553,10404007.png,502730,16062,486668,0.9680504445726335,2,3,61265,2335,58930,0.9618868848445279,26.211971555555557,3568.99728,12.605341438961224,130,8.200000000000015E-4
2,test_20231101_135553,1254659.png,342646,65192,277454,0.8097394979074614,3,6,80080,9165,70915,0.885551948051948,21.891132444444445,3493.511104,12.698182328858888,130,8.200000000000015E-4
3,test_20231101_135553,10188041.png,221231,8122,213109,0.9632872427462698,2,4,41731,1155,40576,0.9723227336991684,12.071612444444444,1370.9407466666667,16.760616762839437,130,8.200000000000015E-4
4,test_20231101_135553,10287332.png,216980,11257,205723,0.9481196423633514,2,4,22337,1550,20787,0.9306084075748757,9.689633777777777,850.2091146666667,18.835546043579313,130,8.200000000000015E-4
5,test_20231101_135553,11610969.png,368720,21067,347653,0.9428645042308527,3,4,84111,3085,81026,0.9633222765155568,23.509820444444443,3413.8907093333332,12.798307471627746,130,8.200000000000015E-4
6,test_20231101_135553,10350842.png,212614,3732,208882,0.9824470636928895,1,4,42529,546,41983,0.9871617014272615,23.254716444444444,3293.3420266666667,12.954435246046875,130,8.200000000000015E-4
7,test_20231101_135553,10863862.png,317432,7077,310355,0.9777054613271504,2,4,66058,1039,65019,0.9842713978624845,36.419152,6690.678650666667,9.87610189394349,130,8.200000000000015E-4
8,test_20231101_135553,11382381.png,312486,567,311919,0.9981855187112383,1,4,46745,75,46670,0.9983955503262381,22.72423288888889,2714.741744,13.793518398308729,130,8.200000000000015E-4
9,test_20231101_135553,11079715.png,443815,107637,336178,0.7574732715207914,3,4,124136,15102,109034,0.8783431075594509,17.963148444444446,2364.288805333333,14.393798349777816,130,8.200000000000015E-4
10,test_20231101_135553,11551286.png,271883,164,271719,0.9993967993585476,2,4,40092,22,40070,0.9994512620971765,18.120286222222223,1899.5769013333334,15.344234809036362,130,8.200000000000015E-4
1,test_20231101_135554,10404007.png,502730,16062,486668,0.9680504445726335,3,4,61265,2335,58930,0.9618868848445279,26.211971555555557,3568.99728,12.605341438961224,130,8.300000000000015E-4
2,test_20231101_135554,1254659.png,342646,65192,277454,0.8097394979074614,3,4,80080,9165,70915,0.885551948051948,21.891132444444445,3493.511104,12.698182328858888,130,8.300000000000015E-4
3,test_20231101_135554,10188041.png,221231,8122,213109,0.9632872427462698,2,3,41731,1155,40576,0.9723227336991684,12.071612444444444,1370.9407466666667,16.760616762839437,130,8.300000000000015E-4
4,test_20231101_135554,10287332.png,216980,11257,205723,0.9481196423633514,2,4,22337,1550,20787,0.9306084075748757,9.689633777777777,850.2091146666667,18.835546043579313,130,8.300000000000015E-4
5,test_20231101_135554,11610969.png,368720,21067,347653,0.9428645042308527,3,4,84111,3085,81026,0.9633222765155568,23.509820444444443,3413.8907093333332,12.798307471627746,130,8.300000000000015E-4
6,test_20231101_135554,10350842.png,212614,3732,208882,0.9824470636928895,2,4,42529,546,41983,0.9871617014272615,23.254716444444444,3293.3420266666667,12.954435246046875,130,8.300000000000015E-4
7,test_20231101_135554,10863862.png,317432,7077,310355,0.9777054613271504,2,4,66058,1039,65019,0.9842713978624845,36.419152,6690.678650666667,9.87610189394349,130,8.300000000000015E-4
8,test_20231101_135554,11382381.png,312486,567,311919,0.9981855187112383,1,3,46745,75,46670,0.9983955503262381,22.72423288888889,2714.741744,13.793518398308729,130,8.300000000000015E-4
9,test_20231101_135554,11079715.png,443815,107637,336178,0.7574732715207914,4,5,124136,15102,109034,0.8783431075594509,17.963148444444446,2364.288805333333,14.393798349777816,130,8.300000000000015E-4
10,test_20231101_135554,11551286.png,271883,164,271719,0.9993967993585476,3,3,40092,22,40070,0.9994512620971765,18.120286222222223,1899.5769013333334,15.344234809036362,130,8.300000000000015E-4
1,test_20231101_135554,10404007.png,502730,16062,486668,0.9680504445726335,2,3,61265,2335,58930,0.9618868848445279,26.211971555555557,3568.99728,12.605341438961224,130,8.400000000000016E-4
2,test_20231101_135554,1254659.png,342646,65192,277454,0.8097394979074614,3,4,80080,9165,70915,0.885551948051948,21.891132444444445,3493.511104,12.698182328858888,130,8.400000000000016E-4
3,test_20231101_135554,10188041.png,221231,8122,213109,0.9632872427462698,2,4,41731,1155,40576,0.9723227336991684,12.071612444444444,1370.9407466666667,16.760616762839437,130,8.400000000000016E-4
4,test_20231101_135554,10287332.png,216980,11257,205723,0.9481196423633514,2,4,22337,1550,20787,0.9306084075748757,9.689633777777777,850.2091146666667,18.835546043579313,130,8.400000000000016E-4
5,test_20231101_135554,11610969.png,368720,21067,347653,0.9428645042308527,2,4,84111,3085,81026,0.9633222765155568,23.509820444444443,3413.8907093333332,12.798307471627746,130,8.400000000000016E-4
6,test_20231101_135554,10350842.png,212614,3269,209345,0.9846247189742915,2,3,42529,477,42052,0.9887841237743658,24.34659911111111,3559.0051413333335,12.617517454824732,130,8.400000000000016E-4
7,test_20231101_135554,10863862.png,317432,7077,310355,0.9777054613271504,1,4,66058,1039,65019,0.9842713978624845,36.419152,6690.678650666667,9.87610189394349,130,8.400000000000016E-4
8,test_20231101_135554,11382381.png,312486,567,311919,0.9981855187112383,1,3,46745,75,46670,0.9983955503262381,22.72423288888889,2714.741744,13.793518398308729,130,8.400000000000016E-4
9,test_20231101_135554,11079715.png,443815,107637,336178,0.7574732715207914,4,5,124136,15102,109034,0.8783431075594509,17.963148444444446,2364.288805333333,14.393798349777816,130,8.400000000000016E-4
10,test_20231101_135554,11551286.png,271883,164,271719,0.9993967993585476,2,4,40092,22,40070,0.9994512620971765,18.120286222222223,1899.5769013333334,15.344234809036362,130,8.400000000000016E-4
1,test_20231101_135555,10404007.png,502730,16062,486668,0.9680504445726335,2,4,61265,2335,58930,0.9618868848445279,26.211971555555557,3568.99728,12.605341438961224,130,8.500000000000016E-4
2,test_20231101_135555,1254659.png,342646,65192,277454,0.8097394979074614,4,4,80080,9165,70915,0.885551948051948,21.891132444444445,3493.511104,12.698182328858888,130,8.500000000000016E-4
3,test_20231101_135555,10188041.png,221231,8122,213109,0.9632872427462698,2,3,41731,1155,40576,0.9723227336991684,12.071612444444444,1370.9407466666667,16.760616762839437,130,8.500000000000016E-4
4,test_20231101_135555,10287332.png,216980,11257,205723,0.9481196423633514,3,4,22337,1550,20787,0.9306084075748757,9.689633777777777,850.2091146666667,18.835546043579313,130,8.500000000000016E-4
5,test_20231101_135555,11610969.png,368720,21067,347653,0.9428645042308527,3,4,84111,3085,81026,0.9633222765155568,23.509820444444443,3413.8907093333332,12.798307471627746,130,8.500000000000016E-4
6,test_20231101_135555,10350842.png,212614,3269,209345,0.9846247189742915,1,4,42529,477,42052,0.9887841237743658,24.34659911111111,3559.0051413333335,12.617517454824732,130,8.500000000000016E-4
7,test_20231101_135555,10863862.png,317432,7077,310355,0.9777054613271504,2,3,66058,1039,65019,0.9842713978624845,36.419152,6690.678650666667,9.87610189394349,130,8.500000000000016E-4
8,test_20231101_135555,11382381.png,312486,567,311919,0.9981855187112383,1,4,46745,75,46670,0.9983955503262381,22.72423288888889,2714.741744,13.793518398308729,130,8.500000000000016E-4
9,test_20231101_135555,11079715.png,443815,107637,336178,0.7574732715207914,3,4,124136,15102,109034,0.8783431075594509,17.963148444444446,2364.288805333333,14.393798349777816,130,8.500000000000016E-4
10,test_20231101_135555,11551286.png,271883,164,271719,0.9993967993585476,1,3,40092,22,40070,0.9994512620971765,18.120286222222223,1899.5769013333334,15.344234809036362,130,8.500000000000016E-4
1,test_20231101_135556,10404007.png,502730,16062,486668,0.9680504445726335,3,4,61265,2335,58930,0.9618868848445279,26.211971555555557,3568.99728,12.605341438961224,130,8.600000000000016E-4
2,test_20231101_135556,1254659.png,342646,65192,277454,0.8097394979074614,3,4,80080,9165,70915,0.885551948051948,21.891132444444445,3493.511104,12.698182328858888,130,8.600000000000016E-4
3,test_20231101_135556,10188041.png,221231,8122,213109,0.9632872427462698,2,4,41731,1155,40576,0.9723227336991684,12.071612444444444,1370.9407466666667,16.760616762839437,130,8.600000000000016E-4
4,test_20231101_135556,10287332.png,216980,11257,205723,0.9481196423633514,1,3,22337,1550,20787,0.9306084075748757,9.689633777777777,850.2091146666667,18.835546043579313,130,8.600000000000016E-4
5,test_20231101_135556,11610969.png,368720,21067,347653,0.9428645042308527,3,4,84111,3085,81026,0.9633222765155568,23.509820444444443,3413.8907093333332,12.798307471627746,130,8.600000000000016E-4
6,test_20231101_135556,10350842.png,212614,3269,209345,0.9846247189742915,2,4,42529,477,42052,0.9887841237743658,24.34659911111111,3559.0051413333335,12.617517454824732,130,8.600000000000016E-4
7,test_20231101_135556,10863862.png,317432,7077,310355,0.9777054613271504,1,4,66058,1039,65019,0.9842713978624845,36.419152,6690.678650666667,9.87610189394349,130,8.600000000000016E-4
8,test_20231101_135556,11382381.png,312486,567,311919,0.9981855187112383,1,4,46745,75,46670,0.9983955503262381,22.72423288888889,2714.741744,13.793518398308729,130,8.600000000000016E-4
9,test_20231101_135556,11079715.png,443815,107637,336178,0.7574732715207914,3,4,124136,15102,109034,0.8783431075594509,17.963148444444446,2364.288805333333,14.393798349777816,130,8.600000000000016E-4
10,test_20231101_135556,11551286.png,271883,164,271719,0.9993967993585476,2,4,40092,22,40070,0.9994512620971765,18.120286222222223,1899.5769013333334,15.344234809036362,130,8.600000000000016E-4
1,test_20231101_135556,10404007.png,502730,16062,486668,0.9680504445726335,2,10,61265,2335,58930,0.9618868848445279,26.211971555555557,3568.99728,12.605341438961224,130,8.700000000000016E-4
2,test_20231101_135556,1254659.png,342646,65192,277454,0.8097394979074614,3,5,80080,9165,70915,0.885551948051948,21.891132444444445,3493.511104,12.698182328858888,130,8.700000000000016E-4
3,test_20231101_135556,10188041.png,221231,8122,213109,0.9632872427462698,2,4,41731,1155,40576,0.9723227336991684,12.071612444444444,1370.9407466666667,16.760616762839437,130,8.700000000000016E-4
4,test_20231101_135556,10287332.png,216980,11257,205723,0.9481196423633514,2,4,22337,1550,20787,0.9306084075748757,9.689633777777777,850.2091146666667,18.835546043579313,130,8.700000000000016E-4
5,test_20231101_135556,11610969.png,368720,21067,347653,0.9428645042308527,2,4,84111,3085,81026,0.9633222765155568,23.509820444444443,3413.8907093333332,12.798307471627746,130,8.700000000000016E-4
6,test_20231101_135556,10350842.png,212614,3269,209345,0.9846247189742915,1,4,42529,477,42052,0.9887841237743658,24.34659911111111,3559.0051413333335,12.617517454824732,130,8.700000000000016E-4
7,test_20231101_135556,10863862.png,317432,7077,310355,0.9777054613271504,2,4,66058,1039,65019,0.9842713978624845,36.419152,6690.678650666667,9.87610189394349,130,8.700000000000016E-4
8,test_20231101_135556,11382381.png,312486,567,311919,0.9981855187112383,2,3,46745,75,46670,0.9983955503262381,22.72423288888889,2714.741744,13.793518398308729,130,8.700000000000016E-4
9,test_20231101_135556,11079715.png,443815,107637,336178,0.7574732715207914,4,4,124136,15102,109034,0.8783431075594509,17.963148444444446,2364.288805333333,14.393798349777816,130,8.700000000000016E-4
10,test_20231101_135556,11551286.png,271883,164,271719,0.9993967993585476,2,3,40092,22,40070,0.9994512620971765,18.120286222222223,1899.5769013333334,15.344234809036362,130,8.700000000000016E-4
1,test_20231101_135557,10404007.png,502730,16062,486668,0.9680504445726335,2,3,61265,2335,58930,0.9618868848445279,26.211971555555557,3568.99728,12.605341438961224,130,8.800000000000017E-4
2,test_20231101_135557,1254659.png,342646,65192,277454,0.8097394979074614,3,10,80080,9165,70915,0.885551948051948,21.891132444444445,3493.511104,12.698182328858888,130,8.800000000000017E-4
3,test_20231101_135557,10188041.png,221231,8122,213109,0.9632872427462698,2,3,41731,1155,40576,0.9723227336991684,12.071612444444444,1370.9407466666667,16.760616762839437,130,8.800000000000017E-4
4,test_20231101_135557,10287332.png,216980,11257,205723,0.9481196423633514,1,3,22337,1550,20787,0.9306084075748757,9.689633777777777,850.2091146666667,18.835546043579313,130,8.800000000000017E-4
5,test_20231101_135557,11610969.png,368720,21067,347653,0.9428645042308527,2,3,84111,3085,81026,0.9633222765155568,23.509820444444443,3413.8907093333332,12.798307471627746,130,8.800000000000017E-4
6,test_20231101_135557,10350842.png,212614,3269,209345,0.9846247189742915,1,4,42529,477,42052,0.9887841237743658,24.34659911111111,3559.0051413333335,12.617517454824732,130,8.800000000000017E-4
7,test_20231101_135557,10863862.png,317432,7077,310355,0.9777054613271504,2,4,66058,1039,65019,0.9842713978624845,36.419152,6690.678650666667,9.87610189394349,130,8.800000000000017E-4
8,test_20231101_135557,11382381.png,312486,567,311919,0.9981855187112383,1,4,46745,75,46670,0.9983955503262381,22.72423288888889,2714.741744,13.793518398308729,130,8.800000000000017E-4
9,test_20231101_135557,11079715.png,443815,107637,336178,0.7574732715207914,5,4,124136,15102,109034,0.8783431075594509,17.963148444444446,2364.288805333333,14.393798349777816,130,8.800000000000017E-4
10,test_20231101_135557,11551286.png,271883,164,271719,0.9993967993585476,1,3,40092,22,40070,0.9994512620971765,18.120286222222223,1899.5769013333334,15.344234809036362,130,8.800000000000017E-4
1,test_20231101_135558,10404007.png,502730,16062,486668,0.9680504445726335,3,4,61265,2335,58930,0.9618868848445279,26.211971555555557,3568.99728,12.605341438961224,130,8.900000000000017E-4
2,test_20231101_135558,1254659.png,342646,65192,277454,0.8097394979074614,4,4,80080,9165,70915,0.885551948051948,21.891132444444445,3493.511104,12.698182328858888,130,8.900000000000017E-4
3,test_20231101_135558,10188041.png,221231,8122,213109,0.9632872427462698,2,4,41731,1155,40576,0.9723227336991684,12.071612444444444,1370.9407466666667,16.760616762839437,130,8.900000000000017E-4
4,test_20231101_135558,10287332.png,216980,11257,205723,0.9481196423633514,1,4,22337,1550,20787,0.9306084075748757,9.689633777777777,850.2091146666667,18.835546043579313,130,8.900000000000017E-4
5,test_20231101_135558,11610969.png,368720,21067,347653,0.9428645042308527,2,4,84111,3085,81026,0.9633222765155568,23.509820444444443,3413.8907093333332,12.798307471627746,130,8.900000000000017E-4
6,test_20231101_135558,10350842.png,212614,3269,209345,0.9846247189742915,1,4,42529,477,42052,0.9887841237743658,24.34659911111111,3559.0051413333335,12.617517454824732,130,8.900000000000017E-4
7,test_20231101_135558,10863862.png,317432,7077,310355,0.9777054613271504,2,3,66058,1039,65019,0.9842713978624845,36.419152,6690.678650666667,9.87610189394349,130,8.900000000000017E-4
8,test_20231101_135558,11382381.png,312486,567,311919,0.9981855187112383,1,3,46745,75,46670,0.9983955503262381,22.72423288888889,2714.741744,13.793518398308729,130,8.900000000000017E-4
9,test_20231101_135558,11079715.png,443815,107637,336178,0.7574732715207914,4,4,124136,15102,109034,0.8783431075594509,17.963148444444446,2364.288805333333,14.393798349777816,130,8.900000000000017E-4
10,test_20231101_135558,11551286.png,271883,164,271719,0.9993967993585476,1,4,40092,22,40070,0.9994512620971765,18.120286222222223,1899.5769013333334,15.344234809036362,130,8.900000000000017E-4
1,test_20231101_135558,10404007.png,502730,16062,486668,0.9680504445726335,3,4,61265,2335,58930,0.9618868848445279,26.211971555555557,3568.99728,12.605341438961224,130,9.000000000000017E-4
2,test_20231101_135558,1254659.png,342646,65192,277454,0.8097394979074614,3,4,80080,9165,70915,0.885551948051948,21.891132444444445,3493.511104,12.698182328858888,130,9.000000000000017E-4
3,test_20231101_135558,10188041.png,221231,8122,213109,0.9632872427462698,2,4,41731,1155,40576,0.9723227336991684,12.071612444444444,1370.9407466666667,16.760616762839437,130,9.000000000000017E-4
4,test_20231101_135558,10287332.png,216980,11257,205723,0.9481196423633514,1,3,22337,1550,20787,0.9306084075748757,9.689633777777777,850.2091146666667,18.835546043579313,130,9.000000000000017E-4
5,test_20231101_135558,11610969.png,368720,21067,347653,0.9428645042308527,2,3,84111,3085,81026,0.9633222765155568,23.509820444444443,3413.8907093333332,12.798307471627746,130,9.000000000000017E-4
6,test_20231101_135558,10350842.png,212614,3269,209345,0.9846247189742915,1,3,42529,477,42052,0.9887841237743658,24.34659911111111,3559.0051413333335,12.617517454824732,130,9.000000000000017E-4
7,test_20231101_135558,10863862.png,317432,7077,310355,0.9777054613271504,2,3,66058,1039,65019,0.9842713978624845,36.419152,6690.678650666667,9.87610189394349,130,9.000000000000017E-4
8,test_20231101_135558,11382381.png,312486,567,311919,0.9981855187112383,2,3,46745,75,46670,0.9983955503262381,22.72423288888889,2714.741744,13.793518398308729,130,9.000000000000017E-4
9,test_20231101_135558,11079715.png,443815,107637,336178,0.7574732715207914,3,4,124136,15102,109034,0.8783431075594509,17.963148444444446,2364.288805333333,14.393798349777816,130,9.000000000000017E-4
10,test_20231101_135558,11551286.png,271883,164,271719,0.9993967993585476,1,3,40092,22,40070,0.9994512620971765,18.120286222222223,1899.5769013333334,15.344234809036362,130,9.000000000000017E-4
1,test_20231101_135559,10404007.png,502730,16062,486668,0.9680504445726335,2,4,61265,2335,58930,0.9618868848445279,26.211971555555557,3568.99728,12.605341438961224,130,9.100000000000017E-4
2,test_20231101_135559,1254659.png,342646,65192,277454,0.8097394979074614,3,4,80080,9165,70915,0.885551948051948,21.891132444444445,3493.511104,12.698182328858888,130,9.100000000000017E-4
3,test_20231101_135559,10188041.png,221231,8122,213109,0.9632872427462698,3,4,41731,1155,40576,0.9723227336991684,12.071612444444444,1370.9407466666667,16.760616762839437,130,9.100000000000017E-4
4,test_20231101_135559,10287332.png,216980,11257,205723,0.9481196423633514,2,4,22337,1550,20787,0.9306084075748757,9.689633777777777,850.2091146666667,18.835546043579313,130,9.100000000000017E-4
5,test_20231101_135559,11610969.png,368720,21067,347653,0.9428645042308527,2,3,84111,3085,81026,0.9633222765155568,23.509820444444443,3413.8907093333332,12.798307471627746,130,9.100000000000017E-4
6,test_20231101_135559,10350842.png,212614,3269,209345,0.9846247189742915,2,4,42529,477,42052,0.9887841237743658,24.34659911111111,3559.0051413333335,12.617517454824732,130,9.100000000000017E-4
7,test_20231101_135559,10863862.png,317432,7077,310355,0.9777054613271504,2,3,66058,1039,65019,0.9842713978624845,36.419152,6690.678650666667,9.87610189394349,130,9.100000000000017E-4
8,test_20231101_135559,11382381.png,312486,567,311919,0.9981855187112383,1,4,46745,75,46670,0.9983955503262381,22.72423288888889,2714.741744,13.793518398308729,130,9.100000000000017E-4
9,test_20231101_135559,11079715.png,443815,107637,336178,0.7574732715207914,4,4,124136,15102,109034,0.8783431075594509,17.963148444444446,2364.288805333333,14.393798349777816,130,9.100000000000017E-4
10,test_20231101_135559,11551286.png,271883,164,271719,0.9993967993585476,1,3,40092,22,40070,0.9994512620971765,18.120286222222223,1899.5769013333334,15.344234809036362,130,9.100000000000017E-4
1,test_20231101_135600,10404007.png,502730,16062,486668,0.9680504445726335,2,3,61265,2335,58930,0.9618868848445279,26.211971555555557,3568.99728,12.605341438961224,130,9.200000000000018E-4
2,test_20231101_135600,1254659.png,342646,65192,277454,0.8097394979074614,3,4,80080,9165,70915,0.885551948051948,21.891132444444445,3493.511104,12.698182328858888,130,9.200000000000018E-4
3,test_20231101_135600,10188041.png,221231,8122,213109,0.9632872427462698,2,4,41731,1155,40576,0.9723227336991684,12.071612444444444,1370.9407466666667,16.760616762839437,130,9.200000000000018E-4
4,test_20231101_135600,10287332.png,216980,11257,205723,0.9481196423633514,1,4,22337,1550,20787,0.9306084075748757,9.689633777777777,850.2091146666667,18.835546043579313,130,9.200000000000018E-4
5,test_20231101_135600,11610969.png,368720,21067,347653,0.9428645042308527,2,4,84111,3085,81026,0.9633222765155568,23.509820444444443,3413.8907093333332,12.798307471627746,130,9.200000000000018E-4
6,test_20231101_135600,10350842.png,212614,3269,209345,0.9846247189742915,1,4,42529,477,42052,0.9887841237743658,24.34659911111111,3559.0051413333335,12.617517454824732,130,9.200000000000018E-4
7,test_20231101_135600,10863862.png,317432,7077,310355,0.9777054613271504,1,3,66058,1039,65019,0.9842713978624845,36.419152,6690.678650666667,9.87610189394349,130,9.200000000000018E-4
8,test_20231101_135600,11382381.png,312486,567,311919,0.9981855187112383,2,3,46745,75,46670,0.9983955503262381,22.72423288888889,2714.741744,13.793518398308729,130,9.200000000000018E-4
9,test_20231101_135600,11079715.png,443815,107637,336178,0.7574732715207914,3,4,124136,15102,109034,0.8783431075594509,17.963148444444446,2364.288805333333,14.393798349777816,130,9.200000000000018E-4
10,test_20231101_135600,11551286.png,271883,164,271719,0.9993967993585476,1,3,40092,22,40070,0.9994512620971765,18.120286222222223,1899.5769013333334,15.344234809036362,130,9.200000000000018E-4
1,test_20231101_135600,10404007.png,502730,16062,486668,0.9680504445726335,3,4,61265,2335,58930,0.9618868848445279,26.211971555555557,3568.99728,12.605341438961224,130,9.300000000000018E-4
2,test_20231101_135600,1254659.png,342646,65192,277454,0.8097394979074614,3,3,80080,9165,70915,0.885551948051948,21.891132444444445,3493.511104,12.698182328858888,130,9.300000000000018E-4
3,test_20231101_135600,10188041.png,221231,8122,213109,0.9632872427462698,1,3,41731,1155,40576,0.9723227336991684,12.071612444444444,1370.9407466666667,16.760616762839437,130,9.300000000000018E-4
4,test_20231101_135600,10287332.png,216980,11257,205723,0.9481196423633514,2,4,22337,1550,20787,0.9306084075748757,9.689633777777777,850.2091146666667,18.835546043579313,130,9.300000000000018E-4
5,test_20231101_135600,11610969.png,368720,21067,347653,0.9428645042308527,3,4,84111,3085,81026,0.9633222765155568,23.509820444444443,3413.8907093333332,12.798307471627746,130,9.300000000000018E-4
6,test_20231101_135600,10350842.png,212614,3269,209345,0.9846247189742915,2,7,42529,477,42052,0.9887841237743658,24.34659911111111,3559.0051413333335,12.617517454824732,130,9.300000000000018E-4
7,test_20231101_135600,10863862.png,317432,7077,310355,0.9777054613271504,1,4,66058,1039,65019,0.9842713978624845,36.419152,6690.678650666667,9.87610189394349,130,9.300000000000018E-4
8,test_20231101_135600,11382381.png,312486,567,311919,0.9981855187112383,1,4,46745,75,46670,0.9983955503262381,22.72423288888889,2714.741744,13.793518398308729,130,9.300000000000018E-4
9,test_20231101_135600,11079715.png,443815,107637,336178,0.7574732715207914,3,4,124136,15102,109034,0.8783431075594509,17.963148444444446,2364.288805333333,14.393798349777816,130,9.300000000000018E-4
10,test_20231101_135600,11551286.png,271883,164,271719,0.9993967993585476,2,4,40092,22,40070,0.9994512620971765,18.120286222222223,1899.5769013333334,15.344234809036362,130,9.300000000000018E-4
1,test_20231101_135601,10404007.png,502730,16062,486668,0.9680504445726335,3,3,61265,2335,58930,0.9618868848445279,26.211971555555557,3568.99728,12.605341438961224,130,9.400000000000018E-4
2,test_20231101_135601,1254659.png,342646,65192,277454,0.8097394979074614,3,4,80080,9165,70915,0.885551948051948,21.891132444444445,3493.511104,12.698182328858888,130,9.400000000000018E-4
3,test_20231101_135601,10188041.png,221231,8122,213109,0.9632872427462698,2,3,41731,1155,40576,0.9723227336991684,12.071612444444444,1370.9407466666667,16.760616762839437,130,9.400000000000018E-4
4,test_20231101_135601,10287332.png,216980,11257,205723,0.9481196423633514,1,3,22337,1550,20787,0.9306084075748757,9.689633777777777,850.2091146666667,18.835546043579313,130,9.400000000000018E-4
5,test_20231101_135601,11610969.png,368720,21067,347653,0.9428645042308527,2,4,84111,3085,81026,0.9633222765155568,23.509820444444443,3413.8907093333332,12.798307471627746,130,9.400000000000018E-4
6,test_20231101_135601,10350842.png,212614,3269,209345,0.9846247189742915,1,3,42529,477,42052,0.9887841237743658,24.34659911111111,3559.0051413333335,12.617517454824732,130,9.400000000000018E-4
7,test_20231101_135601,10863862.png,317432,7077,310355,0.9777054613271504,1,3,66058,1039,65019,0.9842713978624845,36.419152,6690.678650666667,9.87610189394349,130,9.400000000000018E-4
8,test_20231101_135601,11382381.png,312486,567,311919,0.9981855187112383,1,3,46745,75,46670,0.9983955503262381,22.72423288888889,2714.741744,13.793518398308729,130,9.400000000000018E-4
9,test_20231101_135601,11079715.png,443815,107637,336178,0.7574732715207914,4,4,124136,15102,109034,0.8783431075594509,17.963148444444446,2364.288805333333,14.393798349777816,130,9.400000000000018E-4
10,test_20231101_135601,11551286.png,271883,164,271719,0.9993967993585476,1,4,40092,22,40070,0.9994512620971765,18.120286222222223,1899.5769013333334,15.344234809036362,130,9.400000000000018E-4
1,test_20231101_135602,10404007.png,502730,16062,486668,0.9680504445726335,2,4,61265,2335,58930,0.9618868848445279,26.211971555555557,3568.99728,12.605341438961224,130,9.500000000000018E-4
2,test_20231101_135602,1254659.png,342646,65192,277454,0.8097394979074614,3,4,80080,9165,70915,0.885551948051948,21.891132444444445,3493.511104,12.698182328858888,130,9.500000000000018E-4
3,test_20231101_135602,10188041.png,221231,8122,213109,0.9632872427462698,1,3,41731,1155,40576,0.9723227336991684,12.071612444444444,1370.9407466666667,16.760616762839437,130,9.500000000000018E-4
4,test_20231101_135602,10287332.png,216980,11257,205723,0.9481196423633514,2,4,22337,1550,20787,0.9306084075748757,9.689633777777777,850.2091146666667,18.835546043579313,130,9.500000000000018E-4
5,test_20231101_135602,11610969.png,368720,21067,347653,0.9428645042308527,2,4,84111,3085,81026,0.9633222765155568,23.509820444444443,3413.8907093333332,12.798307471627746,130,9.500000000000018E-4
6,test_20231101_135602,10350842.png,212614,3269,209345,0.9846247189742915,2,3,42529,477,42052,0.9887841237743658,24.34659911111111,3559.0051413333335,12.617517454824732,130,9.500000000000018E-4
7,test_20231101_135602,10863862.png,317432,7077,310355,0.9777054613271504,1,3,66058,1039,65019,0.9842713978624845,36.419152,6690.678650666667,9.87610189394349,130,9.500000000000018E-4
8,test_20231101_135602,11382381.png,312486,567,311919,0.9981855187112383,1,4,46745,75,46670,0.9983955503262381,22.72423288888889,2714.741744,13.793518398308729,130,9.500000000000018E-4
9,test_20231101_135602,11079715.png,443815,107637,336178,0.7574732715207914,3,5,124136,15102,109034,0.8783431075594509,17.963148444444446,2364.288805333333,14.393798349777816,130,9.500000000000018E-4
10,test_20231101_135602,11551286.png,271883,164,271719,0.9993967993585476,1,4,40092,22,40070,0.9994512620971765,18.120286222222223,1899.5769013333334,15.344234809036362,130,9.500000000000018E-4
1,test_20231101_135603,10404007.png,502730,16062,486668,0.9680504445726335,3,3,61265,2335,58930,0.9618868848445279,26.211971555555557,3568.99728,12.605341438961224,130,9.600000000000019E-4
2,test_20231101_135603,1254659.png,342646,65192,277454,0.8097394979074614,3,4,80080,9165,70915,0.885551948051948,21.891132444444445,3493.511104,12.698182328858888,130,9.600000000000019E-4
3,test_20231101_135603,10188041.png,221231,8122,213109,0.9632872427462698,2,4,41731,1155,40576,0.9723227336991684,12.071612444444444,1370.9407466666667,16.760616762839437,130,9.600000000000019E-4
4,test_20231101_135603,10287332.png,216980,11257,205723,0.9481196423633514,2,4,22337,1550,20787,0.9306084075748757,9.689633777777777,850.2091146666667,18.835546043579313,130,9.600000000000019E-4
5,test_20231101_135603,11610969.png,368720,21067,347653,0.9428645042308527,2,3,84111,3085,81026,0.9633222765155568,23.509820444444443,3413.8907093333332,12.798307471627746,130,9.600000000000019E-4
6,test_20231101_135603,10350842.png,212614,3269,209345,0.9846247189742915,2,4,42529,477,42052,0.9887841237743658,24.34659911111111,3559.0051413333335,12.617517454824732,130,9.600000000000019E-4
7,test_20231101_135603,10863862.png,317432,7077,310355,0.9777054613271504,2,4,66058,1039,65019,0.9842713978624845,36.419152,6690.678650666667,9.87610189394349,130,9.600000000000019E-4
8,test_20231101_135603,11382381.png,312486,567,311919,0.9981855187112383,1,3,46745,75,46670,0.9983955503262381,22.72423288888889,2714.741744,13.793518398308729,130,9.600000000000019E-4
9,test_20231101_135603,11079715.png,443815,107637,336178,0.7574732715207914,3,4,124136,15102,109034,0.8783431075594509,17.963148444444446,2364.288805333333,14.393798349777816,130,9.600000000000019E-4
10,test_20231101_135603,11551286.png,271883,164,271719,0.9993967993585476,1,4,40092,22,40070,0.9994512620971765,18.120286222222223,1899.5769013333334,15.344234809036362,130,9.600000000000019E-4
1,test_20231101_135603,10404007.png,502730,16062,486668,0.9680504445726335,2,3,61265,2335,58930,0.9618868848445279,26.211971555555557,3568.99728,12.605341438961224,130,9.700000000000019E-4
2,test_20231101_135603,1254659.png,342646,65192,277454,0.8097394979074614,3,4,80080,9165,70915,0.885551948051948,21.891132444444445,3493.511104,12.698182328858888,130,9.700000000000019E-4
3,test_20231101_135603,10188041.png,221231,8122,213109,0.9632872427462698,2,3,41731,1155,40576,0.9723227336991684,12.071612444444444,1370.9407466666667,16.760616762839437,130,9.700000000000019E-4
4,test_20231101_135603,10287332.png,216980,11257,205723,0.9481196423633514,2,3,22337,1550,20787,0.9306084075748757,9.689633777777777,850.2091146666667,18.835546043579313,130,9.700000000000019E-4
5,test_20231101_135603,11610969.png,368720,21067,347653,0.9428645042308527,2,4,84111,3085,81026,0.9633222765155568,23.509820444444443,3413.8907093333332,12.798307471627746,130,9.700000000000019E-4
6,test_20231101_135603,10350842.png,212614,3269,209345,0.9846247189742915,1,4,42529,477,42052,0.9887841237743658,24.34659911111111,3559.0051413333335,12.617517454824732,130,9.700000000000019E-4
7,test_20231101_135603,10863862.png,317432,7077,310355,0.9777054613271504,2,3,66058,1039,65019,0.9842713978624845,36.419152,6690.678650666667,9.87610189394349,130,9.700000000000019E-4
8,test_20231101_135603,11382381.png,312486,567,311919,0.9981855187112383,1,3,46745,75,46670,0.9983955503262381,22.72423288888889,2714.741744,13.793518398308729,130,9.700000000000019E-4
9,test_20231101_135603,11079715.png,443815,107637,336178,0.7574732715207914,3,4,124136,15102,109034,0.8783431075594509,17.963148444444446,2364.288805333333,14.393798349777816,130,9.700000000000019E-4
10,test_20231101_135603,11551286.png,271883,164,271719,0.9993967993585476,2,4,40092,22,40070,0.9994512620971765,18.120286222222223,1899.5769013333334,15.344234809036362,130,9.700000000000019E-4
1,test_20231101_135604,10404007.png,502730,14797,487933,0.9705667057864062,2,3,61265,2153,59112,0.9648575858973313,26.675523555555557,3677.0935466666665,12.475756822407263,130,9.80000000000002E-4
2,test_20231101_135604,1254659.png,342646,65009,277637,0.8102735768110528,3,4,80080,9147,70933,0.8857767232767233,21.97528888888889,3512.2054293333335,12.67500450952557,130,9.80000000000002E-4
3,test_20231101_135604,10188041.png,221231,7982,213249,0.9639200654519484,2,4,41731,1142,40589,0.9726342527138099,12.194165333333334,1410.783392,16.63620022436401,130,9.80000000000002E-4
4,test_20231101_135604,10287332.png,216980,11177,205803,0.9484883399391649,1,3,22337,1538,20799,0.9311456328065542,9.715194666666667,854.379088,18.814297509556095,130,9.80000000000002E-4
5,test_20231101_135604,11610969.png,368720,20724,347996,0.9437947494033413,3,5,84111,3041,81070,0.9638453947759509,23.702741333333332,3441.175072,12.763735926731954,130,9.80000000000002E-4
6,test_20231101_135604,10350842.png,212614,3027,209587,0.985762931885953,2,4,42529,441,42088,0.9896306049989418,24.490901333333333,3586.0659306666666,12.584620909620183,130,9.80000000000002E-4
7,test_20231101_135604,10863862.png,317432,6977,310455,0.978020489427657,2,4,66058,1024,65034,0.9844984710406007,36.437904,6694.791408,9.873433107769149,130,9.80000000000002E-4
8,test_20231101_135604,11382381.png,312486,367,312119,0.9988255473845228,1,3,46745,48,46697,0.9989731522087923,23.28773511111111,2886.24232,13.527475705549977,130,9.80000000000002E-4
9,test_20231101_135604,11079715.png,443815,107537,336278,0.7576985906289783,3,5,124136,15092,109044,0.8784236643681124,18.001861333333334,2370.5821066666667,14.382253588780998,130,9.80000000000002E-4
10,test_20231101_135604,11551286.png,271883,164,271719,0.9993967993585476,1,3,40092,22,40070,0.9994512620971765,18.120286222222223,1899.5769013333334,15.344234809036362,130,9.80000000000002E-4
1,test_20231101_135605,10404007.png,502730,14797,487933,0.9705667057864062,2,4,61265,2153,59112,0.9648575858973313,26.675523555555557,3677.0935466666665,12.475756822407263,130,9.90000000000002E-4
2,test_20231101_135605,1254659.png,342646,65009,277637,0.8102735768110528,3,4,80080,9147,70933,0.8857767232767233,21.97528888888889,3512.2054293333335,12.67500450952557,130,9.90000000000002E-4
3,test_20231101_135605,10188041.png,221231,7982,213249,0.9639200654519484,2,4,41731,1142,40589,0.9726342527138099,12.194165333333334,1410.783392,16.63620022436401,130,9.90000000000002E-4
4,test_20231101_135605,10287332.png,216980,11177,205803,0.9484883399391649,2,3,22337,1538,20799,0.9311456328065542,9.715194666666667,854.379088,18.814297509556095,130,9.90000000000002E-4
5,test_20231101_135605,11610969.png,368720,20724,347996,0.9437947494033413,2,4,84111,3041,81070,0.9638453947759509,23.702741333333332,3441.175072,12.763735926731954,130,9.90000000000002E-4
6,test_20231101_135605,10350842.png,212614,3027,209587,0.985762931885953,1,3,42529,441,42088,0.9896306049989418,24.490901333333333,3586.0659306666666,12.584620909620183,130,9.90000000000002E-4
7,test_20231101_135605,10863862.png,317432,6977,310455,0.978020489427657,1,3,66058,1024,65034,0.9844984710406007,36.437904,6694.791408,9.873433107769149,130,9.90000000000002E-4
8,test_20231101_135605,11382381.png,312486,367,312119,0.9988255473845228,1,3,46745,48,46697,0.9989731522087923,23.28773511111111,2886.24232,13.527475705549977,130,9.90000000000002E-4
9,test_20231101_135605,11079715.png,443815,107537,336278,0.7576985906289783,3,4,124136,15092,109044,0.8784236643681124,18.001861333333334,2370.5821066666667,14.382253588780998,130,9.90000000000002E-4
10,test_20231101_135605,11551286.png,271883,164,271719,0.9993967993585476,1,3,40092,22,40070,0.9994512620971765,18.120286222222223,1899.5769013333334,15.344234809036362,130,9.90000000000002E-4
1,test_20231101_135605,10404007.png,502730,15902,486828,0.9683687068605414,2,4,61265,2311,58954,0.9622786256426997,26.12632177777778,3556.940384,12.620037746016699,131,0.0
2,test_20231101_135605,1254659.png,342646,63482,279164,0.8147300712688897,3,4,80080,8932,71148,0.8884615384615384,22.097859555555555,3563.7523413333333,12.611728452251572,131,0.0
3,test_20231101_135605,10188041.png,221231,8142,213089,0.9631968395026014,2,3,41731,1155,40576,0.9723227336991684,11.613923555555555,1328.2626453333332,16.897964016937422,131,0.0
4,test_20231101_135605,10287332.png,216980,11107,205873,0.9488109503180017,1,4,22337,1526,20811,0.9316828580382326,9.696193777777777,868.9342453333334,18.740934474449688,131,0.0
5,test_20231101_135605,11610969.png,368720,20412,348308,0.9446409199392493,2,3,84111,2992,81119,0.9644279582932078,23.11974222222222,3369.6077386666666,12.855010139573743,131,0.0
6,test_20231101_135605,10350842.png,212614,4777,207837,0.9775320533925329,2,3,42529,701,41828,0.983517129488114,19.68519288888889,2463.000773333333,14.216158126689425,131,0.0
7,test_20231101_135605,10863862.png,317432,7117,310315,0.9775794500869478,1,4,66058,1047,65011,0.9841502921674892,35.75787733333333,6533.859029333334,9.979106007075385,131,0.0
8,test_20231101_135605,11382381.png,312486,827,311659,0.9973534814359684,2,4,46745,113,46632,0.9975826291581987,20.486714666666668,2360.4332106666666,14.400886444502593,131,0.0
9,test_20231101_135605,11079715.png,443815,104602,339213,0.7643117064542658,3,4,124136,14684,109452,0.8817103821615003,17.949937777777777,2382.459072,14.360549121901718,131,0.0
10,test_20231101_135605,11551286.png,271883,657,271226,0.9975835193814987,2,3,40092,95,39997,0.9976304499650803,17.313984,1772.7602773333333,15.64430349051646,131,0.0
1,test_20231101_135606,10404007.png,502730,15902,486828,0.9683687068605414,2,3,61265,2311,58954,0.9622786256426997,26.12632177777778,3556.940384,12.620037746016699,131,1.0E-5
2,test_20231101_135606,1254659.png,342646,63482,279164,0.8147300712688897,3,4,80080,8932,71148,0.8884615384615384,22.097859555555555,3563.7523413333333,12.611728452251572,131,1.0E-5
3,test_20231101_135606,10188041.png,221231,8142,213089,0.9631968395026014,1,3,41731,1155,40576,0.9723227336991684,11.613923555555555,1328.2626453333332,16.897964016937422,131,1.0E-5
4,test_20231101_135606,10287332.png,216980,11107,205873,0.9488109503180017,2,4,22337,1526,20811,0.9316828580382326,9.696193777777777,868.9342453333334,18.740934474449688,131,1.0E-5
5,test_20231101_135606,11610969.png,368720,20412,348308,0.9446409199392493,2,3,84111,2992,81119,0.9644279582932078,23.11974222222222,3369.6077386666666,12.855010139573743,131,1.0E-5
6,test_20231101_135606,10350842.png,212614,4777,207837,0.9775320533925329,2,3,42529,701,41828,0.983517129488114,19.68519288888889,2463.000773333333,14.216158126689425,131,1.0E-5
7,test_20231101_135606,10863862.png,317432,7117,310315,0.9775794500869478,1,4,66058,1047,65011,0.9841502921674892,35.75787733333333,6533.859029333334,9.979106007075385,131,1.0E-5
8,test_20231101_135606,11382381.png,312486,827,311659,0.9973534814359684,2,3,46745,113,46632,0.9975826291581987,20.486714666666668,2360.4332106666666,14.400886444502593,131,1.0E-5
9,test_20231101_135606,11079715.png,443815,104602,339213,0.7643117064542658,3,4,124136,14684,109452,0.8817103821615003,17.949937777777777,2382.459072,14.360549121901718,131,1.0E-5
10,test_20231101_135606,11551286.png,271883,657,271226,0.9975835193814987,1,4,40092,95,39997,0.9976304499650803,17.313984,1772.7602773333333,15.64430349051646,131,1.0E-5
1,test_20231101_135607,10404007.png,502730,15902,486828,0.9683687068605414,2,4,61265,2311,58954,0.9622786256426997,26.12632177777778,3556.940384,12.620037746016699,131,2.0E-5
2,test_20231101_135607,1254659.png,342646,63482,279164,0.8147300712688897,3,4,80080,8932,71148,0.8884615384615384,22.097859555555555,3563.7523413333333,12.611728452251572,131,2.0E-5
3,test_20231101_135607,10188041.png,221231,8142,213089,0.9631968395026014,3,4,41731,1155,40576,0.9723227336991684,11.613923555555555,1328.2626453333332,16.897964016937422,131,2.0E-5
4,test_20231101_135607,10287332.png,216980,11107,205873,0.9488109503180017,2,4,22337,1526,20811,0.9316828580382326,9.696193777777777,868.9342453333334,18.740934474449688,131,2.0E-5
5,test_20231101_135607,11610969.png,368720,20412,348308,0.9446409199392493,2,4,84111,2992,81119,0.9644279582932078,23.11974222222222,3369.6077386666666,12.855010139573743,131,2.0E-5
6,test_20231101_135607,10350842.png,212614,4777,207837,0.9775320533925329,2,3,42529,701,41828,0.983517129488114,19.68519288888889,2463.000773333333,14.216158126689425,131,2.0E-5
7,test_20231101_135607,10863862.png,317432,7117,310315,0.9775794500869478,1,3,66058,1047,65011,0.9841502921674892,35.75787733333333,6533.859029333334,9.979106007075385,131,2.0E-5
8,test_20231101_135607,11382381.png,312486,827,311659,0.9973534814359684,2,3,46745,113,46632,0.9975826291581987,20.486714666666668,2360.4332106666666,14.400886444502593,131,2.0E-5
9,test_20231101_135607,11079715.png,443815,104602,339213,0.7643117064542658,4,4,124136,14684,109452,0.8817103821615003,17.949937777777777,2382.459072,14.360549121901718,131,2.0E-5
10,test_20231101_135607,11551286.png,271883,657,271226,0.9975835193814987,1,4,40092,95,39997,0.9976304499650803,17.313984,1772.7602773333333,15.64430349051646,131,2.0E-5
1,test_20231101_135607,10404007.png,502730,15902,486828,0.9683687068605414,2,4,61265,2311,58954,0.9622786256426997,26.12632177777778,3556.940384,12.620037746016699,131,3.0000000000000004E-5
2,test_20231101_135607,1254659.png,342646,63482,279164,0.8147300712688897,3,4,80080,8932,71148,0.8884615384615384,22.097859555555555,3563.7523413333333,12.611728452251572,131,3.0000000000000004E-5
3,test_20231101_135607,10188041.png,221231,8142,213089,0.9631968395026014,2,3,41731,1155,40576,0.9723227336991684,11.613923555555555,1328.2626453333332,16.897964016937422,131,3.0000000000000004E-5
4,test_20231101_135607,10287332.png,216980,11107,205873,0.9488109503180017,1,3,22337,1526,20811,0.9316828580382326,9.696193777777777,868.9342453333334,18.740934474449688,131,3.0000000000000004E-5
5,test_20231101_135607,11610969.png,368720,20412,348308,0.9446409199392493,3,4,84111,2992,81119,0.9644279582932078,23.11974222222222,3369.6077386666666,12.855010139573743,131,3.0000000000000004E-5
6,test_20231101_135607,10350842.png,212614,4777,207837,0.9775320533925329,2,3,42529,701,41828,0.983517129488114,19.68519288888889,2463.000773333333,14.216158126689425,131,3.0000000000000004E-5
7,test_20231101_135607,10863862.png,317432,7117,310315,0.9775794500869478,2,4,66058,1047,65011,0.9841502921674892,35.75787733333333,6533.859029333334,9.979106007075385,131,3.0000000000000004E-5
8,test_20231101_135607,11382381.png,312486,827,311659,0.9973534814359684,2,4,46745,113,46632,0.9975826291581987,20.486714666666668,2360.4332106666666,14.400886444502593,131,3.0000000000000004E-5
9,test_20231101_135607,11079715.png,443815,104602,339213,0.7643117064542658,3,11,124136,14684,109452,0.8817103821615003,17.949937777777777,2382.459072,14.360549121901718,131,3.0000000000000004E-5
10,test_20231101_135607,11551286.png,271883,657,271226,0.9975835193814987,1,4,40092,95,39997,0.9976304499650803,17.313984,1772.7602773333333,15.64430349051646,131,3.0000000000000004E-5
1,test_20231101_135608,10404007.png,502730,15902,486828,0.9683687068605414,2,3,61265,2311,58954,0.9622786256426997,26.12632177777778,3556.940384,12.620037746016699,131,4.0E-5
2,test_20231101_135608,1254659.png,342646,63482,279164,0.8147300712688897,3,4,80080,8932,71148,0.8884615384615384,22.097859555555555,3563.7523413333333,12.611728452251572,131,4.0E-5
3,test_20231101_135608,10188041.png,221231,8142,213089,0.9631968395026014,2,4,41731,1155,40576,0.9723227336991684,11.613923555555555,1328.2626453333332,16.897964016937422,131,4.0E-5
4,test_20231101_135608,10287332.png,216980,11107,205873,0.9488109503180017,2,3,22337,1526,20811,0.9316828580382326,9.696193777777777,868.9342453333334,18.740934474449688,131,4.0E-5
5,test_20231101_135608,11610969.png,368720,20412,348308,0.9446409199392493,2,4,84111,2992,81119,0.9644279582932078,23.11974222222222,3369.6077386666666,12.855010139573743,131,4.0E-5
6,test_20231101_135608,10350842.png,212614,4777,207837,0.9775320533925329,2,3,42529,701,41828,0.983517129488114,19.68519288888889,2463.000773333333,14.216158126689425,131,4.0E-5
7,test_20231101_135608,10863862.png,317432,7117,310315,0.9775794500869478,2,4,66058,1047,65011,0.9841502921674892,35.75787733333333,6533.859029333334,9.979106007075385,131,4.0E-5
8,test_20231101_135608,11382381.png,312486,817,311669,0.9973854828696326,1,3,46745,112,46633,0.9976040218205156,21.216531555555555,2458.9940213333334,14.223228880483061,131,4.0E-5
9,test_20231101_135608,11079715.png,443815,104602,339213,0.7643117064542658,4,4,124136,14684,109452,0.8817103821615003,17.949937777777777,2382.459072,14.360549121901718,131,4.0E-5
10,test_20231101_135608,11551286.png,271883,657,271226,0.9975835193814987,2,3,40092,95,39997,0.9976304499650803,17.313984,1772.7602773333333,15.64430349051646,131,4.0E-5
1,test_20231101_135609,10404007.png,502730,15902,486828,0.9683687068605414,2,3,61265,2311,58954,0.9622786256426997,26.12632177777778,3556.940384,12.620037746016699,131,5.0E-5
2,test_20231101_135609,1254659.png,342646,63482,279164,0.8147300712688897,3,4,80080,8932,71148,0.8884615384615384,22.097859555555555,3563.7523413333333,12.611728452251572,131,5.0E-5
3,test_20231101_135609,10188041.png,221231,8142,213089,0.9631968395026014,2,4,41731,1155,40576,0.9723227336991684,11.613923555555555,1328.2626453333332,16.897964016937422,131,5.0E-5
4,test_20231101_135609,10287332.png,216980,11107,205873,0.9488109503180017,2,3,22337,1526,20811,0.9316828580382326,9.696193777777777,868.9342453333334,18.740934474449688,131,5.0E-5
5,test_20231101_135609,11610969.png,368720,20412,348308,0.9446409199392493,2,4,84111,2992,81119,0.9644279582932078,23.11974222222222,3369.6077386666666,12.855010139573743,131,5.0E-5
6,test_20231101_135609,10350842.png,212614,4777,207837,0.9775320533925329,1,4,42529,701,41828,0.983517129488114,19.68519288888889,2463.000773333333,14.216158126689425,131,5.0E-5
7,test_20231101_135609,10863862.png,317432,7117,310315,0.9775794500869478,2,3,66058,1047,65011,0.9841502921674892,35.75787733333333,6533.859029333334,9.979106007075385,131,5.0E-5
8,test_20231101_135609,11382381.png,312486,817,311669,0.9973854828696326,2,4,46745,112,46633,0.9976040218205156,21.216531555555555,2458.9940213333334,14.223228880483061,131,5.0E-5
9,test_20231101_135609,11079715.png,443815,104602,339213,0.7643117064542658,3,4,124136,14684,109452,0.8817103821615003,17.949937777777777,2382.459072,14.360549121901718,131,5.0E-5
10,test_20231101_135609,11551286.png,271883,657,271226,0.9975835193814987,1,3,40092,95,39997,0.9976304499650803,17.313984,1772.7602773333333,15.64430349051646,131,5.0E-5
1,test_20231101_135609,10404007.png,502730,15902,486828,0.9683687068605414,2,3,61265,2311,58954,0.9622786256426997,26.12632177777778,3556.940384,12.620037746016699,131,6.0E-5
2,test_20231101_135609,1254659.png,342646,63482,279164,0.8147300712688897,2,3,80080,8932,71148,0.8884615384615384,22.097859555555555,3563.7523413333333,12.611728452251572,131,6.0E-5
3,test_20231101_135609,10188041.png,221231,8142,213089,0.9631968395026014,2,3,41731,1155,40576,0.9723227336991684,11.613923555555555,1328.2626453333332,16.897964016937422,131,6.0E-5
4,test_20231101_135609,10287332.png,216980,11107,205873,0.9488109503180017,2,3,22337,1526,20811,0.9316828580382326,9.696193777777777,868.9342453333334,18.740934474449688,131,6.0E-5
5,test_20231101_135609,11610969.png,368720,20412,348308,0.9446409199392493,2,3,84111,2992,81119,0.9644279582932078,23.11974222222222,3369.6077386666666,12.855010139573743,131,6.0E-5
6,test_20231101_135609,10350842.png,212614,4777,207837,0.9775320533925329,1,3,42529,701,41828,0.983517129488114,19.68519288888889,2463.000773333333,14.216158126689425,131,6.0E-5
7,test_20231101_135609,10863862.png,317432,7117,310315,0.9775794500869478,1,3,66058,1047,65011,0.9841502921674892,35.75787733333333,6533.859029333334,9.979106007075385,131,6.0E-5
8,test_20231101_135609,11382381.png,312486,817,311669,0.9973854828696326,1,3,46745,112,46633,0.9976040218205156,21.216531555555555,2458.9940213333334,14.223228880483061,131,6.0E-5
9,test_20231101_135609,11079715.png,443815,104602,339213,0.7643117064542658,3,4,124136,14684,109452,0.8817103821615003,17.949937777777777,2382.459072,14.360549121901718,131,6.0E-5
10,test_20231101_135609,11551286.png,271883,657,271226,0.9975835193814987,2,4,40092,95,39997,0.9976304499650803,17.313984,1772.7602773333333,15.64430349051646,131,6.0E-5
1,test_20231101_135610,10404007.png,502730,15702,487028,0.9687665347204265,2,13,61265,2282,58983,0.9627519791071575,26.210798222222223,3575.592384,12.597323573071064,131,7.000000000000001E-5
2,test_20231101_135610,1254659.png,342646,63482,279164,0.8147300712688897,3,4,80080,8932,71148,0.8884615384615384,22.097859555555555,3563.7523413333333,12.611728452251572,131,7.000000000000001E-5
3,test_20231101_135610,10188041.png,221231,8142,213089,0.9631968395026014,2,3,41731,1155,40576,0.9723227336991684,11.613923555555555,1328.2626453333332,16.897964016937422,131,7.000000000000001E-5
4,test_20231101_135610,10287332.png,216980,11107,205873,0.9488109503180017,1,3,22337,1526,20811,0.9316828580382326,9.696193777777777,868.9342453333334,18.740934474449688,131,7.000000000000001E-5
5,test_20231101_135610,11610969.png,368720,20412,348308,0.9446409199392493,3,4,84111,2992,81119,0.9644279582932078,23.11974222222222,3369.6077386666666,12.855010139573743,131,7.000000000000001E-5
6,test_20231101_135610,10350842.png,212614,4777,207837,0.9775320533925329,2,4,42529,701,41828,0.983517129488114,19.68519288888889,2463.000773333333,14.216158126689425,131,7.000000000000001E-5
7,test_20231101_135610,10863862.png,317432,7117,310315,0.9775794500869478,2,4,66058,1047,65011,0.9841502921674892,35.75787733333333,6533.859029333334,9.979106007075385,131,7.000000000000001E-5
8,test_20231101_135610,11382381.png,312486,817,311669,0.9973854828696326,2,4,46745,112,46633,0.9976040218205156,21.216531555555555,2458.9940213333334,14.223228880483061,131,7.000000000000001E-5
9,test_20231101_135610,11079715.png,443815,104602,339213,0.7643117064542658,3,4,124136,14684,109452,0.8817103821615003,17.949937777777777,2382.459072,14.360549121901718,131,7.000000000000001E-5
10,test_20231101_135610,11551286.png,271883,537,271346,0.9980248857045126,2,3,40092,77,40015,0.9980794173401177,17.40031822222222,1778.8722506666666,15.629356004302238,131,7.000000000000001E-5
1,test_20231101_135611,10404007.png,502730,15702,487028,0.9687665347204265,2,4,61265,2282,58983,0.9627519791071575,26.210798222222223,3575.592384,12.597323573071064,131,8.0E-5
2,test_20231101_135611,1254659.png,342646,63482,279164,0.8147300712688897,3,3,80080,8932,71148,0.8884615384615384,22.097859555555555,3563.7523413333333,12.611728452251572,131,8.0E-5
3,test_20231101_135611,10188041.png,221231,8142,213089,0.9631968395026014,2,4,41731,1155,40576,0.9723227336991684,11.613923555555555,1328.2626453333332,16.897964016937422,131,8.0E-5
4,test_20231101_135611,10287332.png,216980,11107,205873,0.9488109503180017,1,4,22337,1526,20811,0.9316828580382326,9.696193777777777,868.9342453333334,18.740934474449688,131,8.0E-5
5,test_20231101_135611,11610969.png,368720,20412,348308,0.9446409199392493,3,3,84111,2992,81119,0.9644279582932078,23.11974222222222,3369.6077386666666,12.855010139573743,131,8.0E-5
6,test_20231101_135611,10350842.png,212614,4777,207837,0.9775320533925329,1,3,42529,701,41828,0.983517129488114,19.68519288888889,2463.000773333333,14.216158126689425,131,8.0E-5
7,test_20231101_135611,10863862.png,317432,7117,310315,0.9775794500869478,1,3,66058,1047,65011,0.9841502921674892,35.75787733333333,6533.859029333334,9.979106007075385,131,8.0E-5
8,test_20231101_135611,11382381.png,312486,817,311669,0.9973854828696326,2,4,46745,112,46633,0.9976040218205156,21.216531555555555,2458.9940213333334,14.223228880483061,131,8.0E-5
9,test_20231101_135611,11079715.png,443815,104602,339213,0.7643117064542658,6,5,124136,14684,109452,0.8817103821615003,17.949937777777777,2382.459072,14.360549121901718,131,8.0E-5
10,test_20231101_135611,11551286.png,271883,537,271346,0.9980248857045126,1,3,40092,77,40015,0.9980794173401177,17.40031822222222,1778.8722506666666,15.629356004302238,131,8.0E-5
1,test_20231101_135611,10404007.png,502730,15702,487028,0.9687665347204265,2,4,61265,2282,58983,0.9627519791071575,26.210798222222223,3575.592384,12.597323573071064,131,9.0E-5
2,test_20231101_135611,1254659.png,342646,63482,279164,0.8147300712688897,3,4,80080,8932,71148,0.8884615384615384,22.097859555555555,3563.7523413333333,12.611728452251572,131,9.0E-5
3,test_20231101_135611,10188041.png,221231,8142,213089,0.9631968395026014,2,3,41731,1155,40576,0.9723227336991684,11.613923555555555,1328.2626453333332,16.897964016937422,131,9.0E-5
4,test_20231101_135611,10287332.png,216980,11107,205873,0.9488109503180017,2,4,22337,1526,20811,0.9316828580382326,9.696193777777777,868.9342453333334,18.740934474449688,131,9.0E-5
5,test_20231101_135611,11610969.png,368720,20412,348308,0.9446409199392493,2,4,84111,2992,81119,0.9644279582932078,23.11974222222222,3369.6077386666666,12.855010139573743,131,9.0E-5
6,test_20231101_135611,10350842.png,212614,4777,207837,0.9775320533925329,2,4,42529,701,41828,0.983517129488114,19.68519288888889,2463.000773333333,14.216158126689425,131,9.0E-5
7,test_20231101_135611,10863862.png,317432,7117,310315,0.9775794500869478,2,4,66058,1047,65011,0.9841502921674892,35.75787733333333,6533.859029333334,9.979106007075385,131,9.0E-5
8,test_20231101_135611,11382381.png,312486,817,311669,0.9973854828696326,2,4,46745,112,46633,0.9976040218205156,21.216531555555555,2458.9940213333334,14.223228880483061,131,9.0E-5
9,test_20231101_135611,11079715.png,443815,104602,339213,0.7643117064542658,5,4,124136,14684,109452,0.8817103821615003,17.949937777777777,2382.459072,14.360549121901718,131,9.0E-5
10,test_20231101_135611,11551286.png,271883,537,271346,0.9980248857045126,2,4,40092,77,40015,0.9980794173401177,17.40031822222222,1778.8722506666666,15.629356004302238,131,9.0E-5
1,test_20231101_135612,10404007.png,502730,15702,487028,0.9687665347204265,2,4,61265,2282,58983,0.9627519791071575,26.210798222222223,3575.592384,12.597323573071064,131,1.0E-4
2,test_20231101_135612,1254659.png,342646,63482,279164,0.8147300712688897,3,4,80080,8932,71148,0.8884615384615384,22.097859555555555,3563.7523413333333,12.611728452251572,131,1.0E-4
3,test_20231101_135612,10188041.png,221231,8142,213089,0.9631968395026014,2,3,41731,1155,40576,0.9723227336991684,11.613923555555555,1328.2626453333332,16.897964016937422,131,1.0E-4
4,test_20231101_135612,10287332.png,216980,11107,205873,0.9488109503180017,2,3,22337,1526,20811,0.9316828580382326,9.696193777777777,868.9342453333334,18.740934474449688,131,1.0E-4
5,test_20231101_135612,11610969.png,368720,20412,348308,0.9446409199392493,2,3,84111,2992,81119,0.9644279582932078,23.11974222222222,3369.6077386666666,12.855010139573743,131,1.0E-4
6,test_20231101_135612,10350842.png,212614,4777,207837,0.9775320533925329,2,3,42529,701,41828,0.983517129488114,19.68519288888889,2463.000773333333,14.216158126689425,131,1.0E-4
7,test_20231101_135612,10863862.png,317432,7117,310315,0.9775794500869478,2,4,66058,1047,65011,0.9841502921674892,35.75787733333333,6533.859029333334,9.979106007075385,131,1.0E-4
8,test_20231101_135612,11382381.png,312486,817,311669,0.9973854828696326,2,3,46745,112,46633,0.9976040218205156,21.216531555555555,2458.9940213333334,14.223228880483061,131,1.0E-4
9,test_20231101_135612,11079715.png,443815,104602,339213,0.7643117064542658,3,4,124136,14684,109452,0.8817103821615003,17.949937777777777,2382.459072,14.360549121901718,131,1.0E-4
10,test_20231101_135612,11551286.png,271883,537,271346,0.9980248857045126,1,3,40092,77,40015,0.9980794173401177,17.40031822222222,1778.8722506666666,15.629356004302238,131,1.0E-4
1,test_20231101_135613,10404007.png,502730,15702,487028,0.9687665347204265,3,9,61265,2282,58983,0.9627519791071575,26.210798222222223,3575.592384,12.597323573071064,131,1.1E-4
2,test_20231101_135613,1254659.png,342646,63482,279164,0.8147300712688897,2,3,80080,8932,71148,0.8884615384615384,22.097859555555555,3563.7523413333333,12.611728452251572,131,1.1E-4
3,test_20231101_135613,10188041.png,221231,8142,213089,0.9631968395026014,2,3,41731,1155,40576,0.9723227336991684,11.613923555555555,1328.2626453333332,16.897964016937422,131,1.1E-4
4,test_20231101_135613,10287332.png,216980,11107,205873,0.9488109503180017,2,5,22337,1526,20811,0.9316828580382326,9.696193777777777,868.9342453333334,18.740934474449688,131,1.1E-4
5,test_20231101_135613,11610969.png,368720,20412,348308,0.9446409199392493,2,4,84111,2992,81119,0.9644279582932078,23.11974222222222,3369.6077386666666,12.855010139573743,131,1.1E-4
6,test_20231101_135613,10350842.png,212614,4777,207837,0.9775320533925329,1,3,42529,701,41828,0.983517129488114,19.68519288888889,2463.000773333333,14.216158126689425,131,1.1E-4
7,test_20231101_135613,10863862.png,317432,7117,310315,0.9775794500869478,1,3,66058,1047,65011,0.9841502921674892,35.75787733333333,6533.859029333334,9.979106007075385,131,1.1E-4
8,test_20231101_135613,11382381.png,312486,817,311669,0.9973854828696326,1,3,46745,112,46633,0.9976040218205156,21.216531555555555,2458.9940213333334,14.223228880483061,131,1.1E-4
9,test_20231101_135613,11079715.png,443815,104602,339213,0.7643117064542658,3,4,124136,14684,109452,0.8817103821615003,17.949937777777777,2382.459072,14.360549121901718,131,1.1E-4
10,test_20231101_135613,11551286.png,271883,537,271346,0.9980248857045126,1,4,40092,77,40015,0.9980794173401177,17.40031822222222,1778.8722506666666,15.629356004302238,131,1.1E-4
1,test_20231101_135614,10404007.png,502730,15702,487028,0.9687665347204265,2,3,61265,2282,58983,0.9627519791071575,26.210798222222223,3575.592384,12.597323573071064,131,1.2E-4
2,test_20231101_135614,1254659.png,342646,63482,279164,0.8147300712688897,3,4,80080,8932,71148,0.8884615384615384,22.097859555555555,3563.7523413333333,12.611728452251572,131,1.2E-4
3,test_20231101_135614,10188041.png,221231,8142,213089,0.9631968395026014,1,3,41731,1155,40576,0.9723227336991684,11.613923555555555,1328.2626453333332,16.897964016937422,131,1.2E-4
4,test_20231101_135614,10287332.png,216980,11107,205873,0.9488109503180017,2,3,22337,1526,20811,0.9316828580382326,9.696193777777777,868.9342453333334,18.740934474449688,131,1.2E-4
5,test_20231101_135614,11610969.png,368720,20412,348308,0.9446409199392493,2,4,84111,2992,81119,0.9644279582932078,23.11974222222222,3369.6077386666666,12.855010139573743,131,1.2E-4
6,test_20231101_135614,10350842.png,212614,4777,207837,0.9775320533925329,2,8,42529,701,41828,0.983517129488114,19.68519288888889,2463.000773333333,14.216158126689425,131,1.2E-4
7,test_20231101_135614,10863862.png,317432,7117,310315,0.9775794500869478,2,3,66058,1047,65011,0.9841502921674892,35.75787733333333,6533.859029333334,9.979106007075385,131,1.2E-4
8,test_20231101_135614,11382381.png,312486,817,311669,0.9973854828696326,2,3,46745,112,46633,0.9976040218205156,21.216531555555555,2458.9940213333334,14.223228880483061,131,1.2E-4
9,test_20231101_135614,11079715.png,443815,104602,339213,0.7643117064542658,3,5,124136,14684,109452,0.8817103821615003,17.949937777777777,2382.459072,14.360549121901718,131,1.2E-4
10,test_20231101_135614,11551286.png,271883,537,271346,0.9980248857045126,1,4,40092,77,40015,0.9980794173401177,17.40031822222222,1778.8722506666666,15.629356004302238,131,1.2E-4
1,test_20231101_135614,10404007.png,502730,15702,487028,0.9687665347204265,2,4,61265,2282,58983,0.9627519791071575,26.210798222222223,3575.592384,12.597323573071064,131,1.3000000000000002E-4
2,test_20231101_135614,1254659.png,342646,63482,279164,0.8147300712688897,2,4,80080,8932,71148,0.8884615384615384,22.097859555555555,3563.7523413333333,12.611728452251572,131,1.3000000000000002E-4
3,test_20231101_135614,10188041.png,221231,8142,213089,0.9631968395026014,2,3,41731,1155,40576,0.9723227336991684,11.613923555555555,1328.2626453333332,16.897964016937422,131,1.3000000000000002E-4
4,test_20231101_135614,10287332.png,216980,11107,205873,0.9488109503180017,2,3,22337,1526,20811,0.9316828580382326,9.696193777777777,868.9342453333334,18.740934474449688,131,1.3000000000000002E-4
5,test_20231101_135614,11610969.png,368720,20412,348308,0.9446409199392493,2,4,84111,2992,81119,0.9644279582932078,23.11974222222222,3369.6077386666666,12.855010139573743,131,1.3000000000000002E-4
6,test_20231101_135614,10350842.png,212614,4777,207837,0.9775320533925329,2,3,42529,701,41828,0.983517129488114,19.68519288888889,2463.000773333333,14.216158126689425,131,1.3000000000000002E-4
7,test_20231101_135614,10863862.png,317432,7117,310315,0.9775794500869478,2,4,66058,1047,65011,0.9841502921674892,35.75787733333333,6533.859029333334,9.979106007075385,131,1.3000000000000002E-4
8,test_20231101_135614,11382381.png,312486,817,311669,0.9973854828696326,2,4,46745,112,46633,0.9976040218205156,21.216531555555555,2458.9940213333334,14.223228880483061,131,1.3000000000000002E-4
9,test_20231101_135614,11079715.png,443815,104602,339213,0.7643117064542658,3,4,124136,14684,109452,0.8817103821615003,17.949937777777777,2382.459072,14.360549121901718,131,1.3000000000000002E-4
10,test_20231101_135614,11551286.png,271883,517,271366,0.9980984467583482,2,4,40092,74,40018,0.9981542452359573,17.640316444444444,1823.8651306666666,15.520876404571137,131,1.3000000000000002E-4
1,test_20231101_135615,10404007.png,502730,15702,487028,0.9687665347204265,2,3,61265,2282,58983,0.9627519791071575,26.210798222222223,3575.592384,12.597323573071064,131,1.4000000000000001E-4
2,test_20231101_135615,1254659.png,342646,63482,279164,0.8147300712688897,3,4,80080,8932,71148,0.8884615384615384,22.097859555555555,3563.7523413333333,12.611728452251572,131,1.4000000000000001E-4
3,test_20231101_135615,10188041.png,221231,8142,213089,0.9631968395026014,1,3,41731,1155,40576,0.9723227336991684,11.613923555555555,1328.2626453333332,16.897964016937422,131,1.4000000000000001E-4
4,test_20231101_135615,10287332.png,216980,11107,205873,0.9488109503180017,2,4,22337,1526,20811,0.9316828580382326,9.696193777777777,868.9342453333334,18.740934474449688,131,1.4000000000000001E-4
5,test_20231101_135615,11610969.png,368720,20412,348308,0.9446409199392493,2,8,84111,2992,81119,0.9644279582932078,23.11974222222222,3369.6077386666666,12.855010139573743,131,1.4000000000000001E-4
6,test_20231101_135615,10350842.png,212614,4777,207837,0.9775320533925329,2,3,42529,701,41828,0.983517129488114,19.68519288888889,2463.000773333333,14.216158126689425,131,1.4000000000000001E-4
7,test_20231101_135615,10863862.png,317432,7117,310315,0.9775794500869478,2,4,66058,1047,65011,0.9841502921674892,35.75787733333333,6533.859029333334,9.979106007075385,131,1.4000000000000001E-4
8,test_20231101_135615,11382381.png,312486,817,311669,0.9973854828696326,2,4,46745,112,46633,0.9976040218205156,21.216531555555555,2458.9940213333334,14.223228880483061,131,1.4000000000000001E-4
9,test_20231101_135615,11079715.png,443815,104602,339213,0.7643117064542658,3,4,124136,14684,109452,0.8817103821615003,17.949937777777777,2382.459072,14.360549121901718,131,1.4000000000000001E-4
10,test_20231101_135615,11551286.png,271883,517,271366,0.9980984467583482,1,3,40092,74,40018,0.9981542452359573,17.640316444444444,1823.8651306666666,15.520876404571137,131,1.4000000000000001E-4
1,test_20231101_135616,10404007.png,502730,15702,487028,0.9687665347204265,3,3,61265,2282,58983,0.9627519791071575,26.210798222222223,3575.592384,12.597323573071064,131,1.5000000000000001E-4
2,test_20231101_135616,1254659.png,342646,63482,279164,0.8147300712688897,3,9,80080,8932,71148,0.8884615384615384,22.097859555555555,3563.7523413333333,12.611728452251572,131,1.5000000000000001E-4
3,test_20231101_135616,10188041.png,221231,8142,213089,0.9631968395026014,1,3,41731,1155,40576,0.9723227336991684,11.613923555555555,1328.2626453333332,16.897964016937422,131,1.5000000000000001E-4
4,test_20231101_135616,10287332.png,216980,11107,205873,0.9488109503180017,1,3,22337,1526,20811,0.9316828580382326,9.696193777777777,868.9342453333334,18.740934474449688,131,1.5000000000000001E-4
5,test_20231101_135616,11610969.png,368720,20412,348308,0.9446409199392493,2,4,84111,2992,81119,0.9644279582932078,23.11974222222222,3369.6077386666666,12.855010139573743,131,1.5000000000000001E-4
6,test_20231101_135616,10350842.png,212614,4777,207837,0.9775320533925329,1,4,42529,701,41828,0.983517129488114,19.68519288888889,2463.000773333333,14.216158126689425,131,1.5000000000000001E-4
7,test_20231101_135616,10863862.png,317432,7117,310315,0.9775794500869478,1,3,66058,1047,65011,0.9841502921674892,35.75787733333333,6533.859029333334,9.979106007075385,131,1.5000000000000001E-4
8,test_20231101_135616,11382381.png,312486,707,311779,0.9977374986399391,1,3,46745,96,46649,0.9979463044175848,21.47300977777778,2499.126186666667,14.152921756540431,131,1.5000000000000001E-4
9,test_20231101_135616,11079715.png,443815,104602,339213,0.7643117064542658,4,5,124136,14684,109452,0.8817103821615003,17.949937777777777,2382.459072,14.360549121901718,131,1.5000000000000001E-4
10,test_20231101_135616,11551286.png,271883,517,271366,0.9980984467583482,2,3,40092,74,40018,0.9981542452359573,17.640316444444444,1823.8651306666666,15.520876404571137,131,1.5000000000000001E-4
1,test_20231101_135616,10404007.png,502730,15702,487028,0.9687665347204265,2,3,61265,2282,58983,0.9627519791071575,26.210798222222223,3575.592384,12.597323573071064,131,1.6E-4
2,test_20231101_135616,1254659.png,342646,63482,279164,0.8147300712688897,3,4,80080,8932,71148,0.8884615384615384,22.097859555555555,3563.7523413333333,12.611728452251572,131,1.6E-4
3,test_20231101_135616,10188041.png,221231,8142,213089,0.9631968395026014,2,4,41731,1155,40576,0.9723227336991684,11.613923555555555,1328.2626453333332,16.897964016937422,131,1.6E-4
4,test_20231101_135616,10287332.png,216980,10917,206063,0.9496866070605585,1,4,22337,1502,20835,0.9327573085015893,9.824568888888889,895.248896,18.611365667454372,131,1.6E-4
5,test_20231101_135616,11610969.png,368720,20412,348308,0.9446409199392493,3,4,84111,2992,81119,0.9644279582932078,23.11974222222222,3369.6077386666666,12.855010139573743,131,1.6E-4
6,test_20231101_135616,10350842.png,212614,4777,207837,0.9775320533925329,1,3,42529,701,41828,0.983517129488114,19.68519288888889,2463.000773333333,14.216158126689425,131,1.6E-4
7,test_20231101_135616,10863862.png,317432,7117,310315,0.9775794500869478,2,4,66058,1047,65011,0.9841502921674892,35.75787733333333,6533.859029333334,9.979106007075385,131,1.6E-4
8,test_20231101_135616,11382381.png,312486,707,311779,0.9977374986399391,1,3,46745,96,46649,0.9979463044175848,21.47300977777778,2499.126186666667,14.152921756540431,131,1.6E-4
9,test_20231101_135616,11079715.png,443815,104602,339213,0.7643117064542658,3,5,124136,14684,109452,0.8817103821615003,17.949937777777777,2382.459072,14.360549121901718,131,1.6E-4
10,test_20231101_135616,11551286.png,271883,517,271366,0.9980984467583482,1,4,40092,74,40018,0.9981542452359573,17.640316444444444,1823.8651306666666,15.520876404571137,131,1.6E-4
1,test_20231101_135617,10404007.png,502730,15702,487028,0.9687665347204265,2,4,61265,2282,58983,0.9627519791071575,26.210798222222223,3575.592384,12.597323573071064,131,1.7E-4
2,test_20231101_135617,1254659.png,342646,63482,279164,0.8147300712688897,3,4,80080,8932,71148,0.8884615384615384,22.097859555555555,3563.7523413333333,12.611728452251572,131,1.7E-4
3,test_20231101_135617,10188041.png,221231,8142,213089,0.9631968395026014,2,4,41731,1155,40576,0.9723227336991684,11.613923555555555,1328.2626453333332,16.897964016937422,131,1.7E-4
4,test_20231101_135617,10287332.png,216980,10917,206063,0.9496866070605585,1,4,22337,1502,20835,0.9327573085015893,9.824568888888889,895.248896,18.611365667454372,131,1.7E-4
5,test_20231101_135617,11610969.png,368720,20412,348308,0.9446409199392493,3,4,84111,2992,81119,0.9644279582932078,23.11974222222222,3369.6077386666666,12.855010139573743,131,1.7E-4
6,test_20231101_135617,10350842.png,212614,4777,207837,0.9775320533925329,1,4,42529,701,41828,0.983517129488114,19.68519288888889,2463.000773333333,14.216158126689425,131,1.7E-4
7,test_20231101_135617,10863862.png,317432,7117,310315,0.9775794500869478,2,9,66058,1047,65011,0.9841502921674892,35.75787733333333,6533.859029333334,9.979106007075385,131,1.7E-4
8,test_20231101_135617,11382381.png,312486,707,311779,0.9977374986399391,1,4,46745,96,46649,0.9979463044175848,21.47300977777778,2499.126186666667,14.152921756540431,131,1.7E-4
9,test_20231101_135617,11079715.png,443815,104602,339213,0.7643117064542658,4,4,124136,14684,109452,0.8817103821615003,17.949937777777777,2382.459072,14.360549121901718,131,1.7E-4
10,test_20231101_135617,11551286.png,271883,517,271366,0.9980984467583482,1,4,40092,74,40018,0.9981542452359573,17.640316444444444,1823.8651306666666,15.520876404571137,131,1.7E-4
1,test_20231101_135618,10404007.png,502730,15702,487028,0.9687665347204265,2,4,61265,2282,58983,0.9627519791071575,26.210798222222223,3575.592384,12.597323573071064,131,1.8E-4
2,test_20231101_135618,1254659.png,342646,63482,279164,0.8147300712688897,3,4,80080,8932,71148,0.8884615384615384,22.097859555555555,3563.7523413333333,12.611728452251572,131,1.8E-4
3,test_20231101_135618,10188041.png,221231,8142,213089,0.9631968395026014,2,3,41731,1155,40576,0.9723227336991684,11.613923555555555,1328.2626453333332,16.897964016937422,131,1.8E-4
4,test_20231101_135618,10287332.png,216980,10917,206063,0.9496866070605585,1,3,22337,1502,20835,0.9327573085015893,9.824568888888889,895.248896,18.611365667454372,131,1.8E-4
5,test_20231101_135618,11610969.png,368720,20412,348308,0.9446409199392493,2,4,84111,2992,81119,0.9644279582932078,23.11974222222222,3369.6077386666666,12.855010139573743,131,1.8E-4
6,test_20231101_135618,10350842.png,212614,4777,207837,0.9775320533925329,2,3,42529,701,41828,0.983517129488114,19.68519288888889,2463.000773333333,14.216158126689425,131,1.8E-4
7,test_20231101_135618,10863862.png,317432,7117,310315,0.9775794500869478,2,4,66058,1047,65011,0.9841502921674892,35.75787733333333,6533.859029333334,9.979106007075385,131,1.8E-4
8,test_20231101_135618,11382381.png,312486,707,311779,0.9977374986399391,2,4,46745,96,46649,0.9979463044175848,21.47300977777778,2499.126186666667,14.152921756540431,131,1.8E-4
9,test_20231101_135618,11079715.png,443815,104602,339213,0.7643117064542658,3,4,124136,14684,109452,0.8817103821615003,17.949937777777777,2382.459072,14.360549121901718,131,1.8E-4
10,test_20231101_135618,11551286.png,271883,517,271366,0.9980984467583482,2,3,40092,74,40018,0.9981542452359573,17.640316444444444,1823.8651306666666,15.520876404571137,131,1.8E-4
1,test_20231101_135618,10404007.png,502730,15702,487028,0.9687665347204265,2,4,61265,2282,58983,0.9627519791071575,26.210798222222223,3575.592384,12.597323573071064,131,1.9E-4
2,test_20231101_135618,1254659.png,342646,63482,279164,0.8147300712688897,3,4,80080,8932,71148,0.8884615384615384,22.097859555555555,3563.7523413333333,12.611728452251572,131,1.9E-4
3,test_20231101_135618,10188041.png,221231,8142,213089,0.9631968395026014,2,4,41731,1155,40576,0.9723227336991684,11.613923555555555,1328.2626453333332,16.897964016937422,131,1.9E-4
4,test_20231101_135618,10287332.png,216980,10917,206063,0.9496866070605585,2,4,22337,1502,20835,0.9327573085015893,9.824568888888889,895.248896,18.611365667454372,131,1.9E-4
5,test_20231101_135618,11610969.png,368720,20412,348308,0.9446409199392493,2,4,84111,2992,81119,0.9644279582932078,23.11974222222222,3369.6077386666666,12.855010139573743,131,1.9E-4
6,test_20231101_135618,10350842.png,212614,4777,207837,0.9775320533925329,1,4,42529,701,41828,0.983517129488114,19.68519288888889,2463.000773333333,14.216158126689425,131,1.9E-4
7,test_20231101_135618,10863862.png,317432,7117,310315,0.9775794500869478,2,3,66058,1047,65011,0.9841502921674892,35.75787733333333,6533.859029333334,9.979106007075385,131,1.9E-4
8,test_20231101_135618,11382381.png,312486,707,311779,0.9977374986399391,2,4,46745,96,46649,0.9979463044175848,21.47300977777778,2499.126186666667,14.152921756540431,131,1.9E-4
9,test_20231101_135618,11079715.png,443815,104602,339213,0.7643117064542658,3,6,124136,14684,109452,0.8817103821615003,17.949937777777777,2382.459072,14.360549121901718,131,1.9E-4
10,test_20231101_135618,11551286.png,271883,517,271366,0.9980984467583482,1,3,40092,74,40018,0.9981542452359573,17.640316444444444,1823.8651306666666,15.520876404571137,131,1.9E-4
1,test_20231101_135619,10404007.png,502730,15702,487028,0.9687665347204265,2,4,61265,2282,58983,0.9627519791071575,26.210798222222223,3575.592384,12.597323573071064,131,2.0E-4
2,test_20231101_135619,1254659.png,342646,63482,279164,0.8147300712688897,3,14,80080,8932,71148,0.8884615384615384,22.097859555555555,3563.7523413333333,12.611728452251572,131,2.0E-4
3,test_20231101_135619,10188041.png,221231,8142,213089,0.9631968395026014,2,4,41731,1155,40576,0.9723227336991684,11.613923555555555,1328.2626453333332,16.897964016937422,131,2.0E-4
4,test_20231101_135619,10287332.png,216980,10917,206063,0.9496866070605585,2,4,22337,1502,20835,0.9327573085015893,9.824568888888889,895.248896,18.611365667454372,131,2.0E-4
5,test_20231101_135619,11610969.png,368720,20412,348308,0.9446409199392493,2,3,84111,2992,81119,0.9644279582932078,23.11974222222222,3369.6077386666666,12.855010139573743,131,2.0E-4
6,test_20231101_135619,10350842.png,212614,4777,207837,0.9775320533925329,2,4,42529,701,41828,0.983517129488114,19.68519288888889,2463.000773333333,14.216158126689425,131,2.0E-4
7,test_20231101_135619,10863862.png,317432,7117,310315,0.9775794500869478,2,3,66058,1047,65011,0.9841502921674892,35.75787733333333,6533.859029333334,9.979106007075385,131,2.0E-4
8,test_20231101_135619,11382381.png,312486,707,311779,0.9977374986399391,1,4,46745,96,46649,0.9979463044175848,21.47300977777778,2499.126186666667,14.152921756540431,131,2.0E-4
9,test_20231101_135619,11079715.png,443815,104602,339213,0.7643117064542658,4,4,124136,14684,109452,0.8817103821615003,17.949937777777777,2382.459072,14.360549121901718,131,2.0E-4
10,test_20231101_135619,11551286.png,271883,267,271616,0.9990179599312939,2,3,40092,37,40055,0.9990771226179787,17.919265777777778,1867.1754613333333,15.418952296845859,131,2.0E-4
1,test_20231101_135620,10404007.png,502730,15702,487028,0.9687665347204265,2,4,61265,2282,58983,0.9627519791071575,26.210798222222223,3575.592384,12.597323573071064,131,2.1E-4
2,test_20231101_135620,1254659.png,342646,63482,279164,0.8147300712688897,3,4,80080,8932,71148,0.8884615384615384,22.097859555555555,3563.7523413333333,12.611728452251572,131,2.1E-4
3,test_20231101_135620,10188041.png,221231,8142,213089,0.9631968395026014,2,4,41731,1155,40576,0.9723227336991684,11.613923555555555,1328.2626453333332,16.897964016937422,131,2.1E-4
4,test_20231101_135620,10287332.png,216980,10917,206063,0.9496866070605585,2,3,22337,1502,20835,0.9327573085015893,9.824568888888889,895.248896,18.611365667454372,131,2.1E-4
5,test_20231101_135620,11610969.png,368720,20412,348308,0.9446409199392493,2,4,84111,2992,81119,0.9644279582932078,23.11974222222222,3369.6077386666666,12.855010139573743,131,2.1E-4
6,test_20231101_135620,10350842.png,212614,4777,207837,0.9775320533925329,1,3,42529,701,41828,0.983517129488114,19.68519288888889,2463.000773333333,14.216158126689425,131,2.1E-4
7,test_20231101_135620,10863862.png,317432,7117,310315,0.9775794500869478,1,3,66058,1047,65011,0.9841502921674892,35.75787733333333,6533.859029333334,9.979106007075385,131,2.1E-4
8,test_20231101_135620,11382381.png,312486,707,311779,0.9977374986399391,2,4,46745,96,46649,0.9979463044175848,21.47300977777778,2499.126186666667,14.152921756540431,131,2.1E-4
9,test_20231101_135620,11079715.png,443815,104602,339213,0.7643117064542658,3,4,124136,14684,109452,0.8817103821615003,17.949937777777777,2382.459072,14.360549121901718,131,2.1E-4
10,test_20231101_135620,11551286.png,271883,267,271616,0.9990179599312939,1,4,40092,37,40055,0.9990771226179787,17.919265777777778,1867.1754613333333,15.418952296845859,131,2.1E-4
1,test_20231101_135620,10404007.png,502730,15702,487028,0.9687665347204265,3,3,61265,2282,58983,0.9627519791071575,26.210798222222223,3575.592384,12.597323573071064,131,2.2E-4
2,test_20231101_135620,1254659.png,342646,63482,279164,0.8147300712688897,3,4,80080,8932,71148,0.8884615384615384,22.097859555555555,3563.7523413333333,12.611728452251572,131,2.2E-4
3,test_20231101_135620,10188041.png,221231,8142,213089,0.9631968395026014,2,4,41731,1155,40576,0.9723227336991684,11.613923555555555,1328.2626453333332,16.897964016937422,131,2.2E-4
4,test_20231101_135620,10287332.png,216980,10917,206063,0.9496866070605585,2,4,22337,1502,20835,0.9327573085015893,9.824568888888889,895.248896,18.611365667454372,131,2.2E-4
5,test_20231101_135620,11610969.png,368720,20412,348308,0.9446409199392493,2,4,84111,2992,81119,0.9644279582932078,23.11974222222222,3369.6077386666666,12.855010139573743,131,2.2E-4
6,test_20231101_135620,10350842.png,212614,4777,207837,0.9775320533925329,1,3,42529,701,41828,0.983517129488114,19.68519288888889,2463.000773333333,14.216158126689425,131,2.2E-4
7,test_20231101_135620,10863862.png,317432,7117,310315,0.9775794500869478,2,4,66058,1047,65011,0.9841502921674892,35.75787733333333,6533.859029333334,9.979106007075385,131,2.2E-4
8,test_20231101_135620,11382381.png,312486,707,311779,0.9977374986399391,2,4,46745,96,46649,0.9979463044175848,21.47300977777778,2499.126186666667,14.152921756540431,131,2.2E-4
9,test_20231101_135620,11079715.png,443815,104602,339213,0.7643117064542658,4,4,124136,14684,109452,0.8817103821615003,17.949937777777777,2382.459072,14.360549121901718,131,2.2E-4
10,test_20231101_135620,11551286.png,271883,267,271616,0.9990179599312939,1,4,40092,37,40055,0.9990771226179787,17.919265777777778,1867.1754613333333,15.418952296845859,131,2.2E-4
1,test_20231101_135621,10404007.png,502730,15702,487028,0.9687665347204265,2,4,61265,2282,58983,0.9627519791071575,26.210798222222223,3575.592384,12.597323573071064,131,2.3E-4
2,test_20231101_135621,1254659.png,342646,63482,279164,0.8147300712688897,2,3,80080,8932,71148,0.8884615384615384,22.097859555555555,3563.7523413333333,12.611728452251572,131,2.3E-4
3,test_20231101_135621,10188041.png,221231,8142,213089,0.9631968395026014,2,3,41731,1155,40576,0.9723227336991684,11.613923555555555,1328.2626453333332,16.897964016937422,131,2.3E-4
4,test_20231101_135621,10287332.png,216980,10917,206063,0.9496866070605585,2,4,22337,1502,20835,0.9327573085015893,9.824568888888889,895.248896,18.611365667454372,131,2.3E-4
5,test_20231101_135621,11610969.png,368720,20412,348308,0.9446409199392493,2,3,84111,2992,81119,0.9644279582932078,23.11974222222222,3369.6077386666666,12.855010139573743,131,2.3E-4
6,test_20231101_135621,10350842.png,212614,4777,207837,0.9775320533925329,1,13,42529,701,41828,0.983517129488114,19.68519288888889,2463.000773333333,14.216158126689425,131,2.3E-4
7,test_20231101_135621,10863862.png,317432,7117,310315,0.9775794500869478,1,3,66058,1047,65011,0.9841502921674892,35.75787733333333,6533.859029333334,9.979106007075385,131,2.3E-4
8,test_20231101_135621,11382381.png,312486,707,311779,0.9977374986399391,1,3,46745,96,46649,0.9979463044175848,21.47300977777778,2499.126186666667,14.152921756540431,131,2.3E-4
9,test_20231101_135621,11079715.png,443815,104602,339213,0.7643117064542658,3,4,124136,14684,109452,0.8817103821615003,17.949937777777777,2382.459072,14.360549121901718,131,2.3E-4
10,test_20231101_135621,11551286.png,271883,267,271616,0.9990179599312939,2,3,40092,37,40055,0.9990771226179787,17.919265777777778,1867.1754613333333,15.418952296845859,131,2.3E-4
1,test_20231101_135622,10404007.png,502730,15702,487028,0.9687665347204265,4,4,61265,2282,58983,0.9627519791071575,26.210798222222223,3575.592384,12.597323573071064,131,2.4E-4
2,test_20231101_135622,1254659.png,342646,63482,279164,0.8147300712688897,2,3,80080,8932,71148,0.8884615384615384,22.097859555555555,3563.7523413333333,12.611728452251572,131,2.4E-4
3,test_20231101_135622,10188041.png,221231,8142,213089,0.9631968395026014,2,3,41731,1155,40576,0.9723227336991684,11.613923555555555,1328.2626453333332,16.897964016937422,131,2.4E-4
4,test_20231101_135622,10287332.png,216980,10917,206063,0.9496866070605585,1,4,22337,1502,20835,0.9327573085015893,9.824568888888889,895.248896,18.611365667454372,131,2.4E-4
5,test_20231101_135622,11610969.png,368720,20412,348308,0.9446409199392493,3,4,84111,2992,81119,0.9644279582932078,23.11974222222222,3369.6077386666666,12.855010139573743,131,2.4E-4
6,test_20231101_135622,10350842.png,212614,4777,207837,0.9775320533925329,2,3,42529,701,41828,0.983517129488114,19.68519288888889,2463.000773333333,14.216158126689425,131,2.4E-4
7,test_20231101_135622,10863862.png,317432,7117,310315,0.9775794500869478,1,4,66058,1047,65011,0.9841502921674892,35.75787733333333,6533.859029333334,9.979106007075385,131,2.4E-4
8,test_20231101_135622,11382381.png,312486,707,311779,0.9977374986399391,1,3,46745,96,46649,0.9979463044175848,21.47300977777778,2499.126186666667,14.152921756540431,131,2.4E-4
9,test_20231101_135622,11079715.png,443815,104602,339213,0.7643117064542658,4,4,124136,14684,109452,0.8817103821615003,17.949937777777777,2382.459072,14.360549121901718,131,2.4E-4
10,test_20231101_135622,11551286.png,271883,267,271616,0.9990179599312939,1,3,40092,37,40055,0.9990771226179787,17.919265777777778,1867.1754613333333,15.418952296845859,131,2.4E-4
1,test_20231101_135622,10404007.png,502730,15702,487028,0.9687665347204265,2,4,61265,2282,58983,0.9627519791071575,26.210798222222223,3575.592384,12.597323573071064,131,2.5E-4
2,test_20231101_135622,1254659.png,342646,63482,279164,0.8147300712688897,3,4,80080,8932,71148,0.8884615384615384,22.097859555555555,3563.7523413333333,12.611728452251572,131,2.5E-4
3,test_20231101_135622,10188041.png,221231,8142,213089,0.9631968395026014,2,3,41731,1155,40576,0.9723227336991684,11.613923555555555,1328.2626453333332,16.897964016937422,131,2.5E-4
4,test_20231101_135622,10287332.png,216980,10917,206063,0.9496866070605585,2,3,22337,1502,20835,0.9327573085015893,9.824568888888889,895.248896,18.611365667454372,131,2.5E-4
5,test_20231101_135622,11610969.png,368720,20412,348308,0.9446409199392493,3,3,84111,2992,81119,0.9644279582932078,23.11974222222222,3369.6077386666666,12.855010139573743,131,2.5E-4
6,test_20231101_135622,10350842.png,212614,4777,207837,0.9775320533925329,1,4,42529,701,41828,0.983517129488114,19.68519288888889,2463.000773333333,14.216158126689425,131,2.5E-4
7,test_20231101_135622,10863862.png,317432,7117,310315,0.9775794500869478,2,3,66058,1047,65011,0.9841502921674892,35.75787733333333,6533.859029333334,9.979106007075385,131,2.5E-4
8,test_20231101_135622,11382381.png,312486,707,311779,0.9977374986399391,1,4,46745,96,46649,0.9979463044175848,21.47300977777778,2499.126186666667,14.152921756540431,131,2.5E-4
9,test_20231101_135622,11079715.png,443815,104602,339213,0.7643117064542658,3,4,124136,14684,109452,0.8817103821615003,17.949937777777777,2382.459072,14.360549121901718,131,2.5E-4
10,test_20231101_135622,11551286.png,271883,267,271616,0.9990179599312939,1,3,40092,37,40055,0.9990771226179787,17.919265777777778,1867.1754613333333,15.418952296845859,131,2.5E-4
1,test_20231101_135623,10404007.png,502730,15579,487151,0.9690111988542558,2,4,61265,2265,59000,0.9630294621725292,26.215516444444443,3576.6761493333333,12.596007421963613,131,2.6000000000000003E-4
2,test_20231101_135623,1254659.png,342646,63422,279224,0.8149051791061328,3,4,80080,8926,71154,0.8885364635364635,22.107413333333334,3564.834528,12.610409852338439,131,2.6000000000000003E-4
3,test_20231101_135623,10188041.png,221231,8102,213129,0.9633776459899381,2,4,41731,1149,40582,0.972466511705926,11.979751111111112,1380.5433493333333,16.73030312746173,131,2.6000000000000003E-4
4,test_20231101_135623,10287332.png,216980,10917,206063,0.9496866070605585,2,3,22337,1502,20835,0.9327573085015893,9.824568888888889,895.248896,18.611365667454372,131,2.6000000000000003E-4
5,test_20231101_135623,11610969.png,368720,20332,348388,0.9448578867433283,2,4,84111,2981,81130,0.9645587378583063,23.157488,3373.484581333333,12.850016313349945,131,2.6000000000000003E-4
6,test_20231101_135623,10350842.png,212614,4777,207837,0.9775320533925329,2,4,42529,701,41828,0.983517129488114,19.68519288888889,2463.000773333333,14.216158126689425,131,2.6000000000000003E-4
7,test_20231101_135623,10863862.png,317432,7077,310355,0.9777054613271504,2,3,66058,1041,65017,0.9842411214387357,35.76357333333333,6534.928085333333,9.978395481884935,131,2.6000000000000003E-4
8,test_20231101_135623,11382381.png,312486,587,311899,0.9981215158439098,1,4,46745,78,46667,0.9983313723392876,21.967536,2569.068496,14.03304677372966,131,2.6000000000000003E-4
9,test_20231101_135623,11079715.png,443815,104602,339213,0.7643117064542658,3,4,124136,14684,109452,0.8817103821615003,17.949937777777777,2382.459072,14.360549121901718,131,2.6000000000000003E-4
10,test_20231101_135623,11551286.png,271883,164,271719,0.9993967993585476,1,4,40092,22,40070,0.9994512620971765,18.120286222222223,1899.5769013333334,15.344234809036362,131,2.6000000000000003E-4
1,test_20231101_135624,10404007.png,502730,15579,487151,0.9690111988542558,2,3,61265,2265,59000,0.9630294621725292,26.215516444444443,3576.6761493333333,12.596007421963613,131,2.7000000000000006E-4
2,test_20231101_135624,1254659.png,342646,63422,279224,0.8149051791061328,2,4,80080,8926,71154,0.8885364635364635,22.107413333333334,3564.834528,12.610409852338439,131,2.7000000000000006E-4
3,test_20231101_135624,10188041.png,221231,8102,213129,0.9633776459899381,2,8,41731,1149,40582,0.972466511705926,11.979751111111112,1380.5433493333333,16.73030312746173,131,2.7000000000000006E-4
4,test_20231101_135624,10287332.png,216980,10917,206063,0.9496866070605585,1,3,22337,1502,20835,0.9327573085015893,9.824568888888889,895.248896,18.611365667454372,131,2.7000000000000006E-4
5,test_20231101_135624,11610969.png,368720,20332,348388,0.9448578867433283,3,3,84111,2981,81130,0.9645587378583063,23.157488,3373.484581333333,12.850016313349945,131,2.7000000000000006E-4
6,test_20231101_135624,10350842.png,212614,4777,207837,0.9775320533925329,1,4,42529,701,41828,0.983517129488114,19.68519288888889,2463.000773333333,14.216158126689425,131,2.7000000000000006E-4
7,test_20231101_135624,10863862.png,317432,7077,310355,0.9777054613271504,1,4,66058,1041,65017,0.9842411214387357,35.76357333333333,6534.928085333333,9.978395481884935,131,2.7000000000000006E-4
8,test_20231101_135624,11382381.png,312486,587,311899,0.9981215158439098,2,3,46745,78,46667,0.9983313723392876,21.967536,2569.068496,14.03304677372966,131,2.7000000000000006E-4
9,test_20231101_135624,11079715.png,443815,104602,339213,0.7643117064542658,3,4,124136,14684,109452,0.8817103821615003,17.949937777777777,2382.459072,14.360549121901718,131,2.7000000000000006E-4
10,test_20231101_135624,11551286.png,271883,164,271719,0.9993967993585476,1,4,40092,22,40070,0.9994512620971765,18.120286222222223,1899.5769013333334,15.344234809036362,131,2.7000000000000006E-4
1,test_20231101_135624,10404007.png,502730,15579,487151,0.9690111988542558,3,4,61265,2265,59000,0.9630294621725292,26.215516444444443,3576.6761493333333,12.596007421963613,131,2.800000000000001E-4
2,test_20231101_135624,1254659.png,342646,63422,279224,0.8149051791061328,3,4,80080,8926,71154,0.8885364635364635,22.107413333333334,3564.834528,12.610409852338439,131,2.800000000000001E-4
3,test_20231101_135624,10188041.png,221231,8102,213129,0.9633776459899381,3,4,41731,1149,40582,0.972466511705926,11.979751111111112,1380.5433493333333,16.73030312746173,131,2.800000000000001E-4
4,test_20231101_135624,10287332.png,216980,10917,206063,0.9496866070605585,2,3,22337,1502,20835,0.9327573085015893,9.824568888888889,895.248896,18.611365667454372,131,2.800000000000001E-4
5,test_20231101_135624,11610969.png,368720,20332,348388,0.9448578867433283,2,4,84111,2981,81130,0.9645587378583063,23.157488,3373.484581333333,12.850016313349945,131,2.800000000000001E-4
6,test_20231101_135624,10350842.png,212614,4777,207837,0.9775320533925329,1,4,42529,701,41828,0.983517129488114,19.68519288888889,2463.000773333333,14.216158126689425,131,2.800000000000001E-4
7,test_20231101_135624,10863862.png,317432,7077,310355,0.9777054613271504,1,4,66058,1041,65017,0.9842411214387357,35.76357333333333,6534.928085333333,9.978395481884935,131,2.800000000000001E-4
8,test_20231101_135624,11382381.png,312486,587,311899,0.9981215158439098,2,3,46745,78,46667,0.9983313723392876,21.967536,2569.068496,14.03304677372966,131,2.800000000000001E-4
9,test_20231101_135624,11079715.png,443815,104602,339213,0.7643117064542658,4,4,124136,14684,109452,0.8817103821615003,17.949937777777777,2382.459072,14.360549121901718,131,2.800000000000001E-4
10,test_20231101_135624,11551286.png,271883,164,271719,0.9993967993585476,1,3,40092,22,40070,0.9994512620971765,18.120286222222223,1899.5769013333334,15.344234809036362,131,2.800000000000001E-4
1,test_20231101_135625,10404007.png,502730,15579,487151,0.9690111988542558,2,3,61265,2265,59000,0.9630294621725292,26.215516444444443,3576.6761493333333,12.596007421963613,131,2.900000000000001E-4
2,test_20231101_135625,1254659.png,342646,63422,279224,0.8149051791061328,3,4,80080,8926,71154,0.8885364635364635,22.107413333333334,3564.834528,12.610409852338439,131,2.900000000000001E-4
3,test_20231101_135625,10188041.png,221231,8102,213129,0.9633776459899381,2,3,41731,1149,40582,0.972466511705926,11.979751111111112,1380.5433493333333,16.73030312746173,131,2.900000000000001E-4
4,test_20231101_135625,10287332.png,216980,10917,206063,0.9496866070605585,1,3,22337,1502,20835,0.9327573085015893,9.824568888888889,895.248896,18.611365667454372,131,2.900000000000001E-4
5,test_20231101_135625,11610969.png,368720,20332,348388,0.9448578867433283,3,4,84111,2981,81130,0.9645587378583063,23.157488,3373.484581333333,12.850016313349945,131,2.900000000000001E-4
6,test_20231101_135625,10350842.png,212614,4777,207837,0.9775320533925329,1,4,42529,701,41828,0.983517129488114,19.68519288888889,2463.000773333333,14.216158126689425,131,2.900000000000001E-4
7,test_20231101_135625,10863862.png,317432,7077,310355,0.9777054613271504,2,4,66058,1041,65017,0.9842411214387357,35.76357333333333,6534.928085333333,9.978395481884935,131,2.900000000000001E-4
8,test_20231101_135625,11382381.png,312486,587,311899,0.9981215158439098,1,3,46745,78,46667,0.9983313723392876,21.967536,2569.068496,14.03304677372966,131,2.900000000000001E-4
9,test_20231101_135625,11079715.png,443815,104602,339213,0.7643117064542658,3,4,124136,14684,109452,0.8817103821615003,17.949937777777777,2382.459072,14.360549121901718,131,2.900000000000001E-4
10,test_20231101_135625,11551286.png,271883,164,271719,0.9993967993585476,1,4,40092,22,40070,0.9994512620971765,18.120286222222223,1899.5769013333334,15.344234809036362,131,2.900000000000001E-4
1,test_20231101_135626,10404007.png,502730,15579,487151,0.9690111988542558,2,4,61265,2265,59000,0.9630294621725292,26.215516444444443,3576.6761493333333,12.596007421963613,131,3.0000000000000014E-4
2,test_20231101_135626,1254659.png,342646,63422,279224,0.8149051791061328,2,4,80080,8926,71154,0.8885364635364635,22.107413333333334,3564.834528,12.610409852338439,131,3.0000000000000014E-4
3,test_20231101_135626,10188041.png,221231,8102,213129,0.9633776459899381,2,3,41731,1149,40582,0.972466511705926,11.979751111111112,1380.5433493333333,16.73030312746173,131,3.0000000000000014E-4
4,test_20231101_135626,10287332.png,216980,10917,206063,0.9496866070605585,2,3,22337,1502,20835,0.9327573085015893,9.824568888888889,895.248896,18.611365667454372,131,3.0000000000000014E-4
5,test_20231101_135626,11610969.png,368720,20332,348388,0.9448578867433283,2,3,84111,2981,81130,0.9645587378583063,23.157488,3373.484581333333,12.850016313349945,131,3.0000000000000014E-4
6,test_20231101_135626,10350842.png,212614,4777,207837,0.9775320533925329,2,4,42529,701,41828,0.983517129488114,19.68519288888889,2463.000773333333,14.216158126689425,131,3.0000000000000014E-4
7,test_20231101_135626,10863862.png,317432,7077,310355,0.9777054613271504,1,3,66058,1041,65017,0.9842411214387357,35.76357333333333,6534.928085333333,9.978395481884935,131,3.0000000000000014E-4
8,test_20231101_135626,11382381.png,312486,587,311899,0.9981215158439098,1,4,46745,78,46667,0.9983313723392876,21.967536,2569.068496,14.03304677372966,131,3.0000000000000014E-4
9,test_20231101_135626,11079715.png,443815,104602,339213,0.7643117064542658,3,4,124136,14684,109452,0.8817103821615003,17.949937777777777,2382.459072,14.360549121901718,131,3.0000000000000014E-4
10,test_20231101_135626,11551286.png,271883,164,271719,0.9993967993585476,2,4,40092,22,40070,0.9994512620971765,18.120286222222223,1899.5769013333334,15.344234809036362,131,3.0000000000000014E-4
1,test_20231101_135626,10404007.png,502730,15579,487151,0.9690111988542558,2,3,61265,2265,59000,0.9630294621725292,26.215516444444443,3576.6761493333333,12.596007421963613,131,3.1000000000000016E-4
2,test_20231101_135626,1254659.png,342646,63422,279224,0.8149051791061328,3,4,80080,8926,71154,0.8885364635364635,22.107413333333334,3564.834528,12.610409852338439,131,3.1000000000000016E-4
3,test_20231101_135626,10188041.png,221231,8102,213129,0.9633776459899381,2,4,41731,1149,40582,0.972466511705926,11.979751111111112,1380.5433493333333,16.73030312746173,131,3.1000000000000016E-4
4,test_20231101_135626,10287332.png,216980,10917,206063,0.9496866070605585,2,4,22337,1502,20835,0.9327573085015893,9.824568888888889,895.248896,18.611365667454372,131,3.1000000000000016E-4
5,test_20231101_135626,11610969.png,368720,20332,348388,0.9448578867433283,2,4,84111,2981,81130,0.9645587378583063,23.157488,3373.484581333333,12.850016313349945,131,3.1000000000000016E-4
6,test_20231101_135626,10350842.png,212614,4777,207837,0.9775320533925329,1,4,42529,701,41828,0.983517129488114,19.68519288888889,2463.000773333333,14.216158126689425,131,3.1000000000000016E-4
7,test_20231101_135626,10863862.png,317432,7077,310355,0.9777054613271504,2,3,66058,1041,65017,0.9842411214387357,35.76357333333333,6534.928085333333,9.978395481884935,131,3.1000000000000016E-4
8,test_20231101_135626,11382381.png,312486,587,311899,0.9981215158439098,2,4,46745,78,46667,0.9983313723392876,21.967536,2569.068496,14.03304677372966,131,3.1000000000000016E-4
9,test_20231101_135626,11079715.png,443815,104602,339213,0.7643117064542658,3,5,124136,14684,109452,0.8817103821615003,17.949937777777777,2382.459072,14.360549121901718,131,3.1000000000000016E-4
10,test_20231101_135626,11551286.png,271883,164,271719,0.9993967993585476,1,4,40092,22,40070,0.9994512620971765,18.120286222222223,1899.5769013333334,15.344234809036362,131,3.1000000000000016E-4
1,test_20231101_135627,10404007.png,502730,15417,487313,0.9693334394207627,2,4,61265,2242,59023,0.9634048804374439,26.25734577777778,3584.151632,12.586939861200479,131,3.200000000000002E-4
2,test_20231101_135627,1254659.png,342646,63422,279224,0.8149051791061328,3,4,80080,8926,71154,0.8885364635364635,22.107413333333334,3564.834528,12.610409852338439,131,3.200000000000002E-4
3,test_20231101_135627,10188041.png,221231,8102,213129,0.9633776459899381,2,4,41731,1149,40582,0.972466511705926,11.979751111111112,1380.5433493333333,16.73030312746173,131,3.200000000000002E-4
4,test_20231101_135627,10287332.png,216980,10917,206063,0.9496866070605585,2,4,22337,1502,20835,0.9327573085015893,9.824568888888889,895.248896,18.611365667454372,131,3.200000000000002E-4
5,test_20231101_135627,11610969.png,368720,20332,348388,0.9448578867433283,3,4,84111,2981,81130,0.9645587378583063,23.157488,3373.484581333333,12.850016313349945,131,3.200000000000002E-4
6,test_20231101_135627,10350842.png,212614,4777,207837,0.9775320533925329,2,4,42529,701,41828,0.983517129488114,19.68519288888889,2463.000773333333,14.216158126689425,131,3.200000000000002E-4
7,test_20231101_135627,10863862.png,317432,7077,310355,0.9777054613271504,2,4,66058,1041,65017,0.9842411214387357,35.76357333333333,6534.928085333333,9.978395481884935,131,3.200000000000002E-4
8,test_20231101_135627,11382381.png,312486,587,311899,0.9981215158439098,2,4,46745,78,46667,0.9983313723392876,21.967536,2569.068496,14.03304677372966,131,3.200000000000002E-4
9,test_20231101_135627,11079715.png,443815,104602,339213,0.7643117064542658,3,5,124136,14684,109452,0.8817103821615003,17.949937777777777,2382.459072,14.360549121901718,131,3.200000000000002E-4
10,test_20231101_135627,11551286.png,271883,164,271719,0.9993967993585476,1,4,40092,22,40070,0.9994512620971765,18.120286222222223,1899.5769013333334,15.344234809036362,131,3.200000000000002E-4
1,test_20231101_135628,10404007.png,502730,15417,487313,0.9693334394207627,3,3,61265,2242,59023,0.9634048804374439,26.25734577777778,3584.151632,12.586939861200479,131,3.300000000000002E-4
2,test_20231101_135628,1254659.png,342646,63422,279224,0.8149051791061328,3,4,80080,8926,71154,0.8885364635364635,22.107413333333334,3564.834528,12.610409852338439,131,3.300000000000002E-4
3,test_20231101_135628,10188041.png,221231,8102,213129,0.9633776459899381,2,4,41731,1149,40582,0.972466511705926,11.979751111111112,1380.5433493333333,16.73030312746173,131,3.300000000000002E-4
4,test_20231101_135628,10287332.png,216980,10917,206063,0.9496866070605585,2,3,22337,1502,20835,0.9327573085015893,9.824568888888889,895.248896,18.611365667454372,131,3.300000000000002E-4
5,test_20231101_135628,11610969.png,368720,20332,348388,0.9448578867433283,2,4,84111,2981,81130,0.9645587378583063,23.157488,3373.484581333333,12.850016313349945,131,3.300000000000002E-4
6,test_20231101_135628,10350842.png,212614,4777,207837,0.9775320533925329,2,4,42529,701,41828,0.983517129488114,19.68519288888889,2463.000773333333,14.216158126689425,131,3.300000000000002E-4
7,test_20231101_135628,10863862.png,317432,7077,310355,0.9777054613271504,1,4,66058,1041,65017,0.9842411214387357,35.76357333333333,6534.928085333333,9.978395481884935,131,3.300000000000002E-4
8,test_20231101_135628,11382381.png,312486,587,311899,0.9981215158439098,2,3,46745,78,46667,0.9983313723392876,21.967536,2569.068496,14.03304677372966,131,3.300000000000002E-4
9,test_20231101_135628,11079715.png,443815,104602,339213,0.7643117064542658,4,4,124136,14684,109452,0.8817103821615003,17.949937777777777,2382.459072,14.360549121901718,131,3.300000000000002E-4
10,test_20231101_135628,11551286.png,271883,164,271719,0.9993967993585476,2,3,40092,22,40070,0.9994512620971765,18.120286222222223,1899.5769013333334,15.344234809036362,131,3.300000000000002E-4
1,test_20231101_135628,10404007.png,502730,15417,487313,0.9693334394207627,2,3,61265,2242,59023,0.9634048804374439,26.25734577777778,3584.151632,12.586939861200479,131,3.4000000000000024E-4
2,test_20231101_135628,1254659.png,342646,63422,279224,0.8149051791061328,4,4,80080,8926,71154,0.8885364635364635,22.107413333333334,3564.834528,12.610409852338439,131,3.4000000000000024E-4
3,test_20231101_135628,10188041.png,221231,8102,213129,0.9633776459899381,2,4,41731,1149,40582,0.972466511705926,11.979751111111112,1380.5433493333333,16.73030312746173,131,3.4000000000000024E-4
4,test_20231101_135628,10287332.png,216980,10917,206063,0.9496866070605585,2,4,22337,1502,20835,0.9327573085015893,9.824568888888889,895.248896,18.611365667454372,131,3.4000000000000024E-4
5,test_20231101_135628,11610969.png,368720,20332,348388,0.9448578867433283,2,4,84111,2981,81130,0.9645587378583063,23.157488,3373.484581333333,12.850016313349945,131,3.4000000000000024E-4
6,test_20231101_135628,10350842.png,212614,4777,207837,0.9775320533925329,2,3,42529,701,41828,0.983517129488114,19.68519288888889,2463.000773333333,14.216158126689425,131,3.4000000000000024E-4
7,test_20231101_135628,10863862.png,317432,7077,310355,0.9777054613271504,1,3,66058,1041,65017,0.9842411214387357,35.76357333333333,6534.928085333333,9.978395481884935,131,3.4000000000000024E-4
8,test_20231101_135628,11382381.png,312486,567,311919,0.9981855187112383,1,4,46745,75,46670,0.9983955503262381,22.72423288888889,2714.741744,13.793518398308729,131,3.4000000000000024E-4
9,test_20231101_135628,11079715.png,443815,104602,339213,0.7643117064542658,3,4,124136,14684,109452,0.8817103821615003,17.949937777777777,2382.459072,14.360549121901718,131,3.4000000000000024E-4
10,test_20231101_135628,11551286.png,271883,164,271719,0.9993967993585476,2,3,40092,22,40070,0.9994512620971765,18.120286222222223,1899.5769013333334,15.344234809036362,131,3.4000000000000024E-4
1,test_20231101_135629,10404007.png,502730,15417,487313,0.9693334394207627,3,4,61265,2242,59023,0.9634048804374439,26.25734577777778,3584.151632,12.586939861200479,131,3.5000000000000027E-4
2,test_20231101_135629,1254659.png,342646,63422,279224,0.8149051791061328,2,3,80080,8926,71154,0.8885364635364635,22.107413333333334,3564.834528,12.610409852338439,131,3.5000000000000027E-4
3,test_20231101_135629,10188041.png,221231,8102,213129,0.9633776459899381,2,4,41731,1149,40582,0.972466511705926,11.979751111111112,1380.5433493333333,16.73030312746173,131,3.5000000000000027E-4
4,test_20231101_135629,10287332.png,216980,10917,206063,0.9496866070605585,2,3,22337,1502,20835,0.9327573085015893,9.824568888888889,895.248896,18.611365667454372,131,3.5000000000000027E-4
5,test_20231101_135629,11610969.png,368720,20332,348388,0.9448578867433283,3,4,84111,2981,81130,0.9645587378583063,23.157488,3373.484581333333,12.850016313349945,131,3.5000000000000027E-4
6,test_20231101_135629,10350842.png,212614,4777,207837,0.9775320533925329,2,4,42529,701,41828,0.983517129488114,19.68519288888889,2463.000773333333,14.216158126689425,131,3.5000000000000027E-4
7,test_20231101_135629,10863862.png,317432,7077,310355,0.9777054613271504,2,4,66058,1041,65017,0.9842411214387357,35.76357333333333,6534.928085333333,9.978395481884935,131,3.5000000000000027E-4
8,test_20231101_135629,11382381.png,312486,567,311919,0.9981855187112383,1,3,46745,75,46670,0.9983955503262381,22.72423288888889,2714.741744,13.793518398308729,131,3.5000000000000027E-4
9,test_20231101_135629,11079715.png,443815,104602,339213,0.7643117064542658,3,4,124136,14684,109452,0.8817103821615003,17.949937777777777,2382.459072,14.360549121901718,131,3.5000000000000027E-4
10,test_20231101_135629,11551286.png,271883,164,271719,0.9993967993585476,1,3,40092,22,40070,0.9994512620971765,18.120286222222223,1899.5769013333334,15.344234809036362,131,3.5000000000000027E-4
1,test_20231101_135630,10404007.png,502730,15417,487313,0.9693334394207627,3,3,61265,2242,59023,0.9634048804374439,26.25734577777778,3584.151632,12.586939861200479,131,3.600000000000003E-4
2,test_20231101_135630,1254659.png,342646,63422,279224,0.8149051791061328,3,4,80080,8926,71154,0.8885364635364635,22.107413333333334,3564.834528,12.610409852338439,131,3.600000000000003E-4
3,test_20231101_135630,10188041.png,221231,8102,213129,0.9633776459899381,2,4,41731,1149,40582,0.972466511705926,11.979751111111112,1380.5433493333333,16.73030312746173,131,3.600000000000003E-4
4,test_20231101_135630,10287332.png,216980,10917,206063,0.9496866070605585,2,4,22337,1502,20835,0.9327573085015893,9.824568888888889,895.248896,18.611365667454372,131,3.600000000000003E-4
5,test_20231101_135630,11610969.png,368720,20332,348388,0.9448578867433283,3,4,84111,2981,81130,0.9645587378583063,23.157488,3373.484581333333,12.850016313349945,131,3.600000000000003E-4
6,test_20231101_135630,10350842.png,212614,4777,207837,0.9775320533925329,1,3,42529,701,41828,0.983517129488114,19.68519288888889,2463.000773333333,14.216158126689425,131,3.600000000000003E-4
7,test_20231101_135630,10863862.png,317432,7077,310355,0.9777054613271504,2,3,66058,1041,65017,0.9842411214387357,35.76357333333333,6534.928085333333,9.978395481884935,131,3.600000000000003E-4
8,test_20231101_135630,11382381.png,312486,567,311919,0.9981855187112383,2,3,46745,75,46670,0.9983955503262381,22.72423288888889,2714.741744,13.793518398308729,131,3.600000000000003E-4
9,test_20231101_135630,11079715.png,443815,104602,339213,0.7643117064542658,3,4,124136,14684,109452,0.8817103821615003,17.949937777777777,2382.459072,14.360549121901718,131,3.600000000000003E-4
10,test_20231101_135630,11551286.png,271883,164,271719,0.9993967993585476,1,3,40092,22,40070,0.9994512620971765,18.120286222222223,1899.5769013333334,15.344234809036362,131,3.600000000000003E-4
1,test_20231101_135630,10404007.png,502730,15417,487313,0.9693334394207627,2,3,61265,2242,59023,0.9634048804374439,26.25734577777778,3584.151632,12.586939861200479,131,3.700000000000003E-4
2,test_20231101_135630,1254659.png,342646,63422,279224,0.8149051791061328,3,4,80080,8926,71154,0.8885364635364635,22.107413333333334,3564.834528,12.610409852338439,131,3.700000000000003E-4
3,test_20231101_135630,10188041.png,221231,8102,213129,0.9633776459899381,2,4,41731,1149,40582,0.972466511705926,11.979751111111112,1380.5433493333333,16.73030312746173,131,3.700000000000003E-4
4,test_20231101_135630,10287332.png,216980,10917,206063,0.9496866070605585,1,3,22337,1502,20835,0.9327573085015893,9.824568888888889,895.248896,18.611365667454372,131,3.700000000000003E-4
5,test_20231101_135630,11610969.png,368720,20332,348388,0.9448578867433283,2,4,84111,2981,81130,0.9645587378583063,23.157488,3373.484581333333,12.850016313349945,131,3.700000000000003E-4
6,test_20231101_135630,10350842.png,212614,4777,207837,0.9775320533925329,1,4,42529,701,41828,0.983517129488114,19.68519288888889,2463.000773333333,14.216158126689425,131,3.700000000000003E-4
7,test_20231101_135630,10863862.png,317432,7077,310355,0.9777054613271504,2,3,66058,1041,65017,0.9842411214387357,35.76357333333333,6534.928085333333,9.978395481884935,131,3.700000000000003E-4
8,test_20231101_135630,11382381.png,312486,567,311919,0.9981855187112383,1,4,46745,75,46670,0.9983955503262381,22.72423288888889,2714.741744,13.793518398308729,131,3.700000000000003E-4
9,test_20231101_135630,11079715.png,443815,104602,339213,0.7643117064542658,4,5,124136,14684,109452,0.8817103821615003,17.949937777777777,2382.459072,14.360549121901718,131,3.700000000000003E-4
10,test_20231101_135630,11551286.png,271883,164,271719,0.9993967993585476,1,3,40092,22,40070,0.9994512620971765,18.120286222222223,1899.5769013333334,15.344234809036362,131,3.700000000000003E-4
1,test_20231101_135631,10404007.png,502730,15417,487313,0.9693334394207627,2,4,61265,2242,59023,0.9634048804374439,26.25734577777778,3584.151632,12.586939861200479,131,3.8000000000000035E-4
2,test_20231101_135631,1254659.png,342646,63422,279224,0.8149051791061328,2,3,80080,8926,71154,0.8885364635364635,22.107413333333334,3564.834528,12.610409852338439,131,3.8000000000000035E-4
3,test_20231101_135631,10188041.png,221231,8102,213129,0.9633776459899381,2,3,41731,1149,40582,0.972466511705926,11.979751111111112,1380.5433493333333,16.73030312746173,131,3.8000000000000035E-4
4,test_20231101_135631,10287332.png,216980,10917,206063,0.9496866070605585,2,4,22337,1502,20835,0.9327573085015893,9.824568888888889,895.248896,18.611365667454372,131,3.8000000000000035E-4
5,test_20231101_135631,11610969.png,368720,20332,348388,0.9448578867433283,2,4,84111,2981,81130,0.9645587378583063,23.157488,3373.484581333333,12.850016313349945,131,3.8000000000000035E-4
6,test_20231101_135631,10350842.png,212614,4777,207837,0.9775320533925329,1,4,42529,701,41828,0.983517129488114,19.68519288888889,2463.000773333333,14.216158126689425,131,3.8000000000000035E-4
7,test_20231101_135631,10863862.png,317432,7077,310355,0.9777054613271504,1,3,66058,1041,65017,0.9842411214387357,35.76357333333333,6534.928085333333,9.978395481884935,131,3.8000000000000035E-4
8,test_20231101_135631,11382381.png,312486,567,311919,0.9981855187112383,1,4,46745,75,46670,0.9983955503262381,22.72423288888889,2714.741744,13.793518398308729,131,3.8000000000000035E-4
9,test_20231101_135631,11079715.png,443815,104602,339213,0.7643117064542658,3,4,124136,14684,109452,0.8817103821615003,17.949937777777777,2382.459072,14.360549121901718,131,3.8000000000000035E-4
10,test_20231101_135631,11551286.png,271883,164,271719,0.9993967993585476,1,4,40092,22,40070,0.9994512620971765,18.120286222222223,1899.5769013333334,15.344234809036362,131,3.8000000000000035E-4
1,test_20231101_135632,10404007.png,502730,15417,487313,0.9693334394207627,2,4,61265,2242,59023,0.9634048804374439,26.25734577777778,3584.151632,12.586939861200479,131,3.9000000000000037E-4
2,test_20231101_135632,1254659.png,342646,63422,279224,0.8149051791061328,3,5,80080,8926,71154,0.8885364635364635,22.107413333333334,3564.834528,12.610409852338439,131,3.9000000000000037E-4
3,test_20231101_135632,10188041.png,221231,8102,213129,0.9633776459899381,3,4,41731,1149,40582,0.972466511705926,11.979751111111112,1380.5433493333333,16.73030312746173,131,3.9000000000000037E-4
4,test_20231101_135632,10287332.png,216980,10917,206063,0.9496866070605585,1,3,22337,1502,20835,0.9327573085015893,9.824568888888889,895.248896,18.611365667454372,131,3.9000000000000037E-4
5,test_20231101_135632,11610969.png,368720,20332,348388,0.9448578867433283,2,4,84111,2981,81130,0.9645587378583063,23.157488,3373.484581333333,12.850016313349945,131,3.9000000000000037E-4
6,test_20231101_135632,10350842.png,212614,4777,207837,0.9775320533925329,1,4,42529,701,41828,0.983517129488114,19.68519288888889,2463.000773333333,14.216158126689425,131,3.9000000000000037E-4
7,test_20231101_135632,10863862.png,317432,7077,310355,0.9777054613271504,1,3,66058,1041,65017,0.9842411214387357,35.76357333333333,6534.928085333333,9.978395481884935,131,3.9000000000000037E-4
8,test_20231101_135632,11382381.png,312486,567,311919,0.9981855187112383,1,3,46745,75,46670,0.9983955503262381,22.72423288888889,2714.741744,13.793518398308729,131,3.9000000000000037E-4
9,test_20231101_135632,11079715.png,443815,104602,339213,0.7643117064542658,3,4,124136,14684,109452,0.8817103821615003,17.949937777777777,2382.459072,14.360549121901718,131,3.9000000000000037E-4
10,test_20231101_135632,11551286.png,271883,164,271719,0.9993967993585476,1,4,40092,22,40070,0.9994512620971765,18.120286222222223,1899.5769013333334,15.344234809036362,131,3.9000000000000037E-4
1,test_20231101_135633,10404007.png,502730,15417,487313,0.9693334394207627,2,4,61265,2242,59023,0.9634048804374439,26.25734577777778,3584.151632,12.586939861200479,131,4.000000000000004E-4
2,test_20231101_135633,1254659.png,342646,63422,279224,0.8149051791061328,2,4,80080,8926,71154,0.8885364635364635,22.107413333333334,3564.834528,12.610409852338439,131,4.000000000000004E-4
3,test_20231101_135633,10188041.png,221231,8102,213129,0.9633776459899381,1,3,41731,1149,40582,0.972466511705926,11.979751111111112,1380.5433493333333,16.73030312746173,131,4.000000000000004E-4
4,test_20231101_135633,10287332.png,216980,10917,206063,0.9496866070605585,1,3,22337,1502,20835,0.9327573085015893,9.824568888888889,895.248896,18.611365667454372,131,4.000000000000004E-4
5,test_20231101_135633,11610969.png,368720,20332,348388,0.9448578867433283,2,4,84111,2981,81130,0.9645587378583063,23.157488,3373.484581333333,12.850016313349945,131,4.000000000000004E-4
6,test_20231101_135633,10350842.png,212614,4777,207837,0.9775320533925329,2,4,42529,701,41828,0.983517129488114,19.68519288888889,2463.000773333333,14.216158126689425,131,4.000000000000004E-4
7,test_20231101_135633,10863862.png,317432,7077,310355,0.9777054613271504,2,3,66058,1041,65017,0.9842411214387357,35.76357333333333,6534.928085333333,9.978395481884935,131,4.000000000000004E-4
8,test_20231101_135633,11382381.png,312486,567,311919,0.9981855187112383,1,4,46745,75,46670,0.9983955503262381,22.72423288888889,2714.741744,13.793518398308729,131,4.000000000000004E-4
9,test_20231101_135633,11079715.png,443815,104602,339213,0.7643117064542658,3,4,124136,14684,109452,0.8817103821615003,17.949937777777777,2382.459072,14.360549121901718,131,4.000000000000004E-4
10,test_20231101_135633,11551286.png,271883,164,271719,0.9993967993585476,2,4,40092,22,40070,0.9994512620971765,18.120286222222223,1899.5769013333334,15.344234809036362,131,4.000000000000004E-4
1,test_20231101_135633,10404007.png,502730,15417,487313,0.9693334394207627,2,4,61265,2242,59023,0.9634048804374439,26.25734577777778,3584.151632,12.586939861200479,131,4.100000000000004E-4
2,test_20231101_135633,1254659.png,342646,63422,279224,0.8149051791061328,3,4,80080,8926,71154,0.8885364635364635,22.107413333333334,3564.834528,12.610409852338439,131,4.100000000000004E-4
3,test_20231101_135633,10188041.png,221231,8102,213129,0.9633776459899381,1,3,41731,1149,40582,0.972466511705926,11.979751111111112,1380.5433493333333,16.73030312746173,131,4.100000000000004E-4
4,test_20231101_135633,10287332.png,216980,10917,206063,0.9496866070605585,1,3,22337,1502,20835,0.9327573085015893,9.824568888888889,895.248896,18.611365667454372,131,4.100000000000004E-4
5,test_20231101_135633,11610969.png,368720,20332,348388,0.9448578867433283,2,4,84111,2981,81130,0.9645587378583063,23.157488,3373.484581333333,12.850016313349945,131,4.100000000000004E-4
6,test_20231101_135633,10350842.png,212614,4777,207837,0.9775320533925329,1,3,42529,701,41828,0.983517129488114,19.68519288888889,2463.000773333333,14.216158126689425,131,4.100000000000004E-4
7,test_20231101_135633,10863862.png,317432,7077,310355,0.9777054613271504,1,4,66058,1041,65017,0.9842411214387357,35.76357333333333,6534.928085333333,9.978395481884935,131,4.100000000000004E-4
8,test_20231101_135633,11382381.png,312486,567,311919,0.9981855187112383,1,4,46745,75,46670,0.9983955503262381,22.72423288888889,2714.741744,13.793518398308729,131,4.100000000000004E-4
9,test_20231101_135633,11079715.png,443815,104602,339213,0.7643117064542658,3,4,124136,14684,109452,0.8817103821615003,17.949937777777777,2382.459072,14.360549121901718,131,4.100000000000004E-4
10,test_20231101_135633,11551286.png,271883,164,271719,0.9993967993585476,1,3,40092,22,40070,0.9994512620971765,18.120286222222223,1899.5769013333334,15.344234809036362,131,4.100000000000004E-4
1,test_20231101_135634,10404007.png,502730,15417,487313,0.9693334394207627,2,3,61265,2242,59023,0.9634048804374439,26.25734577777778,3584.151632,12.586939861200479,131,4.2000000000000045E-4
2,test_20231101_135634,1254659.png,342646,63422,279224,0.8149051791061328,3,4,80080,8926,71154,0.8885364635364635,22.107413333333334,3564.834528,12.610409852338439,131,4.2000000000000045E-4
3,test_20231101_135634,10188041.png,221231,8102,213129,0.9633776459899381,2,4,41731,1149,40582,0.972466511705926,11.979751111111112,1380.5433493333333,16.73030312746173,131,4.2000000000000045E-4
4,test_20231101_135634,10287332.png,216980,10917,206063,0.9496866070605585,2,4,22337,1502,20835,0.9327573085015893,9.824568888888889,895.248896,18.611365667454372,131,4.2000000000000045E-4
5,test_20231101_135634,11610969.png,368720,20332,348388,0.9448578867433283,3,4,84111,2981,81130,0.9645587378583063,23.157488,3373.484581333333,12.850016313349945,131,4.2000000000000045E-4
6,test_20231101_135634,10350842.png,212614,4777,207837,0.9775320533925329,2,3,42529,701,41828,0.983517129488114,19.68519288888889,2463.000773333333,14.216158126689425,131,4.2000000000000045E-4
7,test_20231101_135634,10863862.png,317432,7077,310355,0.9777054613271504,2,4,66058,1041,65017,0.9842411214387357,35.76357333333333,6534.928085333333,9.978395481884935,131,4.2000000000000045E-4
8,test_20231101_135634,11382381.png,312486,567,311919,0.9981855187112383,2,3,46745,75,46670,0.9983955503262381,22.72423288888889,2714.741744,13.793518398308729,131,4.2000000000000045E-4
9,test_20231101_135634,11079715.png,443815,104602,339213,0.7643117064542658,3,4,124136,14684,109452,0.8817103821615003,17.949937777777777,2382.459072,14.360549121901718,131,4.2000000000000045E-4
10,test_20231101_135634,11551286.png,271883,164,271719,0.9993967993585476,1,4,40092,22,40070,0.9994512620971765,18.120286222222223,1899.5769013333334,15.344234809036362,131,4.2000000000000045E-4
1,test_20231101_135635,10404007.png,502730,15417,487313,0.9693334394207627,2,4,61265,2242,59023,0.9634048804374439,26.25734577777778,3584.151632,12.586939861200479,131,4.300000000000005E-4
2,test_20231101_135635,1254659.png,342646,63422,279224,0.8149051791061328,3,4,80080,8926,71154,0.8885364635364635,22.107413333333334,3564.834528,12.610409852338439,131,4.300000000000005E-4
3,test_20231101_135635,10188041.png,221231,8102,213129,0.9633776459899381,2,13,41731,1149,40582,0.972466511705926,11.979751111111112,1380.5433493333333,16.73030312746173,131,4.300000000000005E-4
4,test_20231101_135635,10287332.png,216980,10917,206063,0.9496866070605585,2,4,22337,1502,20835,0.9327573085015893,9.824568888888889,895.248896,18.611365667454372,131,4.300000000000005E-4
5,test_20231101_135635,11610969.png,368720,20332,348388,0.9448578867433283,2,4,84111,2981,81130,0.9645587378583063,23.157488,3373.484581333333,12.850016313349945,131,4.300000000000005E-4
6,test_20231101_135635,10350842.png,212614,4777,207837,0.9775320533925329,1,3,42529,701,41828,0.983517129488114,19.68519288888889,2463.000773333333,14.216158126689425,131,4.300000000000005E-4
7,test_20231101_135635,10863862.png,317432,7077,310355,0.9777054613271504,1,3,66058,1041,65017,0.9842411214387357,35.76357333333333,6534.928085333333,9.978395481884935,131,4.300000000000005E-4
8,test_20231101_135635,11382381.png,312486,567,311919,0.9981855187112383,1,4,46745,75,46670,0.9983955503262381,22.72423288888889,2714.741744,13.793518398308729,131,4.300000000000005E-4
9,test_20231101_135635,11079715.png,443815,104602,339213,0.7643117064542658,3,4,124136,14684,109452,0.8817103821615003,17.949937777777777,2382.459072,14.360549121901718,131,4.300000000000005E-4
10,test_20231101_135635,11551286.png,271883,164,271719,0.9993967993585476,2,3,40092,22,40070,0.9994512620971765,18.120286222222223,1899.5769013333334,15.344234809036362,131,4.300000000000005E-4
1,test_20231101_135635,10404007.png,502730,15417,487313,0.9693334394207627,2,4,61265,2242,59023,0.9634048804374439,26.25734577777778,3584.151632,12.586939861200479,131,4.400000000000005E-4
2,test_20231101_135635,1254659.png,342646,63422,279224,0.8149051791061328,3,4,80080,8926,71154,0.8885364635364635,22.107413333333334,3564.834528,12.610409852338439,131,4.400000000000005E-4
3,test_20231101_135635,10188041.png,221231,8102,213129,0.9633776459899381,2,3,41731,1149,40582,0.972466511705926,11.979751111111112,1380.5433493333333,16.73030312746173,131,4.400000000000005E-4
4,test_20231101_135635,10287332.png,216980,10917,206063,0.9496866070605585,2,3,22337,1502,20835,0.9327573085015893,9.824568888888889,895.248896,18.611365667454372,131,4.400000000000005E-4
5,test_20231101_135635,11610969.png,368720,20332,348388,0.9448578867433283,2,4,84111,2981,81130,0.9645587378583063,23.157488,3373.484581333333,12.850016313349945,131,4.400000000000005E-4
6,test_20231101_135635,10350842.png,212614,4777,207837,0.9775320533925329,2,4,42529,701,41828,0.983517129488114,19.68519288888889,2463.000773333333,14.216158126689425,131,4.400000000000005E-4
7,test_20231101_135635,10863862.png,317432,7077,310355,0.9777054613271504,1,3,66058,1041,65017,0.9842411214387357,35.76357333333333,6534.928085333333,9.978395481884935,131,4.400000000000005E-4
8,test_20231101_135635,11382381.png,312486,567,311919,0.9981855187112383,1,4,46745,75,46670,0.9983955503262381,22.72423288888889,2714.741744,13.793518398308729,131,4.400000000000005E-4
9,test_20231101_135635,11079715.png,443815,104602,339213,0.7643117064542658,3,4,124136,14684,109452,0.8817103821615003,17.949937777777777,2382.459072,14.360549121901718,131,4.400000000000005E-4
10,test_20231101_135635,11551286.png,271883,164,271719,0.9993967993585476,1,4,40092,22,40070,0.9994512620971765,18.120286222222223,1899.5769013333334,15.344234809036362,131,4.400000000000005E-4
1,test_20231101_135636,10404007.png,502730,15417,487313,0.9693334394207627,2,4,61265,2242,59023,0.9634048804374439,26.25734577777778,3584.151632,12.586939861200479,131,4.5000000000000053E-4
2,test_20231101_135636,1254659.png,342646,63422,279224,0.8149051791061328,3,4,80080,8926,71154,0.8885364635364635,22.107413333333334,3564.834528,12.610409852338439,131,4.5000000000000053E-4
3,test_20231101_135636,10188041.png,221231,8102,213129,0.9633776459899381,2,4,41731,1149,40582,0.972466511705926,11.979751111111112,1380.5433493333333,16.73030312746173,131,4.5000000000000053E-4
4,test_20231101_135636,10287332.png,216980,10917,206063,0.9496866070605585,2,4,22337,1502,20835,0.9327573085015893,9.824568888888889,895.248896,18.611365667454372,131,4.5000000000000053E-4
5,test_20231101_135636,11610969.png,368720,20332,348388,0.9448578867433283,3,4,84111,2981,81130,0.9645587378583063,23.157488,3373.484581333333,12.850016313349945,131,4.5000000000000053E-4
6,test_20231101_135636,10350842.png,212614,4777,207837,0.9775320533925329,2,4,42529,701,41828,0.983517129488114,19.68519288888889,2463.000773333333,14.216158126689425,131,4.5000000000000053E-4
7,test_20231101_135636,10863862.png,317432,7077,310355,0.9777054613271504,2,4,66058,1041,65017,0.9842411214387357,35.76357333333333,6534.928085333333,9.978395481884935,131,4.5000000000000053E-4
8,test_20231101_135636,11382381.png,312486,567,311919,0.9981855187112383,1,3,46745,75,46670,0.9983955503262381,22.72423288888889,2714.741744,13.793518398308729,131,4.5000000000000053E-4
9,test_20231101_135636,11079715.png,443815,104602,339213,0.7643117064542658,3,4,124136,14684,109452,0.8817103821615003,17.949937777777777,2382.459072,14.360549121901718,131,4.5000000000000053E-4
10,test_20231101_135636,11551286.png,271883,164,271719,0.9993967993585476,1,3,40092,22,40070,0.9994512620971765,18.120286222222223,1899.5769013333334,15.344234809036362,131,4.5000000000000053E-4
1,test_20231101_135637,10404007.png,502730,15417,487313,0.9693334394207627,2,4,61265,2242,59023,0.9634048804374439,26.25734577777778,3584.151632,12.586939861200479,131,4.6000000000000056E-4
2,test_20231101_135637,1254659.png,342646,63422,279224,0.8149051791061328,4,4,80080,8926,71154,0.8885364635364635,22.107413333333334,3564.834528,12.610409852338439,131,4.6000000000000056E-4
3,test_20231101_135637,10188041.png,221231,8102,213129,0.9633776459899381,2,3,41731,1149,40582,0.972466511705926,11.979751111111112,1380.5433493333333,16.73030312746173,131,4.6000000000000056E-4
4,test_20231101_135637,10287332.png,216980,10917,206063,0.9496866070605585,2,4,22337,1502,20835,0.9327573085015893,9.824568888888889,895.248896,18.611365667454372,131,4.6000000000000056E-4
5,test_20231101_135637,11610969.png,368720,20332,348388,0.9448578867433283,2,3,84111,2981,81130,0.9645587378583063,23.157488,3373.484581333333,12.850016313349945,131,4.6000000000000056E-4
6,test_20231101_135637,10350842.png,212614,4777,207837,0.9775320533925329,2,4,42529,701,41828,0.983517129488114,19.68519288888889,2463.000773333333,14.216158126689425,131,4.6000000000000056E-4
7,test_20231101_135637,10863862.png,317432,7077,310355,0.9777054613271504,2,4,66058,1041,65017,0.9842411214387357,35.76357333333333,6534.928085333333,9.978395481884935,131,4.6000000000000056E-4
8,test_20231101_135637,11382381.png,312486,567,311919,0.9981855187112383,1,4,46745,75,46670,0.9983955503262381,22.72423288888889,2714.741744,13.793518398308729,131,4.6000000000000056E-4
9,test_20231101_135637,11079715.png,443815,104602,339213,0.7643117064542658,3,4,124136,14684,109452,0.8817103821615003,17.949937777777777,2382.459072,14.360549121901718,131,4.6000000000000056E-4
10,test_20231101_135637,11551286.png,271883,164,271719,0.9993967993585476,1,3,40092,22,40070,0.9994512620971765,18.120286222222223,1899.5769013333334,15.344234809036362,131,4.6000000000000056E-4
1,test_20231101_135637,10404007.png,502730,15417,487313,0.9693334394207627,3,3,61265,2242,59023,0.9634048804374439,26.25734577777778,3584.151632,12.586939861200479,131,4.700000000000006E-4
2,test_20231101_135637,1254659.png,342646,63422,279224,0.8149051791061328,3,7,80080,8926,71154,0.8885364635364635,22.107413333333334,3564.834528,12.610409852338439,131,4.700000000000006E-4
3,test_20231101_135637,10188041.png,221231,8102,213129,0.9633776459899381,2,4,41731,1149,40582,0.972466511705926,11.979751111111112,1380.5433493333333,16.73030312746173,131,4.700000000000006E-4
4,test_20231101_135637,10287332.png,216980,10917,206063,0.9496866070605585,2,4,22337,1502,20835,0.9327573085015893,9.824568888888889,895.248896,18.611365667454372,131,4.700000000000006E-4
5,test_20231101_135637,11610969.png,368720,20332,348388,0.9448578867433283,2,3,84111,2981,81130,0.9645587378583063,23.157488,3373.484581333333,12.850016313349945,131,4.700000000000006E-4
6,test_20231101_135637,10350842.png,212614,4777,207837,0.9775320533925329,2,3,42529,701,41828,0.983517129488114,19.68519288888889,2463.000773333333,14.216158126689425,131,4.700000000000006E-4
7,test_20231101_135637,10863862.png,317432,7077,310355,0.9777054613271504,2,4,66058,1041,65017,0.9842411214387357,35.76357333333333,6534.928085333333,9.978395481884935,131,4.700000000000006E-4
8,test_20231101_135637,11382381.png,312486,567,311919,0.9981855187112383,1,3,46745,75,46670,0.9983955503262381,22.72423288888889,2714.741744,13.793518398308729,131,4.700000000000006E-4
9,test_20231101_135637,11079715.png,443815,104602,339213,0.7643117064542658,3,4,124136,14684,109452,0.8817103821615003,17.949937777777777,2382.459072,14.360549121901718,131,4.700000000000006E-4
10,test_20231101_135637,11551286.png,271883,164,271719,0.9993967993585476,1,3,40092,22,40070,0.9994512620971765,18.120286222222223,1899.5769013333334,15.344234809036362,131,4.700000000000006E-4
1,test_20231101_135638,10404007.png,502730,15417,487313,0.9693334394207627,2,3,61265,2242,59023,0.9634048804374439,26.25734577777778,3584.151632,12.586939861200479,131,4.800000000000006E-4
2,test_20231101_135638,1254659.png,342646,63422,279224,0.8149051791061328,4,4,80080,8926,71154,0.8885364635364635,22.107413333333334,3564.834528,12.610409852338439,131,4.800000000000006E-4
3,test_20231101_135638,10188041.png,221231,8102,213129,0.9633776459899381,2,4,41731,1149,40582,0.972466511705926,11.979751111111112,1380.5433493333333,16.73030312746173,131,4.800000000000006E-4
4,test_20231101_135638,10287332.png,216980,10917,206063,0.9496866070605585,2,3,22337,1502,20835,0.9327573085015893,9.824568888888889,895.248896,18.611365667454372,131,4.800000000000006E-4
5,test_20231101_135638,11610969.png,368720,20332,348388,0.9448578867433283,3,4,84111,2981,81130,0.9645587378583063,23.157488,3373.484581333333,12.850016313349945,131,4.800000000000006E-4
6,test_20231101_135638,10350842.png,212614,4777,207837,0.9775320533925329,2,4,42529,701,41828,0.983517129488114,19.68519288888889,2463.000773333333,14.216158126689425,131,4.800000000000006E-4
7,test_20231101_135638,10863862.png,317432,7077,310355,0.9777054613271504,1,4,66058,1041,65017,0.9842411214387357,35.76357333333333,6534.928085333333,9.978395481884935,131,4.800000000000006E-4
8,test_20231101_135638,11382381.png,312486,567,311919,0.9981855187112383,1,4,46745,75,46670,0.9983955503262381,22.72423288888889,2714.741744,13.793518398308729,131,4.800000000000006E-4
9,test_20231101_135638,11079715.png,443815,104602,339213,0.7643117064542658,4,4,124136,14684,109452,0.8817103821615003,17.949937777777777,2382.459072,14.360549121901718,131,4.800000000000006E-4
10,test_20231101_135638,11551286.png,271883,164,271719,0.9993967993585476,1,3,40092,22,40070,0.9994512620971765,18.120286222222223,1899.5769013333334,15.344234809036362,131,4.800000000000006E-4
1,test_20231101_135639,10404007.png,502730,15417,487313,0.9693334394207627,3,4,61265,2242,59023,0.9634048804374439,26.25734577777778,3584.151632,12.586939861200479,131,4.900000000000006E-4
2,test_20231101_135639,1254659.png,342646,63422,279224,0.8149051791061328,2,3,80080,8926,71154,0.8885364635364635,22.107413333333334,3564.834528,12.610409852338439,131,4.900000000000006E-4
3,test_20231101_135639,10188041.png,221231,8102,213129,0.9633776459899381,2,4,41731,1149,40582,0.972466511705926,11.979751111111112,1380.5433493333333,16.73030312746173,131,4.900000000000006E-4
4,test_20231101_135639,10287332.png,216980,10917,206063,0.9496866070605585,2,4,22337,1502,20835,0.9327573085015893,9.824568888888889,895.248896,18.611365667454372,131,4.900000000000006E-4
5,test_20231101_135639,11610969.png,368720,20332,348388,0.9448578867433283,2,4,84111,2981,81130,0.9645587378583063,23.157488,3373.484581333333,12.850016313349945,131,4.900000000000006E-4
6,test_20231101_135639,10350842.png,212614,4777,207837,0.9775320533925329,2,3,42529,701,41828,0.983517129488114,19.68519288888889,2463.000773333333,14.216158126689425,131,4.900000000000006E-4
7,test_20231101_135639,10863862.png,317432,7077,310355,0.9777054613271504,5,4,66058,1041,65017,0.9842411214387357,35.76357333333333,6534.928085333333,9.978395481884935,131,4.900000000000006E-4
8,test_20231101_135639,11382381.png,312486,567,311919,0.9981855187112383,1,3,46745,75,46670,0.9983955503262381,22.72423288888889,2714.741744,13.793518398308729,131,4.900000000000006E-4
9,test_20231101_135639,11079715.png,443815,104602,339213,0.7643117064542658,3,5,124136,14684,109452,0.8817103821615003,17.949937777777777,2382.459072,14.360549121901718,131,4.900000000000006E-4
10,test_20231101_135639,11551286.png,271883,164,271719,0.9993967993585476,1,3,40092,22,40070,0.9994512620971765,18.120286222222223,1899.5769013333334,15.344234809036362,131,4.900000000000006E-4
1,test_20231101_135639,10404007.png,502730,15417,487313,0.9693334394207627,2,4,61265,2242,59023,0.9634048804374439,26.25734577777778,3584.151632,12.586939861200479,131,5.000000000000007E-4
2,test_20231101_135639,1254659.png,342646,63422,279224,0.8149051791061328,3,9,80080,8926,71154,0.8885364635364635,22.107413333333334,3564.834528,12.610409852338439,131,5.000000000000007E-4
3,test_20231101_135639,10188041.png,221231,8102,213129,0.9633776459899381,1,3,41731,1149,40582,0.972466511705926,11.979751111111112,1380.5433493333333,16.73030312746173,131,5.000000000000007E-4
4,test_20231101_135639,10287332.png,216980,10917,206063,0.9496866070605585,2,3,22337,1502,20835,0.9327573085015893,9.824568888888889,895.248896,18.611365667454372,131,5.000000000000007E-4
5,test_20231101_135639,11610969.png,368720,20332,348388,0.9448578867433283,2,7,84111,2981,81130,0.9645587378583063,23.157488,3373.484581333333,12.850016313349945,131,5.000000000000007E-4
6,test_20231101_135639,10350842.png,212614,4777,207837,0.9775320533925329,2,3,42529,701,41828,0.983517129488114,19.68519288888889,2463.000773333333,14.216158126689425,131,5.000000000000007E-4
7,test_20231101_135639,10863862.png,317432,7077,310355,0.9777054613271504,2,4,66058,1041,65017,0.9842411214387357,35.76357333333333,6534.928085333333,9.978395481884935,131,5.000000000000007E-4
8,test_20231101_135639,11382381.png,312486,567,311919,0.9981855187112383,2,3,46745,75,46670,0.9983955503262381,22.72423288888889,2714.741744,13.793518398308729,131,5.000000000000007E-4
9,test_20231101_135639,11079715.png,443815,104602,339213,0.7643117064542658,3,4,124136,14684,109452,0.8817103821615003,17.949937777777777,2382.459072,14.360549121901718,131,5.000000000000007E-4
10,test_20231101_135639,11551286.png,271883,164,271719,0.9993967993585476,1,3,40092,22,40070,0.9994512620971765,18.120286222222223,1899.5769013333334,15.344234809036362,131,5.000000000000007E-4
1,test_20231101_135640,10404007.png,502730,15417,487313,0.9693334394207627,2,3,61265,2242,59023,0.9634048804374439,26.25734577777778,3584.151632,12.586939861200479,131,5.100000000000007E-4
2,test_20231101_135640,1254659.png,342646,63422,279224,0.8149051791061328,3,4,80080,8926,71154,0.8885364635364635,22.107413333333334,3564.834528,12.610409852338439,131,5.100000000000007E-4
3,test_20231101_135640,10188041.png,221231,7942,213289,0.9641008719392852,2,4,41731,1127,40604,0.9729936977307038,12.198784,1414.611232,16.62443258813653,131,5.100000000000007E-4
4,test_20231101_135640,10287332.png,216980,10917,206063,0.9496866070605585,1,4,22337,1502,20835,0.9327573085015893,9.824568888888889,895.248896,18.611365667454372,131,5.100000000000007E-4
5,test_20231101_135640,11610969.png,368720,20292,348428,0.9449663701453678,3,4,84111,2977,81134,0.9646062940637966,23.535518222222223,3436.5972213333334,12.76951726258407,131,5.100000000000007E-4
6,test_20231101_135640,10350842.png,212614,4657,207957,0.9780964564892246,2,4,42529,683,41846,0.983940370100402,19.799326222222223,2482.1978613333335,14.182439637775918,131,5.100000000000007E-4
7,test_20231101_135640,10863862.png,317432,6997,310435,0.9779574838075556,2,4,66058,1029,65029,0.9844227799812286,35.88148977777778,6554.7338666666665,9.965252975778046,131,5.100000000000007E-4
8,test_20231101_135640,11382381.png,312486,567,311919,0.9981855187112383,1,4,46745,75,46670,0.9983955503262381,22.72423288888889,2714.741744,13.793518398308729,131,5.100000000000007E-4
9,test_20231101_135640,11079715.png,443815,104422,339393,0.7647172808490024,3,5,124136,14657,109479,0.8819278855448862,18.187201777777776,2424.468208,14.28463867273325,131,5.100000000000007E-4
10,test_20231101_135640,11551286.png,271883,164,271719,0.9993967993585476,1,4,40092,22,40070,0.9994512620971765,18.120286222222223,1899.5769013333334,15.344234809036362,131,5.100000000000007E-4
1,test_20231101_135641,10404007.png,502730,15417,487313,0.9693334394207627,2,3,61265,2242,59023,0.9634048804374439,26.25734577777778,3584.151632,12.586939861200479,131,5.200000000000007E-4
2,test_20231101_135641,1254659.png,342646,63422,279224,0.8149051791061328,4,4,80080,8926,71154,0.8885364635364635,22.107413333333334,3564.834528,12.610409852338439,131,5.200000000000007E-4
3,test_20231101_135641,10188041.png,221231,7942,213289,0.9641008719392852,2,4,41731,1127,40604,0.9729936977307038,12.198784,1414.611232,16.62443258813653,131,5.200000000000007E-4
4,test_20231101_135641,10287332.png,216980,10917,206063,0.9496866070605585,1,3,22337,1502,20835,0.9327573085015893,9.824568888888889,895.248896,18.611365667454372,131,5.200000000000007E-4
5,test_20231101_135641,11610969.png,368720,20292,348428,0.9449663701453678,2,3,84111,2977,81134,0.9646062940637966,23.535518222222223,3436.5972213333334,12.76951726258407,131,5.200000000000007E-4
6,test_20231101_135641,10350842.png,212614,4657,207957,0.9780964564892246,2,4,42529,683,41846,0.983940370100402,19.799326222222223,2482.1978613333335,14.182439637775918,131,5.200000000000007E-4
7,test_20231101_135641,10863862.png,317432,6997,310435,0.9779574838075556,2,4,66058,1029,65029,0.9844227799812286,35.88148977777778,6554.7338666666665,9.965252975778046,131,5.200000000000007E-4
8,test_20231101_135641,11382381.png,312486,567,311919,0.9981855187112383,1,3,46745,75,46670,0.9983955503262381,22.72423288888889,2714.741744,13.793518398308729,131,5.200000000000007E-4
9,test_20231101_135641,11079715.png,443815,104422,339393,0.7647172808490024,4,9,124136,14657,109479,0.8819278855448862,18.187201777777776,2424.468208,14.28463867273325,131,5.200000000000007E-4
10,test_20231101_135641,11551286.png,271883,164,271719,0.9993967993585476,1,3,40092,22,40070,0.9994512620971765,18.120286222222223,1899.5769013333334,15.344234809036362,131,5.200000000000007E-4
1,test_20231101_135641,10404007.png,502730,15417,487313,0.9693334394207627,2,4,61265,2242,59023,0.9634048804374439,26.25734577777778,3584.151632,12.586939861200479,131,5.300000000000007E-4
2,test_20231101_135641,1254659.png,342646,63422,279224,0.8149051791061328,3,4,80080,8926,71154,0.8885364635364635,22.107413333333334,3564.834528,12.610409852338439,131,5.300000000000007E-4
3,test_20231101_135641,10188041.png,221231,7942,213289,0.9641008719392852,2,3,41731,1127,40604,0.9729936977307038,12.198784,1414.611232,16.62443258813653,131,5.300000000000007E-4
4,test_20231101_135641,10287332.png,216980,10917,206063,0.9496866070605585,1,3,22337,1502,20835,0.9327573085015893,9.824568888888889,895.248896,18.611365667454372,131,5.300000000000007E-4
5,test_20231101_135641,11610969.png,368720,20292,348428,0.9449663701453678,2,4,84111,2977,81134,0.9646062940637966,23.535518222222223,3436.5972213333334,12.76951726258407,131,5.300000000000007E-4
6,test_20231101_135641,10350842.png,212614,4657,207957,0.9780964564892246,2,3,42529,683,41846,0.983940370100402,19.799326222222223,2482.1978613333335,14.182439637775918,131,5.300000000000007E-4
7,test_20231101_135641,10863862.png,317432,6997,310435,0.9779574838075556,1,4,66058,1029,65029,0.9844227799812286,35.88148977777778,6554.7338666666665,9.965252975778046,131,5.300000000000007E-4
8,test_20231101_135641,11382381.png,312486,567,311919,0.9981855187112383,1,4,46745,75,46670,0.9983955503262381,22.72423288888889,2714.741744,13.793518398308729,131,5.300000000000007E-4
9,test_20231101_135641,11079715.png,443815,104422,339393,0.7647172808490024,4,4,124136,14657,109479,0.8819278855448862,18.187201777777776,2424.468208,14.28463867273325,131,5.300000000000007E-4
10,test_20231101_135641,11551286.png,271883,164,271719,0.9993967993585476,1,10,40092,22,40070,0.9994512620971765,18.120286222222223,1899.5769013333334,15.344234809036362,131,5.300000000000007E-4
1,test_20231101_135642,10404007.png,502730,15417,487313,0.9693334394207627,2,3,61265,2242,59023,0.9634048804374439,26.25734577777778,3584.151632,12.586939861200479,131,5.400000000000008E-4
2,test_20231101_135642,1254659.png,342646,63422,279224,0.8149051791061328,3,4,80080,8926,71154,0.8885364635364635,22.107413333333334,3564.834528,12.610409852338439,131,5.400000000000008E-4
3,test_20231101_135642,10188041.png,221231,7942,213289,0.9641008719392852,2,3,41731,1127,40604,0.9729936977307038,12.198784,1414.611232,16.62443258813653,131,5.400000000000008E-4
4,test_20231101_135642,10287332.png,216980,10917,206063,0.9496866070605585,2,4,22337,1502,20835,0.9327573085015893,9.824568888888889,895.248896,18.611365667454372,131,5.400000000000008E-4
5,test_20231101_135642,11610969.png,368720,20292,348428,0.9449663701453678,2,4,84111,2977,81134,0.9646062940637966,23.535518222222223,3436.5972213333334,12.76951726258407,131,5.400000000000008E-4
6,test_20231101_135642,10350842.png,212614,4657,207957,0.9780964564892246,1,4,42529,683,41846,0.983940370100402,19.799326222222223,2482.1978613333335,14.182439637775918,131,5.400000000000008E-4
7,test_20231101_135642,10863862.png,317432,6997,310435,0.9779574838075556,2,4,66058,1029,65029,0.9844227799812286,35.88148977777778,6554.7338666666665,9.965252975778046,131,5.400000000000008E-4
8,test_20231101_135642,11382381.png,312486,567,311919,0.9981855187112383,2,10,46745,75,46670,0.9983955503262381,22.72423288888889,2714.741744,13.793518398308729,131,5.400000000000008E-4
9,test_20231101_135642,11079715.png,443815,104422,339393,0.7647172808490024,3,4,124136,14657,109479,0.8819278855448862,18.187201777777776,2424.468208,14.28463867273325,131,5.400000000000008E-4
10,test_20231101_135642,11551286.png,271883,164,271719,0.9993967993585476,1,4,40092,22,40070,0.9994512620971765,18.120286222222223,1899.5769013333334,15.344234809036362,131,5.400000000000008E-4
1,test_20231101_135643,10404007.png,502730,15417,487313,0.9693334394207627,2,4,61265,2242,59023,0.9634048804374439,26.25734577777778,3584.151632,12.586939861200479,131,5.500000000000008E-4
2,test_20231101_135643,1254659.png,342646,63422,279224,0.8149051791061328,3,4,80080,8926,71154,0.8885364635364635,22.107413333333334,3564.834528,12.610409852338439,131,5.500000000000008E-4
3,test_20231101_135643,10188041.png,221231,7942,213289,0.9641008719392852,3,3,41731,1127,40604,0.9729936977307038,12.198784,1414.611232,16.62443258813653,131,5.500000000000008E-4
4,test_20231101_135643,10287332.png,216980,10917,206063,0.9496866070605585,2,4,22337,1502,20835,0.9327573085015893,9.824568888888889,895.248896,18.611365667454372,131,5.500000000000008E-4
5,test_20231101_135643,11610969.png,368720,20292,348428,0.9449663701453678,2,4,84111,2977,81134,0.9646062940637966,23.535518222222223,3436.5972213333334,12.76951726258407,131,5.500000000000008E-4
6,test_20231101_135643,10350842.png,212614,4657,207957,0.9780964564892246,1,4,42529,683,41846,0.983940370100402,19.799326222222223,2482.1978613333335,14.182439637775918,131,5.500000000000008E-4
7,test_20231101_135643,10863862.png,317432,6997,310435,0.9779574838075556,1,3,66058,1029,65029,0.9844227799812286,35.88148977777778,6554.7338666666665,9.965252975778046,131,5.500000000000008E-4
8,test_20231101_135643,11382381.png,312486,567,311919,0.9981855187112383,1,3,46745,75,46670,0.9983955503262381,22.72423288888889,2714.741744,13.793518398308729,131,5.500000000000008E-4
9,test_20231101_135643,11079715.png,443815,104422,339393,0.7647172808490024,3,4,124136,14657,109479,0.8819278855448862,18.187201777777776,2424.468208,14.28463867273325,131,5.500000000000008E-4
10,test_20231101_135643,11551286.png,271883,164,271719,0.9993967993585476,1,4,40092,22,40070,0.9994512620971765,18.120286222222223,1899.5769013333334,15.344234809036362,131,5.500000000000008E-4
1,test_20231101_135643,10404007.png,502730,15417,487313,0.9693334394207627,2,15,61265,2242,59023,0.9634048804374439,26.25734577777778,3584.151632,12.586939861200479,131,5.600000000000008E-4
2,test_20231101_135643,1254659.png,342646,63422,279224,0.8149051791061328,3,4,80080,8926,71154,0.8885364635364635,22.107413333333334,3564.834528,12.610409852338439,131,5.600000000000008E-4
3,test_20231101_135643,10188041.png,221231,7942,213289,0.9641008719392852,1,3,41731,1127,40604,0.9729936977307038,12.198784,1414.611232,16.62443258813653,131,5.600000000000008E-4
4,test_20231101_135643,10287332.png,216980,10917,206063,0.9496866070605585,2,4,22337,1502,20835,0.9327573085015893,9.824568888888889,895.248896,18.611365667454372,131,5.600000000000008E-4
5,test_20231101_135643,11610969.png,368720,20292,348428,0.9449663701453678,2,3,84111,2977,81134,0.9646062940637966,23.535518222222223,3436.5972213333334,12.76951726258407,131,5.600000000000008E-4
6,test_20231101_135643,10350842.png,212614,4657,207957,0.9780964564892246,2,3,42529,683,41846,0.983940370100402,19.799326222222223,2482.1978613333335,14.182439637775918,131,5.600000000000008E-4
7,test_20231101_135643,10863862.png,317432,6997,310435,0.9779574838075556,1,3,66058,1029,65029,0.9844227799812286,35.88148977777778,6554.7338666666665,9.965252975778046,131,5.600000000000008E-4
8,test_20231101_135643,11382381.png,312486,567,311919,0.9981855187112383,2,4,46745,75,46670,0.9983955503262381,22.72423288888889,2714.741744,13.793518398308729,131,5.600000000000008E-4
9,test_20231101_135643,11079715.png,443815,104422,339393,0.7647172808490024,3,4,124136,14657,109479,0.8819278855448862,18.187201777777776,2424.468208,14.28463867273325,131,5.600000000000008E-4
10,test_20231101_135643,11551286.png,271883,164,271719,0.9993967993585476,1,4,40092,22,40070,0.9994512620971765,18.120286222222223,1899.5769013333334,15.344234809036362,131,5.600000000000008E-4
1,test_20231101_135644,10404007.png,502730,15417,487313,0.9693334394207627,2,4,61265,2242,59023,0.9634048804374439,26.25734577777778,3584.151632,12.586939861200479,131,5.700000000000008E-4
2,test_20231101_135644,1254659.png,342646,63422,279224,0.8149051791061328,2,3,80080,8926,71154,0.8885364635364635,22.107413333333334,3564.834528,12.610409852338439,131,5.700000000000008E-4
3,test_20231101_135644,10188041.png,221231,7942,213289,0.9641008719392852,2,4,41731,1127,40604,0.9729936977307038,12.198784,1414.611232,16.62443258813653,131,5.700000000000008E-4
4,test_20231101_135644,10287332.png,216980,10917,206063,0.9496866070605585,2,3,22337,1502,20835,0.9327573085015893,9.824568888888889,895.248896,18.611365667454372,131,5.700000000000008E-4
5,test_20231101_135644,11610969.png,368720,20292,348428,0.9449663701453678,2,3,84111,2977,81134,0.9646062940637966,23.535518222222223,3436.5972213333334,12.76951726258407,131,5.700000000000008E-4
6,test_20231101_135644,10350842.png,212614,4657,207957,0.9780964564892246,2,4,42529,683,41846,0.983940370100402,19.799326222222223,2482.1978613333335,14.182439637775918,131,5.700000000000008E-4
7,test_20231101_135644,10863862.png,317432,6997,310435,0.9779574838075556,3,4,66058,1029,65029,0.9844227799812286,35.88148977777778,6554.7338666666665,9.965252975778046,131,5.700000000000008E-4
8,test_20231101_135644,11382381.png,312486,567,311919,0.9981855187112383,1,3,46745,75,46670,0.9983955503262381,22.72423288888889,2714.741744,13.793518398308729,131,5.700000000000008E-4
9,test_20231101_135644,11079715.png,443815,104422,339393,0.7647172808490024,4,4,124136,14657,109479,0.8819278855448862,18.187201777777776,2424.468208,14.28463867273325,131,5.700000000000008E-4
10,test_20231101_135644,11551286.png,271883,164,271719,0.9993967993585476,1,4,40092,22,40070,0.9994512620971765,18.120286222222223,1899.5769013333334,15.344234809036362,131,5.700000000000008E-4
1,test_20231101_135645,10404007.png,502730,15417,487313,0.9693334394207627,2,3,61265,2242,59023,0.9634048804374439,26.25734577777778,3584.151632,12.586939861200479,131,5.800000000000009E-4
2,test_20231101_135645,1254659.png,342646,63422,279224,0.8149051791061328,3,4,80080,8926,71154,0.8885364635364635,22.107413333333334,3564.834528,12.610409852338439,131,5.800000000000009E-4
3,test_20231101_135645,10188041.png,221231,7942,213289,0.9641008719392852,2,4,41731,1127,40604,0.9729936977307038,12.198784,1414.611232,16.62443258813653,131,5.800000000000009E-4
4,test_20231101_135645,10287332.png,216980,10917,206063,0.9496866070605585,2,3,22337,1502,20835,0.9327573085015893,9.824568888888889,895.248896,18.611365667454372,131,5.800000000000009E-4
5,test_20231101_135645,11610969.png,368720,20292,348428,0.9449663701453678,2,3,84111,2977,81134,0.9646062940637966,23.535518222222223,3436.5972213333334,12.76951726258407,131,5.800000000000009E-4
6,test_20231101_135645,10350842.png,212614,3712,208902,0.9825411308756714,2,4,42529,543,41986,0.9872322415293094,22.807100444444444,3214.5809066666666,13.059560000263657,131,5.800000000000009E-4
7,test_20231101_135645,10863862.png,317432,6997,310435,0.9779574838075556,2,4,66058,1029,65029,0.9844227799812286,35.88148977777778,6554.7338666666665,9.965252975778046,131,5.800000000000009E-4
8,test_20231101_135645,11382381.png,312486,567,311919,0.9981855187112383,1,4,46745,75,46670,0.9983955503262381,22.72423288888889,2714.741744,13.793518398308729,131,5.800000000000009E-4
9,test_20231101_135645,11079715.png,443815,104422,339393,0.7647172808490024,3,5,124136,14657,109479,0.8819278855448862,18.187201777777776,2424.468208,14.28463867273325,131,5.800000000000009E-4
10,test_20231101_135645,11551286.png,271883,164,271719,0.9993967993585476,1,3,40092,22,40070,0.9994512620971765,18.120286222222223,1899.5769013333334,15.344234809036362,131,5.800000000000009E-4
1,test_20231101_135645,10404007.png,502730,15417,487313,0.9693334394207627,2,3,61265,2242,59023,0.9634048804374439,26.25734577777778,3584.151632,12.586939861200479,131,5.900000000000009E-4
2,test_20231101_135645,1254659.png,342646,63422,279224,0.8149051791061328,2,4,80080,8926,71154,0.8885364635364635,22.107413333333334,3564.834528,12.610409852338439,131,5.900000000000009E-4
3,test_20231101_135645,10188041.png,221231,7942,213289,0.9641008719392852,1,3,41731,1127,40604,0.9729936977307038,12.198784,1414.611232,16.62443258813653,131,5.900000000000009E-4
4,test_20231101_135645,10287332.png,216980,10917,206063,0.9496866070605585,1,4,22337,1502,20835,0.9327573085015893,9.824568888888889,895.248896,18.611365667454372,131,5.900000000000009E-4
5,test_20231101_135645,11610969.png,368720,20292,348428,0.9449663701453678,3,3,84111,2977,81134,0.9646062940637966,23.535518222222223,3436.5972213333334,12.76951726258407,131,5.900000000000009E-4
6,test_20231101_135645,10350842.png,212614,3712,208902,0.9825411308756714,1,4,42529,543,41986,0.9872322415293094,22.807100444444444,3214.5809066666666,13.059560000263657,131,5.900000000000009E-4
7,test_20231101_135645,10863862.png,317432,6997,310435,0.9779574838075556,2,5,66058,1029,65029,0.9844227799812286,35.88148977777778,6554.7338666666665,9.965252975778046,131,5.900000000000009E-4
8,test_20231101_135645,11382381.png,312486,567,311919,0.9981855187112383,1,4,46745,75,46670,0.9983955503262381,22.72423288888889,2714.741744,13.793518398308729,131,5.900000000000009E-4
9,test_20231101_135645,11079715.png,443815,104422,339393,0.7647172808490024,3,4,124136,14657,109479,0.8819278855448862,18.187201777777776,2424.468208,14.28463867273325,131,5.900000000000009E-4
10,test_20231101_135645,11551286.png,271883,164,271719,0.9993967993585476,2,3,40092,22,40070,0.9994512620971765,18.120286222222223,1899.5769013333334,15.344234809036362,131,5.900000000000009E-4
1,test_20231101_135646,10404007.png,502730,15417,487313,0.9693334394207627,2,4,61265,2242,59023,0.9634048804374439,26.25734577777778,3584.151632,12.586939861200479,131,6.000000000000009E-4
2,test_20231101_135646,1254659.png,342646,63422,279224,0.8149051791061328,3,4,80080,8926,71154,0.8885364635364635,22.107413333333334,3564.834528,12.610409852338439,131,6.000000000000009E-4
3,test_20231101_135646,10188041.png,221231,7942,213289,0.9641008719392852,2,3,41731,1127,40604,0.9729936977307038,12.198784,1414.611232,16.62443258813653,131,6.000000000000009E-4
4,test_20231101_135646,10287332.png,216980,10917,206063,0.9496866070605585,1,3,22337,1502,20835,0.9327573085015893,9.824568888888889,895.248896,18.611365667454372,131,6.000000000000009E-4
5,test_20231101_135646,11610969.png,368720,20292,348428,0.9449663701453678,3,3,84111,2977,81134,0.9646062940637966,23.535518222222223,3436.5972213333334,12.76951726258407,131,6.000000000000009E-4
6,test_20231101_135646,10350842.png,212614,3712,208902,0.9825411308756714,2,3,42529,543,41986,0.9872322415293094,22.807100444444444,3214.5809066666666,13.059560000263657,131,6.000000000000009E-4
7,test_20231101_135646,10863862.png,317432,6997,310435,0.9779574838075556,2,3,66058,1029,65029,0.9844227799812286,35.88148977777778,6554.7338666666665,9.965252975778046,131,6.000000000000009E-4
8,test_20231101_135646,11382381.png,312486,567,311919,0.9981855187112383,1,4,46745,75,46670,0.9983955503262381,22.72423288888889,2714.741744,13.793518398308729,131,6.000000000000009E-4
9,test_20231101_135646,11079715.png,443815,104422,339393,0.7647172808490024,3,5,124136,14657,109479,0.8819278855448862,18.187201777777776,2424.468208,14.28463867273325,131,6.000000000000009E-4
10,test_20231101_135646,11551286.png,271883,164,271719,0.9993967993585476,1,3,40092,22,40070,0.9994512620971765,18.120286222222223,1899.5769013333334,15.344234809036362,131,6.000000000000009E-4
1,test_20231101_135647,10404007.png,502730,15417,487313,0.9693334394207627,2,4,61265,2242,59023,0.9634048804374439,26.25734577777778,3584.151632,12.586939861200479,131,6.10000000000001E-4
2,test_20231101_135647,1254659.png,342646,63422,279224,0.8149051791061328,3,4,80080,8926,71154,0.8885364635364635,22.107413333333334,3564.834528,12.610409852338439,131,6.10000000000001E-4
3,test_20231101_135647,10188041.png,221231,7942,213289,0.9641008719392852,2,3,41731,1127,40604,0.9729936977307038,12.198784,1414.611232,16.62443258813653,131,6.10000000000001E-4
4,test_20231101_135647,10287332.png,216980,10917,206063,0.9496866070605585,2,3,22337,1502,20835,0.9327573085015893,9.824568888888889,895.248896,18.611365667454372,131,6.10000000000001E-4
5,test_20231101_135647,11610969.png,368720,20292,348428,0.9449663701453678,3,3,84111,2977,81134,0.9646062940637966,23.535518222222223,3436.5972213333334,12.76951726258407,131,6.10000000000001E-4
6,test_20231101_135647,10350842.png,212614,3712,208902,0.9825411308756714,1,3,42529,543,41986,0.9872322415293094,22.807100444444444,3214.5809066666666,13.059560000263657,131,6.10000000000001E-4
7,test_20231101_135647,10863862.png,317432,6997,310435,0.9779574838075556,1,3,66058,1029,65029,0.9844227799812286,35.88148977777778,6554.7338666666665,9.965252975778046,131,6.10000000000001E-4
8,test_20231101_135647,11382381.png,312486,567,311919,0.9981855187112383,1,3,46745,75,46670,0.9983955503262381,22.72423288888889,2714.741744,13.793518398308729,131,6.10000000000001E-4
9,test_20231101_135647,11079715.png,443815,104422,339393,0.7647172808490024,4,4,124136,14657,109479,0.8819278855448862,18.187201777777776,2424.468208,14.28463867273325,131,6.10000000000001E-4
10,test_20231101_135647,11551286.png,271883,164,271719,0.9993967993585476,2,3,40092,22,40070,0.9994512620971765,18.120286222222223,1899.5769013333334,15.344234809036362,131,6.10000000000001E-4
1,test_20231101_135648,10404007.png,502730,15417,487313,0.9693334394207627,3,3,61265,2242,59023,0.9634048804374439,26.25734577777778,3584.151632,12.586939861200479,131,6.20000000000001E-4
2,test_20231101_135648,1254659.png,342646,63422,279224,0.8149051791061328,3,4,80080,8926,71154,0.8885364635364635,22.107413333333334,3564.834528,12.610409852338439,131,6.20000000000001E-4
3,test_20231101_135648,10188041.png,221231,7942,213289,0.9641008719392852,2,4,41731,1127,40604,0.9729936977307038,12.198784,1414.611232,16.62443258813653,131,6.20000000000001E-4
4,test_20231101_135648,10287332.png,216980,10917,206063,0.9496866070605585,2,4,22337,1502,20835,0.9327573085015893,9.824568888888889,895.248896,18.611365667454372,131,6.20000000000001E-4
5,test_20231101_135648,11610969.png,368720,20292,348428,0.9449663701453678,3,3,84111,2977,81134,0.9646062940637966,23.535518222222223,3436.5972213333334,12.76951726258407,131,6.20000000000001E-4
6,test_20231101_135648,10350842.png,212614,3712,208902,0.9825411308756714,2,4,42529,543,41986,0.9872322415293094,22.807100444444444,3214.5809066666666,13.059560000263657,131,6.20000000000001E-4
7,test_20231101_135648,10863862.png,317432,6997,310435,0.9779574838075556,2,4,66058,1029,65029,0.9844227799812286,35.88148977777778,6554.7338666666665,9.965252975778046,131,6.20000000000001E-4
8,test_20231101_135648,11382381.png,312486,567,311919,0.9981855187112383,2,3,46745,75,46670,0.9983955503262381,22.72423288888889,2714.741744,13.793518398308729,131,6.20000000000001E-4
9,test_20231101_135648,11079715.png,443815,104422,339393,0.7647172808490024,3,4,124136,14657,109479,0.8819278855448862,18.187201777777776,2424.468208,14.28463867273325,131,6.20000000000001E-4
10,test_20231101_135648,11551286.png,271883,164,271719,0.9993967993585476,1,3,40092,22,40070,0.9994512620971765,18.120286222222223,1899.5769013333334,15.344234809036362,131,6.20000000000001E-4
1,test_20231101_135648,10404007.png,502730,15417,487313,0.9693334394207627,2,4,61265,2242,59023,0.9634048804374439,26.25734577777778,3584.151632,12.586939861200479,131,6.30000000000001E-4
2,test_20231101_135648,1254659.png,342646,63422,279224,0.8149051791061328,3,16,80080,8926,71154,0.8885364635364635,22.107413333333334,3564.834528,12.610409852338439,131,6.30000000000001E-4
3,test_20231101_135648,10188041.png,221231,7942,213289,0.9641008719392852,2,4,41731,1127,40604,0.9729936977307038,12.198784,1414.611232,16.62443258813653,131,6.30000000000001E-4
4,test_20231101_135648,10287332.png,216980,10917,206063,0.9496866070605585,1,4,22337,1502,20835,0.9327573085015893,9.824568888888889,895.248896,18.611365667454372,131,6.30000000000001E-4
5,test_20231101_135648,11610969.png,368720,20292,348428,0.9449663701453678,3,4,84111,2977,81134,0.9646062940637966,23.535518222222223,3436.5972213333334,12.76951726258407,131,6.30000000000001E-4
6,test_20231101_135648,10350842.png,212614,3712,208902,0.9825411308756714,3,4,42529,543,41986,0.9872322415293094,22.807100444444444,3214.5809066666666,13.059560000263657,131,6.30000000000001E-4
7,test_20231101_135648,10863862.png,317432,6997,310435,0.9779574838075556,2,4,66058,1029,65029,0.9844227799812286,35.88148977777778,6554.7338666666665,9.965252975778046,131,6.30000000000001E-4
8,test_20231101_135648,11382381.png,312486,567,311919,0.9981855187112383,1,3,46745,75,46670,0.9983955503262381,22.72423288888889,2714.741744,13.793518398308729,131,6.30000000000001E-4
9,test_20231101_135648,11079715.png,443815,104422,339393,0.7647172808490024,4,5,124136,14657,109479,0.8819278855448862,18.187201777777776,2424.468208,14.28463867273325,131,6.30000000000001E-4
10,test_20231101_135648,11551286.png,271883,164,271719,0.9993967993585476,1,3,40092,22,40070,0.9994512620971765,18.120286222222223,1899.5769013333334,15.344234809036362,131,6.30000000000001E-4
1,test_20231101_135649,10404007.png,502730,15417,487313,0.9693334394207627,2,4,61265,2242,59023,0.9634048804374439,26.25734577777778,3584.151632,12.586939861200479,131,6.40000000000001E-4
2,test_20231101_135649,1254659.png,342646,63422,279224,0.8149051791061328,3,4,80080,8926,71154,0.8885364635364635,22.107413333333334,3564.834528,12.610409852338439,131,6.40000000000001E-4
3,test_20231101_135649,10188041.png,221231,7862,213369,0.9644624849139587,2,3,41731,1117,40614,0.9732333277419664,12.237685333333333,1418.6957333333332,16.611910982529146,131,6.40000000000001E-4
4,test_20231101_135649,10287332.png,216980,10917,206063,0.9496866070605585,3,3,22337,1502,20835,0.9327573085015893,9.824568888888889,895.248896,18.611365667454372,131,6.40000000000001E-4
5,test_20231101_135649,11610969.png,368720,20292,348428,0.9449663701453678,2,4,84111,2977,81134,0.9646062940637966,23.535518222222223,3436.5972213333334,12.76951726258407,131,6.40000000000001E-4
6,test_20231101_135649,10350842.png,212614,3712,208902,0.9825411308756714,1,4,42529,543,41986,0.9872322415293094,22.807100444444444,3214.5809066666666,13.059560000263657,131,6.40000000000001E-4
7,test_20231101_135649,10863862.png,317432,6997,310435,0.9779574838075556,2,3,66058,1029,65029,0.9844227799812286,35.88148977777778,6554.7338666666665,9.965252975778046,131,6.40000000000001E-4
8,test_20231101_135649,11382381.png,312486,567,311919,0.9981855187112383,1,4,46745,75,46670,0.9983955503262381,22.72423288888889,2714.741744,13.793518398308729,131,6.40000000000001E-4
9,test_20231101_135649,11079715.png,443815,104422,339393,0.7647172808490024,3,4,124136,14657,109479,0.8819278855448862,18.187201777777776,2424.468208,14.28463867273325,131,6.40000000000001E-4
10,test_20231101_135649,11551286.png,271883,164,271719,0.9993967993585476,1,3,40092,22,40070,0.9994512620971765,18.120286222222223,1899.5769013333334,15.344234809036362,131,6.40000000000001E-4
1,test_20231101_135650,10404007.png,502730,15417,487313,0.9693334394207627,2,4,61265,2242,59023,0.9634048804374439,26.25734577777778,3584.151632,12.586939861200479,131,6.500000000000011E-4
2,test_20231101_135650,1254659.png,342646,63422,279224,0.8149051791061328,3,4,80080,8926,71154,0.8885364635364635,22.107413333333334,3564.834528,12.610409852338439,131,6.500000000000011E-4
3,test_20231101_135650,10188041.png,221231,7862,213369,0.9644624849139587,3,3,41731,1117,40614,0.9732333277419664,12.237685333333333,1418.6957333333332,16.611910982529146,131,6.500000000000011E-4
4,test_20231101_135650,10287332.png,216980,10917,206063,0.9496866070605585,2,4,22337,1502,20835,0.9327573085015893,9.824568888888889,895.248896,18.611365667454372,131,6.500000000000011E-4
5,test_20231101_135650,11610969.png,368720,20292,348428,0.9449663701453678,2,4,84111,2977,81134,0.9646062940637966,23.535518222222223,3436.5972213333334,12.76951726258407,131,6.500000000000011E-4
6,test_20231101_135650,10350842.png,212614,3712,208902,0.9825411308756714,2,3,42529,543,41986,0.9872322415293094,22.807100444444444,3214.5809066666666,13.059560000263657,131,6.500000000000011E-4
7,test_20231101_135650,10863862.png,317432,6997,310435,0.9779574838075556,1,4,66058,1029,65029,0.9844227799812286,35.88148977777778,6554.7338666666665,9.965252975778046,131,6.500000000000011E-4
8,test_20231101_135650,11382381.png,312486,567,311919,0.9981855187112383,1,4,46745,75,46670,0.9983955503262381,22.72423288888889,2714.741744,13.793518398308729,131,6.500000000000011E-4
9,test_20231101_135650,11079715.png,443815,104422,339393,0.7647172808490024,3,4,124136,14657,109479,0.8819278855448862,18.187201777777776,2424.468208,14.28463867273325,131,6.500000000000011E-4
10,test_20231101_135650,11551286.png,271883,164,271719,0.9993967993585476,2,3,40092,22,40070,0.9994512620971765,18.120286222222223,1899.5769013333334,15.344234809036362,131,6.500000000000011E-4
1,test_20231101_135650,10404007.png,502730,15417,487313,0.9693334394207627,3,3,61265,2242,59023,0.9634048804374439,26.25734577777778,3584.151632,12.586939861200479,131,6.600000000000011E-4
2,test_20231101_135650,1254659.png,342646,63422,279224,0.8149051791061328,2,4,80080,8926,71154,0.8885364635364635,22.107413333333334,3564.834528,12.610409852338439,131,6.600000000000011E-4
3,test_20231101_135650,10188041.png,221231,7862,213369,0.9644624849139587,2,4,41731,1117,40614,0.9732333277419664,12.237685333333333,1418.6957333333332,16.611910982529146,131,6.600000000000011E-4
4,test_20231101_135650,10287332.png,216980,10917,206063,0.9496866070605585,2,4,22337,1502,20835,0.9327573085015893,9.824568888888889,895.248896,18.611365667454372,131,6.600000000000011E-4
5,test_20231101_135650,11610969.png,368720,20292,348428,0.9449663701453678,2,3,84111,2977,81134,0.9646062940637966,23.535518222222223,3436.5972213333334,12.76951726258407,131,6.600000000000011E-4
6,test_20231101_135650,10350842.png,212614,3712,208902,0.9825411308756714,2,3,42529,543,41986,0.9872322415293094,22.807100444444444,3214.5809066666666,13.059560000263657,131,6.600000000000011E-4
7,test_20231101_135650,10863862.png,317432,6997,310435,0.9779574838075556,1,3,66058,1029,65029,0.9844227799812286,35.88148977777778,6554.7338666666665,9.965252975778046,131,6.600000000000011E-4
8,test_20231101_135650,11382381.png,312486,567,311919,0.9981855187112383,2,4,46745,75,46670,0.9983955503262381,22.72423288888889,2714.741744,13.793518398308729,131,6.600000000000011E-4
9,test_20231101_135650,11079715.png,443815,104422,339393,0.7647172808490024,4,4,124136,14657,109479,0.8819278855448862,18.187201777777776,2424.468208,14.28463867273325,131,6.600000000000011E-4
10,test_20231101_135650,11551286.png,271883,164,271719,0.9993967993585476,1,3,40092,22,40070,0.9994512620971765,18.120286222222223,1899.5769013333334,15.344234809036362,131,6.600000000000011E-4
1,test_20231101_135651,10404007.png,502730,15417,487313,0.9693334394207627,2,4,61265,2242,59023,0.9634048804374439,26.25734577777778,3584.151632,12.586939861200479,131,6.700000000000011E-4
2,test_20231101_135651,1254659.png,342646,63422,279224,0.8149051791061328,3,5,80080,8926,71154,0.8885364635364635,22.107413333333334,3564.834528,12.610409852338439,131,6.700000000000011E-4
3,test_20231101_135651,10188041.png,221231,7862,213369,0.9644624849139587,1,3,41731,1117,40614,0.9732333277419664,12.237685333333333,1418.6957333333332,16.611910982529146,131,6.700000000000011E-4
4,test_20231101_135651,10287332.png,216980,10917,206063,0.9496866070605585,2,4,22337,1502,20835,0.9327573085015893,9.824568888888889,895.248896,18.611365667454372,131,6.700000000000011E-4
5,test_20231101_135651,11610969.png,368720,20292,348428,0.9449663701453678,2,4,84111,2977,81134,0.9646062940637966,23.535518222222223,3436.5972213333334,12.76951726258407,131,6.700000000000011E-4
6,test_20231101_135651,10350842.png,212614,3712,208902,0.9825411308756714,2,3,42529,543,41986,0.9872322415293094,22.807100444444444,3214.5809066666666,13.059560000263657,131,6.700000000000011E-4
7,test_20231101_135651,10863862.png,317432,6997,310435,0.9779574838075556,2,4,66058,1029,65029,0.9844227799812286,35.88148977777778,6554.7338666666665,9.965252975778046,131,6.700000000000011E-4
8,test_20231101_135651,11382381.png,312486,567,311919,0.9981855187112383,1,4,46745,75,46670,0.9983955503262381,22.72423288888889,2714.741744,13.793518398308729,131,6.700000000000011E-4
9,test_20231101_135651,11079715.png,443815,104422,339393,0.7647172808490024,4,4,124136,14657,109479,0.8819278855448862,18.187201777777776,2424.468208,14.28463867273325,131,6.700000000000011E-4
10,test_20231101_135651,11551286.png,271883,164,271719,0.9993967993585476,1,3,40092,22,40070,0.9994512620971765,18.120286222222223,1899.5769013333334,15.344234809036362,131,6.700000000000011E-4
1,test_20231101_135652,10404007.png,502730,15417,487313,0.9693334394207627,2,3,61265,2242,59023,0.9634048804374439,26.25734577777778,3584.151632,12.586939861200479,131,6.800000000000011E-4
2,test_20231101_135652,1254659.png,342646,63422,279224,0.8149051791061328,3,4,80080,8926,71154,0.8885364635364635,22.107413333333334,3564.834528,12.610409852338439,131,6.800000000000011E-4
3,test_20231101_135652,10188041.png,221231,7862,213369,0.9644624849139587,2,4,41731,1117,40614,0.9732333277419664,12.237685333333333,1418.6957333333332,16.611910982529146,131,6.800000000000011E-4
4,test_20231101_135652,10287332.png,216980,10917,206063,0.9496866070605585,2,4,22337,1502,20835,0.9327573085015893,9.824568888888889,895.248896,18.611365667454372,131,6.800000000000011E-4
5,test_20231101_135652,11610969.png,368720,20292,348428,0.9449663701453678,2,3,84111,2977,81134,0.9646062940637966,23.535518222222223,3436.5972213333334,12.76951726258407,131,6.800000000000011E-4
6,test_20231101_135652,10350842.png,212614,3712,208902,0.9825411308756714,2,4,42529,543,41986,0.9872322415293094,22.807100444444444,3214.5809066666666,13.059560000263657,131,6.800000000000011E-4
7,test_20231101_135652,10863862.png,317432,6997,310435,0.9779574838075556,1,3,66058,1029,65029,0.9844227799812286,35.88148977777778,6554.7338666666665,9.965252975778046,131,6.800000000000011E-4
8,test_20231101_135652,11382381.png,312486,567,311919,0.9981855187112383,1,3,46745,75,46670,0.9983955503262381,22.72423288888889,2714.741744,13.793518398308729,131,6.800000000000011E-4
9,test_20231101_135652,11079715.png,443815,104422,339393,0.7647172808490024,3,4,124136,14657,109479,0.8819278855448862,18.187201777777776,2424.468208,14.28463867273325,131,6.800000000000011E-4
10,test_20231101_135652,11551286.png,271883,164,271719,0.9993967993585476,2,3,40092,22,40070,0.9994512620971765,18.120286222222223,1899.5769013333334,15.344234809036362,131,6.800000000000011E-4
1,test_20231101_135652,10404007.png,502730,15417,487313,0.9693334394207627,2,3,61265,2242,59023,0.9634048804374439,26.25734577777778,3584.151632,12.586939861200479,131,6.900000000000012E-4
2,test_20231101_135652,1254659.png,342646,63422,279224,0.8149051791061328,2,4,80080,8926,71154,0.8885364635364635,22.107413333333334,3564.834528,12.610409852338439,131,6.900000000000012E-4
3,test_20231101_135652,10188041.png,221231,7862,213369,0.9644624849139587,2,3,41731,1117,40614,0.9732333277419664,12.237685333333333,1418.6957333333332,16.611910982529146,131,6.900000000000012E-4
4,test_20231101_135652,10287332.png,216980,10917,206063,0.9496866070605585,2,4,22337,1502,20835,0.9327573085015893,9.824568888888889,895.248896,18.611365667454372,131,6.900000000000012E-4
5,test_20231101_135652,11610969.png,368720,20292,348428,0.9449663701453678,3,3,84111,2977,81134,0.9646062940637966,23.535518222222223,3436.5972213333334,12.76951726258407,131,6.900000000000012E-4
6,test_20231101_135652,10350842.png,212614,3712,208902,0.9825411308756714,2,3,42529,543,41986,0.9872322415293094,22.807100444444444,3214.5809066666666,13.059560000263657,131,6.900000000000012E-4
7,test_20231101_135652,10863862.png,317432,6997,310435,0.9779574838075556,2,3,66058,1029,65029,0.9844227799812286,35.88148977777778,6554.7338666666665,9.965252975778046,131,6.900000000000012E-4
8,test_20231101_135652,11382381.png,312486,567,311919,0.9981855187112383,1,4,46745,75,46670,0.9983955503262381,22.72423288888889,2714.741744,13.793518398308729,131,6.900000000000012E-4
9,test_20231101_135652,11079715.png,443815,104422,339393,0.7647172808490024,4,4,124136,14657,109479,0.8819278855448862,18.187201777777776,2424.468208,14.28463867273325,131,6.900000000000012E-4
10,test_20231101_135652,11551286.png,271883,164,271719,0.9993967993585476,1,3,40092,22,40070,0.9994512620971765,18.120286222222223,1899.5769013333334,15.344234809036362,131,6.900000000000012E-4
1,test_20231101_135653,10404007.png,502730,15417,487313,0.9693334394207627,2,4,61265,2242,59023,0.9634048804374439,26.25734577777778,3584.151632,12.586939861200479,131,7.000000000000012E-4
2,test_20231101_135653,1254659.png,342646,63422,279224,0.8149051791061328,5,4,80080,8926,71154,0.8885364635364635,22.107413333333334,3564.834528,12.610409852338439,131,7.000000000000012E-4
3,test_20231101_135653,10188041.png,221231,7862,213369,0.9644624849139587,6,3,41731,1117,40614,0.9732333277419664,12.237685333333333,1418.6957333333332,16.611910982529146,131,7.000000000000012E-4
4,test_20231101_135653,10287332.png,216980,10917,206063,0.9496866070605585,2,5,22337,1502,20835,0.9327573085015893,9.824568888888889,895.248896,18.611365667454372,131,7.000000000000012E-4
5,test_20231101_135653,11610969.png,368720,20292,348428,0.9449663701453678,2,4,84111,2977,81134,0.9646062940637966,23.535518222222223,3436.5972213333334,12.76951726258407,131,7.000000000000012E-4
6,test_20231101_135653,10350842.png,212614,3712,208902,0.9825411308756714,2,4,42529,543,41986,0.9872322415293094,22.807100444444444,3214.5809066666666,13.059560000263657,131,7.000000000000012E-4
7,test_20231101_135653,10863862.png,317432,6997,310435,0.9779574838075556,2,4,66058,1029,65029,0.9844227799812286,35.88148977777778,6554.7338666666665,9.965252975778046,131,7.000000000000012E-4
8,test_20231101_135653,11382381.png,312486,567,311919,0.9981855187112383,1,4,46745,75,46670,0.9983955503262381,22.72423288888889,2714.741744,13.793518398308729,131,7.000000000000012E-4
9,test_20231101_135653,11079715.png,443815,104422,339393,0.7647172808490024,4,4,124136,14657,109479,0.8819278855448862,18.187201777777776,2424.468208,14.28463867273325,131,7.000000000000012E-4
10,test_20231101_135653,11551286.png,271883,164,271719,0.9993967993585476,1,3,40092,22,40070,0.9994512620971765,18.120286222222223,1899.5769013333334,15.344234809036362,131,7.000000000000012E-4
1,test_20231101_135654,10404007.png,502730,15417,487313,0.9693334394207627,2,4,61265,2242,59023,0.9634048804374439,26.25734577777778,3584.151632,12.586939861200479,131,7.100000000000012E-4
2,test_20231101_135654,1254659.png,342646,63422,279224,0.8149051791061328,2,3,80080,8926,71154,0.8885364635364635,22.107413333333334,3564.834528,12.610409852338439,131,7.100000000000012E-4
3,test_20231101_135654,10188041.png,221231,7862,213369,0.9644624849139587,1,3,41731,1117,40614,0.9732333277419664,12.237685333333333,1418.6957333333332,16.611910982529146,131,7.100000000000012E-4
4,test_20231101_135654,10287332.png,216980,10917,206063,0.9496866070605585,2,3,22337,1502,20835,0.9327573085015893,9.824568888888889,895.248896,18.611365667454372,131,7.100000000000012E-4
5,test_20231101_135654,11610969.png,368720,20292,348428,0.9449663701453678,2,4,84111,2977,81134,0.9646062940637966,23.535518222222223,3436.5972213333334,12.76951726258407,131,7.100000000000012E-4
6,test_20231101_135654,10350842.png,212614,3712,208902,0.9825411308756714,2,3,42529,543,41986,0.9872322415293094,22.807100444444444,3214.5809066666666,13.059560000263657,131,7.100000000000012E-4
7,test_20231101_135654,10863862.png,317432,6997,310435,0.9779574838075556,2,3,66058,1029,65029,0.9844227799812286,35.88148977777778,6554.7338666666665,9.965252975778046,131,7.100000000000012E-4
8,test_20231101_135654,11382381.png,312486,567,311919,0.9981855187112383,1,4,46745,75,46670,0.9983955503262381,22.72423288888889,2714.741744,13.793518398308729,131,7.100000000000012E-4
9,test_20231101_135654,11079715.png,443815,104422,339393,0.7647172808490024,3,5,124136,14657,109479,0.8819278855448862,18.187201777777776,2424.468208,14.28463867273325,131,7.100000000000012E-4
10,test_20231101_135654,11551286.png,271883,164,271719,0.9993967993585476,2,4,40092,22,40070,0.9994512620971765,18.120286222222223,1899.5769013333334,15.344234809036362,131,7.100000000000012E-4
1,test_20231101_135654,10404007.png,502730,15417,487313,0.9693334394207627,2,4,61265,2242,59023,0.9634048804374439,26.25734577777778,3584.151632,12.586939861200479,131,7.200000000000012E-4
2,test_20231101_135654,1254659.png,342646,63422,279224,0.8149051791061328,3,4,80080,8926,71154,0.8885364635364635,22.107413333333334,3564.834528,12.610409852338439,131,7.200000000000012E-4
3,test_20231101_135654,10188041.png,221231,7862,213369,0.9644624849139587,2,3,41731,1117,40614,0.9732333277419664,12.237685333333333,1418.6957333333332,16.611910982529146,131,7.200000000000012E-4
4,test_20231101_135654,10287332.png,216980,10917,206063,0.9496866070605585,2,3,22337,1502,20835,0.9327573085015893,9.824568888888889,895.248896,18.611365667454372,131,7.200000000000012E-4
5,test_20231101_135654,11610969.png,368720,20292,348428,0.9449663701453678,3,4,84111,2977,81134,0.9646062940637966,23.535518222222223,3436.5972213333334,12.76951726258407,131,7.200000000000012E-4
6,test_20231101_135654,10350842.png,212614,3712,208902,0.9825411308756714,1,3,42529,543,41986,0.9872322415293094,22.807100444444444,3214.5809066666666,13.059560000263657,131,7.200000000000012E-4
7,test_20231101_135654,10863862.png,317432,6997,310435,0.9779574838075556,2,4,66058,1029,65029,0.9844227799812286,35.88148977777778,6554.7338666666665,9.965252975778046,131,7.200000000000012E-4
8,test_20231101_135654,11382381.png,312486,567,311919,0.9981855187112383,2,3,46745,75,46670,0.9983955503262381,22.72423288888889,2714.741744,13.793518398308729,131,7.200000000000012E-4
9,test_20231101_135654,11079715.png,443815,104422,339393,0.7647172808490024,4,4,124136,14657,109479,0.8819278855448862,18.187201777777776,2424.468208,14.28463867273325,131,7.200000000000012E-4
10,test_20231101_135654,11551286.png,271883,164,271719,0.9993967993585476,2,3,40092,22,40070,0.9994512620971765,18.120286222222223,1899.5769013333334,15.344234809036362,131,7.200000000000012E-4
1,test_20231101_135655,10404007.png,502730,15417,487313,0.9693334394207627,2,4,61265,2242,59023,0.9634048804374439,26.25734577777778,3584.151632,12.586939861200479,131,7.300000000000013E-4
2,test_20231101_135655,1254659.png,342646,63422,279224,0.8149051791061328,3,4,80080,8926,71154,0.8885364635364635,22.107413333333334,3564.834528,12.610409852338439,131,7.300000000000013E-4
3,test_20231101_135655,10188041.png,221231,7862,213369,0.9644624849139587,2,3,41731,1117,40614,0.9732333277419664,12.237685333333333,1418.6957333333332,16.611910982529146,131,7.300000000000013E-4
4,test_20231101_135655,10287332.png,216980,10917,206063,0.9496866070605585,1,3,22337,1502,20835,0.9327573085015893,9.824568888888889,895.248896,18.611365667454372,131,7.300000000000013E-4
5,test_20231101_135655,11610969.png,368720,20292,348428,0.9449663701453678,2,4,84111,2977,81134,0.9646062940637966,23.535518222222223,3436.5972213333334,12.76951726258407,131,7.300000000000013E-4
6,test_20231101_135655,10350842.png,212614,3712,208902,0.9825411308756714,2,4,42529,543,41986,0.9872322415293094,22.807100444444444,3214.5809066666666,13.059560000263657,131,7.300000000000013E-4
7,test_20231101_135655,10863862.png,317432,6997,310435,0.9779574838075556,2,4,66058,1029,65029,0.9844227799812286,35.88148977777778,6554.7338666666665,9.965252975778046,131,7.300000000000013E-4
8,test_20231101_135655,11382381.png,312486,567,311919,0.9981855187112383,1,4,46745,75,46670,0.9983955503262381,22.72423288888889,2714.741744,13.793518398308729,131,7.300000000000013E-4
9,test_20231101_135655,11079715.png,443815,104422,339393,0.7647172808490024,3,4,124136,14657,109479,0.8819278855448862,18.187201777777776,2424.468208,14.28463867273325,131,7.300000000000013E-4
10,test_20231101_135655,11551286.png,271883,164,271719,0.9993967993585476,1,3,40092,22,40070,0.9994512620971765,18.120286222222223,1899.5769013333334,15.344234809036362,131,7.300000000000013E-4
1,test_20231101_135656,10404007.png,502730,15417,487313,0.9693334394207627,2,4,61265,2242,59023,0.9634048804374439,26.25734577777778,3584.151632,12.586939861200479,131,7.400000000000013E-4
2,test_20231101_135656,1254659.png,342646,63422,279224,0.8149051791061328,3,4,80080,8926,71154,0.8885364635364635,22.107413333333334,3564.834528,12.610409852338439,131,7.400000000000013E-4
3,test_20231101_135656,10188041.png,221231,7862,213369,0.9644624849139587,2,4,41731,1117,40614,0.9732333277419664,12.237685333333333,1418.6957333333332,16.611910982529146,131,7.400000000000013E-4
4,test_20231101_135656,10287332.png,216980,10917,206063,0.9496866070605585,2,4,22337,1502,20835,0.9327573085015893,9.824568888888889,895.248896,18.611365667454372,131,7.400000000000013E-4
5,test_20231101_135656,11610969.png,368720,20292,348428,0.9449663701453678,2,3,84111,2977,81134,0.9646062940637966,23.535518222222223,3436.5972213333334,12.76951726258407,131,7.400000000000013E-4
6,test_20231101_135656,10350842.png,212614,3712,208902,0.9825411308756714,1,3,42529,543,41986,0.9872322415293094,22.807100444444444,3214.5809066666666,13.059560000263657,131,7.400000000000013E-4
7,test_20231101_135656,10863862.png,317432,6997,310435,0.9779574838075556,1,4,66058,1029,65029,0.9844227799812286,35.88148977777778,6554.7338666666665,9.965252975778046,131,7.400000000000013E-4
8,test_20231101_135656,11382381.png,312486,567,311919,0.9981855187112383,1,4,46745,75,46670,0.9983955503262381,22.72423288888889,2714.741744,13.793518398308729,131,7.400000000000013E-4
9,test_20231101_135656,11079715.png,443815,104422,339393,0.7647172808490024,3,4,124136,14657,109479,0.8819278855448862,18.187201777777776,2424.468208,14.28463867273325,131,7.400000000000013E-4
10,test_20231101_135656,11551286.png,271883,164,271719,0.9993967993585476,1,3,40092,22,40070,0.9994512620971765,18.120286222222223,1899.5769013333334,15.344234809036362,131,7.400000000000013E-4
1,test_20231101_135656,10404007.png,502730,15417,487313,0.9693334394207627,3,3,61265,2242,59023,0.9634048804374439,26.25734577777778,3584.151632,12.586939861200479,131,7.500000000000013E-4
2,test_20231101_135656,1254659.png,342646,63422,279224,0.8149051791061328,3,4,80080,8926,71154,0.8885364635364635,22.107413333333334,3564.834528,12.610409852338439,131,7.500000000000013E-4
3,test_20231101_135656,10188041.png,221231,7862,213369,0.9644624849139587,2,3,41731,1117,40614,0.9732333277419664,12.237685333333333,1418.6957333333332,16.611910982529146,131,7.500000000000013E-4
4,test_20231101_135656,10287332.png,216980,10917,206063,0.9496866070605585,1,3,22337,1502,20835,0.9327573085015893,9.824568888888889,895.248896,18.611365667454372,131,7.500000000000013E-4
5,test_20231101_135656,11610969.png,368720,20292,348428,0.9449663701453678,2,4,84111,2977,81134,0.9646062940637966,23.535518222222223,3436.5972213333334,12.76951726258407,131,7.500000000000013E-4
6,test_20231101_135656,10350842.png,212614,3712,208902,0.9825411308756714,2,4,42529,543,41986,0.9872322415293094,22.807100444444444,3214.5809066666666,13.059560000263657,131,7.500000000000013E-4
7,test_20231101_135656,10863862.png,317432,6997,310435,0.9779574838075556,2,4,66058,1029,65029,0.9844227799812286,35.88148977777778,6554.7338666666665,9.965252975778046,131,7.500000000000013E-4
8,test_20231101_135656,11382381.png,312486,567,311919,0.9981855187112383,1,3,46745,75,46670,0.9983955503262381,22.72423288888889,2714.741744,13.793518398308729,131,7.500000000000013E-4
9,test_20231101_135656,11079715.png,443815,104422,339393,0.7647172808490024,3,4,124136,14657,109479,0.8819278855448862,18.187201777777776,2424.468208,14.28463867273325,131,7.500000000000013E-4
10,test_20231101_135656,11551286.png,271883,164,271719,0.9993967993585476,2,3,40092,22,40070,0.9994512620971765,18.120286222222223,1899.5769013333334,15.344234809036362,131,7.500000000000013E-4
1,test_20231101_135657,10404007.png,502730,15357,487373,0.9694527877787281,2,4,61265,2233,59032,0.9635517832367584,26.260865777777777,3584.812048,12.586139703637475,131,7.600000000000013E-4
2,test_20231101_135657,1254659.png,342646,63422,279224,0.8149051791061328,2,4,80080,8926,71154,0.8885364635364635,22.107413333333334,3564.834528,12.610409852338439,131,7.600000000000013E-4
3,test_20231101_135657,10188041.png,221231,7862,213369,0.9644624849139587,2,4,41731,1117,40614,0.9732333277419664,12.237685333333333,1418.6957333333332,16.611910982529146,131,7.600000000000013E-4
4,test_20231101_135657,10287332.png,216980,10917,206063,0.9496866070605585,2,4,22337,1502,20835,0.9327573085015893,9.824568888888889,895.248896,18.611365667454372,131,7.600000000000013E-4
5,test_20231101_135657,11610969.png,368720,20272,348448,0.9450206118463875,2,3,84111,2976,81135,0.9646181831151692,23.641168,3446.775301333333,12.75667388620914,131,7.600000000000013E-4
6,test_20231101_135657,10350842.png,212614,3692,208922,0.9826351980584533,2,4,42529,540,41989,0.9873027816313574,23.269838222222223,3295.771018666667,12.951233304108065,131,7.600000000000013E-4
7,test_20231101_135657,10863862.png,317432,6757,310675,0.9787135512487714,1,3,66058,994,65064,0.984952617396833,36.49882844444444,6712.9091573333335,9.861695907477596,131,7.600000000000013E-4
8,test_20231101_135657,11382381.png,312486,567,311919,0.9981855187112383,1,4,46745,75,46670,0.9983955503262381,22.72423288888889,2714.741744,13.793518398308729,131,7.600000000000013E-4
9,test_20231101_135657,11079715.png,443815,104402,339413,0.7647623446706397,3,4,124136,14654,109482,0.8819520525874847,18.204314666666665,2429.122021333333,14.276310297347752,131,7.600000000000013E-4
10,test_20231101_135657,11551286.png,271883,164,271719,0.9993967993585476,2,3,40092,22,40070,0.9994512620971765,18.120286222222223,1899.5769013333334,15.344234809036362,131,7.600000000000013E-4
1,test_20231101_135658,10404007.png,502730,15357,487373,0.9694527877787281,3,3,61265,2233,59032,0.9635517832367584,26.260865777777777,3584.812048,12.586139703637475,131,7.700000000000014E-4
2,test_20231101_135658,1254659.png,342646,63422,279224,0.8149051791061328,3,4,80080,8926,71154,0.8885364635364635,22.107413333333334,3564.834528,12.610409852338439,131,7.700000000000014E-4
3,test_20231101_135658,10188041.png,221231,7862,213369,0.9644624849139587,2,4,41731,1117,40614,0.9732333277419664,12.237685333333333,1418.6957333333332,16.611910982529146,131,7.700000000000014E-4
4,test_20231101_135658,10287332.png,216980,10917,206063,0.9496866070605585,2,4,22337,1502,20835,0.9327573085015893,9.824568888888889,895.248896,18.611365667454372,131,7.700000000000014E-4
5,test_20231101_135658,11610969.png,368720,20272,348448,0.9450206118463875,2,4,84111,2976,81135,0.9646181831151692,23.641168,3446.775301333333,12.75667388620914,131,7.700000000000014E-4
6,test_20231101_135658,10350842.png,212614,3229,209385,0.9848128533398554,1,4,42529,471,42058,0.9889252039784617,24.36172088888889,3561.434133333333,12.614554441385772,131,7.700000000000014E-4
7,test_20231101_135658,10863862.png,317432,6757,310675,0.9787135512487714,2,4,66058,994,65064,0.984952617396833,36.49882844444444,6712.9091573333335,9.861695907477596,131,7.700000000000014E-4
8,test_20231101_135658,11382381.png,312486,567,311919,0.9981855187112383,2,3,46745,75,46670,0.9983955503262381,22.72423288888889,2714.741744,13.793518398308729,131,7.700000000000014E-4
9,test_20231101_135658,11079715.png,443815,104402,339413,0.7647623446706397,3,4,124136,14654,109482,0.8819520525874847,18.204314666666665,2429.122021333333,14.276310297347752,131,7.700000000000014E-4
10,test_20231101_135658,11551286.png,271883,164,271719,0.9993967993585476,1,4,40092,22,40070,0.9994512620971765,18.120286222222223,1899.5769013333334,15.344234809036362,131,7.700000000000014E-4
1,test_20231101_135658,10404007.png,502730,15357,487373,0.9694527877787281,2,4,61265,2233,59032,0.9635517832367584,26.260865777777777,3584.812048,12.586139703637475,131,7.800000000000014E-4
2,test_20231101_135658,1254659.png,342646,63422,279224,0.8149051791061328,3,4,80080,8926,71154,0.8885364635364635,22.107413333333334,3564.834528,12.610409852338439,131,7.800000000000014E-4
3,test_20231101_135658,10188041.png,221231,7862,213369,0.9644624849139587,2,3,41731,1117,40614,0.9732333277419664,12.237685333333333,1418.6957333333332,16.611910982529146,131,7.800000000000014E-4
4,test_20231101_135658,10287332.png,216980,10917,206063,0.9496866070605585,1,4,22337,1502,20835,0.9327573085015893,9.824568888888889,895.248896,18.611365667454372,131,7.800000000000014E-4
5,test_20231101_135658,11610969.png,368720,20272,348448,0.9450206118463875,2,4,84111,2976,81135,0.9646181831151692,23.641168,3446.775301333333,12.75667388620914,131,7.800000000000014E-4
6,test_20231101_135658,10350842.png,212614,3229,209385,0.9848128533398554,1,3,42529,471,42058,0.9889252039784617,24.36172088888889,3561.434133333333,12.614554441385772,131,7.800000000000014E-4
7,test_20231101_135658,10863862.png,317432,6757,310675,0.9787135512487714,2,4,66058,994,65064,0.984952617396833,36.49882844444444,6712.9091573333335,9.861695907477596,131,7.800000000000014E-4
8,test_20231101_135658,11382381.png,312486,567,311919,0.9981855187112383,1,4,46745,75,46670,0.9983955503262381,22.72423288888889,2714.741744,13.793518398308729,131,7.800000000000014E-4
9,test_20231101_135658,11079715.png,443815,104402,339413,0.7647623446706397,4,5,124136,14654,109482,0.8819520525874847,18.204314666666665,2429.122021333333,14.276310297347752,131,7.800000000000014E-4
10,test_20231101_135658,11551286.png,271883,164,271719,0.9993967993585476,1,3,40092,22,40070,0.9994512620971765,18.120286222222223,1899.5769013333334,15.344234809036362,131,7.800000000000014E-4
1,test_20231101_135659,10404007.png,502730,15357,487373,0.9694527877787281,2,3,61265,2233,59032,0.9635517832367584,26.260865777777777,3584.812048,12.586139703637475,131,7.900000000000014E-4
2,test_20231101_135659,1254659.png,342646,63422,279224,0.8149051791061328,3,4,80080,8926,71154,0.8885364635364635,22.107413333333334,3564.834528,12.610409852338439,131,7.900000000000014E-4
3,test_20231101_135659,10188041.png,221231,7862,213369,0.9644624849139587,2,4,41731,1117,40614,0.9732333277419664,12.237685333333333,1418.6957333333332,16.611910982529146,131,7.900000000000014E-4
4,test_20231101_135659,10287332.png,216980,10917,206063,0.9496866070605585,2,4,22337,1502,20835,0.9327573085015893,9.824568888888889,895.248896,18.611365667454372,131,7.900000000000014E-4
5,test_20231101_135659,11610969.png,368720,20272,348448,0.9450206118463875,2,4,84111,2976,81135,0.9646181831151692,23.641168,3446.775301333333,12.75667388620914,131,7.900000000000014E-4
6,test_20231101_135659,10350842.png,212614,3229,209385,0.9848128533398554,1,3,42529,471,42058,0.9889252039784617,24.36172088888889,3561.434133333333,12.614554441385772,131,7.900000000000014E-4
7,test_20231101_135659,10863862.png,317432,6757,310675,0.9787135512487714,2,3,66058,994,65064,0.984952617396833,36.49882844444444,6712.9091573333335,9.861695907477596,131,7.900000000000014E-4
8,test_20231101_135659,11382381.png,312486,567,311919,0.9981855187112383,1,4,46745,75,46670,0.9983955503262381,22.72423288888889,2714.741744,13.793518398308729,131,7.900000000000014E-4
9,test_20231101_135659,11079715.png,443815,104402,339413,0.7647623446706397,3,4,124136,14654,109482,0.8819520525874847,18.204314666666665,2429.122021333333,14.276310297347752,131,7.900000000000014E-4
10,test_20231101_135659,11551286.png,271883,164,271719,0.9993967993585476,1,4,40092,22,40070,0.9994512620971765,18.120286222222223,1899.5769013333334,15.344234809036362,131,7.900000000000014E-4
1,test_20231101_135700,10404007.png,502730,15357,487373,0.9694527877787281,3,4,61265,2233,59032,0.9635517832367584,26.260865777777777,3584.812048,12.586139703637475,131,8.000000000000014E-4
2,test_20231101_135700,1254659.png,342646,63422,279224,0.8149051791061328,4,4,80080,8926,71154,0.8885364635364635,22.107413333333334,3564.834528,12.610409852338439,131,8.000000000000014E-4
3,test_20231101_135700,10188041.png,221231,7862,213369,0.9644624849139587,2,4,41731,1117,40614,0.9732333277419664,12.237685333333333,1418.6957333333332,16.611910982529146,131,8.000000000000014E-4
4,test_20231101_135700,10287332.png,216980,10917,206063,0.9496866070605585,2,4,22337,1502,20835,0.9327573085015893,9.824568888888889,895.248896,18.611365667454372,131,8.000000000000014E-4
5,test_20231101_135700,11610969.png,368720,20272,348448,0.9450206118463875,3,4,84111,2976,81135,0.9646181831151692,23.641168,3446.775301333333,12.75667388620914,131,8.000000000000014E-4
6,test_20231101_135700,10350842.png,212614,3229,209385,0.9848128533398554,1,3,42529,471,42058,0.9889252039784617,24.36172088888889,3561.434133333333,12.614554441385772,131,8.000000000000014E-4
7,test_20231101_135700,10863862.png,317432,6757,310675,0.9787135512487714,2,3,66058,994,65064,0.984952617396833,36.49882844444444,6712.9091573333335,9.861695907477596,131,8.000000000000014E-4
8,test_20231101_135700,11382381.png,312486,567,311919,0.9981855187112383,2,3,46745,75,46670,0.9983955503262381,22.72423288888889,2714.741744,13.793518398308729,131,8.000000000000014E-4
9,test_20231101_135700,11079715.png,443815,104402,339413,0.7647623446706397,3,5,124136,14654,109482,0.8819520525874847,18.204314666666665,2429.122021333333,14.276310297347752,131,8.000000000000014E-4
10,test_20231101_135700,11551286.png,271883,164,271719,0.9993967993585476,1,3,40092,22,40070,0.9994512620971765,18.120286222222223,1899.5769013333334,15.344234809036362,131,8.000000000000014E-4
1,test_20231101_135700,10404007.png,502730,15357,487373,0.9694527877787281,2,4,61265,2233,59032,0.9635517832367584,26.260865777777777,3584.812048,12.586139703637475,131,8.100000000000015E-4
2,test_20231101_135700,1254659.png,342646,63422,279224,0.8149051791061328,3,4,80080,8926,71154,0.8885364635364635,22.107413333333334,3564.834528,12.610409852338439,131,8.100000000000015E-4
3,test_20231101_135700,10188041.png,221231,7862,213369,0.9644624849139587,2,3,41731,1117,40614,0.9732333277419664,12.237685333333333,1418.6957333333332,16.611910982529146,131,8.100000000000015E-4
4,test_20231101_135700,10287332.png,216980,10917,206063,0.9496866070605585,2,4,22337,1502,20835,0.9327573085015893,9.824568888888889,895.248896,18.611365667454372,131,8.100000000000015E-4
5,test_20231101_135700,11610969.png,368720,20272,348448,0.9450206118463875,2,5,84111,2976,81135,0.9646181831151692,23.641168,3446.775301333333,12.75667388620914,131,8.100000000000015E-4
6,test_20231101_135700,10350842.png,212614,3229,209385,0.9848128533398554,2,3,42529,471,42058,0.9889252039784617,24.36172088888889,3561.434133333333,12.614554441385772,131,8.100000000000015E-4
7,test_20231101_135700,10863862.png,317432,6757,310675,0.9787135512487714,2,4,66058,994,65064,0.984952617396833,36.49882844444444,6712.9091573333335,9.861695907477596,131,8.100000000000015E-4
8,test_20231101_135700,11382381.png,312486,567,311919,0.9981855187112383,1,3,46745,75,46670,0.9983955503262381,22.72423288888889,2714.741744,13.793518398308729,131,8.100000000000015E-4
9,test_20231101_135700,11079715.png,443815,104402,339413,0.7647623446706397,3,4,124136,14654,109482,0.8819520525874847,18.204314666666665,2429.122021333333,14.276310297347752,131,8.100000000000015E-4
10,test_20231101_135700,11551286.png,271883,164,271719,0.9993967993585476,1,3,40092,22,40070,0.9994512620971765,18.120286222222223,1899.5769013333334,15.344234809036362,131,8.100000000000015E-4
1,test_20231101_135701,10404007.png,502730,15357,487373,0.9694527877787281,2,4,61265,2233,59032,0.9635517832367584,26.260865777777777,3584.812048,12.586139703637475,131,8.200000000000015E-4
2,test_20231101_135701,1254659.png,342646,63422,279224,0.8149051791061328,2,4,80080,8926,71154,0.8885364635364635,22.107413333333334,3564.834528,12.610409852338439,131,8.200000000000015E-4
3,test_20231101_135701,10188041.png,221231,7862,213369,0.9644624849139587,1,3,41731,1117,40614,0.9732333277419664,12.237685333333333,1418.6957333333332,16.611910982529146,131,8.200000000000015E-4
4,test_20231101_135701,10287332.png,216980,10917,206063,0.9496866070605585,1,3,22337,1502,20835,0.9327573085015893,9.824568888888889,895.248896,18.611365667454372,131,8.200000000000015E-4
5,test_20231101_135701,11610969.png,368720,20272,348448,0.9450206118463875,3,3,84111,2976,81135,0.9646181831151692,23.641168,3446.775301333333,12.75667388620914,131,8.200000000000015E-4
6,test_20231101_135701,10350842.png,212614,3229,209385,0.9848128533398554,1,4,42529,471,42058,0.9889252039784617,24.36172088888889,3561.434133333333,12.614554441385772,131,8.200000000000015E-4
7,test_20231101_135701,10863862.png,317432,6757,310675,0.9787135512487714,2,4,66058,994,65064,0.984952617396833,36.49882844444444,6712.9091573333335,9.861695907477596,131,8.200000000000015E-4
8,test_20231101_135701,11382381.png,312486,567,311919,0.9981855187112383,2,3,46745,75,46670,0.9983955503262381,22.72423288888889,2714.741744,13.793518398308729,131,8.200000000000015E-4
9,test_20231101_135701,11079715.png,443815,104402,339413,0.7647623446706397,3,4,124136,14654,109482,0.8819520525874847,18.204314666666665,2429.122021333333,14.276310297347752,131,8.200000000000015E-4
10,test_20231101_135701,11551286.png,271883,164,271719,0.9993967993585476,1,13,40092,22,40070,0.9994512620971765,18.120286222222223,1899.5769013333334,15.344234809036362,131,8.200000000000015E-4
1,test_20231101_135702,10404007.png,502730,15357,487373,0.9694527877787281,2,4,61265,2233,59032,0.9635517832367584,26.260865777777777,3584.812048,12.586139703637475,131,8.300000000000015E-4
2,test_20231101_135702,1254659.png,342646,63422,279224,0.8149051791061328,3,4,80080,8926,71154,0.8885364635364635,22.107413333333334,3564.834528,12.610409852338439,131,8.300000000000015E-4
3,test_20231101_135702,10188041.png,221231,7862,213369,0.9644624849139587,2,4,41731,1117,40614,0.9732333277419664,12.237685333333333,1418.6957333333332,16.611910982529146,131,8.300000000000015E-4
4,test_20231101_135702,10287332.png,216980,10917,206063,0.9496866070605585,2,4,22337,1502,20835,0.9327573085015893,9.824568888888889,895.248896,18.611365667454372,131,8.300000000000015E-4
5,test_20231101_135702,11610969.png,368720,20272,348448,0.9450206118463875,2,4,84111,2976,81135,0.9646181831151692,23.641168,3446.775301333333,12.75667388620914,131,8.300000000000015E-4
6,test_20231101_135702,10350842.png,212614,3229,209385,0.9848128533398554,2,3,42529,471,42058,0.9889252039784617,24.36172088888889,3561.434133333333,12.614554441385772,131,8.300000000000015E-4
7,test_20231101_135702,10863862.png,317432,6757,310675,0.9787135512487714,1,4,66058,994,65064,0.984952617396833,36.49882844444444,6712.9091573333335,9.861695907477596,131,8.300000000000015E-4
8,test_20231101_135702,11382381.png,312486,567,311919,0.9981855187112383,1,3,46745,75,46670,0.9983955503262381,22.72423288888889,2714.741744,13.793518398308729,131,8.300000000000015E-4
9,test_20231101_135702,11079715.png,443815,104402,339413,0.7647623446706397,3,4,124136,14654,109482,0.8819520525874847,18.204314666666665,2429.122021333333,14.276310297347752,131,8.300000000000015E-4
10,test_20231101_135702,11551286.png,271883,164,271719,0.9993967993585476,1,3,40092,22,40070,0.9994512620971765,18.120286222222223,1899.5769013333334,15.344234809036362,131,8.300000000000015E-4
1,test_20231101_135703,10404007.png,502730,15357,487373,0.9694527877787281,3,3,61265,2233,59032,0.9635517832367584,26.260865777777777,3584.812048,12.586139703637475,131,8.400000000000016E-4
2,test_20231101_135703,1254659.png,342646,63422,279224,0.8149051791061328,4,4,80080,8926,71154,0.8885364635364635,22.107413333333334,3564.834528,12.610409852338439,131,8.400000000000016E-4
3,test_20231101_135703,10188041.png,221231,7862,213369,0.9644624849139587,2,4,41731,1117,40614,0.9732333277419664,12.237685333333333,1418.6957333333332,16.611910982529146,131,8.400000000000016E-4
4,test_20231101_135703,10287332.png,216980,10917,206063,0.9496866070605585,2,4,22337,1502,20835,0.9327573085015893,9.824568888888889,895.248896,18.611365667454372,131,8.400000000000016E-4
5,test_20231101_135703,11610969.png,368720,20272,348448,0.9450206118463875,3,4,84111,2976,81135,0.9646181831151692,23.641168,3446.775301333333,12.75667388620914,131,8.400000000000016E-4
6,test_20231101_135703,10350842.png,212614,3229,209385,0.9848128533398554,1,3,42529,471,42058,0.9889252039784617,24.36172088888889,3561.434133333333,12.614554441385772,131,8.400000000000016E-4
7,test_20231101_135703,10863862.png,317432,6757,310675,0.9787135512487714,2,4,66058,994,65064,0.984952617396833,36.49882844444444,6712.9091573333335,9.861695907477596,131,8.400000000000016E-4
8,test_20231101_135703,11382381.png,312486,567,311919,0.9981855187112383,1,3,46745,75,46670,0.9983955503262381,22.72423288888889,2714.741744,13.793518398308729,131,8.400000000000016E-4
9,test_20231101_135703,11079715.png,443815,104402,339413,0.7647623446706397,4,6,124136,14654,109482,0.8819520525874847,18.204314666666665,2429.122021333333,14.276310297347752,131,8.400000000000016E-4
10,test_20231101_135703,11551286.png,271883,164,271719,0.9993967993585476,2,3,40092,22,40070,0.9994512620971765,18.120286222222223,1899.5769013333334,15.344234809036362,131,8.400000000000016E-4
1,test_20231101_135703,10404007.png,502730,15357,487373,0.9694527877787281,2,3,61265,2233,59032,0.9635517832367584,26.260865777777777,3584.812048,12.586139703637475,131,8.500000000000016E-4
2,test_20231101_135703,1254659.png,342646,63422,279224,0.8149051791061328,3,3,80080,8926,71154,0.8885364635364635,22.107413333333334,3564.834528,12.610409852338439,131,8.500000000000016E-4
3,test_20231101_135703,10188041.png,221231,7862,213369,0.9644624849139587,3,4,41731,1117,40614,0.9732333277419664,12.237685333333333,1418.6957333333332,16.611910982529146,131,8.500000000000016E-4
4,test_20231101_135703,10287332.png,216980,10917,206063,0.9496866070605585,2,4,22337,1502,20835,0.9327573085015893,9.824568888888889,895.248896,18.611365667454372,131,8.500000000000016E-4
5,test_20231101_135703,11610969.png,368720,20272,348448,0.9450206118463875,3,3,84111,2976,81135,0.9646181831151692,23.641168,3446.775301333333,12.75667388620914,131,8.500000000000016E-4
6,test_20231101_135703,10350842.png,212614,3229,209385,0.9848128533398554,1,4,42529,471,42058,0.9889252039784617,24.36172088888889,3561.434133333333,12.614554441385772,131,8.500000000000016E-4
7,test_20231101_135703,10863862.png,317432,6757,310675,0.9787135512487714,1,4,66058,994,65064,0.984952617396833,36.49882844444444,6712.9091573333335,9.861695907477596,131,8.500000000000016E-4
8,test_20231101_135703,11382381.png,312486,567,311919,0.9981855187112383,1,3,46745,75,46670,0.9983955503262381,22.72423288888889,2714.741744,13.793518398308729,131,8.500000000000016E-4
9,test_20231101_135703,11079715.png,443815,104402,339413,0.7647623446706397,4,5,124136,14654,109482,0.8819520525874847,18.204314666666665,2429.122021333333,14.276310297347752,131,8.500000000000016E-4
10,test_20231101_135703,11551286.png,271883,164,271719,0.9993967993585476,1,4,40092,22,40070,0.9994512620971765,18.120286222222223,1899.5769013333334,15.344234809036362,131,8.500000000000016E-4
1,test_20231101_135704,10404007.png,502730,15357,487373,0.9694527877787281,3,3,61265,2233,59032,0.9635517832367584,26.260865777777777,3584.812048,12.586139703637475,131,8.600000000000016E-4
2,test_20231101_135704,1254659.png,342646,63422,279224,0.8149051791061328,3,4,80080,8926,71154,0.8885364635364635,22.107413333333334,3564.834528,12.610409852338439,131,8.600000000000016E-4
3,test_20231101_135704,10188041.png,221231,7862,213369,0.9644624849139587,2,4,41731,1117,40614,0.9732333277419664,12.237685333333333,1418.6957333333332,16.611910982529146,131,8.600000000000016E-4
4,test_20231101_135704,10287332.png,216980,10917,206063,0.9496866070605585,2,3,22337,1502,20835,0.9327573085015893,9.824568888888889,895.248896,18.611365667454372,131,8.600000000000016E-4
5,test_20231101_135704,11610969.png,368720,20272,348448,0.9450206118463875,3,3,84111,2976,81135,0.9646181831151692,23.641168,3446.775301333333,12.75667388620914,131,8.600000000000016E-4
6,test_20231101_135704,10350842.png,212614,3229,209385,0.9848128533398554,2,4,42529,471,42058,0.9889252039784617,24.36172088888889,3561.434133333333,12.614554441385772,131,8.600000000000016E-4
7,test_20231101_135704,10863862.png,317432,6757,310675,0.9787135512487714,1,3,66058,994,65064,0.984952617396833,36.49882844444444,6712.9091573333335,9.861695907477596,131,8.600000000000016E-4
8,test_20231101_135704,11382381.png,312486,567,311919,0.9981855187112383,1,4,46745,75,46670,0.9983955503262381,22.72423288888889,2714.741744,13.793518398308729,131,8.600000000000016E-4
9,test_20231101_135704,11079715.png,443815,104402,339413,0.7647623446706397,3,4,124136,14654,109482,0.8819520525874847,18.204314666666665,2429.122021333333,14.276310297347752,131,8.600000000000016E-4
10,test_20231101_135704,11551286.png,271883,164,271719,0.9993967993585476,2,3,40092,22,40070,0.9994512620971765,18.120286222222223,1899.5769013333334,15.344234809036362,131,8.600000000000016E-4
1,test_20231101_135705,10404007.png,502730,15357,487373,0.9694527877787281,2,4,61265,2233,59032,0.9635517832367584,26.260865777777777,3584.812048,12.586139703637475,131,8.700000000000016E-4
2,test_20231101_135705,1254659.png,342646,63422,279224,0.8149051791061328,2,3,80080,8926,71154,0.8885364635364635,22.107413333333334,3564.834528,12.610409852338439,131,8.700000000000016E-4
3,test_20231101_135705,10188041.png,221231,7862,213369,0.9644624849139587,2,4,41731,1117,40614,0.9732333277419664,12.237685333333333,1418.6957333333332,16.611910982529146,131,8.700000000000016E-4
4,test_20231101_135705,10287332.png,216980,10917,206063,0.9496866070605585,1,4,22337,1502,20835,0.9327573085015893,9.824568888888889,895.248896,18.611365667454372,131,8.700000000000016E-4
5,test_20231101_135705,11610969.png,368720,20272,348448,0.9450206118463875,2,4,84111,2976,81135,0.9646181831151692,23.641168,3446.775301333333,12.75667388620914,131,8.700000000000016E-4
6,test_20231101_135705,10350842.png,212614,3229,209385,0.9848128533398554,2,3,42529,471,42058,0.9889252039784617,24.36172088888889,3561.434133333333,12.614554441385772,131,8.700000000000016E-4
7,test_20231101_135705,10863862.png,317432,6757,310675,0.9787135512487714,1,4,66058,994,65064,0.984952617396833,36.49882844444444,6712.9091573333335,9.861695907477596,131,8.700000000000016E-4
8,test_20231101_135705,11382381.png,312486,567,311919,0.9981855187112383,1,3,46745,75,46670,0.9983955503262381,22.72423288888889,2714.741744,13.793518398308729,131,8.700000000000016E-4
9,test_20231101_135705,11079715.png,443815,104402,339413,0.7647623446706397,3,4,124136,14654,109482,0.8819520525874847,18.204314666666665,2429.122021333333,14.276310297347752,131,8.700000000000016E-4
10,test_20231101_135705,11551286.png,271883,164,271719,0.9993967993585476,1,3,40092,22,40070,0.9994512620971765,18.120286222222223,1899.5769013333334,15.344234809036362,131,8.700000000000016E-4
1,test_20231101_135705,10404007.png,502730,15357,487373,0.9694527877787281,3,3,61265,2233,59032,0.9635517832367584,26.260865777777777,3584.812048,12.586139703637475,131,8.800000000000017E-4
2,test_20231101_135705,1254659.png,342646,63422,279224,0.8149051791061328,3,4,80080,8926,71154,0.8885364635364635,22.107413333333334,3564.834528,12.610409852338439,131,8.800000000000017E-4
3,test_20231101_135705,10188041.png,221231,7862,213369,0.9644624849139587,1,4,41731,1117,40614,0.9732333277419664,12.237685333333333,1418.6957333333332,16.611910982529146,131,8.800000000000017E-4
4,test_20231101_135705,10287332.png,216980,10917,206063,0.9496866070605585,1,4,22337,1502,20835,0.9327573085015893,9.824568888888889,895.248896,18.611365667454372,131,8.800000000000017E-4
5,test_20231101_135705,11610969.png,368720,20272,348448,0.9450206118463875,2,4,84111,2976,81135,0.9646181831151692,23.641168,3446.775301333333,12.75667388620914,131,8.800000000000017E-4
6,test_20231101_135705,10350842.png,212614,3229,209385,0.9848128533398554,2,4,42529,471,42058,0.9889252039784617,24.36172088888889,3561.434133333333,12.614554441385772,131,8.800000000000017E-4
7,test_20231101_135705,10863862.png,317432,6757,310675,0.9787135512487714,2,3,66058,994,65064,0.984952617396833,36.49882844444444,6712.9091573333335,9.861695907477596,131,8.800000000000017E-4
8,test_20231101_135705,11382381.png,312486,567,311919,0.9981855187112383,2,3,46745,75,46670,0.9983955503262381,22.72423288888889,2714.741744,13.793518398308729,131,8.800000000000017E-4
9,test_20231101_135705,11079715.png,443815,104402,339413,0.7647623446706397,3,5,124136,14654,109482,0.8819520525874847,18.204314666666665,2429.122021333333,14.276310297347752,131,8.800000000000017E-4
10,test_20231101_135705,11551286.png,271883,164,271719,0.9993967993585476,2,3,40092,22,40070,0.9994512620971765,18.120286222222223,1899.5769013333334,15.344234809036362,131,8.800000000000017E-4
1,test_20231101_135706,10404007.png,502730,15357,487373,0.9694527877787281,2,4,61265,2233,59032,0.9635517832367584,26.260865777777777,3584.812048,12.586139703637475,131,8.900000000000017E-4
2,test_20231101_135706,1254659.png,342646,63422,279224,0.8149051791061328,3,4,80080,8926,71154,0.8885364635364635,22.107413333333334,3564.834528,12.610409852338439,131,8.900000000000017E-4
3,test_20231101_135706,10188041.png,221231,7862,213369,0.9644624849139587,2,4,41731,1117,40614,0.9732333277419664,12.237685333333333,1418.6957333333332,16.611910982529146,131,8.900000000000017E-4
4,test_20231101_135706,10287332.png,216980,10917,206063,0.9496866070605585,1,4,22337,1502,20835,0.9327573085015893,9.824568888888889,895.248896,18.611365667454372,131,8.900000000000017E-4
5,test_20231101_135706,11610969.png,368720,20272,348448,0.9450206118463875,3,3,84111,2976,81135,0.9646181831151692,23.641168,3446.775301333333,12.75667388620914,131,8.900000000000017E-4
6,test_20231101_135706,10350842.png,212614,3229,209385,0.9848128533398554,2,3,42529,471,42058,0.9889252039784617,24.36172088888889,3561.434133333333,12.614554441385772,131,8.900000000000017E-4
7,test_20231101_135706,10863862.png,317432,6757,310675,0.9787135512487714,2,3,66058,994,65064,0.984952617396833,36.49882844444444,6712.9091573333335,9.861695907477596,131,8.900000000000017E-4
8,test_20231101_135706,11382381.png,312486,567,311919,0.9981855187112383,1,4,46745,75,46670,0.9983955503262381,22.72423288888889,2714.741744,13.793518398308729,131,8.900000000000017E-4
9,test_20231101_135706,11079715.png,443815,104402,339413,0.7647623446706397,3,5,124136,14654,109482,0.8819520525874847,18.204314666666665,2429.122021333333,14.276310297347752,131,8.900000000000017E-4
10,test_20231101_135706,11551286.png,271883,164,271719,0.9993967993585476,1,4,40092,22,40070,0.9994512620971765,18.120286222222223,1899.5769013333334,15.344234809036362,131,8.900000000000017E-4
1,test_20231101_135707,10404007.png,502730,14654,488076,0.970851152706224,1,3,61265,2132,59133,0.9652003590957317,26.640064,3669.864821333333,12.484302934632945,131,9.000000000000017E-4
2,test_20231101_135707,1254659.png,342646,63422,279224,0.8149051791061328,3,4,80080,8926,71154,0.8885364635364635,22.107413333333334,3564.834528,12.610409852338439,131,9.000000000000017E-4
3,test_20231101_135707,10188041.png,221231,7862,213369,0.9644624849139587,2,4,41731,1117,40614,0.9732333277419664,12.237685333333333,1418.6957333333332,16.611910982529146,131,9.000000000000017E-4
4,test_20231101_135707,10287332.png,216980,10917,206063,0.9496866070605585,2,3,22337,1502,20835,0.9327573085015893,9.824568888888889,895.248896,18.611365667454372,131,9.000000000000017E-4
5,test_20231101_135707,11610969.png,368720,20272,348448,0.9450206118463875,2,4,84111,2976,81135,0.9646181831151692,23.641168,3446.775301333333,12.75667388620914,131,9.000000000000017E-4
6,test_20231101_135707,10350842.png,212614,3229,209385,0.9848128533398554,1,4,42529,471,42058,0.9889252039784617,24.36172088888889,3561.434133333333,12.614554441385772,131,9.000000000000017E-4
7,test_20231101_135707,10863862.png,317432,6757,310675,0.9787135512487714,2,3,66058,994,65064,0.984952617396833,36.49882844444444,6712.9091573333335,9.861695907477596,131,9.000000000000017E-4
8,test_20231101_135707,11382381.png,312486,567,311919,0.9981855187112383,1,5,46745,75,46670,0.9983955503262381,22.72423288888889,2714.741744,13.793518398308729,131,9.000000000000017E-4
9,test_20231101_135707,11079715.png,443815,104402,339413,0.7647623446706397,3,5,124136,14654,109482,0.8819520525874847,18.204314666666665,2429.122021333333,14.276310297347752,131,9.000000000000017E-4
10,test_20231101_135707,11551286.png,271883,164,271719,0.9993967993585476,1,4,40092,22,40070,0.9994512620971765,18.120286222222223,1899.5769013333334,15.344234809036362,131,9.000000000000017E-4
1,test_20231101_135707,10404007.png,502730,14654,488076,0.970851152706224,2,4,61265,2132,59133,0.9652003590957317,26.640064,3669.864821333333,12.484302934632945,131,9.100000000000017E-4
2,test_20231101_135707,1254659.png,342646,63422,279224,0.8149051791061328,3,4,80080,8926,71154,0.8885364635364635,22.107413333333334,3564.834528,12.610409852338439,131,9.100000000000017E-4
3,test_20231101_135707,10188041.png,221231,7862,213369,0.9644624849139587,2,4,41731,1117,40614,0.9732333277419664,12.237685333333333,1418.6957333333332,16.611910982529146,131,9.100000000000017E-4
4,test_20231101_135707,10287332.png,216980,10917,206063,0.9496866070605585,2,4,22337,1502,20835,0.9327573085015893,9.824568888888889,895.248896,18.611365667454372,131,9.100000000000017E-4
5,test_20231101_135707,11610969.png,368720,20272,348448,0.9450206118463875,3,4,84111,2976,81135,0.9646181831151692,23.641168,3446.775301333333,12.75667388620914,131,9.100000000000017E-4
6,test_20231101_135707,10350842.png,212614,3229,209385,0.9848128533398554,1,3,42529,471,42058,0.9889252039784617,24.36172088888889,3561.434133333333,12.614554441385772,131,9.100000000000017E-4
7,test_20231101_135707,10863862.png,317432,6757,310675,0.9787135512487714,1,4,66058,994,65064,0.984952617396833,36.49882844444444,6712.9091573333335,9.861695907477596,131,9.100000000000017E-4
8,test_20231101_135707,11382381.png,312486,567,311919,0.9981855187112383,1,3,46745,75,46670,0.9983955503262381,22.72423288888889,2714.741744,13.793518398308729,131,9.100000000000017E-4
9,test_20231101_135707,11079715.png,443815,104402,339413,0.7647623446706397,3,4,124136,14654,109482,0.8819520525874847,18.204314666666665,2429.122021333333,14.276310297347752,131,9.100000000000017E-4
10,test_20231101_135707,11551286.png,271883,164,271719,0.9993967993585476,1,4,40092,22,40070,0.9994512620971765,18.120286222222223,1899.5769013333334,15.344234809036362,131,9.100000000000017E-4
1,test_20231101_135708,10404007.png,502730,14654,488076,0.970851152706224,2,3,61265,2132,59133,0.9652003590957317,26.640064,3669.864821333333,12.484302934632945,131,9.200000000000018E-4
2,test_20231101_135708,1254659.png,342646,63422,279224,0.8149051791061328,3,4,80080,8926,71154,0.8885364635364635,22.107413333333334,3564.834528,12.610409852338439,131,9.200000000000018E-4
3,test_20231101_135708,10188041.png,221231,7862,213369,0.9644624849139587,2,4,41731,1117,40614,0.9732333277419664,12.237685333333333,1418.6957333333332,16.611910982529146,131,9.200000000000018E-4
4,test_20231101_135708,10287332.png,216980,10917,206063,0.9496866070605585,2,3,22337,1502,20835,0.9327573085015893,9.824568888888889,895.248896,18.611365667454372,131,9.200000000000018E-4
5,test_20231101_135708,11610969.png,368720,20272,348448,0.9450206118463875,2,4,84111,2976,81135,0.9646181831151692,23.641168,3446.775301333333,12.75667388620914,131,9.200000000000018E-4
6,test_20231101_135708,10350842.png,212614,3229,209385,0.9848128533398554,1,4,42529,471,42058,0.9889252039784617,24.36172088888889,3561.434133333333,12.614554441385772,131,9.200000000000018E-4
7,test_20231101_135708,10863862.png,317432,6757,310675,0.9787135512487714,1,3,66058,994,65064,0.984952617396833,36.49882844444444,6712.9091573333335,9.861695907477596,131,9.200000000000018E-4
8,test_20231101_135708,11382381.png,312486,567,311919,0.9981855187112383,2,4,46745,75,46670,0.9983955503262381,22.72423288888889,2714.741744,13.793518398308729,131,9.200000000000018E-4
9,test_20231101_135708,11079715.png,443815,104402,339413,0.7647623446706397,3,4,124136,14654,109482,0.8819520525874847,18.204314666666665,2429.122021333333,14.276310297347752,131,9.200000000000018E-4
10,test_20231101_135708,11551286.png,271883,164,271719,0.9993967993585476,2,4,40092,22,40070,0.9994512620971765,18.120286222222223,1899.5769013333334,15.344234809036362,131,9.200000000000018E-4
1,test_20231101_135709,10404007.png,502730,14654,488076,0.970851152706224,2,3,61265,2132,59133,0.9652003590957317,26.640064,3669.864821333333,12.484302934632945,131,9.300000000000018E-4
2,test_20231101_135709,1254659.png,342646,63422,279224,0.8149051791061328,3,4,80080,8926,71154,0.8885364635364635,22.107413333333334,3564.834528,12.610409852338439,131,9.300000000000018E-4
3,test_20231101_135709,10188041.png,221231,7862,213369,0.9644624849139587,1,3,41731,1117,40614,0.9732333277419664,12.237685333333333,1418.6957333333332,16.611910982529146,131,9.300000000000018E-4
4,test_20231101_135709,10287332.png,216980,10917,206063,0.9496866070605585,2,3,22337,1502,20835,0.9327573085015893,9.824568888888889,895.248896,18.611365667454372,131,9.300000000000018E-4
5,test_20231101_135709,11610969.png,368720,20272,348448,0.9450206118463875,2,3,84111,2976,81135,0.9646181831151692,23.641168,3446.775301333333,12.75667388620914,131,9.300000000000018E-4
6,test_20231101_135709,10350842.png,212614,3229,209385,0.9848128533398554,1,4,42529,471,42058,0.9889252039784617,24.36172088888889,3561.434133333333,12.614554441385772,131,9.300000000000018E-4
7,test_20231101_135709,10863862.png,317432,6757,310675,0.9787135512487714,2,3,66058,994,65064,0.984952617396833,36.49882844444444,6712.9091573333335,9.861695907477596,131,9.300000000000018E-4
8,test_20231101_135709,11382381.png,312486,567,311919,0.9981855187112383,1,3,46745,75,46670,0.9983955503262381,22.72423288888889,2714.741744,13.793518398308729,131,9.300000000000018E-4
9,test_20231101_135709,11079715.png,443815,104402,339413,0.7647623446706397,3,4,124136,14654,109482,0.8819520525874847,18.204314666666665,2429.122021333333,14.276310297347752,131,9.300000000000018E-4
10,test_20231101_135709,11551286.png,271883,24,271859,0.9999117267353972,1,3,40092,1,40091,0.9999750573680535,24.866876444444443,3470.407338666667,12.72699907819776,131,9.300000000000018E-4
1,test_20231101_135709,10404007.png,502730,14654,488076,0.970851152706224,3,3,61265,2132,59133,0.9652003590957317,26.640064,3669.864821333333,12.484302934632945,131,9.400000000000018E-4
2,test_20231101_135709,1254659.png,342646,63422,279224,0.8149051791061328,3,4,80080,8926,71154,0.8885364635364635,22.107413333333334,3564.834528,12.610409852338439,131,9.400000000000018E-4
3,test_20231101_135709,10188041.png,221231,7862,213369,0.9644624849139587,2,3,41731,1117,40614,0.9732333277419664,12.237685333333333,1418.6957333333332,16.611910982529146,131,9.400000000000018E-4
4,test_20231101_135709,10287332.png,216980,10917,206063,0.9496866070605585,2,3,22337,1502,20835,0.9327573085015893,9.824568888888889,895.248896,18.611365667454372,131,9.400000000000018E-4
5,test_20231101_135709,11610969.png,368720,20272,348448,0.9450206118463875,2,4,84111,2976,81135,0.9646181831151692,23.641168,3446.775301333333,12.75667388620914,131,9.400000000000018E-4
6,test_20231101_135709,10350842.png,212614,3229,209385,0.9848128533398554,1,3,42529,471,42058,0.9889252039784617,24.36172088888889,3561.434133333333,12.614554441385772,131,9.400000000000018E-4
7,test_20231101_135709,10863862.png,317432,6757,310675,0.9787135512487714,1,4,66058,994,65064,0.984952617396833,36.49882844444444,6712.9091573333335,9.861695907477596,131,9.400000000000018E-4
8,test_20231101_135709,11382381.png,312486,567,311919,0.9981855187112383,1,4,46745,75,46670,0.9983955503262381,22.72423288888889,2714.741744,13.793518398308729,131,9.400000000000018E-4
9,test_20231101_135709,11079715.png,443815,104402,339413,0.7647623446706397,3,4,124136,14654,109482,0.8819520525874847,18.204314666666665,2429.122021333333,14.276310297347752,131,9.400000000000018E-4
10,test_20231101_135709,11551286.png,271883,24,271859,0.9999117267353972,1,4,40092,1,40091,0.9999750573680535,24.866876444444443,3470.407338666667,12.72699907819776,131,9.400000000000018E-4
1,test_20231101_135710,10404007.png,502730,14654,488076,0.970851152706224,3,4,61265,2132,59133,0.9652003590957317,26.640064,3669.864821333333,12.484302934632945,131,9.500000000000018E-4
2,test_20231101_135710,1254659.png,342646,63422,279224,0.8149051791061328,3,4,80080,8926,71154,0.8885364635364635,22.107413333333334,3564.834528,12.610409852338439,131,9.500000000000018E-4
3,test_20231101_135710,10188041.png,221231,7862,213369,0.9644624849139587,2,4,41731,1117,40614,0.9732333277419664,12.237685333333333,1418.6957333333332,16.611910982529146,131,9.500000000000018E-4
4,test_20231101_135710,10287332.png,216980,10917,206063,0.9496866070605585,1,3,22337,1502,20835,0.9327573085015893,9.824568888888889,895.248896,18.611365667454372,131,9.500000000000018E-4
5,test_20231101_135710,11610969.png,368720,20272,348448,0.9450206118463875,2,4,84111,2976,81135,0.9646181831151692,23.641168,3446.775301333333,12.75667388620914,131,9.500000000000018E-4
6,test_20231101_135710,10350842.png,212614,3229,209385,0.9848128533398554,2,3,42529,471,42058,0.9889252039784617,24.36172088888889,3561.434133333333,12.614554441385772,131,9.500000000000018E-4
7,test_20231101_135710,10863862.png,317432,6757,310675,0.9787135512487714,1,3,66058,994,65064,0.984952617396833,36.49882844444444,6712.9091573333335,9.861695907477596,131,9.500000000000018E-4
8,test_20231101_135710,11382381.png,312486,567,311919,0.9981855187112383,1,3,46745,75,46670,0.9983955503262381,22.72423288888889,2714.741744,13.793518398308729,131,9.500000000000018E-4
9,test_20231101_135710,11079715.png,443815,104402,339413,0.7647623446706397,3,4,124136,14654,109482,0.8819520525874847,18.204314666666665,2429.122021333333,14.276310297347752,131,9.500000000000018E-4
10,test_20231101_135710,11551286.png,271883,24,271859,0.9999117267353972,1,4,40092,1,40091,0.9999750573680535,24.866876444444443,3470.407338666667,12.72699907819776,131,9.500000000000018E-4
1,test_20231101_135711,10404007.png,502730,14654,488076,0.970851152706224,2,4,61265,2132,59133,0.9652003590957317,26.640064,3669.864821333333,12.484302934632945,131,9.600000000000019E-4
2,test_20231101_135711,1254659.png,342646,63422,279224,0.8149051791061328,3,4,80080,8926,71154,0.8885364635364635,22.107413333333334,3564.834528,12.610409852338439,131,9.600000000000019E-4
3,test_20231101_135711,10188041.png,221231,7862,213369,0.9644624849139587,2,4,41731,1117,40614,0.9732333277419664,12.237685333333333,1418.6957333333332,16.611910982529146,131,9.600000000000019E-4
4,test_20231101_135711,10287332.png,216980,10917,206063,0.9496866070605585,2,4,22337,1502,20835,0.9327573085015893,9.824568888888889,895.248896,18.611365667454372,131,9.600000000000019E-4
5,test_20231101_135711,11610969.png,368720,20272,348448,0.9450206118463875,3,4,84111,2976,81135,0.9646181831151692,23.641168,3446.775301333333,12.75667388620914,131,9.600000000000019E-4
6,test_20231101_135711,10350842.png,212614,3229,209385,0.9848128533398554,1,4,42529,471,42058,0.9889252039784617,24.36172088888889,3561.434133333333,12.614554441385772,131,9.600000000000019E-4
7,test_20231101_135711,10863862.png,317432,6757,310675,0.9787135512487714,2,10,66058,994,65064,0.984952617396833,36.49882844444444,6712.9091573333335,9.861695907477596,131,9.600000000000019E-4
8,test_20231101_135711,11382381.png,312486,567,311919,0.9981855187112383,2,4,46745,75,46670,0.9983955503262381,22.72423288888889,2714.741744,13.793518398308729,131,9.600000000000019E-4
9,test_20231101_135711,11079715.png,443815,104402,339413,0.7647623446706397,4,4,124136,14654,109482,0.8819520525874847,18.204314666666665,2429.122021333333,14.276310297347752,131,9.600000000000019E-4
10,test_20231101_135711,11551286.png,271883,24,271859,0.9999117267353972,1,3,40092,1,40091,0.9999750573680535,24.866876444444443,3470.407338666667,12.72699907819776,131,9.600000000000019E-4
1,test_20231101_135711,10404007.png,502730,14654,488076,0.970851152706224,2,4,61265,2132,59133,0.9652003590957317,26.640064,3669.864821333333,12.484302934632945,131,9.700000000000019E-4
2,test_20231101_135711,1254659.png,342646,63422,279224,0.8149051791061328,3,4,80080,8926,71154,0.8885364635364635,22.107413333333334,3564.834528,12.610409852338439,131,9.700000000000019E-4
3,test_20231101_135711,10188041.png,221231,7862,213369,0.9644624849139587,2,4,41731,1117,40614,0.9732333277419664,12.237685333333333,1418.6957333333332,16.611910982529146,131,9.700000000000019E-4
4,test_20231101_135711,10287332.png,216980,10917,206063,0.9496866070605585,1,3,22337,1502,20835,0.9327573085015893,9.824568888888889,895.248896,18.611365667454372,131,9.700000000000019E-4
5,test_20231101_135711,11610969.png,368720,20272,348448,0.9450206118463875,3,3,84111,2976,81135,0.9646181831151692,23.641168,3446.775301333333,12.75667388620914,131,9.700000000000019E-4
6,test_20231101_135711,10350842.png,212614,3229,209385,0.9848128533398554,1,4,42529,471,42058,0.9889252039784617,24.36172088888889,3561.434133333333,12.614554441385772,131,9.700000000000019E-4
7,test_20231101_135711,10863862.png,317432,6757,310675,0.9787135512487714,1,3,66058,994,65064,0.984952617396833,36.49882844444444,6712.9091573333335,9.861695907477596,131,9.700000000000019E-4
8,test_20231101_135711,11382381.png,312486,567,311919,0.9981855187112383,2,4,46745,75,46670,0.9983955503262381,22.72423288888889,2714.741744,13.793518398308729,131,9.700000000000019E-4
9,test_20231101_135711,11079715.png,443815,104402,339413,0.7647623446706397,3,4,124136,14654,109482,0.8819520525874847,18.204314666666665,2429.122021333333,14.276310297347752,131,9.700000000000019E-4
10,test_20231101_135711,11551286.png,271883,24,271859,0.9999117267353972,1,4,40092,1,40091,0.9999750573680535,24.866876444444443,3470.407338666667,12.72699907819776,131,9.700000000000019E-4
1,test_20231101_135712,10404007.png,502730,14032,488698,0.9720883973504665,2,3,61265,2042,59223,0.9666693870888762,26.740097777777777,3696.926032,12.452395995605873,131,9.80000000000002E-4
2,test_20231101_135712,1254659.png,342646,63202,279444,0.8155472411760243,3,4,80080,8902,71178,0.8888361638361638,22.216220444444446,3587.384608,12.58302420440101,131,9.80000000000002E-4
3,test_20231101_135712,10188041.png,221231,7722,213509,0.9650953076196374,2,3,41731,1104,40627,0.9735448467566078,12.360238222222222,1458.5383786666666,16.491624996255407,131,9.80000000000002E-4
4,test_20231101_135712,10287332.png,216980,10837,206143,0.950055304636372,2,4,22337,1490,20847,0.9332945337332677,9.850129777777777,899.4188693333333,18.591183662713203,131,9.80000000000002E-4
5,test_20231101_135712,11610969.png,368720,19932,348788,0.9459427207637231,2,4,84111,2930,81181,0.9651650794783084,23.984652444444446,3509.584368,12.678246738528486,131,9.80000000000002E-4
6,test_20231101_135712,10350842.png,212614,2927,209687,0.9862332677998626,1,3,42529,428,42101,0.9899362787744833,24.522236444444445,3590.750122666667,12.578951768843748,131,9.80000000000002E-4
7,test_20231101_135712,10863862.png,317432,6657,310775,0.979028579349278,2,4,66058,979,65079,0.9851796905749493,36.51841955555555,6717.434224,9.858769382813048,131,9.80000000000002E-4
8,test_20231101_135712,11382381.png,312486,367,312119,0.9988255473845228,1,3,46745,48,46697,0.9989731522087923,23.28773511111111,2886.24232,13.527475705549977,131,9.80000000000002E-4
9,test_20231101_135712,11079715.png,443815,104322,339493,0.7649425999571894,4,4,124136,14647,109489,0.8820084423535477,18.220912,2431.481509333333,14.272093896266934,131,9.80000000000002E-4
10,test_20231101_135712,11551286.png,271883,24,271859,0.9999117267353972,0,3,40092,1,40091,0.9999750573680535,24.866876444444443,3470.407338666667,12.72699907819776,131,9.80000000000002E-4
1,test_20231101_135713,10404007.png,502730,14032,488698,0.9720883973504665,2,3,61265,2042,59223,0.9666693870888762,26.740097777777777,3696.926032,12.452395995605873,131,9.90000000000002E-4
2,test_20231101_135713,1254659.png,342646,63202,279444,0.8155472411760243,3,5,80080,8902,71178,0.8888361638361638,22.216220444444446,3587.384608,12.58302420440101,131,9.90000000000002E-4
3,test_20231101_135713,10188041.png,221231,7722,213509,0.9650953076196374,1,3,41731,1104,40627,0.9735448467566078,12.360238222222222,1458.5383786666666,16.491624996255407,131,9.90000000000002E-4
4,test_20231101_135713,10287332.png,216980,10837,206143,0.950055304636372,2,3,22337,1490,20847,0.9332945337332677,9.850129777777777,899.4188693333333,18.591183662713203,131,9.90000000000002E-4
5,test_20231101_135713,11610969.png,368720,19932,348788,0.9459427207637231,2,3,84111,2930,81181,0.9651650794783084,23.984652444444446,3509.584368,12.678246738528486,131,9.90000000000002E-4
6,test_20231101_135713,10350842.png,212614,2927,209687,0.9862332677998626,2,4,42529,428,42101,0.9899362787744833,24.522236444444445,3590.750122666667,12.578951768843748,131,9.90000000000002E-4
7,test_20231101_135713,10863862.png,317432,6657,310775,0.979028579349278,2,4,66058,979,65079,0.9851796905749493,36.51841955555555,6717.434224,9.858769382813048,131,9.90000000000002E-4
8,test_20231101_135713,11382381.png,312486,367,312119,0.9988255473845228,2,3,46745,48,46697,0.9989731522087923,23.28773511111111,2886.24232,13.527475705549977,131,9.90000000000002E-4
9,test_20231101_135713,11079715.png,443815,104322,339493,0.7649425999571894,3,4,124136,14647,109489,0.8820084423535477,18.220912,2431.481509333333,14.272093896266934,131,9.90000000000002E-4
10,test_20231101_135713,11551286.png,271883,24,271859,0.9999117267353972,1,4,40092,1,40091,0.9999750573680535,24.866876444444443,3470.407338666667,12.72699907819776,131,9.90000000000002E-4
1,test_20231101_135713,10404007.png,502730,14997,487733,0.9701688779265212,2,3,61265,2183,59082,0.9643679098996164,26.26188088888889,3595.4905386666665,12.573222105988407,132,0.0
2,test_20231101_135713,1254659.png,342646,61492,281154,0.8205378145374527,3,4,80080,8660,71420,0.8918581418581418,22.37580088888889,3655.8830826666667,12.500880625819997,132,0.0
3,test_20231101_135713,10188041.png,221231,7962,213269,0.9640104686956168,2,3,41731,1128,40603,0.9729697347295775,11.738563555555556,1370.24816,16.76281133303664,132,0.0
4,test_20231101_135713,10287332.png,216980,10607,206373,0.9511153101668357,1,3,22337,1456,20881,0.9348166718896898,9.912922666666667,943.6587786666666,18.382653764547456,132,0.0
5,test_20231101_135713,11610969.png,368720,19779,348941,0.9463576697765241,2,4,84111,2902,81209,0.965497972916741,23.214288,3392.272112,12.825896788397955,132,0.0
6,test_20231101_135713,10350842.png,212614,4557,208057,0.9785667924031343,1,3,42529,670,41859,0.9842460438759435,19.768544,2479.744469333333,14.18673430556272,132,0.0
7,test_20231101_135713,10863862.png,317432,6857,310575,0.9783985231482648,1,4,66058,1009,65049,0.9847255442187168,35.86164977777778,6559.87024,9.96185112133917,132,0.0
8,test_20231101_135713,11382381.png,312486,807,311679,0.9974174843032968,1,3,46745,110,46635,0.9976468071451492,20.579290666666665,2386.569818666667,14.353062167735953,132,0.0
9,test_20231101_135713,11079715.png,443815,101847,341968,0.7705192478848168,3,4,124136,14305,109831,0.8847634852097699,18.156124444444444,2439.9212586666667,14.25704549889165,132,0.0
10,test_20231101_135713,11551286.png,271883,637,271246,0.9976570804353343,2,3,40092,92,40000,0.9977052778609199,17.315537777777777,1773.2081386666666,15.643206449122175,132,0.0
1,test_20231101_135714,10404007.png,502730,14997,487733,0.9701688779265212,2,3,61265,2183,59082,0.9643679098996164,26.26188088888889,3595.4905386666665,12.573222105988407,132,1.0E-5
2,test_20231101_135714,1254659.png,342646,61492,281154,0.8205378145374527,2,3,80080,8660,71420,0.8918581418581418,22.37580088888889,3655.8830826666667,12.500880625819997,132,1.0E-5
3,test_20231101_135714,10188041.png,221231,7962,213269,0.9640104686956168,2,4,41731,1128,40603,0.9729697347295775,11.738563555555556,1370.24816,16.76281133303664,132,1.0E-5
4,test_20231101_135714,10287332.png,216980,10607,206373,0.9511153101668357,2,4,22337,1456,20881,0.9348166718896898,9.912922666666667,943.6587786666666,18.382653764547456,132,1.0E-5
5,test_20231101_135714,11610969.png,368720,19779,348941,0.9463576697765241,2,3,84111,2902,81209,0.965497972916741,23.214288,3392.272112,12.825896788397955,132,1.0E-5
6,test_20231101_135714,10350842.png,212614,4557,208057,0.9785667924031343,1,4,42529,670,41859,0.9842460438759435,19.768544,2479.744469333333,14.18673430556272,132,1.0E-5
7,test_20231101_135714,10863862.png,317432,6857,310575,0.9783985231482648,1,4,66058,1009,65049,0.9847255442187168,35.86164977777778,6559.87024,9.96185112133917,132,1.0E-5
8,test_20231101_135714,11382381.png,312486,807,311679,0.9974174843032968,2,4,46745,110,46635,0.9976468071451492,20.579290666666665,2386.569818666667,14.353062167735953,132,1.0E-5
9,test_20231101_135714,11079715.png,443815,101847,341968,0.7705192478848168,3,4,124136,14305,109831,0.8847634852097699,18.156124444444444,2439.9212586666667,14.25704549889165,132,1.0E-5
10,test_20231101_135714,11551286.png,271883,637,271246,0.9976570804353343,2,3,40092,92,40000,0.9977052778609199,17.315537777777777,1773.2081386666666,15.643206449122175,132,1.0E-5
1,test_20231101_135715,10404007.png,502730,14997,487733,0.9701688779265212,2,4,61265,2183,59082,0.9643679098996164,26.26188088888889,3595.4905386666665,12.573222105988407,132,2.0E-5
2,test_20231101_135715,1254659.png,342646,61492,281154,0.8205378145374527,4,4,80080,8660,71420,0.8918581418581418,22.37580088888889,3655.8830826666667,12.500880625819997,132,2.0E-5
3,test_20231101_135715,10188041.png,221231,7962,213269,0.9640104686956168,2,4,41731,1128,40603,0.9729697347295775,11.738563555555556,1370.24816,16.76281133303664,132,2.0E-5
4,test_20231101_135715,10287332.png,216980,10607,206373,0.9511153101668357,2,4,22337,1456,20881,0.9348166718896898,9.912922666666667,943.6587786666666,18.382653764547456,132,2.0E-5
5,test_20231101_135715,11610969.png,368720,19779,348941,0.9463576697765241,2,4,84111,2902,81209,0.965497972916741,23.214288,3392.272112,12.825896788397955,132,2.0E-5
6,test_20231101_135715,10350842.png,212614,4557,208057,0.9785667924031343,2,4,42529,670,41859,0.9842460438759435,19.768544,2479.744469333333,14.18673430556272,132,2.0E-5
7,test_20231101_135715,10863862.png,317432,6857,310575,0.9783985231482648,2,4,66058,1009,65049,0.9847255442187168,35.86164977777778,6559.87024,9.96185112133917,132,2.0E-5
8,test_20231101_135715,11382381.png,312486,797,311689,0.997449485736961,1,3,46745,109,46636,0.997668199807466,21.309107555555556,2485.130629333333,14.177311387814227,132,2.0E-5
9,test_20231101_135715,11079715.png,443815,101847,341968,0.7705192478848168,3,4,124136,14305,109831,0.8847634852097699,18.156124444444444,2439.9212586666667,14.25704549889165,132,2.0E-5
10,test_20231101_135715,11551286.png,271883,637,271246,0.9976570804353343,2,3,40092,92,40000,0.9977052778609199,17.315537777777777,1773.2081386666666,15.643206449122175,132,2.0E-5
1,test_20231101_135716,10404007.png,502730,14997,487733,0.9701688779265212,2,3,61265,2183,59082,0.9643679098996164,26.26188088888889,3595.4905386666665,12.573222105988407,132,3.0000000000000004E-5
2,test_20231101_135716,1254659.png,342646,61492,281154,0.8205378145374527,3,4,80080,8660,71420,0.8918581418581418,22.37580088888889,3655.8830826666667,12.500880625819997,132,3.0000000000000004E-5
3,test_20231101_135716,10188041.png,221231,7962,213269,0.9640104686956168,2,3,41731,1128,40603,0.9729697347295775,11.738563555555556,1370.24816,16.76281133303664,132,3.0000000000000004E-5
4,test_20231101_135716,10287332.png,216980,10607,206373,0.9511153101668357,2,4,22337,1456,20881,0.9348166718896898,9.912922666666667,943.6587786666666,18.382653764547456,132,3.0000000000000004E-5
5,test_20231101_135716,11610969.png,368720,19779,348941,0.9463576697765241,2,4,84111,2902,81209,0.965497972916741,23.214288,3392.272112,12.825896788397955,132,3.0000000000000004E-5
6,test_20231101_135716,10350842.png,212614,4557,208057,0.9785667924031343,1,3,42529,670,41859,0.9842460438759435,19.768544,2479.744469333333,14.18673430556272,132,3.0000000000000004E-5
7,test_20231101_135716,10863862.png,317432,6857,310575,0.9783985231482648,2,4,66058,1009,65049,0.9847255442187168,35.86164977777778,6559.87024,9.96185112133917,132,3.0000000000000004E-5
8,test_20231101_135716,11382381.png,312486,797,311689,0.997449485736961,2,4,46745,109,46636,0.997668199807466,21.309107555555556,2485.130629333333,14.177311387814227,132,3.0000000000000004E-5
9,test_20231101_135716,11079715.png,443815,101847,341968,0.7705192478848168,3,4,124136,14305,109831,0.8847634852097699,18.156124444444444,2439.9212586666667,14.25704549889165,132,3.0000000000000004E-5
10,test_20231101_135716,11551286.png,271883,637,271246,0.9976570804353343,2,3,40092,92,40000,0.9977052778609199,17.315537777777777,1773.2081386666666,15.643206449122175,132,3.0000000000000004E-5
1,test_20231101_135716,10404007.png,502730,14997,487733,0.9701688779265212,2,4,61265,2183,59082,0.9643679098996164,26.26188088888889,3595.4905386666665,12.573222105988407,132,4.0E-5
2,test_20231101_135716,1254659.png,342646,61492,281154,0.8205378145374527,3,3,80080,8660,71420,0.8918581418581418,22.37580088888889,3655.8830826666667,12.500880625819997,132,4.0E-5
3,test_20231101_135716,10188041.png,221231,7962,213269,0.9640104686956168,2,3,41731,1128,40603,0.9729697347295775,11.738563555555556,1370.24816,16.76281133303664,132,4.0E-5
4,test_20231101_135716,10287332.png,216980,10607,206373,0.9511153101668357,2,3,22337,1456,20881,0.9348166718896898,9.912922666666667,943.6587786666666,18.382653764547456,132,4.0E-5
5,test_20231101_135716,11610969.png,368720,19779,348941,0.9463576697765241,3,4,84111,2902,81209,0.965497972916741,23.214288,3392.272112,12.825896788397955,132,4.0E-5
6,test_20231101_135716,10350842.png,212614,4557,208057,0.9785667924031343,1,4,42529,670,41859,0.9842460438759435,19.768544,2479.744469333333,14.18673430556272,132,4.0E-5
7,test_20231101_135716,10863862.png,317432,6857,310575,0.9783985231482648,1,3,66058,1009,65049,0.9847255442187168,35.86164977777778,6559.87024,9.96185112133917,132,4.0E-5
8,test_20231101_135716,11382381.png,312486,797,311689,0.997449485736961,1,3,46745,109,46636,0.997668199807466,21.309107555555556,2485.130629333333,14.177311387814227,132,4.0E-5
9,test_20231101_135716,11079715.png,443815,101847,341968,0.7705192478848168,3,5,124136,14305,109831,0.8847634852097699,18.156124444444444,2439.9212586666667,14.25704549889165,132,4.0E-5
10,test_20231101_135716,11551286.png,271883,637,271246,0.9976570804353343,1,4,40092,92,40000,0.9977052778609199,17.315537777777777,1773.2081386666666,15.643206449122175,132,4.0E-5
1,test_20231101_135717,10404007.png,502730,14997,487733,0.9701688779265212,2,4,61265,2183,59082,0.9643679098996164,26.26188088888889,3595.4905386666665,12.573222105988407,132,5.0E-5
2,test_20231101_135717,1254659.png,342646,61492,281154,0.8205378145374527,3,4,80080,8660,71420,0.8918581418581418,22.37580088888889,3655.8830826666667,12.500880625819997,132,5.0E-5
3,test_20231101_135717,10188041.png,221231,7962,213269,0.9640104686956168,2,3,41731,1128,40603,0.9729697347295775,11.738563555555556,1370.24816,16.76281133303664,132,5.0E-5
4,test_20231101_135717,10287332.png,216980,10607,206373,0.9511153101668357,2,3,22337,1456,20881,0.9348166718896898,9.912922666666667,943.6587786666666,18.382653764547456,132,5.0E-5
5,test_20231101_135717,11610969.png,368720,19779,348941,0.9463576697765241,3,3,84111,2902,81209,0.965497972916741,23.214288,3392.272112,12.825896788397955,132,5.0E-5
6,test_20231101_135717,10350842.png,212614,4557,208057,0.9785667924031343,2,3,42529,670,41859,0.9842460438759435,19.768544,2479.744469333333,14.18673430556272,132,5.0E-5
7,test_20231101_135717,10863862.png,317432,6857,310575,0.9783985231482648,1,4,66058,1009,65049,0.9847255442187168,35.86164977777778,6559.87024,9.96185112133917,132,5.0E-5
8,test_20231101_135717,11382381.png,312486,797,311689,0.997449485736961,2,4,46745,109,46636,0.997668199807466,21.309107555555556,2485.130629333333,14.177311387814227,132,5.0E-5
9,test_20231101_135717,11079715.png,443815,101847,341968,0.7705192478848168,3,4,124136,14305,109831,0.8847634852097699,18.156124444444444,2439.9212586666667,14.25704549889165,132,5.0E-5
10,test_20231101_135717,11551286.png,271883,637,271246,0.9976570804353343,1,4,40092,92,40000,0.9977052778609199,17.315537777777777,1773.2081386666666,15.643206449122175,132,5.0E-5
1,test_20231101_135718,10404007.png,502730,14997,487733,0.9701688779265212,2,4,61265,2183,59082,0.9643679098996164,26.26188088888889,3595.4905386666665,12.573222105988407,132,6.0E-5
2,test_20231101_135718,1254659.png,342646,61492,281154,0.8205378145374527,3,4,80080,8660,71420,0.8918581418581418,22.37580088888889,3655.8830826666667,12.500880625819997,132,6.0E-5
3,test_20231101_135718,10188041.png,221231,7962,213269,0.9640104686956168,1,3,41731,1128,40603,0.9729697347295775,11.738563555555556,1370.24816,16.76281133303664,132,6.0E-5
4,test_20231101_135718,10287332.png,216980,10607,206373,0.9511153101668357,2,4,22337,1456,20881,0.9348166718896898,9.912922666666667,943.6587786666666,18.382653764547456,132,6.0E-5
5,test_20231101_135718,11610969.png,368720,19779,348941,0.9463576697765241,2,3,84111,2902,81209,0.965497972916741,23.214288,3392.272112,12.825896788397955,132,6.0E-5
6,test_20231101_135718,10350842.png,212614,4557,208057,0.9785667924031343,1,3,42529,670,41859,0.9842460438759435,19.768544,2479.744469333333,14.18673430556272,132,6.0E-5
7,test_20231101_135718,10863862.png,317432,6857,310575,0.9783985231482648,2,4,66058,1009,65049,0.9847255442187168,35.86164977777778,6559.87024,9.96185112133917,132,6.0E-5
8,test_20231101_135718,11382381.png,312486,797,311689,0.997449485736961,2,4,46745,109,46636,0.997668199807466,21.309107555555556,2485.130629333333,14.177311387814227,132,6.0E-5
9,test_20231101_135718,11079715.png,443815,101847,341968,0.7705192478848168,3,4,124136,14305,109831,0.8847634852097699,18.156124444444444,2439.9212586666667,14.25704549889165,132,6.0E-5
10,test_20231101_135718,11551286.png,271883,637,271246,0.9976570804353343,1,3,40092,92,40000,0.9977052778609199,17.315537777777777,1773.2081386666666,15.643206449122175,132,6.0E-5
1,test_20231101_135718,10404007.png,502730,14797,487933,0.9705667057864062,2,3,61265,2154,59111,0.964841263364074,26.346357333333334,3614.1425386666665,12.550750841051833,132,7.000000000000001E-5
2,test_20231101_135718,1254659.png,342646,61492,281154,0.8205378145374527,2,4,80080,8660,71420,0.8918581418581418,22.37580088888889,3655.8830826666667,12.500880625819997,132,7.000000000000001E-5
3,test_20231101_135718,10188041.png,221231,7962,213269,0.9640104686956168,1,3,41731,1128,40603,0.9729697347295775,11.738563555555556,1370.24816,16.76281133303664,132,7.000000000000001E-5
4,test_20231101_135718,10287332.png,216980,10607,206373,0.9511153101668357,1,3,22337,1456,20881,0.9348166718896898,9.912922666666667,943.6587786666666,18.382653764547456,132,7.000000000000001E-5
5,test_20231101_135718,11610969.png,368720,19779,348941,0.9463576697765241,2,4,84111,2902,81209,0.965497972916741,23.214288,3392.272112,12.825896788397955,132,7.000000000000001E-5
6,test_20231101_135718,10350842.png,212614,4194,208420,0.9802741117706266,2,3,42529,617,41912,0.9854922523454583,21.679027555555557,2995.340346666667,13.366341844659766,132,7.000000000000001E-5
7,test_20231101_135718,10863862.png,317432,6857,310575,0.9783985231482648,1,3,66058,1009,65049,0.9847255442187168,35.86164977777778,6559.87024,9.96185112133917,132,7.000000000000001E-5
8,test_20231101_135718,11382381.png,312486,797,311689,0.997449485736961,1,3,46745,109,46636,0.997668199807466,21.309107555555556,2485.130629333333,14.177311387814227,132,7.000000000000001E-5
9,test_20231101_135718,11079715.png,443815,101847,341968,0.7705192478848168,7,4,124136,14305,109831,0.8847634852097699,18.156124444444444,2439.9212586666667,14.25704549889165,132,7.000000000000001E-5
10,test_20231101_135718,11551286.png,271883,497,271386,0.998172007812184,2,4,40092,71,40021,0.9982290731317969,17.641870222222224,1824.312992,15.519810098595052,132,7.000000000000001E-5
1,test_20231101_135719,10404007.png,502730,14797,487933,0.9705667057864062,2,4,61265,2154,59111,0.964841263364074,26.346357333333334,3614.1425386666665,12.550750841051833,132,8.0E-5
2,test_20231101_135719,1254659.png,342646,61492,281154,0.8205378145374527,2,4,80080,8660,71420,0.8918581418581418,22.37580088888889,3655.8830826666667,12.500880625819997,132,8.0E-5
3,test_20231101_135719,10188041.png,221231,7962,213269,0.9640104686956168,2,4,41731,1128,40603,0.9729697347295775,11.738563555555556,1370.24816,16.76281133303664,132,8.0E-5
4,test_20231101_135719,10287332.png,216980,10607,206373,0.9511153101668357,2,4,22337,1456,20881,0.9348166718896898,9.912922666666667,943.6587786666666,18.382653764547456,132,8.0E-5
5,test_20231101_135719,11610969.png,368720,19779,348941,0.9463576697765241,2,4,84111,2902,81209,0.965497972916741,23.214288,3392.272112,12.825896788397955,132,8.0E-5
6,test_20231101_135719,10350842.png,212614,4194,208420,0.9802741117706266,1,4,42529,617,41912,0.9854922523454583,21.679027555555557,2995.340346666667,13.366341844659766,132,8.0E-5
7,test_20231101_135719,10863862.png,317432,6857,310575,0.9783985231482648,1,5,66058,1009,65049,0.9847255442187168,35.86164977777778,6559.87024,9.96185112133917,132,8.0E-5
8,test_20231101_135719,11382381.png,312486,797,311689,0.997449485736961,2,6,46745,109,46636,0.997668199807466,21.309107555555556,2485.130629333333,14.177311387814227,132,8.0E-5
9,test_20231101_135719,11079715.png,443815,101847,341968,0.7705192478848168,3,4,124136,14305,109831,0.8847634852097699,18.156124444444444,2439.9212586666667,14.25704549889165,132,8.0E-5
10,test_20231101_135719,11551286.png,271883,497,271386,0.998172007812184,2,3,40092,71,40021,0.9982290731317969,17.641870222222224,1824.312992,15.519810098595052,132,8.0E-5
1,test_20231101_135720,10404007.png,502730,14797,487933,0.9705667057864062,2,4,61265,2154,59111,0.964841263364074,26.346357333333334,3614.1425386666665,12.550750841051833,132,9.0E-5
2,test_20231101_135720,1254659.png,342646,61492,281154,0.8205378145374527,2,4,80080,8660,71420,0.8918581418581418,22.37580088888889,3655.8830826666667,12.500880625819997,132,9.0E-5
3,test_20231101_135720,10188041.png,221231,7962,213269,0.9640104686956168,2,4,41731,1128,40603,0.9729697347295775,11.738563555555556,1370.24816,16.76281133303664,132,9.0E-5
4,test_20231101_135720,10287332.png,216980,10607,206373,0.9511153101668357,2,4,22337,1456,20881,0.9348166718896898,9.912922666666667,943.6587786666666,18.382653764547456,132,9.0E-5
5,test_20231101_135720,11610969.png,368720,19779,348941,0.9463576697765241,3,4,84111,2902,81209,0.965497972916741,23.214288,3392.272112,12.825896788397955,132,9.0E-5
6,test_20231101_135720,10350842.png,212614,4194,208420,0.9802741117706266,2,3,42529,617,41912,0.9854922523454583,21.679027555555557,2995.340346666667,13.366341844659766,132,9.0E-5
7,test_20231101_135720,10863862.png,317432,6857,310575,0.9783985231482648,1,4,66058,1009,65049,0.9847255442187168,35.86164977777778,6559.87024,9.96185112133917,132,9.0E-5
8,test_20231101_135720,11382381.png,312486,797,311689,0.997449485736961,1,3,46745,109,46636,0.997668199807466,21.309107555555556,2485.130629333333,14.177311387814227,132,9.0E-5
9,test_20231101_135720,11079715.png,443815,101847,341968,0.7705192478848168,3,4,124136,14305,109831,0.8847634852097699,18.156124444444444,2439.9212586666667,14.25704549889165,132,9.0E-5
10,test_20231101_135720,11551286.png,271883,497,271386,0.998172007812184,1,3,40092,71,40021,0.9982290731317969,17.641870222222224,1824.312992,15.519810098595052,132,9.0E-5
1,test_20231101_135720,10404007.png,502730,14797,487933,0.9705667057864062,2,4,61265,2154,59111,0.964841263364074,26.346357333333334,3614.1425386666665,12.550750841051833,132,1.0E-4
2,test_20231101_135720,1254659.png,342646,61492,281154,0.8205378145374527,3,4,80080,8660,71420,0.8918581418581418,22.37580088888889,3655.8830826666667,12.500880625819997,132,1.0E-4
3,test_20231101_135720,10188041.png,221231,7962,213269,0.9640104686956168,2,4,41731,1128,40603,0.9729697347295775,11.738563555555556,1370.24816,16.76281133303664,132,1.0E-4
4,test_20231101_135720,10287332.png,216980,10607,206373,0.9511153101668357,1,3,22337,1456,20881,0.9348166718896898,9.912922666666667,943.6587786666666,18.382653764547456,132,1.0E-4
5,test_20231101_135720,11610969.png,368720,19779,348941,0.9463576697765241,3,4,84111,2902,81209,0.965497972916741,23.214288,3392.272112,12.825896788397955,132,1.0E-4
6,test_20231101_135720,10350842.png,212614,4194,208420,0.9802741117706266,1,5,42529,617,41912,0.9854922523454583,21.679027555555557,2995.340346666667,13.366341844659766,132,1.0E-4
7,test_20231101_135720,10863862.png,317432,6857,310575,0.9783985231482648,2,4,66058,1009,65049,0.9847255442187168,35.86164977777778,6559.87024,9.96185112133917,132,1.0E-4
8,test_20231101_135720,11382381.png,312486,797,311689,0.997449485736961,2,3,46745,109,46636,0.997668199807466,21.309107555555556,2485.130629333333,14.177311387814227,132,1.0E-4
9,test_20231101_135720,11079715.png,443815,101847,341968,0.7705192478848168,3,5,124136,14305,109831,0.8847634852097699,18.156124444444444,2439.9212586666667,14.25704549889165,132,1.0E-4
10,test_20231101_135720,11551286.png,271883,497,271386,0.998172007812184,2,4,40092,71,40021,0.9982290731317969,17.641870222222224,1824.312992,15.519810098595052,132,1.0E-4
1,test_20231101_135721,10404007.png,502730,14797,487933,0.9705667057864062,2,4,61265,2154,59111,0.964841263364074,26.346357333333334,3614.1425386666665,12.550750841051833,132,1.1E-4
2,test_20231101_135721,1254659.png,342646,61492,281154,0.8205378145374527,3,4,80080,8660,71420,0.8918581418581418,22.37580088888889,3655.8830826666667,12.500880625819997,132,1.1E-4
3,test_20231101_135721,10188041.png,221231,7962,213269,0.9640104686956168,2,3,41731,1128,40603,0.9729697347295775,11.738563555555556,1370.24816,16.76281133303664,132,1.1E-4
4,test_20231101_135721,10287332.png,216980,10607,206373,0.9511153101668357,2,4,22337,1456,20881,0.9348166718896898,9.912922666666667,943.6587786666666,18.382653764547456,132,1.1E-4
5,test_20231101_135721,11610969.png,368720,19779,348941,0.9463576697765241,2,3,84111,2902,81209,0.965497972916741,23.214288,3392.272112,12.825896788397955,132,1.1E-4
6,test_20231101_135721,10350842.png,212614,4194,208420,0.9802741117706266,1,3,42529,617,41912,0.9854922523454583,21.679027555555557,2995.340346666667,13.366341844659766,132,1.1E-4
7,test_20231101_135721,10863862.png,317432,6857,310575,0.9783985231482648,1,3,66058,1009,65049,0.9847255442187168,35.86164977777778,6559.87024,9.96185112133917,132,1.1E-4
8,test_20231101_135721,11382381.png,312486,797,311689,0.997449485736961,2,4,46745,109,46636,0.997668199807466,21.309107555555556,2485.130629333333,14.177311387814227,132,1.1E-4
9,test_20231101_135721,11079715.png,443815,101847,341968,0.7705192478848168,3,4,124136,14305,109831,0.8847634852097699,18.156124444444444,2439.9212586666667,14.25704549889165,132,1.1E-4
10,test_20231101_135721,11551286.png,271883,497,271386,0.998172007812184,1,4,40092,71,40021,0.9982290731317969,17.641870222222224,1824.312992,15.519810098595052,132,1.1E-4
1,test_20231101_135722,10404007.png,502730,14797,487933,0.9705667057864062,2,4,61265,2154,59111,0.964841263364074,26.346357333333334,3614.1425386666665,12.550750841051833,132,1.2E-4
2,test_20231101_135722,1254659.png,342646,61492,281154,0.8205378145374527,2,4,80080,8660,71420,0.8918581418581418,22.37580088888889,3655.8830826666667,12.500880625819997,132,1.2E-4
3,test_20231101_135722,10188041.png,221231,7962,213269,0.9640104686956168,2,4,41731,1128,40603,0.9729697347295775,11.738563555555556,1370.24816,16.76281133303664,132,1.2E-4
4,test_20231101_135722,10287332.png,216980,10607,206373,0.9511153101668357,2,3,22337,1456,20881,0.9348166718896898,9.912922666666667,943.6587786666666,18.382653764547456,132,1.2E-4
5,test_20231101_135722,11610969.png,368720,19779,348941,0.9463576697765241,3,3,84111,2902,81209,0.965497972916741,23.214288,3392.272112,12.825896788397955,132,1.2E-4
6,test_20231101_135722,10350842.png,212614,4194,208420,0.9802741117706266,1,4,42529,617,41912,0.9854922523454583,21.679027555555557,2995.340346666667,13.366341844659766,132,1.2E-4
7,test_20231101_135722,10863862.png,317432,6857,310575,0.9783985231482648,1,3,66058,1009,65049,0.9847255442187168,35.86164977777778,6559.87024,9.96185112133917,132,1.2E-4
8,test_20231101_135722,11382381.png,312486,797,311689,0.997449485736961,2,4,46745,109,46636,0.997668199807466,21.309107555555556,2485.130629333333,14.177311387814227,132,1.2E-4
9,test_20231101_135722,11079715.png,443815,101847,341968,0.7705192478848168,3,4,124136,14305,109831,0.8847634852097699,18.156124444444444,2439.9212586666667,14.25704549889165,132,1.2E-4
10,test_20231101_135722,11551286.png,271883,497,271386,0.998172007812184,1,3,40092,71,40021,0.9982290731317969,17.641870222222224,1824.312992,15.519810098595052,132,1.2E-4
1,test_20231101_135722,10404007.png,502730,14797,487933,0.9705667057864062,2,3,61265,2154,59111,0.964841263364074,26.346357333333334,3614.1425386666665,12.550750841051833,132,1.3000000000000002E-4
2,test_20231101_135722,1254659.png,342646,61492,281154,0.8205378145374527,3,4,80080,8660,71420,0.8918581418581418,22.37580088888889,3655.8830826666667,12.500880625819997,132,1.3000000000000002E-4
3,test_20231101_135722,10188041.png,221231,7962,213269,0.9640104686956168,2,4,41731,1128,40603,0.9729697347295775,11.738563555555556,1370.24816,16.76281133303664,132,1.3000000000000002E-4
4,test_20231101_135722,10287332.png,216980,10607,206373,0.9511153101668357,2,3,22337,1456,20881,0.9348166718896898,9.912922666666667,943.6587786666666,18.382653764547456,132,1.3000000000000002E-4
5,test_20231101_135722,11610969.png,368720,19779,348941,0.9463576697765241,2,9,84111,2902,81209,0.965497972916741,23.214288,3392.272112,12.825896788397955,132,1.3000000000000002E-4
6,test_20231101_135722,10350842.png,212614,4194,208420,0.9802741117706266,1,3,42529,617,41912,0.9854922523454583,21.679027555555557,2995.340346666667,13.366341844659766,132,1.3000000000000002E-4
7,test_20231101_135722,10863862.png,317432,6857,310575,0.9783985231482648,1,4,66058,1009,65049,0.9847255442187168,35.86164977777778,6559.87024,9.96185112133917,132,1.3000000000000002E-4
8,test_20231101_135722,11382381.png,312486,797,311689,0.997449485736961,2,3,46745,109,46636,0.997668199807466,21.309107555555556,2485.130629333333,14.177311387814227,132,1.3000000000000002E-4
9,test_20231101_135722,11079715.png,443815,101847,341968,0.7705192478848168,4,5,124136,14305,109831,0.8847634852097699,18.156124444444444,2439.9212586666667,14.25704549889165,132,1.3000000000000002E-4
10,test_20231101_135722,11551286.png,271883,497,271386,0.998172007812184,1,4,40092,71,40021,0.9982290731317969,17.641870222222224,1824.312992,15.519810098595052,132,1.3000000000000002E-4
1,test_20231101_135723,10404007.png,502730,14797,487933,0.9705667057864062,2,3,61265,2154,59111,0.964841263364074,26.346357333333334,3614.1425386666665,12.550750841051833,132,1.4000000000000001E-4
2,test_20231101_135723,1254659.png,342646,61492,281154,0.8205378145374527,3,4,80080,8660,71420,0.8918581418581418,22.37580088888889,3655.8830826666667,12.500880625819997,132,1.4000000000000001E-4
3,test_20231101_135723,10188041.png,221231,7962,213269,0.9640104686956168,1,3,41731,1128,40603,0.9729697347295775,11.738563555555556,1370.24816,16.76281133303664,132,1.4000000000000001E-4
4,test_20231101_135723,10287332.png,216980,10607,206373,0.9511153101668357,1,3,22337,1456,20881,0.9348166718896898,9.912922666666667,943.6587786666666,18.382653764547456,132,1.4000000000000001E-4
5,test_20231101_135723,11610969.png,368720,19779,348941,0.9463576697765241,2,4,84111,2902,81209,0.965497972916741,23.214288,3392.272112,12.825896788397955,132,1.4000000000000001E-4
6,test_20231101_135723,10350842.png,212614,4194,208420,0.9802741117706266,1,3,42529,617,41912,0.9854922523454583,21.679027555555557,2995.340346666667,13.366341844659766,132,1.4000000000000001E-4
7,test_20231101_135723,10863862.png,317432,6857,310575,0.9783985231482648,2,4,66058,1009,65049,0.9847255442187168,35.86164977777778,6559.87024,9.96185112133917,132,1.4000000000000001E-4
8,test_20231101_135723,11382381.png,312486,797,311689,0.997449485736961,1,3,46745,109,46636,0.997668199807466,21.309107555555556,2485.130629333333,14.177311387814227,132,1.4000000000000001E-4
9,test_20231101_135723,11079715.png,443815,101847,341968,0.7705192478848168,3,5,124136,14305,109831,0.8847634852097699,18.156124444444444,2439.9212586666667,14.25704549889165,132,1.4000000000000001E-4
10,test_20231101_135723,11551286.png,271883,497,271386,0.998172007812184,1,4,40092,71,40021,0.9982290731317969,17.641870222222224,1824.312992,15.519810098595052,132,1.4000000000000001E-4
1,test_20231101_135724,10404007.png,502730,14797,487933,0.9705667057864062,2,4,61265,2154,59111,0.964841263364074,26.346357333333334,3614.1425386666665,12.550750841051833,132,1.5000000000000001E-4
2,test_20231101_135724,1254659.png,342646,61492,281154,0.8205378145374527,3,4,80080,8660,71420,0.8918581418581418,22.37580088888889,3655.8830826666667,12.500880625819997,132,1.5000000000000001E-4
3,test_20231101_135724,10188041.png,221231,7962,213269,0.9640104686956168,2,3,41731,1128,40603,0.9729697347295775,11.738563555555556,1370.24816,16.76281133303664,132,1.5000000000000001E-4
4,test_20231101_135724,10287332.png,216980,10607,206373,0.9511153101668357,2,3,22337,1456,20881,0.9348166718896898,9.912922666666667,943.6587786666666,18.382653764547456,132,1.5000000000000001E-4
5,test_20231101_135724,11610969.png,368720,19779,348941,0.9463576697765241,2,8,84111,2902,81209,0.965497972916741,23.214288,3392.272112,12.825896788397955,132,1.5000000000000001E-4
6,test_20231101_135724,10350842.png,212614,4194,208420,0.9802741117706266,1,3,42529,617,41912,0.9854922523454583,21.679027555555557,2995.340346666667,13.366341844659766,132,1.5000000000000001E-4
7,test_20231101_135724,10863862.png,317432,6857,310575,0.9783985231482648,2,4,66058,1009,65049,0.9847255442187168,35.86164977777778,6559.87024,9.96185112133917,132,1.5000000000000001E-4
8,test_20231101_135724,11382381.png,312486,687,311799,0.9978015015072675,1,4,46745,93,46652,0.9980104824045353,21.565585777777777,2525.2627946666667,14.107737806568558,132,1.5000000000000001E-4
9,test_20231101_135724,11079715.png,443815,101847,341968,0.7705192478848168,4,4,124136,14305,109831,0.8847634852097699,18.156124444444444,2439.9212586666667,14.25704549889165,132,1.5000000000000001E-4
10,test_20231101_135724,11551286.png,271883,497,271386,0.998172007812184,1,3,40092,71,40021,0.9982290731317969,17.641870222222224,1824.312992,15.519810098595052,132,1.5000000000000001E-4
1,test_20231101_135724,10404007.png,502730,14797,487933,0.9705667057864062,2,4,61265,2154,59111,0.964841263364074,26.346357333333334,3614.1425386666665,12.550750841051833,132,1.6E-4
2,test_20231101_135724,1254659.png,342646,61492,281154,0.8205378145374527,3,4,80080,8660,71420,0.8918581418581418,22.37580088888889,3655.8830826666667,12.500880625819997,132,1.6E-4
3,test_20231101_135724,10188041.png,221231,7962,213269,0.9640104686956168,2,3,41731,1128,40603,0.9729697347295775,11.738563555555556,1370.24816,16.76281133303664,132,1.6E-4
4,test_20231101_135724,10287332.png,216980,10414,206566,0.9520047930684856,2,4,22337,1432,20905,0.9358911223530465,10.041297777777778,969.9734293333333,18.26320523150082,132,1.6E-4
5,test_20231101_135724,11610969.png,368720,19779,348941,0.9463576697765241,2,3,84111,2902,81209,0.965497972916741,23.214288,3392.272112,12.825896788397955,132,1.6E-4
6,test_20231101_135724,10350842.png,212614,4194,208420,0.9802741117706266,1,8,42529,617,41912,0.9854922523454583,21.679027555555557,2995.340346666667,13.366341844659766,132,1.6E-4
7,test_20231101_135724,10863862.png,317432,6857,310575,0.9783985231482648,2,4,66058,1009,65049,0.9847255442187168,35.86164977777778,6559.87024,9.96185112133917,132,1.6E-4
8,test_20231101_135724,11382381.png,312486,687,311799,0.9978015015072675,1,3,46745,93,46652,0.9980104824045353,21.565585777777777,2525.2627946666667,14.107737806568558,132,1.6E-4
9,test_20231101_135724,11079715.png,443815,101847,341968,0.7705192478848168,4,4,124136,14305,109831,0.8847634852097699,18.156124444444444,2439.9212586666667,14.25704549889165,132,1.6E-4
10,test_20231101_135724,11551286.png,271883,497,271386,0.998172007812184,1,3,40092,71,40021,0.9982290731317969,17.641870222222224,1824.312992,15.519810098595052,132,1.6E-4
1,test_20231101_135725,10404007.png,502730,14797,487933,0.9705667057864062,2,4,61265,2154,59111,0.964841263364074,26.346357333333334,3614.1425386666665,12.550750841051833,132,1.7E-4
2,test_20231101_135725,1254659.png,342646,61492,281154,0.8205378145374527,2,3,80080,8660,71420,0.8918581418581418,22.37580088888889,3655.8830826666667,12.500880625819997,132,1.7E-4
3,test_20231101_135725,10188041.png,221231,7962,213269,0.9640104686956168,2,10,41731,1128,40603,0.9729697347295775,11.738563555555556,1370.24816,16.76281133303664,132,1.7E-4
4,test_20231101_135725,10287332.png,216980,10414,206566,0.9520047930684856,1,3,22337,1432,20905,0.9358911223530465,10.041297777777778,969.9734293333333,18.26320523150082,132,1.7E-4
5,test_20231101_135725,11610969.png,368720,19779,348941,0.9463576697765241,2,4,84111,2902,81209,0.965497972916741,23.214288,3392.272112,12.825896788397955,132,1.7E-4
6,test_20231101_135725,10350842.png,212614,4194,208420,0.9802741117706266,2,3,42529,617,41912,0.9854922523454583,21.679027555555557,2995.340346666667,13.366341844659766,132,1.7E-4
7,test_20231101_135725,10863862.png,317432,6857,310575,0.9783985231482648,2,4,66058,1009,65049,0.9847255442187168,35.86164977777778,6559.87024,9.96185112133917,132,1.7E-4
8,test_20231101_135725,11382381.png,312486,687,311799,0.9978015015072675,2,4,46745,93,46652,0.9980104824045353,21.565585777777777,2525.2627946666667,14.107737806568558,132,1.7E-4
9,test_20231101_135725,11079715.png,443815,101847,341968,0.7705192478848168,3,4,124136,14305,109831,0.8847634852097699,18.156124444444444,2439.9212586666667,14.25704549889165,132,1.7E-4
10,test_20231101_135725,11551286.png,271883,497,271386,0.998172007812184,2,3,40092,71,40021,0.9982290731317969,17.641870222222224,1824.312992,15.519810098595052,132,1.7E-4
1,test_20231101_135726,10404007.png,502730,14797,487933,0.9705667057864062,2,4,61265,2154,59111,0.964841263364074,26.346357333333334,3614.1425386666665,12.550750841051833,132,1.8E-4
2,test_20231101_135726,1254659.png,342646,61492,281154,0.8205378145374527,2,4,80080,8660,71420,0.8918581418581418,22.37580088888889,3655.8830826666667,12.500880625819997,132,1.8E-4
3,test_20231101_135726,10188041.png,221231,7962,213269,0.9640104686956168,2,3,41731,1128,40603,0.9729697347295775,11.738563555555556,1370.24816,16.76281133303664,132,1.8E-4
4,test_20231101_135726,10287332.png,216980,10414,206566,0.9520047930684856,2,3,22337,1432,20905,0.9358911223530465,10.041297777777778,969.9734293333333,18.26320523150082,132,1.8E-4
5,test_20231101_135726,11610969.png,368720,19779,348941,0.9463576697765241,2,4,84111,2902,81209,0.965497972916741,23.214288,3392.272112,12.825896788397955,132,1.8E-4
6,test_20231101_135726,10350842.png,212614,4194,208420,0.9802741117706266,2,3,42529,617,41912,0.9854922523454583,21.679027555555557,2995.340346666667,13.366341844659766,132,1.8E-4
7,test_20231101_135726,10863862.png,317432,6857,310575,0.9783985231482648,1,4,66058,1009,65049,0.9847255442187168,35.86164977777778,6559.87024,9.96185112133917,132,1.8E-4
8,test_20231101_135726,11382381.png,312486,667,311819,0.997865504374596,1,4,46745,90,46655,0.9980746603914857,22.322282666666666,2670.9360426666667,13.864168721911659,132,1.8E-4
9,test_20231101_135726,11079715.png,443815,101847,341968,0.7705192478848168,3,4,124136,14305,109831,0.8847634852097699,18.156124444444444,2439.9212586666667,14.25704549889165,132,1.8E-4
10,test_20231101_135726,11551286.png,271883,497,271386,0.998172007812184,2,3,40092,71,40021,0.9982290731317969,17.641870222222224,1824.312992,15.519810098595052,132,1.8E-4
1,test_20231101_135726,10404007.png,502730,14797,487933,0.9705667057864062,2,4,61265,2154,59111,0.964841263364074,26.346357333333334,3614.1425386666665,12.550750841051833,132,1.9E-4
2,test_20231101_135726,1254659.png,342646,61492,281154,0.8205378145374527,3,4,80080,8660,71420,0.8918581418581418,22.37580088888889,3655.8830826666667,12.500880625819997,132,1.9E-4
3,test_20231101_135726,10188041.png,221231,7962,213269,0.9640104686956168,2,4,41731,1128,40603,0.9729697347295775,11.738563555555556,1370.24816,16.76281133303664,132,1.9E-4
4,test_20231101_135726,10287332.png,216980,10414,206566,0.9520047930684856,2,3,22337,1432,20905,0.9358911223530465,10.041297777777778,969.9734293333333,18.26320523150082,132,1.9E-4
5,test_20231101_135726,11610969.png,368720,19779,348941,0.9463576697765241,3,3,84111,2902,81209,0.965497972916741,23.214288,3392.272112,12.825896788397955,132,1.9E-4
6,test_20231101_135726,10350842.png,212614,4194,208420,0.9802741117706266,1,3,42529,617,41912,0.9854922523454583,21.679027555555557,2995.340346666667,13.366341844659766,132,1.9E-4
7,test_20231101_135726,10863862.png,317432,6857,310575,0.9783985231482648,1,3,66058,1009,65049,0.9847255442187168,35.86164977777778,6559.87024,9.96185112133917,132,1.9E-4
8,test_20231101_135726,11382381.png,312486,667,311819,0.997865504374596,2,4,46745,90,46655,0.9980746603914857,22.322282666666666,2670.9360426666667,13.864168721911659,132,1.9E-4
9,test_20231101_135726,11079715.png,443815,101847,341968,0.7705192478848168,4,4,124136,14305,109831,0.8847634852097699,18.156124444444444,2439.9212586666667,14.25704549889165,132,1.9E-4
10,test_20231101_135726,11551286.png,271883,497,271386,0.998172007812184,1,3,40092,71,40021,0.9982290731317969,17.641870222222224,1824.312992,15.519810098595052,132,1.9E-4
1,test_20231101_135727,10404007.png,502730,14797,487933,0.9705667057864062,2,4,61265,2154,59111,0.964841263364074,26.346357333333334,3614.1425386666665,12.550750841051833,132,2.0E-4
2,test_20231101_135727,1254659.png,342646,61492,281154,0.8205378145374527,3,4,80080,8660,71420,0.8918581418581418,22.37580088888889,3655.8830826666667,12.500880625819997,132,2.0E-4
3,test_20231101_135727,10188041.png,221231,7962,213269,0.9640104686956168,2,4,41731,1128,40603,0.9729697347295775,11.738563555555556,1370.24816,16.76281133303664,132,2.0E-4
4,test_20231101_135727,10287332.png,216980,10414,206566,0.9520047930684856,1,3,22337,1432,20905,0.9358911223530465,10.041297777777778,969.9734293333333,18.26320523150082,132,2.0E-4
5,test_20231101_135727,11610969.png,368720,19779,348941,0.9463576697765241,2,3,84111,2902,81209,0.965497972916741,23.214288,3392.272112,12.825896788397955,132,2.0E-4
6,test_20231101_135727,10350842.png,212614,4194,208420,0.9802741117706266,2,3,42529,617,41912,0.9854922523454583,21.679027555555557,2995.340346666667,13.366341844659766,132,2.0E-4
7,test_20231101_135727,10863862.png,317432,6857,310575,0.9783985231482648,2,4,66058,1009,65049,0.9847255442187168,35.86164977777778,6559.87024,9.96185112133917,132,2.0E-4
8,test_20231101_135727,11382381.png,312486,667,311819,0.997865504374596,2,3,46745,90,46655,0.9980746603914857,22.322282666666666,2670.9360426666667,13.864168721911659,132,2.0E-4
9,test_20231101_135727,11079715.png,443815,101847,341968,0.7705192478848168,4,4,124136,14305,109831,0.8847634852097699,18.156124444444444,2439.9212586666667,14.25704549889165,132,2.0E-4
10,test_20231101_135727,11551286.png,271883,267,271616,0.9990179599312939,1,4,40092,37,40055,0.9990771226179787,17.919265777777778,1867.1754613333333,15.418952296845859,132,2.0E-4
1,test_20231101_135728,10404007.png,502730,14797,487933,0.9705667057864062,2,4,61265,2154,59111,0.964841263364074,26.346357333333334,3614.1425386666665,12.550750841051833,132,2.1E-4
2,test_20231101_135728,1254659.png,342646,61492,281154,0.8205378145374527,3,4,80080,8660,71420,0.8918581418581418,22.37580088888889,3655.8830826666667,12.500880625819997,132,2.1E-4
3,test_20231101_135728,10188041.png,221231,7962,213269,0.9640104686956168,2,4,41731,1128,40603,0.9729697347295775,11.738563555555556,1370.24816,16.76281133303664,132,2.1E-4
4,test_20231101_135728,10287332.png,216980,10414,206566,0.9520047930684856,1,3,22337,1432,20905,0.9358911223530465,10.041297777777778,969.9734293333333,18.26320523150082,132,2.1E-4
5,test_20231101_135728,11610969.png,368720,19779,348941,0.9463576697765241,2,3,84111,2902,81209,0.965497972916741,23.214288,3392.272112,12.825896788397955,132,2.1E-4
6,test_20231101_135728,10350842.png,212614,4194,208420,0.9802741117706266,2,3,42529,617,41912,0.9854922523454583,21.679027555555557,2995.340346666667,13.366341844659766,132,2.1E-4
7,test_20231101_135728,10863862.png,317432,6857,310575,0.9783985231482648,1,3,66058,1009,65049,0.9847255442187168,35.86164977777778,6559.87024,9.96185112133917,132,2.1E-4
8,test_20231101_135728,11382381.png,312486,667,311819,0.997865504374596,1,4,46745,90,46655,0.9980746603914857,22.322282666666666,2670.9360426666667,13.864168721911659,132,2.1E-4
9,test_20231101_135728,11079715.png,443815,101847,341968,0.7705192478848168,3,4,124136,14305,109831,0.8847634852097699,18.156124444444444,2439.9212586666667,14.25704549889165,132,2.1E-4
10,test_20231101_135728,11551286.png,271883,267,271616,0.9990179599312939,1,3,40092,37,40055,0.9990771226179787,17.919265777777778,1867.1754613333333,15.418952296845859,132,2.1E-4
1,test_20231101_135728,10404007.png,502730,14797,487933,0.9705667057864062,2,3,61265,2154,59111,0.964841263364074,26.346357333333334,3614.1425386666665,12.550750841051833,132,2.2E-4
2,test_20231101_135728,1254659.png,342646,61492,281154,0.8205378145374527,3,4,80080,8660,71420,0.8918581418581418,22.37580088888889,3655.8830826666667,12.500880625819997,132,2.2E-4
3,test_20231101_135728,10188041.png,221231,7962,213269,0.9640104686956168,2,4,41731,1128,40603,0.9729697347295775,11.738563555555556,1370.24816,16.76281133303664,132,2.2E-4
4,test_20231101_135728,10287332.png,216980,10414,206566,0.9520047930684856,1,4,22337,1432,20905,0.9358911223530465,10.041297777777778,969.9734293333333,18.26320523150082,132,2.2E-4
5,test_20231101_135728,11610969.png,368720,19779,348941,0.9463576697765241,2,4,84111,2902,81209,0.965497972916741,23.214288,3392.272112,12.825896788397955,132,2.2E-4
6,test_20231101_135728,10350842.png,212614,4194,208420,0.9802741117706266,1,4,42529,617,41912,0.9854922523454583,21.679027555555557,2995.340346666667,13.366341844659766,132,2.2E-4
7,test_20231101_135728,10863862.png,317432,6857,310575,0.9783985231482648,1,3,66058,1009,65049,0.9847255442187168,35.86164977777778,6559.87024,9.96185112133917,132,2.2E-4
8,test_20231101_135728,11382381.png,312486,667,311819,0.997865504374596,1,4,46745,90,46655,0.9980746603914857,22.322282666666666,2670.9360426666667,13.864168721911659,132,2.2E-4
9,test_20231101_135728,11079715.png,443815,101847,341968,0.7705192478848168,5,4,124136,14305,109831,0.8847634852097699,18.156124444444444,2439.9212586666667,14.25704549889165,132,2.2E-4
10,test_20231101_135728,11551286.png,271883,267,271616,0.9990179599312939,1,4,40092,37,40055,0.9990771226179787,17.919265777777778,1867.1754613333333,15.418952296845859,132,2.2E-4
1,test_20231101_135729,10404007.png,502730,14797,487933,0.9705667057864062,2,4,61265,2154,59111,0.964841263364074,26.346357333333334,3614.1425386666665,12.550750841051833,132,2.3E-4
2,test_20231101_135729,1254659.png,342646,61492,281154,0.8205378145374527,3,4,80080,8660,71420,0.8918581418581418,22.37580088888889,3655.8830826666667,12.500880625819997,132,2.3E-4
3,test_20231101_135729,10188041.png,221231,7962,213269,0.9640104686956168,2,4,41731,1128,40603,0.9729697347295775,11.738563555555556,1370.24816,16.76281133303664,132,2.3E-4
4,test_20231101_135729,10287332.png,216980,10414,206566,0.9520047930684856,1,3,22337,1432,20905,0.9358911223530465,10.041297777777778,969.9734293333333,18.26320523150082,132,2.3E-4
5,test_20231101_135729,11610969.png,368720,19779,348941,0.9463576697765241,2,4,84111,2902,81209,0.965497972916741,23.214288,3392.272112,12.825896788397955,132,2.3E-4
6,test_20231101_135729,10350842.png,212614,4194,208420,0.9802741117706266,1,3,42529,617,41912,0.9854922523454583,21.679027555555557,2995.340346666667,13.366341844659766,132,2.3E-4
7,test_20231101_135729,10863862.png,317432,6857,310575,0.9783985231482648,2,4,66058,1009,65049,0.9847255442187168,35.86164977777778,6559.87024,9.96185112133917,132,2.3E-4
8,test_20231101_135729,11382381.png,312486,667,311819,0.997865504374596,1,3,46745,90,46655,0.9980746603914857,22.322282666666666,2670.9360426666667,13.864168721911659,132,2.3E-4
9,test_20231101_135729,11079715.png,443815,101847,341968,0.7705192478848168,3,4,124136,14305,109831,0.8847634852097699,18.156124444444444,2439.9212586666667,14.25704549889165,132,2.3E-4
10,test_20231101_135729,11551286.png,271883,267,271616,0.9990179599312939,1,3,40092,37,40055,0.9990771226179787,17.919265777777778,1867.1754613333333,15.418952296845859,132,2.3E-4
1,test_20231101_135730,10404007.png,502730,14797,487933,0.9705667057864062,2,4,61265,2154,59111,0.964841263364074,26.346357333333334,3614.1425386666665,12.550750841051833,132,2.4E-4
2,test_20231101_135730,1254659.png,342646,61492,281154,0.8205378145374527,3,4,80080,8660,71420,0.8918581418581418,22.37580088888889,3655.8830826666667,12.500880625819997,132,2.4E-4
3,test_20231101_135730,10188041.png,221231,7962,213269,0.9640104686956168,2,3,41731,1128,40603,0.9729697347295775,11.738563555555556,1370.24816,16.76281133303664,132,2.4E-4
4,test_20231101_135730,10287332.png,216980,10414,206566,0.9520047930684856,2,4,22337,1432,20905,0.9358911223530465,10.041297777777778,969.9734293333333,18.26320523150082,132,2.4E-4
5,test_20231101_135730,11610969.png,368720,19779,348941,0.9463576697765241,2,4,84111,2902,81209,0.965497972916741,23.214288,3392.272112,12.825896788397955,132,2.4E-4
6,test_20231101_135730,10350842.png,212614,4194,208420,0.9802741117706266,5,7,42529,617,41912,0.9854922523454583,21.679027555555557,2995.340346666667,13.366341844659766,132,2.4E-4
7,test_20231101_135730,10863862.png,317432,6857,310575,0.9783985231482648,1,3,66058,1009,65049,0.9847255442187168,35.86164977777778,6559.87024,9.96185112133917,132,2.4E-4
8,test_20231101_135730,11382381.png,312486,667,311819,0.997865504374596,2,4,46745,90,46655,0.9980746603914857,22.322282666666666,2670.9360426666667,13.864168721911659,132,2.4E-4
9,test_20231101_135730,11079715.png,443815,101847,341968,0.7705192478848168,4,4,124136,14305,109831,0.8847634852097699,18.156124444444444,2439.9212586666667,14.25704549889165,132,2.4E-4
10,test_20231101_135730,11551286.png,271883,267,271616,0.9990179599312939,2,4,40092,37,40055,0.9990771226179787,17.919265777777778,1867.1754613333333,15.418952296845859,132,2.4E-4
1,test_20231101_135731,10404007.png,502730,14797,487933,0.9705667057864062,2,3,61265,2154,59111,0.964841263364074,26.346357333333334,3614.1425386666665,12.550750841051833,132,2.5E-4
2,test_20231101_135731,1254659.png,342646,61492,281154,0.8205378145374527,4,4,80080,8660,71420,0.8918581418581418,22.37580088888889,3655.8830826666667,12.500880625819997,132,2.5E-4
3,test_20231101_135731,10188041.png,221231,7962,213269,0.9640104686956168,2,3,41731,1128,40603,0.9729697347295775,11.738563555555556,1370.24816,16.76281133303664,132,2.5E-4
4,test_20231101_135731,10287332.png,216980,10414,206566,0.9520047930684856,2,3,22337,1432,20905,0.9358911223530465,10.041297777777778,969.9734293333333,18.26320523150082,132,2.5E-4
5,test_20231101_135731,11610969.png,368720,19779,348941,0.9463576697765241,2,5,84111,2902,81209,0.965497972916741,23.214288,3392.272112,12.825896788397955,132,2.5E-4
6,test_20231101_135731,10350842.png,212614,4194,208420,0.9802741117706266,1,5,42529,617,41912,0.9854922523454583,21.679027555555557,2995.340346666667,13.366341844659766,132,2.5E-4
7,test_20231101_135731,10863862.png,317432,6857,310575,0.9783985231482648,2,4,66058,1009,65049,0.9847255442187168,35.86164977777778,6559.87024,9.96185112133917,132,2.5E-4
8,test_20231101_135731,11382381.png,312486,667,311819,0.997865504374596,1,4,46745,90,46655,0.9980746603914857,22.322282666666666,2670.9360426666667,13.864168721911659,132,2.5E-4
9,test_20231101_135731,11079715.png,443815,101847,341968,0.7705192478848168,3,4,124136,14305,109831,0.8847634852097699,18.156124444444444,2439.9212586666667,14.25704549889165,132,2.5E-4
10,test_20231101_135731,11551286.png,271883,267,271616,0.9990179599312939,2,3,40092,37,40055,0.9990771226179787,17.919265777777778,1867.1754613333333,15.418952296845859,132,2.5E-4
1,test_20231101_135731,10404007.png,502730,14677,488053,0.9708054025023373,3,4,61265,2138,59127,0.9651024238961887,26.351075555555557,3615.226304,12.549448726530596,132,2.6000000000000003E-4
2,test_20231101_135731,1254659.png,342646,61432,281214,0.8207129223746957,3,4,80080,8654,71426,0.891933066933067,22.385354666666668,3656.9652693333333,12.49959525060495,132,2.6000000000000003E-4
3,test_20231101_135731,10188041.png,221231,7922,213309,0.9641912751829536,2,3,41731,1122,40609,0.9731135127363351,12.104391111111111,1422.528864,16.60019273604845,132,2.6000000000000003E-4
4,test_20231101_135731,10287332.png,216980,10414,206566,0.9520047930684856,1,4,22337,1432,20905,0.9358911223530465,10.041297777777778,969.9734293333333,18.26320523150082,132,2.6000000000000003E-4
5,test_20231101_135731,11610969.png,368720,19659,349061,0.9466831199826427,2,4,84111,2887,81224,0.9656763086873298,23.630064,3459.2615946666665,12.740969555969798,132,2.6000000000000003E-4
6,test_20231101_135731,10350842.png,212614,4194,208420,0.9802741117706266,1,4,42529,617,41912,0.9854922523454583,21.679027555555557,2995.340346666667,13.366341844659766,132,2.6000000000000003E-4
7,test_20231101_135731,10863862.png,317432,6817,310615,0.9785245343884674,2,3,66058,1003,65055,0.9848163734899633,35.86734577777778,6560.939296,9.96114341329509,132,2.6000000000000003E-4
8,test_20231101_135731,11382381.png,312486,547,311939,0.9982495215785667,1,8,46745,72,46673,0.9984597283131885,22.81680888888889,2740.878352,13.751906001286724,132,2.6000000000000003E-4
9,test_20231101_135731,11079715.png,443815,101847,341968,0.7705192478848168,3,4,124136,14305,109831,0.8847634852097699,18.156124444444444,2439.9212586666667,14.25704549889165,132,2.6000000000000003E-4
10,test_20231101_135731,11551286.png,271883,164,271719,0.9993967993585476,2,3,40092,22,40070,0.9994512620971765,18.120286222222223,1899.5769013333334,15.344234809036362,132,2.6000000000000003E-4
1,test_20231101_135732,10404007.png,502730,14677,488053,0.9708054025023373,2,4,61265,2138,59127,0.9651024238961887,26.351075555555557,3615.226304,12.549448726530596,132,2.7000000000000006E-4
2,test_20231101_135732,1254659.png,342646,61432,281214,0.8207129223746957,2,4,80080,8654,71426,0.891933066933067,22.385354666666668,3656.9652693333333,12.49959525060495,132,2.7000000000000006E-4
3,test_20231101_135732,10188041.png,221231,7922,213309,0.9641912751829536,2,4,41731,1122,40609,0.9731135127363351,12.104391111111111,1422.528864,16.60019273604845,132,2.7000000000000006E-4
4,test_20231101_135732,10287332.png,216980,10414,206566,0.9520047930684856,2,4,22337,1432,20905,0.9358911223530465,10.041297777777778,969.9734293333333,18.26320523150082,132,2.7000000000000006E-4
5,test_20231101_135732,11610969.png,368720,19659,349061,0.9466831199826427,2,4,84111,2887,81224,0.9656763086873298,23.630064,3459.2615946666665,12.740969555969798,132,2.7000000000000006E-4
6,test_20231101_135732,10350842.png,212614,4194,208420,0.9802741117706266,2,3,42529,617,41912,0.9854922523454583,21.679027555555557,2995.340346666667,13.366341844659766,132,2.7000000000000006E-4
7,test_20231101_135732,10863862.png,317432,6817,310615,0.9785245343884674,1,3,66058,1003,65055,0.9848163734899633,35.86734577777778,6560.939296,9.96114341329509,132,2.7000000000000006E-4
8,test_20231101_135732,11382381.png,312486,547,311939,0.9982495215785667,1,4,46745,72,46673,0.9984597283131885,22.81680888888889,2740.878352,13.751906001286724,132,2.7000000000000006E-4
9,test_20231101_135732,11079715.png,443815,101847,341968,0.7705192478848168,3,4,124136,14305,109831,0.8847634852097699,18.156124444444444,2439.9212586666667,14.25704549889165,132,2.7000000000000006E-4
10,test_20231101_135732,11551286.png,271883,164,271719,0.9993967993585476,1,4,40092,22,40070,0.9994512620971765,18.120286222222223,1899.5769013333334,15.344234809036362,132,2.7000000000000006E-4
1,test_20231101_135733,10404007.png,502730,14677,488053,0.9708054025023373,3,4,61265,2138,59127,0.9651024238961887,26.351075555555557,3615.226304,12.549448726530596,132,2.800000000000001E-4
2,test_20231101_135733,1254659.png,342646,61432,281214,0.8207129223746957,3,4,80080,8654,71426,0.891933066933067,22.385354666666668,3656.9652693333333,12.49959525060495,132,2.800000000000001E-4
3,test_20231101_135733,10188041.png,221231,7922,213309,0.9641912751829536,3,6,41731,1122,40609,0.9731135127363351,12.104391111111111,1422.528864,16.60019273604845,132,2.800000000000001E-4
4,test_20231101_135733,10287332.png,216980,10414,206566,0.9520047930684856,2,4,22337,1432,20905,0.9358911223530465,10.041297777777778,969.9734293333333,18.26320523150082,132,2.800000000000001E-4
5,test_20231101_135733,11610969.png,368720,19659,349061,0.9466831199826427,2,3,84111,2887,81224,0.9656763086873298,23.630064,3459.2615946666665,12.740969555969798,132,2.800000000000001E-4
6,test_20231101_135733,10350842.png,212614,4194,208420,0.9802741117706266,2,3,42529,617,41912,0.9854922523454583,21.679027555555557,2995.340346666667,13.366341844659766,132,2.800000000000001E-4
7,test_20231101_135733,10863862.png,317432,6817,310615,0.9785245343884674,2,4,66058,1003,65055,0.9848163734899633,35.86734577777778,6560.939296,9.96114341329509,132,2.800000000000001E-4
8,test_20231101_135733,11382381.png,312486,547,311939,0.9982495215785667,1,4,46745,72,46673,0.9984597283131885,22.81680888888889,2740.878352,13.751906001286724,132,2.800000000000001E-4
9,test_20231101_135733,11079715.png,443815,101847,341968,0.7705192478848168,3,4,124136,14305,109831,0.8847634852097699,18.156124444444444,2439.9212586666667,14.25704549889165,132,2.800000000000001E-4
10,test_20231101_135733,11551286.png,271883,164,271719,0.9993967993585476,1,3,40092,22,40070,0.9994512620971765,18.120286222222223,1899.5769013333334,15.344234809036362,132,2.800000000000001E-4
1,test_20231101_135733,10404007.png,502730,14677,488053,0.9708054025023373,2,4,61265,2138,59127,0.9651024238961887,26.351075555555557,3615.226304,12.549448726530596,132,2.900000000000001E-4
2,test_20231101_135733,1254659.png,342646,61432,281214,0.8207129223746957,4,5,80080,8654,71426,0.891933066933067,22.385354666666668,3656.9652693333333,12.49959525060495,132,2.900000000000001E-4
3,test_20231101_135733,10188041.png,221231,7922,213309,0.9641912751829536,2,4,41731,1122,40609,0.9731135127363351,12.104391111111111,1422.528864,16.60019273604845,132,2.900000000000001E-4
4,test_20231101_135733,10287332.png,216980,10414,206566,0.9520047930684856,2,4,22337,1432,20905,0.9358911223530465,10.041297777777778,969.9734293333333,18.26320523150082,132,2.900000000000001E-4
5,test_20231101_135733,11610969.png,368720,19659,349061,0.9466831199826427,2,4,84111,2887,81224,0.9656763086873298,23.630064,3459.2615946666665,12.740969555969798,132,2.900000000000001E-4
6,test_20231101_135733,10350842.png,212614,4194,208420,0.9802741117706266,2,4,42529,617,41912,0.9854922523454583,21.679027555555557,2995.340346666667,13.366341844659766,132,2.900000000000001E-4
7,test_20231101_135733,10863862.png,317432,6817,310615,0.9785245343884674,2,4,66058,1003,65055,0.9848163734899633,35.86734577777778,6560.939296,9.96114341329509,132,2.900000000000001E-4
8,test_20231101_135733,11382381.png,312486,547,311939,0.9982495215785667,2,5,46745,72,46673,0.9984597283131885,22.81680888888889,2740.878352,13.751906001286724,132,2.900000000000001E-4
9,test_20231101_135733,11079715.png,443815,101847,341968,0.7705192478848168,3,4,124136,14305,109831,0.8847634852097699,18.156124444444444,2439.9212586666667,14.25704549889165,132,2.900000000000001E-4
10,test_20231101_135733,11551286.png,271883,164,271719,0.9993967993585476,1,3,40092,22,40070,0.9994512620971765,18.120286222222223,1899.5769013333334,15.344234809036362,132,2.900000000000001E-4
1,test_20231101_135734,10404007.png,502730,14677,488053,0.9708054025023373,3,4,61265,2138,59127,0.9651024238961887,26.351075555555557,3615.226304,12.549448726530596,132,3.0000000000000014E-4
2,test_20231101_135734,1254659.png,342646,61432,281214,0.8207129223746957,3,4,80080,8654,71426,0.891933066933067,22.385354666666668,3656.9652693333333,12.49959525060495,132,3.0000000000000014E-4
3,test_20231101_135734,10188041.png,221231,7922,213309,0.9641912751829536,3,4,41731,1122,40609,0.9731135127363351,12.104391111111111,1422.528864,16.60019273604845,132,3.0000000000000014E-4
4,test_20231101_135734,10287332.png,216980,10414,206566,0.9520047930684856,3,4,22337,1432,20905,0.9358911223530465,10.041297777777778,969.9734293333333,18.26320523150082,132,3.0000000000000014E-4
5,test_20231101_135734,11610969.png,368720,19659,349061,0.9466831199826427,3,4,84111,2887,81224,0.9656763086873298,23.630064,3459.2615946666665,12.740969555969798,132,3.0000000000000014E-4
6,test_20231101_135734,10350842.png,212614,4194,208420,0.9802741117706266,2,3,42529,617,41912,0.9854922523454583,21.679027555555557,2995.340346666667,13.366341844659766,132,3.0000000000000014E-4
7,test_20231101_135734,10863862.png,317432,6817,310615,0.9785245343884674,1,3,66058,1003,65055,0.9848163734899633,35.86734577777778,6560.939296,9.96114341329509,132,3.0000000000000014E-4
8,test_20231101_135734,11382381.png,312486,547,311939,0.9982495215785667,2,3,46745,72,46673,0.9984597283131885,22.81680888888889,2740.878352,13.751906001286724,132,3.0000000000000014E-4
9,test_20231101_135734,11079715.png,443815,101847,341968,0.7705192478848168,3,4,124136,14305,109831,0.8847634852097699,18.156124444444444,2439.9212586666667,14.25704549889165,132,3.0000000000000014E-4
10,test_20231101_135734,11551286.png,271883,164,271719,0.9993967993585476,2,4,40092,22,40070,0.9994512620971765,18.120286222222223,1899.5769013333334,15.344234809036362,132,3.0000000000000014E-4
1,test_20231101_135735,10404007.png,502730,14677,488053,0.9708054025023373,3,4,61265,2138,59127,0.9651024238961887,26.351075555555557,3615.226304,12.549448726530596,132,3.1000000000000016E-4
2,test_20231101_135735,1254659.png,342646,61432,281214,0.8207129223746957,4,4,80080,8654,71426,0.891933066933067,22.385354666666668,3656.9652693333333,12.49959525060495,132,3.1000000000000016E-4
3,test_20231101_135735,10188041.png,221231,7922,213309,0.9641912751829536,2,4,41731,1122,40609,0.9731135127363351,12.104391111111111,1422.528864,16.60019273604845,132,3.1000000000000016E-4
4,test_20231101_135735,10287332.png,216980,10414,206566,0.9520047930684856,2,3,22337,1432,20905,0.9358911223530465,10.041297777777778,969.9734293333333,18.26320523150082,132,3.1000000000000016E-4
5,test_20231101_135735,11610969.png,368720,19659,349061,0.9466831199826427,2,4,84111,2887,81224,0.9656763086873298,23.630064,3459.2615946666665,12.740969555969798,132,3.1000000000000016E-4
6,test_20231101_135735,10350842.png,212614,4194,208420,0.9802741117706266,2,3,42529,617,41912,0.9854922523454583,21.679027555555557,2995.340346666667,13.366341844659766,132,3.1000000000000016E-4
7,test_20231101_135735,10863862.png,317432,6817,310615,0.9785245343884674,2,4,66058,1003,65055,0.9848163734899633,35.86734577777778,6560.939296,9.96114341329509,132,3.1000000000000016E-4
8,test_20231101_135735,11382381.png,312486,547,311939,0.9982495215785667,1,3,46745,72,46673,0.9984597283131885,22.81680888888889,2740.878352,13.751906001286724,132,3.1000000000000016E-4
9,test_20231101_135735,11079715.png,443815,101847,341968,0.7705192478848168,4,4,124136,14305,109831,0.8847634852097699,18.156124444444444,2439.9212586666667,14.25704549889165,132,3.1000000000000016E-4
10,test_20231101_135735,11551286.png,271883,164,271719,0.9993967993585476,1,3,40092,22,40070,0.9994512620971765,18.120286222222223,1899.5769013333334,15.344234809036362,132,3.1000000000000016E-4
1,test_20231101_135736,10404007.png,502730,14514,488216,0.9711296322081435,2,4,61265,2115,59150,0.9654778421611034,26.39290488888889,3622.7017866666665,12.540477755873196,132,3.200000000000002E-4
2,test_20231101_135736,1254659.png,342646,61432,281214,0.8207129223746957,4,4,80080,8654,71426,0.891933066933067,22.385354666666668,3656.9652693333333,12.49959525060495,132,3.200000000000002E-4
3,test_20231101_135736,10188041.png,221231,7922,213309,0.9641912751829536,2,4,41731,1122,40609,0.9731135127363351,12.104391111111111,1422.528864,16.60019273604845,132,3.200000000000002E-4
4,test_20231101_135736,10287332.png,216980,10414,206566,0.9520047930684856,2,4,22337,1432,20905,0.9358911223530465,10.041297777777778,969.9734293333333,18.26320523150082,132,3.200000000000002E-4
5,test_20231101_135736,11610969.png,368720,19659,349061,0.9466831199826427,2,7,84111,2887,81224,0.9656763086873298,23.630064,3459.2615946666665,12.740969555969798,132,3.200000000000002E-4
6,test_20231101_135736,10350842.png,212614,4194,208420,0.9802741117706266,2,6,42529,617,41912,0.9854922523454583,21.679027555555557,2995.340346666667,13.366341844659766,132,3.200000000000002E-4
7,test_20231101_135736,10863862.png,317432,6817,310615,0.9785245343884674,2,4,66058,1003,65055,0.9848163734899633,35.86734577777778,6560.939296,9.96114341329509,132,3.200000000000002E-4
8,test_20231101_135736,11382381.png,312486,547,311939,0.9982495215785667,2,4,46745,72,46673,0.9984597283131885,22.81680888888889,2740.878352,13.751906001286724,132,3.200000000000002E-4
9,test_20231101_135736,11079715.png,443815,101847,341968,0.7705192478848168,3,5,124136,14305,109831,0.8847634852097699,18.156124444444444,2439.9212586666667,14.25704549889165,132,3.200000000000002E-4
10,test_20231101_135736,11551286.png,271883,164,271719,0.9993967993585476,1,4,40092,22,40070,0.9994512620971765,18.120286222222223,1899.5769013333334,15.344234809036362,132,3.200000000000002E-4
1,test_20231101_135736,10404007.png,502730,14514,488216,0.9711296322081435,3,4,61265,2115,59150,0.9654778421611034,26.39290488888889,3622.7017866666665,12.540477755873196,132,3.300000000000002E-4
2,test_20231101_135736,1254659.png,342646,61432,281214,0.8207129223746957,3,4,80080,8654,71426,0.891933066933067,22.385354666666668,3656.9652693333333,12.49959525060495,132,3.300000000000002E-4
3,test_20231101_135736,10188041.png,221231,7922,213309,0.9641912751829536,2,4,41731,1122,40609,0.9731135127363351,12.104391111111111,1422.528864,16.60019273604845,132,3.300000000000002E-4
4,test_20231101_135736,10287332.png,216980,10414,206566,0.9520047930684856,2,3,22337,1432,20905,0.9358911223530465,10.041297777777778,969.9734293333333,18.26320523150082,132,3.300000000000002E-4
5,test_20231101_135736,11610969.png,368720,19659,349061,0.9466831199826427,3,5,84111,2887,81224,0.9656763086873298,23.630064,3459.2615946666665,12.740969555969798,132,3.300000000000002E-4
6,test_20231101_135736,10350842.png,212614,4194,208420,0.9802741117706266,2,3,42529,617,41912,0.9854922523454583,21.679027555555557,2995.340346666667,13.366341844659766,132,3.300000000000002E-4
7,test_20231101_135736,10863862.png,317432,6817,310615,0.9785245343884674,2,4,66058,1003,65055,0.9848163734899633,35.86734577777778,6560.939296,9.96114341329509,132,3.300000000000002E-4
8,test_20231101_135736,11382381.png,312486,547,311939,0.9982495215785667,2,4,46745,72,46673,0.9984597283131885,22.81680888888889,2740.878352,13.751906001286724,132,3.300000000000002E-4
9,test_20231101_135736,11079715.png,443815,101847,341968,0.7705192478848168,4,4,124136,14305,109831,0.8847634852097699,18.156124444444444,2439.9212586666667,14.25704549889165,132,3.300000000000002E-4
10,test_20231101_135736,11551286.png,271883,164,271719,0.9993967993585476,1,4,40092,22,40070,0.9994512620971765,18.120286222222223,1899.5769013333334,15.344234809036362,132,3.300000000000002E-4
1,test_20231101_135737,10404007.png,502730,14514,488216,0.9711296322081435,2,3,61265,2115,59150,0.9654778421611034,26.39290488888889,3622.7017866666665,12.540477755873196,132,3.4000000000000024E-4
2,test_20231101_135737,1254659.png,342646,61432,281214,0.8207129223746957,3,4,80080,8654,71426,0.891933066933067,22.385354666666668,3656.9652693333333,12.49959525060495,132,3.4000000000000024E-4
3,test_20231101_135737,10188041.png,221231,7922,213309,0.9641912751829536,2,3,41731,1122,40609,0.9731135127363351,12.104391111111111,1422.528864,16.60019273604845,132,3.4000000000000024E-4
4,test_20231101_135737,10287332.png,216980,10414,206566,0.9520047930684856,2,4,22337,1432,20905,0.9358911223530465,10.041297777777778,969.9734293333333,18.26320523150082,132,3.4000000000000024E-4
5,test_20231101_135737,11610969.png,368720,19659,349061,0.9466831199826427,2,4,84111,2887,81224,0.9656763086873298,23.630064,3459.2615946666665,12.740969555969798,132,3.4000000000000024E-4
6,test_20231101_135737,10350842.png,212614,4194,208420,0.9802741117706266,2,4,42529,617,41912,0.9854922523454583,21.679027555555557,2995.340346666667,13.366341844659766,132,3.4000000000000024E-4
7,test_20231101_135737,10863862.png,317432,6817,310615,0.9785245343884674,1,3,66058,1003,65055,0.9848163734899633,35.86734577777778,6560.939296,9.96114341329509,132,3.4000000000000024E-4
8,test_20231101_135737,11382381.png,312486,547,311939,0.9982495215785667,1,4,46745,72,46673,0.9984597283131885,22.81680888888889,2740.878352,13.751906001286724,132,3.4000000000000024E-4
9,test_20231101_135737,11079715.png,443815,101847,341968,0.7705192478848168,4,6,124136,14305,109831,0.8847634852097699,18.156124444444444,2439.9212586666667,14.25704549889165,132,3.4000000000000024E-4
10,test_20231101_135737,11551286.png,271883,164,271719,0.9993967993585476,2,5,40092,22,40070,0.9994512620971765,18.120286222222223,1899.5769013333334,15.344234809036362,132,3.4000000000000024E-4
1,test_20231101_135738,10404007.png,502730,14514,488216,0.9711296322081435,2,4,61265,2115,59150,0.9654778421611034,26.39290488888889,3622.7017866666665,12.540477755873196,132,3.5000000000000027E-4
2,test_20231101_135738,1254659.png,342646,61432,281214,0.8207129223746957,3,5,80080,8654,71426,0.891933066933067,22.385354666666668,3656.9652693333333,12.49959525060495,132,3.5000000000000027E-4
3,test_20231101_135738,10188041.png,221231,7922,213309,0.9641912751829536,3,4,41731,1122,40609,0.9731135127363351,12.104391111111111,1422.528864,16.60019273604845,132,3.5000000000000027E-4
4,test_20231101_135738,10287332.png,216980,10414,206566,0.9520047930684856,2,4,22337,1432,20905,0.9358911223530465,10.041297777777778,969.9734293333333,18.26320523150082,132,3.5000000000000027E-4
5,test_20231101_135738,11610969.png,368720,19659,349061,0.9466831199826427,3,4,84111,2887,81224,0.9656763086873298,23.630064,3459.2615946666665,12.740969555969798,132,3.5000000000000027E-4
6,test_20231101_135738,10350842.png,212614,4194,208420,0.9802741117706266,2,3,42529,617,41912,0.9854922523454583,21.679027555555557,2995.340346666667,13.366341844659766,132,3.5000000000000027E-4
7,test_20231101_135738,10863862.png,317432,6817,310615,0.9785245343884674,2,4,66058,1003,65055,0.9848163734899633,35.86734577777778,6560.939296,9.96114341329509,132,3.5000000000000027E-4
8,test_20231101_135738,11382381.png,312486,547,311939,0.9982495215785667,2,4,46745,72,46673,0.9984597283131885,22.81680888888889,2740.878352,13.751906001286724,132,3.5000000000000027E-4
9,test_20231101_135738,11079715.png,443815,101847,341968,0.7705192478848168,3,4,124136,14305,109831,0.8847634852097699,18.156124444444444,2439.9212586666667,14.25704549889165,132,3.5000000000000027E-4
10,test_20231101_135738,11551286.png,271883,164,271719,0.9993967993585476,1,4,40092,22,40070,0.9994512620971765,18.120286222222223,1899.5769013333334,15.344234809036362,132,3.5000000000000027E-4
1,test_20231101_135739,10404007.png,502730,14514,488216,0.9711296322081435,2,4,61265,2115,59150,0.9654778421611034,26.39290488888889,3622.7017866666665,12.540477755873196,132,3.600000000000003E-4
2,test_20231101_135739,1254659.png,342646,61432,281214,0.8207129223746957,2,4,80080,8654,71426,0.891933066933067,22.385354666666668,3656.9652693333333,12.49959525060495,132,3.600000000000003E-4
3,test_20231101_135739,10188041.png,221231,7922,213309,0.9641912751829536,2,3,41731,1122,40609,0.9731135127363351,12.104391111111111,1422.528864,16.60019273604845,132,3.600000000000003E-4
4,test_20231101_135739,10287332.png,216980,10414,206566,0.9520047930684856,2,4,22337,1432,20905,0.9358911223530465,10.041297777777778,969.9734293333333,18.26320523150082,132,3.600000000000003E-4
5,test_20231101_135739,11610969.png,368720,19659,349061,0.9466831199826427,2,4,84111,2887,81224,0.9656763086873298,23.630064,3459.2615946666665,12.740969555969798,132,3.600000000000003E-4
6,test_20231101_135739,10350842.png,212614,4194,208420,0.9802741117706266,1,4,42529,617,41912,0.9854922523454583,21.679027555555557,2995.340346666667,13.366341844659766,132,3.600000000000003E-4
7,test_20231101_135739,10863862.png,317432,6817,310615,0.9785245343884674,1,3,66058,1003,65055,0.9848163734899633,35.86734577777778,6560.939296,9.96114341329509,132,3.600000000000003E-4
8,test_20231101_135739,11382381.png,312486,547,311939,0.9982495215785667,1,3,46745,72,46673,0.9984597283131885,22.81680888888889,2740.878352,13.751906001286724,132,3.600000000000003E-4
9,test_20231101_135739,11079715.png,443815,101847,341968,0.7705192478848168,3,4,124136,14305,109831,0.8847634852097699,18.156124444444444,2439.9212586666667,14.25704549889165,132,3.600000000000003E-4
10,test_20231101_135739,11551286.png,271883,164,271719,0.9993967993585476,2,4,40092,22,40070,0.9994512620971765,18.120286222222223,1899.5769013333334,15.344234809036362,132,3.600000000000003E-4
1,test_20231101_135739,10404007.png,502730,14514,488216,0.9711296322081435,3,3,61265,2115,59150,0.9654778421611034,26.39290488888889,3622.7017866666665,12.540477755873196,132,3.700000000000003E-4
2,test_20231101_135739,1254659.png,342646,61432,281214,0.8207129223746957,3,3,80080,8654,71426,0.891933066933067,22.385354666666668,3656.9652693333333,12.49959525060495,132,3.700000000000003E-4
3,test_20231101_135739,10188041.png,221231,7922,213309,0.9641912751829536,2,4,41731,1122,40609,0.9731135127363351,12.104391111111111,1422.528864,16.60019273604845,132,3.700000000000003E-4
4,test_20231101_135739,10287332.png,216980,10414,206566,0.9520047930684856,1,4,22337,1432,20905,0.9358911223530465,10.041297777777778,969.9734293333333,18.26320523150082,132,3.700000000000003E-4
5,test_20231101_135739,11610969.png,368720,19659,349061,0.9466831199826427,2,4,84111,2887,81224,0.9656763086873298,23.630064,3459.2615946666665,12.740969555969798,132,3.700000000000003E-4
6,test_20231101_135739,10350842.png,212614,4194,208420,0.9802741117706266,2,3,42529,617,41912,0.9854922523454583,21.679027555555557,2995.340346666667,13.366341844659766,132,3.700000000000003E-4
7,test_20231101_135739,10863862.png,317432,6817,310615,0.9785245343884674,2,3,66058,1003,65055,0.9848163734899633,35.86734577777778,6560.939296,9.96114341329509,132,3.700000000000003E-4
8,test_20231101_135739,11382381.png,312486,547,311939,0.9982495215785667,1,4,46745,72,46673,0.9984597283131885,22.81680888888889,2740.878352,13.751906001286724,132,3.700000000000003E-4
9,test_20231101_135739,11079715.png,443815,101847,341968,0.7705192478848168,3,4,124136,14305,109831,0.8847634852097699,18.156124444444444,2439.9212586666667,14.25704549889165,132,3.700000000000003E-4
10,test_20231101_135739,11551286.png,271883,164,271719,0.9993967993585476,5,4,40092,22,40070,0.9994512620971765,18.120286222222223,1899.5769013333334,15.344234809036362,132,3.700000000000003E-4
1,test_20231101_135740,10404007.png,502730,14514,488216,0.9711296322081435,2,3,61265,2115,59150,0.9654778421611034,26.39290488888889,3622.7017866666665,12.540477755873196,132,3.8000000000000035E-4
2,test_20231101_135740,1254659.png,342646,61432,281214,0.8207129223746957,3,4,80080,8654,71426,0.891933066933067,22.385354666666668,3656.9652693333333,12.49959525060495,132,3.8000000000000035E-4
3,test_20231101_135740,10188041.png,221231,7922,213309,0.9641912751829536,1,3,41731,1122,40609,0.9731135127363351,12.104391111111111,1422.528864,16.60019273604845,132,3.8000000000000035E-4
4,test_20231101_135740,10287332.png,216980,10414,206566,0.9520047930684856,1,3,22337,1432,20905,0.9358911223530465,10.041297777777778,969.9734293333333,18.26320523150082,132,3.8000000000000035E-4
5,test_20231101_135740,11610969.png,368720,19659,349061,0.9466831199826427,2,3,84111,2887,81224,0.9656763086873298,23.630064,3459.2615946666665,12.740969555969798,132,3.8000000000000035E-4
6,test_20231101_135740,10350842.png,212614,4194,208420,0.9802741117706266,2,3,42529,617,41912,0.9854922523454583,21.679027555555557,2995.340346666667,13.366341844659766,132,3.8000000000000035E-4
7,test_20231101_135740,10863862.png,317432,6817,310615,0.9785245343884674,1,3,66058,1003,65055,0.9848163734899633,35.86734577777778,6560.939296,9.96114341329509,132,3.8000000000000035E-4
8,test_20231101_135740,11382381.png,312486,547,311939,0.9982495215785667,2,3,46745,72,46673,0.9984597283131885,22.81680888888889,2740.878352,13.751906001286724,132,3.8000000000000035E-4
9,test_20231101_135740,11079715.png,443815,101847,341968,0.7705192478848168,3,4,124136,14305,109831,0.8847634852097699,18.156124444444444,2439.9212586666667,14.25704549889165,132,3.8000000000000035E-4
10,test_20231101_135740,11551286.png,271883,164,271719,0.9993967993585476,1,4,40092,22,40070,0.9994512620971765,18.120286222222223,1899.5769013333334,15.344234809036362,132,3.8000000000000035E-4
1,test_20231101_135741,10404007.png,502730,14514,488216,0.9711296322081435,2,4,61265,2115,59150,0.9654778421611034,26.39290488888889,3622.7017866666665,12.540477755873196,132,3.9000000000000037E-4
2,test_20231101_135741,1254659.png,342646,61432,281214,0.8207129223746957,2,4,80080,8654,71426,0.891933066933067,22.385354666666668,3656.9652693333333,12.49959525060495,132,3.9000000000000037E-4
3,test_20231101_135741,10188041.png,221231,7922,213309,0.9641912751829536,2,4,41731,1122,40609,0.9731135127363351,12.104391111111111,1422.528864,16.60019273604845,132,3.9000000000000037E-4
4,test_20231101_135741,10287332.png,216980,10414,206566,0.9520047930684856,1,3,22337,1432,20905,0.9358911223530465,10.041297777777778,969.9734293333333,18.26320523150082,132,3.9000000000000037E-4
5,test_20231101_135741,11610969.png,368720,19659,349061,0.9466831199826427,4,4,84111,2887,81224,0.9656763086873298,23.630064,3459.2615946666665,12.740969555969798,132,3.9000000000000037E-4
6,test_20231101_135741,10350842.png,212614,4194,208420,0.9802741117706266,1,4,42529,617,41912,0.9854922523454583,21.679027555555557,2995.340346666667,13.366341844659766,132,3.9000000000000037E-4
7,test_20231101_135741,10863862.png,317432,6817,310615,0.9785245343884674,2,4,66058,1003,65055,0.9848163734899633,35.86734577777778,6560.939296,9.96114341329509,132,3.9000000000000037E-4
8,test_20231101_135741,11382381.png,312486,547,311939,0.9982495215785667,1,4,46745,72,46673,0.9984597283131885,22.81680888888889,2740.878352,13.751906001286724,132,3.9000000000000037E-4
9,test_20231101_135741,11079715.png,443815,101847,341968,0.7705192478848168,3,4,124136,14305,109831,0.8847634852097699,18.156124444444444,2439.9212586666667,14.25704549889165,132,3.9000000000000037E-4
10,test_20231101_135741,11551286.png,271883,164,271719,0.9993967993585476,1,4,40092,22,40070,0.9994512620971765,18.120286222222223,1899.5769013333334,15.344234809036362,132,3.9000000000000037E-4
1,test_20231101_135741,10404007.png,502730,14514,488216,0.9711296322081435,2,4,61265,2115,59150,0.9654778421611034,26.39290488888889,3622.7017866666665,12.540477755873196,132,4.000000000000004E-4
2,test_20231101_135741,1254659.png,342646,61432,281214,0.8207129223746957,3,4,80080,8654,71426,0.891933066933067,22.385354666666668,3656.9652693333333,12.49959525060495,132,4.000000000000004E-4
3,test_20231101_135741,10188041.png,221231,7922,213309,0.9641912751829536,2,4,41731,1122,40609,0.9731135127363351,12.104391111111111,1422.528864,16.60019273604845,132,4.000000000000004E-4
4,test_20231101_135741,10287332.png,216980,10414,206566,0.9520047930684856,2,3,22337,1432,20905,0.9358911223530465,10.041297777777778,969.9734293333333,18.26320523150082,132,4.000000000000004E-4
5,test_20231101_135741,11610969.png,368720,19659,349061,0.9466831199826427,2,4,84111,2887,81224,0.9656763086873298,23.630064,3459.2615946666665,12.740969555969798,132,4.000000000000004E-4
6,test_20231101_135741,10350842.png,212614,4194,208420,0.9802741117706266,1,4,42529,617,41912,0.9854922523454583,21.679027555555557,2995.340346666667,13.366341844659766,132,4.000000000000004E-4
7,test_20231101_135741,10863862.png,317432,6817,310615,0.9785245343884674,2,3,66058,1003,65055,0.9848163734899633,35.86734577777778,6560.939296,9.96114341329509,132,4.000000000000004E-4
8,test_20231101_135741,11382381.png,312486,547,311939,0.9982495215785667,2,3,46745,72,46673,0.9984597283131885,22.81680888888889,2740.878352,13.751906001286724,132,4.000000000000004E-4
9,test_20231101_135741,11079715.png,443815,101847,341968,0.7705192478848168,3,4,124136,14305,109831,0.8847634852097699,18.156124444444444,2439.9212586666667,14.25704549889165,132,4.000000000000004E-4
10,test_20231101_135741,11551286.png,271883,164,271719,0.9993967993585476,1,4,40092,22,40070,0.9994512620971765,18.120286222222223,1899.5769013333334,15.344234809036362,132,4.000000000000004E-4
1,test_20231101_135742,10404007.png,502730,14514,488216,0.9711296322081435,2,4,61265,2115,59150,0.9654778421611034,26.39290488888889,3622.7017866666665,12.540477755873196,132,4.100000000000004E-4
2,test_20231101_135742,1254659.png,342646,61432,281214,0.8207129223746957,3,4,80080,8654,71426,0.891933066933067,22.385354666666668,3656.9652693333333,12.49959525060495,132,4.100000000000004E-4
3,test_20231101_135742,10188041.png,221231,7922,213309,0.9641912751829536,2,4,41731,1122,40609,0.9731135127363351,12.104391111111111,1422.528864,16.60019273604845,132,4.100000000000004E-4
4,test_20231101_135742,10287332.png,216980,10414,206566,0.9520047930684856,2,4,22337,1432,20905,0.9358911223530465,10.041297777777778,969.9734293333333,18.26320523150082,132,4.100000000000004E-4
5,test_20231101_135742,11610969.png,368720,19659,349061,0.9466831199826427,2,4,84111,2887,81224,0.9656763086873298,23.630064,3459.2615946666665,12.740969555969798,132,4.100000000000004E-4
6,test_20231101_135742,10350842.png,212614,4194,208420,0.9802741117706266,1,4,42529,617,41912,0.9854922523454583,21.679027555555557,2995.340346666667,13.366341844659766,132,4.100000000000004E-4
7,test_20231101_135742,10863862.png,317432,6817,310615,0.9785245343884674,2,4,66058,1003,65055,0.9848163734899633,35.86734577777778,6560.939296,9.96114341329509,132,4.100000000000004E-4
8,test_20231101_135742,11382381.png,312486,547,311939,0.9982495215785667,1,3,46745,72,46673,0.9984597283131885,22.81680888888889,2740.878352,13.751906001286724,132,4.100000000000004E-4
9,test_20231101_135742,11079715.png,443815,101847,341968,0.7705192478848168,11,4,124136,14305,109831,0.8847634852097699,18.156124444444444,2439.9212586666667,14.25704549889165,132,4.100000000000004E-4
10,test_20231101_135742,11551286.png,271883,164,271719,0.9993967993585476,1,3,40092,22,40070,0.9994512620971765,18.120286222222223,1899.5769013333334,15.344234809036362,132,4.100000000000004E-4
1,test_20231101_135743,10404007.png,502730,14514,488216,0.9711296322081435,2,4,61265,2115,59150,0.9654778421611034,26.39290488888889,3622.7017866666665,12.540477755873196,132,4.2000000000000045E-4
2,test_20231101_135743,1254659.png,342646,61432,281214,0.8207129223746957,3,4,80080,8654,71426,0.891933066933067,22.385354666666668,3656.9652693333333,12.49959525060495,132,4.2000000000000045E-4
3,test_20231101_135743,10188041.png,221231,7922,213309,0.9641912751829536,2,3,41731,1122,40609,0.9731135127363351,12.104391111111111,1422.528864,16.60019273604845,132,4.2000000000000045E-4
4,test_20231101_135743,10287332.png,216980,10414,206566,0.9520047930684856,2,4,22337,1432,20905,0.9358911223530465,10.041297777777778,969.9734293333333,18.26320523150082,132,4.2000000000000045E-4
5,test_20231101_135743,11610969.png,368720,19659,349061,0.9466831199826427,2,3,84111,2887,81224,0.9656763086873298,23.630064,3459.2615946666665,12.740969555969798,132,4.2000000000000045E-4
6,test_20231101_135743,10350842.png,212614,4194,208420,0.9802741117706266,2,4,42529,617,41912,0.9854922523454583,21.679027555555557,2995.340346666667,13.366341844659766,132,4.2000000000000045E-4
7,test_20231101_135743,10863862.png,317432,6817,310615,0.9785245343884674,2,4,66058,1003,65055,0.9848163734899633,35.86734577777778,6560.939296,9.96114341329509,132,4.2000000000000045E-4
8,test_20231101_135743,11382381.png,312486,547,311939,0.9982495215785667,1,4,46745,72,46673,0.9984597283131885,22.81680888888889,2740.878352,13.751906001286724,132,4.2000000000000045E-4
9,test_20231101_135743,11079715.png,443815,101847,341968,0.7705192478848168,3,4,124136,14305,109831,0.8847634852097699,18.156124444444444,2439.9212586666667,14.25704549889165,132,4.2000000000000045E-4
10,test_20231101_135743,11551286.png,271883,164,271719,0.9993967993585476,1,4,40092,22,40070,0.9994512620971765,18.120286222222223,1899.5769013333334,15.344234809036362,132,4.2000000000000045E-4
1,test_20231101_135743,10404007.png,502730,14514,488216,0.9711296322081435,2,3,61265,2115,59150,0.9654778421611034,26.39290488888889,3622.7017866666665,12.540477755873196,132,4.300000000000005E-4
2,test_20231101_135743,1254659.png,342646,61432,281214,0.8207129223746957,3,4,80080,8654,71426,0.891933066933067,22.385354666666668,3656.9652693333333,12.49959525060495,132,4.300000000000005E-4
3,test_20231101_135743,10188041.png,221231,7922,213309,0.9641912751829536,1,3,41731,1122,40609,0.9731135127363351,12.104391111111111,1422.528864,16.60019273604845,132,4.300000000000005E-4
4,test_20231101_135743,10287332.png,216980,10414,206566,0.9520047930684856,2,4,22337,1432,20905,0.9358911223530465,10.041297777777778,969.9734293333333,18.26320523150082,132,4.300000000000005E-4
5,test_20231101_135743,11610969.png,368720,19659,349061,0.9466831199826427,2,3,84111,2887,81224,0.9656763086873298,23.630064,3459.2615946666665,12.740969555969798,132,4.300000000000005E-4
6,test_20231101_135743,10350842.png,212614,4194,208420,0.9802741117706266,1,4,42529,617,41912,0.9854922523454583,21.679027555555557,2995.340346666667,13.366341844659766,132,4.300000000000005E-4
7,test_20231101_135743,10863862.png,317432,6817,310615,0.9785245343884674,1,4,66058,1003,65055,0.9848163734899633,35.86734577777778,6560.939296,9.96114341329509,132,4.300000000000005E-4
8,test_20231101_135743,11382381.png,312486,547,311939,0.9982495215785667,1,10,46745,72,46673,0.9984597283131885,22.81680888888889,2740.878352,13.751906001286724,132,4.300000000000005E-4
9,test_20231101_135743,11079715.png,443815,101847,341968,0.7705192478848168,3,6,124136,14305,109831,0.8847634852097699,18.156124444444444,2439.9212586666667,14.25704549889165,132,4.300000000000005E-4
10,test_20231101_135743,11551286.png,271883,164,271719,0.9993967993585476,2,4,40092,22,40070,0.9994512620971765,18.120286222222223,1899.5769013333334,15.344234809036362,132,4.300000000000005E-4
1,test_20231101_135744,10404007.png,502730,14514,488216,0.9711296322081435,2,4,61265,2115,59150,0.9654778421611034,26.39290488888889,3622.7017866666665,12.540477755873196,132,4.400000000000005E-4
2,test_20231101_135744,1254659.png,342646,61432,281214,0.8207129223746957,3,3,80080,8654,71426,0.891933066933067,22.385354666666668,3656.9652693333333,12.49959525060495,132,4.400000000000005E-4
3,test_20231101_135744,10188041.png,221231,7922,213309,0.9641912751829536,2,14,41731,1122,40609,0.9731135127363351,12.104391111111111,1422.528864,16.60019273604845,132,4.400000000000005E-4
4,test_20231101_135744,10287332.png,216980,10414,206566,0.9520047930684856,2,4,22337,1432,20905,0.9358911223530465,10.041297777777778,969.9734293333333,18.26320523150082,132,4.400000000000005E-4
5,test_20231101_135744,11610969.png,368720,19659,349061,0.9466831199826427,3,4,84111,2887,81224,0.9656763086873298,23.630064,3459.2615946666665,12.740969555969798,132,4.400000000000005E-4
6,test_20231101_135744,10350842.png,212614,4194,208420,0.9802741117706266,1,4,42529,617,41912,0.9854922523454583,21.679027555555557,2995.340346666667,13.366341844659766,132,4.400000000000005E-4
7,test_20231101_135744,10863862.png,317432,6817,310615,0.9785245343884674,2,4,66058,1003,65055,0.9848163734899633,35.86734577777778,6560.939296,9.96114341329509,132,4.400000000000005E-4
8,test_20231101_135744,11382381.png,312486,547,311939,0.9982495215785667,1,3,46745,72,46673,0.9984597283131885,22.81680888888889,2740.878352,13.751906001286724,132,4.400000000000005E-4
9,test_20231101_135744,11079715.png,443815,101847,341968,0.7705192478848168,4,4,124136,14305,109831,0.8847634852097699,18.156124444444444,2439.9212586666667,14.25704549889165,132,4.400000000000005E-4
10,test_20231101_135744,11551286.png,271883,164,271719,0.9993967993585476,1,3,40092,22,40070,0.9994512620971765,18.120286222222223,1899.5769013333334,15.344234809036362,132,4.400000000000005E-4
1,test_20231101_135745,10404007.png,502730,14514,488216,0.9711296322081435,2,3,61265,2115,59150,0.9654778421611034,26.39290488888889,3622.7017866666665,12.540477755873196,132,4.5000000000000053E-4
2,test_20231101_135745,1254659.png,342646,61432,281214,0.8207129223746957,3,4,80080,8654,71426,0.891933066933067,22.385354666666668,3656.9652693333333,12.49959525060495,132,4.5000000000000053E-4
3,test_20231101_135745,10188041.png,221231,7922,213309,0.9641912751829536,1,3,41731,1122,40609,0.9731135127363351,12.104391111111111,1422.528864,16.60019273604845,132,4.5000000000000053E-4
4,test_20231101_135745,10287332.png,216980,10414,206566,0.9520047930684856,2,4,22337,1432,20905,0.9358911223530465,10.041297777777778,969.9734293333333,18.26320523150082,132,4.5000000000000053E-4
5,test_20231101_135745,11610969.png,368720,19659,349061,0.9466831199826427,3,4,84111,2887,81224,0.9656763086873298,23.630064,3459.2615946666665,12.740969555969798,132,4.5000000000000053E-4
6,test_20231101_135745,10350842.png,212614,4194,208420,0.9802741117706266,2,3,42529,617,41912,0.9854922523454583,21.679027555555557,2995.340346666667,13.366341844659766,132,4.5000000000000053E-4
7,test_20231101_135745,10863862.png,317432,6817,310615,0.9785245343884674,1,3,66058,1003,65055,0.9848163734899633,35.86734577777778,6560.939296,9.96114341329509,132,4.5000000000000053E-4
8,test_20231101_135745,11382381.png,312486,547,311939,0.9982495215785667,1,3,46745,72,46673,0.9984597283131885,22.81680888888889,2740.878352,13.751906001286724,132,4.5000000000000053E-4
9,test_20231101_135745,11079715.png,443815,101847,341968,0.7705192478848168,4,4,124136,14305,109831,0.8847634852097699,18.156124444444444,2439.9212586666667,14.25704549889165,132,4.5000000000000053E-4
10,test_20231101_135745,11551286.png,271883,164,271719,0.9993967993585476,1,4,40092,22,40070,0.9994512620971765,18.120286222222223,1899.5769013333334,15.344234809036362,132,4.5000000000000053E-4
1,test_20231101_135746,10404007.png,502730,14514,488216,0.9711296322081435,2,4,61265,2115,59150,0.9654778421611034,26.39290488888889,3622.7017866666665,12.540477755873196,132,4.6000000000000056E-4
2,test_20231101_135746,1254659.png,342646,61432,281214,0.8207129223746957,3,4,80080,8654,71426,0.891933066933067,22.385354666666668,3656.9652693333333,12.49959525060495,132,4.6000000000000056E-4
3,test_20231101_135746,10188041.png,221231,7922,213309,0.9641912751829536,2,4,41731,1122,40609,0.9731135127363351,12.104391111111111,1422.528864,16.60019273604845,132,4.6000000000000056E-4
4,test_20231101_135746,10287332.png,216980,10414,206566,0.9520047930684856,1,3,22337,1432,20905,0.9358911223530465,10.041297777777778,969.9734293333333,18.26320523150082,132,4.6000000000000056E-4
5,test_20231101_135746,11610969.png,368720,19659,349061,0.9466831199826427,3,4,84111,2887,81224,0.9656763086873298,23.630064,3459.2615946666665,12.740969555969798,132,4.6000000000000056E-4
6,test_20231101_135746,10350842.png,212614,4194,208420,0.9802741117706266,2,4,42529,617,41912,0.9854922523454583,21.679027555555557,2995.340346666667,13.366341844659766,132,4.6000000000000056E-4
7,test_20231101_135746,10863862.png,317432,6817,310615,0.9785245343884674,2,3,66058,1003,65055,0.9848163734899633,35.86734577777778,6560.939296,9.96114341329509,132,4.6000000000000056E-4
8,test_20231101_135746,11382381.png,312486,547,311939,0.9982495215785667,1,4,46745,72,46673,0.9984597283131885,22.81680888888889,2740.878352,13.751906001286724,132,4.6000000000000056E-4
9,test_20231101_135746,11079715.png,443815,101847,341968,0.7705192478848168,12,4,124136,14305,109831,0.8847634852097699,18.156124444444444,2439.9212586666667,14.25704549889165,132,4.6000000000000056E-4
10,test_20231101_135746,11551286.png,271883,164,271719,0.9993967993585476,1,3,40092,22,40070,0.9994512620971765,18.120286222222223,1899.5769013333334,15.344234809036362,132,4.6000000000000056E-4
1,test_20231101_135746,10404007.png,502730,14514,488216,0.9711296322081435,2,3,61265,2115,59150,0.9654778421611034,26.39290488888889,3622.7017866666665,12.540477755873196,132,4.700000000000006E-4
2,test_20231101_135746,1254659.png,342646,61432,281214,0.8207129223746957,3,4,80080,8654,71426,0.891933066933067,22.385354666666668,3656.9652693333333,12.49959525060495,132,4.700000000000006E-4
3,test_20231101_135746,10188041.png,221231,7922,213309,0.9641912751829536,2,3,41731,1122,40609,0.9731135127363351,12.104391111111111,1422.528864,16.60019273604845,132,4.700000000000006E-4
4,test_20231101_135746,10287332.png,216980,10414,206566,0.9520047930684856,2,13,22337,1432,20905,0.9358911223530465,10.041297777777778,969.9734293333333,18.26320523150082,132,4.700000000000006E-4
5,test_20231101_135746,11610969.png,368720,19659,349061,0.9466831199826427,2,3,84111,2887,81224,0.9656763086873298,23.630064,3459.2615946666665,12.740969555969798,132,4.700000000000006E-4
6,test_20231101_135746,10350842.png,212614,4194,208420,0.9802741117706266,2,4,42529,617,41912,0.9854922523454583,21.679027555555557,2995.340346666667,13.366341844659766,132,4.700000000000006E-4
7,test_20231101_135746,10863862.png,317432,6817,310615,0.9785245343884674,1,3,66058,1003,65055,0.9848163734899633,35.86734577777778,6560.939296,9.96114341329509,132,4.700000000000006E-4
8,test_20231101_135746,11382381.png,312486,547,311939,0.9982495215785667,1,3,46745,72,46673,0.9984597283131885,22.81680888888889,2740.878352,13.751906001286724,132,4.700000000000006E-4
9,test_20231101_135746,11079715.png,443815,101847,341968,0.7705192478848168,4,4,124136,14305,109831,0.8847634852097699,18.156124444444444,2439.9212586666667,14.25704549889165,132,4.700000000000006E-4
10,test_20231101_135746,11551286.png,271883,164,271719,0.9993967993585476,2,3,40092,22,40070,0.9994512620971765,18.120286222222223,1899.5769013333334,15.344234809036362,132,4.700000000000006E-4
1,test_20231101_135747,10404007.png,502730,14514,488216,0.9711296322081435,2,4,61265,2115,59150,0.9654778421611034,26.39290488888889,3622.7017866666665,12.540477755873196,132,4.800000000000006E-4
2,test_20231101_135747,1254659.png,342646,61432,281214,0.8207129223746957,3,4,80080,8654,71426,0.891933066933067,22.385354666666668,3656.9652693333333,12.49959525060495,132,4.800000000000006E-4
3,test_20231101_135747,10188041.png,221231,7922,213309,0.9641912751829536,2,4,41731,1122,40609,0.9731135127363351,12.104391111111111,1422.528864,16.60019273604845,132,4.800000000000006E-4
4,test_20231101_135747,10287332.png,216980,10414,206566,0.9520047930684856,2,4,22337,1432,20905,0.9358911223530465,10.041297777777778,969.9734293333333,18.26320523150082,132,4.800000000000006E-4
5,test_20231101_135747,11610969.png,368720,19659,349061,0.9466831199826427,2,3,84111,2887,81224,0.9656763086873298,23.630064,3459.2615946666665,12.740969555969798,132,4.800000000000006E-4
6,test_20231101_135747,10350842.png,212614,4194,208420,0.9802741117706266,2,3,42529,617,41912,0.9854922523454583,21.679027555555557,2995.340346666667,13.366341844659766,132,4.800000000000006E-4
7,test_20231101_135747,10863862.png,317432,6817,310615,0.9785245343884674,1,3,66058,1003,65055,0.9848163734899633,35.86734577777778,6560.939296,9.96114341329509,132,4.800000000000006E-4
8,test_20231101_135747,11382381.png,312486,547,311939,0.9982495215785667,1,3,46745,72,46673,0.9984597283131885,22.81680888888889,2740.878352,13.751906001286724,132,4.800000000000006E-4
9,test_20231101_135747,11079715.png,443815,101847,341968,0.7705192478848168,4,4,124136,14305,109831,0.8847634852097699,18.156124444444444,2439.9212586666667,14.25704549889165,132,4.800000000000006E-4
10,test_20231101_135747,11551286.png,271883,164,271719,0.9993967993585476,1,3,40092,22,40070,0.9994512620971765,18.120286222222223,1899.5769013333334,15.344234809036362,132,4.800000000000006E-4
1,test_20231101_135748,10404007.png,502730,14514,488216,0.9711296322081435,2,4,61265,2115,59150,0.9654778421611034,26.39290488888889,3622.7017866666665,12.540477755873196,132,4.900000000000006E-4
2,test_20231101_135748,1254659.png,342646,61432,281214,0.8207129223746957,3,4,80080,8654,71426,0.891933066933067,22.385354666666668,3656.9652693333333,12.49959525060495,132,4.900000000000006E-4
3,test_20231101_135748,10188041.png,221231,7922,213309,0.9641912751829536,2,5,41731,1122,40609,0.9731135127363351,12.104391111111111,1422.528864,16.60019273604845,132,4.900000000000006E-4
4,test_20231101_135748,10287332.png,216980,10414,206566,0.9520047930684856,1,4,22337,1432,20905,0.9358911223530465,10.041297777777778,969.9734293333333,18.26320523150082,132,4.900000000000006E-4
5,test_20231101_135748,11610969.png,368720,19659,349061,0.9466831199826427,2,3,84111,2887,81224,0.9656763086873298,23.630064,3459.2615946666665,12.740969555969798,132,4.900000000000006E-4
6,test_20231101_135748,10350842.png,212614,4194,208420,0.9802741117706266,1,4,42529,617,41912,0.9854922523454583,21.679027555555557,2995.340346666667,13.366341844659766,132,4.900000000000006E-4
7,test_20231101_135748,10863862.png,317432,6817,310615,0.9785245343884674,2,3,66058,1003,65055,0.9848163734899633,35.86734577777778,6560.939296,9.96114341329509,132,4.900000000000006E-4
8,test_20231101_135748,11382381.png,312486,547,311939,0.9982495215785667,1,4,46745,72,46673,0.9984597283131885,22.81680888888889,2740.878352,13.751906001286724,132,4.900000000000006E-4
9,test_20231101_135748,11079715.png,443815,101847,341968,0.7705192478848168,3,4,124136,14305,109831,0.8847634852097699,18.156124444444444,2439.9212586666667,14.25704549889165,132,4.900000000000006E-4
10,test_20231101_135748,11551286.png,271883,164,271719,0.9993967993585476,2,3,40092,22,40070,0.9994512620971765,18.120286222222223,1899.5769013333334,15.344234809036362,132,4.900000000000006E-4
1,test_20231101_135748,10404007.png,502730,14514,488216,0.9711296322081435,2,4,61265,2115,59150,0.9654778421611034,26.39290488888889,3622.7017866666665,12.540477755873196,132,5.000000000000007E-4
2,test_20231101_135748,1254659.png,342646,61432,281214,0.8207129223746957,4,4,80080,8654,71426,0.891933066933067,22.385354666666668,3656.9652693333333,12.49959525060495,132,5.000000000000007E-4
3,test_20231101_135748,10188041.png,221231,7922,213309,0.9641912751829536,2,4,41731,1122,40609,0.9731135127363351,12.104391111111111,1422.528864,16.60019273604845,132,5.000000000000007E-4
4,test_20231101_135748,10287332.png,216980,10414,206566,0.9520047930684856,1,3,22337,1432,20905,0.9358911223530465,10.041297777777778,969.9734293333333,18.26320523150082,132,5.000000000000007E-4
5,test_20231101_135748,11610969.png,368720,19659,349061,0.9466831199826427,2,3,84111,2887,81224,0.9656763086873298,23.630064,3459.2615946666665,12.740969555969798,132,5.000000000000007E-4
6,test_20231101_135748,10350842.png,212614,4194,208420,0.9802741117706266,2,3,42529,617,41912,0.9854922523454583,21.679027555555557,2995.340346666667,13.366341844659766,132,5.000000000000007E-4
7,test_20231101_135748,10863862.png,317432,6817,310615,0.9785245343884674,2,3,66058,1003,65055,0.9848163734899633,35.86734577777778,6560.939296,9.96114341329509,132,5.000000000000007E-4
8,test_20231101_135748,11382381.png,312486,547,311939,0.9982495215785667,2,3,46745,72,46673,0.9984597283131885,22.81680888888889,2740.878352,13.751906001286724,132,5.000000000000007E-4
9,test_20231101_135748,11079715.png,443815,101847,341968,0.7705192478848168,3,4,124136,14305,109831,0.8847634852097699,18.156124444444444,2439.9212586666667,14.25704549889165,132,5.000000000000007E-4
10,test_20231101_135748,11551286.png,271883,164,271719,0.9993967993585476,1,3,40092,22,40070,0.9994512620971765,18.120286222222223,1899.5769013333334,15.344234809036362,132,5.000000000000007E-4
1,test_20231101_135749,10404007.png,502730,14514,488216,0.9711296322081435,2,4,61265,2115,59150,0.9654778421611034,26.39290488888889,3622.7017866666665,12.540477755873196,132,5.100000000000007E-4
2,test_20231101_135749,1254659.png,342646,61432,281214,0.8207129223746957,2,3,80080,8654,71426,0.891933066933067,22.385354666666668,3656.9652693333333,12.49959525060495,132,5.100000000000007E-4
3,test_20231101_135749,10188041.png,221231,7762,213469,0.9649145011323006,2,3,41731,1100,40631,0.9736406987611128,12.323424,1456.5967466666666,16.497410252526056,132,5.100000000000007E-4
4,test_20231101_135749,10287332.png,216980,10414,206566,0.9520047930684856,2,4,22337,1432,20905,0.9358911223530465,10.041297777777778,969.9734293333333,18.26320523150082,132,5.100000000000007E-4
5,test_20231101_135749,11610969.png,368720,19639,349081,0.9467373616836624,2,4,84111,2886,81225,0.9656881977387024,23.73571377777778,3469.4396746666666,12.728210203277182,132,5.100000000000007E-4
6,test_20231101_135749,10350842.png,212614,4112,208502,0.9806597872200326,2,3,42529,605,41924,0.9857744127536504,21.73920888888889,3005.7424906666665,13.351285900970453,132,5.100000000000007E-4
7,test_20231101_135749,10863862.png,317432,6737,310695,0.9787765568688727,2,3,66058,991,65067,0.9849980320324563,35.985262222222225,6580.745077333333,9.94805293294137,132,5.100000000000007E-4
8,test_20231101_135749,11382381.png,312486,547,311939,0.9982495215785667,1,3,46745,72,46673,0.9984597283131885,22.81680888888889,2740.878352,13.751906001286724,132,5.100000000000007E-4
9,test_20231101_135749,11079715.png,443815,101667,342148,0.7709248222795534,3,4,124136,14278,109858,0.8849809885931559,18.393388444444444,2481.930394666667,14.182907632523632,132,5.100000000000007E-4
10,test_20231101_135749,11551286.png,271883,164,271719,0.9993967993585476,2,3,40092,22,40070,0.9994512620971765,18.120286222222223,1899.5769013333334,15.344234809036362,132,5.100000000000007E-4
1,test_20231101_135750,10404007.png,502730,14514,488216,0.9711296322081435,2,3,61265,2115,59150,0.9654778421611034,26.39290488888889,3622.7017866666665,12.540477755873196,132,5.200000000000007E-4
2,test_20231101_135750,1254659.png,342646,61432,281214,0.8207129223746957,3,4,80080,8654,71426,0.891933066933067,22.385354666666668,3656.9652693333333,12.49959525060495,132,5.200000000000007E-4
3,test_20231101_135750,10188041.png,221231,7762,213469,0.9649145011323006,2,4,41731,1100,40631,0.9736406987611128,12.323424,1456.5967466666666,16.497410252526056,132,5.200000000000007E-4
4,test_20231101_135750,10287332.png,216980,10414,206566,0.9520047930684856,2,3,22337,1432,20905,0.9358911223530465,10.041297777777778,969.9734293333333,18.26320523150082,132,5.200000000000007E-4
5,test_20231101_135750,11610969.png,368720,19639,349081,0.9467373616836624,2,7,84111,2886,81225,0.9656881977387024,23.73571377777778,3469.4396746666666,12.728210203277182,132,5.200000000000007E-4
6,test_20231101_135750,10350842.png,212614,4112,208502,0.9806597872200326,1,4,42529,605,41924,0.9857744127536504,21.73920888888889,3005.7424906666665,13.351285900970453,132,5.200000000000007E-4
7,test_20231101_135750,10863862.png,317432,6737,310695,0.9787765568688727,2,4,66058,991,65067,0.9849980320324563,35.985262222222225,6580.745077333333,9.94805293294137,132,5.200000000000007E-4
8,test_20231101_135750,11382381.png,312486,547,311939,0.9982495215785667,1,3,46745,72,46673,0.9984597283131885,22.81680888888889,2740.878352,13.751906001286724,132,5.200000000000007E-4
9,test_20231101_135750,11079715.png,443815,101667,342148,0.7709248222795534,3,4,124136,14278,109858,0.8849809885931559,18.393388444444444,2481.930394666667,14.182907632523632,132,5.200000000000007E-4
10,test_20231101_135750,11551286.png,271883,164,271719,0.9993967993585476,1,4,40092,22,40070,0.9994512620971765,18.120286222222223,1899.5769013333334,15.344234809036362,132,5.200000000000007E-4
1,test_20231101_135750,10404007.png,502730,14514,488216,0.9711296322081435,2,4,61265,2115,59150,0.9654778421611034,26.39290488888889,3622.7017866666665,12.540477755873196,132,5.300000000000007E-4
2,test_20231101_135750,1254659.png,342646,61432,281214,0.8207129223746957,3,4,80080,8654,71426,0.891933066933067,22.385354666666668,3656.9652693333333,12.49959525060495,132,5.300000000000007E-4
3,test_20231101_135750,10188041.png,221231,7762,213469,0.9649145011323006,2,3,41731,1100,40631,0.9736406987611128,12.323424,1456.5967466666666,16.497410252526056,132,5.300000000000007E-4
4,test_20231101_135750,10287332.png,216980,10414,206566,0.9520047930684856,2,3,22337,1432,20905,0.9358911223530465,10.041297777777778,969.9734293333333,18.26320523150082,132,5.300000000000007E-4
5,test_20231101_135750,11610969.png,368720,19639,349081,0.9467373616836624,2,4,84111,2886,81225,0.9656881977387024,23.73571377777778,3469.4396746666666,12.728210203277182,132,5.300000000000007E-4
6,test_20231101_135750,10350842.png,212614,4112,208502,0.9806597872200326,2,4,42529,605,41924,0.9857744127536504,21.73920888888889,3005.7424906666665,13.351285900970453,132,5.300000000000007E-4
7,test_20231101_135750,10863862.png,317432,6737,310695,0.9787765568688727,2,6,66058,991,65067,0.9849980320324563,35.985262222222225,6580.745077333333,9.94805293294137,132,5.300000000000007E-4
8,test_20231101_135750,11382381.png,312486,547,311939,0.9982495215785667,1,3,46745,72,46673,0.9984597283131885,22.81680888888889,2740.878352,13.751906001286724,132,5.300000000000007E-4
9,test_20231101_135750,11079715.png,443815,101667,342148,0.7709248222795534,4,4,124136,14278,109858,0.8849809885931559,18.393388444444444,2481.930394666667,14.182907632523632,132,5.300000000000007E-4
10,test_20231101_135750,11551286.png,271883,164,271719,0.9993967993585476,1,4,40092,22,40070,0.9994512620971765,18.120286222222223,1899.5769013333334,15.344234809036362,132,5.300000000000007E-4
1,test_20231101_135751,10404007.png,502730,14514,488216,0.9711296322081435,2,4,61265,2115,59150,0.9654778421611034,26.39290488888889,3622.7017866666665,12.540477755873196,132,5.400000000000008E-4
2,test_20231101_135751,1254659.png,342646,61432,281214,0.8207129223746957,3,4,80080,8654,71426,0.891933066933067,22.385354666666668,3656.9652693333333,12.49959525060495,132,5.400000000000008E-4
3,test_20231101_135751,10188041.png,221231,7762,213469,0.9649145011323006,2,3,41731,1100,40631,0.9736406987611128,12.323424,1456.5967466666666,16.497410252526056,132,5.400000000000008E-4
4,test_20231101_135751,10287332.png,216980,10414,206566,0.9520047930684856,2,5,22337,1432,20905,0.9358911223530465,10.041297777777778,969.9734293333333,18.26320523150082,132,5.400000000000008E-4
5,test_20231101_135751,11610969.png,368720,19639,349081,0.9467373616836624,3,4,84111,2886,81225,0.9656881977387024,23.73571377777778,3469.4396746666666,12.728210203277182,132,5.400000000000008E-4
6,test_20231101_135751,10350842.png,212614,4112,208502,0.9806597872200326,2,3,42529,605,41924,0.9857744127536504,21.73920888888889,3005.7424906666665,13.351285900970453,132,5.400000000000008E-4
7,test_20231101_135751,10863862.png,317432,6737,310695,0.9787765568688727,1,3,66058,991,65067,0.9849980320324563,35.985262222222225,6580.745077333333,9.94805293294137,132,5.400000000000008E-4
8,test_20231101_135751,11382381.png,312486,547,311939,0.9982495215785667,2,4,46745,72,46673,0.9984597283131885,22.81680888888889,2740.878352,13.751906001286724,132,5.400000000000008E-4
9,test_20231101_135751,11079715.png,443815,101667,342148,0.7709248222795534,3,5,124136,14278,109858,0.8849809885931559,18.393388444444444,2481.930394666667,14.182907632523632,132,5.400000000000008E-4
10,test_20231101_135751,11551286.png,271883,164,271719,0.9993967993585476,1,4,40092,22,40070,0.9994512620971765,18.120286222222223,1899.5769013333334,15.344234809036362,132,5.400000000000008E-4
1,test_20231101_135752,10404007.png,502730,14514,488216,0.9711296322081435,3,3,61265,2115,59150,0.9654778421611034,26.39290488888889,3622.7017866666665,12.540477755873196,132,5.500000000000008E-4
2,test_20231101_135752,1254659.png,342646,61432,281214,0.8207129223746957,3,4,80080,8654,71426,0.891933066933067,22.385354666666668,3656.9652693333333,12.49959525060495,132,5.500000000000008E-4
3,test_20231101_135752,10188041.png,221231,7762,213469,0.9649145011323006,2,4,41731,1100,40631,0.9736406987611128,12.323424,1456.5967466666666,16.497410252526056,132,5.500000000000008E-4
4,test_20231101_135752,10287332.png,216980,10414,206566,0.9520047930684856,2,4,22337,1432,20905,0.9358911223530465,10.041297777777778,969.9734293333333,18.26320523150082,132,5.500000000000008E-4
5,test_20231101_135752,11610969.png,368720,19639,349081,0.9467373616836624,2,3,84111,2886,81225,0.9656881977387024,23.73571377777778,3469.4396746666666,12.728210203277182,132,5.500000000000008E-4
6,test_20231101_135752,10350842.png,212614,4112,208502,0.9806597872200326,1,4,42529,605,41924,0.9857744127536504,21.73920888888889,3005.7424906666665,13.351285900970453,132,5.500000000000008E-4
7,test_20231101_135752,10863862.png,317432,6737,310695,0.9787765568688727,1,4,66058,991,65067,0.9849980320324563,35.985262222222225,6580.745077333333,9.94805293294137,132,5.500000000000008E-4
8,test_20231101_135752,11382381.png,312486,547,311939,0.9982495215785667,1,3,46745,72,46673,0.9984597283131885,22.81680888888889,2740.878352,13.751906001286724,132,5.500000000000008E-4
9,test_20231101_135752,11079715.png,443815,101667,342148,0.7709248222795534,3,5,124136,14278,109858,0.8849809885931559,18.393388444444444,2481.930394666667,14.182907632523632,132,5.500000000000008E-4
10,test_20231101_135752,11551286.png,271883,164,271719,0.9993967993585476,2,3,40092,22,40070,0.9994512620971765,18.120286222222223,1899.5769013333334,15.344234809036362,132,5.500000000000008E-4
1,test_20231101_135752,10404007.png,502730,14514,488216,0.9711296322081435,2,3,61265,2115,59150,0.9654778421611034,26.39290488888889,3622.7017866666665,12.540477755873196,132,5.600000000000008E-4
2,test_20231101_135752,1254659.png,342646,61432,281214,0.8207129223746957,3,4,80080,8654,71426,0.891933066933067,22.385354666666668,3656.9652693333333,12.49959525060495,132,5.600000000000008E-4
3,test_20231101_135752,10188041.png,221231,7762,213469,0.9649145011323006,2,3,41731,1100,40631,0.9736406987611128,12.323424,1456.5967466666666,16.497410252526056,132,5.600000000000008E-4
4,test_20231101_135752,10287332.png,216980,10414,206566,0.9520047930684856,2,4,22337,1432,20905,0.9358911223530465,10.041297777777778,969.9734293333333,18.26320523150082,132,5.600000000000008E-4
5,test_20231101_135752,11610969.png,368720,19639,349081,0.9467373616836624,2,4,84111,2886,81225,0.9656881977387024,23.73571377777778,3469.4396746666666,12.728210203277182,132,5.600000000000008E-4
6,test_20231101_135752,10350842.png,212614,4112,208502,0.9806597872200326,2,4,42529,605,41924,0.9857744127536504,21.73920888888889,3005.7424906666665,13.351285900970453,132,5.600000000000008E-4
7,test_20231101_135752,10863862.png,317432,6737,310695,0.9787765568688727,2,4,66058,991,65067,0.9849980320324563,35.985262222222225,6580.745077333333,9.94805293294137,132,5.600000000000008E-4
8,test_20231101_135752,11382381.png,312486,547,311939,0.9982495215785667,1,4,46745,72,46673,0.9984597283131885,22.81680888888889,2740.878352,13.751906001286724,132,5.600000000000008E-4
9,test_20231101_135752,11079715.png,443815,101667,342148,0.7709248222795534,3,4,124136,14278,109858,0.8849809885931559,18.393388444444444,2481.930394666667,14.182907632523632,132,5.600000000000008E-4
10,test_20231101_135752,11551286.png,271883,164,271719,0.9993967993585476,2,3,40092,22,40070,0.9994512620971765,18.120286222222223,1899.5769013333334,15.344234809036362,132,5.600000000000008E-4
1,test_20231101_135753,10404007.png,502730,14514,488216,0.9711296322081435,2,4,61265,2115,59150,0.9654778421611034,26.39290488888889,3622.7017866666665,12.540477755873196,132,5.700000000000008E-4
2,test_20231101_135753,1254659.png,342646,61432,281214,0.8207129223746957,2,3,80080,8654,71426,0.891933066933067,22.385354666666668,3656.9652693333333,12.49959525060495,132,5.700000000000008E-4
3,test_20231101_135753,10188041.png,221231,7762,213469,0.9649145011323006,2,4,41731,1100,40631,0.9736406987611128,12.323424,1456.5967466666666,16.497410252526056,132,5.700000000000008E-4
4,test_20231101_135753,10287332.png,216980,10414,206566,0.9520047930684856,1,4,22337,1432,20905,0.9358911223530465,10.041297777777778,969.9734293333333,18.26320523150082,132,5.700000000000008E-4
5,test_20231101_135753,11610969.png,368720,19639,349081,0.9467373616836624,3,4,84111,2886,81225,0.9656881977387024,23.73571377777778,3469.4396746666666,12.728210203277182,132,5.700000000000008E-4
6,test_20231101_135753,10350842.png,212614,4112,208502,0.9806597872200326,2,3,42529,605,41924,0.9857744127536504,21.73920888888889,3005.7424906666665,13.351285900970453,132,5.700000000000008E-4
7,test_20231101_135753,10863862.png,317432,6737,310695,0.9787765568688727,2,4,66058,991,65067,0.9849980320324563,35.985262222222225,6580.745077333333,9.94805293294137,132,5.700000000000008E-4
8,test_20231101_135753,11382381.png,312486,547,311939,0.9982495215785667,1,4,46745,72,46673,0.9984597283131885,22.81680888888889,2740.878352,13.751906001286724,132,5.700000000000008E-4
9,test_20231101_135753,11079715.png,443815,101667,342148,0.7709248222795534,3,4,124136,14278,109858,0.8849809885931559,18.393388444444444,2481.930394666667,14.182907632523632,132,5.700000000000008E-4
10,test_20231101_135753,11551286.png,271883,164,271719,0.9993967993585476,1,4,40092,22,40070,0.9994512620971765,18.120286222222223,1899.5769013333334,15.344234809036362,132,5.700000000000008E-4
1,test_20231101_135754,10404007.png,502730,14514,488216,0.9711296322081435,2,4,61265,2115,59150,0.9654778421611034,26.39290488888889,3622.7017866666665,12.540477755873196,132,5.800000000000009E-4
2,test_20231101_135754,1254659.png,342646,61432,281214,0.8207129223746957,2,4,80080,8654,71426,0.891933066933067,22.385354666666668,3656.9652693333333,12.49959525060495,132,5.800000000000009E-4
3,test_20231101_135754,10188041.png,221231,7762,213469,0.9649145011323006,2,3,41731,1100,40631,0.9736406987611128,12.323424,1456.5967466666666,16.497410252526056,132,5.800000000000009E-4
4,test_20231101_135754,10287332.png,216980,10414,206566,0.9520047930684856,2,3,22337,1432,20905,0.9358911223530465,10.041297777777778,969.9734293333333,18.26320523150082,132,5.800000000000009E-4
5,test_20231101_135754,11610969.png,368720,19639,349081,0.9467373616836624,2,4,84111,2886,81225,0.9656881977387024,23.73571377777778,3469.4396746666666,12.728210203277182,132,5.800000000000009E-4
6,test_20231101_135754,10350842.png,212614,3209,209405,0.9849069205226373,1,3,42529,471,42058,0.9889252039784617,24.746065777777776,3737.8829333333333,12.404546652706536,132,5.800000000000009E-4
7,test_20231101_135754,10863862.png,317432,6737,310695,0.9787765568688727,2,3,66058,991,65067,0.9849980320324563,35.985262222222225,6580.745077333333,9.94805293294137,132,5.800000000000009E-4
8,test_20231101_135754,11382381.png,312486,547,311939,0.9982495215785667,1,4,46745,72,46673,0.9984597283131885,22.81680888888889,2740.878352,13.751906001286724,132,5.800000000000009E-4
9,test_20231101_135754,11079715.png,443815,101667,342148,0.7709248222795534,3,4,124136,14278,109858,0.8849809885931559,18.393388444444444,2481.930394666667,14.182907632523632,132,5.800000000000009E-4
10,test_20231101_135754,11551286.png,271883,164,271719,0.9993967993585476,2,4,40092,22,40070,0.9994512620971765,18.120286222222223,1899.5769013333334,15.344234809036362,132,5.800000000000009E-4
1,test_20231101_135754,10404007.png,502730,14514,488216,0.9711296322081435,2,4,61265,2115,59150,0.9654778421611034,26.39290488888889,3622.7017866666665,12.540477755873196,132,5.900000000000009E-4
2,test_20231101_135754,1254659.png,342646,61432,281214,0.8207129223746957,3,4,80080,8654,71426,0.891933066933067,22.385354666666668,3656.9652693333333,12.49959525060495,132,5.900000000000009E-4
3,test_20231101_135754,10188041.png,221231,7762,213469,0.9649145011323006,2,4,41731,1100,40631,0.9736406987611128,12.323424,1456.5967466666666,16.497410252526056,132,5.900000000000009E-4
4,test_20231101_135754,10287332.png,216980,10414,206566,0.9520047930684856,1,4,22337,1432,20905,0.9358911223530465,10.041297777777778,969.9734293333333,18.26320523150082,132,5.900000000000009E-4
5,test_20231101_135754,11610969.png,368720,19639,349081,0.9467373616836624,2,4,84111,2886,81225,0.9656881977387024,23.73571377777778,3469.4396746666666,12.728210203277182,132,5.900000000000009E-4
6,test_20231101_135754,10350842.png,212614,3209,209405,0.9849069205226373,2,4,42529,471,42058,0.9889252039784617,24.746065777777776,3737.8829333333333,12.404546652706536,132,5.900000000000009E-4
7,test_20231101_135754,10863862.png,317432,6737,310695,0.9787765568688727,2,4,66058,991,65067,0.9849980320324563,35.985262222222225,6580.745077333333,9.94805293294137,132,5.900000000000009E-4
8,test_20231101_135754,11382381.png,312486,547,311939,0.9982495215785667,2,4,46745,72,46673,0.9984597283131885,22.81680888888889,2740.878352,13.751906001286724,132,5.900000000000009E-4
9,test_20231101_135754,11079715.png,443815,101667,342148,0.7709248222795534,3,4,124136,14278,109858,0.8849809885931559,18.393388444444444,2481.930394666667,14.182907632523632,132,5.900000000000009E-4
10,test_20231101_135754,11551286.png,271883,164,271719,0.9993967993585476,2,4,40092,22,40070,0.9994512620971765,18.120286222222223,1899.5769013333334,15.344234809036362,132,5.900000000000009E-4
1,test_20231101_135755,10404007.png,502730,14514,488216,0.9711296322081435,3,3,61265,2115,59150,0.9654778421611034,26.39290488888889,3622.7017866666665,12.540477755873196,132,6.000000000000009E-4
2,test_20231101_135755,1254659.png,342646,61432,281214,0.8207129223746957,3,4,80080,8654,71426,0.891933066933067,22.385354666666668,3656.9652693333333,12.49959525060495,132,6.000000000000009E-4
3,test_20231101_135755,10188041.png,221231,7762,213469,0.9649145011323006,2,4,41731,1100,40631,0.9736406987611128,12.323424,1456.5967466666666,16.497410252526056,132,6.000000000000009E-4
4,test_20231101_135755,10287332.png,216980,10414,206566,0.9520047930684856,2,4,22337,1432,20905,0.9358911223530465,10.041297777777778,969.9734293333333,18.26320523150082,132,6.000000000000009E-4
5,test_20231101_135755,11610969.png,368720,19639,349081,0.9467373616836624,2,4,84111,2886,81225,0.9656881977387024,23.73571377777778,3469.4396746666666,12.728210203277182,132,6.000000000000009E-4
6,test_20231101_135755,10350842.png,212614,3209,209405,0.9849069205226373,1,4,42529,471,42058,0.9889252039784617,24.746065777777776,3737.8829333333333,12.404546652706536,132,6.000000000000009E-4
7,test_20231101_135755,10863862.png,317432,6737,310695,0.9787765568688727,2,4,66058,991,65067,0.9849980320324563,35.985262222222225,6580.745077333333,9.94805293294137,132,6.000000000000009E-4
8,test_20231101_135755,11382381.png,312486,547,311939,0.9982495215785667,1,3,46745,72,46673,0.9984597283131885,22.81680888888889,2740.878352,13.751906001286724,132,6.000000000000009E-4
9,test_20231101_135755,11079715.png,443815,101667,342148,0.7709248222795534,3,4,124136,14278,109858,0.8849809885931559,18.393388444444444,2481.930394666667,14.182907632523632,132,6.000000000000009E-4
10,test_20231101_135755,11551286.png,271883,164,271719,0.9993967993585476,1,4,40092,22,40070,0.9994512620971765,18.120286222222223,1899.5769013333334,15.344234809036362,132,6.000000000000009E-4
1,test_20231101_135756,10404007.png,502730,14514,488216,0.9711296322081435,2,4,61265,2115,59150,0.9654778421611034,26.39290488888889,3622.7017866666665,12.540477755873196,132,6.10000000000001E-4
2,test_20231101_135756,1254659.png,342646,61432,281214,0.8207129223746957,3,4,80080,8654,71426,0.891933066933067,22.385354666666668,3656.9652693333333,12.49959525060495,132,6.10000000000001E-4
3,test_20231101_135756,10188041.png,221231,7762,213469,0.9649145011323006,1,3,41731,1100,40631,0.9736406987611128,12.323424,1456.5967466666666,16.497410252526056,132,6.10000000000001E-4
4,test_20231101_135756,10287332.png,216980,10414,206566,0.9520047930684856,2,3,22337,1432,20905,0.9358911223530465,10.041297777777778,969.9734293333333,18.26320523150082,132,6.10000000000001E-4
5,test_20231101_135756,11610969.png,368720,19639,349081,0.9467373616836624,3,4,84111,2886,81225,0.9656881977387024,23.73571377777778,3469.4396746666666,12.728210203277182,132,6.10000000000001E-4
6,test_20231101_135756,10350842.png,212614,3209,209405,0.9849069205226373,1,4,42529,471,42058,0.9889252039784617,24.746065777777776,3737.8829333333333,12.404546652706536,132,6.10000000000001E-4
7,test_20231101_135756,10863862.png,317432,6737,310695,0.9787765568688727,1,4,66058,991,65067,0.9849980320324563,35.985262222222225,6580.745077333333,9.94805293294137,132,6.10000000000001E-4
8,test_20231101_135756,11382381.png,312486,547,311939,0.9982495215785667,1,4,46745,72,46673,0.9984597283131885,22.81680888888889,2740.878352,13.751906001286724,132,6.10000000000001E-4
9,test_20231101_135756,11079715.png,443815,101667,342148,0.7709248222795534,3,4,124136,14278,109858,0.8849809885931559,18.393388444444444,2481.930394666667,14.182907632523632,132,6.10000000000001E-4
10,test_20231101_135756,11551286.png,271883,164,271719,0.9993967993585476,2,3,40092,22,40070,0.9994512620971765,18.120286222222223,1899.5769013333334,15.344234809036362,132,6.10000000000001E-4
1,test_20231101_135756,10404007.png,502730,14514,488216,0.9711296322081435,2,4,61265,2115,59150,0.9654778421611034,26.39290488888889,3622.7017866666665,12.540477755873196,132,6.20000000000001E-4
2,test_20231101_135756,1254659.png,342646,61432,281214,0.8207129223746957,3,4,80080,8654,71426,0.891933066933067,22.385354666666668,3656.9652693333333,12.49959525060495,132,6.20000000000001E-4
3,test_20231101_135756,10188041.png,221231,7762,213469,0.9649145011323006,2,13,41731,1100,40631,0.9736406987611128,12.323424,1456.5967466666666,16.497410252526056,132,6.20000000000001E-4
4,test_20231101_135756,10287332.png,216980,10414,206566,0.9520047930684856,2,4,22337,1432,20905,0.9358911223530465,10.041297777777778,969.9734293333333,18.26320523150082,132,6.20000000000001E-4
5,test_20231101_135756,11610969.png,368720,19639,349081,0.9467373616836624,2,3,84111,2886,81225,0.9656881977387024,23.73571377777778,3469.4396746666666,12.728210203277182,132,6.20000000000001E-4
6,test_20231101_135756,10350842.png,212614,3209,209405,0.9849069205226373,2,3,42529,471,42058,0.9889252039784617,24.746065777777776,3737.8829333333333,12.404546652706536,132,6.20000000000001E-4
7,test_20231101_135756,10863862.png,317432,6737,310695,0.9787765568688727,4,4,66058,991,65067,0.9849980320324563,35.985262222222225,6580.745077333333,9.94805293294137,132,6.20000000000001E-4
8,test_20231101_135756,11382381.png,312486,547,311939,0.9982495215785667,1,4,46745,72,46673,0.9984597283131885,22.81680888888889,2740.878352,13.751906001286724,132,6.20000000000001E-4
9,test_20231101_135756,11079715.png,443815,101667,342148,0.7709248222795534,3,4,124136,14278,109858,0.8849809885931559,18.393388444444444,2481.930394666667,14.182907632523632,132,6.20000000000001E-4
10,test_20231101_135756,11551286.png,271883,164,271719,0.9993967993585476,1,3,40092,22,40070,0.9994512620971765,18.120286222222223,1899.5769013333334,15.344234809036362,132,6.20000000000001E-4
1,test_20231101_135757,10404007.png,502730,14514,488216,0.9711296322081435,3,3,61265,2115,59150,0.9654778421611034,26.39290488888889,3622.7017866666665,12.540477755873196,132,6.30000000000001E-4
2,test_20231101_135757,1254659.png,342646,61432,281214,0.8207129223746957,2,3,80080,8654,71426,0.891933066933067,22.385354666666668,3656.9652693333333,12.49959525060495,132,6.30000000000001E-4
3,test_20231101_135757,10188041.png,221231,7762,213469,0.9649145011323006,2,3,41731,1100,40631,0.9736406987611128,12.323424,1456.5967466666666,16.497410252526056,132,6.30000000000001E-4
4,test_20231101_135757,10287332.png,216980,10414,206566,0.9520047930684856,2,4,22337,1432,20905,0.9358911223530465,10.041297777777778,969.9734293333333,18.26320523150082,132,6.30000000000001E-4
5,test_20231101_135757,11610969.png,368720,19639,349081,0.9467373616836624,2,4,84111,2886,81225,0.9656881977387024,23.73571377777778,3469.4396746666666,12.728210203277182,132,6.30000000000001E-4
6,test_20231101_135757,10350842.png,212614,3209,209405,0.9849069205226373,1,3,42529,471,42058,0.9889252039784617,24.746065777777776,3737.8829333333333,12.404546652706536,132,6.30000000000001E-4
7,test_20231101_135757,10863862.png,317432,6737,310695,0.9787765568688727,1,3,66058,991,65067,0.9849980320324563,35.985262222222225,6580.745077333333,9.94805293294137,132,6.30000000000001E-4
8,test_20231101_135757,11382381.png,312486,547,311939,0.9982495215785667,1,4,46745,72,46673,0.9984597283131885,22.81680888888889,2740.878352,13.751906001286724,132,6.30000000000001E-4
9,test_20231101_135757,11079715.png,443815,101667,342148,0.7709248222795534,3,4,124136,14278,109858,0.8849809885931559,18.393388444444444,2481.930394666667,14.182907632523632,132,6.30000000000001E-4
10,test_20231101_135757,11551286.png,271883,164,271719,0.9993967993585476,1,3,40092,22,40070,0.9994512620971765,18.120286222222223,1899.5769013333334,15.344234809036362,132,6.30000000000001E-4
1,test_20231101_135758,10404007.png,502730,14514,488216,0.9711296322081435,2,4,61265,2115,59150,0.9654778421611034,26.39290488888889,3622.7017866666665,12.540477755873196,132,6.40000000000001E-4
2,test_20231101_135758,1254659.png,342646,61432,281214,0.8207129223746957,3,13,80080,8654,71426,0.891933066933067,22.385354666666668,3656.9652693333333,12.49959525060495,132,6.40000000000001E-4
3,test_20231101_135758,10188041.png,221231,7682,213549,0.9652761141069741,2,3,41731,1090,40641,0.9738803287723754,12.362325333333333,1460.681248,16.485249069719707,132,6.40000000000001E-4
4,test_20231101_135758,10287332.png,216980,10414,206566,0.9520047930684856,2,4,22337,1432,20905,0.9358911223530465,10.041297777777778,969.9734293333333,18.26320523150082,132,6.40000000000001E-4
5,test_20231101_135758,11610969.png,368720,19639,349081,0.9467373616836624,2,4,84111,2886,81225,0.9656881977387024,23.73571377777778,3469.4396746666666,12.728210203277182,132,6.40000000000001E-4
6,test_20231101_135758,10350842.png,212614,3209,209405,0.9849069205226373,1,3,42529,471,42058,0.9889252039784617,24.746065777777776,3737.8829333333333,12.404546652706536,132,6.40000000000001E-4
7,test_20231101_135758,10863862.png,317432,6737,310695,0.9787765568688727,1,4,66058,991,65067,0.9849980320324563,35.985262222222225,6580.745077333333,9.94805293294137,132,6.40000000000001E-4
8,test_20231101_135758,11382381.png,312486,547,311939,0.9982495215785667,1,4,46745,72,46673,0.9984597283131885,22.81680888888889,2740.878352,13.751906001286724,132,6.40000000000001E-4
9,test_20231101_135758,11079715.png,443815,101667,342148,0.7709248222795534,3,5,124136,14278,109858,0.8849809885931559,18.393388444444444,2481.930394666667,14.182907632523632,132,6.40000000000001E-4
10,test_20231101_135758,11551286.png,271883,164,271719,0.9993967993585476,2,4,40092,22,40070,0.9994512620971765,18.120286222222223,1899.5769013333334,15.344234809036362,132,6.40000000000001E-4
1,test_20231101_135759,10404007.png,502730,14514,488216,0.9711296322081435,2,4,61265,2115,59150,0.9654778421611034,26.39290488888889,3622.7017866666665,12.540477755873196,132,6.500000000000011E-4
2,test_20231101_135759,1254659.png,342646,61432,281214,0.8207129223746957,4,4,80080,8654,71426,0.891933066933067,22.385354666666668,3656.9652693333333,12.49959525060495,132,6.500000000000011E-4
3,test_20231101_135759,10188041.png,221231,7682,213549,0.9652761141069741,2,5,41731,1090,40641,0.9738803287723754,12.362325333333333,1460.681248,16.485249069719707,132,6.500000000000011E-4
4,test_20231101_135759,10287332.png,216980,10414,206566,0.9520047930684856,2,4,22337,1432,20905,0.9358911223530465,10.041297777777778,969.9734293333333,18.26320523150082,132,6.500000000000011E-4
5,test_20231101_135759,11610969.png,368720,19639,349081,0.9467373616836624,3,4,84111,2886,81225,0.9656881977387024,23.73571377777778,3469.4396746666666,12.728210203277182,132,6.500000000000011E-4
6,test_20231101_135759,10350842.png,212614,3209,209405,0.9849069205226373,2,4,42529,471,42058,0.9889252039784617,24.746065777777776,3737.8829333333333,12.404546652706536,132,6.500000000000011E-4
7,test_20231101_135759,10863862.png,317432,6737,310695,0.9787765568688727,1,4,66058,991,65067,0.9849980320324563,35.985262222222225,6580.745077333333,9.94805293294137,132,6.500000000000011E-4
8,test_20231101_135759,11382381.png,312486,547,311939,0.9982495215785667,1,4,46745,72,46673,0.9984597283131885,22.81680888888889,2740.878352,13.751906001286724,132,6.500000000000011E-4
9,test_20231101_135759,11079715.png,443815,101667,342148,0.7709248222795534,4,4,124136,14278,109858,0.8849809885931559,18.393388444444444,2481.930394666667,14.182907632523632,132,6.500000000000011E-4
10,test_20231101_135759,11551286.png,271883,164,271719,0.9993967993585476,1,3,40092,22,40070,0.9994512620971765,18.120286222222223,1899.5769013333334,15.344234809036362,132,6.500000000000011E-4
1,test_20231101_135759,10404007.png,502730,14514,488216,0.9711296322081435,3,4,61265,2115,59150,0.9654778421611034,26.39290488888889,3622.7017866666665,12.540477755873196,132,6.600000000000011E-4
2,test_20231101_135759,1254659.png,342646,61432,281214,0.8207129223746957,3,4,80080,8654,71426,0.891933066933067,22.385354666666668,3656.9652693333333,12.49959525060495,132,6.600000000000011E-4
3,test_20231101_135759,10188041.png,221231,7682,213549,0.9652761141069741,2,19,41731,1090,40641,0.9738803287723754,12.362325333333333,1460.681248,16.485249069719707,132,6.600000000000011E-4
4,test_20231101_135759,10287332.png,216980,10414,206566,0.9520047930684856,3,4,22337,1432,20905,0.9358911223530465,10.041297777777778,969.9734293333333,18.26320523150082,132,6.600000000000011E-4
5,test_20231101_135759,11610969.png,368720,19639,349081,0.9467373616836624,2,4,84111,2886,81225,0.9656881977387024,23.73571377777778,3469.4396746666666,12.728210203277182,132,6.600000000000011E-4
6,test_20231101_135759,10350842.png,212614,3209,209405,0.9849069205226373,1,3,42529,471,42058,0.9889252039784617,24.746065777777776,3737.8829333333333,12.404546652706536,132,6.600000000000011E-4
7,test_20231101_135759,10863862.png,317432,6737,310695,0.9787765568688727,1,4,66058,991,65067,0.9849980320324563,35.985262222222225,6580.745077333333,9.94805293294137,132,6.600000000000011E-4
8,test_20231101_135759,11382381.png,312486,547,311939,0.9982495215785667,2,3,46745,72,46673,0.9984597283131885,22.81680888888889,2740.878352,13.751906001286724,132,6.600000000000011E-4
9,test_20231101_135759,11079715.png,443815,101667,342148,0.7709248222795534,4,4,124136,14278,109858,0.8849809885931559,18.393388444444444,2481.930394666667,14.182907632523632,132,6.600000000000011E-4
10,test_20231101_135759,11551286.png,271883,164,271719,0.9993967993585476,1,4,40092,22,40070,0.9994512620971765,18.120286222222223,1899.5769013333334,15.344234809036362,132,6.600000000000011E-4
1,test_20231101_135800,10404007.png,502730,14514,488216,0.9711296322081435,2,4,61265,2115,59150,0.9654778421611034,26.39290488888889,3622.7017866666665,12.540477755873196,132,6.700000000000011E-4
2,test_20231101_135800,1254659.png,342646,61432,281214,0.8207129223746957,2,4,80080,8654,71426,0.891933066933067,22.385354666666668,3656.9652693333333,12.49959525060495,132,6.700000000000011E-4
3,test_20231101_135800,10188041.png,221231,7682,213549,0.9652761141069741,2,4,41731,1090,40641,0.9738803287723754,12.362325333333333,1460.681248,16.485249069719707,132,6.700000000000011E-4
4,test_20231101_135800,10287332.png,216980,10414,206566,0.9520047930684856,2,4,22337,1432,20905,0.9358911223530465,10.041297777777778,969.9734293333333,18.26320523150082,132,6.700000000000011E-4
5,test_20231101_135800,11610969.png,368720,19639,349081,0.9467373616836624,3,4,84111,2886,81225,0.9656881977387024,23.73571377777778,3469.4396746666666,12.728210203277182,132,6.700000000000011E-4
6,test_20231101_135800,10350842.png,212614,3209,209405,0.9849069205226373,1,3,42529,471,42058,0.9889252039784617,24.746065777777776,3737.8829333333333,12.404546652706536,132,6.700000000000011E-4
7,test_20231101_135800,10863862.png,317432,6737,310695,0.9787765568688727,2,4,66058,991,65067,0.9849980320324563,35.985262222222225,6580.745077333333,9.94805293294137,132,6.700000000000011E-4
8,test_20231101_135800,11382381.png,312486,547,311939,0.9982495215785667,1,4,46745,72,46673,0.9984597283131885,22.81680888888889,2740.878352,13.751906001286724,132,6.700000000000011E-4
9,test_20231101_135800,11079715.png,443815,101667,342148,0.7709248222795534,3,4,124136,14278,109858,0.8849809885931559,18.393388444444444,2481.930394666667,14.182907632523632,132,6.700000000000011E-4
10,test_20231101_135800,11551286.png,271883,164,271719,0.9993967993585476,1,4,40092,22,40070,0.9994512620971765,18.120286222222223,1899.5769013333334,15.344234809036362,132,6.700000000000011E-4
1,test_20231101_135801,10404007.png,502730,14514,488216,0.9711296322081435,2,4,61265,2115,59150,0.9654778421611034,26.39290488888889,3622.7017866666665,12.540477755873196,132,6.800000000000011E-4
2,test_20231101_135801,1254659.png,342646,61432,281214,0.8207129223746957,2,4,80080,8654,71426,0.891933066933067,22.385354666666668,3656.9652693333333,12.49959525060495,132,6.800000000000011E-4
3,test_20231101_135801,10188041.png,221231,7682,213549,0.9652761141069741,1,3,41731,1090,40641,0.9738803287723754,12.362325333333333,1460.681248,16.485249069719707,132,6.800000000000011E-4
4,test_20231101_135801,10287332.png,216980,10414,206566,0.9520047930684856,1,3,22337,1432,20905,0.9358911223530465,10.041297777777778,969.9734293333333,18.26320523150082,132,6.800000000000011E-4
5,test_20231101_135801,11610969.png,368720,19639,349081,0.9467373616836624,2,4,84111,2886,81225,0.9656881977387024,23.73571377777778,3469.4396746666666,12.728210203277182,132,6.800000000000011E-4
6,test_20231101_135801,10350842.png,212614,3209,209405,0.9849069205226373,1,12,42529,471,42058,0.9889252039784617,24.746065777777776,3737.8829333333333,12.404546652706536,132,6.800000000000011E-4
7,test_20231101_135801,10863862.png,317432,6737,310695,0.9787765568688727,2,4,66058,991,65067,0.9849980320324563,35.985262222222225,6580.745077333333,9.94805293294137,132,6.800000000000011E-4
8,test_20231101_135801,11382381.png,312486,547,311939,0.9982495215785667,1,4,46745,72,46673,0.9984597283131885,22.81680888888889,2740.878352,13.751906001286724,132,6.800000000000011E-4
9,test_20231101_135801,11079715.png,443815,101667,342148,0.7709248222795534,3,4,124136,14278,109858,0.8849809885931559,18.393388444444444,2481.930394666667,14.182907632523632,132,6.800000000000011E-4
10,test_20231101_135801,11551286.png,271883,164,271719,0.9993967993585476,1,4,40092,22,40070,0.9994512620971765,18.120286222222223,1899.5769013333334,15.344234809036362,132,6.800000000000011E-4
1,test_20231101_135801,10404007.png,502730,14514,488216,0.9711296322081435,2,3,61265,2115,59150,0.9654778421611034,26.39290488888889,3622.7017866666665,12.540477755873196,132,6.900000000000012E-4
2,test_20231101_135801,1254659.png,342646,61432,281214,0.8207129223746957,3,4,80080,8654,71426,0.891933066933067,22.385354666666668,3656.9652693333333,12.49959525060495,132,6.900000000000012E-4
3,test_20231101_135801,10188041.png,221231,7682,213549,0.9652761141069741,2,4,41731,1090,40641,0.9738803287723754,12.362325333333333,1460.681248,16.485249069719707,132,6.900000000000012E-4
4,test_20231101_135801,10287332.png,216980,10414,206566,0.9520047930684856,2,4,22337,1432,20905,0.9358911223530465,10.041297777777778,969.9734293333333,18.26320523150082,132,6.900000000000012E-4
5,test_20231101_135801,11610969.png,368720,19639,349081,0.9467373616836624,3,4,84111,2886,81225,0.9656881977387024,23.73571377777778,3469.4396746666666,12.728210203277182,132,6.900000000000012E-4
6,test_20231101_135801,10350842.png,212614,3209,209405,0.9849069205226373,2,3,42529,471,42058,0.9889252039784617,24.746065777777776,3737.8829333333333,12.404546652706536,132,6.900000000000012E-4
7,test_20231101_135801,10863862.png,317432,6737,310695,0.9787765568688727,2,4,66058,991,65067,0.9849980320324563,35.985262222222225,6580.745077333333,9.94805293294137,132,6.900000000000012E-4
8,test_20231101_135801,11382381.png,312486,547,311939,0.9982495215785667,1,3,46745,72,46673,0.9984597283131885,22.81680888888889,2740.878352,13.751906001286724,132,6.900000000000012E-4
9,test_20231101_135801,11079715.png,443815,101667,342148,0.7709248222795534,3,4,124136,14278,109858,0.8849809885931559,18.393388444444444,2481.930394666667,14.182907632523632,132,6.900000000000012E-4
10,test_20231101_135801,11551286.png,271883,164,271719,0.9993967993585476,2,3,40092,22,40070,0.9994512620971765,18.120286222222223,1899.5769013333334,15.344234809036362,132,6.900000000000012E-4
1,test_20231101_135802,10404007.png,502730,14514,488216,0.9711296322081435,2,4,61265,2115,59150,0.9654778421611034,26.39290488888889,3622.7017866666665,12.540477755873196,132,7.000000000000012E-4
2,test_20231101_135802,1254659.png,342646,61432,281214,0.8207129223746957,3,4,80080,8654,71426,0.891933066933067,22.385354666666668,3656.9652693333333,12.49959525060495,132,7.000000000000012E-4
3,test_20231101_135802,10188041.png,221231,7682,213549,0.9652761141069741,1,3,41731,1090,40641,0.9738803287723754,12.362325333333333,1460.681248,16.485249069719707,132,7.000000000000012E-4
4,test_20231101_135802,10287332.png,216980,10414,206566,0.9520047930684856,1,3,22337,1432,20905,0.9358911223530465,10.041297777777778,969.9734293333333,18.26320523150082,132,7.000000000000012E-4
5,test_20231101_135802,11610969.png,368720,19639,349081,0.9467373616836624,2,4,84111,2886,81225,0.9656881977387024,23.73571377777778,3469.4396746666666,12.728210203277182,132,7.000000000000012E-4
6,test_20231101_135802,10350842.png,212614,3209,209405,0.9849069205226373,1,4,42529,471,42058,0.9889252039784617,24.746065777777776,3737.8829333333333,12.404546652706536,132,7.000000000000012E-4
7,test_20231101_135802,10863862.png,317432,6737,310695,0.9787765568688727,2,3,66058,991,65067,0.9849980320324563,35.985262222222225,6580.745077333333,9.94805293294137,132,7.000000000000012E-4
8,test_20231101_135802,11382381.png,312486,547,311939,0.9982495215785667,1,3,46745,72,46673,0.9984597283131885,22.81680888888889,2740.878352,13.751906001286724,132,7.000000000000012E-4
9,test_20231101_135802,11079715.png,443815,101667,342148,0.7709248222795534,3,13,124136,14278,109858,0.8849809885931559,18.393388444444444,2481.930394666667,14.182907632523632,132,7.000000000000012E-4
10,test_20231101_135802,11551286.png,271883,164,271719,0.9993967993585476,1,4,40092,22,40070,0.9994512620971765,18.120286222222223,1899.5769013333334,15.344234809036362,132,7.000000000000012E-4
1,test_20231101_135803,10404007.png,502730,14514,488216,0.9711296322081435,2,3,61265,2115,59150,0.9654778421611034,26.39290488888889,3622.7017866666665,12.540477755873196,132,7.100000000000012E-4
2,test_20231101_135803,1254659.png,342646,61432,281214,0.8207129223746957,3,4,80080,8654,71426,0.891933066933067,22.385354666666668,3656.9652693333333,12.49959525060495,132,7.100000000000012E-4
3,test_20231101_135803,10188041.png,221231,7682,213549,0.9652761141069741,2,4,41731,1090,40641,0.9738803287723754,12.362325333333333,1460.681248,16.485249069719707,132,7.100000000000012E-4
4,test_20231101_135803,10287332.png,216980,10414,206566,0.9520047930684856,1,3,22337,1432,20905,0.9358911223530465,10.041297777777778,969.9734293333333,18.26320523150082,132,7.100000000000012E-4
5,test_20231101_135803,11610969.png,368720,19639,349081,0.9467373616836624,3,4,84111,2886,81225,0.9656881977387024,23.73571377777778,3469.4396746666666,12.728210203277182,132,7.100000000000012E-4
6,test_20231101_135803,10350842.png,212614,3209,209405,0.9849069205226373,2,3,42529,471,42058,0.9889252039784617,24.746065777777776,3737.8829333333333,12.404546652706536,132,7.100000000000012E-4
7,test_20231101_135803,10863862.png,317432,6737,310695,0.9787765568688727,2,4,66058,991,65067,0.9849980320324563,35.985262222222225,6580.745077333333,9.94805293294137,132,7.100000000000012E-4
8,test_20231101_135803,11382381.png,312486,547,311939,0.9982495215785667,1,4,46745,72,46673,0.9984597283131885,22.81680888888889,2740.878352,13.751906001286724,132,7.100000000000012E-4
9,test_20231101_135803,11079715.png,443815,101667,342148,0.7709248222795534,3,4,124136,14278,109858,0.8849809885931559,18.393388444444444,2481.930394666667,14.182907632523632,132,7.100000000000012E-4
10,test_20231101_135803,11551286.png,271883,164,271719,0.9993967993585476,2,4,40092,22,40070,0.9994512620971765,18.120286222222223,1899.5769013333334,15.344234809036362,132,7.100000000000012E-4
1,test_20231101_135803,10404007.png,502730,14514,488216,0.9711296322081435,3,4,61265,2115,59150,0.9654778421611034,26.39290488888889,3622.7017866666665,12.540477755873196,132,7.200000000000012E-4
2,test_20231101_135803,1254659.png,342646,61432,281214,0.8207129223746957,3,4,80080,8654,71426,0.891933066933067,22.385354666666668,3656.9652693333333,12.49959525060495,132,7.200000000000012E-4
3,test_20231101_135803,10188041.png,221231,7682,213549,0.9652761141069741,2,4,41731,1090,40641,0.9738803287723754,12.362325333333333,1460.681248,16.485249069719707,132,7.200000000000012E-4
4,test_20231101_135803,10287332.png,216980,10414,206566,0.9520047930684856,1,3,22337,1432,20905,0.9358911223530465,10.041297777777778,969.9734293333333,18.26320523150082,132,7.200000000000012E-4
5,test_20231101_135803,11610969.png,368720,19639,349081,0.9467373616836624,2,4,84111,2886,81225,0.9656881977387024,23.73571377777778,3469.4396746666666,12.728210203277182,132,7.200000000000012E-4
6,test_20231101_135803,10350842.png,212614,3209,209405,0.9849069205226373,1,11,42529,471,42058,0.9889252039784617,24.746065777777776,3737.8829333333333,12.404546652706536,132,7.200000000000012E-4
7,test_20231101_135803,10863862.png,317432,6737,310695,0.9787765568688727,1,3,66058,991,65067,0.9849980320324563,35.985262222222225,6580.745077333333,9.94805293294137,132,7.200000000000012E-4
8,test_20231101_135803,11382381.png,312486,547,311939,0.9982495215785667,1,4,46745,72,46673,0.9984597283131885,22.81680888888889,2740.878352,13.751906001286724,132,7.200000000000012E-4
9,test_20231101_135803,11079715.png,443815,101667,342148,0.7709248222795534,3,4,124136,14278,109858,0.8849809885931559,18.393388444444444,2481.930394666667,14.182907632523632,132,7.200000000000012E-4
10,test_20231101_135803,11551286.png,271883,164,271719,0.9993967993585476,2,4,40092,22,40070,0.9994512620971765,18.120286222222223,1899.5769013333334,15.344234809036362,132,7.200000000000012E-4
1,test_20231101_135804,10404007.png,502730,14514,488216,0.9711296322081435,3,3,61265,2115,59150,0.9654778421611034,26.39290488888889,3622.7017866666665,12.540477755873196,132,7.300000000000013E-4
2,test_20231101_135804,1254659.png,342646,61432,281214,0.8207129223746957,3,4,80080,8654,71426,0.891933066933067,22.385354666666668,3656.9652693333333,12.49959525060495,132,7.300000000000013E-4
3,test_20231101_135804,10188041.png,221231,7682,213549,0.9652761141069741,2,4,41731,1090,40641,0.9738803287723754,12.362325333333333,1460.681248,16.485249069719707,132,7.300000000000013E-4
4,test_20231101_135804,10287332.png,216980,10414,206566,0.9520047930684856,1,3,22337,1432,20905,0.9358911223530465,10.041297777777778,969.9734293333333,18.26320523150082,132,7.300000000000013E-4
5,test_20231101_135804,11610969.png,368720,19639,349081,0.9467373616836624,2,4,84111,2886,81225,0.9656881977387024,23.73571377777778,3469.4396746666666,12.728210203277182,132,7.300000000000013E-4
6,test_20231101_135804,10350842.png,212614,3209,209405,0.9849069205226373,1,3,42529,471,42058,0.9889252039784617,24.746065777777776,3737.8829333333333,12.404546652706536,132,7.300000000000013E-4
7,test_20231101_135804,10863862.png,317432,6737,310695,0.9787765568688727,1,3,66058,991,65067,0.9849980320324563,35.985262222222225,6580.745077333333,9.94805293294137,132,7.300000000000013E-4
8,test_20231101_135804,11382381.png,312486,547,311939,0.9982495215785667,1,3,46745,72,46673,0.9984597283131885,22.81680888888889,2740.878352,13.751906001286724,132,7.300000000000013E-4
9,test_20231101_135804,11079715.png,443815,101667,342148,0.7709248222795534,3,4,124136,14278,109858,0.8849809885931559,18.393388444444444,2481.930394666667,14.182907632523632,132,7.300000000000013E-4
10,test_20231101_135804,11551286.png,271883,164,271719,0.9993967993585476,2,4,40092,22,40070,0.9994512620971765,18.120286222222223,1899.5769013333334,15.344234809036362,132,7.300000000000013E-4
1,test_20231101_135805,10404007.png,502730,14514,488216,0.9711296322081435,2,4,61265,2115,59150,0.9654778421611034,26.39290488888889,3622.7017866666665,12.540477755873196,132,7.400000000000013E-4
2,test_20231101_135805,1254659.png,342646,61432,281214,0.8207129223746957,3,4,80080,8654,71426,0.891933066933067,22.385354666666668,3656.9652693333333,12.49959525060495,132,7.400000000000013E-4
3,test_20231101_135805,10188041.png,221231,7682,213549,0.9652761141069741,2,3,41731,1090,40641,0.9738803287723754,12.362325333333333,1460.681248,16.485249069719707,132,7.400000000000013E-4
4,test_20231101_135805,10287332.png,216980,10414,206566,0.9520047930684856,2,3,22337,1432,20905,0.9358911223530465,10.041297777777778,969.9734293333333,18.26320523150082,132,7.400000000000013E-4
5,test_20231101_135805,11610969.png,368720,19639,349081,0.9467373616836624,5,3,84111,2886,81225,0.9656881977387024,23.73571377777778,3469.4396746666666,12.728210203277182,132,7.400000000000013E-4
6,test_20231101_135805,10350842.png,212614,3209,209405,0.9849069205226373,2,4,42529,471,42058,0.9889252039784617,24.746065777777776,3737.8829333333333,12.404546652706536,132,7.400000000000013E-4
7,test_20231101_135805,10863862.png,317432,6737,310695,0.9787765568688727,2,3,66058,991,65067,0.9849980320324563,35.985262222222225,6580.745077333333,9.94805293294137,132,7.400000000000013E-4
8,test_20231101_135805,11382381.png,312486,547,311939,0.9982495215785667,1,4,46745,72,46673,0.9984597283131885,22.81680888888889,2740.878352,13.751906001286724,132,7.400000000000013E-4
9,test_20231101_135805,11079715.png,443815,101667,342148,0.7709248222795534,3,4,124136,14278,109858,0.8849809885931559,18.393388444444444,2481.930394666667,14.182907632523632,132,7.400000000000013E-4
10,test_20231101_135805,11551286.png,271883,164,271719,0.9993967993585476,1,4,40092,22,40070,0.9994512620971765,18.120286222222223,1899.5769013333334,15.344234809036362,132,7.400000000000013E-4
1,test_20231101_135805,10404007.png,502730,14514,488216,0.9711296322081435,2,3,61265,2115,59150,0.9654778421611034,26.39290488888889,3622.7017866666665,12.540477755873196,132,7.500000000000013E-4
2,test_20231101_135805,1254659.png,342646,61432,281214,0.8207129223746957,3,4,80080,8654,71426,0.891933066933067,22.385354666666668,3656.9652693333333,12.49959525060495,132,7.500000000000013E-4
3,test_20231101_135805,10188041.png,221231,7682,213549,0.9652761141069741,2,4,41731,1090,40641,0.9738803287723754,12.362325333333333,1460.681248,16.485249069719707,132,7.500000000000013E-4
4,test_20231101_135805,10287332.png,216980,10414,206566,0.9520047930684856,2,4,22337,1432,20905,0.9358911223530465,10.041297777777778,969.9734293333333,18.26320523150082,132,7.500000000000013E-4
5,test_20231101_135805,11610969.png,368720,19639,349081,0.9467373616836624,2,4,84111,2886,81225,0.9656881977387024,23.73571377777778,3469.4396746666666,12.728210203277182,132,7.500000000000013E-4
6,test_20231101_135805,10350842.png,212614,3209,209405,0.9849069205226373,2,4,42529,471,42058,0.9889252039784617,24.746065777777776,3737.8829333333333,12.404546652706536,132,7.500000000000013E-4
7,test_20231101_135805,10863862.png,317432,6737,310695,0.9787765568688727,2,4,66058,991,65067,0.9849980320324563,35.985262222222225,6580.745077333333,9.94805293294137,132,7.500000000000013E-4
8,test_20231101_135805,11382381.png,312486,547,311939,0.9982495215785667,1,3,46745,72,46673,0.9984597283131885,22.81680888888889,2740.878352,13.751906001286724,132,7.500000000000013E-4
9,test_20231101_135805,11079715.png,443815,101667,342148,0.7709248222795534,3,4,124136,14278,109858,0.8849809885931559,18.393388444444444,2481.930394666667,14.182907632523632,132,7.500000000000013E-4
10,test_20231101_135805,11551286.png,271883,164,271719,0.9993967993585476,1,4,40092,22,40070,0.9994512620971765,18.120286222222223,1899.5769013333334,15.344234809036362,132,7.500000000000013E-4
1,test_20231101_135806,10404007.png,502730,14332,488398,0.9714916555606389,2,4,61265,2089,59176,0.9659022280257896,26.614300444444446,3672.928288,12.480679118120042,132,7.600000000000013E-4
2,test_20231101_135806,1254659.png,342646,61432,281214,0.8207129223746957,3,4,80080,8654,71426,0.891933066933067,22.385354666666668,3656.9652693333333,12.49959525060495,132,7.600000000000013E-4
3,test_20231101_135806,10188041.png,221231,7682,213549,0.9652761141069741,2,3,41731,1090,40641,0.9738803287723754,12.362325333333333,1460.681248,16.485249069719707,132,7.600000000000013E-4
4,test_20231101_135806,10287332.png,216980,10414,206566,0.9520047930684856,1,4,22337,1432,20905,0.9358911223530465,10.041297777777778,969.9734293333333,18.26320523150082,132,7.600000000000013E-4
5,test_20231101_135806,11610969.png,368720,19639,349081,0.9467373616836624,2,4,84111,2886,81225,0.9656881977387024,23.73571377777778,3469.4396746666666,12.728210203277182,132,7.600000000000013E-4
6,test_20231101_135806,10350842.png,212614,3189,209425,0.9850009877054192,2,4,42529,468,42061,0.9889957440805097,25.208803555555555,3819.0730453333335,12.311223959007675,132,7.600000000000013E-4
7,test_20231101_135806,10863862.png,317432,6497,310935,0.9795326243100885,2,3,66058,956,65102,0.9855278694480608,36.60260088888889,6738.920368,9.844900364063601,132,7.600000000000013E-4
8,test_20231101_135806,11382381.png,312486,547,311939,0.9982495215785667,1,4,46745,72,46673,0.9984597283131885,22.81680888888889,2740.878352,13.751906001286724,132,7.600000000000013E-4
9,test_20231101_135806,11079715.png,443815,101647,342168,0.7709698861011908,4,4,124136,14275,109861,0.8850051556357543,18.410501333333332,2486.584208,14.17477189698425,132,7.600000000000013E-4
10,test_20231101_135806,11551286.png,271883,164,271719,0.9993967993585476,1,4,40092,22,40070,0.9994512620971765,18.120286222222223,1899.5769013333334,15.344234809036362,132,7.600000000000013E-4
1,test_20231101_135807,10404007.png,502730,13792,488938,0.9725657907823285,2,4,61265,2010,59255,0.9671917081531054,26.968791111111113,3750.1036106666666,12.390370939617432,132,7.700000000000014E-4
2,test_20231101_135807,1254659.png,342646,61432,281214,0.8207129223746957,3,4,80080,8654,71426,0.891933066933067,22.385354666666668,3656.9652693333333,12.49959525060495,132,7.700000000000014E-4
3,test_20231101_135807,10188041.png,221231,7682,213549,0.9652761141069741,2,4,41731,1090,40641,0.9738803287723754,12.362325333333333,1460.681248,16.485249069719707,132,7.700000000000014E-4
4,test_20231101_135807,10287332.png,216980,10414,206566,0.9520047930684856,1,3,22337,1432,20905,0.9358911223530465,10.041297777777778,969.9734293333333,18.26320523150082,132,7.700000000000014E-4
5,test_20231101_135807,11610969.png,368720,19639,349081,0.9467373616836624,3,4,84111,2886,81225,0.9656881977387024,23.73571377777778,3469.4396746666666,12.728210203277182,132,7.700000000000014E-4
6,test_20231101_135807,10350842.png,212614,2727,209887,0.9871739396276821,1,4,42529,399,42130,0.9906181664276141,26.30068622222222,4084.73616,12.019163509068495,132,7.700000000000014E-4
7,test_20231101_135807,10863862.png,317432,6497,310935,0.9795326243100885,2,4,66058,956,65102,0.9855278694480608,36.60260088888889,6738.920368,9.844900364063601,132,7.700000000000014E-4
8,test_20231101_135807,11382381.png,312486,547,311939,0.9982495215785667,1,4,46745,72,46673,0.9984597283131885,22.81680888888889,2740.878352,13.751906001286724,132,7.700000000000014E-4
9,test_20231101_135807,11079715.png,443815,101647,342168,0.7709698861011908,3,4,124136,14275,109861,0.8850051556357543,18.410501333333332,2486.584208,14.17477189698425,132,7.700000000000014E-4
10,test_20231101_135807,11551286.png,271883,164,271719,0.9993967993585476,1,3,40092,22,40070,0.9994512620971765,18.120286222222223,1899.5769013333334,15.344234809036362,132,7.700000000000014E-4
1,test_20231101_135807,10404007.png,502730,13792,488938,0.9725657907823285,2,3,61265,2010,59255,0.9671917081531054,26.968791111111113,3750.1036106666666,12.390370939617432,132,7.800000000000014E-4
2,test_20231101_135807,1254659.png,342646,61432,281214,0.8207129223746957,3,4,80080,8654,71426,0.891933066933067,22.385354666666668,3656.9652693333333,12.49959525060495,132,7.800000000000014E-4
3,test_20231101_135807,10188041.png,221231,7682,213549,0.9652761141069741,2,4,41731,1090,40641,0.9738803287723754,12.362325333333333,1460.681248,16.485249069719707,132,7.800000000000014E-4
4,test_20231101_135807,10287332.png,216980,10414,206566,0.9520047930684856,4,4,22337,1432,20905,0.9358911223530465,10.041297777777778,969.9734293333333,18.26320523150082,132,7.800000000000014E-4
5,test_20231101_135807,11610969.png,368720,19639,349081,0.9467373616836624,3,4,84111,2886,81225,0.9656881977387024,23.73571377777778,3469.4396746666666,12.728210203277182,132,7.800000000000014E-4
6,test_20231101_135807,10350842.png,212614,2727,209887,0.9871739396276821,1,3,42529,399,42130,0.9906181664276141,26.30068622222222,4084.73616,12.019163509068495,132,7.800000000000014E-4
7,test_20231101_135807,10863862.png,317432,6497,310935,0.9795326243100885,1,3,66058,956,65102,0.9855278694480608,36.60260088888889,6738.920368,9.844900364063601,132,7.800000000000014E-4
8,test_20231101_135807,11382381.png,312486,547,311939,0.9982495215785667,2,3,46745,72,46673,0.9984597283131885,22.81680888888889,2740.878352,13.751906001286724,132,7.800000000000014E-4
9,test_20231101_135807,11079715.png,443815,101647,342168,0.7709698861011908,3,4,124136,14275,109861,0.8850051556357543,18.410501333333332,2486.584208,14.17477189698425,132,7.800000000000014E-4
10,test_20231101_135807,11551286.png,271883,164,271719,0.9993967993585476,1,4,40092,22,40070,0.9994512620971765,18.120286222222223,1899.5769013333334,15.344234809036362,132,7.800000000000014E-4
1,test_20231101_135808,10404007.png,502730,13792,488938,0.9725657907823285,2,4,61265,2010,59255,0.9671917081531054,26.968791111111113,3750.1036106666666,12.390370939617432,132,7.900000000000014E-4
2,test_20231101_135808,1254659.png,342646,61432,281214,0.8207129223746957,2,4,80080,8654,71426,0.891933066933067,22.385354666666668,3656.9652693333333,12.49959525060495,132,7.900000000000014E-4
3,test_20231101_135808,10188041.png,221231,7682,213549,0.9652761141069741,1,3,41731,1090,40641,0.9738803287723754,12.362325333333333,1460.681248,16.485249069719707,132,7.900000000000014E-4
4,test_20231101_135808,10287332.png,216980,10414,206566,0.9520047930684856,1,3,22337,1432,20905,0.9358911223530465,10.041297777777778,969.9734293333333,18.26320523150082,132,7.900000000000014E-4
5,test_20231101_135808,11610969.png,368720,19639,349081,0.9467373616836624,2,4,84111,2886,81225,0.9656881977387024,23.73571377777778,3469.4396746666666,12.728210203277182,132,7.900000000000014E-4
6,test_20231101_135808,10350842.png,212614,2727,209887,0.9871739396276821,1,3,42529,399,42130,0.9906181664276141,26.30068622222222,4084.73616,12.019163509068495,132,7.900000000000014E-4
7,test_20231101_135808,10863862.png,317432,6497,310935,0.9795326243100885,1,4,66058,956,65102,0.9855278694480608,36.60260088888889,6738.920368,9.844900364063601,132,7.900000000000014E-4
8,test_20231101_135808,11382381.png,312486,547,311939,0.9982495215785667,2,3,46745,72,46673,0.9984597283131885,22.81680888888889,2740.878352,13.751906001286724,132,7.900000000000014E-4
9,test_20231101_135808,11079715.png,443815,101647,342168,0.7709698861011908,4,4,124136,14275,109861,0.8850051556357543,18.410501333333332,2486.584208,14.17477189698425,132,7.900000000000014E-4
10,test_20231101_135808,11551286.png,271883,164,271719,0.9993967993585476,1,3,40092,22,40070,0.9994512620971765,18.120286222222223,1899.5769013333334,15.344234809036362,132,7.900000000000014E-4
1,test_20231101_135809,10404007.png,502730,13792,488938,0.9725657907823285,2,4,61265,2010,59255,0.9671917081531054,26.968791111111113,3750.1036106666666,12.390370939617432,132,8.000000000000014E-4
2,test_20231101_135809,1254659.png,342646,61432,281214,0.8207129223746957,3,4,80080,8654,71426,0.891933066933067,22.385354666666668,3656.9652693333333,12.49959525060495,132,8.000000000000014E-4
3,test_20231101_135809,10188041.png,221231,7682,213549,0.9652761141069741,2,4,41731,1090,40641,0.9738803287723754,12.362325333333333,1460.681248,16.485249069719707,132,8.000000000000014E-4
4,test_20231101_135809,10287332.png,216980,10414,206566,0.9520047930684856,2,4,22337,1432,20905,0.9358911223530465,10.041297777777778,969.9734293333333,18.26320523150082,132,8.000000000000014E-4
5,test_20231101_135809,11610969.png,368720,19639,349081,0.9467373616836624,2,3,84111,2886,81225,0.9656881977387024,23.73571377777778,3469.4396746666666,12.728210203277182,132,8.000000000000014E-4
6,test_20231101_135809,10350842.png,212614,2727,209887,0.9871739396276821,1,3,42529,399,42130,0.9906181664276141,26.30068622222222,4084.73616,12.019163509068495,132,8.000000000000014E-4
7,test_20231101_135809,10863862.png,317432,6497,310935,0.9795326243100885,2,4,66058,956,65102,0.9855278694480608,36.60260088888889,6738.920368,9.844900364063601,132,8.000000000000014E-4
8,test_20231101_135809,11382381.png,312486,547,311939,0.9982495215785667,2,3,46745,72,46673,0.9984597283131885,22.81680888888889,2740.878352,13.751906001286724,132,8.000000000000014E-4
9,test_20231101_135809,11079715.png,443815,101647,342168,0.7709698861011908,4,4,124136,14275,109861,0.8850051556357543,18.410501333333332,2486.584208,14.17477189698425,132,8.000000000000014E-4
10,test_20231101_135809,11551286.png,271883,164,271719,0.9993967993585476,2,4,40092,22,40070,0.9994512620971765,18.120286222222223,1899.5769013333334,15.344234809036362,132,8.000000000000014E-4
1,test_20231101_135809,10404007.png,502730,13792,488938,0.9725657907823285,2,3,61265,2010,59255,0.9671917081531054,26.968791111111113,3750.1036106666666,12.390370939617432,132,8.100000000000015E-4
2,test_20231101_135809,1254659.png,342646,61432,281214,0.8207129223746957,3,4,80080,8654,71426,0.891933066933067,22.385354666666668,3656.9652693333333,12.49959525060495,132,8.100000000000015E-4
3,test_20231101_135809,10188041.png,221231,7682,213549,0.9652761141069741,2,3,41731,1090,40641,0.9738803287723754,12.362325333333333,1460.681248,16.485249069719707,132,8.100000000000015E-4
4,test_20231101_135809,10287332.png,216980,10414,206566,0.9520047930684856,2,3,22337,1432,20905,0.9358911223530465,10.041297777777778,969.9734293333333,18.26320523150082,132,8.100000000000015E-4
5,test_20231101_135809,11610969.png,368720,19639,349081,0.9467373616836624,3,4,84111,2886,81225,0.9656881977387024,23.73571377777778,3469.4396746666666,12.728210203277182,132,8.100000000000015E-4
6,test_20231101_135809,10350842.png,212614,2727,209887,0.9871739396276821,2,3,42529,399,42130,0.9906181664276141,26.30068622222222,4084.73616,12.019163509068495,132,8.100000000000015E-4
7,test_20231101_135809,10863862.png,317432,6497,310935,0.9795326243100885,1,3,66058,956,65102,0.9855278694480608,36.60260088888889,6738.920368,9.844900364063601,132,8.100000000000015E-4
8,test_20231101_135809,11382381.png,312486,547,311939,0.9982495215785667,1,3,46745,72,46673,0.9984597283131885,22.81680888888889,2740.878352,13.751906001286724,132,8.100000000000015E-4
9,test_20231101_135809,11079715.png,443815,101647,342168,0.7709698861011908,3,4,124136,14275,109861,0.8850051556357543,18.410501333333332,2486.584208,14.17477189698425,132,8.100000000000015E-4
10,test_20231101_135809,11551286.png,271883,164,271719,0.9993967993585476,1,4,40092,22,40070,0.9994512620971765,18.120286222222223,1899.5769013333334,15.344234809036362,132,8.100000000000015E-4
1,test_20231101_135810,10404007.png,502730,13792,488938,0.9725657907823285,2,4,61265,2010,59255,0.9671917081531054,26.968791111111113,3750.1036106666666,12.390370939617432,132,8.200000000000015E-4
2,test_20231101_135810,1254659.png,342646,61432,281214,0.8207129223746957,2,3,80080,8654,71426,0.891933066933067,22.385354666666668,3656.9652693333333,12.49959525060495,132,8.200000000000015E-4
3,test_20231101_135810,10188041.png,221231,7682,213549,0.9652761141069741,2,3,41731,1090,40641,0.9738803287723754,12.362325333333333,1460.681248,16.485249069719707,132,8.200000000000015E-4
4,test_20231101_135810,10287332.png,216980,10414,206566,0.9520047930684856,2,4,22337,1432,20905,0.9358911223530465,10.041297777777778,969.9734293333333,18.26320523150082,132,8.200000000000015E-4
5,test_20231101_135810,11610969.png,368720,19639,349081,0.9467373616836624,2,3,84111,2886,81225,0.9656881977387024,23.73571377777778,3469.4396746666666,12.728210203277182,132,8.200000000000015E-4
6,test_20231101_135810,10350842.png,212614,2727,209887,0.9871739396276821,1,3,42529,399,42130,0.9906181664276141,26.30068622222222,4084.73616,12.019163509068495,132,8.200000000000015E-4
7,test_20231101_135810,10863862.png,317432,6497,310935,0.9795326243100885,2,4,66058,956,65102,0.9855278694480608,36.60260088888889,6738.920368,9.844900364063601,132,8.200000000000015E-4
8,test_20231101_135810,11382381.png,312486,547,311939,0.9982495215785667,1,3,46745,72,46673,0.9984597283131885,22.81680888888889,2740.878352,13.751906001286724,132,8.200000000000015E-4
9,test_20231101_135810,11079715.png,443815,101647,342168,0.7709698861011908,3,4,124136,14275,109861,0.8850051556357543,18.410501333333332,2486.584208,14.17477189698425,132,8.200000000000015E-4
10,test_20231101_135810,11551286.png,271883,164,271719,0.9993967993585476,1,3,40092,22,40070,0.9994512620971765,18.120286222222223,1899.5769013333334,15.344234809036362,132,8.200000000000015E-4
1,test_20231101_135811,10404007.png,502730,13792,488938,0.9725657907823285,2,3,61265,2010,59255,0.9671917081531054,26.968791111111113,3750.1036106666666,12.390370939617432,132,8.300000000000015E-4
2,test_20231101_135811,1254659.png,342646,61432,281214,0.8207129223746957,3,4,80080,8654,71426,0.891933066933067,22.385354666666668,3656.9652693333333,12.49959525060495,132,8.300000000000015E-4
3,test_20231101_135811,10188041.png,221231,7682,213549,0.9652761141069741,2,3,41731,1090,40641,0.9738803287723754,12.362325333333333,1460.681248,16.485249069719707,132,8.300000000000015E-4
4,test_20231101_135811,10287332.png,216980,10414,206566,0.9520047930684856,2,4,22337,1432,20905,0.9358911223530465,10.041297777777778,969.9734293333333,18.26320523150082,132,8.300000000000015E-4
5,test_20231101_135811,11610969.png,368720,19639,349081,0.9467373616836624,2,4,84111,2886,81225,0.9656881977387024,23.73571377777778,3469.4396746666666,12.728210203277182,132,8.300000000000015E-4
6,test_20231101_135811,10350842.png,212614,2727,209887,0.9871739396276821,2,3,42529,399,42130,0.9906181664276141,26.30068622222222,4084.73616,12.019163509068495,132,8.300000000000015E-4
7,test_20231101_135811,10863862.png,317432,6497,310935,0.9795326243100885,2,4,66058,956,65102,0.9855278694480608,36.60260088888889,6738.920368,9.844900364063601,132,8.300000000000015E-4
8,test_20231101_135811,11382381.png,312486,547,311939,0.9982495215785667,2,4,46745,72,46673,0.9984597283131885,22.81680888888889,2740.878352,13.751906001286724,132,8.300000000000015E-4
9,test_20231101_135811,11079715.png,443815,101647,342168,0.7709698861011908,3,4,124136,14275,109861,0.8850051556357543,18.410501333333332,2486.584208,14.17477189698425,132,8.300000000000015E-4
10,test_20231101_135811,11551286.png,271883,164,271719,0.9993967993585476,2,4,40092,22,40070,0.9994512620971765,18.120286222222223,1899.5769013333334,15.344234809036362,132,8.300000000000015E-4
1,test_20231101_135811,10404007.png,502730,13792,488938,0.9725657907823285,2,3,61265,2010,59255,0.9671917081531054,26.968791111111113,3750.1036106666666,12.390370939617432,132,8.400000000000016E-4
2,test_20231101_135811,1254659.png,342646,61432,281214,0.8207129223746957,3,4,80080,8654,71426,0.891933066933067,22.385354666666668,3656.9652693333333,12.49959525060495,132,8.400000000000016E-4
3,test_20231101_135811,10188041.png,221231,7682,213549,0.9652761141069741,1,3,41731,1090,40641,0.9738803287723754,12.362325333333333,1460.681248,16.485249069719707,132,8.400000000000016E-4
4,test_20231101_135811,10287332.png,216980,10414,206566,0.9520047930684856,2,4,22337,1432,20905,0.9358911223530465,10.041297777777778,969.9734293333333,18.26320523150082,132,8.400000000000016E-4
5,test_20231101_135811,11610969.png,368720,19639,349081,0.9467373616836624,3,4,84111,2886,81225,0.9656881977387024,23.73571377777778,3469.4396746666666,12.728210203277182,132,8.400000000000016E-4
6,test_20231101_135811,10350842.png,212614,2727,209887,0.9871739396276821,1,4,42529,399,42130,0.9906181664276141,26.30068622222222,4084.73616,12.019163509068495,132,8.400000000000016E-4
7,test_20231101_135811,10863862.png,317432,6497,310935,0.9795326243100885,2,4,66058,956,65102,0.9855278694480608,36.60260088888889,6738.920368,9.844900364063601,132,8.400000000000016E-4
8,test_20231101_135811,11382381.png,312486,547,311939,0.9982495215785667,1,4,46745,72,46673,0.9984597283131885,22.81680888888889,2740.878352,13.751906001286724,132,8.400000000000016E-4
9,test_20231101_135811,11079715.png,443815,101647,342168,0.7709698861011908,3,5,124136,14275,109861,0.8850051556357543,18.410501333333332,2486.584208,14.17477189698425,132,8.400000000000016E-4
10,test_20231101_135811,11551286.png,271883,164,271719,0.9993967993585476,1,3,40092,22,40070,0.9994512620971765,18.120286222222223,1899.5769013333334,15.344234809036362,132,8.400000000000016E-4
1,test_20231101_135812,10404007.png,502730,13792,488938,0.9725657907823285,2,3,61265,2010,59255,0.9671917081531054,26.968791111111113,3750.1036106666666,12.390370939617432,132,8.500000000000016E-4
2,test_20231101_135812,1254659.png,342646,61432,281214,0.8207129223746957,3,4,80080,8654,71426,0.891933066933067,22.385354666666668,3656.9652693333333,12.49959525060495,132,8.500000000000016E-4
3,test_20231101_135812,10188041.png,221231,7682,213549,0.9652761141069741,2,3,41731,1090,40641,0.9738803287723754,12.362325333333333,1460.681248,16.485249069719707,132,8.500000000000016E-4
4,test_20231101_135812,10287332.png,216980,10414,206566,0.9520047930684856,1,3,22337,1432,20905,0.9358911223530465,10.041297777777778,969.9734293333333,18.26320523150082,132,8.500000000000016E-4
5,test_20231101_135812,11610969.png,368720,19639,349081,0.9467373616836624,2,4,84111,2886,81225,0.9656881977387024,23.73571377777778,3469.4396746666666,12.728210203277182,132,8.500000000000016E-4
6,test_20231101_135812,10350842.png,212614,2727,209887,0.9871739396276821,2,3,42529,399,42130,0.9906181664276141,26.30068622222222,4084.73616,12.019163509068495,132,8.500000000000016E-4
7,test_20231101_135812,10863862.png,317432,6497,310935,0.9795326243100885,2,4,66058,956,65102,0.9855278694480608,36.60260088888889,6738.920368,9.844900364063601,132,8.500000000000016E-4
8,test_20231101_135812,11382381.png,312486,547,311939,0.9982495215785667,1,4,46745,72,46673,0.9984597283131885,22.81680888888889,2740.878352,13.751906001286724,132,8.500000000000016E-4
9,test_20231101_135812,11079715.png,443815,101647,342168,0.7709698861011908,4,4,124136,14275,109861,0.8850051556357543,18.410501333333332,2486.584208,14.17477189698425,132,8.500000000000016E-4
10,test_20231101_135812,11551286.png,271883,164,271719,0.9993967993585476,2,3,40092,22,40070,0.9994512620971765,18.120286222222223,1899.5769013333334,15.344234809036362,132,8.500000000000016E-4
1,test_20231101_135813,10404007.png,502730,13792,488938,0.9725657907823285,2,12,61265,2010,59255,0.9671917081531054,26.968791111111113,3750.1036106666666,12.390370939617432,132,8.600000000000016E-4
2,test_20231101_135813,1254659.png,342646,61432,281214,0.8207129223746957,3,4,80080,8654,71426,0.891933066933067,22.385354666666668,3656.9652693333333,12.49959525060495,132,8.600000000000016E-4
3,test_20231101_135813,10188041.png,221231,7682,213549,0.9652761141069741,2,4,41731,1090,40641,0.9738803287723754,12.362325333333333,1460.681248,16.485249069719707,132,8.600000000000016E-4
4,test_20231101_135813,10287332.png,216980,10414,206566,0.9520047930684856,1,3,22337,1432,20905,0.9358911223530465,10.041297777777778,969.9734293333333,18.26320523150082,132,8.600000000000016E-4
5,test_20231101_135813,11610969.png,368720,19639,349081,0.9467373616836624,2,4,84111,2886,81225,0.9656881977387024,23.73571377777778,3469.4396746666666,12.728210203277182,132,8.600000000000016E-4
6,test_20231101_135813,10350842.png,212614,2727,209887,0.9871739396276821,1,3,42529,399,42130,0.9906181664276141,26.30068622222222,4084.73616,12.019163509068495,132,8.600000000000016E-4
7,test_20231101_135813,10863862.png,317432,6497,310935,0.9795326243100885,2,4,66058,956,65102,0.9855278694480608,36.60260088888889,6738.920368,9.844900364063601,132,8.600000000000016E-4
8,test_20231101_135813,11382381.png,312486,547,311939,0.9982495215785667,1,4,46745,72,46673,0.9984597283131885,22.81680888888889,2740.878352,13.751906001286724,132,8.600000000000016E-4
9,test_20231101_135813,11079715.png,443815,101647,342168,0.7709698861011908,3,4,124136,14275,109861,0.8850051556357543,18.410501333333332,2486.584208,14.17477189698425,132,8.600000000000016E-4
10,test_20231101_135813,11551286.png,271883,24,271859,0.9999117267353972,1,4,40092,1,40091,0.9999750573680535,24.866876444444443,3470.407338666667,12.72699907819776,132,8.600000000000016E-4
1,test_20231101_135814,10404007.png,502730,13792,488938,0.9725657907823285,2,4,61265,2010,59255,0.9671917081531054,26.968791111111113,3750.1036106666666,12.390370939617432,132,8.700000000000016E-4
2,test_20231101_135814,1254659.png,342646,61432,281214,0.8207129223746957,2,3,80080,8654,71426,0.891933066933067,22.385354666666668,3656.9652693333333,12.49959525060495,132,8.700000000000016E-4
3,test_20231101_135814,10188041.png,221231,7682,213549,0.9652761141069741,1,3,41731,1090,40641,0.9738803287723754,12.362325333333333,1460.681248,16.485249069719707,132,8.700000000000016E-4
4,test_20231101_135814,10287332.png,216980,10414,206566,0.9520047930684856,2,4,22337,1432,20905,0.9358911223530465,10.041297777777778,969.9734293333333,18.26320523150082,132,8.700000000000016E-4
5,test_20231101_135814,11610969.png,368720,19639,349081,0.9467373616836624,3,3,84111,2886,81225,0.9656881977387024,23.73571377777778,3469.4396746666666,12.728210203277182,132,8.700000000000016E-4
6,test_20231101_135814,10350842.png,212614,2727,209887,0.9871739396276821,1,4,42529,399,42130,0.9906181664276141,26.30068622222222,4084.73616,12.019163509068495,132,8.700000000000016E-4
7,test_20231101_135814,10863862.png,317432,6497,310935,0.9795326243100885,2,4,66058,956,65102,0.9855278694480608,36.60260088888889,6738.920368,9.844900364063601,132,8.700000000000016E-4
8,test_20231101_135814,11382381.png,312486,547,311939,0.9982495215785667,1,3,46745,72,46673,0.9984597283131885,22.81680888888889,2740.878352,13.751906001286724,132,8.700000000000016E-4
9,test_20231101_135814,11079715.png,443815,101647,342168,0.7709698861011908,3,4,124136,14275,109861,0.8850051556357543,18.410501333333332,2486.584208,14.17477189698425,132,8.700000000000016E-4
10,test_20231101_135814,11551286.png,271883,24,271859,0.9999117267353972,1,4,40092,1,40091,0.9999750573680535,24.866876444444443,3470.407338666667,12.72699907819776,132,8.700000000000016E-4
1,test_20231101_135814,10404007.png,502730,13792,488938,0.9725657907823285,2,4,61265,2010,59255,0.9671917081531054,26.968791111111113,3750.1036106666666,12.390370939617432,132,8.800000000000017E-4
2,test_20231101_135814,1254659.png,342646,61432,281214,0.8207129223746957,3,4,80080,8654,71426,0.891933066933067,22.385354666666668,3656.9652693333333,12.49959525060495,132,8.800000000000017E-4
3,test_20231101_135814,10188041.png,221231,7682,213549,0.9652761141069741,2,3,41731,1090,40641,0.9738803287723754,12.362325333333333,1460.681248,16.485249069719707,132,8.800000000000017E-4
4,test_20231101_135814,10287332.png,216980,10414,206566,0.9520047930684856,2,11,22337,1432,20905,0.9358911223530465,10.041297777777778,969.9734293333333,18.26320523150082,132,8.800000000000017E-4
5,test_20231101_135814,11610969.png,368720,19639,349081,0.9467373616836624,3,4,84111,2886,81225,0.9656881977387024,23.73571377777778,3469.4396746666666,12.728210203277182,132,8.800000000000017E-4
6,test_20231101_135814,10350842.png,212614,2727,209887,0.9871739396276821,1,3,42529,399,42130,0.9906181664276141,26.30068622222222,4084.73616,12.019163509068495,132,8.800000000000017E-4
7,test_20231101_135814,10863862.png,317432,6497,310935,0.9795326243100885,2,3,66058,956,65102,0.9855278694480608,36.60260088888889,6738.920368,9.844900364063601,132,8.800000000000017E-4
8,test_20231101_135814,11382381.png,312486,547,311939,0.9982495215785667,2,4,46745,72,46673,0.9984597283131885,22.81680888888889,2740.878352,13.751906001286724,132,8.800000000000017E-4
9,test_20231101_135814,11079715.png,443815,101647,342168,0.7709698861011908,3,4,124136,14275,109861,0.8850051556357543,18.410501333333332,2486.584208,14.17477189698425,132,8.800000000000017E-4
10,test_20231101_135814,11551286.png,271883,24,271859,0.9999117267353972,0,4,40092,1,40091,0.9999750573680535,24.866876444444443,3470.407338666667,12.72699907819776,132,8.800000000000017E-4
1,test_20231101_135815,10404007.png,502730,13792,488938,0.9725657907823285,1,3,61265,2010,59255,0.9671917081531054,26.968791111111113,3750.1036106666666,12.390370939617432,132,8.900000000000017E-4
2,test_20231101_135815,1254659.png,342646,61432,281214,0.8207129223746957,3,4,80080,8654,71426,0.891933066933067,22.385354666666668,3656.9652693333333,12.49959525060495,132,8.900000000000017E-4
3,test_20231101_135815,10188041.png,221231,7682,213549,0.9652761141069741,2,3,41731,1090,40641,0.9738803287723754,12.362325333333333,1460.681248,16.485249069719707,132,8.900000000000017E-4
4,test_20231101_135815,10287332.png,216980,10414,206566,0.9520047930684856,1,4,22337,1432,20905,0.9358911223530465,10.041297777777778,969.9734293333333,18.26320523150082,132,8.900000000000017E-4
5,test_20231101_135815,11610969.png,368720,19639,349081,0.9467373616836624,3,4,84111,2886,81225,0.9656881977387024,23.73571377777778,3469.4396746666666,12.728210203277182,132,8.900000000000017E-4
6,test_20231101_135815,10350842.png,212614,2727,209887,0.9871739396276821,1,4,42529,399,42130,0.9906181664276141,26.30068622222222,4084.73616,12.019163509068495,132,8.900000000000017E-4
7,test_20231101_135815,10863862.png,317432,6497,310935,0.9795326243100885,2,3,66058,956,65102,0.9855278694480608,36.60260088888889,6738.920368,9.844900364063601,132,8.900000000000017E-4
8,test_20231101_135815,11382381.png,312486,547,311939,0.9982495215785667,2,3,46745,72,46673,0.9984597283131885,22.81680888888889,2740.878352,13.751906001286724,132,8.900000000000017E-4
9,test_20231101_135815,11079715.png,443815,101647,342168,0.7709698861011908,4,4,124136,14275,109861,0.8850051556357543,18.410501333333332,2486.584208,14.17477189698425,132,8.900000000000017E-4
10,test_20231101_135815,11551286.png,271883,24,271859,0.9999117267353972,0,3,40092,1,40091,0.9999750573680535,24.866876444444443,3470.407338666667,12.72699907819776,132,8.900000000000017E-4
1,test_20231101_135816,10404007.png,502730,13792,488938,0.9725657907823285,2,3,61265,2010,59255,0.9671917081531054,26.968791111111113,3750.1036106666666,12.390370939617432,132,9.000000000000017E-4
2,test_20231101_135816,1254659.png,342646,61432,281214,0.8207129223746957,3,4,80080,8654,71426,0.891933066933067,22.385354666666668,3656.9652693333333,12.49959525060495,132,9.000000000000017E-4
3,test_20231101_135816,10188041.png,221231,7682,213549,0.9652761141069741,2,3,41731,1090,40641,0.9738803287723754,12.362325333333333,1460.681248,16.485249069719707,132,9.000000000000017E-4
4,test_20231101_135816,10287332.png,216980,10414,206566,0.9520047930684856,2,3,22337,1432,20905,0.9358911223530465,10.041297777777778,969.9734293333333,18.26320523150082,132,9.000000000000017E-4
5,test_20231101_135816,11610969.png,368720,19639,349081,0.9467373616836624,2,4,84111,2886,81225,0.9656881977387024,23.73571377777778,3469.4396746666666,12.728210203277182,132,9.000000000000017E-4
6,test_20231101_135816,10350842.png,212614,2727,209887,0.9871739396276821,1,3,42529,399,42130,0.9906181664276141,26.30068622222222,4084.73616,12.019163509068495,132,9.000000000000017E-4
7,test_20231101_135816,10863862.png,317432,6497,310935,0.9795326243100885,1,4,66058,956,65102,0.9855278694480608,36.60260088888889,6738.920368,9.844900364063601,132,9.000000000000017E-4
8,test_20231101_135816,11382381.png,312486,547,311939,0.9982495215785667,1,3,46745,72,46673,0.9984597283131885,22.81680888888889,2740.878352,13.751906001286724,132,9.000000000000017E-4
9,test_20231101_135816,11079715.png,443815,101647,342168,0.7709698861011908,4,4,124136,14275,109861,0.8850051556357543,18.410501333333332,2486.584208,14.17477189698425,132,9.000000000000017E-4
10,test_20231101_135816,11551286.png,271883,24,271859,0.9999117267353972,1,4,40092,1,40091,0.9999750573680535,24.866876444444443,3470.407338666667,12.72699907819776,132,9.000000000000017E-4
1,test_20231101_135816,10404007.png,502730,13792,488938,0.9725657907823285,2,4,61265,2010,59255,0.9671917081531054,26.968791111111113,3750.1036106666666,12.390370939617432,132,9.100000000000017E-4
2,test_20231101_135816,1254659.png,342646,61432,281214,0.8207129223746957,2,4,80080,8654,71426,0.891933066933067,22.385354666666668,3656.9652693333333,12.49959525060495,132,9.100000000000017E-4
3,test_20231101_135816,10188041.png,221231,7682,213549,0.9652761141069741,2,4,41731,1090,40641,0.9738803287723754,12.362325333333333,1460.681248,16.485249069719707,132,9.100000000000017E-4
4,test_20231101_135816,10287332.png,216980,10414,206566,0.9520047930684856,2,4,22337,1432,20905,0.9358911223530465,10.041297777777778,969.9734293333333,18.26320523150082,132,9.100000000000017E-4
5,test_20231101_135816,11610969.png,368720,19639,349081,0.9467373616836624,2,11,84111,2886,81225,0.9656881977387024,23.73571377777778,3469.4396746666666,12.728210203277182,132,9.100000000000017E-4
6,test_20231101_135816,10350842.png,212614,2727,209887,0.9871739396276821,1,5,42529,399,42130,0.9906181664276141,26.30068622222222,4084.73616,12.019163509068495,132,9.100000000000017E-4
7,test_20231101_135816,10863862.png,317432,6497,310935,0.9795326243100885,2,3,66058,956,65102,0.9855278694480608,36.60260088888889,6738.920368,9.844900364063601,132,9.100000000000017E-4
8,test_20231101_135816,11382381.png,312486,547,311939,0.9982495215785667,1,4,46745,72,46673,0.9984597283131885,22.81680888888889,2740.878352,13.751906001286724,132,9.100000000000017E-4
9,test_20231101_135816,11079715.png,443815,101647,342168,0.7709698861011908,3,4,124136,14275,109861,0.8850051556357543,18.410501333333332,2486.584208,14.17477189698425,132,9.100000000000017E-4
10,test_20231101_135816,11551286.png,271883,24,271859,0.9999117267353972,1,3,40092,1,40091,0.9999750573680535,24.866876444444443,3470.407338666667,12.72699907819776,132,9.100000000000017E-4
1,test_20231101_135817,10404007.png,502730,13792,488938,0.9725657907823285,2,4,61265,2010,59255,0.9671917081531054,26.968791111111113,3750.1036106666666,12.390370939617432,132,9.200000000000018E-4
2,test_20231101_135817,1254659.png,342646,61432,281214,0.8207129223746957,2,4,80080,8654,71426,0.891933066933067,22.385354666666668,3656.9652693333333,12.49959525060495,132,9.200000000000018E-4
3,test_20231101_135817,10188041.png,221231,7682,213549,0.9652761141069741,1,3,41731,1090,40641,0.9738803287723754,12.362325333333333,1460.681248,16.485249069719707,132,9.200000000000018E-4
4,test_20231101_135817,10287332.png,216980,10414,206566,0.9520047930684856,2,3,22337,1432,20905,0.9358911223530465,10.041297777777778,969.9734293333333,18.26320523150082,132,9.200000000000018E-4
5,test_20231101_135817,11610969.png,368720,19639,349081,0.9467373616836624,2,4,84111,2886,81225,0.9656881977387024,23.73571377777778,3469.4396746666666,12.728210203277182,132,9.200000000000018E-4
6,test_20231101_135817,10350842.png,212614,2727,209887,0.9871739396276821,1,4,42529,399,42130,0.9906181664276141,26.30068622222222,4084.73616,12.019163509068495,132,9.200000000000018E-4
7,test_20231101_135817,10863862.png,317432,6497,310935,0.9795326243100885,2,4,66058,956,65102,0.9855278694480608,36.60260088888889,6738.920368,9.844900364063601,132,9.200000000000018E-4
8,test_20231101_135817,11382381.png,312486,547,311939,0.9982495215785667,2,4,46745,72,46673,0.9984597283131885,22.81680888888889,2740.878352,13.751906001286724,132,9.200000000000018E-4
9,test_20231101_135817,11079715.png,443815,101647,342168,0.7709698861011908,3,5,124136,14275,109861,0.8850051556357543,18.410501333333332,2486.584208,14.17477189698425,132,9.200000000000018E-4
10,test_20231101_135817,11551286.png,271883,24,271859,0.9999117267353972,0,3,40092,1,40091,0.9999750573680535,24.866876444444443,3470.407338666667,12.72699907819776,132,9.200000000000018E-4
1,test_20231101_135818,10404007.png,502730,13792,488938,0.9725657907823285,2,4,61265,2010,59255,0.9671917081531054,26.968791111111113,3750.1036106666666,12.390370939617432,132,9.300000000000018E-4
2,test_20231101_135818,1254659.png,342646,61432,281214,0.8207129223746957,3,4,80080,8654,71426,0.891933066933067,22.385354666666668,3656.9652693333333,12.49959525060495,132,9.300000000000018E-4
3,test_20231101_135818,10188041.png,221231,7682,213549,0.9652761141069741,2,4,41731,1090,40641,0.9738803287723754,12.362325333333333,1460.681248,16.485249069719707,132,9.300000000000018E-4
4,test_20231101_135818,10287332.png,216980,10414,206566,0.9520047930684856,1,3,22337,1432,20905,0.9358911223530465,10.041297777777778,969.9734293333333,18.26320523150082,132,9.300000000000018E-4
5,test_20231101_135818,11610969.png,368720,19639,349081,0.9467373616836624,2,3,84111,2886,81225,0.9656881977387024,23.73571377777778,3469.4396746666666,12.728210203277182,132,9.300000000000018E-4
6,test_20231101_135818,10350842.png,212614,2727,209887,0.9871739396276821,1,4,42529,399,42130,0.9906181664276141,26.30068622222222,4084.73616,12.019163509068495,132,9.300000000000018E-4
7,test_20231101_135818,10863862.png,317432,6497,310935,0.9795326243100885,2,3,66058,956,65102,0.9855278694480608,36.60260088888889,6738.920368,9.844900364063601,132,9.300000000000018E-4
8,test_20231101_135818,11382381.png,312486,547,311939,0.9982495215785667,1,4,46745,72,46673,0.9984597283131885,22.81680888888889,2740.878352,13.751906001286724,132,9.300000000000018E-4
9,test_20231101_135818,11079715.png,443815,101647,342168,0.7709698861011908,3,4,124136,14275,109861,0.8850051556357543,18.410501333333332,2486.584208,14.17477189698425,132,9.300000000000018E-4
10,test_20231101_135818,11551286.png,271883,24,271859,0.9999117267353972,0,4,40092,1,40091,0.9999750573680535,24.866876444444443,3470.407338666667,12.72699907819776,132,9.300000000000018E-4
1,test_20231101_135818,10404007.png,502730,13792,488938,0.9725657907823285,2,3,61265,2010,59255,0.9671917081531054,26.968791111111113,3750.1036106666666,12.390370939617432,132,9.400000000000018E-4
2,test_20231101_135818,1254659.png,342646,61432,281214,0.8207129223746957,3,4,80080,8654,71426,0.891933066933067,22.385354666666668,3656.9652693333333,12.49959525060495,132,9.400000000000018E-4
3,test_20231101_135818,10188041.png,221231,7682,213549,0.9652761141069741,2,4,41731,1090,40641,0.9738803287723754,12.362325333333333,1460.681248,16.485249069719707,132,9.400000000000018E-4
4,test_20231101_135818,10287332.png,216980,10414,206566,0.9520047930684856,2,4,22337,1432,20905,0.9358911223530465,10.041297777777778,969.9734293333333,18.26320523150082,132,9.400000000000018E-4
5,test_20231101_135818,11610969.png,368720,19639,349081,0.9467373616836624,3,3,84111,2886,81225,0.9656881977387024,23.73571377777778,3469.4396746666666,12.728210203277182,132,9.400000000000018E-4
6,test_20231101_135818,10350842.png,212614,2727,209887,0.9871739396276821,1,4,42529,399,42130,0.9906181664276141,26.30068622222222,4084.73616,12.019163509068495,132,9.400000000000018E-4
7,test_20231101_135818,10863862.png,317432,6497,310935,0.9795326243100885,1,3,66058,956,65102,0.9855278694480608,36.60260088888889,6738.920368,9.844900364063601,132,9.400000000000018E-4
8,test_20231101_135818,11382381.png,312486,547,311939,0.9982495215785667,1,4,46745,72,46673,0.9984597283131885,22.81680888888889,2740.878352,13.751906001286724,132,9.400000000000018E-4
9,test_20231101_135818,11079715.png,443815,101647,342168,0.7709698861011908,3,4,124136,14275,109861,0.8850051556357543,18.410501333333332,2486.584208,14.17477189698425,132,9.400000000000018E-4
10,test_20231101_135818,11551286.png,271883,24,271859,0.9999117267353972,1,10,40092,1,40091,0.9999750573680535,24.866876444444443,3470.407338666667,12.72699907819776,132,9.400000000000018E-4
1,test_20231101_135819,10404007.png,502730,13792,488938,0.9725657907823285,2,4,61265,2010,59255,0.9671917081531054,26.968791111111113,3750.1036106666666,12.390370939617432,132,9.500000000000018E-4
2,test_20231101_135819,1254659.png,342646,61432,281214,0.8207129223746957,2,5,80080,8654,71426,0.891933066933067,22.385354666666668,3656.9652693333333,12.49959525060495,132,9.500000000000018E-4
3,test_20231101_135819,10188041.png,221231,7682,213549,0.9652761141069741,3,4,41731,1090,40641,0.9738803287723754,12.362325333333333,1460.681248,16.485249069719707,132,9.500000000000018E-4
4,test_20231101_135819,10287332.png,216980,10414,206566,0.9520047930684856,1,3,22337,1432,20905,0.9358911223530465,10.041297777777778,969.9734293333333,18.26320523150082,132,9.500000000000018E-4
5,test_20231101_135819,11610969.png,368720,19639,349081,0.9467373616836624,2,4,84111,2886,81225,0.9656881977387024,23.73571377777778,3469.4396746666666,12.728210203277182,132,9.500000000000018E-4
6,test_20231101_135819,10350842.png,212614,2727,209887,0.9871739396276821,1,4,42529,399,42130,0.9906181664276141,26.30068622222222,4084.73616,12.019163509068495,132,9.500000000000018E-4
7,test_20231101_135819,10863862.png,317432,6497,310935,0.9795326243100885,2,4,66058,956,65102,0.9855278694480608,36.60260088888889,6738.920368,9.844900364063601,132,9.500000000000018E-4
8,test_20231101_135819,11382381.png,312486,547,311939,0.9982495215785667,1,3,46745,72,46673,0.9984597283131885,22.81680888888889,2740.878352,13.751906001286724,132,9.500000000000018E-4
9,test_20231101_135819,11079715.png,443815,101647,342168,0.7709698861011908,3,4,124136,14275,109861,0.8850051556357543,18.410501333333332,2486.584208,14.17477189698425,132,9.500000000000018E-4
10,test_20231101_135819,11551286.png,271883,24,271859,0.9999117267353972,0,3,40092,1,40091,0.9999750573680535,24.866876444444443,3470.407338666667,12.72699907819776,132,9.500000000000018E-4
1,test_20231101_135820,10404007.png,502730,13792,488938,0.9725657907823285,2,4,61265,2010,59255,0.9671917081531054,26.968791111111113,3750.1036106666666,12.390370939617432,132,9.600000000000019E-4
2,test_20231101_135820,1254659.png,342646,61432,281214,0.8207129223746957,2,3,80080,8654,71426,0.891933066933067,22.385354666666668,3656.9652693333333,12.49959525060495,132,9.600000000000019E-4
3,test_20231101_135820,10188041.png,221231,7682,213549,0.9652761141069741,2,4,41731,1090,40641,0.9738803287723754,12.362325333333333,1460.681248,16.485249069719707,132,9.600000000000019E-4
4,test_20231101_135820,10287332.png,216980,10414,206566,0.9520047930684856,2,4,22337,1432,20905,0.9358911223530465,10.041297777777778,969.9734293333333,18.26320523150082,132,9.600000000000019E-4
5,test_20231101_135820,11610969.png,368720,19639,349081,0.9467373616836624,2,3,84111,2886,81225,0.9656881977387024,23.73571377777778,3469.4396746666666,12.728210203277182,132,9.600000000000019E-4
6,test_20231101_135820,10350842.png,212614,2727,209887,0.9871739396276821,2,3,42529,399,42130,0.9906181664276141,26.30068622222222,4084.73616,12.019163509068495,132,9.600000000000019E-4
7,test_20231101_135820,10863862.png,317432,6497,310935,0.9795326243100885,2,3,66058,956,65102,0.9855278694480608,36.60260088888889,6738.920368,9.844900364063601,132,9.600000000000019E-4
8,test_20231101_135820,11382381.png,312486,547,311939,0.9982495215785667,1,4,46745,72,46673,0.9984597283131885,22.81680888888889,2740.878352,13.751906001286724,132,9.600000000000019E-4
9,test_20231101_135820,11079715.png,443815,101647,342168,0.7709698861011908,4,4,124136,14275,109861,0.8850051556357543,18.410501333333332,2486.584208,14.17477189698425,132,9.600000000000019E-4
10,test_20231101_135820,11551286.png,271883,24,271859,0.9999117267353972,1,4,40092,1,40091,0.9999750573680535,24.866876444444443,3470.407338666667,12.72699907819776,132,9.600000000000019E-4
1,test_20231101_135820,10404007.png,502730,13792,488938,0.9725657907823285,2,5,61265,2010,59255,0.9671917081531054,26.968791111111113,3750.1036106666666,12.390370939617432,132,9.700000000000019E-4
2,test_20231101_135820,1254659.png,342646,61432,281214,0.8207129223746957,2,4,80080,8654,71426,0.891933066933067,22.385354666666668,3656.9652693333333,12.49959525060495,132,9.700000000000019E-4
3,test_20231101_135820,10188041.png,221231,7682,213549,0.9652761141069741,2,3,41731,1090,40641,0.9738803287723754,12.362325333333333,1460.681248,16.485249069719707,132,9.700000000000019E-4
4,test_20231101_135820,10287332.png,216980,10414,206566,0.9520047930684856,2,3,22337,1432,20905,0.9358911223530465,10.041297777777778,969.9734293333333,18.26320523150082,132,9.700000000000019E-4
5,test_20231101_135820,11610969.png,368720,19639,349081,0.9467373616836624,2,4,84111,2886,81225,0.9656881977387024,23.73571377777778,3469.4396746666666,12.728210203277182,132,9.700000000000019E-4
6,test_20231101_135820,10350842.png,212614,2727,209887,0.9871739396276821,2,4,42529,399,42130,0.9906181664276141,26.30068622222222,4084.73616,12.019163509068495,132,9.700000000000019E-4
7,test_20231101_135820,10863862.png,317432,6497,310935,0.9795326243100885,1,3,66058,956,65102,0.9855278694480608,36.60260088888889,6738.920368,9.844900364063601,132,9.700000000000019E-4
8,test_20231101_135820,11382381.png,312486,547,311939,0.9982495215785667,1,4,46745,72,46673,0.9984597283131885,22.81680888888889,2740.878352,13.751906001286724,132,9.700000000000019E-4
9,test_20231101_135820,11079715.png,443815,101647,342168,0.7709698861011908,4,4,124136,14275,109861,0.8850051556357543,18.410501333333332,2486.584208,14.17477189698425,132,9.700000000000019E-4
10,test_20231101_135820,11551286.png,271883,24,271859,0.9999117267353972,0,3,40092,1,40091,0.9999750573680535,24.866876444444443,3470.407338666667,12.72699907819776,132,9.700000000000019E-4
1,test_20231101_135821,10404007.png,502730,13247,489483,0.9736498717005152,2,4,61265,1933,59332,0.9684485432139068,27.050533333333334,3771.916186666667,12.365183268748838,132,9.80000000000002E-4
2,test_20231101_135821,1254659.png,342646,60909,281737,0.8222392790226648,3,4,80080,8586,71494,0.8927822177822178,22.573884444444445,3701.8934933333335,12.446564412978685,132,9.80000000000002E-4
3,test_20231101_135821,10188041.png,221231,7562,213669,0.9658185335689845,2,3,41731,1080,40651,0.9741199587836381,12.371623111111111,1461.5576533333333,16.48264409439469,132,9.80000000000002E-4
4,test_20231101_135821,10287332.png,216980,10334,206646,0.952373490644299,2,4,22337,1420,20917,0.9364283475847249,10.066858666666667,974.1434026666667,18.244574672309938,132,9.80000000000002E-4
5,test_20231101_135821,11610969.png,368720,19317,349403,0.9476106530700803,2,4,84111,2841,81270,0.966223205050469,24.148250666666666,3544.499024,12.635254997655483,132,9.80000000000002E-4
6,test_20231101_135821,10350842.png,212614,2467,210147,0.9883968130038473,1,4,42529,362,42167,0.9914881610195396,26.458492444444445,4113.412426666667,11.988781051282807,132,9.80000000000002E-4
7,test_20231101_135821,10863862.png,317432,6414,311018,0.9797940976335089,1,3,66058,944,65114,0.9857095279905538,36.62045688888889,6742.872165333333,9.842354346803099,132,9.80000000000002E-4
8,test_20231101_135821,11382381.png,312486,367,312119,0.9988255473845228,2,3,46745,48,46697,0.9989731522087923,23.28773511111111,2886.24232,13.527475705549977,132,9.80000000000002E-4
9,test_20231101_135821,11079715.png,443815,101547,342268,0.7711952052093778,3,4,124136,14265,109871,0.8850857124444158,18.447898666666667,2491.5173813333336,14.166164396233976,132,9.80000000000002E-4
10,test_20231101_135821,11551286.png,271883,24,271859,0.9999117267353972,1,3,40092,1,40091,0.9999750573680535,24.866876444444443,3470.407338666667,12.72699907819776,132,9.80000000000002E-4
1,test_20231101_135822,10404007.png,502730,13247,489483,0.9736498717005152,2,4,61265,1933,59332,0.9684485432139068,27.050533333333334,3771.916186666667,12.365183268748838,132,9.90000000000002E-4
2,test_20231101_135822,1254659.png,342646,60909,281737,0.8222392790226648,3,4,80080,8586,71494,0.8927822177822178,22.573884444444445,3701.8934933333335,12.446564412978685,132,9.90000000000002E-4
3,test_20231101_135822,10188041.png,221231,7562,213669,0.9658185335689845,2,3,41731,1080,40651,0.9741199587836381,12.371623111111111,1461.5576533333333,16.48264409439469,132,9.90000000000002E-4
4,test_20231101_135822,10287332.png,216980,10334,206646,0.952373490644299,2,3,22337,1420,20917,0.9364283475847249,10.066858666666667,974.1434026666667,18.244574672309938,132,9.90000000000002E-4
5,test_20231101_135822,11610969.png,368720,19317,349403,0.9476106530700803,2,3,84111,2841,81270,0.966223205050469,24.148250666666666,3544.499024,12.635254997655483,132,9.90000000000002E-4
6,test_20231101_135822,10350842.png,212614,2467,210147,0.9883968130038473,2,3,42529,362,42167,0.9914881610195396,26.458492444444445,4113.412426666667,11.988781051282807,132,9.90000000000002E-4
7,test_20231101_135822,10863862.png,317432,6414,311018,0.9797940976335089,1,3,66058,944,65114,0.9857095279905538,36.62045688888889,6742.872165333333,9.842354346803099,132,9.90000000000002E-4
8,test_20231101_135822,11382381.png,312486,367,312119,0.9988255473845228,1,4,46745,48,46697,0.9989731522087923,23.28773511111111,2886.24232,13.527475705549977,132,9.90000000000002E-4
9,test_20231101_135822,11079715.png,443815,101547,342268,0.7711952052093778,4,4,124136,14265,109871,0.8850857124444158,18.447898666666667,2491.5173813333336,14.166164396233976,132,9.90000000000002E-4
10,test_20231101_135822,11551286.png,271883,24,271859,0.9999117267353972,1,4,40092,1,40091,0.9999750573680535,24.866876444444443,3470.407338666667,12.72699907819776,132,9.90000000000002E-4
1,test_20231101_135822,10404007.png,502730,14152,488578,0.9718497006345355,2,10,61265,2060,59205,0.9663755814902473,26.344917333333335,3614.72256,12.55005391266389,133,0.0
2,test_20231101_135822,1254659.png,342646,59502,283144,0.8263455578060155,3,4,80080,8383,71697,0.8953171828171829,22.628085333333335,3743.293184,12.398265174011183,133,0.0
3,test_20231101_135822,10188041.png,221231,7742,213489,0.965004904375969,2,3,41731,1099,40632,0.9736646617622391,12.021692444444444,1415.9182933333334,16.620421680920458,133,0.0
4,test_20231101_135822,10287332.png,216980,10444,206536,0.9518665314775555,2,4,22337,1436,20901,0.9357120472758204,9.952625777777778,956.3146133333333,18.32479568637085,133,0.0
5,test_20231101_135822,11610969.png,368720,19097,349623,0.9482073117812975,2,4,84111,2803,81308,0.9666749890026275,23.451530666666667,3450.915978666667,12.751459754522989,133,0.0
6,test_20231101_135822,10350842.png,212614,4072,208542,0.9808479215855964,1,4,42529,599,41930,0.9859154929577465,20.203443555555555,2580.173893333333,14.014313842185771,133,0.0
7,test_20231101_135822,10863862.png,317432,6657,310775,0.979028579349278,1,4,66058,979,65079,0.9851796905749493,35.89375288888889,6568.835178666666,9.955919959241273,133,0.0
8,test_20231101_135822,11382381.png,312486,807,311679,0.9974174843032968,1,4,46745,110,46635,0.9976468071451492,20.579290666666665,2386.569818666667,14.353062167735953,133,0.0
9,test_20231101_135822,11079715.png,443815,98874,344941,0.7772179849712155,4,5,124136,13895,110241,0.8880663143648901,18.42161422222222,2518.297664,14.119732982444997,133,0.0
10,test_20231101_135822,11551286.png,271883,617,271266,0.99773064148917,1,3,40092,89,40003,0.9977801057567595,17.32512711111111,1775.1936,15.638346373772247,133,0.0
1,test_20231101_135823,10404007.png,502730,14152,488578,0.9718497006345355,2,4,61265,2060,59205,0.9663755814902473,26.344917333333335,3614.72256,12.55005391266389,133,1.0E-5
2,test_20231101_135823,1254659.png,342646,59502,283144,0.8263455578060155,3,11,80080,8383,71697,0.8953171828171829,22.628085333333335,3743.293184,12.398265174011183,133,1.0E-5
3,test_20231101_135823,10188041.png,221231,7742,213489,0.965004904375969,2,4,41731,1099,40632,0.9736646617622391,12.021692444444444,1415.9182933333334,16.620421680920458,133,1.0E-5
4,test_20231101_135823,10287332.png,216980,10444,206536,0.9518665314775555,2,3,22337,1436,20901,0.9357120472758204,9.952625777777778,956.3146133333333,18.32479568637085,133,1.0E-5
5,test_20231101_135823,11610969.png,368720,19097,349623,0.9482073117812975,2,4,84111,2803,81308,0.9666749890026275,23.451530666666667,3450.915978666667,12.751459754522989,133,1.0E-5
6,test_20231101_135823,10350842.png,212614,4072,208542,0.9808479215855964,2,4,42529,599,41930,0.9859154929577465,20.203443555555555,2580.173893333333,14.014313842185771,133,1.0E-5
7,test_20231101_135823,10863862.png,317432,6657,310775,0.979028579349278,1,4,66058,979,65079,0.9851796905749493,35.89375288888889,6568.835178666666,9.955919959241273,133,1.0E-5
8,test_20231101_135823,11382381.png,312486,807,311679,0.9974174843032968,2,3,46745,110,46635,0.9976468071451492,20.579290666666665,2386.569818666667,14.353062167735953,133,1.0E-5
9,test_20231101_135823,11079715.png,443815,98874,344941,0.7772179849712155,3,4,124136,13895,110241,0.8880663143648901,18.42161422222222,2518.297664,14.119732982444997,133,1.0E-5
10,test_20231101_135823,11551286.png,271883,617,271266,0.99773064148917,2,3,40092,89,40003,0.9977801057567595,17.32512711111111,1775.1936,15.638346373772247,133,1.0E-5
1,test_20231101_135824,10404007.png,502730,14152,488578,0.9718497006345355,1,3,61265,2060,59205,0.9663755814902473,26.344917333333335,3614.72256,12.55005391266389,133,2.0E-5
2,test_20231101_135824,1254659.png,342646,59502,283144,0.8263455578060155,2,3,80080,8383,71697,0.8953171828171829,22.628085333333335,3743.293184,12.398265174011183,133,2.0E-5
3,test_20231101_135824,10188041.png,221231,7742,213489,0.965004904375969,2,3,41731,1099,40632,0.9736646617622391,12.021692444444444,1415.9182933333334,16.620421680920458,133,2.0E-5
4,test_20231101_135824,10287332.png,216980,10444,206536,0.9518665314775555,2,4,22337,1436,20901,0.9357120472758204,9.952625777777778,956.3146133333333,18.32479568637085,133,2.0E-5
5,test_20231101_135824,11610969.png,368720,19097,349623,0.9482073117812975,2,3,84111,2803,81308,0.9666749890026275,23.451530666666667,3450.915978666667,12.751459754522989,133,2.0E-5
6,test_20231101_135824,10350842.png,212614,4072,208542,0.9808479215855964,2,3,42529,599,41930,0.9859154929577465,20.203443555555555,2580.173893333333,14.014313842185771,133,2.0E-5
7,test_20231101_135824,10863862.png,317432,6657,310775,0.979028579349278,1,4,66058,979,65079,0.9851796905749493,35.89375288888889,6568.835178666666,9.955919959241273,133,2.0E-5
8,test_20231101_135824,11382381.png,312486,797,311689,0.997449485736961,2,3,46745,109,46636,0.997668199807466,21.309107555555556,2485.130629333333,14.177311387814227,133,2.0E-5
9,test_20231101_135824,11079715.png,443815,98874,344941,0.7772179849712155,3,4,124136,13895,110241,0.8880663143648901,18.42161422222222,2518.297664,14.119732982444997,133,2.0E-5
10,test_20231101_135824,11551286.png,271883,617,271266,0.99773064148917,2,3,40092,89,40003,0.9977801057567595,17.32512711111111,1775.1936,15.638346373772247,133,2.0E-5
1,test_20231101_135824,10404007.png,502730,14152,488578,0.9718497006345355,1,3,61265,2060,59205,0.9663755814902473,26.344917333333335,3614.72256,12.55005391266389,133,3.0000000000000004E-5
2,test_20231101_135824,1254659.png,342646,59502,283144,0.8263455578060155,2,3,80080,8383,71697,0.8953171828171829,22.628085333333335,3743.293184,12.398265174011183,133,3.0000000000000004E-5
3,test_20231101_135824,10188041.png,221231,7742,213489,0.965004904375969,2,4,41731,1099,40632,0.9736646617622391,12.021692444444444,1415.9182933333334,16.620421680920458,133,3.0000000000000004E-5
4,test_20231101_135824,10287332.png,216980,10444,206536,0.9518665314775555,1,3,22337,1436,20901,0.9357120472758204,9.952625777777778,956.3146133333333,18.32479568637085,133,3.0000000000000004E-5
5,test_20231101_135824,11610969.png,368720,19097,349623,0.9482073117812975,3,3,84111,2803,81308,0.9666749890026275,23.451530666666667,3450.915978666667,12.751459754522989,133,3.0000000000000004E-5
6,test_20231101_135824,10350842.png,212614,4072,208542,0.9808479215855964,1,3,42529,599,41930,0.9859154929577465,20.203443555555555,2580.173893333333,14.014313842185771,133,3.0000000000000004E-5
7,test_20231101_135824,10863862.png,317432,6657,310775,0.979028579349278,1,4,66058,979,65079,0.9851796905749493,35.89375288888889,6568.835178666666,9.955919959241273,133,3.0000000000000004E-5
8,test_20231101_135824,11382381.png,312486,797,311689,0.997449485736961,1,3,46745,109,46636,0.997668199807466,21.309107555555556,2485.130629333333,14.177311387814227,133,3.0000000000000004E-5
9,test_20231101_135824,11079715.png,443815,98874,344941,0.7772179849712155,3,4,124136,13895,110241,0.8880663143648901,18.42161422222222,2518.297664,14.119732982444997,133,3.0000000000000004E-5
10,test_20231101_135824,11551286.png,271883,617,271266,0.99773064148917,1,3,40092,89,40003,0.9977801057567595,17.32512711111111,1775.1936,15.638346373772247,133,3.0000000000000004E-5
1,test_20231101_135825,10404007.png,502730,14152,488578,0.9718497006345355,2,4,61265,2060,59205,0.9663755814902473,26.344917333333335,3614.72256,12.55005391266389,133,4.0E-5
2,test_20231101_135825,1254659.png,342646,59502,283144,0.8263455578060155,3,4,80080,8383,71697,0.8953171828171829,22.628085333333335,3743.293184,12.398265174011183,133,4.0E-5
3,test_20231101_135825,10188041.png,221231,7742,213489,0.965004904375969,2,4,41731,1099,40632,0.9736646617622391,12.021692444444444,1415.9182933333334,16.620421680920458,133,4.0E-5
4,test_20231101_135825,10287332.png,216980,10444,206536,0.9518665314775555,2,3,22337,1436,20901,0.9357120472758204,9.952625777777778,956.3146133333333,18.32479568637085,133,4.0E-5
5,test_20231101_135825,11610969.png,368720,19097,349623,0.9482073117812975,2,4,84111,2803,81308,0.9666749890026275,23.451530666666667,3450.915978666667,12.751459754522989,133,4.0E-5
6,test_20231101_135825,10350842.png,212614,4072,208542,0.9808479215855964,1,4,42529,599,41930,0.9859154929577465,20.203443555555555,2580.173893333333,14.014313842185771,133,4.0E-5
7,test_20231101_135825,10863862.png,317432,6657,310775,0.979028579349278,2,4,66058,979,65079,0.9851796905749493,35.89375288888889,6568.835178666666,9.955919959241273,133,4.0E-5
8,test_20231101_135825,11382381.png,312486,797,311689,0.997449485736961,1,4,46745,109,46636,0.997668199807466,21.309107555555556,2485.130629333333,14.177311387814227,133,4.0E-5
9,test_20231101_135825,11079715.png,443815,98874,344941,0.7772179849712155,4,4,124136,13895,110241,0.8880663143648901,18.42161422222222,2518.297664,14.119732982444997,133,4.0E-5
10,test_20231101_135825,11551286.png,271883,617,271266,0.99773064148917,1,3,40092,89,40003,0.9977801057567595,17.32512711111111,1775.1936,15.638346373772247,133,4.0E-5
1,test_20231101_135826,10404007.png,502730,14152,488578,0.9718497006345355,2,4,61265,2060,59205,0.9663755814902473,26.344917333333335,3614.72256,12.55005391266389,133,5.0E-5
2,test_20231101_135826,1254659.png,342646,59502,283144,0.8263455578060155,3,4,80080,8383,71697,0.8953171828171829,22.628085333333335,3743.293184,12.398265174011183,133,5.0E-5
3,test_20231101_135826,10188041.png,221231,7742,213489,0.965004904375969,2,4,41731,1099,40632,0.9736646617622391,12.021692444444444,1415.9182933333334,16.620421680920458,133,5.0E-5
4,test_20231101_135826,10287332.png,216980,10444,206536,0.9518665314775555,1,3,22337,1436,20901,0.9357120472758204,9.952625777777778,956.3146133333333,18.32479568637085,133,5.0E-5
5,test_20231101_135826,11610969.png,368720,19097,349623,0.9482073117812975,2,4,84111,2803,81308,0.9666749890026275,23.451530666666667,3450.915978666667,12.751459754522989,133,5.0E-5
6,test_20231101_135826,10350842.png,212614,4072,208542,0.9808479215855964,2,4,42529,599,41930,0.9859154929577465,20.203443555555555,2580.173893333333,14.014313842185771,133,5.0E-5
7,test_20231101_135826,10863862.png,317432,6657,310775,0.979028579349278,2,4,66058,979,65079,0.9851796905749493,35.89375288888889,6568.835178666666,9.955919959241273,133,5.0E-5
8,test_20231101_135826,11382381.png,312486,797,311689,0.997449485736961,2,3,46745,109,46636,0.997668199807466,21.309107555555556,2485.130629333333,14.177311387814227,133,5.0E-5
9,test_20231101_135826,11079715.png,443815,98874,344941,0.7772179849712155,3,4,124136,13895,110241,0.8880663143648901,18.42161422222222,2518.297664,14.119732982444997,133,5.0E-5
10,test_20231101_135826,11551286.png,271883,617,271266,0.99773064148917,1,3,40092,89,40003,0.9977801057567595,17.32512711111111,1775.1936,15.638346373772247,133,5.0E-5
1,test_20231101_135826,10404007.png,502730,14152,488578,0.9718497006345355,2,3,61265,2060,59205,0.9663755814902473,26.344917333333335,3614.72256,12.55005391266389,133,6.0E-5
2,test_20231101_135826,1254659.png,342646,59502,283144,0.8263455578060155,3,4,80080,8383,71697,0.8953171828171829,22.628085333333335,3743.293184,12.398265174011183,133,6.0E-5
3,test_20231101_135826,10188041.png,221231,7742,213489,0.965004904375969,2,3,41731,1099,40632,0.9736646617622391,12.021692444444444,1415.9182933333334,16.620421680920458,133,6.0E-5
4,test_20231101_135826,10287332.png,216980,10444,206536,0.9518665314775555,2,4,22337,1436,20901,0.9357120472758204,9.952625777777778,956.3146133333333,18.32479568637085,133,6.0E-5
5,test_20231101_135826,11610969.png,368720,19097,349623,0.9482073117812975,2,4,84111,2803,81308,0.9666749890026275,23.451530666666667,3450.915978666667,12.751459754522989,133,6.0E-5
6,test_20231101_135826,10350842.png,212614,4072,208542,0.9808479215855964,1,4,42529,599,41930,0.9859154929577465,20.203443555555555,2580.173893333333,14.014313842185771,133,6.0E-5
7,test_20231101_135826,10863862.png,317432,6657,310775,0.979028579349278,2,3,66058,979,65079,0.9851796905749493,35.89375288888889,6568.835178666666,9.955919959241273,133,6.0E-5
8,test_20231101_135826,11382381.png,312486,797,311689,0.997449485736961,2,3,46745,109,46636,0.997668199807466,21.309107555555556,2485.130629333333,14.177311387814227,133,6.0E-5
9,test_20231101_135826,11079715.png,443815,98874,344941,0.7772179849712155,5,4,124136,13895,110241,0.8880663143648901,18.42161422222222,2518.297664,14.119732982444997,133,6.0E-5
10,test_20231101_135826,11551286.png,271883,617,271266,0.99773064148917,1,3,40092,89,40003,0.9977801057567595,17.32512711111111,1775.1936,15.638346373772247,133,6.0E-5
1,test_20231101_135827,10404007.png,502730,13952,488778,0.9722475284944204,2,3,61265,2031,59234,0.9668489349547049,26.42939377777778,3633.37456,12.527701898270605,133,7.000000000000001E-5
2,test_20231101_135827,1254659.png,342646,59502,283144,0.8263455578060155,4,4,80080,8383,71697,0.8953171828171829,22.628085333333335,3743.293184,12.398265174011183,133,7.000000000000001E-5
3,test_20231101_135827,10188041.png,221231,7742,213489,0.965004904375969,2,3,41731,1099,40632,0.9736646617622391,12.021692444444444,1415.9182933333334,16.620421680920458,133,7.000000000000001E-5
4,test_20231101_135827,10287332.png,216980,10444,206536,0.9518665314775555,3,4,22337,1436,20901,0.9357120472758204,9.952625777777778,956.3146133333333,18.32479568637085,133,7.000000000000001E-5
5,test_20231101_135827,11610969.png,368720,19097,349623,0.9482073117812975,3,4,84111,2803,81308,0.9666749890026275,23.451530666666667,3450.915978666667,12.751459754522989,133,7.000000000000001E-5
6,test_20231101_135827,10350842.png,212614,3932,208682,0.98150639186507,4,7,42529,578,41951,0.9864092736720825,21.983740444444443,3072.926976,13.255281209164664,133,7.000000000000001E-5
7,test_20231101_135827,10863862.png,317432,6657,310775,0.979028579349278,2,3,66058,979,65079,0.9851796905749493,35.89375288888889,6568.835178666666,9.955919959241273,133,7.000000000000001E-5
8,test_20231101_135827,11382381.png,312486,797,311689,0.997449485736961,1,3,46745,109,46636,0.997668199807466,21.309107555555556,2485.130629333333,14.177311387814227,133,7.000000000000001E-5
9,test_20231101_135827,11079715.png,443815,98874,344941,0.7772179849712155,3,4,124136,13895,110241,0.8880663143648901,18.42161422222222,2518.297664,14.119732982444997,133,7.000000000000001E-5
10,test_20231101_135827,11551286.png,271883,477,271406,0.9982455688660196,1,4,40092,68,40024,0.9983039010276364,17.651459555555554,1826.2984533333333,15.515086095512114,133,7.000000000000001E-5
1,test_20231101_135828,10404007.png,502730,13952,488778,0.9722475284944204,2,4,61265,2031,59234,0.9668489349547049,26.42939377777778,3633.37456,12.527701898270605,133,8.0E-5
2,test_20231101_135828,1254659.png,342646,59502,283144,0.8263455578060155,3,4,80080,8383,71697,0.8953171828171829,22.628085333333335,3743.293184,12.398265174011183,133,8.0E-5
3,test_20231101_135828,10188041.png,221231,7742,213489,0.965004904375969,2,3,41731,1099,40632,0.9736646617622391,12.021692444444444,1415.9182933333334,16.620421680920458,133,8.0E-5
4,test_20231101_135828,10287332.png,216980,10444,206536,0.9518665314775555,2,3,22337,1436,20901,0.9357120472758204,9.952625777777778,956.3146133333333,18.32479568637085,133,8.0E-5
5,test_20231101_135828,11610969.png,368720,19097,349623,0.9482073117812975,3,3,84111,2803,81308,0.9666749890026275,23.451530666666667,3450.915978666667,12.751459754522989,133,8.0E-5
6,test_20231101_135828,10350842.png,212614,3932,208682,0.98150639186507,2,3,42529,578,41951,0.9864092736720825,21.983740444444443,3072.926976,13.255281209164664,133,8.0E-5
7,test_20231101_135828,10863862.png,317432,6657,310775,0.979028579349278,1,4,66058,979,65079,0.9851796905749493,35.89375288888889,6568.835178666666,9.955919959241273,133,8.0E-5
8,test_20231101_135828,11382381.png,312486,797,311689,0.997449485736961,2,3,46745,109,46636,0.997668199807466,21.309107555555556,2485.130629333333,14.177311387814227,133,8.0E-5
9,test_20231101_135828,11079715.png,443815,98874,344941,0.7772179849712155,3,4,124136,13895,110241,0.8880663143648901,18.42161422222222,2518.297664,14.119732982444997,133,8.0E-5
10,test_20231101_135828,11551286.png,271883,477,271406,0.9982455688660196,2,3,40092,68,40024,0.9983039010276364,17.651459555555554,1826.2984533333333,15.515086095512114,133,8.0E-5
1,test_20231101_135829,10404007.png,502730,13952,488778,0.9722475284944204,2,4,61265,2031,59234,0.9668489349547049,26.42939377777778,3633.37456,12.527701898270605,133,9.0E-5
2,test_20231101_135829,1254659.png,342646,59502,283144,0.8263455578060155,2,3,80080,8383,71697,0.8953171828171829,22.628085333333335,3743.293184,12.398265174011183,133,9.0E-5
3,test_20231101_135829,10188041.png,221231,7742,213489,0.965004904375969,1,3,41731,1099,40632,0.9736646617622391,12.021692444444444,1415.9182933333334,16.620421680920458,133,9.0E-5
4,test_20231101_135829,10287332.png,216980,10444,206536,0.9518665314775555,2,3,22337,1436,20901,0.9357120472758204,9.952625777777778,956.3146133333333,18.32479568637085,133,9.0E-5
5,test_20231101_135829,11610969.png,368720,19097,349623,0.9482073117812975,2,4,84111,2803,81308,0.9666749890026275,23.451530666666667,3450.915978666667,12.751459754522989,133,9.0E-5
6,test_20231101_135829,10350842.png,212614,3932,208682,0.98150639186507,1,4,42529,578,41951,0.9864092736720825,21.983740444444443,3072.926976,13.255281209164664,133,9.0E-5
7,test_20231101_135829,10863862.png,317432,6657,310775,0.979028579349278,2,4,66058,979,65079,0.9851796905749493,35.89375288888889,6568.835178666666,9.955919959241273,133,9.0E-5
8,test_20231101_135829,11382381.png,312486,797,311689,0.997449485736961,1,4,46745,109,46636,0.997668199807466,21.309107555555556,2485.130629333333,14.177311387814227,133,9.0E-5
9,test_20231101_135829,11079715.png,443815,98874,344941,0.7772179849712155,3,5,124136,13895,110241,0.8880663143648901,18.42161422222222,2518.297664,14.119732982444997,133,9.0E-5
10,test_20231101_135829,11551286.png,271883,477,271406,0.9982455688660196,2,3,40092,68,40024,0.9983039010276364,17.651459555555554,1826.2984533333333,15.515086095512114,133,9.0E-5
1,test_20231101_135829,10404007.png,502730,13952,488778,0.9722475284944204,2,4,61265,2031,59234,0.9668489349547049,26.42939377777778,3633.37456,12.527701898270605,133,1.0E-4
2,test_20231101_135829,1254659.png,342646,59502,283144,0.8263455578060155,3,4,80080,8383,71697,0.8953171828171829,22.628085333333335,3743.293184,12.398265174011183,133,1.0E-4
3,test_20231101_135829,10188041.png,221231,7742,213489,0.965004904375969,2,4,41731,1099,40632,0.9736646617622391,12.021692444444444,1415.9182933333334,16.620421680920458,133,1.0E-4
4,test_20231101_135829,10287332.png,216980,10444,206536,0.9518665314775555,2,3,22337,1436,20901,0.9357120472758204,9.952625777777778,956.3146133333333,18.32479568637085,133,1.0E-4
5,test_20231101_135829,11610969.png,368720,19097,349623,0.9482073117812975,2,4,84111,2803,81308,0.9666749890026275,23.451530666666667,3450.915978666667,12.751459754522989,133,1.0E-4
6,test_20231101_135829,10350842.png,212614,3932,208682,0.98150639186507,2,3,42529,578,41951,0.9864092736720825,21.983740444444443,3072.926976,13.255281209164664,133,1.0E-4
7,test_20231101_135829,10863862.png,317432,6657,310775,0.979028579349278,2,3,66058,979,65079,0.9851796905749493,35.89375288888889,6568.835178666666,9.955919959241273,133,1.0E-4
8,test_20231101_135829,11382381.png,312486,797,311689,0.997449485736961,2,3,46745,109,46636,0.997668199807466,21.309107555555556,2485.130629333333,14.177311387814227,133,1.0E-4
9,test_20231101_135829,11079715.png,443815,98874,344941,0.7772179849712155,3,4,124136,13895,110241,0.8880663143648901,18.42161422222222,2518.297664,14.119732982444997,133,1.0E-4
10,test_20231101_135829,11551286.png,271883,477,271406,0.9982455688660196,1,4,40092,68,40024,0.9983039010276364,17.651459555555554,1826.2984533333333,15.515086095512114,133,1.0E-4
1,test_20231101_135830,10404007.png,502730,13952,488778,0.9722475284944204,2,3,61265,2031,59234,0.9668489349547049,26.42939377777778,3633.37456,12.527701898270605,133,1.1E-4
2,test_20231101_135830,1254659.png,342646,59502,283144,0.8263455578060155,3,11,80080,8383,71697,0.8953171828171829,22.628085333333335,3743.293184,12.398265174011183,133,1.1E-4
3,test_20231101_135830,10188041.png,221231,7742,213489,0.965004904375969,2,4,41731,1099,40632,0.9736646617622391,12.021692444444444,1415.9182933333334,16.620421680920458,133,1.1E-4
4,test_20231101_135830,10287332.png,216980,10444,206536,0.9518665314775555,2,4,22337,1436,20901,0.9357120472758204,9.952625777777778,956.3146133333333,18.32479568637085,133,1.1E-4
5,test_20231101_135830,11610969.png,368720,19097,349623,0.9482073117812975,2,4,84111,2803,81308,0.9666749890026275,23.451530666666667,3450.915978666667,12.751459754522989,133,1.1E-4
6,test_20231101_135830,10350842.png,212614,3932,208682,0.98150639186507,1,3,42529,578,41951,0.9864092736720825,21.983740444444443,3072.926976,13.255281209164664,133,1.1E-4
7,test_20231101_135830,10863862.png,317432,6657,310775,0.979028579349278,2,4,66058,979,65079,0.9851796905749493,35.89375288888889,6568.835178666666,9.955919959241273,133,1.1E-4
8,test_20231101_135830,11382381.png,312486,797,311689,0.997449485736961,2,4,46745,109,46636,0.997668199807466,21.309107555555556,2485.130629333333,14.177311387814227,133,1.1E-4
9,test_20231101_135830,11079715.png,443815,98874,344941,0.7772179849712155,3,4,124136,13895,110241,0.8880663143648901,18.42161422222222,2518.297664,14.119732982444997,133,1.1E-4
10,test_20231101_135830,11551286.png,271883,477,271406,0.9982455688660196,2,3,40092,68,40024,0.9983039010276364,17.651459555555554,1826.2984533333333,15.515086095512114,133,1.1E-4
1,test_20231101_135831,10404007.png,502730,13952,488778,0.9722475284944204,2,4,61265,2031,59234,0.9668489349547049,26.42939377777778,3633.37456,12.527701898270605,133,1.2E-4
2,test_20231101_135831,1254659.png,342646,59502,283144,0.8263455578060155,2,11,80080,8383,71697,0.8953171828171829,22.628085333333335,3743.293184,12.398265174011183,133,1.2E-4
3,test_20231101_135831,10188041.png,221231,7742,213489,0.965004904375969,1,3,41731,1099,40632,0.9736646617622391,12.021692444444444,1415.9182933333334,16.620421680920458,133,1.2E-4
4,test_20231101_135831,10287332.png,216980,10444,206536,0.9518665314775555,1,4,22337,1436,20901,0.9357120472758204,9.952625777777778,956.3146133333333,18.32479568637085,133,1.2E-4
5,test_20231101_135831,11610969.png,368720,19097,349623,0.9482073117812975,2,4,84111,2803,81308,0.9666749890026275,23.451530666666667,3450.915978666667,12.751459754522989,133,1.2E-4
6,test_20231101_135831,10350842.png,212614,3932,208682,0.98150639186507,1,4,42529,578,41951,0.9864092736720825,21.983740444444443,3072.926976,13.255281209164664,133,1.2E-4
7,test_20231101_135831,10863862.png,317432,6657,310775,0.979028579349278,2,3,66058,979,65079,0.9851796905749493,35.89375288888889,6568.835178666666,9.955919959241273,133,1.2E-4
8,test_20231101_135831,11382381.png,312486,777,311709,0.9975134886042895,2,3,46745,106,46639,0.9977323777944165,22.065804444444446,2630.8038773333333,13.929918876080027,133,1.2E-4
9,test_20231101_135831,11079715.png,443815,98874,344941,0.7772179849712155,3,4,124136,13895,110241,0.8880663143648901,18.42161422222222,2518.297664,14.119732982444997,133,1.2E-4
10,test_20231101_135831,11551286.png,271883,477,271406,0.9982455688660196,1,4,40092,68,40024,0.9983039010276364,17.651459555555554,1826.2984533333333,15.515086095512114,133,1.2E-4
1,test_20231101_135831,10404007.png,502730,13952,488778,0.9722475284944204,2,3,61265,2031,59234,0.9668489349547049,26.42939377777778,3633.37456,12.527701898270605,133,1.3000000000000002E-4
2,test_20231101_135831,1254659.png,342646,59502,283144,0.8263455578060155,3,4,80080,8383,71697,0.8953171828171829,22.628085333333335,3743.293184,12.398265174011183,133,1.3000000000000002E-4
3,test_20231101_135831,10188041.png,221231,7742,213489,0.965004904375969,2,3,41731,1099,40632,0.9736646617622391,12.021692444444444,1415.9182933333334,16.620421680920458,133,1.3000000000000002E-4
4,test_20231101_135831,10287332.png,216980,10444,206536,0.9518665314775555,2,4,22337,1436,20901,0.9357120472758204,9.952625777777778,956.3146133333333,18.32479568637085,133,1.3000000000000002E-4
5,test_20231101_135831,11610969.png,368720,19097,349623,0.9482073117812975,2,4,84111,2803,81308,0.9666749890026275,23.451530666666667,3450.915978666667,12.751459754522989,133,1.3000000000000002E-4
6,test_20231101_135831,10350842.png,212614,3932,208682,0.98150639186507,1,4,42529,578,41951,0.9864092736720825,21.983740444444443,3072.926976,13.255281209164664,133,1.3000000000000002E-4
7,test_20231101_135831,10863862.png,317432,6657,310775,0.979028579349278,2,3,66058,979,65079,0.9851796905749493,35.89375288888889,6568.835178666666,9.955919959241273,133,1.3000000000000002E-4
8,test_20231101_135831,11382381.png,312486,667,311819,0.997865504374596,2,3,46745,90,46655,0.9980746603914857,22.322282666666666,2670.9360426666667,13.864168721911659,133,1.3000000000000002E-4
9,test_20231101_135831,11079715.png,443815,98874,344941,0.7772179849712155,3,4,124136,13895,110241,0.8880663143648901,18.42161422222222,2518.297664,14.119732982444997,133,1.3000000000000002E-4
10,test_20231101_135831,11551286.png,271883,477,271406,0.9982455688660196,1,3,40092,68,40024,0.9983039010276364,17.651459555555554,1826.2984533333333,15.515086095512114,133,1.3000000000000002E-4
1,test_20231101_135832,10404007.png,502730,13952,488778,0.9722475284944204,2,4,61265,2031,59234,0.9668489349547049,26.42939377777778,3633.37456,12.527701898270605,133,1.4000000000000001E-4
2,test_20231101_135832,1254659.png,342646,59502,283144,0.8263455578060155,3,4,80080,8383,71697,0.8953171828171829,22.628085333333335,3743.293184,12.398265174011183,133,1.4000000000000001E-4
3,test_20231101_135832,10188041.png,221231,7742,213489,0.965004904375969,2,4,41731,1099,40632,0.9736646617622391,12.021692444444444,1415.9182933333334,16.620421680920458,133,1.4000000000000001E-4
4,test_20231101_135832,10287332.png,216980,10444,206536,0.9518665314775555,2,4,22337,1436,20901,0.9357120472758204,9.952625777777778,956.3146133333333,18.32479568637085,133,1.4000000000000001E-4
5,test_20231101_135832,11610969.png,368720,19097,349623,0.9482073117812975,3,4,84111,2803,81308,0.9666749890026275,23.451530666666667,3450.915978666667,12.751459754522989,133,1.4000000000000001E-4
6,test_20231101_135832,10350842.png,212614,3932,208682,0.98150639186507,2,4,42529,578,41951,0.9864092736720825,21.983740444444443,3072.926976,13.255281209164664,133,1.4000000000000001E-4
7,test_20231101_135832,10863862.png,317432,6657,310775,0.979028579349278,1,4,66058,979,65079,0.9851796905749493,35.89375288888889,6568.835178666666,9.955919959241273,133,1.4000000000000001E-4
8,test_20231101_135832,11382381.png,312486,667,311819,0.997865504374596,2,3,46745,90,46655,0.9980746603914857,22.322282666666666,2670.9360426666667,13.864168721911659,133,1.4000000000000001E-4
9,test_20231101_135832,11079715.png,443815,98874,344941,0.7772179849712155,3,4,124136,13895,110241,0.8880663143648901,18.42161422222222,2518.297664,14.119732982444997,133,1.4000000000000001E-4
10,test_20231101_135832,11551286.png,271883,477,271406,0.9982455688660196,1,3,40092,68,40024,0.9983039010276364,17.651459555555554,1826.2984533333333,15.515086095512114,133,1.4000000000000001E-4
1,test_20231101_135833,10404007.png,502730,13952,488778,0.9722475284944204,2,3,61265,2031,59234,0.9668489349547049,26.42939377777778,3633.37456,12.527701898270605,133,1.5000000000000001E-4
2,test_20231101_135833,1254659.png,342646,59502,283144,0.8263455578060155,3,3,80080,8383,71697,0.8953171828171829,22.628085333333335,3743.293184,12.398265174011183,133,1.5000000000000001E-4
3,test_20231101_135833,10188041.png,221231,7742,213489,0.965004904375969,2,4,41731,1099,40632,0.9736646617622391,12.021692444444444,1415.9182933333334,16.620421680920458,133,1.5000000000000001E-4
4,test_20231101_135833,10287332.png,216980,10444,206536,0.9518665314775555,1,3,22337,1436,20901,0.9357120472758204,9.952625777777778,956.3146133333333,18.32479568637085,133,1.5000000000000001E-4
5,test_20231101_135833,11610969.png,368720,19097,349623,0.9482073117812975,2,4,84111,2803,81308,0.9666749890026275,23.451530666666667,3450.915978666667,12.751459754522989,133,1.5000000000000001E-4
6,test_20231101_135833,10350842.png,212614,3932,208682,0.98150639186507,1,4,42529,578,41951,0.9864092736720825,21.983740444444443,3072.926976,13.255281209164664,133,1.5000000000000001E-4
7,test_20231101_135833,10863862.png,317432,6657,310775,0.979028579349278,2,4,66058,979,65079,0.9851796905749493,35.89375288888889,6568.835178666666,9.955919959241273,133,1.5000000000000001E-4
8,test_20231101_135833,11382381.png,312486,667,311819,0.997865504374596,1,3,46745,90,46655,0.9980746603914857,22.322282666666666,2670.9360426666667,13.864168721911659,133,1.5000000000000001E-4
9,test_20231101_135833,11079715.png,443815,98874,344941,0.7772179849712155,4,9,124136,13895,110241,0.8880663143648901,18.42161422222222,2518.297664,14.119732982444997,133,1.5000000000000001E-4
10,test_20231101_135833,11551286.png,271883,477,271406,0.9982455688660196,1,3,40092,68,40024,0.9983039010276364,17.651459555555554,1826.2984533333333,15.515086095512114,133,1.5000000000000001E-4
1,test_20231101_135833,10404007.png,502730,13952,488778,0.9722475284944204,2,4,61265,2031,59234,0.9668489349547049,26.42939377777778,3633.37456,12.527701898270605,133,1.6E-4
2,test_20231101_135833,1254659.png,342646,59502,283144,0.8263455578060155,3,4,80080,8383,71697,0.8953171828171829,22.628085333333335,3743.293184,12.398265174011183,133,1.6E-4
3,test_20231101_135833,10188041.png,221231,7742,213489,0.965004904375969,2,3,41731,1099,40632,0.9736646617622391,12.021692444444444,1415.9182933333334,16.620421680920458,133,1.6E-4
4,test_20231101_135833,10287332.png,216980,10252,206728,0.9527514056595078,2,4,22337,1412,20925,0.9367864977391771,10.08100088888889,982.629264,18.20690667012046,133,1.6E-4
5,test_20231101_135833,11610969.png,368720,19097,349623,0.9482073117812975,2,4,84111,2803,81308,0.9666749890026275,23.451530666666667,3450.915978666667,12.751459754522989,133,1.6E-4
6,test_20231101_135833,10350842.png,212614,3932,208682,0.98150639186507,2,3,42529,578,41951,0.9864092736720825,21.983740444444443,3072.926976,13.255281209164664,133,1.6E-4
7,test_20231101_135833,10863862.png,317432,6657,310775,0.979028579349278,1,4,66058,979,65079,0.9851796905749493,35.89375288888889,6568.835178666666,9.955919959241273,133,1.6E-4
8,test_20231101_135833,11382381.png,312486,667,311819,0.997865504374596,1,4,46745,90,46655,0.9980746603914857,22.322282666666666,2670.9360426666667,13.864168721911659,133,1.6E-4
9,test_20231101_135833,11079715.png,443815,98874,344941,0.7772179849712155,4,4,124136,13895,110241,0.8880663143648901,18.42161422222222,2518.297664,14.119732982444997,133,1.6E-4
10,test_20231101_135833,11551286.png,271883,477,271406,0.9982455688660196,1,4,40092,68,40024,0.9983039010276364,17.651459555555554,1826.2984533333333,15.515086095512114,133,1.6E-4
1,test_20231101_135834,10404007.png,502730,13952,488778,0.9722475284944204,2,3,61265,2031,59234,0.9668489349547049,26.42939377777778,3633.37456,12.527701898270605,133,1.7E-4
2,test_20231101_135834,1254659.png,342646,59502,283144,0.8263455578060155,3,4,80080,8383,71697,0.8953171828171829,22.628085333333335,3743.293184,12.398265174011183,133,1.7E-4
3,test_20231101_135834,10188041.png,221231,7742,213489,0.965004904375969,2,4,41731,1099,40632,0.9736646617622391,12.021692444444444,1415.9182933333334,16.620421680920458,133,1.7E-4
4,test_20231101_135834,10287332.png,216980,10252,206728,0.9527514056595078,2,4,22337,1412,20925,0.9367864977391771,10.08100088888889,982.629264,18.20690667012046,133,1.7E-4
5,test_20231101_135834,11610969.png,368720,19097,349623,0.9482073117812975,2,4,84111,2803,81308,0.9666749890026275,23.451530666666667,3450.915978666667,12.751459754522989,133,1.7E-4
6,test_20231101_135834,10350842.png,212614,3932,208682,0.98150639186507,2,3,42529,578,41951,0.9864092736720825,21.983740444444443,3072.926976,13.255281209164664,133,1.7E-4
7,test_20231101_135834,10863862.png,317432,6657,310775,0.979028579349278,1,4,66058,979,65079,0.9851796905749493,35.89375288888889,6568.835178666666,9.955919959241273,133,1.7E-4
8,test_20231101_135834,11382381.png,312486,667,311819,0.997865504374596,1,4,46745,90,46655,0.9980746603914857,22.322282666666666,2670.9360426666667,13.864168721911659,133,1.7E-4
9,test_20231101_135834,11079715.png,443815,98874,344941,0.7772179849712155,4,4,124136,13895,110241,0.8880663143648901,18.42161422222222,2518.297664,14.119732982444997,133,1.7E-4
10,test_20231101_135834,11551286.png,271883,477,271406,0.9982455688660196,2,4,40092,68,40024,0.9983039010276364,17.651459555555554,1826.2984533333333,15.515086095512114,133,1.7E-4
1,test_20231101_135835,10404007.png,502730,13952,488778,0.9722475284944204,2,4,61265,2031,59234,0.9668489349547049,26.42939377777778,3633.37456,12.527701898270605,133,1.8E-4
2,test_20231101_135835,1254659.png,342646,59502,283144,0.8263455578060155,2,4,80080,8383,71697,0.8953171828171829,22.628085333333335,3743.293184,12.398265174011183,133,1.8E-4
3,test_20231101_135835,10188041.png,221231,7742,213489,0.965004904375969,2,3,41731,1099,40632,0.9736646617622391,12.021692444444444,1415.9182933333334,16.620421680920458,133,1.8E-4
4,test_20231101_135835,10287332.png,216980,10252,206728,0.9527514056595078,2,4,22337,1412,20925,0.9367864977391771,10.08100088888889,982.629264,18.20690667012046,133,1.8E-4
5,test_20231101_135835,11610969.png,368720,19097,349623,0.9482073117812975,2,3,84111,2803,81308,0.9666749890026275,23.451530666666667,3450.915978666667,12.751459754522989,133,1.8E-4
6,test_20231101_135835,10350842.png,212614,3932,208682,0.98150639186507,2,3,42529,578,41951,0.9864092736720825,21.983740444444443,3072.926976,13.255281209164664,133,1.8E-4
7,test_20231101_135835,10863862.png,317432,6657,310775,0.979028579349278,2,4,66058,979,65079,0.9851796905749493,35.89375288888889,6568.835178666666,9.955919959241273,133,1.8E-4
8,test_20231101_135835,11382381.png,312486,667,311819,0.997865504374596,1,4,46745,90,46655,0.9980746603914857,22.322282666666666,2670.9360426666667,13.864168721911659,133,1.8E-4
9,test_20231101_135835,11079715.png,443815,98874,344941,0.7772179849712155,3,4,124136,13895,110241,0.8880663143648901,18.42161422222222,2518.297664,14.119732982444997,133,1.8E-4
10,test_20231101_135835,11551286.png,271883,477,271406,0.9982455688660196,1,4,40092,68,40024,0.9983039010276364,17.651459555555554,1826.2984533333333,15.515086095512114,133,1.8E-4
1,test_20231101_135835,10404007.png,502730,13952,488778,0.9722475284944204,2,4,61265,2031,59234,0.9668489349547049,26.42939377777778,3633.37456,12.527701898270605,133,1.9E-4
2,test_20231101_135835,1254659.png,342646,59502,283144,0.8263455578060155,3,3,80080,8383,71697,0.8953171828171829,22.628085333333335,3743.293184,12.398265174011183,133,1.9E-4
3,test_20231101_135835,10188041.png,221231,7742,213489,0.965004904375969,2,4,41731,1099,40632,0.9736646617622391,12.021692444444444,1415.9182933333334,16.620421680920458,133,1.9E-4
4,test_20231101_135835,10287332.png,216980,10252,206728,0.9527514056595078,1,8,22337,1412,20925,0.9367864977391771,10.08100088888889,982.629264,18.20690667012046,133,1.9E-4
5,test_20231101_135835,11610969.png,368720,19097,349623,0.9482073117812975,2,5,84111,2803,81308,0.9666749890026275,23.451530666666667,3450.915978666667,12.751459754522989,133,1.9E-4
6,test_20231101_135835,10350842.png,212614,3932,208682,0.98150639186507,3,4,42529,578,41951,0.9864092736720825,21.983740444444443,3072.926976,13.255281209164664,133,1.9E-4
7,test_20231101_135835,10863862.png,317432,6657,310775,0.979028579349278,1,3,66058,979,65079,0.9851796905749493,35.89375288888889,6568.835178666666,9.955919959241273,133,1.9E-4
8,test_20231101_135835,11382381.png,312486,667,311819,0.997865504374596,1,4,46745,90,46655,0.9980746603914857,22.322282666666666,2670.9360426666667,13.864168721911659,133,1.9E-4
9,test_20231101_135835,11079715.png,443815,98874,344941,0.7772179849712155,3,4,124136,13895,110241,0.8880663143648901,18.42161422222222,2518.297664,14.119732982444997,133,1.9E-4
10,test_20231101_135835,11551286.png,271883,477,271406,0.9982455688660196,2,4,40092,68,40024,0.9983039010276364,17.651459555555554,1826.2984533333333,15.515086095512114,133,1.9E-4
1,test_20231101_135836,10404007.png,502730,13952,488778,0.9722475284944204,2,4,61265,2031,59234,0.9668489349547049,26.42939377777778,3633.37456,12.527701898270605,133,2.0E-4
2,test_20231101_135836,1254659.png,342646,59502,283144,0.8263455578060155,3,4,80080,8383,71697,0.8953171828171829,22.628085333333335,3743.293184,12.398265174011183,133,2.0E-4
3,test_20231101_135836,10188041.png,221231,7742,213489,0.965004904375969,2,4,41731,1099,40632,0.9736646617622391,12.021692444444444,1415.9182933333334,16.620421680920458,133,2.0E-4
4,test_20231101_135836,10287332.png,216980,10252,206728,0.9527514056595078,2,4,22337,1412,20925,0.9367864977391771,10.08100088888889,982.629264,18.20690667012046,133,2.0E-4
5,test_20231101_135836,11610969.png,368720,19097,349623,0.9482073117812975,3,4,84111,2803,81308,0.9666749890026275,23.451530666666667,3450.915978666667,12.751459754522989,133,2.0E-4
6,test_20231101_135836,10350842.png,212614,3932,208682,0.98150639186507,2,4,42529,578,41951,0.9864092736720825,21.983740444444443,3072.926976,13.255281209164664,133,2.0E-4
7,test_20231101_135836,10863862.png,317432,6657,310775,0.979028579349278,2,4,66058,979,65079,0.9851796905749493,35.89375288888889,6568.835178666666,9.955919959241273,133,2.0E-4
8,test_20231101_135836,11382381.png,312486,667,311819,0.997865504374596,2,4,46745,90,46655,0.9980746603914857,22.322282666666666,2670.9360426666667,13.864168721911659,133,2.0E-4
9,test_20231101_135836,11079715.png,443815,98874,344941,0.7772179849712155,3,4,124136,13895,110241,0.8880663143648901,18.42161422222222,2518.297664,14.119732982444997,133,2.0E-4
10,test_20231101_135836,11551286.png,271883,267,271616,0.9990179599312939,1,4,40092,37,40055,0.9990771226179787,17.919265777777778,1867.1754613333333,15.418952296845859,133,2.0E-4
1,test_20231101_135837,10404007.png,502730,13952,488778,0.9722475284944204,3,3,61265,2031,59234,0.9668489349547049,26.42939377777778,3633.37456,12.527701898270605,133,2.1E-4
2,test_20231101_135837,1254659.png,342646,59502,283144,0.8263455578060155,3,4,80080,8383,71697,0.8953171828171829,22.628085333333335,3743.293184,12.398265174011183,133,2.1E-4
3,test_20231101_135837,10188041.png,221231,7742,213489,0.965004904375969,2,4,41731,1099,40632,0.9736646617622391,12.021692444444444,1415.9182933333334,16.620421680920458,133,2.1E-4
4,test_20231101_135837,10287332.png,216980,10252,206728,0.9527514056595078,2,3,22337,1412,20925,0.9367864977391771,10.08100088888889,982.629264,18.20690667012046,133,2.1E-4
5,test_20231101_135837,11610969.png,368720,19097,349623,0.9482073117812975,3,4,84111,2803,81308,0.9666749890026275,23.451530666666667,3450.915978666667,12.751459754522989,133,2.1E-4
6,test_20231101_135837,10350842.png,212614,3932,208682,0.98150639186507,2,4,42529,578,41951,0.9864092736720825,21.983740444444443,3072.926976,13.255281209164664,133,2.1E-4
7,test_20231101_135837,10863862.png,317432,6657,310775,0.979028579349278,2,4,66058,979,65079,0.9851796905749493,35.89375288888889,6568.835178666666,9.955919959241273,133,2.1E-4
8,test_20231101_135837,11382381.png,312486,667,311819,0.997865504374596,3,4,46745,90,46655,0.9980746603914857,22.322282666666666,2670.9360426666667,13.864168721911659,133,2.1E-4
9,test_20231101_135837,11079715.png,443815,98874,344941,0.7772179849712155,5,5,124136,13895,110241,0.8880663143648901,18.42161422222222,2518.297664,14.119732982444997,133,2.1E-4
10,test_20231101_135837,11551286.png,271883,267,271616,0.9990179599312939,1,3,40092,37,40055,0.9990771226179787,17.919265777777778,1867.1754613333333,15.418952296845859,133,2.1E-4
1,test_20231101_135838,10404007.png,502730,13952,488778,0.9722475284944204,3,4,61265,2031,59234,0.9668489349547049,26.42939377777778,3633.37456,12.527701898270605,133,2.2E-4
2,test_20231101_135838,1254659.png,342646,59502,283144,0.8263455578060155,3,4,80080,8383,71697,0.8953171828171829,22.628085333333335,3743.293184,12.398265174011183,133,2.2E-4
3,test_20231101_135838,10188041.png,221231,7742,213489,0.965004904375969,2,3,41731,1099,40632,0.9736646617622391,12.021692444444444,1415.9182933333334,16.620421680920458,133,2.2E-4
4,test_20231101_135838,10287332.png,216980,10252,206728,0.9527514056595078,2,4,22337,1412,20925,0.9367864977391771,10.08100088888889,982.629264,18.20690667012046,133,2.2E-4
5,test_20231101_135838,11610969.png,368720,19097,349623,0.9482073117812975,2,3,84111,2803,81308,0.9666749890026275,23.451530666666667,3450.915978666667,12.751459754522989,133,2.2E-4
6,test_20231101_135838,10350842.png,212614,3932,208682,0.98150639186507,2,4,42529,578,41951,0.9864092736720825,21.983740444444443,3072.926976,13.255281209164664,133,2.2E-4
7,test_20231101_135838,10863862.png,317432,6657,310775,0.979028579349278,2,4,66058,979,65079,0.9851796905749493,35.89375288888889,6568.835178666666,9.955919959241273,133,2.2E-4
8,test_20231101_135838,11382381.png,312486,667,311819,0.997865504374596,1,3,46745,90,46655,0.9980746603914857,22.322282666666666,2670.9360426666667,13.864168721911659,133,2.2E-4
9,test_20231101_135838,11079715.png,443815,98874,344941,0.7772179849712155,7,4,124136,13895,110241,0.8880663143648901,18.42161422222222,2518.297664,14.119732982444997,133,2.2E-4
10,test_20231101_135838,11551286.png,271883,267,271616,0.9990179599312939,1,4,40092,37,40055,0.9990771226179787,17.919265777777778,1867.1754613333333,15.418952296845859,133,2.2E-4
1,test_20231101_135838,10404007.png,502730,13952,488778,0.9722475284944204,2,5,61265,2031,59234,0.9668489349547049,26.42939377777778,3633.37456,12.527701898270605,133,2.3E-4
2,test_20231101_135838,1254659.png,342646,59502,283144,0.8263455578060155,3,4,80080,8383,71697,0.8953171828171829,22.628085333333335,3743.293184,12.398265174011183,133,2.3E-4
3,test_20231101_135838,10188041.png,221231,7742,213489,0.965004904375969,2,4,41731,1099,40632,0.9736646617622391,12.021692444444444,1415.9182933333334,16.620421680920458,133,2.3E-4
4,test_20231101_135838,10287332.png,216980,10252,206728,0.9527514056595078,1,4,22337,1412,20925,0.9367864977391771,10.08100088888889,982.629264,18.20690667012046,133,2.3E-4
5,test_20231101_135838,11610969.png,368720,19097,349623,0.9482073117812975,2,3,84111,2803,81308,0.9666749890026275,23.451530666666667,3450.915978666667,12.751459754522989,133,2.3E-4
6,test_20231101_135838,10350842.png,212614,3932,208682,0.98150639186507,2,4,42529,578,41951,0.9864092736720825,21.983740444444443,3072.926976,13.255281209164664,133,2.3E-4
7,test_20231101_135838,10863862.png,317432,6657,310775,0.979028579349278,2,4,66058,979,65079,0.9851796905749493,35.89375288888889,6568.835178666666,9.955919959241273,133,2.3E-4
8,test_20231101_135838,11382381.png,312486,667,311819,0.997865504374596,2,3,46745,90,46655,0.9980746603914857,22.322282666666666,2670.9360426666667,13.864168721911659,133,2.3E-4
9,test_20231101_135838,11079715.png,443815,98874,344941,0.7772179849712155,4,4,124136,13895,110241,0.8880663143648901,18.42161422222222,2518.297664,14.119732982444997,133,2.3E-4
10,test_20231101_135838,11551286.png,271883,267,271616,0.9990179599312939,1,3,40092,37,40055,0.9990771226179787,17.919265777777778,1867.1754613333333,15.418952296845859,133,2.3E-4
1,test_20231101_135839,10404007.png,502730,13952,488778,0.9722475284944204,2,4,61265,2031,59234,0.9668489349547049,26.42939377777778,3633.37456,12.527701898270605,133,2.4E-4
2,test_20231101_135839,1254659.png,342646,59502,283144,0.8263455578060155,3,4,80080,8383,71697,0.8953171828171829,22.628085333333335,3743.293184,12.398265174011183,133,2.4E-4
3,test_20231101_135839,10188041.png,221231,7742,213489,0.965004904375969,2,4,41731,1099,40632,0.9736646617622391,12.021692444444444,1415.9182933333334,16.620421680920458,133,2.4E-4
4,test_20231101_135839,10287332.png,216980,10252,206728,0.9527514056595078,2,4,22337,1412,20925,0.9367864977391771,10.08100088888889,982.629264,18.20690667012046,133,2.4E-4
5,test_20231101_135839,11610969.png,368720,19097,349623,0.9482073117812975,3,4,84111,2803,81308,0.9666749890026275,23.451530666666667,3450.915978666667,12.751459754522989,133,2.4E-4
6,test_20231101_135839,10350842.png,212614,3932,208682,0.98150639186507,2,4,42529,578,41951,0.9864092736720825,21.983740444444443,3072.926976,13.255281209164664,133,2.4E-4
7,test_20231101_135839,10863862.png,317432,6657,310775,0.979028579349278,2,4,66058,979,65079,0.9851796905749493,35.89375288888889,6568.835178666666,9.955919959241273,133,2.4E-4
8,test_20231101_135839,11382381.png,312486,667,311819,0.997865504374596,2,4,46745,90,46655,0.9980746603914857,22.322282666666666,2670.9360426666667,13.864168721911659,133,2.4E-4
9,test_20231101_135839,11079715.png,443815,98874,344941,0.7772179849712155,3,4,124136,13895,110241,0.8880663143648901,18.42161422222222,2518.297664,14.119732982444997,133,2.4E-4
10,test_20231101_135839,11551286.png,271883,267,271616,0.9990179599312939,2,4,40092,37,40055,0.9990771226179787,17.919265777777778,1867.1754613333333,15.418952296845859,133,2.4E-4
1,test_20231101_135840,10404007.png,502730,13952,488778,0.9722475284944204,2,4,61265,2031,59234,0.9668489349547049,26.42939377777778,3633.37456,12.527701898270605,133,2.5E-4
2,test_20231101_135840,1254659.png,342646,59502,283144,0.8263455578060155,3,4,80080,8383,71697,0.8953171828171829,22.628085333333335,3743.293184,12.398265174011183,133,2.5E-4
3,test_20231101_135840,10188041.png,221231,7742,213489,0.965004904375969,2,4,41731,1099,40632,0.9736646617622391,12.021692444444444,1415.9182933333334,16.620421680920458,133,2.5E-4
4,test_20231101_135840,10287332.png,216980,10252,206728,0.9527514056595078,1,4,22337,1412,20925,0.9367864977391771,10.08100088888889,982.629264,18.20690667012046,133,2.5E-4
5,test_20231101_135840,11610969.png,368720,19097,349623,0.9482073117812975,2,4,84111,2803,81308,0.9666749890026275,23.451530666666667,3450.915978666667,12.751459754522989,133,2.5E-4
6,test_20231101_135840,10350842.png,212614,3932,208682,0.98150639186507,1,3,42529,578,41951,0.9864092736720825,21.983740444444443,3072.926976,13.255281209164664,133,2.5E-4
7,test_20231101_135840,10863862.png,317432,6657,310775,0.979028579349278,1,4,66058,979,65079,0.9851796905749493,35.89375288888889,6568.835178666666,9.955919959241273,133,2.5E-4
8,test_20231101_135840,11382381.png,312486,667,311819,0.997865504374596,1,4,46745,90,46655,0.9980746603914857,22.322282666666666,2670.9360426666667,13.864168721911659,133,2.5E-4
9,test_20231101_135840,11079715.png,443815,98874,344941,0.7772179849712155,3,4,124136,13895,110241,0.8880663143648901,18.42161422222222,2518.297664,14.119732982444997,133,2.5E-4
10,test_20231101_135840,11551286.png,271883,267,271616,0.9990179599312939,1,4,40092,37,40055,0.9990771226179787,17.919265777777778,1867.1754613333333,15.418952296845859,133,2.5E-4
1,test_20231101_135840,10404007.png,502730,13872,488858,0.9724066596383745,2,3,61265,2019,59246,0.9670448053537909,26.43332977777778,3634.1775893333333,12.526742149506438,133,2.6000000000000003E-4
2,test_20231101_135840,1254659.png,342646,59442,283204,0.8265206656432587,3,5,80080,8377,71703,0.8953921078921079,22.63763911111111,3744.3753706666666,12.397009809413873,133,2.6000000000000003E-4
3,test_20231101_135840,10188041.png,221231,7682,213549,0.9652761141069741,2,4,41731,1091,40640,0.9738563657712492,12.255687111111111,1439.799552,16.54778326772516,133,2.6000000000000003E-4
4,test_20231101_135840,10287332.png,216980,10252,206728,0.9527514056595078,2,4,22337,1412,20925,0.9367864977391771,10.08100088888889,982.629264,18.20690667012046,133,2.6000000000000003E-4
5,test_20231101_135840,11610969.png,368720,18977,349743,0.9485327619874159,3,4,84111,2788,81323,0.9668533247732164,23.867306666666668,3517.9054613333333,12.667961966313278,133,2.6000000000000003E-4
6,test_20231101_135840,10350842.png,212614,3932,208682,0.98150639186507,1,3,42529,578,41951,0.9864092736720825,21.983740444444443,3072.926976,13.255281209164664,133,2.6000000000000003E-4
7,test_20231101_135840,10863862.png,317432,6617,310815,0.9791545905894806,2,3,66058,973,65085,0.9852705198461957,35.89944888888889,6569.9042346666665,9.955213216976183,133,2.6000000000000003E-4
8,test_20231101_135840,11382381.png,312486,547,311939,0.9982495215785667,1,3,46745,72,46673,0.9984597283131885,22.81680888888889,2740.878352,13.751906001286724,133,2.6000000000000003E-4
9,test_20231101_135840,11079715.png,443815,98874,344941,0.7772179849712155,3,4,124136,13895,110241,0.8880663143648901,18.42161422222222,2518.297664,14.119732982444997,133,2.6000000000000003E-4
10,test_20231101_135840,11551286.png,271883,164,271719,0.9993967993585476,1,3,40092,22,40070,0.9994512620971765,18.120286222222223,1899.5769013333334,15.344234809036362,133,2.6000000000000003E-4
1,test_20231101_135841,10404007.png,502730,13872,488858,0.9724066596383745,2,4,61265,2019,59246,0.9670448053537909,26.43332977777778,3634.1775893333333,12.526742149506438,133,2.7000000000000006E-4
2,test_20231101_135841,1254659.png,342646,59442,283204,0.8265206656432587,2,4,80080,8377,71703,0.8953921078921079,22.63763911111111,3744.3753706666666,12.397009809413873,133,2.7000000000000006E-4
3,test_20231101_135841,10188041.png,221231,7682,213549,0.9652761141069741,2,3,41731,1091,40640,0.9738563657712492,12.255687111111111,1439.799552,16.54778326772516,133,2.7000000000000006E-4
4,test_20231101_135841,10287332.png,216980,10252,206728,0.9527514056595078,2,3,22337,1412,20925,0.9367864977391771,10.08100088888889,982.629264,18.20690667012046,133,2.7000000000000006E-4
5,test_20231101_135841,11610969.png,368720,18977,349743,0.9485327619874159,2,4,84111,2788,81323,0.9668533247732164,23.867306666666668,3517.9054613333333,12.667961966313278,133,2.7000000000000006E-4
6,test_20231101_135841,10350842.png,212614,3932,208682,0.98150639186507,2,4,42529,578,41951,0.9864092736720825,21.983740444444443,3072.926976,13.255281209164664,133,2.7000000000000006E-4
7,test_20231101_135841,10863862.png,317432,6617,310815,0.9791545905894806,2,5,66058,973,65085,0.9852705198461957,35.89944888888889,6569.9042346666665,9.955213216976183,133,2.7000000000000006E-4
8,test_20231101_135841,11382381.png,312486,547,311939,0.9982495215785667,2,4,46745,72,46673,0.9984597283131885,22.81680888888889,2740.878352,13.751906001286724,133,2.7000000000000006E-4
9,test_20231101_135841,11079715.png,443815,98874,344941,0.7772179849712155,4,4,124136,13895,110241,0.8880663143648901,18.42161422222222,2518.297664,14.119732982444997,133,2.7000000000000006E-4
10,test_20231101_135841,11551286.png,271883,164,271719,0.9993967993585476,2,4,40092,22,40070,0.9994512620971765,18.120286222222223,1899.5769013333334,15.344234809036362,133,2.7000000000000006E-4
1,test_20231101_135842,10404007.png,502730,13872,488858,0.9724066596383745,3,4,61265,2019,59246,0.9670448053537909,26.43332977777778,3634.1775893333333,12.526742149506438,133,2.800000000000001E-4
2,test_20231101_135842,1254659.png,342646,59442,283204,0.8265206656432587,3,5,80080,8377,71703,0.8953921078921079,22.63763911111111,3744.3753706666666,12.397009809413873,133,2.800000000000001E-4
3,test_20231101_135842,10188041.png,221231,7682,213549,0.9652761141069741,2,5,41731,1091,40640,0.9738563657712492,12.255687111111111,1439.799552,16.54778326772516,133,2.800000000000001E-4
4,test_20231101_135842,10287332.png,216980,10252,206728,0.9527514056595078,4,7,22337,1412,20925,0.9367864977391771,10.08100088888889,982.629264,18.20690667012046,133,2.800000000000001E-4
5,test_20231101_135842,11610969.png,368720,18977,349743,0.9485327619874159,2,3,84111,2788,81323,0.9668533247732164,23.867306666666668,3517.9054613333333,12.667961966313278,133,2.800000000000001E-4
6,test_20231101_135842,10350842.png,212614,3932,208682,0.98150639186507,2,4,42529,578,41951,0.9864092736720825,21.983740444444443,3072.926976,13.255281209164664,133,2.800000000000001E-4
7,test_20231101_135842,10863862.png,317432,6617,310815,0.9791545905894806,2,4,66058,973,65085,0.9852705198461957,35.89944888888889,6569.9042346666665,9.955213216976183,133,2.800000000000001E-4
8,test_20231101_135842,11382381.png,312486,547,311939,0.9982495215785667,1,3,46745,72,46673,0.9984597283131885,22.81680888888889,2740.878352,13.751906001286724,133,2.800000000000001E-4
9,test_20231101_135842,11079715.png,443815,98874,344941,0.7772179849712155,3,4,124136,13895,110241,0.8880663143648901,18.42161422222222,2518.297664,14.119732982444997,133,2.800000000000001E-4
10,test_20231101_135842,11551286.png,271883,164,271719,0.9993967993585476,1,4,40092,22,40070,0.9994512620971765,18.120286222222223,1899.5769013333334,15.344234809036362,133,2.800000000000001E-4
1,test_20231101_135843,10404007.png,502730,13872,488858,0.9724066596383745,2,4,61265,2019,59246,0.9670448053537909,26.43332977777778,3634.1775893333333,12.526742149506438,133,2.900000000000001E-4
2,test_20231101_135843,1254659.png,342646,59442,283204,0.8265206656432587,2,4,80080,8377,71703,0.8953921078921079,22.63763911111111,3744.3753706666666,12.397009809413873,133,2.900000000000001E-4
3,test_20231101_135843,10188041.png,221231,7682,213549,0.9652761141069741,3,4,41731,1091,40640,0.9738563657712492,12.255687111111111,1439.799552,16.54778326772516,133,2.900000000000001E-4
4,test_20231101_135843,10287332.png,216980,10252,206728,0.9527514056595078,2,4,22337,1412,20925,0.9367864977391771,10.08100088888889,982.629264,18.20690667012046,133,2.900000000000001E-4
5,test_20231101_135843,11610969.png,368720,18977,349743,0.9485327619874159,2,3,84111,2788,81323,0.9668533247732164,23.867306666666668,3517.9054613333333,12.667961966313278,133,2.900000000000001E-4
6,test_20231101_135843,10350842.png,212614,3932,208682,0.98150639186507,1,4,42529,578,41951,0.9864092736720825,21.983740444444443,3072.926976,13.255281209164664,133,2.900000000000001E-4
7,test_20231101_135843,10863862.png,317432,6617,310815,0.9791545905894806,2,3,66058,973,65085,0.9852705198461957,35.89944888888889,6569.9042346666665,9.955213216976183,133,2.900000000000001E-4
8,test_20231101_135843,11382381.png,312486,547,311939,0.9982495215785667,2,3,46745,72,46673,0.9984597283131885,22.81680888888889,2740.878352,13.751906001286724,133,2.900000000000001E-4
9,test_20231101_135843,11079715.png,443815,98874,344941,0.7772179849712155,3,4,124136,13895,110241,0.8880663143648901,18.42161422222222,2518.297664,14.119732982444997,133,2.900000000000001E-4
10,test_20231101_135843,11551286.png,271883,164,271719,0.9993967993585476,1,3,40092,22,40070,0.9994512620971765,18.120286222222223,1899.5769013333334,15.344234809036362,133,2.900000000000001E-4
1,test_20231101_135843,10404007.png,502730,13872,488858,0.9724066596383745,2,3,61265,2019,59246,0.9670448053537909,26.43332977777778,3634.1775893333333,12.526742149506438,133,3.0000000000000014E-4
2,test_20231101_135843,1254659.png,342646,59442,283204,0.8265206656432587,2,4,80080,8377,71703,0.8953921078921079,22.63763911111111,3744.3753706666666,12.397009809413873,133,3.0000000000000014E-4
3,test_20231101_135843,10188041.png,221231,7682,213549,0.9652761141069741,1,3,41731,1091,40640,0.9738563657712492,12.255687111111111,1439.799552,16.54778326772516,133,3.0000000000000014E-4
4,test_20231101_135843,10287332.png,216980,10252,206728,0.9527514056595078,1,3,22337,1412,20925,0.9367864977391771,10.08100088888889,982.629264,18.20690667012046,133,3.0000000000000014E-4
5,test_20231101_135843,11610969.png,368720,18977,349743,0.9485327619874159,2,4,84111,2788,81323,0.9668533247732164,23.867306666666668,3517.9054613333333,12.667961966313278,133,3.0000000000000014E-4
6,test_20231101_135843,10350842.png,212614,3932,208682,0.98150639186507,2,7,42529,578,41951,0.9864092736720825,21.983740444444443,3072.926976,13.255281209164664,133,3.0000000000000014E-4
7,test_20231101_135843,10863862.png,317432,6617,310815,0.9791545905894806,2,4,66058,973,65085,0.9852705198461957,35.89944888888889,6569.9042346666665,9.955213216976183,133,3.0000000000000014E-4
8,test_20231101_135843,11382381.png,312486,547,311939,0.9982495215785667,2,4,46745,72,46673,0.9984597283131885,22.81680888888889,2740.878352,13.751906001286724,133,3.0000000000000014E-4
9,test_20231101_135843,11079715.png,443815,98874,344941,0.7772179849712155,3,4,124136,13895,110241,0.8880663143648901,18.42161422222222,2518.297664,14.119732982444997,133,3.0000000000000014E-4
10,test_20231101_135843,11551286.png,271883,164,271719,0.9993967993585476,1,3,40092,22,40070,0.9994512620971765,18.120286222222223,1899.5769013333334,15.344234809036362,133,3.0000000000000014E-4
1,test_20231101_135844,10404007.png,502730,13872,488858,0.9724066596383745,2,4,61265,2019,59246,0.9670448053537909,26.43332977777778,3634.1775893333333,12.526742149506438,133,3.1000000000000016E-4
2,test_20231101_135844,1254659.png,342646,59442,283204,0.8265206656432587,3,4,80080,8377,71703,0.8953921078921079,22.63763911111111,3744.3753706666666,12.397009809413873,133,3.1000000000000016E-4
3,test_20231101_135844,10188041.png,221231,7682,213549,0.9652761141069741,2,3,41731,1091,40640,0.9738563657712492,12.255687111111111,1439.799552,16.54778326772516,133,3.1000000000000016E-4
4,test_20231101_135844,10287332.png,216980,10252,206728,0.9527514056595078,2,4,22337,1412,20925,0.9367864977391771,10.08100088888889,982.629264,18.20690667012046,133,3.1000000000000016E-4
5,test_20231101_135844,11610969.png,368720,18977,349743,0.9485327619874159,3,4,84111,2788,81323,0.9668533247732164,23.867306666666668,3517.9054613333333,12.667961966313278,133,3.1000000000000016E-4
6,test_20231101_135844,10350842.png,212614,3932,208682,0.98150639186507,2,3,42529,578,41951,0.9864092736720825,21.983740444444443,3072.926976,13.255281209164664,133,3.1000000000000016E-4
7,test_20231101_135844,10863862.png,317432,6617,310815,0.9791545905894806,2,4,66058,973,65085,0.9852705198461957,35.89944888888889,6569.9042346666665,9.955213216976183,133,3.1000000000000016E-4
8,test_20231101_135844,11382381.png,312486,547,311939,0.9982495215785667,1,3,46745,72,46673,0.9984597283131885,22.81680888888889,2740.878352,13.751906001286724,133,3.1000000000000016E-4
9,test_20231101_135844,11079715.png,443815,98874,344941,0.7772179849712155,3,4,124136,13895,110241,0.8880663143648901,18.42161422222222,2518.297664,14.119732982444997,133,3.1000000000000016E-4
10,test_20231101_135844,11551286.png,271883,164,271719,0.9993967993585476,1,4,40092,22,40070,0.9994512620971765,18.120286222222223,1899.5769013333334,15.344234809036362,133,3.1000000000000016E-4
1,test_20231101_135845,10404007.png,502730,13872,488858,0.9724066596383745,2,4,61265,2019,59246,0.9670448053537909,26.43332977777778,3634.1775893333333,12.526742149506438,133,3.200000000000002E-4
2,test_20231101_135845,1254659.png,342646,59442,283204,0.8265206656432587,3,4,80080,8377,71703,0.8953921078921079,22.63763911111111,3744.3753706666666,12.397009809413873,133,3.200000000000002E-4
3,test_20231101_135845,10188041.png,221231,7682,213549,0.9652761141069741,2,4,41731,1091,40640,0.9738563657712492,12.255687111111111,1439.799552,16.54778326772516,133,3.200000000000002E-4
4,test_20231101_135845,10287332.png,216980,10252,206728,0.9527514056595078,2,3,22337,1412,20925,0.9367864977391771,10.08100088888889,982.629264,18.20690667012046,133,3.200000000000002E-4
5,test_20231101_135845,11610969.png,368720,18977,349743,0.9485327619874159,3,4,84111,2788,81323,0.9668533247732164,23.867306666666668,3517.9054613333333,12.667961966313278,133,3.200000000000002E-4
6,test_20231101_135845,10350842.png,212614,3932,208682,0.98150639186507,1,4,42529,578,41951,0.9864092736720825,21.983740444444443,3072.926976,13.255281209164664,133,3.200000000000002E-4
7,test_20231101_135845,10863862.png,317432,6617,310815,0.9791545905894806,2,4,66058,973,65085,0.9852705198461957,35.89944888888889,6569.9042346666665,9.955213216976183,133,3.200000000000002E-4
8,test_20231101_135845,11382381.png,312486,547,311939,0.9982495215785667,1,6,46745,72,46673,0.9984597283131885,22.81680888888889,2740.878352,13.751906001286724,133,3.200000000000002E-4
9,test_20231101_135845,11079715.png,443815,98874,344941,0.7772179849712155,3,4,124136,13895,110241,0.8880663143648901,18.42161422222222,2518.297664,14.119732982444997,133,3.200000000000002E-4
10,test_20231101_135845,11551286.png,271883,164,271719,0.9993967993585476,1,3,40092,22,40070,0.9994512620971765,18.120286222222223,1899.5769013333334,15.344234809036362,133,3.200000000000002E-4
1,test_20231101_135845,10404007.png,502730,13872,488858,0.9724066596383745,2,3,61265,2019,59246,0.9670448053537909,26.43332977777778,3634.1775893333333,12.526742149506438,133,3.300000000000002E-4
2,test_20231101_135845,1254659.png,342646,59442,283204,0.8265206656432587,3,4,80080,8377,71703,0.8953921078921079,22.63763911111111,3744.3753706666666,12.397009809413873,133,3.300000000000002E-4
3,test_20231101_135845,10188041.png,221231,7682,213549,0.9652761141069741,2,4,41731,1091,40640,0.9738563657712492,12.255687111111111,1439.799552,16.54778326772516,133,3.300000000000002E-4
4,test_20231101_135845,10287332.png,216980,10252,206728,0.9527514056595078,2,3,22337,1412,20925,0.9367864977391771,10.08100088888889,982.629264,18.20690667012046,133,3.300000000000002E-4
5,test_20231101_135845,11610969.png,368720,18977,349743,0.9485327619874159,2,4,84111,2788,81323,0.9668533247732164,23.867306666666668,3517.9054613333333,12.667961966313278,133,3.300000000000002E-4
6,test_20231101_135845,10350842.png,212614,3932,208682,0.98150639186507,1,3,42529,578,41951,0.9864092736720825,21.983740444444443,3072.926976,13.255281209164664,133,3.300000000000002E-4
7,test_20231101_135845,10863862.png,317432,6617,310815,0.9791545905894806,2,3,66058,973,65085,0.9852705198461957,35.89944888888889,6569.9042346666665,9.955213216976183,133,3.300000000000002E-4
8,test_20231101_135845,11382381.png,312486,547,311939,0.9982495215785667,2,3,46745,72,46673,0.9984597283131885,22.81680888888889,2740.878352,13.751906001286724,133,3.300000000000002E-4
9,test_20231101_135845,11079715.png,443815,98874,344941,0.7772179849712155,4,4,124136,13895,110241,0.8880663143648901,18.42161422222222,2518.297664,14.119732982444997,133,3.300000000000002E-4
10,test_20231101_135845,11551286.png,271883,164,271719,0.9993967993585476,1,4,40092,22,40070,0.9994512620971765,18.120286222222223,1899.5769013333334,15.344234809036362,133,3.300000000000002E-4
1,test_20231101_135846,10404007.png,502730,13872,488858,0.9724066596383745,2,4,61265,2019,59246,0.9670448053537909,26.43332977777778,3634.1775893333333,12.526742149506438,133,3.4000000000000024E-4
2,test_20231101_135846,1254659.png,342646,59442,283204,0.8265206656432587,3,4,80080,8377,71703,0.8953921078921079,22.63763911111111,3744.3753706666666,12.397009809413873,133,3.4000000000000024E-4
3,test_20231101_135846,10188041.png,221231,7682,213549,0.9652761141069741,2,4,41731,1091,40640,0.9738563657712492,12.255687111111111,1439.799552,16.54778326772516,133,3.4000000000000024E-4
4,test_20231101_135846,10287332.png,216980,10252,206728,0.9527514056595078,1,4,22337,1412,20925,0.9367864977391771,10.08100088888889,982.629264,18.20690667012046,133,3.4000000000000024E-4
5,test_20231101_135846,11610969.png,368720,18977,349743,0.9485327619874159,2,4,84111,2788,81323,0.9668533247732164,23.867306666666668,3517.9054613333333,12.667961966313278,133,3.4000000000000024E-4
6,test_20231101_135846,10350842.png,212614,3932,208682,0.98150639186507,1,3,42529,578,41951,0.9864092736720825,21.983740444444443,3072.926976,13.255281209164664,133,3.4000000000000024E-4
7,test_20231101_135846,10863862.png,317432,6617,310815,0.9791545905894806,2,4,66058,973,65085,0.9852705198461957,35.89944888888889,6569.9042346666665,9.955213216976183,133,3.4000000000000024E-4
8,test_20231101_135846,11382381.png,312486,547,311939,0.9982495215785667,2,3,46745,72,46673,0.9984597283131885,22.81680888888889,2740.878352,13.751906001286724,133,3.4000000000000024E-4
9,test_20231101_135846,11079715.png,443815,98874,344941,0.7772179849712155,3,5,124136,13895,110241,0.8880663143648901,18.42161422222222,2518.297664,14.119732982444997,133,3.4000000000000024E-4
10,test_20231101_135846,11551286.png,271883,164,271719,0.9993967993585476,1,4,40092,22,40070,0.9994512620971765,18.120286222222223,1899.5769013333334,15.344234809036362,133,3.4000000000000024E-4
1,test_20231101_135847,10404007.png,502730,13872,488858,0.9724066596383745,3,3,61265,2019,59246,0.9670448053537909,26.43332977777778,3634.1775893333333,12.526742149506438,133,3.5000000000000027E-4
2,test_20231101_135847,1254659.png,342646,59442,283204,0.8265206656432587,3,4,80080,8377,71703,0.8953921078921079,22.63763911111111,3744.3753706666666,12.397009809413873,133,3.5000000000000027E-4
3,test_20231101_135847,10188041.png,221231,7682,213549,0.9652761141069741,1,3,41731,1091,40640,0.9738563657712492,12.255687111111111,1439.799552,16.54778326772516,133,3.5000000000000027E-4
4,test_20231101_135847,10287332.png,216980,10252,206728,0.9527514056595078,2,4,22337,1412,20925,0.9367864977391771,10.08100088888889,982.629264,18.20690667012046,133,3.5000000000000027E-4
5,test_20231101_135847,11610969.png,368720,18977,349743,0.9485327619874159,2,4,84111,2788,81323,0.9668533247732164,23.867306666666668,3517.9054613333333,12.667961966313278,133,3.5000000000000027E-4
6,test_20231101_135847,10350842.png,212614,3932,208682,0.98150639186507,2,3,42529,578,41951,0.9864092736720825,21.983740444444443,3072.926976,13.255281209164664,133,3.5000000000000027E-4
7,test_20231101_135847,10863862.png,317432,6617,310815,0.9791545905894806,1,4,66058,973,65085,0.9852705198461957,35.89944888888889,6569.9042346666665,9.955213216976183,133,3.5000000000000027E-4
8,test_20231101_135847,11382381.png,312486,547,311939,0.9982495215785667,1,4,46745,72,46673,0.9984597283131885,22.81680888888889,2740.878352,13.751906001286724,133,3.5000000000000027E-4
9,test_20231101_135847,11079715.png,443815,98874,344941,0.7772179849712155,3,4,124136,13895,110241,0.8880663143648901,18.42161422222222,2518.297664,14.119732982444997,133,3.5000000000000027E-4
10,test_20231101_135847,11551286.png,271883,164,271719,0.9993967993585476,1,3,40092,22,40070,0.9994512620971765,18.120286222222223,1899.5769013333334,15.344234809036362,133,3.5000000000000027E-4
1,test_20231101_135847,10404007.png,502730,13872,488858,0.9724066596383745,2,4,61265,2019,59246,0.9670448053537909,26.43332977777778,3634.1775893333333,12.526742149506438,133,3.600000000000003E-4
2,test_20231101_135847,1254659.png,342646,59442,283204,0.8265206656432587,3,4,80080,8377,71703,0.8953921078921079,22.63763911111111,3744.3753706666666,12.397009809413873,133,3.600000000000003E-4
3,test_20231101_135847,10188041.png,221231,7682,213549,0.9652761141069741,1,3,41731,1091,40640,0.9738563657712492,12.255687111111111,1439.799552,16.54778326772516,133,3.600000000000003E-4
4,test_20231101_135847,10287332.png,216980,10252,206728,0.9527514056595078,2,4,22337,1412,20925,0.9367864977391771,10.08100088888889,982.629264,18.20690667012046,133,3.600000000000003E-4
5,test_20231101_135847,11610969.png,368720,18977,349743,0.9485327619874159,3,4,84111,2788,81323,0.9668533247732164,23.867306666666668,3517.9054613333333,12.667961966313278,133,3.600000000000003E-4
6,test_20231101_135847,10350842.png,212614,3932,208682,0.98150639186507,2,3,42529,578,41951,0.9864092736720825,21.983740444444443,3072.926976,13.255281209164664,133,3.600000000000003E-4
7,test_20231101_135847,10863862.png,317432,6617,310815,0.9791545905894806,2,4,66058,973,65085,0.9852705198461957,35.89944888888889,6569.9042346666665,9.955213216976183,133,3.600000000000003E-4
8,test_20231101_135847,11382381.png,312486,547,311939,0.9982495215785667,1,3,46745,72,46673,0.9984597283131885,22.81680888888889,2740.878352,13.751906001286724,133,3.600000000000003E-4
9,test_20231101_135847,11079715.png,443815,98874,344941,0.7772179849712155,4,5,124136,13895,110241,0.8880663143648901,18.42161422222222,2518.297664,14.119732982444997,133,3.600000000000003E-4
10,test_20231101_135847,11551286.png,271883,164,271719,0.9993967993585476,1,3,40092,22,40070,0.9994512620971765,18.120286222222223,1899.5769013333334,15.344234809036362,133,3.600000000000003E-4
1,test_20231101_135848,10404007.png,502730,13872,488858,0.9724066596383745,2,4,61265,2019,59246,0.9670448053537909,26.43332977777778,3634.1775893333333,12.526742149506438,133,3.700000000000003E-4
2,test_20231101_135848,1254659.png,342646,59442,283204,0.8265206656432587,2,4,80080,8377,71703,0.8953921078921079,22.63763911111111,3744.3753706666666,12.397009809413873,133,3.700000000000003E-4
3,test_20231101_135848,10188041.png,221231,7682,213549,0.9652761141069741,2,3,41731,1091,40640,0.9738563657712492,12.255687111111111,1439.799552,16.54778326772516,133,3.700000000000003E-4
4,test_20231101_135848,10287332.png,216980,10252,206728,0.9527514056595078,1,4,22337,1412,20925,0.9367864977391771,10.08100088888889,982.629264,18.20690667012046,133,3.700000000000003E-4
5,test_20231101_135848,11610969.png,368720,18977,349743,0.9485327619874159,3,3,84111,2788,81323,0.9668533247732164,23.867306666666668,3517.9054613333333,12.667961966313278,133,3.700000000000003E-4
6,test_20231101_135848,10350842.png,212614,3932,208682,0.98150639186507,1,4,42529,578,41951,0.9864092736720825,21.983740444444443,3072.926976,13.255281209164664,133,3.700000000000003E-4
7,test_20231101_135848,10863862.png,317432,6617,310815,0.9791545905894806,2,3,66058,973,65085,0.9852705198461957,35.89944888888889,6569.9042346666665,9.955213216976183,133,3.700000000000003E-4
8,test_20231101_135848,11382381.png,312486,547,311939,0.9982495215785667,1,7,46745,72,46673,0.9984597283131885,22.81680888888889,2740.878352,13.751906001286724,133,3.700000000000003E-4
9,test_20231101_135848,11079715.png,443815,98874,344941,0.7772179849712155,3,4,124136,13895,110241,0.8880663143648901,18.42161422222222,2518.297664,14.119732982444997,133,3.700000000000003E-4
10,test_20231101_135848,11551286.png,271883,164,271719,0.9993967993585476,1,3,40092,22,40070,0.9994512620971765,18.120286222222223,1899.5769013333334,15.344234809036362,133,3.700000000000003E-4
1,test_20231101_135849,10404007.png,502730,13872,488858,0.9724066596383745,2,4,61265,2019,59246,0.9670448053537909,26.43332977777778,3634.1775893333333,12.526742149506438,133,3.8000000000000035E-4
2,test_20231101_135849,1254659.png,342646,59442,283204,0.8265206656432587,3,4,80080,8377,71703,0.8953921078921079,22.63763911111111,3744.3753706666666,12.397009809413873,133,3.8000000000000035E-4
3,test_20231101_135849,10188041.png,221231,7682,213549,0.9652761141069741,2,3,41731,1091,40640,0.9738563657712492,12.255687111111111,1439.799552,16.54778326772516,133,3.8000000000000035E-4
4,test_20231101_135849,10287332.png,216980,10252,206728,0.9527514056595078,1,10,22337,1412,20925,0.9367864977391771,10.08100088888889,982.629264,18.20690667012046,133,3.8000000000000035E-4
5,test_20231101_135849,11610969.png,368720,18977,349743,0.9485327619874159,2,4,84111,2788,81323,0.9668533247732164,23.867306666666668,3517.9054613333333,12.667961966313278,133,3.8000000000000035E-4
6,test_20231101_135849,10350842.png,212614,3932,208682,0.98150639186507,1,3,42529,578,41951,0.9864092736720825,21.983740444444443,3072.926976,13.255281209164664,133,3.8000000000000035E-4
7,test_20231101_135849,10863862.png,317432,6617,310815,0.9791545905894806,2,4,66058,973,65085,0.9852705198461957,35.89944888888889,6569.9042346666665,9.955213216976183,133,3.8000000000000035E-4
8,test_20231101_135849,11382381.png,312486,547,311939,0.9982495215785667,1,4,46745,72,46673,0.9984597283131885,22.81680888888889,2740.878352,13.751906001286724,133,3.8000000000000035E-4
9,test_20231101_135849,11079715.png,443815,98874,344941,0.7772179849712155,4,4,124136,13895,110241,0.8880663143648901,18.42161422222222,2518.297664,14.119732982444997,133,3.8000000000000035E-4
10,test_20231101_135849,11551286.png,271883,164,271719,0.9993967993585476,1,3,40092,22,40070,0.9994512620971765,18.120286222222223,1899.5769013333334,15.344234809036362,133,3.8000000000000035E-4
1,test_20231101_135849,10404007.png,502730,13872,488858,0.9724066596383745,2,4,61265,2019,59246,0.9670448053537909,26.43332977777778,3634.1775893333333,12.526742149506438,133,3.9000000000000037E-4
2,test_20231101_135849,1254659.png,342646,59442,283204,0.8265206656432587,2,3,80080,8377,71703,0.8953921078921079,22.63763911111111,3744.3753706666666,12.397009809413873,133,3.9000000000000037E-4
3,test_20231101_135849,10188041.png,221231,7682,213549,0.9652761141069741,2,3,41731,1091,40640,0.9738563657712492,12.255687111111111,1439.799552,16.54778326772516,133,3.9000000000000037E-4
4,test_20231101_135849,10287332.png,216980,10252,206728,0.9527514056595078,2,3,22337,1412,20925,0.9367864977391771,10.08100088888889,982.629264,18.20690667012046,133,3.9000000000000037E-4
5,test_20231101_135849,11610969.png,368720,18977,349743,0.9485327619874159,2,3,84111,2788,81323,0.9668533247732164,23.867306666666668,3517.9054613333333,12.667961966313278,133,3.9000000000000037E-4
6,test_20231101_135849,10350842.png,212614,3932,208682,0.98150639186507,1,3,42529,578,41951,0.9864092736720825,21.983740444444443,3072.926976,13.255281209164664,133,3.9000000000000037E-4
7,test_20231101_135849,10863862.png,317432,6617,310815,0.9791545905894806,2,3,66058,973,65085,0.9852705198461957,35.89944888888889,6569.9042346666665,9.955213216976183,133,3.9000000000000037E-4
8,test_20231101_135849,11382381.png,312486,547,311939,0.9982495215785667,1,4,46745,72,46673,0.9984597283131885,22.81680888888889,2740.878352,13.751906001286724,133,3.9000000000000037E-4
9,test_20231101_135849,11079715.png,443815,98874,344941,0.7772179849712155,3,4,124136,13895,110241,0.8880663143648901,18.42161422222222,2518.297664,14.119732982444997,133,3.9000000000000037E-4
10,test_20231101_135849,11551286.png,271883,164,271719,0.9993967993585476,1,4,40092,22,40070,0.9994512620971765,18.120286222222223,1899.5769013333334,15.344234809036362,133,3.9000000000000037E-4
1,test_20231101_135850,10404007.png,502730,13872,488858,0.9724066596383745,2,4,61265,2019,59246,0.9670448053537909,26.43332977777778,3634.1775893333333,12.526742149506438,133,4.000000000000004E-4
2,test_20231101_135850,1254659.png,342646,59442,283204,0.8265206656432587,3,4,80080,8377,71703,0.8953921078921079,22.63763911111111,3744.3753706666666,12.397009809413873,133,4.000000000000004E-4
3,test_20231101_135850,10188041.png,221231,7682,213549,0.9652761141069741,2,4,41731,1091,40640,0.9738563657712492,12.255687111111111,1439.799552,16.54778326772516,133,4.000000000000004E-4
4,test_20231101_135850,10287332.png,216980,10252,206728,0.9527514056595078,2,3,22337,1412,20925,0.9367864977391771,10.08100088888889,982.629264,18.20690667012046,133,4.000000000000004E-4
5,test_20231101_135850,11610969.png,368720,18977,349743,0.9485327619874159,3,4,84111,2788,81323,0.9668533247732164,23.867306666666668,3517.9054613333333,12.667961966313278,133,4.000000000000004E-4
6,test_20231101_135850,10350842.png,212614,3932,208682,0.98150639186507,1,3,42529,578,41951,0.9864092736720825,21.983740444444443,3072.926976,13.255281209164664,133,4.000000000000004E-4
7,test_20231101_135850,10863862.png,317432,6617,310815,0.9791545905894806,2,4,66058,973,65085,0.9852705198461957,35.89944888888889,6569.9042346666665,9.955213216976183,133,4.000000000000004E-4
8,test_20231101_135850,11382381.png,312486,547,311939,0.9982495215785667,1,4,46745,72,46673,0.9984597283131885,22.81680888888889,2740.878352,13.751906001286724,133,4.000000000000004E-4
9,test_20231101_135850,11079715.png,443815,98874,344941,0.7772179849712155,3,4,124136,13895,110241,0.8880663143648901,18.42161422222222,2518.297664,14.119732982444997,133,4.000000000000004E-4
10,test_20231101_135850,11551286.png,271883,164,271719,0.9993967993585476,1,3,40092,22,40070,0.9994512620971765,18.120286222222223,1899.5769013333334,15.344234809036362,133,4.000000000000004E-4
1,test_20231101_135851,10404007.png,502730,13872,488858,0.9724066596383745,2,4,61265,2019,59246,0.9670448053537909,26.43332977777778,3634.1775893333333,12.526742149506438,133,4.100000000000004E-4
2,test_20231101_135851,1254659.png,342646,59442,283204,0.8265206656432587,3,4,80080,8377,71703,0.8953921078921079,22.63763911111111,3744.3753706666666,12.397009809413873,133,4.100000000000004E-4
3,test_20231101_135851,10188041.png,221231,7682,213549,0.9652761141069741,2,4,41731,1091,40640,0.9738563657712492,12.255687111111111,1439.799552,16.54778326772516,133,4.100000000000004E-4
4,test_20231101_135851,10287332.png,216980,10252,206728,0.9527514056595078,1,4,22337,1412,20925,0.9367864977391771,10.08100088888889,982.629264,18.20690667012046,133,4.100000000000004E-4
5,test_20231101_135851,11610969.png,368720,18977,349743,0.9485327619874159,2,4,84111,2788,81323,0.9668533247732164,23.867306666666668,3517.9054613333333,12.667961966313278,133,4.100000000000004E-4
6,test_20231101_135851,10350842.png,212614,3932,208682,0.98150639186507,2,3,42529,578,41951,0.9864092736720825,21.983740444444443,3072.926976,13.255281209164664,133,4.100000000000004E-4
7,test_20231101_135851,10863862.png,317432,6617,310815,0.9791545905894806,2,4,66058,973,65085,0.9852705198461957,35.89944888888889,6569.9042346666665,9.955213216976183,133,4.100000000000004E-4
8,test_20231101_135851,11382381.png,312486,547,311939,0.9982495215785667,2,3,46745,72,46673,0.9984597283131885,22.81680888888889,2740.878352,13.751906001286724,133,4.100000000000004E-4
9,test_20231101_135851,11079715.png,443815,98874,344941,0.7772179849712155,3,4,124136,13895,110241,0.8880663143648901,18.42161422222222,2518.297664,14.119732982444997,133,4.100000000000004E-4
10,test_20231101_135851,11551286.png,271883,164,271719,0.9993967993585476,1,4,40092,22,40070,0.9994512620971765,18.120286222222223,1899.5769013333334,15.344234809036362,133,4.100000000000004E-4
1,test_20231101_135852,10404007.png,502730,13872,488858,0.9724066596383745,2,3,61265,2019,59246,0.9670448053537909,26.43332977777778,3634.1775893333333,12.526742149506438,133,4.2000000000000045E-4
2,test_20231101_135852,1254659.png,342646,59442,283204,0.8265206656432587,3,4,80080,8377,71703,0.8953921078921079,22.63763911111111,3744.3753706666666,12.397009809413873,133,4.2000000000000045E-4
3,test_20231101_135852,10188041.png,221231,7682,213549,0.9652761141069741,1,3,41731,1091,40640,0.9738563657712492,12.255687111111111,1439.799552,16.54778326772516,133,4.2000000000000045E-4
4,test_20231101_135852,10287332.png,216980,10252,206728,0.9527514056595078,2,4,22337,1412,20925,0.9367864977391771,10.08100088888889,982.629264,18.20690667012046,133,4.2000000000000045E-4
5,test_20231101_135852,11610969.png,368720,18977,349743,0.9485327619874159,2,4,84111,2788,81323,0.9668533247732164,23.867306666666668,3517.9054613333333,12.667961966313278,133,4.2000000000000045E-4
6,test_20231101_135852,10350842.png,212614,3932,208682,0.98150639186507,2,3,42529,578,41951,0.9864092736720825,21.983740444444443,3072.926976,13.255281209164664,133,4.2000000000000045E-4
7,test_20231101_135852,10863862.png,317432,6617,310815,0.9791545905894806,2,4,66058,973,65085,0.9852705198461957,35.89944888888889,6569.9042346666665,9.955213216976183,133,4.2000000000000045E-4
8,test_20231101_135852,11382381.png,312486,547,311939,0.9982495215785667,1,3,46745,72,46673,0.9984597283131885,22.81680888888889,2740.878352,13.751906001286724,133,4.2000000000000045E-4
9,test_20231101_135852,11079715.png,443815,98874,344941,0.7772179849712155,3,4,124136,13895,110241,0.8880663143648901,18.42161422222222,2518.297664,14.119732982444997,133,4.2000000000000045E-4
10,test_20231101_135852,11551286.png,271883,164,271719,0.9993967993585476,1,4,40092,22,40070,0.9994512620971765,18.120286222222223,1899.5769013333334,15.344234809036362,133,4.2000000000000045E-4
1,test_20231101_135852,10404007.png,502730,13872,488858,0.9724066596383745,2,4,61265,2019,59246,0.9670448053537909,26.43332977777778,3634.1775893333333,12.526742149506438,133,4.300000000000005E-4
2,test_20231101_135852,1254659.png,342646,59442,283204,0.8265206656432587,3,4,80080,8377,71703,0.8953921078921079,22.63763911111111,3744.3753706666666,12.397009809413873,133,4.300000000000005E-4
3,test_20231101_135852,10188041.png,221231,7682,213549,0.9652761141069741,2,3,41731,1091,40640,0.9738563657712492,12.255687111111111,1439.799552,16.54778326772516,133,4.300000000000005E-4
4,test_20231101_135852,10287332.png,216980,10252,206728,0.9527514056595078,2,4,22337,1412,20925,0.9367864977391771,10.08100088888889,982.629264,18.20690667012046,133,4.300000000000005E-4
5,test_20231101_135852,11610969.png,368720,18977,349743,0.9485327619874159,2,3,84111,2788,81323,0.9668533247732164,23.867306666666668,3517.9054613333333,12.667961966313278,133,4.300000000000005E-4
6,test_20231101_135852,10350842.png,212614,3932,208682,0.98150639186507,1,4,42529,578,41951,0.9864092736720825,21.983740444444443,3072.926976,13.255281209164664,133,4.300000000000005E-4
7,test_20231101_135852,10863862.png,317432,6617,310815,0.9791545905894806,1,3,66058,973,65085,0.9852705198461957,35.89944888888889,6569.9042346666665,9.955213216976183,133,4.300000000000005E-4
8,test_20231101_135852,11382381.png,312486,547,311939,0.9982495215785667,1,4,46745,72,46673,0.9984597283131885,22.81680888888889,2740.878352,13.751906001286724,133,4.300000000000005E-4
9,test_20231101_135852,11079715.png,443815,98874,344941,0.7772179849712155,3,4,124136,13895,110241,0.8880663143648901,18.42161422222222,2518.297664,14.119732982444997,133,4.300000000000005E-4
10,test_20231101_135852,11551286.png,271883,164,271719,0.9993967993585476,2,3,40092,22,40070,0.9994512620971765,18.120286222222223,1899.5769013333334,15.344234809036362,133,4.300000000000005E-4
1,test_20231101_135853,10404007.png,502730,13872,488858,0.9724066596383745,3,3,61265,2019,59246,0.9670448053537909,26.43332977777778,3634.1775893333333,12.526742149506438,133,4.400000000000005E-4
2,test_20231101_135853,1254659.png,342646,59442,283204,0.8265206656432587,3,4,80080,8377,71703,0.8953921078921079,22.63763911111111,3744.3753706666666,12.397009809413873,133,4.400000000000005E-4
3,test_20231101_135853,10188041.png,221231,7682,213549,0.9652761141069741,2,3,41731,1091,40640,0.9738563657712492,12.255687111111111,1439.799552,16.54778326772516,133,4.400000000000005E-4
4,test_20231101_135853,10287332.png,216980,10252,206728,0.9527514056595078,1,3,22337,1412,20925,0.9367864977391771,10.08100088888889,982.629264,18.20690667012046,133,4.400000000000005E-4
5,test_20231101_135853,11610969.png,368720,18977,349743,0.9485327619874159,3,3,84111,2788,81323,0.9668533247732164,23.867306666666668,3517.9054613333333,12.667961966313278,133,4.400000000000005E-4
6,test_20231101_135853,10350842.png,212614,3932,208682,0.98150639186507,2,4,42529,578,41951,0.9864092736720825,21.983740444444443,3072.926976,13.255281209164664,133,4.400000000000005E-4
7,test_20231101_135853,10863862.png,317432,6617,310815,0.9791545905894806,2,4,66058,973,65085,0.9852705198461957,35.89944888888889,6569.9042346666665,9.955213216976183,133,4.400000000000005E-4
8,test_20231101_135853,11382381.png,312486,547,311939,0.9982495215785667,1,4,46745,72,46673,0.9984597283131885,22.81680888888889,2740.878352,13.751906001286724,133,4.400000000000005E-4
9,test_20231101_135853,11079715.png,443815,98874,344941,0.7772179849712155,3,4,124136,13895,110241,0.8880663143648901,18.42161422222222,2518.297664,14.119732982444997,133,4.400000000000005E-4
10,test_20231101_135853,11551286.png,271883,164,271719,0.9993967993585476,1,4,40092,22,40070,0.9994512620971765,18.120286222222223,1899.5769013333334,15.344234809036362,133,4.400000000000005E-4
1,test_20231101_135854,10404007.png,502730,13872,488858,0.9724066596383745,3,10,61265,2019,59246,0.9670448053537909,26.43332977777778,3634.1775893333333,12.526742149506438,133,4.5000000000000053E-4
2,test_20231101_135854,1254659.png,342646,59442,283204,0.8265206656432587,2,3,80080,8377,71703,0.8953921078921079,22.63763911111111,3744.3753706666666,12.397009809413873,133,4.5000000000000053E-4
3,test_20231101_135854,10188041.png,221231,7682,213549,0.9652761141069741,1,3,41731,1091,40640,0.9738563657712492,12.255687111111111,1439.799552,16.54778326772516,133,4.5000000000000053E-4
4,test_20231101_135854,10287332.png,216980,10252,206728,0.9527514056595078,2,4,22337,1412,20925,0.9367864977391771,10.08100088888889,982.629264,18.20690667012046,133,4.5000000000000053E-4
5,test_20231101_135854,11610969.png,368720,18977,349743,0.9485327619874159,2,4,84111,2788,81323,0.9668533247732164,23.867306666666668,3517.9054613333333,12.667961966313278,133,4.5000000000000053E-4
6,test_20231101_135854,10350842.png,212614,3932,208682,0.98150639186507,1,4,42529,578,41951,0.9864092736720825,21.983740444444443,3072.926976,13.255281209164664,133,4.5000000000000053E-4
7,test_20231101_135854,10863862.png,317432,6617,310815,0.9791545905894806,1,3,66058,973,65085,0.9852705198461957,35.89944888888889,6569.9042346666665,9.955213216976183,133,4.5000000000000053E-4
8,test_20231101_135854,11382381.png,312486,547,311939,0.9982495215785667,1,4,46745,72,46673,0.9984597283131885,22.81680888888889,2740.878352,13.751906001286724,133,4.5000000000000053E-4
9,test_20231101_135854,11079715.png,443815,98874,344941,0.7772179849712155,3,4,124136,13895,110241,0.8880663143648901,18.42161422222222,2518.297664,14.119732982444997,133,4.5000000000000053E-4
10,test_20231101_135854,11551286.png,271883,164,271719,0.9993967993585476,1,3,40092,22,40070,0.9994512620971765,18.120286222222223,1899.5769013333334,15.344234809036362,133,4.5000000000000053E-4
1,test_20231101_135854,10404007.png,502730,13872,488858,0.9724066596383745,2,3,61265,2019,59246,0.9670448053537909,26.43332977777778,3634.1775893333333,12.526742149506438,133,4.6000000000000056E-4
2,test_20231101_135854,1254659.png,342646,59442,283204,0.8265206656432587,3,3,80080,8377,71703,0.8953921078921079,22.63763911111111,3744.3753706666666,12.397009809413873,133,4.6000000000000056E-4
3,test_20231101_135854,10188041.png,221231,7682,213549,0.9652761141069741,2,3,41731,1091,40640,0.9738563657712492,12.255687111111111,1439.799552,16.54778326772516,133,4.6000000000000056E-4
4,test_20231101_135854,10287332.png,216980,10252,206728,0.9527514056595078,2,3,22337,1412,20925,0.9367864977391771,10.08100088888889,982.629264,18.20690667012046,133,4.6000000000000056E-4
5,test_20231101_135854,11610969.png,368720,18977,349743,0.9485327619874159,3,3,84111,2788,81323,0.9668533247732164,23.867306666666668,3517.9054613333333,12.667961966313278,133,4.6000000000000056E-4
6,test_20231101_135854,10350842.png,212614,3932,208682,0.98150639186507,2,3,42529,578,41951,0.9864092736720825,21.983740444444443,3072.926976,13.255281209164664,133,4.6000000000000056E-4
7,test_20231101_135854,10863862.png,317432,6617,310815,0.9791545905894806,1,4,66058,973,65085,0.9852705198461957,35.89944888888889,6569.9042346666665,9.955213216976183,133,4.6000000000000056E-4
8,test_20231101_135854,11382381.png,312486,547,311939,0.9982495215785667,1,4,46745,72,46673,0.9984597283131885,22.81680888888889,2740.878352,13.751906001286724,133,4.6000000000000056E-4
9,test_20231101_135854,11079715.png,443815,98874,344941,0.7772179849712155,3,4,124136,13895,110241,0.8880663143648901,18.42161422222222,2518.297664,14.119732982444997,133,4.6000000000000056E-4
10,test_20231101_135854,11551286.png,271883,164,271719,0.9993967993585476,1,3,40092,22,40070,0.9994512620971765,18.120286222222223,1899.5769013333334,15.344234809036362,133,4.6000000000000056E-4
1,test_20231101_135855,10404007.png,502730,13872,488858,0.9724066596383745,3,3,61265,2019,59246,0.9670448053537909,26.43332977777778,3634.1775893333333,12.526742149506438,133,4.700000000000006E-4
2,test_20231101_135855,1254659.png,342646,59442,283204,0.8265206656432587,3,4,80080,8377,71703,0.8953921078921079,22.63763911111111,3744.3753706666666,12.397009809413873,133,4.700000000000006E-4
3,test_20231101_135855,10188041.png,221231,7682,213549,0.9652761141069741,2,4,41731,1091,40640,0.9738563657712492,12.255687111111111,1439.799552,16.54778326772516,133,4.700000000000006E-4
4,test_20231101_135855,10287332.png,216980,10252,206728,0.9527514056595078,2,4,22337,1412,20925,0.9367864977391771,10.08100088888889,982.629264,18.20690667012046,133,4.700000000000006E-4
5,test_20231101_135855,11610969.png,368720,18977,349743,0.9485327619874159,3,4,84111,2788,81323,0.9668533247732164,23.867306666666668,3517.9054613333333,12.667961966313278,133,4.700000000000006E-4
6,test_20231101_135855,10350842.png,212614,3932,208682,0.98150639186507,2,4,42529,578,41951,0.9864092736720825,21.983740444444443,3072.926976,13.255281209164664,133,4.700000000000006E-4
7,test_20231101_135855,10863862.png,317432,6617,310815,0.9791545905894806,1,3,66058,973,65085,0.9852705198461957,35.89944888888889,6569.9042346666665,9.955213216976183,133,4.700000000000006E-4
8,test_20231101_135855,11382381.png,312486,547,311939,0.9982495215785667,1,11,46745,72,46673,0.9984597283131885,22.81680888888889,2740.878352,13.751906001286724,133,4.700000000000006E-4
9,test_20231101_135855,11079715.png,443815,98874,344941,0.7772179849712155,3,4,124136,13895,110241,0.8880663143648901,18.42161422222222,2518.297664,14.119732982444997,133,4.700000000000006E-4
10,test_20231101_135855,11551286.png,271883,164,271719,0.9993967993585476,1,4,40092,22,40070,0.9994512620971765,18.120286222222223,1899.5769013333334,15.344234809036362,133,4.700000000000006E-4
1,test_20231101_135856,10404007.png,502730,13872,488858,0.9724066596383745,2,4,61265,2019,59246,0.9670448053537909,26.43332977777778,3634.1775893333333,12.526742149506438,133,4.800000000000006E-4
2,test_20231101_135856,1254659.png,342646,59442,283204,0.8265206656432587,3,4,80080,8377,71703,0.8953921078921079,22.63763911111111,3744.3753706666666,12.397009809413873,133,4.800000000000006E-4
3,test_20231101_135856,10188041.png,221231,7682,213549,0.9652761141069741,1,3,41731,1091,40640,0.9738563657712492,12.255687111111111,1439.799552,16.54778326772516,133,4.800000000000006E-4
4,test_20231101_135856,10287332.png,216980,10252,206728,0.9527514056595078,1,3,22337,1412,20925,0.9367864977391771,10.08100088888889,982.629264,18.20690667012046,133,4.800000000000006E-4
5,test_20231101_135856,11610969.png,368720,18977,349743,0.9485327619874159,3,3,84111,2788,81323,0.9668533247732164,23.867306666666668,3517.9054613333333,12.667961966313278,133,4.800000000000006E-4
6,test_20231101_135856,10350842.png,212614,3932,208682,0.98150639186507,1,3,42529,578,41951,0.9864092736720825,21.983740444444443,3072.926976,13.255281209164664,133,4.800000000000006E-4
7,test_20231101_135856,10863862.png,317432,6617,310815,0.9791545905894806,2,4,66058,973,65085,0.9852705198461957,35.89944888888889,6569.9042346666665,9.955213216976183,133,4.800000000000006E-4
8,test_20231101_135856,11382381.png,312486,547,311939,0.9982495215785667,1,4,46745,72,46673,0.9984597283131885,22.81680888888889,2740.878352,13.751906001286724,133,4.800000000000006E-4
9,test_20231101_135856,11079715.png,443815,98874,344941,0.7772179849712155,3,4,124136,13895,110241,0.8880663143648901,18.42161422222222,2518.297664,14.119732982444997,133,4.800000000000006E-4
10,test_20231101_135856,11551286.png,271883,164,271719,0.9993967993585476,2,4,40092,22,40070,0.9994512620971765,18.120286222222223,1899.5769013333334,15.344234809036362,133,4.800000000000006E-4
1,test_20231101_135856,10404007.png,502730,13872,488858,0.9724066596383745,3,3,61265,2019,59246,0.9670448053537909,26.43332977777778,3634.1775893333333,12.526742149506438,133,4.900000000000006E-4
2,test_20231101_135856,1254659.png,342646,59442,283204,0.8265206656432587,3,4,80080,8377,71703,0.8953921078921079,22.63763911111111,3744.3753706666666,12.397009809413873,133,4.900000000000006E-4
3,test_20231101_135856,10188041.png,221231,7682,213549,0.9652761141069741,2,4,41731,1091,40640,0.9738563657712492,12.255687111111111,1439.799552,16.54778326772516,133,4.900000000000006E-4
4,test_20231101_135856,10287332.png,216980,10252,206728,0.9527514056595078,3,4,22337,1412,20925,0.9367864977391771,10.08100088888889,982.629264,18.20690667012046,133,4.900000000000006E-4
5,test_20231101_135856,11610969.png,368720,18977,349743,0.9485327619874159,2,4,84111,2788,81323,0.9668533247732164,23.867306666666668,3517.9054613333333,12.667961966313278,133,4.900000000000006E-4
6,test_20231101_135856,10350842.png,212614,3932,208682,0.98150639186507,1,4,42529,578,41951,0.9864092736720825,21.983740444444443,3072.926976,13.255281209164664,133,4.900000000000006E-4
7,test_20231101_135856,10863862.png,317432,6617,310815,0.9791545905894806,2,4,66058,973,65085,0.9852705198461957,35.89944888888889,6569.9042346666665,9.955213216976183,133,4.900000000000006E-4
8,test_20231101_135856,11382381.png,312486,547,311939,0.9982495215785667,1,4,46745,72,46673,0.9984597283131885,22.81680888888889,2740.878352,13.751906001286724,133,4.900000000000006E-4
9,test_20231101_135856,11079715.png,443815,98874,344941,0.7772179849712155,4,4,124136,13895,110241,0.8880663143648901,18.42161422222222,2518.297664,14.119732982444997,133,4.900000000000006E-4
10,test_20231101_135856,11551286.png,271883,164,271719,0.9993967993585476,1,3,40092,22,40070,0.9994512620971765,18.120286222222223,1899.5769013333334,15.344234809036362,133,4.900000000000006E-4
1,test_20231101_135857,10404007.png,502730,13872,488858,0.9724066596383745,2,4,61265,2019,59246,0.9670448053537909,26.43332977777778,3634.1775893333333,12.526742149506438,133,5.000000000000007E-4
2,test_20231101_135857,1254659.png,342646,59442,283204,0.8265206656432587,3,4,80080,8377,71703,0.8953921078921079,22.63763911111111,3744.3753706666666,12.397009809413873,133,5.000000000000007E-4
3,test_20231101_135857,10188041.png,221231,7682,213549,0.9652761141069741,2,3,41731,1091,40640,0.9738563657712492,12.255687111111111,1439.799552,16.54778326772516,133,5.000000000000007E-4
4,test_20231101_135857,10287332.png,216980,10252,206728,0.9527514056595078,1,4,22337,1412,20925,0.9367864977391771,10.08100088888889,982.629264,18.20690667012046,133,5.000000000000007E-4
5,test_20231101_135857,11610969.png,368720,18977,349743,0.9485327619874159,2,4,84111,2788,81323,0.9668533247732164,23.867306666666668,3517.9054613333333,12.667961966313278,133,5.000000000000007E-4
6,test_20231101_135857,10350842.png,212614,3932,208682,0.98150639186507,1,3,42529,578,41951,0.9864092736720825,21.983740444444443,3072.926976,13.255281209164664,133,5.000000000000007E-4
7,test_20231101_135857,10863862.png,317432,6617,310815,0.9791545905894806,2,4,66058,973,65085,0.9852705198461957,35.89944888888889,6569.9042346666665,9.955213216976183,133,5.000000000000007E-4
8,test_20231101_135857,11382381.png,312486,547,311939,0.9982495215785667,1,4,46745,72,46673,0.9984597283131885,22.81680888888889,2740.878352,13.751906001286724,133,5.000000000000007E-4
9,test_20231101_135857,11079715.png,443815,98874,344941,0.7772179849712155,3,4,124136,13895,110241,0.8880663143648901,18.42161422222222,2518.297664,14.119732982444997,133,5.000000000000007E-4
10,test_20231101_135857,11551286.png,271883,164,271719,0.9993967993585476,2,4,40092,22,40070,0.9994512620971765,18.120286222222223,1899.5769013333334,15.344234809036362,133,5.000000000000007E-4
1,test_20231101_135858,10404007.png,502730,13812,488918,0.97252600799634,2,4,61265,2010,59255,0.9671917081531054,26.436849777777777,3634.8380053333335,12.525953005442528,133,5.100000000000007E-4
2,test_20231101_135858,1254659.png,342646,59442,283204,0.8265206656432587,3,4,80080,8377,71703,0.8953921078921079,22.63763911111111,3744.3753706666666,12.397009809413873,133,5.100000000000007E-4
3,test_20231101_135858,10188041.png,221231,7582,213649,0.965728130325316,2,3,41731,1076,40655,0.9742158107881431,12.348760888888888,1463.1674453333333,16.477863311041546,133,5.100000000000007E-4
4,test_20231101_135858,10287332.png,216980,10252,206728,0.9527514056595078,2,4,22337,1412,20925,0.9367864977391771,10.08100088888889,982.629264,18.20690667012046,133,5.100000000000007E-4
5,test_20231101_135858,11610969.png,368720,18957,349763,0.9485870036884356,2,12,84111,2787,81324,0.9668652138245889,23.972956444444446,3528.0835413333334,12.65541500646643,133,5.100000000000007E-4
6,test_20231101_135858,10350842.png,212614,3852,208762,0.9818826605961978,2,3,42529,566,41963,0.9866914340802746,22.04392177777778,3083.32912,13.240604763064862,133,5.100000000000007E-4
7,test_20231101_135858,10863862.png,317432,6294,311138,0.9801721313541167,2,4,66058,926,65132,0.9859820158042932,36.634704,6747.885306666667,9.839126685609427,133,5.100000000000007E-4
8,test_20231101_135858,11382381.png,312486,547,311939,0.9982495215785667,2,3,46745,72,46673,0.9984597283131885,22.81680888888889,2740.878352,13.751906001286724,133,5.100000000000007E-4
9,test_20231101_135858,11079715.png,443815,98692,345123,0.7776280657481158,3,4,124136,13868,110268,0.8882838177482761,18.65887822222222,2560.3068,14.047883511952787,133,5.100000000000007E-4
10,test_20231101_135858,11551286.png,271883,164,271719,0.9993967993585476,1,12,40092,22,40070,0.9994512620971765,18.120286222222223,1899.5769013333334,15.344234809036362,133,5.100000000000007E-4
1,test_20231101_135858,10404007.png,502730,13812,488918,0.97252600799634,3,4,61265,2010,59255,0.9671917081531054,26.436849777777777,3634.8380053333335,12.525953005442528,133,5.200000000000007E-4
2,test_20231101_135858,1254659.png,342646,59442,283204,0.8265206656432587,3,4,80080,8377,71703,0.8953921078921079,22.63763911111111,3744.3753706666666,12.397009809413873,133,5.200000000000007E-4
3,test_20231101_135858,10188041.png,221231,7582,213649,0.965728130325316,3,3,41731,1076,40655,0.9742158107881431,12.348760888888888,1463.1674453333333,16.477863311041546,133,5.200000000000007E-4
4,test_20231101_135858,10287332.png,216980,10252,206728,0.9527514056595078,1,4,22337,1412,20925,0.9367864977391771,10.08100088888889,982.629264,18.20690667012046,133,5.200000000000007E-4
5,test_20231101_135858,11610969.png,368720,18957,349763,0.9485870036884356,2,3,84111,2787,81324,0.9668652138245889,23.972956444444446,3528.0835413333334,12.65541500646643,133,5.200000000000007E-4
6,test_20231101_135858,10350842.png,212614,3852,208762,0.9818826605961978,2,4,42529,566,41963,0.9866914340802746,22.04392177777778,3083.32912,13.240604763064862,133,5.200000000000007E-4
7,test_20231101_135858,10863862.png,317432,6294,311138,0.9801721313541167,2,4,66058,926,65132,0.9859820158042932,36.634704,6747.885306666667,9.839126685609427,133,5.200000000000007E-4
8,test_20231101_135858,11382381.png,312486,547,311939,0.9982495215785667,1,3,46745,72,46673,0.9984597283131885,22.81680888888889,2740.878352,13.751906001286724,133,5.200000000000007E-4
9,test_20231101_135858,11079715.png,443815,98692,345123,0.7776280657481158,3,4,124136,13868,110268,0.8882838177482761,18.65887822222222,2560.3068,14.047883511952787,133,5.200000000000007E-4
10,test_20231101_135858,11551286.png,271883,164,271719,0.9993967993585476,1,13,40092,22,40070,0.9994512620971765,18.120286222222223,1899.5769013333334,15.344234809036362,133,5.200000000000007E-4
1,test_20231101_135859,10404007.png,502730,13812,488918,0.97252600799634,2,3,61265,2010,59255,0.9671917081531054,26.436849777777777,3634.8380053333335,12.525953005442528,133,5.300000000000007E-4
2,test_20231101_135859,1254659.png,342646,59442,283204,0.8265206656432587,3,4,80080,8377,71703,0.8953921078921079,22.63763911111111,3744.3753706666666,12.397009809413873,133,5.300000000000007E-4
3,test_20231101_135859,10188041.png,221231,7582,213649,0.965728130325316,2,4,41731,1076,40655,0.9742158107881431,12.348760888888888,1463.1674453333333,16.477863311041546,133,5.300000000000007E-4
4,test_20231101_135859,10287332.png,216980,10252,206728,0.9527514056595078,1,3,22337,1412,20925,0.9367864977391771,10.08100088888889,982.629264,18.20690667012046,133,5.300000000000007E-4
5,test_20231101_135859,11610969.png,368720,18957,349763,0.9485870036884356,2,4,84111,2787,81324,0.9668652138245889,23.972956444444446,3528.0835413333334,12.65541500646643,133,5.300000000000007E-4
6,test_20231101_135859,10350842.png,212614,3852,208762,0.9818826605961978,3,7,42529,566,41963,0.9866914340802746,22.04392177777778,3083.32912,13.240604763064862,133,5.300000000000007E-4
7,test_20231101_135859,10863862.png,317432,6294,311138,0.9801721313541167,2,4,66058,926,65132,0.9859820158042932,36.634704,6747.885306666667,9.839126685609427,133,5.300000000000007E-4
8,test_20231101_135859,11382381.png,312486,547,311939,0.9982495215785667,2,3,46745,72,46673,0.9984597283131885,22.81680888888889,2740.878352,13.751906001286724,133,5.300000000000007E-4
9,test_20231101_135859,11079715.png,443815,98692,345123,0.7776280657481158,4,4,124136,13868,110268,0.8882838177482761,18.65887822222222,2560.3068,14.047883511952787,133,5.300000000000007E-4
10,test_20231101_135859,11551286.png,271883,164,271719,0.9993967993585476,1,4,40092,22,40070,0.9994512620971765,18.120286222222223,1899.5769013333334,15.344234809036362,133,5.300000000000007E-4
1,test_20231101_135900,10404007.png,502730,13812,488918,0.97252600799634,3,4,61265,2010,59255,0.9671917081531054,26.436849777777777,3634.8380053333335,12.525953005442528,133,5.400000000000008E-4
2,test_20231101_135900,1254659.png,342646,59442,283204,0.8265206656432587,2,4,80080,8377,71703,0.8953921078921079,22.63763911111111,3744.3753706666666,12.397009809413873,133,5.400000000000008E-4
3,test_20231101_135900,10188041.png,221231,7582,213649,0.965728130325316,2,5,41731,1076,40655,0.9742158107881431,12.348760888888888,1463.1674453333333,16.477863311041546,133,5.400000000000008E-4
4,test_20231101_135900,10287332.png,216980,10252,206728,0.9527514056595078,1,3,22337,1412,20925,0.9367864977391771,10.08100088888889,982.629264,18.20690667012046,133,5.400000000000008E-4
5,test_20231101_135900,11610969.png,368720,18957,349763,0.9485870036884356,2,3,84111,2787,81324,0.9668652138245889,23.972956444444446,3528.0835413333334,12.65541500646643,133,5.400000000000008E-4
6,test_20231101_135900,10350842.png,212614,3852,208762,0.9818826605961978,1,4,42529,566,41963,0.9866914340802746,22.04392177777778,3083.32912,13.240604763064862,133,5.400000000000008E-4
7,test_20231101_135900,10863862.png,317432,6294,311138,0.9801721313541167,2,4,66058,926,65132,0.9859820158042932,36.634704,6747.885306666667,9.839126685609427,133,5.400000000000008E-4
8,test_20231101_135900,11382381.png,312486,547,311939,0.9982495215785667,1,4,46745,72,46673,0.9984597283131885,22.81680888888889,2740.878352,13.751906001286724,133,5.400000000000008E-4
9,test_20231101_135900,11079715.png,443815,98692,345123,0.7776280657481158,3,4,124136,13868,110268,0.8882838177482761,18.65887822222222,2560.3068,14.047883511952787,133,5.400000000000008E-4
10,test_20231101_135900,11551286.png,271883,164,271719,0.9993967993585476,1,4,40092,22,40070,0.9994512620971765,18.120286222222223,1899.5769013333334,15.344234809036362,133,5.400000000000008E-4
1,test_20231101_135900,10404007.png,502730,13812,488918,0.97252600799634,2,3,61265,2010,59255,0.9671917081531054,26.436849777777777,3634.8380053333335,12.525953005442528,133,5.500000000000008E-4
2,test_20231101_135900,1254659.png,342646,59442,283204,0.8265206656432587,2,4,80080,8377,71703,0.8953921078921079,22.63763911111111,3744.3753706666666,12.397009809413873,133,5.500000000000008E-4
3,test_20231101_135900,10188041.png,221231,7582,213649,0.965728130325316,2,4,41731,1076,40655,0.9742158107881431,12.348760888888888,1463.1674453333333,16.477863311041546,133,5.500000000000008E-4
4,test_20231101_135900,10287332.png,216980,10252,206728,0.9527514056595078,2,3,22337,1412,20925,0.9367864977391771,10.08100088888889,982.629264,18.20690667012046,133,5.500000000000008E-4
5,test_20231101_135900,11610969.png,368720,18957,349763,0.9485870036884356,2,4,84111,2787,81324,0.9668652138245889,23.972956444444446,3528.0835413333334,12.65541500646643,133,5.500000000000008E-4
6,test_20231101_135900,10350842.png,212614,3852,208762,0.9818826605961978,2,3,42529,566,41963,0.9866914340802746,22.04392177777778,3083.32912,13.240604763064862,133,5.500000000000008E-4
7,test_20231101_135900,10863862.png,317432,6294,311138,0.9801721313541167,3,4,66058,926,65132,0.9859820158042932,36.634704,6747.885306666667,9.839126685609427,133,5.500000000000008E-4
8,test_20231101_135900,11382381.png,312486,547,311939,0.9982495215785667,2,3,46745,72,46673,0.9984597283131885,22.81680888888889,2740.878352,13.751906001286724,133,5.500000000000008E-4
9,test_20231101_135900,11079715.png,443815,98692,345123,0.7776280657481158,3,4,124136,13868,110268,0.8882838177482761,18.65887822222222,2560.3068,14.047883511952787,133,5.500000000000008E-4
10,test_20231101_135900,11551286.png,271883,164,271719,0.9993967993585476,2,3,40092,22,40070,0.9994512620971765,18.120286222222223,1899.5769013333334,15.344234809036362,133,5.500000000000008E-4
1,test_20231101_135901,10404007.png,502730,13812,488918,0.97252600799634,2,3,61265,2010,59255,0.9671917081531054,26.436849777777777,3634.8380053333335,12.525953005442528,133,5.600000000000008E-4
2,test_20231101_135901,1254659.png,342646,59442,283204,0.8265206656432587,3,4,80080,8377,71703,0.8953921078921079,22.63763911111111,3744.3753706666666,12.397009809413873,133,5.600000000000008E-4
3,test_20231101_135901,10188041.png,221231,7582,213649,0.965728130325316,2,4,41731,1076,40655,0.9742158107881431,12.348760888888888,1463.1674453333333,16.477863311041546,133,5.600000000000008E-4
4,test_20231101_135901,10287332.png,216980,10252,206728,0.9527514056595078,2,4,22337,1412,20925,0.9367864977391771,10.08100088888889,982.629264,18.20690667012046,133,5.600000000000008E-4
5,test_20231101_135901,11610969.png,368720,18957,349763,0.9485870036884356,2,4,84111,2787,81324,0.9668652138245889,23.972956444444446,3528.0835413333334,12.65541500646643,133,5.600000000000008E-4
6,test_20231101_135901,10350842.png,212614,3852,208762,0.9818826605961978,1,3,42529,566,41963,0.9866914340802746,22.04392177777778,3083.32912,13.240604763064862,133,5.600000000000008E-4
7,test_20231101_135901,10863862.png,317432,6294,311138,0.9801721313541167,2,3,66058,926,65132,0.9859820158042932,36.634704,6747.885306666667,9.839126685609427,133,5.600000000000008E-4
8,test_20231101_135901,11382381.png,312486,547,311939,0.9982495215785667,1,4,46745,72,46673,0.9984597283131885,22.81680888888889,2740.878352,13.751906001286724,133,5.600000000000008E-4
9,test_20231101_135901,11079715.png,443815,98692,345123,0.7776280657481158,3,4,124136,13868,110268,0.8882838177482761,18.65887822222222,2560.3068,14.047883511952787,133,5.600000000000008E-4
10,test_20231101_135901,11551286.png,271883,164,271719,0.9993967993585476,1,4,40092,22,40070,0.9994512620971765,18.120286222222223,1899.5769013333334,15.344234809036362,133,5.600000000000008E-4
1,test_20231101_135902,10404007.png,502730,13812,488918,0.97252600799634,2,4,61265,2010,59255,0.9671917081531054,26.436849777777777,3634.8380053333335,12.525953005442528,133,5.700000000000008E-4
2,test_20231101_135902,1254659.png,342646,59442,283204,0.8265206656432587,3,4,80080,8377,71703,0.8953921078921079,22.63763911111111,3744.3753706666666,12.397009809413873,133,5.700000000000008E-4
3,test_20231101_135902,10188041.png,221231,7582,213649,0.965728130325316,2,4,41731,1076,40655,0.9742158107881431,12.348760888888888,1463.1674453333333,16.477863311041546,133,5.700000000000008E-4
4,test_20231101_135902,10287332.png,216980,10252,206728,0.9527514056595078,1,3,22337,1412,20925,0.9367864977391771,10.08100088888889,982.629264,18.20690667012046,133,5.700000000000008E-4
5,test_20231101_135902,11610969.png,368720,18957,349763,0.9485870036884356,3,3,84111,2787,81324,0.9668652138245889,23.972956444444446,3528.0835413333334,12.65541500646643,133,5.700000000000008E-4
6,test_20231101_135902,10350842.png,212614,3852,208762,0.9818826605961978,1,4,42529,566,41963,0.9866914340802746,22.04392177777778,3083.32912,13.240604763064862,133,5.700000000000008E-4
7,test_20231101_135902,10863862.png,317432,6294,311138,0.9801721313541167,2,3,66058,926,65132,0.9859820158042932,36.634704,6747.885306666667,9.839126685609427,133,5.700000000000008E-4
8,test_20231101_135902,11382381.png,312486,547,311939,0.9982495215785667,1,4,46745,72,46673,0.9984597283131885,22.81680888888889,2740.878352,13.751906001286724,133,5.700000000000008E-4
9,test_20231101_135902,11079715.png,443815,98692,345123,0.7776280657481158,3,4,124136,13868,110268,0.8882838177482761,18.65887822222222,2560.3068,14.047883511952787,133,5.700000000000008E-4
10,test_20231101_135902,11551286.png,271883,164,271719,0.9993967993585476,1,3,40092,22,40070,0.9994512620971765,18.120286222222223,1899.5769013333334,15.344234809036362,133,5.700000000000008E-4
1,test_20231101_135902,10404007.png,502730,13812,488918,0.97252600799634,2,4,61265,2010,59255,0.9671917081531054,26.436849777777777,3634.8380053333335,12.525953005442528,133,5.800000000000009E-4
2,test_20231101_135902,1254659.png,342646,59442,283204,0.8265206656432587,3,4,80080,8377,71703,0.8953921078921079,22.63763911111111,3744.3753706666666,12.397009809413873,133,5.800000000000009E-4
3,test_20231101_135902,10188041.png,221231,7582,213649,0.965728130325316,2,4,41731,1076,40655,0.9742158107881431,12.348760888888888,1463.1674453333333,16.477863311041546,133,5.800000000000009E-4
4,test_20231101_135902,10287332.png,216980,10252,206728,0.9527514056595078,2,4,22337,1412,20925,0.9367864977391771,10.08100088888889,982.629264,18.20690667012046,133,5.800000000000009E-4
5,test_20231101_135902,11610969.png,368720,18957,349763,0.9485870036884356,2,4,84111,2787,81324,0.9668652138245889,23.972956444444446,3528.0835413333334,12.65541500646643,133,5.800000000000009E-4
6,test_20231101_135902,10350842.png,212614,3087,209527,0.9854807303376071,1,3,42529,453,42076,0.9893484445907499,24.783941333333335,3746.0126026666667,12.395111267343555,133,5.800000000000009E-4
7,test_20231101_135902,10863862.png,317432,6294,311138,0.9801721313541167,2,4,66058,926,65132,0.9859820158042932,36.634704,6747.885306666667,9.839126685609427,133,5.800000000000009E-4
8,test_20231101_135902,11382381.png,312486,547,311939,0.9982495215785667,1,4,46745,72,46673,0.9984597283131885,22.81680888888889,2740.878352,13.751906001286724,133,5.800000000000009E-4
9,test_20231101_135902,11079715.png,443815,98692,345123,0.7776280657481158,3,4,124136,13868,110268,0.8882838177482761,18.65887822222222,2560.3068,14.047883511952787,133,5.800000000000009E-4
10,test_20231101_135902,11551286.png,271883,164,271719,0.9993967993585476,2,4,40092,22,40070,0.9994512620971765,18.120286222222223,1899.5769013333334,15.344234809036362,133,5.800000000000009E-4
1,test_20231101_135903,10404007.png,502730,13812,488918,0.97252600799634,2,4,61265,2010,59255,0.9671917081531054,26.436849777777777,3634.8380053333335,12.525953005442528,133,5.900000000000009E-4
2,test_20231101_135903,1254659.png,342646,59442,283204,0.8265206656432587,3,4,80080,8377,71703,0.8953921078921079,22.63763911111111,3744.3753706666666,12.397009809413873,133,5.900000000000009E-4
3,test_20231101_135903,10188041.png,221231,7582,213649,0.965728130325316,2,4,41731,1076,40655,0.9742158107881431,12.348760888888888,1463.1674453333333,16.477863311041546,133,5.900000000000009E-4
4,test_20231101_135903,10287332.png,216980,10252,206728,0.9527514056595078,2,4,22337,1412,20925,0.9367864977391771,10.08100088888889,982.629264,18.20690667012046,133,5.900000000000009E-4
5,test_20231101_135903,11610969.png,368720,18957,349763,0.9485870036884356,2,3,84111,2787,81324,0.9668652138245889,23.972956444444446,3528.0835413333334,12.65541500646643,133,5.900000000000009E-4
6,test_20231101_135903,10350842.png,212614,3087,209527,0.9854807303376071,2,4,42529,453,42076,0.9893484445907499,24.783941333333335,3746.0126026666667,12.395111267343555,133,5.900000000000009E-4
7,test_20231101_135903,10863862.png,317432,6294,311138,0.9801721313541167,2,4,66058,926,65132,0.9859820158042932,36.634704,6747.885306666667,9.839126685609427,133,5.900000000000009E-4
8,test_20231101_135903,11382381.png,312486,547,311939,0.9982495215785667,1,3,46745,72,46673,0.9984597283131885,22.81680888888889,2740.878352,13.751906001286724,133,5.900000000000009E-4
9,test_20231101_135903,11079715.png,443815,98692,345123,0.7776280657481158,3,4,124136,13868,110268,0.8882838177482761,18.65887822222222,2560.3068,14.047883511952787,133,5.900000000000009E-4
10,test_20231101_135903,11551286.png,271883,164,271719,0.9993967993585476,1,4,40092,22,40070,0.9994512620971765,18.120286222222223,1899.5769013333334,15.344234809036362,133,5.900000000000009E-4
1,test_20231101_135904,10404007.png,502730,13812,488918,0.97252600799634,3,3,61265,2010,59255,0.9671917081531054,26.436849777777777,3634.8380053333335,12.525953005442528,133,6.000000000000009E-4
2,test_20231101_135904,1254659.png,342646,59442,283204,0.8265206656432587,2,3,80080,8377,71703,0.8953921078921079,22.63763911111111,3744.3753706666666,12.397009809413873,133,6.000000000000009E-4
3,test_20231101_135904,10188041.png,221231,7582,213649,0.965728130325316,2,4,41731,1076,40655,0.9742158107881431,12.348760888888888,1463.1674453333333,16.477863311041546,133,6.000000000000009E-4
4,test_20231101_135904,10287332.png,216980,10252,206728,0.9527514056595078,1,4,22337,1412,20925,0.9367864977391771,10.08100088888889,982.629264,18.20690667012046,133,6.000000000000009E-4
5,test_20231101_135904,11610969.png,368720,18957,349763,0.9485870036884356,2,4,84111,2787,81324,0.9668652138245889,23.972956444444446,3528.0835413333334,12.65541500646643,133,6.000000000000009E-4
6,test_20231101_135904,10350842.png,212614,3087,209527,0.9854807303376071,2,3,42529,453,42076,0.9893484445907499,24.783941333333335,3746.0126026666667,12.395111267343555,133,6.000000000000009E-4
7,test_20231101_135904,10863862.png,317432,6294,311138,0.9801721313541167,2,3,66058,926,65132,0.9859820158042932,36.634704,6747.885306666667,9.839126685609427,133,6.000000000000009E-4
8,test_20231101_135904,11382381.png,312486,547,311939,0.9982495215785667,2,3,46745,72,46673,0.9984597283131885,22.81680888888889,2740.878352,13.751906001286724,133,6.000000000000009E-4
9,test_20231101_135904,11079715.png,443815,98692,345123,0.7776280657481158,3,4,124136,13868,110268,0.8882838177482761,18.65887822222222,2560.3068,14.047883511952787,133,6.000000000000009E-4
10,test_20231101_135904,11551286.png,271883,164,271719,0.9993967993585476,1,4,40092,22,40070,0.9994512620971765,18.120286222222223,1899.5769013333334,15.344234809036362,133,6.000000000000009E-4
1,test_20231101_135904,10404007.png,502730,13812,488918,0.97252600799634,2,3,61265,2010,59255,0.9671917081531054,26.436849777777777,3634.8380053333335,12.525953005442528,133,6.10000000000001E-4
2,test_20231101_135904,1254659.png,342646,59442,283204,0.8265206656432587,3,4,80080,8377,71703,0.8953921078921079,22.63763911111111,3744.3753706666666,12.397009809413873,133,6.10000000000001E-4
3,test_20231101_135904,10188041.png,221231,7582,213649,0.965728130325316,2,4,41731,1076,40655,0.9742158107881431,12.348760888888888,1463.1674453333333,16.477863311041546,133,6.10000000000001E-4
4,test_20231101_135904,10287332.png,216980,10252,206728,0.9527514056595078,1,3,22337,1412,20925,0.9367864977391771,10.08100088888889,982.629264,18.20690667012046,133,6.10000000000001E-4
5,test_20231101_135904,11610969.png,368720,18957,349763,0.9485870036884356,3,3,84111,2787,81324,0.9668652138245889,23.972956444444446,3528.0835413333334,12.65541500646643,133,6.10000000000001E-4
6,test_20231101_135904,10350842.png,212614,3087,209527,0.9854807303376071,1,3,42529,453,42076,0.9893484445907499,24.783941333333335,3746.0126026666667,12.395111267343555,133,6.10000000000001E-4
7,test_20231101_135904,10863862.png,317432,6294,311138,0.9801721313541167,2,3,66058,926,65132,0.9859820158042932,36.634704,6747.885306666667,9.839126685609427,133,6.10000000000001E-4
8,test_20231101_135904,11382381.png,312486,547,311939,0.9982495215785667,1,4,46745,72,46673,0.9984597283131885,22.81680888888889,2740.878352,13.751906001286724,133,6.10000000000001E-4
9,test_20231101_135904,11079715.png,443815,98692,345123,0.7776280657481158,3,4,124136,13868,110268,0.8882838177482761,18.65887822222222,2560.3068,14.047883511952787,133,6.10000000000001E-4
10,test_20231101_135904,11551286.png,271883,164,271719,0.9993967993585476,1,4,40092,22,40070,0.9994512620971765,18.120286222222223,1899.5769013333334,15.344234809036362,133,6.10000000000001E-4
1,test_20231101_135905,10404007.png,502730,13812,488918,0.97252600799634,2,4,61265,2010,59255,0.9671917081531054,26.436849777777777,3634.8380053333335,12.525953005442528,133,6.20000000000001E-4
2,test_20231101_135905,1254659.png,342646,59442,283204,0.8265206656432587,3,4,80080,8377,71703,0.8953921078921079,22.63763911111111,3744.3753706666666,12.397009809413873,133,6.20000000000001E-4
3,test_20231101_135905,10188041.png,221231,7582,213649,0.965728130325316,1,3,41731,1076,40655,0.9742158107881431,12.348760888888888,1463.1674453333333,16.477863311041546,133,6.20000000000001E-4
4,test_20231101_135905,10287332.png,216980,10252,206728,0.9527514056595078,1,3,22337,1412,20925,0.9367864977391771,10.08100088888889,982.629264,18.20690667012046,133,6.20000000000001E-4
5,test_20231101_135905,11610969.png,368720,18957,349763,0.9485870036884356,2,4,84111,2787,81324,0.9668652138245889,23.972956444444446,3528.0835413333334,12.65541500646643,133,6.20000000000001E-4
6,test_20231101_135905,10350842.png,212614,3087,209527,0.9854807303376071,1,5,42529,453,42076,0.9893484445907499,24.783941333333335,3746.0126026666667,12.395111267343555,133,6.20000000000001E-4
7,test_20231101_135905,10863862.png,317432,6294,311138,0.9801721313541167,1,3,66058,926,65132,0.9859820158042932,36.634704,6747.885306666667,9.839126685609427,133,6.20000000000001E-4
8,test_20231101_135905,11382381.png,312486,547,311939,0.9982495215785667,1,4,46745,72,46673,0.9984597283131885,22.81680888888889,2740.878352,13.751906001286724,133,6.20000000000001E-4
9,test_20231101_135905,11079715.png,443815,98692,345123,0.7776280657481158,3,4,124136,13868,110268,0.8882838177482761,18.65887822222222,2560.3068,14.047883511952787,133,6.20000000000001E-4
10,test_20231101_135905,11551286.png,271883,164,271719,0.9993967993585476,1,4,40092,22,40070,0.9994512620971765,18.120286222222223,1899.5769013333334,15.344234809036362,133,6.20000000000001E-4
1,test_20231101_135906,10404007.png,502730,13812,488918,0.97252600799634,2,3,61265,2010,59255,0.9671917081531054,26.436849777777777,3634.8380053333335,12.525953005442528,133,6.30000000000001E-4
2,test_20231101_135906,1254659.png,342646,59442,283204,0.8265206656432587,3,4,80080,8377,71703,0.8953921078921079,22.63763911111111,3744.3753706666666,12.397009809413873,133,6.30000000000001E-4
3,test_20231101_135906,10188041.png,221231,7582,213649,0.965728130325316,1,3,41731,1076,40655,0.9742158107881431,12.348760888888888,1463.1674453333333,16.477863311041546,133,6.30000000000001E-4
4,test_20231101_135906,10287332.png,216980,10252,206728,0.9527514056595078,1,4,22337,1412,20925,0.9367864977391771,10.08100088888889,982.629264,18.20690667012046,133,6.30000000000001E-4
5,test_20231101_135906,11610969.png,368720,18957,349763,0.9485870036884356,2,4,84111,2787,81324,0.9668652138245889,23.972956444444446,3528.0835413333334,12.65541500646643,133,6.30000000000001E-4
6,test_20231101_135906,10350842.png,212614,3087,209527,0.9854807303376071,2,3,42529,453,42076,0.9893484445907499,24.783941333333335,3746.0126026666667,12.395111267343555,133,6.30000000000001E-4
7,test_20231101_135906,10863862.png,317432,6294,311138,0.9801721313541167,1,3,66058,926,65132,0.9859820158042932,36.634704,6747.885306666667,9.839126685609427,133,6.30000000000001E-4
8,test_20231101_135906,11382381.png,312486,547,311939,0.9982495215785667,1,3,46745,72,46673,0.9984597283131885,22.81680888888889,2740.878352,13.751906001286724,133,6.30000000000001E-4
9,test_20231101_135906,11079715.png,443815,98692,345123,0.7776280657481158,3,4,124136,13868,110268,0.8882838177482761,18.65887822222222,2560.3068,14.047883511952787,133,6.30000000000001E-4
10,test_20231101_135906,11551286.png,271883,164,271719,0.9993967993585476,1,4,40092,22,40070,0.9994512620971765,18.120286222222223,1899.5769013333334,15.344234809036362,133,6.30000000000001E-4
1,test_20231101_135907,10404007.png,502730,13812,488918,0.97252600799634,2,3,61265,2010,59255,0.9671917081531054,26.436849777777777,3634.8380053333335,12.525953005442528,133,6.40000000000001E-4
2,test_20231101_135907,1254659.png,342646,59442,283204,0.8265206656432587,3,4,80080,8377,71703,0.8953921078921079,22.63763911111111,3744.3753706666666,12.397009809413873,133,6.40000000000001E-4
3,test_20231101_135907,10188041.png,221231,7502,213729,0.9660897432999896,2,4,41731,1066,40665,0.9744554407994057,12.387662222222222,1467.2519466666668,16.465756664846296,133,6.40000000000001E-4
4,test_20231101_135907,10287332.png,216980,10252,206728,0.9527514056595078,2,4,22337,1412,20925,0.9367864977391771,10.08100088888889,982.629264,18.20690667012046,133,6.40000000000001E-4
5,test_20231101_135907,11610969.png,368720,18957,349763,0.9485870036884356,2,4,84111,2787,81324,0.9668652138245889,23.972956444444446,3528.0835413333334,12.65541500646643,133,6.40000000000001E-4
6,test_20231101_135907,10350842.png,212614,3087,209527,0.9854807303376071,1,4,42529,453,42076,0.9893484445907499,24.783941333333335,3746.0126026666667,12.395111267343555,133,6.40000000000001E-4
7,test_20231101_135907,10863862.png,317432,6294,311138,0.9801721313541167,1,3,66058,926,65132,0.9859820158042932,36.634704,6747.885306666667,9.839126685609427,133,6.40000000000001E-4
8,test_20231101_135907,11382381.png,312486,547,311939,0.9982495215785667,1,3,46745,72,46673,0.9984597283131885,22.81680888888889,2740.878352,13.751906001286724,133,6.40000000000001E-4
9,test_20231101_135907,11079715.png,443815,98692,345123,0.7776280657481158,3,4,124136,13868,110268,0.8882838177482761,18.65887822222222,2560.3068,14.047883511952787,133,6.40000000000001E-4
10,test_20231101_135907,11551286.png,271883,164,271719,0.9993967993585476,1,3,40092,22,40070,0.9994512620971765,18.120286222222223,1899.5769013333334,15.344234809036362,133,6.40000000000001E-4
1,test_20231101_135907,10404007.png,502730,13812,488918,0.97252600799634,2,4,61265,2010,59255,0.9671917081531054,26.436849777777777,3634.8380053333335,12.525953005442528,133,6.500000000000011E-4
2,test_20231101_135907,1254659.png,342646,59442,283204,0.8265206656432587,2,4,80080,8377,71703,0.8953921078921079,22.63763911111111,3744.3753706666666,12.397009809413873,133,6.500000000000011E-4
3,test_20231101_135907,10188041.png,221231,7502,213729,0.9660897432999896,2,4,41731,1066,40665,0.9744554407994057,12.387662222222222,1467.2519466666668,16.465756664846296,133,6.500000000000011E-4
4,test_20231101_135907,10287332.png,216980,10252,206728,0.9527514056595078,2,4,22337,1412,20925,0.9367864977391771,10.08100088888889,982.629264,18.20690667012046,133,6.500000000000011E-4
5,test_20231101_135907,11610969.png,368720,18957,349763,0.9485870036884356,2,3,84111,2787,81324,0.9668652138245889,23.972956444444446,3528.0835413333334,12.65541500646643,133,6.500000000000011E-4
6,test_20231101_135907,10350842.png,212614,3087,209527,0.9854807303376071,2,3,42529,453,42076,0.9893484445907499,24.783941333333335,3746.0126026666667,12.395111267343555,133,6.500000000000011E-4
7,test_20231101_135907,10863862.png,317432,6294,311138,0.9801721313541167,2,4,66058,926,65132,0.9859820158042932,36.634704,6747.885306666667,9.839126685609427,133,6.500000000000011E-4
8,test_20231101_135907,11382381.png,312486,547,311939,0.9982495215785667,1,4,46745,72,46673,0.9984597283131885,22.81680888888889,2740.878352,13.751906001286724,133,6.500000000000011E-4
9,test_20231101_135907,11079715.png,443815,98692,345123,0.7776280657481158,3,4,124136,13868,110268,0.8882838177482761,18.65887822222222,2560.3068,14.047883511952787,133,6.500000000000011E-4
10,test_20231101_135907,11551286.png,271883,164,271719,0.9993967993585476,1,4,40092,22,40070,0.9994512620971765,18.120286222222223,1899.5769013333334,15.344234809036362,133,6.500000000000011E-4
1,test_20231101_135908,10404007.png,502730,13812,488918,0.97252600799634,2,4,61265,2010,59255,0.9671917081531054,26.436849777777777,3634.8380053333335,12.525953005442528,133,6.600000000000011E-4
2,test_20231101_135908,1254659.png,342646,59442,283204,0.8265206656432587,3,4,80080,8377,71703,0.8953921078921079,22.63763911111111,3744.3753706666666,12.397009809413873,133,6.600000000000011E-4
3,test_20231101_135908,10188041.png,221231,7502,213729,0.9660897432999896,2,3,41731,1066,40665,0.9744554407994057,12.387662222222222,1467.2519466666668,16.465756664846296,133,6.600000000000011E-4
4,test_20231101_135908,10287332.png,216980,10252,206728,0.9527514056595078,2,4,22337,1412,20925,0.9367864977391771,10.08100088888889,982.629264,18.20690667012046,133,6.600000000000011E-4
5,test_20231101_135908,11610969.png,368720,18957,349763,0.9485870036884356,3,3,84111,2787,81324,0.9668652138245889,23.972956444444446,3528.0835413333334,12.65541500646643,133,6.600000000000011E-4
6,test_20231101_135908,10350842.png,212614,3087,209527,0.9854807303376071,1,3,42529,453,42076,0.9893484445907499,24.783941333333335,3746.0126026666667,12.395111267343555,133,6.600000000000011E-4
7,test_20231101_135908,10863862.png,317432,6294,311138,0.9801721313541167,1,3,66058,926,65132,0.9859820158042932,36.634704,6747.885306666667,9.839126685609427,133,6.600000000000011E-4
8,test_20231101_135908,11382381.png,312486,547,311939,0.9982495215785667,2,8,46745,72,46673,0.9984597283131885,22.81680888888889,2740.878352,13.751906001286724,133,6.600000000000011E-4
9,test_20231101_135908,11079715.png,443815,98692,345123,0.7776280657481158,3,4,124136,13868,110268,0.8882838177482761,18.65887822222222,2560.3068,14.047883511952787,133,6.600000000000011E-4
10,test_20231101_135908,11551286.png,271883,164,271719,0.9993967993585476,1,4,40092,22,40070,0.9994512620971765,18.120286222222223,1899.5769013333334,15.344234809036362,133,6.600000000000011E-4
1,test_20231101_135909,10404007.png,502730,13812,488918,0.97252600799634,2,4,61265,2010,59255,0.9671917081531054,26.436849777777777,3634.8380053333335,12.525953005442528,133,6.700000000000011E-4
2,test_20231101_135909,1254659.png,342646,59442,283204,0.8265206656432587,3,3,80080,8377,71703,0.8953921078921079,22.63763911111111,3744.3753706666666,12.397009809413873,133,6.700000000000011E-4
3,test_20231101_135909,10188041.png,221231,7502,213729,0.9660897432999896,2,4,41731,1066,40665,0.9744554407994057,12.387662222222222,1467.2519466666668,16.465756664846296,133,6.700000000000011E-4
4,test_20231101_135909,10287332.png,216980,10252,206728,0.9527514056595078,2,4,22337,1412,20925,0.9367864977391771,10.08100088888889,982.629264,18.20690667012046,133,6.700000000000011E-4
5,test_20231101_135909,11610969.png,368720,18957,349763,0.9485870036884356,2,4,84111,2787,81324,0.9668652138245889,23.972956444444446,3528.0835413333334,12.65541500646643,133,6.700000000000011E-4
6,test_20231101_135909,10350842.png,212614,3087,209527,0.9854807303376071,2,3,42529,453,42076,0.9893484445907499,24.783941333333335,3746.0126026666667,12.395111267343555,133,6.700000000000011E-4
7,test_20231101_135909,10863862.png,317432,6294,311138,0.9801721313541167,2,4,66058,926,65132,0.9859820158042932,36.634704,6747.885306666667,9.839126685609427,133,6.700000000000011E-4
8,test_20231101_135909,11382381.png,312486,547,311939,0.9982495215785667,2,4,46745,72,46673,0.9984597283131885,22.81680888888889,2740.878352,13.751906001286724,133,6.700000000000011E-4
9,test_20231101_135909,11079715.png,443815,98692,345123,0.7776280657481158,3,4,124136,13868,110268,0.8882838177482761,18.65887822222222,2560.3068,14.047883511952787,133,6.700000000000011E-4
10,test_20231101_135909,11551286.png,271883,164,271719,0.9993967993585476,2,4,40092,22,40070,0.9994512620971765,18.120286222222223,1899.5769013333334,15.344234809036362,133,6.700000000000011E-4
1,test_20231101_135909,10404007.png,502730,13812,488918,0.97252600799634,2,3,61265,2010,59255,0.9671917081531054,26.436849777777777,3634.8380053333335,12.525953005442528,133,6.800000000000011E-4
2,test_20231101_135909,1254659.png,342646,59442,283204,0.8265206656432587,3,4,80080,8377,71703,0.8953921078921079,22.63763911111111,3744.3753706666666,12.397009809413873,133,6.800000000000011E-4
3,test_20231101_135909,10188041.png,221231,7502,213729,0.9660897432999896,2,4,41731,1066,40665,0.9744554407994057,12.387662222222222,1467.2519466666668,16.465756664846296,133,6.800000000000011E-4
4,test_20231101_135909,10287332.png,216980,10252,206728,0.9527514056595078,2,4,22337,1412,20925,0.9367864977391771,10.08100088888889,982.629264,18.20690667012046,133,6.800000000000011E-4
5,test_20231101_135909,11610969.png,368720,18957,349763,0.9485870036884356,2,4,84111,2787,81324,0.9668652138245889,23.972956444444446,3528.0835413333334,12.65541500646643,133,6.800000000000011E-4
6,test_20231101_135909,10350842.png,212614,3087,209527,0.9854807303376071,2,9,42529,453,42076,0.9893484445907499,24.783941333333335,3746.0126026666667,12.395111267343555,133,6.800000000000011E-4
7,test_20231101_135909,10863862.png,317432,6294,311138,0.9801721313541167,1,4,66058,926,65132,0.9859820158042932,36.634704,6747.885306666667,9.839126685609427,133,6.800000000000011E-4
8,test_20231101_135909,11382381.png,312486,547,311939,0.9982495215785667,1,3,46745,72,46673,0.9984597283131885,22.81680888888889,2740.878352,13.751906001286724,133,6.800000000000011E-4
9,test_20231101_135909,11079715.png,443815,98692,345123,0.7776280657481158,3,4,124136,13868,110268,0.8882838177482761,18.65887822222222,2560.3068,14.047883511952787,133,6.800000000000011E-4
10,test_20231101_135909,11551286.png,271883,164,271719,0.9993967993585476,1,4,40092,22,40070,0.9994512620971765,18.120286222222223,1899.5769013333334,15.344234809036362,133,6.800000000000011E-4
1,test_20231101_135910,10404007.png,502730,13167,489563,0.9738090028444693,2,3,61265,1917,59348,0.9687097037460214,26.80989688888889,3717.2848693333335,12.428545168991805,133,6.900000000000012E-4
2,test_20231101_135910,1254659.png,342646,59442,283204,0.8265206656432587,2,3,80080,8377,71703,0.8953921078921079,22.63763911111111,3744.3753706666666,12.397009809413873,133,6.900000000000012E-4
3,test_20231101_135910,10188041.png,221231,7502,213729,0.9660897432999896,1,3,41731,1066,40665,0.9744554407994057,12.387662222222222,1467.2519466666668,16.465756664846296,133,6.900000000000012E-4
4,test_20231101_135910,10287332.png,216980,10252,206728,0.9527514056595078,1,3,22337,1412,20925,0.9367864977391771,10.08100088888889,982.629264,18.20690667012046,133,6.900000000000012E-4
5,test_20231101_135910,11610969.png,368720,18957,349763,0.9485870036884356,3,4,84111,2787,81324,0.9668652138245889,23.972956444444446,3528.0835413333334,12.65541500646643,133,6.900000000000012E-4
6,test_20231101_135910,10350842.png,212614,3087,209527,0.9854807303376071,2,3,42529,453,42076,0.9893484445907499,24.783941333333335,3746.0126026666667,12.395111267343555,133,6.900000000000012E-4
7,test_20231101_135910,10863862.png,317432,6294,311138,0.9801721313541167,1,3,66058,926,65132,0.9859820158042932,36.634704,6747.885306666667,9.839126685609427,133,6.900000000000012E-4
8,test_20231101_135910,11382381.png,312486,547,311939,0.9982495215785667,1,4,46745,72,46673,0.9984597283131885,22.81680888888889,2740.878352,13.751906001286724,133,6.900000000000012E-4
9,test_20231101_135910,11079715.png,443815,98692,345123,0.7776280657481158,3,4,124136,13868,110268,0.8882838177482761,18.65887822222222,2560.3068,14.047883511952787,133,6.900000000000012E-4
10,test_20231101_135910,11551286.png,271883,164,271719,0.9993967993585476,1,4,40092,22,40070,0.9994512620971765,18.120286222222223,1899.5769013333334,15.344234809036362,133,6.900000000000012E-4
1,test_20231101_135911,10404007.png,502730,13167,489563,0.9738090028444693,2,4,61265,1917,59348,0.9687097037460214,26.80989688888889,3717.2848693333335,12.428545168991805,133,7.000000000000012E-4
2,test_20231101_135911,1254659.png,342646,59442,283204,0.8265206656432587,3,4,80080,8377,71703,0.8953921078921079,22.63763911111111,3744.3753706666666,12.397009809413873,133,7.000000000000012E-4
3,test_20231101_135911,10188041.png,221231,7502,213729,0.9660897432999896,2,4,41731,1066,40665,0.9744554407994057,12.387662222222222,1467.2519466666668,16.465756664846296,133,7.000000000000012E-4
4,test_20231101_135911,10287332.png,216980,10252,206728,0.9527514056595078,2,3,22337,1412,20925,0.9367864977391771,10.08100088888889,982.629264,18.20690667012046,133,7.000000000000012E-4
5,test_20231101_135911,11610969.png,368720,18957,349763,0.9485870036884356,2,4,84111,2787,81324,0.9668652138245889,23.972956444444446,3528.0835413333334,12.65541500646643,133,7.000000000000012E-4
6,test_20231101_135911,10350842.png,212614,3087,209527,0.9854807303376071,1,3,42529,453,42076,0.9893484445907499,24.783941333333335,3746.0126026666667,12.395111267343555,133,7.000000000000012E-4
7,test_20231101_135911,10863862.png,317432,6294,311138,0.9801721313541167,2,3,66058,926,65132,0.9859820158042932,36.634704,6747.885306666667,9.839126685609427,133,7.000000000000012E-4
8,test_20231101_135911,11382381.png,312486,547,311939,0.9982495215785667,1,4,46745,72,46673,0.9984597283131885,22.81680888888889,2740.878352,13.751906001286724,133,7.000000000000012E-4
9,test_20231101_135911,11079715.png,443815,98692,345123,0.7776280657481158,3,4,124136,13868,110268,0.8882838177482761,18.65887822222222,2560.3068,14.047883511952787,133,7.000000000000012E-4
10,test_20231101_135911,11551286.png,271883,164,271719,0.9993967993585476,1,4,40092,22,40070,0.9994512620971765,18.120286222222223,1899.5769013333334,15.344234809036362,133,7.000000000000012E-4
1,test_20231101_135911,10404007.png,502730,13167,489563,0.9738090028444693,2,13,61265,1917,59348,0.9687097037460214,26.80989688888889,3717.2848693333335,12.428545168991805,133,7.100000000000012E-4
2,test_20231101_135911,1254659.png,342646,59442,283204,0.8265206656432587,3,4,80080,8377,71703,0.8953921078921079,22.63763911111111,3744.3753706666666,12.397009809413873,133,7.100000000000012E-4
3,test_20231101_135911,10188041.png,221231,7502,213729,0.9660897432999896,2,3,41731,1066,40665,0.9744554407994057,12.387662222222222,1467.2519466666668,16.465756664846296,133,7.100000000000012E-4
4,test_20231101_135911,10287332.png,216980,10252,206728,0.9527514056595078,1,3,22337,1412,20925,0.9367864977391771,10.08100088888889,982.629264,18.20690667012046,133,7.100000000000012E-4
5,test_20231101_135911,11610969.png,368720,18957,349763,0.9485870036884356,2,3,84111,2787,81324,0.9668652138245889,23.972956444444446,3528.0835413333334,12.65541500646643,133,7.100000000000012E-4
6,test_20231101_135911,10350842.png,212614,3087,209527,0.9854807303376071,1,3,42529,453,42076,0.9893484445907499,24.783941333333335,3746.0126026666667,12.395111267343555,133,7.100000000000012E-4
7,test_20231101_135911,10863862.png,317432,6294,311138,0.9801721313541167,2,3,66058,926,65132,0.9859820158042932,36.634704,6747.885306666667,9.839126685609427,133,7.100000000000012E-4
8,test_20231101_135911,11382381.png,312486,547,311939,0.9982495215785667,1,4,46745,72,46673,0.9984597283131885,22.81680888888889,2740.878352,13.751906001286724,133,7.100000000000012E-4
9,test_20231101_135911,11079715.png,443815,98692,345123,0.7776280657481158,3,4,124136,13868,110268,0.8882838177482761,18.65887822222222,2560.3068,14.047883511952787,133,7.100000000000012E-4
10,test_20231101_135911,11551286.png,271883,164,271719,0.9993967993585476,1,4,40092,22,40070,0.9994512620971765,18.120286222222223,1899.5769013333334,15.344234809036362,133,7.100000000000012E-4
1,test_20231101_135912,10404007.png,502730,13167,489563,0.9738090028444693,2,4,61265,1917,59348,0.9687097037460214,26.80989688888889,3717.2848693333335,12.428545168991805,133,7.200000000000012E-4
2,test_20231101_135912,1254659.png,342646,59442,283204,0.8265206656432587,4,4,80080,8377,71703,0.8953921078921079,22.63763911111111,3744.3753706666666,12.397009809413873,133,7.200000000000012E-4
3,test_20231101_135912,10188041.png,221231,7502,213729,0.9660897432999896,2,4,41731,1066,40665,0.9744554407994057,12.387662222222222,1467.2519466666668,16.465756664846296,133,7.200000000000012E-4
4,test_20231101_135912,10287332.png,216980,10252,206728,0.9527514056595078,2,4,22337,1412,20925,0.9367864977391771,10.08100088888889,982.629264,18.20690667012046,133,7.200000000000012E-4
5,test_20231101_135912,11610969.png,368720,18957,349763,0.9485870036884356,2,4,84111,2787,81324,0.9668652138245889,23.972956444444446,3528.0835413333334,12.65541500646643,133,7.200000000000012E-4
6,test_20231101_135912,10350842.png,212614,3087,209527,0.9854807303376071,2,4,42529,453,42076,0.9893484445907499,24.783941333333335,3746.0126026666667,12.395111267343555,133,7.200000000000012E-4
7,test_20231101_135912,10863862.png,317432,6294,311138,0.9801721313541167,1,3,66058,926,65132,0.9859820158042932,36.634704,6747.885306666667,9.839126685609427,133,7.200000000000012E-4
8,test_20231101_135912,11382381.png,312486,547,311939,0.9982495215785667,1,3,46745,72,46673,0.9984597283131885,22.81680888888889,2740.878352,13.751906001286724,133,7.200000000000012E-4
9,test_20231101_135912,11079715.png,443815,98692,345123,0.7776280657481158,3,4,124136,13868,110268,0.8882838177482761,18.65887822222222,2560.3068,14.047883511952787,133,7.200000000000012E-4
10,test_20231101_135912,11551286.png,271883,164,271719,0.9993967993585476,1,4,40092,22,40070,0.9994512620971765,18.120286222222223,1899.5769013333334,15.344234809036362,133,7.200000000000012E-4
1,test_20231101_135913,10404007.png,502730,13167,489563,0.9738090028444693,2,4,61265,1917,59348,0.9687097037460214,26.80989688888889,3717.2848693333335,12.428545168991805,133,7.300000000000013E-4
2,test_20231101_135913,1254659.png,342646,59442,283204,0.8265206656432587,2,3,80080,8377,71703,0.8953921078921079,22.63763911111111,3744.3753706666666,12.397009809413873,133,7.300000000000013E-4
3,test_20231101_135913,10188041.png,221231,7502,213729,0.9660897432999896,2,4,41731,1066,40665,0.9744554407994057,12.387662222222222,1467.2519466666668,16.465756664846296,133,7.300000000000013E-4
4,test_20231101_135913,10287332.png,216980,10252,206728,0.9527514056595078,2,3,22337,1412,20925,0.9367864977391771,10.08100088888889,982.629264,18.20690667012046,133,7.300000000000013E-4
5,test_20231101_135913,11610969.png,368720,18957,349763,0.9485870036884356,3,3,84111,2787,81324,0.9668652138245889,23.972956444444446,3528.0835413333334,12.65541500646643,133,7.300000000000013E-4
6,test_20231101_135913,10350842.png,212614,3087,209527,0.9854807303376071,2,4,42529,453,42076,0.9893484445907499,24.783941333333335,3746.0126026666667,12.395111267343555,133,7.300000000000013E-4
7,test_20231101_135913,10863862.png,317432,6294,311138,0.9801721313541167,1,3,66058,926,65132,0.9859820158042932,36.634704,6747.885306666667,9.839126685609427,133,7.300000000000013E-4
8,test_20231101_135913,11382381.png,312486,547,311939,0.9982495215785667,2,3,46745,72,46673,0.9984597283131885,22.81680888888889,2740.878352,13.751906001286724,133,7.300000000000013E-4
9,test_20231101_135913,11079715.png,443815,98692,345123,0.7776280657481158,3,4,124136,13868,110268,0.8882838177482761,18.65887822222222,2560.3068,14.047883511952787,133,7.300000000000013E-4
10,test_20231101_135913,11551286.png,271883,164,271719,0.9993967993585476,2,4,40092,22,40070,0.9994512620971765,18.120286222222223,1899.5769013333334,15.344234809036362,133,7.300000000000013E-4
1,test_20231101_135913,10404007.png,502730,13167,489563,0.9738090028444693,2,13,61265,1917,59348,0.9687097037460214,26.80989688888889,3717.2848693333335,12.428545168991805,133,7.400000000000013E-4
2,test_20231101_135913,1254659.png,342646,59442,283204,0.8265206656432587,2,4,80080,8377,71703,0.8953921078921079,22.63763911111111,3744.3753706666666,12.397009809413873,133,7.400000000000013E-4
3,test_20231101_135913,10188041.png,221231,7502,213729,0.9660897432999896,2,3,41731,1066,40665,0.9744554407994057,12.387662222222222,1467.2519466666668,16.465756664846296,133,7.400000000000013E-4
4,test_20231101_135913,10287332.png,216980,10252,206728,0.9527514056595078,2,4,22337,1412,20925,0.9367864977391771,10.08100088888889,982.629264,18.20690667012046,133,7.400000000000013E-4
5,test_20231101_135913,11610969.png,368720,18957,349763,0.9485870036884356,2,3,84111,2787,81324,0.9668652138245889,23.972956444444446,3528.0835413333334,12.65541500646643,133,7.400000000000013E-4
6,test_20231101_135913,10350842.png,212614,3087,209527,0.9854807303376071,2,4,42529,453,42076,0.9893484445907499,24.783941333333335,3746.0126026666667,12.395111267343555,133,7.400000000000013E-4
7,test_20231101_135913,10863862.png,317432,6294,311138,0.9801721313541167,2,4,66058,926,65132,0.9859820158042932,36.634704,6747.885306666667,9.839126685609427,133,7.400000000000013E-4
8,test_20231101_135913,11382381.png,312486,547,311939,0.9982495215785667,1,4,46745,72,46673,0.9984597283131885,22.81680888888889,2740.878352,13.751906001286724,133,7.400000000000013E-4
9,test_20231101_135913,11079715.png,443815,98692,345123,0.7776280657481158,3,4,124136,13868,110268,0.8882838177482761,18.65887822222222,2560.3068,14.047883511952787,133,7.400000000000013E-4
10,test_20231101_135913,11551286.png,271883,164,271719,0.9993967993585476,2,3,40092,22,40070,0.9994512620971765,18.120286222222223,1899.5769013333334,15.344234809036362,133,7.400000000000013E-4
1,test_20231101_135914,10404007.png,502730,13167,489563,0.9738090028444693,2,4,61265,1917,59348,0.9687097037460214,26.80989688888889,3717.2848693333335,12.428545168991805,133,7.500000000000013E-4
2,test_20231101_135914,1254659.png,342646,59442,283204,0.8265206656432587,3,4,80080,8377,71703,0.8953921078921079,22.63763911111111,3744.3753706666666,12.397009809413873,133,7.500000000000013E-4
3,test_20231101_135914,10188041.png,221231,7502,213729,0.9660897432999896,2,4,41731,1066,40665,0.9744554407994057,12.387662222222222,1467.2519466666668,16.465756664846296,133,7.500000000000013E-4
4,test_20231101_135914,10287332.png,216980,10252,206728,0.9527514056595078,1,4,22337,1412,20925,0.9367864977391771,10.08100088888889,982.629264,18.20690667012046,133,7.500000000000013E-4
5,test_20231101_135914,11610969.png,368720,18957,349763,0.9485870036884356,2,4,84111,2787,81324,0.9668652138245889,23.972956444444446,3528.0835413333334,12.65541500646643,133,7.500000000000013E-4
6,test_20231101_135914,10350842.png,212614,3087,209527,0.9854807303376071,2,3,42529,453,42076,0.9893484445907499,24.783941333333335,3746.0126026666667,12.395111267343555,133,7.500000000000013E-4
7,test_20231101_135914,10863862.png,317432,6294,311138,0.9801721313541167,1,4,66058,926,65132,0.9859820158042932,36.634704,6747.885306666667,9.839126685609427,133,7.500000000000013E-4
8,test_20231101_135914,11382381.png,312486,547,311939,0.9982495215785667,1,4,46745,72,46673,0.9984597283131885,22.81680888888889,2740.878352,13.751906001286724,133,7.500000000000013E-4
9,test_20231101_135914,11079715.png,443815,98692,345123,0.7776280657481158,3,4,124136,13868,110268,0.8882838177482761,18.65887822222222,2560.3068,14.047883511952787,133,7.500000000000013E-4
10,test_20231101_135914,11551286.png,271883,164,271719,0.9993967993585476,1,4,40092,22,40070,0.9994512620971765,18.120286222222223,1899.5769013333334,15.344234809036362,133,7.500000000000013E-4
1,test_20231101_135915,10404007.png,502730,13147,489583,0.9738487856304577,3,3,61265,1914,59351,0.9687586713457929,27.009216,3761.5794133333334,12.377101259214252,133,7.600000000000013E-4
2,test_20231101_135915,1254659.png,342646,59442,283204,0.8265206656432587,3,4,80080,8377,71703,0.8953921078921079,22.63763911111111,3744.3753706666666,12.397009809413873,133,7.600000000000013E-4
3,test_20231101_135915,10188041.png,221231,7502,213729,0.9660897432999896,2,4,41731,1066,40665,0.9744554407994057,12.387662222222222,1467.2519466666668,16.465756664846296,133,7.600000000000013E-4
4,test_20231101_135915,10287332.png,216980,10252,206728,0.9527514056595078,2,3,22337,1412,20925,0.9367864977391771,10.08100088888889,982.629264,18.20690667012046,133,7.600000000000013E-4
5,test_20231101_135915,11610969.png,368720,18957,349763,0.9485870036884356,2,4,84111,2787,81324,0.9668652138245889,23.972956444444446,3528.0835413333334,12.65541500646643,133,7.600000000000013E-4
6,test_20231101_135915,10350842.png,212614,3067,209547,0.985574797520389,2,4,42529,450,42079,0.9894189846927979,25.24667911111111,3827.2027146666665,12.301988948468205,133,7.600000000000013E-4
7,test_20231101_135915,10863862.png,317432,6274,311158,0.9802351369742182,1,4,66058,923,65135,0.9860274304399165,36.73645333333333,6789.547589333333,9.8123952414293,133,7.600000000000013E-4
8,test_20231101_135915,11382381.png,312486,547,311939,0.9982495215785667,2,3,46745,72,46673,0.9984597283131885,22.81680888888889,2740.878352,13.751906001286724,133,7.600000000000013E-4
9,test_20231101_135915,11079715.png,443815,98692,345123,0.7776280657481158,3,4,124136,13868,110268,0.8882838177482761,18.65887822222222,2560.3068,14.047883511952787,133,7.600000000000013E-4
10,test_20231101_135915,11551286.png,271883,24,271859,0.9999117267353972,2,4,40092,1,40091,0.9999750573680535,24.866876444444443,3470.407338666667,12.72699907819776,133,7.600000000000013E-4
1,test_20231101_135915,10404007.png,502730,13147,489583,0.9738487856304577,2,4,61265,1914,59351,0.9687586713457929,27.009216,3761.5794133333334,12.377101259214252,133,7.700000000000014E-4
2,test_20231101_135915,1254659.png,342646,59442,283204,0.8265206656432587,2,4,80080,8377,71703,0.8953921078921079,22.63763911111111,3744.3753706666666,12.397009809413873,133,7.700000000000014E-4
3,test_20231101_135915,10188041.png,221231,7502,213729,0.9660897432999896,2,4,41731,1066,40665,0.9744554407994057,12.387662222222222,1467.2519466666668,16.465756664846296,133,7.700000000000014E-4
4,test_20231101_135915,10287332.png,216980,10252,206728,0.9527514056595078,1,3,22337,1412,20925,0.9367864977391771,10.08100088888889,982.629264,18.20690667012046,133,7.700000000000014E-4
5,test_20231101_135915,11610969.png,368720,18957,349763,0.9485870036884356,2,4,84111,2787,81324,0.9668652138245889,23.972956444444446,3528.0835413333334,12.65541500646643,133,7.700000000000014E-4
6,test_20231101_135915,10350842.png,212614,2687,209927,0.9873620739932459,2,4,42529,393,42136,0.9907592466317101,26.303125333333334,4085.2473066666666,12.018620085258714,133,7.700000000000014E-4
7,test_20231101_135915,10863862.png,317432,6274,311158,0.9802351369742182,2,4,66058,923,65135,0.9860274304399165,36.73645333333333,6789.547589333333,9.8123952414293,133,7.700000000000014E-4
8,test_20231101_135915,11382381.png,312486,547,311939,0.9982495215785667,1,3,46745,72,46673,0.9984597283131885,22.81680888888889,2740.878352,13.751906001286724,133,7.700000000000014E-4
9,test_20231101_135915,11079715.png,443815,98692,345123,0.7776280657481158,3,4,124136,13868,110268,0.8882838177482761,18.65887822222222,2560.3068,14.047883511952787,133,7.700000000000014E-4
10,test_20231101_135915,11551286.png,271883,24,271859,0.9999117267353972,1,4,40092,1,40091,0.9999750573680535,24.866876444444443,3470.407338666667,12.72699907819776,133,7.700000000000014E-4
1,test_20231101_135916,10404007.png,502730,13147,489583,0.9738487856304577,2,3,61265,1914,59351,0.9687586713457929,27.009216,3761.5794133333334,12.377101259214252,133,7.800000000000014E-4
2,test_20231101_135916,1254659.png,342646,59442,283204,0.8265206656432587,4,4,80080,8377,71703,0.8953921078921079,22.63763911111111,3744.3753706666666,12.397009809413873,133,7.800000000000014E-4
3,test_20231101_135916,10188041.png,221231,7502,213729,0.9660897432999896,2,4,41731,1066,40665,0.9744554407994057,12.387662222222222,1467.2519466666668,16.465756664846296,133,7.800000000000014E-4
4,test_20231101_135916,10287332.png,216980,10252,206728,0.9527514056595078,2,3,22337,1412,20925,0.9367864977391771,10.08100088888889,982.629264,18.20690667012046,133,7.800000000000014E-4
5,test_20231101_135916,11610969.png,368720,18957,349763,0.9485870036884356,3,3,84111,2787,81324,0.9668652138245889,23.972956444444446,3528.0835413333334,12.65541500646643,133,7.800000000000014E-4
6,test_20231101_135916,10350842.png,212614,2687,209927,0.9873620739932459,1,4,42529,393,42136,0.9907592466317101,26.303125333333334,4085.2473066666666,12.018620085258714,133,7.800000000000014E-4
7,test_20231101_135916,10863862.png,317432,6274,311158,0.9802351369742182,1,4,66058,923,65135,0.9860274304399165,36.73645333333333,6789.547589333333,9.8123952414293,133,7.800000000000014E-4
8,test_20231101_135916,11382381.png,312486,547,311939,0.9982495215785667,1,3,46745,72,46673,0.9984597283131885,22.81680888888889,2740.878352,13.751906001286724,133,7.800000000000014E-4
9,test_20231101_135916,11079715.png,443815,98692,345123,0.7776280657481158,3,4,124136,13868,110268,0.8882838177482761,18.65887822222222,2560.3068,14.047883511952787,133,7.800000000000014E-4
10,test_20231101_135916,11551286.png,271883,24,271859,0.9999117267353972,1,3,40092,1,40091,0.9999750573680535,24.866876444444443,3470.407338666667,12.72699907819776,133,7.800000000000014E-4
1,test_20231101_135917,10404007.png,502730,13147,489583,0.9738487856304577,2,4,61265,1914,59351,0.9687586713457929,27.009216,3761.5794133333334,12.377101259214252,133,7.900000000000014E-4
2,test_20231101_135917,1254659.png,342646,59442,283204,0.8265206656432587,4,4,80080,8377,71703,0.8953921078921079,22.63763911111111,3744.3753706666666,12.397009809413873,133,7.900000000000014E-4
3,test_20231101_135917,10188041.png,221231,7502,213729,0.9660897432999896,1,3,41731,1066,40665,0.9744554407994057,12.387662222222222,1467.2519466666668,16.465756664846296,133,7.900000000000014E-4
4,test_20231101_135917,10287332.png,216980,10252,206728,0.9527514056595078,2,4,22337,1412,20925,0.9367864977391771,10.08100088888889,982.629264,18.20690667012046,133,7.900000000000014E-4
5,test_20231101_135917,11610969.png,368720,18957,349763,0.9485870036884356,2,4,84111,2787,81324,0.9668652138245889,23.972956444444446,3528.0835413333334,12.65541500646643,133,7.900000000000014E-4
6,test_20231101_135917,10350842.png,212614,2687,209927,0.9873620739932459,1,3,42529,393,42136,0.9907592466317101,26.303125333333334,4085.2473066666666,12.018620085258714,133,7.900000000000014E-4
7,test_20231101_135917,10863862.png,317432,6274,311158,0.9802351369742182,1,3,66058,923,65135,0.9860274304399165,36.73645333333333,6789.547589333333,9.8123952414293,133,7.900000000000014E-4
8,test_20231101_135917,11382381.png,312486,547,311939,0.9982495215785667,1,3,46745,72,46673,0.9984597283131885,22.81680888888889,2740.878352,13.751906001286724,133,7.900000000000014E-4
9,test_20231101_135917,11079715.png,443815,98692,345123,0.7776280657481158,3,5,124136,13868,110268,0.8882838177482761,18.65887822222222,2560.3068,14.047883511952787,133,7.900000000000014E-4
10,test_20231101_135917,11551286.png,271883,24,271859,0.9999117267353972,1,4,40092,1,40091,0.9999750573680535,24.866876444444443,3470.407338666667,12.72699907819776,133,7.900000000000014E-4
1,test_20231101_135917,10404007.png,502730,13147,489583,0.9738487856304577,2,3,61265,1914,59351,0.9687586713457929,27.009216,3761.5794133333334,12.377101259214252,133,8.000000000000014E-4
2,test_20231101_135917,1254659.png,342646,59442,283204,0.8265206656432587,2,4,80080,8377,71703,0.8953921078921079,22.63763911111111,3744.3753706666666,12.397009809413873,133,8.000000000000014E-4
3,test_20231101_135917,10188041.png,221231,7502,213729,0.9660897432999896,2,4,41731,1066,40665,0.9744554407994057,12.387662222222222,1467.2519466666668,16.465756664846296,133,8.000000000000014E-4
4,test_20231101_135917,10287332.png,216980,10252,206728,0.9527514056595078,2,4,22337,1412,20925,0.9367864977391771,10.08100088888889,982.629264,18.20690667012046,133,8.000000000000014E-4
5,test_20231101_135917,11610969.png,368720,18957,349763,0.9485870036884356,2,3,84111,2787,81324,0.9668652138245889,23.972956444444446,3528.0835413333334,12.65541500646643,133,8.000000000000014E-4
6,test_20231101_135917,10350842.png,212614,2687,209927,0.9873620739932459,1,4,42529,393,42136,0.9907592466317101,26.303125333333334,4085.2473066666666,12.018620085258714,133,8.000000000000014E-4
7,test_20231101_135917,10863862.png,317432,6274,311158,0.9802351369742182,1,10,66058,923,65135,0.9860274304399165,36.73645333333333,6789.547589333333,9.8123952414293,133,8.000000000000014E-4
8,test_20231101_135917,11382381.png,312486,547,311939,0.9982495215785667,2,4,46745,72,46673,0.9984597283131885,22.81680888888889,2740.878352,13.751906001286724,133,8.000000000000014E-4
9,test_20231101_135917,11079715.png,443815,98692,345123,0.7776280657481158,4,5,124136,13868,110268,0.8882838177482761,18.65887822222222,2560.3068,14.047883511952787,133,8.000000000000014E-4
10,test_20231101_135917,11551286.png,271883,24,271859,0.9999117267353972,1,4,40092,1,40091,0.9999750573680535,24.866876444444443,3470.407338666667,12.72699907819776,133,8.000000000000014E-4
1,test_20231101_135918,10404007.png,502730,13147,489583,0.9738487856304577,2,4,61265,1914,59351,0.9687586713457929,27.009216,3761.5794133333334,12.377101259214252,133,8.100000000000015E-4
2,test_20231101_135918,1254659.png,342646,59442,283204,0.8265206656432587,3,4,80080,8377,71703,0.8953921078921079,22.63763911111111,3744.3753706666666,12.397009809413873,133,8.100000000000015E-4
3,test_20231101_135918,10188041.png,221231,7502,213729,0.9660897432999896,2,3,41731,1066,40665,0.9744554407994057,12.387662222222222,1467.2519466666668,16.465756664846296,133,8.100000000000015E-4
4,test_20231101_135918,10287332.png,216980,10252,206728,0.9527514056595078,2,4,22337,1412,20925,0.9367864977391771,10.08100088888889,982.629264,18.20690667012046,133,8.100000000000015E-4
5,test_20231101_135918,11610969.png,368720,18957,349763,0.9485870036884356,3,8,84111,2787,81324,0.9668652138245889,23.972956444444446,3528.0835413333334,12.65541500646643,133,8.100000000000015E-4
6,test_20231101_135918,10350842.png,212614,2687,209927,0.9873620739932459,2,4,42529,393,42136,0.9907592466317101,26.303125333333334,4085.2473066666666,12.018620085258714,133,8.100000000000015E-4
7,test_20231101_135918,10863862.png,317432,6274,311158,0.9802351369742182,2,4,66058,923,65135,0.9860274304399165,36.73645333333333,6789.547589333333,9.8123952414293,133,8.100000000000015E-4
8,test_20231101_135918,11382381.png,312486,547,311939,0.9982495215785667,1,4,46745,72,46673,0.9984597283131885,22.81680888888889,2740.878352,13.751906001286724,133,8.100000000000015E-4
9,test_20231101_135918,11079715.png,443815,98692,345123,0.7776280657481158,3,4,124136,13868,110268,0.8882838177482761,18.65887822222222,2560.3068,14.047883511952787,133,8.100000000000015E-4
10,test_20231101_135918,11551286.png,271883,24,271859,0.9999117267353972,1,4,40092,1,40091,0.9999750573680535,24.866876444444443,3470.407338666667,12.72699907819776,133,8.100000000000015E-4
1,test_20231101_135919,10404007.png,502730,13147,489583,0.9738487856304577,2,4,61265,1914,59351,0.9687586713457929,27.009216,3761.5794133333334,12.377101259214252,133,8.200000000000015E-4
2,test_20231101_135919,1254659.png,342646,59442,283204,0.8265206656432587,3,4,80080,8377,71703,0.8953921078921079,22.63763911111111,3744.3753706666666,12.397009809413873,133,8.200000000000015E-4
3,test_20231101_135919,10188041.png,221231,7502,213729,0.9660897432999896,2,3,41731,1066,40665,0.9744554407994057,12.387662222222222,1467.2519466666668,16.465756664846296,133,8.200000000000015E-4
4,test_20231101_135919,10287332.png,216980,10252,206728,0.9527514056595078,2,3,22337,1412,20925,0.9367864977391771,10.08100088888889,982.629264,18.20690667012046,133,8.200000000000015E-4
5,test_20231101_135919,11610969.png,368720,18957,349763,0.9485870036884356,3,3,84111,2787,81324,0.9668652138245889,23.972956444444446,3528.0835413333334,12.65541500646643,133,8.200000000000015E-4
6,test_20231101_135919,10350842.png,212614,2687,209927,0.9873620739932459,1,7,42529,393,42136,0.9907592466317101,26.303125333333334,4085.2473066666666,12.018620085258714,133,8.200000000000015E-4
7,test_20231101_135919,10863862.png,317432,6274,311158,0.9802351369742182,1,4,66058,923,65135,0.9860274304399165,36.73645333333333,6789.547589333333,9.8123952414293,133,8.200000000000015E-4
8,test_20231101_135919,11382381.png,312486,547,311939,0.9982495215785667,1,3,46745,72,46673,0.9984597283131885,22.81680888888889,2740.878352,13.751906001286724,133,8.200000000000015E-4
9,test_20231101_135919,11079715.png,443815,98692,345123,0.7776280657481158,5,4,124136,13868,110268,0.8882838177482761,18.65887822222222,2560.3068,14.047883511952787,133,8.200000000000015E-4
10,test_20231101_135919,11551286.png,271883,24,271859,0.9999117267353972,0,3,40092,1,40091,0.9999750573680535,24.866876444444443,3470.407338666667,12.72699907819776,133,8.200000000000015E-4
1,test_20231101_135919,10404007.png,502730,13147,489583,0.9738487856304577,1,3,61265,1914,59351,0.9687586713457929,27.009216,3761.5794133333334,12.377101259214252,133,8.300000000000015E-4
2,test_20231101_135919,1254659.png,342646,59442,283204,0.8265206656432587,3,3,80080,8377,71703,0.8953921078921079,22.63763911111111,3744.3753706666666,12.397009809413873,133,8.300000000000015E-4
3,test_20231101_135919,10188041.png,221231,7502,213729,0.9660897432999896,2,4,41731,1066,40665,0.9744554407994057,12.387662222222222,1467.2519466666668,16.465756664846296,133,8.300000000000015E-4
4,test_20231101_135919,10287332.png,216980,10252,206728,0.9527514056595078,2,3,22337,1412,20925,0.9367864977391771,10.08100088888889,982.629264,18.20690667012046,133,8.300000000000015E-4
5,test_20231101_135919,11610969.png,368720,18957,349763,0.9485870036884356,3,4,84111,2787,81324,0.9668652138245889,23.972956444444446,3528.0835413333334,12.65541500646643,133,8.300000000000015E-4
6,test_20231101_135919,10350842.png,212614,2687,209927,0.9873620739932459,1,8,42529,393,42136,0.9907592466317101,26.303125333333334,4085.2473066666666,12.018620085258714,133,8.300000000000015E-4
7,test_20231101_135919,10863862.png,317432,6274,311158,0.9802351369742182,2,4,66058,923,65135,0.9860274304399165,36.73645333333333,6789.547589333333,9.8123952414293,133,8.300000000000015E-4
8,test_20231101_135919,11382381.png,312486,547,311939,0.9982495215785667,1,4,46745,72,46673,0.9984597283131885,22.81680888888889,2740.878352,13.751906001286724,133,8.300000000000015E-4
9,test_20231101_135919,11079715.png,443815,98692,345123,0.7776280657481158,4,4,124136,13868,110268,0.8882838177482761,18.65887822222222,2560.3068,14.047883511952787,133,8.300000000000015E-4
10,test_20231101_135919,11551286.png,271883,24,271859,0.9999117267353972,0,3,40092,1,40091,0.9999750573680535,24.866876444444443,3470.407338666667,12.72699907819776,133,8.300000000000015E-4
1,test_20231101_135920,10404007.png,502730,13147,489583,0.9738487856304577,2,3,61265,1914,59351,0.9687586713457929,27.009216,3761.5794133333334,12.377101259214252,133,8.400000000000016E-4
2,test_20231101_135920,1254659.png,342646,59442,283204,0.8265206656432587,3,4,80080,8377,71703,0.8953921078921079,22.63763911111111,3744.3753706666666,12.397009809413873,133,8.400000000000016E-4
3,test_20231101_135920,10188041.png,221231,7502,213729,0.9660897432999896,2,4,41731,1066,40665,0.9744554407994057,12.387662222222222,1467.2519466666668,16.465756664846296,133,8.400000000000016E-4
4,test_20231101_135920,10287332.png,216980,10252,206728,0.9527514056595078,2,4,22337,1412,20925,0.9367864977391771,10.08100088888889,982.629264,18.20690667012046,133,8.400000000000016E-4
5,test_20231101_135920,11610969.png,368720,18957,349763,0.9485870036884356,3,4,84111,2787,81324,0.9668652138245889,23.972956444444446,3528.0835413333334,12.65541500646643,133,8.400000000000016E-4
6,test_20231101_135920,10350842.png,212614,2687,209927,0.9873620739932459,1,4,42529,393,42136,0.9907592466317101,26.303125333333334,4085.2473066666666,12.018620085258714,133,8.400000000000016E-4
7,test_20231101_135920,10863862.png,317432,6012,311420,0.9810605105975453,2,3,66058,884,65174,0.9866178207030185,37.291216,6937.797168,9.718587621197267,133,8.400000000000016E-4
8,test_20231101_135920,11382381.png,312486,547,311939,0.9982495215785667,1,4,46745,72,46673,0.9984597283131885,22.81680888888889,2740.878352,13.751906001286724,133,8.400000000000016E-4
9,test_20231101_135920,11079715.png,443815,98692,345123,0.7776280657481158,3,4,124136,13868,110268,0.8882838177482761,18.65887822222222,2560.3068,14.047883511952787,133,8.400000000000016E-4
10,test_20231101_135920,11551286.png,271883,24,271859,0.9999117267353972,0,3,40092,1,40091,0.9999750573680535,24.866876444444443,3470.407338666667,12.72699907819776,133,8.400000000000016E-4
1,test_20231101_135921,10404007.png,502730,13147,489583,0.9738487856304577,1,3,61265,1914,59351,0.9687586713457929,27.009216,3761.5794133333334,12.377101259214252,133,8.500000000000016E-4
2,test_20231101_135921,1254659.png,342646,59442,283204,0.8265206656432587,2,4,80080,8377,71703,0.8953921078921079,22.63763911111111,3744.3753706666666,12.397009809413873,133,8.500000000000016E-4
3,test_20231101_135921,10188041.png,221231,7502,213729,0.9660897432999896,2,4,41731,1066,40665,0.9744554407994057,12.387662222222222,1467.2519466666668,16.465756664846296,133,8.500000000000016E-4
4,test_20231101_135921,10287332.png,216980,10252,206728,0.9527514056595078,2,4,22337,1412,20925,0.9367864977391771,10.08100088888889,982.629264,18.20690667012046,133,8.500000000000016E-4
5,test_20231101_135921,11610969.png,368720,18957,349763,0.9485870036884356,3,3,84111,2787,81324,0.9668652138245889,23.972956444444446,3528.0835413333334,12.65541500646643,133,8.500000000000016E-4
6,test_20231101_135921,10350842.png,212614,2687,209927,0.9873620739932459,1,4,42529,393,42136,0.9907592466317101,26.303125333333334,4085.2473066666666,12.018620085258714,133,8.500000000000016E-4
7,test_20231101_135921,10863862.png,317432,6012,311420,0.9810605105975453,2,3,66058,884,65174,0.9866178207030185,37.291216,6937.797168,9.718587621197267,133,8.500000000000016E-4
8,test_20231101_135921,11382381.png,312486,547,311939,0.9982495215785667,1,4,46745,72,46673,0.9984597283131885,22.81680888888889,2740.878352,13.751906001286724,133,8.500000000000016E-4
9,test_20231101_135921,11079715.png,443815,98692,345123,0.7776280657481158,3,4,124136,13868,110268,0.8882838177482761,18.65887822222222,2560.3068,14.047883511952787,133,8.500000000000016E-4
10,test_20231101_135921,11551286.png,271883,24,271859,0.9999117267353972,0,3,40092,1,40091,0.9999750573680535,24.866876444444443,3470.407338666667,12.72699907819776,133,8.500000000000016E-4
1,test_20231101_135921,10404007.png,502730,13147,489583,0.9738487856304577,1,3,61265,1914,59351,0.9687586713457929,27.009216,3761.5794133333334,12.377101259214252,133,8.600000000000016E-4
2,test_20231101_135921,1254659.png,342646,59442,283204,0.8265206656432587,3,4,80080,8377,71703,0.8953921078921079,22.63763911111111,3744.3753706666666,12.397009809413873,133,8.600000000000016E-4
3,test_20231101_135921,10188041.png,221231,7502,213729,0.9660897432999896,2,4,41731,1066,40665,0.9744554407994057,12.387662222222222,1467.2519466666668,16.465756664846296,133,8.600000000000016E-4
4,test_20231101_135921,10287332.png,216980,10252,206728,0.9527514056595078,1,4,22337,1412,20925,0.9367864977391771,10.08100088888889,982.629264,18.20690667012046,133,8.600000000000016E-4
5,test_20231101_135921,11610969.png,368720,18957,349763,0.9485870036884356,2,4,84111,2787,81324,0.9668652138245889,23.972956444444446,3528.0835413333334,12.65541500646643,133,8.600000000000016E-4
6,test_20231101_135921,10350842.png,212614,2687,209927,0.9873620739932459,1,4,42529,393,42136,0.9907592466317101,26.303125333333334,4085.2473066666666,12.018620085258714,133,8.600000000000016E-4
7,test_20231101_135921,10863862.png,317432,6012,311420,0.9810605105975453,1,4,66058,884,65174,0.9866178207030185,37.291216,6937.797168,9.718587621197267,133,8.600000000000016E-4
8,test_20231101_135921,11382381.png,312486,547,311939,0.9982495215785667,1,5,46745,72,46673,0.9984597283131885,22.81680888888889,2740.878352,13.751906001286724,133,8.600000000000016E-4
9,test_20231101_135921,11079715.png,443815,98692,345123,0.7776280657481158,3,4,124136,13868,110268,0.8882838177482761,18.65887822222222,2560.3068,14.047883511952787,133,8.600000000000016E-4
10,test_20231101_135921,11551286.png,271883,24,271859,0.9999117267353972,0,3,40092,1,40091,0.9999750573680535,24.866876444444443,3470.407338666667,12.72699907819776,133,8.600000000000016E-4
1,test_20231101_135922,10404007.png,502730,13147,489583,0.9738487856304577,2,4,61265,1914,59351,0.9687586713457929,27.009216,3761.5794133333334,12.377101259214252,133,8.700000000000016E-4
2,test_20231101_135922,1254659.png,342646,59442,283204,0.8265206656432587,3,3,80080,8377,71703,0.8953921078921079,22.63763911111111,3744.3753706666666,12.397009809413873,133,8.700000000000016E-4
3,test_20231101_135922,10188041.png,221231,7502,213729,0.9660897432999896,2,3,41731,1066,40665,0.9744554407994057,12.387662222222222,1467.2519466666668,16.465756664846296,133,8.700000000000016E-4
4,test_20231101_135922,10287332.png,216980,10252,206728,0.9527514056595078,2,3,22337,1412,20925,0.9367864977391771,10.08100088888889,982.629264,18.20690667012046,133,8.700000000000016E-4
5,test_20231101_135922,11610969.png,368720,18957,349763,0.9485870036884356,2,4,84111,2787,81324,0.9668652138245889,23.972956444444446,3528.0835413333334,12.65541500646643,133,8.700000000000016E-4
6,test_20231101_135922,10350842.png,212614,2687,209927,0.9873620739932459,1,3,42529,393,42136,0.9907592466317101,26.303125333333334,4085.2473066666666,12.018620085258714,133,8.700000000000016E-4
7,test_20231101_135922,10863862.png,317432,6012,311420,0.9810605105975453,2,3,66058,884,65174,0.9866178207030185,37.291216,6937.797168,9.718587621197267,133,8.700000000000016E-4
8,test_20231101_135922,11382381.png,312486,547,311939,0.9982495215785667,1,3,46745,72,46673,0.9984597283131885,22.81680888888889,2740.878352,13.751906001286724,133,8.700000000000016E-4
9,test_20231101_135922,11079715.png,443815,98692,345123,0.7776280657481158,3,4,124136,13868,110268,0.8882838177482761,18.65887822222222,2560.3068,14.047883511952787,133,8.700000000000016E-4
10,test_20231101_135922,11551286.png,271883,24,271859,0.9999117267353972,1,4,40092,1,40091,0.9999750573680535,24.866876444444443,3470.407338666667,12.72699907819776,133,8.700000000000016E-4
1,test_20231101_135923,10404007.png,502730,13147,489583,0.9738487856304577,2,4,61265,1914,59351,0.9687586713457929,27.009216,3761.5794133333334,12.377101259214252,133,8.800000000000017E-4
2,test_20231101_135923,1254659.png,342646,59442,283204,0.8265206656432587,2,3,80080,8377,71703,0.8953921078921079,22.63763911111111,3744.3753706666666,12.397009809413873,133,8.800000000000017E-4
3,test_20231101_135923,10188041.png,221231,7502,213729,0.9660897432999896,2,3,41731,1066,40665,0.9744554407994057,12.387662222222222,1467.2519466666668,16.465756664846296,133,8.800000000000017E-4
4,test_20231101_135923,10287332.png,216980,10252,206728,0.9527514056595078,2,3,22337,1412,20925,0.9367864977391771,10.08100088888889,982.629264,18.20690667012046,133,8.800000000000017E-4
5,test_20231101_135923,11610969.png,368720,18957,349763,0.9485870036884356,2,10,84111,2787,81324,0.9668652138245889,23.972956444444446,3528.0835413333334,12.65541500646643,133,8.800000000000017E-4
6,test_20231101_135923,10350842.png,212614,2687,209927,0.9873620739932459,1,3,42529,393,42136,0.9907592466317101,26.303125333333334,4085.2473066666666,12.018620085258714,133,8.800000000000017E-4
7,test_20231101_135923,10863862.png,317432,6012,311420,0.9810605105975453,1,3,66058,884,65174,0.9866178207030185,37.291216,6937.797168,9.718587621197267,133,8.800000000000017E-4
8,test_20231101_135923,11382381.png,312486,547,311939,0.9982495215785667,1,3,46745,72,46673,0.9984597283131885,22.81680888888889,2740.878352,13.751906001286724,133,8.800000000000017E-4
9,test_20231101_135923,11079715.png,443815,98692,345123,0.7776280657481158,3,10,124136,13868,110268,0.8882838177482761,18.65887822222222,2560.3068,14.047883511952787,133,8.800000000000017E-4
10,test_20231101_135923,11551286.png,271883,24,271859,0.9999117267353972,0,3,40092,1,40091,0.9999750573680535,24.866876444444443,3470.407338666667,12.72699907819776,133,8.800000000000017E-4
1,test_20231101_135923,10404007.png,502730,13147,489583,0.9738487856304577,2,4,61265,1914,59351,0.9687586713457929,27.009216,3761.5794133333334,12.377101259214252,133,8.900000000000017E-4
2,test_20231101_135923,1254659.png,342646,59442,283204,0.8265206656432587,2,3,80080,8377,71703,0.8953921078921079,22.63763911111111,3744.3753706666666,12.397009809413873,133,8.900000000000017E-4
3,test_20231101_135923,10188041.png,221231,7502,213729,0.9660897432999896,2,3,41731,1066,40665,0.9744554407994057,12.387662222222222,1467.2519466666668,16.465756664846296,133,8.900000000000017E-4
4,test_20231101_135923,10287332.png,216980,10252,206728,0.9527514056595078,1,4,22337,1412,20925,0.9367864977391771,10.08100088888889,982.629264,18.20690667012046,133,8.900000000000017E-4
5,test_20231101_135923,11610969.png,368720,18957,349763,0.9485870036884356,3,3,84111,2787,81324,0.9668652138245889,23.972956444444446,3528.0835413333334,12.65541500646643,133,8.900000000000017E-4
6,test_20231101_135923,10350842.png,212614,2687,209927,0.9873620739932459,1,4,42529,393,42136,0.9907592466317101,26.303125333333334,4085.2473066666666,12.018620085258714,133,8.900000000000017E-4
7,test_20231101_135923,10863862.png,317432,6012,311420,0.9810605105975453,1,4,66058,884,65174,0.9866178207030185,37.291216,6937.797168,9.718587621197267,133,8.900000000000017E-4
8,test_20231101_135923,11382381.png,312486,547,311939,0.9982495215785667,1,3,46745,72,46673,0.9984597283131885,22.81680888888889,2740.878352,13.751906001286724,133,8.900000000000017E-4
9,test_20231101_135923,11079715.png,443815,98692,345123,0.7776280657481158,3,4,124136,13868,110268,0.8882838177482761,18.65887822222222,2560.3068,14.047883511952787,133,8.900000000000017E-4
10,test_20231101_135923,11551286.png,271883,24,271859,0.9999117267353972,1,4,40092,1,40091,0.9999750573680535,24.866876444444443,3470.407338666667,12.72699907819776,133,8.900000000000017E-4
1,test_20231101_135924,10404007.png,502730,13147,489583,0.9738487856304577,2,3,61265,1914,59351,0.9687586713457929,27.009216,3761.5794133333334,12.377101259214252,133,9.000000000000017E-4
2,test_20231101_135924,1254659.png,342646,59442,283204,0.8265206656432587,3,5,80080,8377,71703,0.8953921078921079,22.63763911111111,3744.3753706666666,12.397009809413873,133,9.000000000000017E-4
3,test_20231101_135924,10188041.png,221231,7502,213729,0.9660897432999896,2,4,41731,1066,40665,0.9744554407994057,12.387662222222222,1467.2519466666668,16.465756664846296,133,9.000000000000017E-4
4,test_20231101_135924,10287332.png,216980,10252,206728,0.9527514056595078,1,4,22337,1412,20925,0.9367864977391771,10.08100088888889,982.629264,18.20690667012046,133,9.000000000000017E-4
5,test_20231101_135924,11610969.png,368720,18957,349763,0.9485870036884356,2,4,84111,2787,81324,0.9668652138245889,23.972956444444446,3528.0835413333334,12.65541500646643,133,9.000000000000017E-4
6,test_20231101_135924,10350842.png,212614,2687,209927,0.9873620739932459,1,4,42529,393,42136,0.9907592466317101,26.303125333333334,4085.2473066666666,12.018620085258714,133,9.000000000000017E-4
7,test_20231101_135924,10863862.png,317432,6012,311420,0.9810605105975453,1,5,66058,884,65174,0.9866178207030185,37.291216,6937.797168,9.718587621197267,133,9.000000000000017E-4
8,test_20231101_135924,11382381.png,312486,547,311939,0.9982495215785667,1,4,46745,72,46673,0.9984597283131885,22.81680888888889,2740.878352,13.751906001286724,133,9.000000000000017E-4
9,test_20231101_135924,11079715.png,443815,98692,345123,0.7776280657481158,3,4,124136,13868,110268,0.8882838177482761,18.65887822222222,2560.3068,14.047883511952787,133,9.000000000000017E-4
10,test_20231101_135924,11551286.png,271883,24,271859,0.9999117267353972,1,3,40092,1,40091,0.9999750573680535,24.866876444444443,3470.407338666667,12.72699907819776,133,9.000000000000017E-4
1,test_20231101_135925,10404007.png,502730,13147,489583,0.9738487856304577,2,3,61265,1914,59351,0.9687586713457929,27.009216,3761.5794133333334,12.377101259214252,133,9.100000000000017E-4
2,test_20231101_135925,1254659.png,342646,59442,283204,0.8265206656432587,3,3,80080,8377,71703,0.8953921078921079,22.63763911111111,3744.3753706666666,12.397009809413873,133,9.100000000000017E-4
3,test_20231101_135925,10188041.png,221231,7502,213729,0.9660897432999896,2,3,41731,1066,40665,0.9744554407994057,12.387662222222222,1467.2519466666668,16.465756664846296,133,9.100000000000017E-4
4,test_20231101_135925,10287332.png,216980,10252,206728,0.9527514056595078,1,4,22337,1412,20925,0.9367864977391771,10.08100088888889,982.629264,18.20690667012046,133,9.100000000000017E-4
5,test_20231101_135925,11610969.png,368720,18957,349763,0.9485870036884356,2,3,84111,2787,81324,0.9668652138245889,23.972956444444446,3528.0835413333334,12.65541500646643,133,9.100000000000017E-4
6,test_20231101_135925,10350842.png,212614,2687,209927,0.9873620739932459,1,4,42529,393,42136,0.9907592466317101,26.303125333333334,4085.2473066666666,12.018620085258714,133,9.100000000000017E-4
7,test_20231101_135925,10863862.png,317432,6012,311420,0.9810605105975453,2,3,66058,884,65174,0.9866178207030185,37.291216,6937.797168,9.718587621197267,133,9.100000000000017E-4
8,test_20231101_135925,11382381.png,312486,547,311939,0.9982495215785667,2,3,46745,72,46673,0.9984597283131885,22.81680888888889,2740.878352,13.751906001286724,133,9.100000000000017E-4
9,test_20231101_135925,11079715.png,443815,98692,345123,0.7776280657481158,3,4,124136,13868,110268,0.8882838177482761,18.65887822222222,2560.3068,14.047883511952787,133,9.100000000000017E-4
10,test_20231101_135925,11551286.png,271883,24,271859,0.9999117267353972,2,4,40092,1,40091,0.9999750573680535,24.866876444444443,3470.407338666667,12.72699907819776,133,9.100000000000017E-4
1,test_20231101_135925,10404007.png,502730,13147,489583,0.9738487856304577,2,4,61265,1914,59351,0.9687586713457929,27.009216,3761.5794133333334,12.377101259214252,133,9.200000000000018E-4
2,test_20231101_135925,1254659.png,342646,59442,283204,0.8265206656432587,3,4,80080,8377,71703,0.8953921078921079,22.63763911111111,3744.3753706666666,12.397009809413873,133,9.200000000000018E-4
3,test_20231101_135925,10188041.png,221231,7502,213729,0.9660897432999896,2,4,41731,1066,40665,0.9744554407994057,12.387662222222222,1467.2519466666668,16.465756664846296,133,9.200000000000018E-4
4,test_20231101_135925,10287332.png,216980,10252,206728,0.9527514056595078,2,3,22337,1412,20925,0.9367864977391771,10.08100088888889,982.629264,18.20690667012046,133,9.200000000000018E-4
5,test_20231101_135925,11610969.png,368720,18957,349763,0.9485870036884356,2,4,84111,2787,81324,0.9668652138245889,23.972956444444446,3528.0835413333334,12.65541500646643,133,9.200000000000018E-4
6,test_20231101_135925,10350842.png,212614,2687,209927,0.9873620739932459,1,4,42529,393,42136,0.9907592466317101,26.303125333333334,4085.2473066666666,12.018620085258714,133,9.200000000000018E-4
7,test_20231101_135925,10863862.png,317432,6012,311420,0.9810605105975453,2,3,66058,884,65174,0.9866178207030185,37.291216,6937.797168,9.718587621197267,133,9.200000000000018E-4
8,test_20231101_135925,11382381.png,312486,547,311939,0.9982495215785667,1,4,46745,72,46673,0.9984597283131885,22.81680888888889,2740.878352,13.751906001286724,133,9.200000000000018E-4
9,test_20231101_135925,11079715.png,443815,98692,345123,0.7776280657481158,3,4,124136,13868,110268,0.8882838177482761,18.65887822222222,2560.3068,14.047883511952787,133,9.200000000000018E-4
10,test_20231101_135925,11551286.png,271883,24,271859,0.9999117267353972,1,4,40092,1,40091,0.9999750573680535,24.866876444444443,3470.407338666667,12.72699907819776,133,9.200000000000018E-4
1,test_20231101_135926,10404007.png,502730,13147,489583,0.9738487856304577,2,3,61265,1914,59351,0.9687586713457929,27.009216,3761.5794133333334,12.377101259214252,133,9.300000000000018E-4
2,test_20231101_135926,1254659.png,342646,59442,283204,0.8265206656432587,3,4,80080,8377,71703,0.8953921078921079,22.63763911111111,3744.3753706666666,12.397009809413873,133,9.300000000000018E-4
3,test_20231101_135926,10188041.png,221231,7502,213729,0.9660897432999896,2,4,41731,1066,40665,0.9744554407994057,12.387662222222222,1467.2519466666668,16.465756664846296,133,9.300000000000018E-4
4,test_20231101_135926,10287332.png,216980,10252,206728,0.9527514056595078,2,3,22337,1412,20925,0.9367864977391771,10.08100088888889,982.629264,18.20690667012046,133,9.300000000000018E-4
5,test_20231101_135926,11610969.png,368720,18957,349763,0.9485870036884356,3,5,84111,2787,81324,0.9668652138245889,23.972956444444446,3528.0835413333334,12.65541500646643,133,9.300000000000018E-4
6,test_20231101_135926,10350842.png,212614,2687,209927,0.9873620739932459,1,4,42529,393,42136,0.9907592466317101,26.303125333333334,4085.2473066666666,12.018620085258714,133,9.300000000000018E-4
7,test_20231101_135926,10863862.png,317432,6012,311420,0.9810605105975453,2,4,66058,884,65174,0.9866178207030185,37.291216,6937.797168,9.718587621197267,133,9.300000000000018E-4
8,test_20231101_135926,11382381.png,312486,547,311939,0.9982495215785667,2,4,46745,72,46673,0.9984597283131885,22.81680888888889,2740.878352,13.751906001286724,133,9.300000000000018E-4
9,test_20231101_135926,11079715.png,443815,98692,345123,0.7776280657481158,3,5,124136,13868,110268,0.8882838177482761,18.65887822222222,2560.3068,14.047883511952787,133,9.300000000000018E-4
10,test_20231101_135926,11551286.png,271883,24,271859,0.9999117267353972,0,3,40092,1,40091,0.9999750573680535,24.866876444444443,3470.407338666667,12.72699907819776,133,9.300000000000018E-4
1,test_20231101_135927,10404007.png,502730,13147,489583,0.9738487856304577,2,4,61265,1914,59351,0.9687586713457929,27.009216,3761.5794133333334,12.377101259214252,133,9.400000000000018E-4
2,test_20231101_135927,1254659.png,342646,59442,283204,0.8265206656432587,4,4,80080,8377,71703,0.8953921078921079,22.63763911111111,3744.3753706666666,12.397009809413873,133,9.400000000000018E-4
3,test_20231101_135927,10188041.png,221231,7502,213729,0.9660897432999896,2,4,41731,1066,40665,0.9744554407994057,12.387662222222222,1467.2519466666668,16.465756664846296,133,9.400000000000018E-4
4,test_20231101_135927,10287332.png,216980,10252,206728,0.9527514056595078,1,3,22337,1412,20925,0.9367864977391771,10.08100088888889,982.629264,18.20690667012046,133,9.400000000000018E-4
5,test_20231101_135927,11610969.png,368720,18957,349763,0.9485870036884356,3,4,84111,2787,81324,0.9668652138245889,23.972956444444446,3528.0835413333334,12.65541500646643,133,9.400000000000018E-4
6,test_20231101_135927,10350842.png,212614,2687,209927,0.9873620739932459,2,4,42529,393,42136,0.9907592466317101,26.303125333333334,4085.2473066666666,12.018620085258714,133,9.400000000000018E-4
7,test_20231101_135927,10863862.png,317432,6012,311420,0.9810605105975453,2,4,66058,884,65174,0.9866178207030185,37.291216,6937.797168,9.718587621197267,133,9.400000000000018E-4
8,test_20231101_135927,11382381.png,312486,547,311939,0.9982495215785667,1,4,46745,72,46673,0.9984597283131885,22.81680888888889,2740.878352,13.751906001286724,133,9.400000000000018E-4
9,test_20231101_135927,11079715.png,443815,98692,345123,0.7776280657481158,3,4,124136,13868,110268,0.8882838177482761,18.65887822222222,2560.3068,14.047883511952787,133,9.400000000000018E-4
10,test_20231101_135927,11551286.png,271883,24,271859,0.9999117267353972,1,4,40092,1,40091,0.9999750573680535,24.866876444444443,3470.407338666667,12.72699907819776,133,9.400000000000018E-4
1,test_20231101_135928,10404007.png,502730,13147,489583,0.9738487856304577,2,3,61265,1914,59351,0.9687586713457929,27.009216,3761.5794133333334,12.377101259214252,133,9.500000000000018E-4
2,test_20231101_135928,1254659.png,342646,59442,283204,0.8265206656432587,2,3,80080,8377,71703,0.8953921078921079,22.63763911111111,3744.3753706666666,12.397009809413873,133,9.500000000000018E-4
3,test_20231101_135928,10188041.png,221231,7502,213729,0.9660897432999896,2,4,41731,1066,40665,0.9744554407994057,12.387662222222222,1467.2519466666668,16.465756664846296,133,9.500000000000018E-4
4,test_20231101_135928,10287332.png,216980,10252,206728,0.9527514056595078,1,4,22337,1412,20925,0.9367864977391771,10.08100088888889,982.629264,18.20690667012046,133,9.500000000000018E-4
5,test_20231101_135928,11610969.png,368720,18957,349763,0.9485870036884356,3,12,84111,2787,81324,0.9668652138245889,23.972956444444446,3528.0835413333334,12.65541500646643,133,9.500000000000018E-4
6,test_20231101_135928,10350842.png,212614,2687,209927,0.9873620739932459,2,4,42529,393,42136,0.9907592466317101,26.303125333333334,4085.2473066666666,12.018620085258714,133,9.500000000000018E-4
7,test_20231101_135928,10863862.png,317432,6012,311420,0.9810605105975453,2,3,66058,884,65174,0.9866178207030185,37.291216,6937.797168,9.718587621197267,133,9.500000000000018E-4
8,test_20231101_135928,11382381.png,312486,547,311939,0.9982495215785667,2,7,46745,72,46673,0.9984597283131885,22.81680888888889,2740.878352,13.751906001286724,133,9.500000000000018E-4
9,test_20231101_135928,11079715.png,443815,98692,345123,0.7776280657481158,3,5,124136,13868,110268,0.8882838177482761,18.65887822222222,2560.3068,14.047883511952787,133,9.500000000000018E-4
10,test_20231101_135928,11551286.png,271883,24,271859,0.9999117267353972,0,3,40092,1,40091,0.9999750573680535,24.866876444444443,3470.407338666667,12.72699907819776,133,9.500000000000018E-4
1,test_20231101_135928,10404007.png,502730,13147,489583,0.9738487856304577,2,4,61265,1914,59351,0.9687586713457929,27.009216,3761.5794133333334,12.377101259214252,133,9.600000000000019E-4
2,test_20231101_135928,1254659.png,342646,59442,283204,0.8265206656432587,3,4,80080,8377,71703,0.8953921078921079,22.63763911111111,3744.3753706666666,12.397009809413873,133,9.600000000000019E-4
3,test_20231101_135928,10188041.png,221231,7502,213729,0.9660897432999896,2,3,41731,1066,40665,0.9744554407994057,12.387662222222222,1467.2519466666668,16.465756664846296,133,9.600000000000019E-4
4,test_20231101_135928,10287332.png,216980,10252,206728,0.9527514056595078,3,4,22337,1412,20925,0.9367864977391771,10.08100088888889,982.629264,18.20690667012046,133,9.600000000000019E-4
5,test_20231101_135928,11610969.png,368720,18957,349763,0.9485870036884356,2,4,84111,2787,81324,0.9668652138245889,23.972956444444446,3528.0835413333334,12.65541500646643,133,9.600000000000019E-4
6,test_20231101_135928,10350842.png,212614,2687,209927,0.9873620739932459,2,3,42529,393,42136,0.9907592466317101,26.303125333333334,4085.2473066666666,12.018620085258714,133,9.600000000000019E-4
7,test_20231101_135928,10863862.png,317432,6012,311420,0.9810605105975453,1,4,66058,884,65174,0.9866178207030185,37.291216,6937.797168,9.718587621197267,133,9.600000000000019E-4
8,test_20231101_135928,11382381.png,312486,547,311939,0.9982495215785667,1,3,46745,72,46673,0.9984597283131885,22.81680888888889,2740.878352,13.751906001286724,133,9.600000000000019E-4
9,test_20231101_135928,11079715.png,443815,98692,345123,0.7776280657481158,3,4,124136,13868,110268,0.8882838177482761,18.65887822222222,2560.3068,14.047883511952787,133,9.600000000000019E-4
10,test_20231101_135928,11551286.png,271883,24,271859,0.9999117267353972,1,3,40092,1,40091,0.9999750573680535,24.866876444444443,3470.407338666667,12.72699907819776,133,9.600000000000019E-4
1,test_20231101_135929,10404007.png,502730,13147,489583,0.9738487856304577,2,4,61265,1914,59351,0.9687586713457929,27.009216,3761.5794133333334,12.377101259214252,133,9.700000000000019E-4
2,test_20231101_135929,1254659.png,342646,59442,283204,0.8265206656432587,2,3,80080,8377,71703,0.8953921078921079,22.63763911111111,3744.3753706666666,12.397009809413873,133,9.700000000000019E-4
3,test_20231101_135929,10188041.png,221231,7502,213729,0.9660897432999896,2,3,41731,1066,40665,0.9744554407994057,12.387662222222222,1467.2519466666668,16.465756664846296,133,9.700000000000019E-4
4,test_20231101_135929,10287332.png,216980,10252,206728,0.9527514056595078,2,4,22337,1412,20925,0.9367864977391771,10.08100088888889,982.629264,18.20690667012046,133,9.700000000000019E-4
5,test_20231101_135929,11610969.png,368720,18957,349763,0.9485870036884356,2,4,84111,2787,81324,0.9668652138245889,23.972956444444446,3528.0835413333334,12.65541500646643,133,9.700000000000019E-4
6,test_20231101_135929,10350842.png,212614,2687,209927,0.9873620739932459,1,4,42529,393,42136,0.9907592466317101,26.303125333333334,4085.2473066666666,12.018620085258714,133,9.700000000000019E-4
7,test_20231101_135929,10863862.png,317432,6012,311420,0.9810605105975453,1,3,66058,884,65174,0.9866178207030185,37.291216,6937.797168,9.718587621197267,133,9.700000000000019E-4
8,test_20231101_135929,11382381.png,312486,547,311939,0.9982495215785667,1,4,46745,72,46673,0.9984597283131885,22.81680888888889,2740.878352,13.751906001286724,133,9.700000000000019E-4
9,test_20231101_135929,11079715.png,443815,98692,345123,0.7776280657481158,4,4,124136,13868,110268,0.8882838177482761,18.65887822222222,2560.3068,14.047883511952787,133,9.700000000000019E-4
10,test_20231101_135929,11551286.png,271883,24,271859,0.9999117267353972,1,4,40092,1,40091,0.9999750573680535,24.866876444444443,3470.407338666667,12.72699907819776,133,9.700000000000019E-4
1,test_20231101_135930,10404007.png,502730,12464,490266,0.975207367771965,2,4,61265,1816,59449,0.9703582796049947,27.089916444444444,3784.6046506666667,12.350598421577324,133,9.80000000000002E-4
2,test_20231101_135930,1254659.png,342646,58962,283684,0.8279215283412035,3,4,80080,8315,71765,0.8961663336663337,22.82140088888889,3788.5269973333334,12.346099744557197,133,9.80000000000002E-4
3,test_20231101_135930,10188041.png,221231,7379,213852,0.9666457232485501,2,3,41731,1056,40675,0.9746950708106683,12.39696,1468.128352,16.463163351730042,133,9.80000000000002E-4
4,test_20231101_135930,10287332.png,216980,10172,206808,0.9531201032353213,1,3,22337,1400,20937,0.9373237229708555,10.106561777777777,986.7992373333333,18.1885155570288,133,9.80000000000002E-4
5,test_20231101_135930,11610969.png,368720,18614,350106,0.9495172488609243,2,4,84111,2739,81372,0.9674358882904733,24.283783111111113,3581.063690666667,12.590683156842386,133,9.80000000000002E-4
6,test_20231101_135930,10350842.png,212614,2427,210187,0.9885849473694113,1,4,42529,356,42173,0.9916292412236356,26.460931555555554,4113.9235733333335,11.988241415665488,133,9.80000000000002E-4
7,test_20231101_135930,10863862.png,317432,5912,311520,0.9813755386980518,2,4,66058,869,65189,0.9868448938811347,37.41166755555555,6964.58216,9.70185294817149,133,9.80000000000002E-4
8,test_20231101_135930,11382381.png,312486,367,312119,0.9988255473845228,1,4,46745,48,46697,0.9989731522087923,23.28773511111111,2886.24232,13.527475705549977,133,9.80000000000002E-4
9,test_20231101_135930,11079715.png,443815,98592,345223,0.7778533848563027,3,5,124136,13858,110278,0.8883643745569375,18.696275555555555,2565.239973333333,14.039523620947072,133,9.80000000000002E-4
10,test_20231101_135930,11551286.png,271883,24,271859,0.9999117267353972,0,3,40092,1,40091,0.9999750573680535,24.866876444444443,3470.407338666667,12.72699907819776,133,9.80000000000002E-4
1,test_20231101_135930,10404007.png,502730,12464,490266,0.975207367771965,1,3,61265,1816,59449,0.9703582796049947,27.089916444444444,3784.6046506666667,12.350598421577324,133,9.90000000000002E-4
2,test_20231101_135930,1254659.png,342646,58962,283684,0.8279215283412035,2,3,80080,8315,71765,0.8961663336663337,22.82140088888889,3788.5269973333334,12.346099744557197,133,9.90000000000002E-4
3,test_20231101_135930,10188041.png,221231,7379,213852,0.9666457232485501,2,3,41731,1056,40675,0.9746950708106683,12.39696,1468.128352,16.463163351730042,133,9.90000000000002E-4
4,test_20231101_135930,10287332.png,216980,10172,206808,0.9531201032353213,2,4,22337,1400,20937,0.9373237229708555,10.106561777777777,986.7992373333333,18.1885155570288,133,9.90000000000002E-4
5,test_20231101_135930,11610969.png,368720,18614,350106,0.9495172488609243,2,4,84111,2739,81372,0.9674358882904733,24.283783111111113,3581.063690666667,12.590683156842386,133,9.90000000000002E-4
6,test_20231101_135930,10350842.png,212614,2427,210187,0.9885849473694113,2,4,42529,356,42173,0.9916292412236356,26.460931555555554,4113.9235733333335,11.988241415665488,133,9.90000000000002E-4
7,test_20231101_135930,10863862.png,317432,5912,311520,0.9813755386980518,1,5,66058,869,65189,0.9868448938811347,37.41166755555555,6964.58216,9.70185294817149,133,9.90000000000002E-4
8,test_20231101_135930,11382381.png,312486,367,312119,0.9988255473845228,1,4,46745,48,46697,0.9989731522087923,23.28773511111111,2886.24232,13.527475705549977,133,9.90000000000002E-4
9,test_20231101_135930,11079715.png,443815,98592,345223,0.7778533848563027,3,5,124136,13858,110278,0.8883643745569375,18.696275555555555,2565.239973333333,14.039523620947072,133,9.90000000000002E-4
10,test_20231101_135930,11551286.png,271883,24,271859,0.9999117267353972,1,3,40092,1,40091,0.9999750573680535,24.866876444444443,3470.407338666667,12.72699907819776,133,9.90000000000002E-4
1,test_20231101_135931,10404007.png,502730,12787,489943,0.9745648757782508,2,4,61265,1869,59396,0.9694931853423652,26.516264888888887,3659.1609973333334,12.496988426862345,134,0.0
2,test_20231101_135931,1254659.png,342646,57112,285534,0.8333206866561991,3,4,80080,8046,72034,0.8995254745254745,22.946245333333334,3855.036016,12.270519210290555,134,0.0
3,test_20231101_135931,10188041.png,221231,7542,213689,0.9659089368126529,1,3,41731,1070,40661,0.9743595887949007,12.04232,1422.4973813333334,16.60028885290102,134,0.0
4,test_20231101_135931,10287332.png,216980,10122,206858,0.9533505392202046,1,3,22337,1393,20944,0.9376371043560012,10.011550222222223,977.165808,18.231120986949595,134,0.0
5,test_20231101_135931,11610969.png,368720,18252,350468,0.9504990236493817,2,3,84111,2682,81429,0.968113564218711,23.600170666666667,3494.751157333333,12.696641034884948,134,0.0
6,test_20231101_135931,10350842.png,212614,3832,208782,0.9819767277789797,1,3,42529,563,41966,0.9867619741823227,20.466149333333334,2642.7065866666667,13.910314137276194,134,0.0
7,test_20231101_135931,10863862.png,317432,6234,311198,0.9803611482144208,1,3,66058,916,65142,0.9861333979230373,36.010332444444444,6595.3394026666665,9.938432111883285,134,0.0
8,test_20231101_135931,11382381.png,312486,787,311699,0.9974814871706252,2,3,46745,107,46638,0.9977109851320997,20.595329777777778,2391.5028426666668,14.344094594342474,134,0.0
9,test_20231101_135931,11079715.png,443815,96804,347011,0.7818820905106858,4,4,124136,13603,110533,0.8904185731778049,18.573955555555557,2560.8911893333334,14.046892349086676,134,0.0
10,test_20231101_135931,11551286.png,271883,557,271326,0.9979513246506769,2,4,40092,80,40012,0.9980045894442782,17.47336888888889,1793.4866346666668,15.593822162719512,134,0.0
1,test_20231101_135932,10404007.png,502730,12787,489943,0.9745648757782508,2,4,61265,1869,59396,0.9694931853423652,26.516264888888887,3659.1609973333334,12.496988426862345,134,1.0E-5
2,test_20231101_135932,1254659.png,342646,57112,285534,0.8333206866561991,2,4,80080,8046,72034,0.8995254745254745,22.946245333333334,3855.036016,12.270519210290555,134,1.0E-5
3,test_20231101_135932,10188041.png,221231,7542,213689,0.9659089368126529,2,4,41731,1070,40661,0.9743595887949007,12.04232,1422.4973813333334,16.60028885290102,134,1.0E-5
4,test_20231101_135932,10287332.png,216980,10122,206858,0.9533505392202046,2,7,22337,1393,20944,0.9376371043560012,10.011550222222223,977.165808,18.231120986949595,134,1.0E-5
5,test_20231101_135932,11610969.png,368720,18252,350468,0.9504990236493817,2,4,84111,2682,81429,0.968113564218711,23.600170666666667,3494.751157333333,12.696641034884948,134,1.0E-5
6,test_20231101_135932,10350842.png,212614,3832,208782,0.9819767277789797,1,4,42529,563,41966,0.9867619741823227,20.466149333333334,2642.7065866666667,13.910314137276194,134,1.0E-5
7,test_20231101_135932,10863862.png,317432,6234,311198,0.9803611482144208,2,3,66058,916,65142,0.9861333979230373,36.010332444444444,6595.3394026666665,9.938432111883285,134,1.0E-5
8,test_20231101_135932,11382381.png,312486,787,311699,0.9974814871706252,1,3,46745,107,46638,0.9977109851320997,20.595329777777778,2391.5028426666668,14.344094594342474,134,1.0E-5
9,test_20231101_135932,11079715.png,443815,96804,347011,0.7818820905106858,3,4,124136,13603,110533,0.8904185731778049,18.573955555555557,2560.8911893333334,14.046892349086676,134,1.0E-5
10,test_20231101_135932,11551286.png,271883,557,271326,0.9979513246506769,1,3,40092,80,40012,0.9980045894442782,17.47336888888889,1793.4866346666668,15.593822162719512,134,1.0E-5
1,test_20231101_135932,10404007.png,502730,12787,489943,0.9745648757782508,2,3,61265,1869,59396,0.9694931853423652,26.516264888888887,3659.1609973333334,12.496988426862345,134,2.0E-5
2,test_20231101_135932,1254659.png,342646,57112,285534,0.8333206866561991,3,4,80080,8046,72034,0.8995254745254745,22.946245333333334,3855.036016,12.270519210290555,134,2.0E-5
3,test_20231101_135932,10188041.png,221231,7542,213689,0.9659089368126529,2,4,41731,1070,40661,0.9743595887949007,12.04232,1422.4973813333334,16.60028885290102,134,2.0E-5
4,test_20231101_135932,10287332.png,216980,10122,206858,0.9533505392202046,2,3,22337,1393,20944,0.9376371043560012,10.011550222222223,977.165808,18.231120986949595,134,2.0E-5
5,test_20231101_135932,11610969.png,368720,18252,350468,0.9504990236493817,2,3,84111,2682,81429,0.968113564218711,23.600170666666667,3494.751157333333,12.696641034884948,134,2.0E-5
6,test_20231101_135932,10350842.png,212614,3832,208782,0.9819767277789797,2,3,42529,563,41966,0.9867619741823227,20.466149333333334,2642.7065866666667,13.910314137276194,134,2.0E-5
7,test_20231101_135932,10863862.png,317432,6234,311198,0.9803611482144208,1,3,66058,916,65142,0.9861333979230373,36.010332444444444,6595.3394026666665,9.938432111883285,134,2.0E-5
8,test_20231101_135932,11382381.png,312486,777,311709,0.9975134886042895,2,6,46745,106,46639,0.9977323777944165,21.325146666666665,2490.063653333333,14.168699117890078,134,2.0E-5
9,test_20231101_135932,11079715.png,443815,96804,347011,0.7818820905106858,3,4,124136,13603,110533,0.8904185731778049,18.573955555555557,2560.8911893333334,14.046892349086676,134,2.0E-5
10,test_20231101_135932,11551286.png,271883,557,271326,0.9979513246506769,2,8,40092,80,40012,0.9980045894442782,17.47336888888889,1793.4866346666668,15.593822162719512,134,2.0E-5
1,test_20231101_135933,10404007.png,502730,12787,489943,0.9745648757782508,2,4,61265,1869,59396,0.9694931853423652,26.516264888888887,3659.1609973333334,12.496988426862345,134,3.0000000000000004E-5
2,test_20231101_135933,1254659.png,342646,57112,285534,0.8333206866561991,2,4,80080,8046,72034,0.8995254745254745,22.946245333333334,3855.036016,12.270519210290555,134,3.0000000000000004E-5
3,test_20231101_135933,10188041.png,221231,7542,213689,0.9659089368126529,2,4,41731,1070,40661,0.9743595887949007,12.04232,1422.4973813333334,16.60028885290102,134,3.0000000000000004E-5
4,test_20231101_135933,10287332.png,216980,10122,206858,0.9533505392202046,1,3,22337,1393,20944,0.9376371043560012,10.011550222222223,977.165808,18.231120986949595,134,3.0000000000000004E-5
5,test_20231101_135933,11610969.png,368720,18252,350468,0.9504990236493817,2,4,84111,2682,81429,0.968113564218711,23.600170666666667,3494.751157333333,12.696641034884948,134,3.0000000000000004E-5
6,test_20231101_135933,10350842.png,212614,3832,208782,0.9819767277789797,1,4,42529,563,41966,0.9867619741823227,20.466149333333334,2642.7065866666667,13.910314137276194,134,3.0000000000000004E-5
7,test_20231101_135933,10863862.png,317432,6234,311198,0.9803611482144208,2,4,66058,916,65142,0.9861333979230373,36.010332444444444,6595.3394026666665,9.938432111883285,134,3.0000000000000004E-5
8,test_20231101_135933,11382381.png,312486,777,311709,0.9975134886042895,2,4,46745,106,46639,0.9977323777944165,21.325146666666665,2490.063653333333,14.168699117890078,134,3.0000000000000004E-5
9,test_20231101_135933,11079715.png,443815,96804,347011,0.7818820905106858,3,3,124136,13603,110533,0.8904185731778049,18.573955555555557,2560.8911893333334,14.046892349086676,134,3.0000000000000004E-5
10,test_20231101_135933,11551286.png,271883,557,271326,0.9979513246506769,1,3,40092,80,40012,0.9980045894442782,17.47336888888889,1793.4866346666668,15.593822162719512,134,3.0000000000000004E-5
1,test_20231101_135934,10404007.png,502730,12787,489943,0.9745648757782508,2,3,61265,1869,59396,0.9694931853423652,26.516264888888887,3659.1609973333334,12.496988426862345,134,4.0E-5
2,test_20231101_135934,1254659.png,342646,57112,285534,0.8333206866561991,2,3,80080,8046,72034,0.8995254745254745,22.946245333333334,3855.036016,12.270519210290555,134,4.0E-5
3,test_20231101_135934,10188041.png,221231,7542,213689,0.9659089368126529,2,4,41731,1070,40661,0.9743595887949007,12.04232,1422.4973813333334,16.60028885290102,134,4.0E-5
4,test_20231101_135934,10287332.png,216980,10122,206858,0.9533505392202046,1,4,22337,1393,20944,0.9376371043560012,10.011550222222223,977.165808,18.231120986949595,134,4.0E-5
5,test_20231101_135934,11610969.png,368720,18252,350468,0.9504990236493817,2,3,84111,2682,81429,0.968113564218711,23.600170666666667,3494.751157333333,12.696641034884948,134,4.0E-5
6,test_20231101_135934,10350842.png,212614,3832,208782,0.9819767277789797,1,4,42529,563,41966,0.9867619741823227,20.466149333333334,2642.7065866666667,13.910314137276194,134,4.0E-5
7,test_20231101_135934,10863862.png,317432,6234,311198,0.9803611482144208,1,4,66058,916,65142,0.9861333979230373,36.010332444444444,6595.3394026666665,9.938432111883285,134,4.0E-5
8,test_20231101_135934,11382381.png,312486,777,311709,0.9975134886042895,2,4,46745,106,46639,0.9977323777944165,21.325146666666665,2490.063653333333,14.168699117890078,134,4.0E-5
9,test_20231101_135934,11079715.png,443815,96804,347011,0.7818820905106858,3,4,124136,13603,110533,0.8904185731778049,18.573955555555557,2560.8911893333334,14.046892349086676,134,4.0E-5
10,test_20231101_135934,11551286.png,271883,557,271326,0.9979513246506769,1,4,40092,80,40012,0.9980045894442782,17.47336888888889,1793.4866346666668,15.593822162719512,134,4.0E-5
1,test_20231101_135934,10404007.png,502730,12787,489943,0.9745648757782508,2,4,61265,1869,59396,0.9694931853423652,26.516264888888887,3659.1609973333334,12.496988426862345,134,5.0E-5
2,test_20231101_135934,1254659.png,342646,57112,285534,0.8333206866561991,2,4,80080,8046,72034,0.8995254745254745,22.946245333333334,3855.036016,12.270519210290555,134,5.0E-5
3,test_20231101_135934,10188041.png,221231,7542,213689,0.9659089368126529,2,3,41731,1070,40661,0.9743595887949007,12.04232,1422.4973813333334,16.60028885290102,134,5.0E-5
4,test_20231101_135934,10287332.png,216980,10122,206858,0.9533505392202046,2,4,22337,1393,20944,0.9376371043560012,10.011550222222223,977.165808,18.231120986949595,134,5.0E-5
5,test_20231101_135934,11610969.png,368720,18252,350468,0.9504990236493817,2,4,84111,2682,81429,0.968113564218711,23.600170666666667,3494.751157333333,12.696641034884948,134,5.0E-5
6,test_20231101_135934,10350842.png,212614,3832,208782,0.9819767277789797,2,4,42529,563,41966,0.9867619741823227,20.466149333333334,2642.7065866666667,13.910314137276194,134,5.0E-5
7,test_20231101_135934,10863862.png,317432,6234,311198,0.9803611482144208,2,3,66058,916,65142,0.9861333979230373,36.010332444444444,6595.3394026666665,9.938432111883285,134,5.0E-5
8,test_20231101_135934,11382381.png,312486,777,311709,0.9975134886042895,2,3,46745,106,46639,0.9977323777944165,21.325146666666665,2490.063653333333,14.168699117890078,134,5.0E-5
9,test_20231101_135934,11079715.png,443815,96804,347011,0.7818820905106858,4,4,124136,13603,110533,0.8904185731778049,18.573955555555557,2560.8911893333334,14.046892349086676,134,5.0E-5
10,test_20231101_135934,11551286.png,271883,557,271326,0.9979513246506769,1,4,40092,80,40012,0.9980045894442782,17.47336888888889,1793.4866346666668,15.593822162719512,134,5.0E-5
1,test_20231101_135935,10404007.png,502730,12787,489943,0.9745648757782508,2,4,61265,1869,59396,0.9694931853423652,26.516264888888887,3659.1609973333334,12.496988426862345,134,6.0E-5
2,test_20231101_135935,1254659.png,342646,57112,285534,0.8333206866561991,3,4,80080,8046,72034,0.8995254745254745,22.946245333333334,3855.036016,12.270519210290555,134,6.0E-5
3,test_20231101_135935,10188041.png,221231,7542,213689,0.9659089368126529,2,4,41731,1070,40661,0.9743595887949007,12.04232,1422.4973813333334,16.60028885290102,134,6.0E-5
4,test_20231101_135935,10287332.png,216980,10122,206858,0.9533505392202046,5,5,22337,1393,20944,0.9376371043560012,10.011550222222223,977.165808,18.231120986949595,134,6.0E-5
5,test_20231101_135935,11610969.png,368720,18252,350468,0.9504990236493817,2,4,84111,2682,81429,0.968113564218711,23.600170666666667,3494.751157333333,12.696641034884948,134,6.0E-5
6,test_20231101_135935,10350842.png,212614,3832,208782,0.9819767277789797,1,3,42529,563,41966,0.9867619741823227,20.466149333333334,2642.7065866666667,13.910314137276194,134,6.0E-5
7,test_20231101_135935,10863862.png,317432,6234,311198,0.9803611482144208,1,3,66058,916,65142,0.9861333979230373,36.010332444444444,6595.3394026666665,9.938432111883285,134,6.0E-5
8,test_20231101_135935,11382381.png,312486,777,311709,0.9975134886042895,1,4,46745,106,46639,0.9977323777944165,21.325146666666665,2490.063653333333,14.168699117890078,134,6.0E-5
9,test_20231101_135935,11079715.png,443815,96804,347011,0.7818820905106858,3,4,124136,13603,110533,0.8904185731778049,18.573955555555557,2560.8911893333334,14.046892349086676,134,6.0E-5
10,test_20231101_135935,11551286.png,271883,557,271326,0.9979513246506769,1,4,40092,80,40012,0.9980045894442782,17.47336888888889,1793.4866346666668,15.593822162719512,134,6.0E-5
1,test_20231101_135936,10404007.png,502730,12787,489943,0.9745648757782508,2,3,61265,1869,59396,0.9694931853423652,26.516264888888887,3659.1609973333334,12.496988426862345,134,7.000000000000001E-5
2,test_20231101_135936,1254659.png,342646,57112,285534,0.8333206866561991,3,4,80080,8046,72034,0.8995254745254745,22.946245333333334,3855.036016,12.270519210290555,134,7.000000000000001E-5
3,test_20231101_135936,10188041.png,221231,7542,213689,0.9659089368126529,2,3,41731,1070,40661,0.9743595887949007,12.04232,1422.4973813333334,16.60028885290102,134,7.000000000000001E-5
4,test_20231101_135936,10287332.png,216980,10122,206858,0.9533505392202046,2,4,22337,1393,20944,0.9376371043560012,10.011550222222223,977.165808,18.231120986949595,134,7.000000000000001E-5
5,test_20231101_135936,11610969.png,368720,18252,350468,0.9504990236493817,2,3,84111,2682,81429,0.968113564218711,23.600170666666667,3494.751157333333,12.696641034884948,134,7.000000000000001E-5
6,test_20231101_135936,10350842.png,212614,3712,208902,0.9825411308756714,1,3,42529,545,41984,0.9871852147946107,22.243114666666667,3134.937568,13.168514645506416,134,7.000000000000001E-5
7,test_20231101_135936,10863862.png,317432,6234,311198,0.9803611482144208,2,4,66058,916,65142,0.9861333979230373,36.010332444444444,6595.3394026666665,9.938432111883285,134,7.000000000000001E-5
8,test_20231101_135936,11382381.png,312486,777,311709,0.9975134886042895,1,3,46745,106,46639,0.9977323777944165,21.325146666666665,2490.063653333333,14.168699117890078,134,7.000000000000001E-5
9,test_20231101_135936,11079715.png,443815,96804,347011,0.7818820905106858,5,4,124136,13603,110533,0.8904185731778049,18.573955555555557,2560.8911893333334,14.046892349086676,134,7.000000000000001E-5
10,test_20231101_135936,11551286.png,271883,417,271466,0.9984662520275266,2,3,40092,59,40033,0.9985283847151551,17.799701333333335,1844.591488,15.471801606446313,134,7.000000000000001E-5
1,test_20231101_135936,10404007.png,502730,12787,489943,0.9745648757782508,2,3,61265,1869,59396,0.9694931853423652,26.516264888888887,3659.1609973333334,12.496988426862345,134,8.0E-5
2,test_20231101_135936,1254659.png,342646,57112,285534,0.8333206866561991,3,4,80080,8046,72034,0.8995254745254745,22.946245333333334,3855.036016,12.270519210290555,134,8.0E-5
3,test_20231101_135936,10188041.png,221231,7542,213689,0.9659089368126529,2,3,41731,1070,40661,0.9743595887949007,12.04232,1422.4973813333334,16.60028885290102,134,8.0E-5
4,test_20231101_135936,10287332.png,216980,10122,206858,0.9533505392202046,2,4,22337,1393,20944,0.9376371043560012,10.011550222222223,977.165808,18.231120986949595,134,8.0E-5
5,test_20231101_135936,11610969.png,368720,18252,350468,0.9504990236493817,2,4,84111,2682,81429,0.968113564218711,23.600170666666667,3494.751157333333,12.696641034884948,134,8.0E-5
6,test_20231101_135936,10350842.png,212614,3712,208902,0.9825411308756714,2,3,42529,545,41984,0.9871852147946107,22.243114666666667,3134.937568,13.168514645506416,134,8.0E-5
7,test_20231101_135936,10863862.png,317432,6234,311198,0.9803611482144208,2,4,66058,916,65142,0.9861333979230373,36.010332444444444,6595.3394026666665,9.938432111883285,134,8.0E-5
8,test_20231101_135936,11382381.png,312486,757,311729,0.9975774914716179,1,4,46745,103,46642,0.997796555781367,22.081843555555555,2635.736901333333,13.921783039602623,134,8.0E-5
9,test_20231101_135936,11079715.png,443815,96804,347011,0.7818820905106858,3,4,124136,13603,110533,0.8904185731778049,18.573955555555557,2560.8911893333334,14.046892349086676,134,8.0E-5
10,test_20231101_135936,11551286.png,271883,417,271466,0.9984662520275266,1,3,40092,59,40033,0.9985283847151551,17.799701333333335,1844.591488,15.471801606446313,134,8.0E-5
1,test_20231101_135937,10404007.png,502730,12787,489943,0.9745648757782508,2,4,61265,1869,59396,0.9694931853423652,26.516264888888887,3659.1609973333334,12.496988426862345,134,9.0E-5
2,test_20231101_135937,1254659.png,342646,57112,285534,0.8333206866561991,2,4,80080,8046,72034,0.8995254745254745,22.946245333333334,3855.036016,12.270519210290555,134,9.0E-5
3,test_20231101_135937,10188041.png,221231,7542,213689,0.9659089368126529,1,3,41731,1070,40661,0.9743595887949007,12.04232,1422.4973813333334,16.60028885290102,134,9.0E-5
4,test_20231101_135937,10287332.png,216980,10122,206858,0.9533505392202046,3,4,22337,1393,20944,0.9376371043560012,10.011550222222223,977.165808,18.231120986949595,134,9.0E-5
5,test_20231101_135937,11610969.png,368720,18252,350468,0.9504990236493817,2,3,84111,2682,81429,0.968113564218711,23.600170666666667,3494.751157333333,12.696641034884948,134,9.0E-5
6,test_20231101_135937,10350842.png,212614,3712,208902,0.9825411308756714,1,4,42529,545,41984,0.9871852147946107,22.243114666666667,3134.937568,13.168514645506416,134,9.0E-5
7,test_20231101_135937,10863862.png,317432,6234,311198,0.9803611482144208,2,4,66058,916,65142,0.9861333979230373,36.010332444444444,6595.3394026666665,9.938432111883285,134,9.0E-5
8,test_20231101_135937,11382381.png,312486,757,311729,0.9975774914716179,1,4,46745,103,46642,0.997796555781367,22.081843555555555,2635.736901333333,13.921783039602623,134,9.0E-5
9,test_20231101_135937,11079715.png,443815,96804,347011,0.7818820905106858,3,4,124136,13603,110533,0.8904185731778049,18.573955555555557,2560.8911893333334,14.046892349086676,134,9.0E-5
10,test_20231101_135937,11551286.png,271883,417,271466,0.9984662520275266,2,3,40092,59,40033,0.9985283847151551,17.799701333333335,1844.591488,15.471801606446313,134,9.0E-5
1,test_20231101_135938,10404007.png,502730,12787,489943,0.9745648757782508,2,4,61265,1869,59396,0.9694931853423652,26.516264888888887,3659.1609973333334,12.496988426862345,134,1.0E-4
2,test_20231101_135938,1254659.png,342646,57112,285534,0.8333206866561991,3,4,80080,8046,72034,0.8995254745254745,22.946245333333334,3855.036016,12.270519210290555,134,1.0E-4
3,test_20231101_135938,10188041.png,221231,7542,213689,0.9659089368126529,2,4,41731,1070,40661,0.9743595887949007,12.04232,1422.4973813333334,16.60028885290102,134,1.0E-4
4,test_20231101_135938,10287332.png,216980,10122,206858,0.9533505392202046,2,3,22337,1393,20944,0.9376371043560012,10.011550222222223,977.165808,18.231120986949595,134,1.0E-4
5,test_20231101_135938,11610969.png,368720,18252,350468,0.9504990236493817,2,3,84111,2682,81429,0.968113564218711,23.600170666666667,3494.751157333333,12.696641034884948,134,1.0E-4
6,test_20231101_135938,10350842.png,212614,3712,208902,0.9825411308756714,2,3,42529,545,41984,0.9871852147946107,22.243114666666667,3134.937568,13.168514645506416,134,1.0E-4
7,test_20231101_135938,10863862.png,317432,6234,311198,0.9803611482144208,2,4,66058,916,65142,0.9861333979230373,36.010332444444444,6595.3394026666665,9.938432111883285,134,1.0E-4
8,test_20231101_135938,11382381.png,312486,757,311729,0.9975774914716179,1,4,46745,103,46642,0.997796555781367,22.081843555555555,2635.736901333333,13.921783039602623,134,1.0E-4
9,test_20231101_135938,11079715.png,443815,96804,347011,0.7818820905106858,3,4,124136,13603,110533,0.8904185731778049,18.573955555555557,2560.8911893333334,14.046892349086676,134,1.0E-4
10,test_20231101_135938,11551286.png,271883,417,271466,0.9984662520275266,1,3,40092,59,40033,0.9985283847151551,17.799701333333335,1844.591488,15.471801606446313,134,1.0E-4
1,test_20231101_135938,10404007.png,502730,12787,489943,0.9745648757782508,2,4,61265,1869,59396,0.9694931853423652,26.516264888888887,3659.1609973333334,12.496988426862345,134,1.1E-4
2,test_20231101_135938,1254659.png,342646,57112,285534,0.8333206866561991,2,4,80080,8046,72034,0.8995254745254745,22.946245333333334,3855.036016,12.270519210290555,134,1.1E-4
3,test_20231101_135938,10188041.png,221231,7542,213689,0.9659089368126529,2,4,41731,1070,40661,0.9743595887949007,12.04232,1422.4973813333334,16.60028885290102,134,1.1E-4
4,test_20231101_135938,10287332.png,216980,10122,206858,0.9533505392202046,2,4,22337,1393,20944,0.9376371043560012,10.011550222222223,977.165808,18.231120986949595,134,1.1E-4
5,test_20231101_135938,11610969.png,368720,18252,350468,0.9504990236493817,2,4,84111,2682,81429,0.968113564218711,23.600170666666667,3494.751157333333,12.696641034884948,134,1.1E-4
6,test_20231101_135938,10350842.png,212614,3712,208902,0.9825411308756714,1,4,42529,545,41984,0.9871852147946107,22.243114666666667,3134.937568,13.168514645506416,134,1.1E-4
7,test_20231101_135938,10863862.png,317432,6234,311198,0.9803611482144208,2,5,66058,916,65142,0.9861333979230373,36.010332444444444,6595.3394026666665,9.938432111883285,134,1.1E-4
8,test_20231101_135938,11382381.png,312486,757,311729,0.9975774914716179,2,4,46745,103,46642,0.997796555781367,22.081843555555555,2635.736901333333,13.921783039602623,134,1.1E-4
9,test_20231101_135938,11079715.png,443815,96804,347011,0.7818820905106858,4,4,124136,13603,110533,0.8904185731778049,18.573955555555557,2560.8911893333334,14.046892349086676,134,1.1E-4
10,test_20231101_135938,11551286.png,271883,417,271466,0.9984662520275266,1,4,40092,59,40033,0.9985283847151551,17.799701333333335,1844.591488,15.471801606446313,134,1.1E-4
1,test_20231101_135939,10404007.png,502730,12787,489943,0.9745648757782508,2,3,61265,1869,59396,0.9694931853423652,26.516264888888887,3659.1609973333334,12.496988426862345,134,1.2E-4
2,test_20231101_135939,1254659.png,342646,57112,285534,0.8333206866561991,3,4,80080,8046,72034,0.8995254745254745,22.946245333333334,3855.036016,12.270519210290555,134,1.2E-4
3,test_20231101_135939,10188041.png,221231,7542,213689,0.9659089368126529,2,4,41731,1070,40661,0.9743595887949007,12.04232,1422.4973813333334,16.60028885290102,134,1.2E-4
4,test_20231101_135939,10287332.png,216980,10122,206858,0.9533505392202046,2,4,22337,1393,20944,0.9376371043560012,10.011550222222223,977.165808,18.231120986949595,134,1.2E-4
5,test_20231101_135939,11610969.png,368720,18252,350468,0.9504990236493817,2,4,84111,2682,81429,0.968113564218711,23.600170666666667,3494.751157333333,12.696641034884948,134,1.2E-4
6,test_20231101_135939,10350842.png,212614,3712,208902,0.9825411308756714,2,3,42529,545,41984,0.9871852147946107,22.243114666666667,3134.937568,13.168514645506416,134,1.2E-4
7,test_20231101_135939,10863862.png,317432,6234,311198,0.9803611482144208,1,4,66058,916,65142,0.9861333979230373,36.010332444444444,6595.3394026666665,9.938432111883285,134,1.2E-4
8,test_20231101_135939,11382381.png,312486,757,311729,0.9975774914716179,2,3,46745,103,46642,0.997796555781367,22.081843555555555,2635.736901333333,13.921783039602623,134,1.2E-4
9,test_20231101_135939,11079715.png,443815,96804,347011,0.7818820905106858,3,4,124136,13603,110533,0.8904185731778049,18.573955555555557,2560.8911893333334,14.046892349086676,134,1.2E-4
10,test_20231101_135939,11551286.png,271883,417,271466,0.9984662520275266,1,3,40092,59,40033,0.9985283847151551,17.799701333333335,1844.591488,15.471801606446313,134,1.2E-4
1,test_20231101_135940,10404007.png,502730,12787,489943,0.9745648757782508,2,4,61265,1869,59396,0.9694931853423652,26.516264888888887,3659.1609973333334,12.496988426862345,134,1.3000000000000002E-4
2,test_20231101_135940,1254659.png,342646,57112,285534,0.8333206866561991,3,4,80080,8046,72034,0.8995254745254745,22.946245333333334,3855.036016,12.270519210290555,134,1.3000000000000002E-4
3,test_20231101_135940,10188041.png,221231,7542,213689,0.9659089368126529,2,4,41731,1070,40661,0.9743595887949007,12.04232,1422.4973813333334,16.60028885290102,134,1.3000000000000002E-4
4,test_20231101_135940,10287332.png,216980,10122,206858,0.9533505392202046,2,4,22337,1393,20944,0.9376371043560012,10.011550222222223,977.165808,18.231120986949595,134,1.3000000000000002E-4
5,test_20231101_135940,11610969.png,368720,18252,350468,0.9504990236493817,2,4,84111,2682,81429,0.968113564218711,23.600170666666667,3494.751157333333,12.696641034884948,134,1.3000000000000002E-4
6,test_20231101_135940,10350842.png,212614,3712,208902,0.9825411308756714,2,3,42529,545,41984,0.9871852147946107,22.243114666666667,3134.937568,13.168514645506416,134,1.3000000000000002E-4
7,test_20231101_135940,10863862.png,317432,6234,311198,0.9803611482144208,1,3,66058,916,65142,0.9861333979230373,36.010332444444444,6595.3394026666665,9.938432111883285,134,1.3000000000000002E-4
8,test_20231101_135940,11382381.png,312486,647,311839,0.9979295072419244,2,3,46745,87,46658,0.9981388383784362,22.33832177777778,2675.8690666666666,13.85615501777858,134,1.3000000000000002E-4
9,test_20231101_135940,11079715.png,443815,96804,347011,0.7818820905106858,4,4,124136,13603,110533,0.8904185731778049,18.573955555555557,2560.8911893333334,14.046892349086676,134,1.3000000000000002E-4
10,test_20231101_135940,11551286.png,271883,417,271466,0.9984662520275266,2,4,40092,59,40033,0.9985283847151551,17.799701333333335,1844.591488,15.471801606446313,134,1.3000000000000002E-4
1,test_20231101_135940,10404007.png,502730,12787,489943,0.9745648757782508,2,3,61265,1869,59396,0.9694931853423652,26.516264888888887,3659.1609973333334,12.496988426862345,134,1.4000000000000001E-4
2,test_20231101_135940,1254659.png,342646,57112,285534,0.8333206866561991,3,4,80080,8046,72034,0.8995254745254745,22.946245333333334,3855.036016,12.270519210290555,134,1.4000000000000001E-4
3,test_20231101_135940,10188041.png,221231,7542,213689,0.9659089368126529,2,4,41731,1070,40661,0.9743595887949007,12.04232,1422.4973813333334,16.60028885290102,134,1.4000000000000001E-4
4,test_20231101_135940,10287332.png,216980,10122,206858,0.9533505392202046,2,4,22337,1393,20944,0.9376371043560012,10.011550222222223,977.165808,18.231120986949595,134,1.4000000000000001E-4
5,test_20231101_135940,11610969.png,368720,18252,350468,0.9504990236493817,2,4,84111,2682,81429,0.968113564218711,23.600170666666667,3494.751157333333,12.696641034884948,134,1.4000000000000001E-4
6,test_20231101_135940,10350842.png,212614,3712,208902,0.9825411308756714,1,4,42529,545,41984,0.9871852147946107,22.243114666666667,3134.937568,13.168514645506416,134,1.4000000000000001E-4
7,test_20231101_135940,10863862.png,317432,6234,311198,0.9803611482144208,2,3,66058,916,65142,0.9861333979230373,36.010332444444444,6595.3394026666665,9.938432111883285,134,1.4000000000000001E-4
8,test_20231101_135940,11382381.png,312486,647,311839,0.9979295072419244,1,3,46745,87,46658,0.9981388383784362,22.33832177777778,2675.8690666666666,13.85615501777858,134,1.4000000000000001E-4
9,test_20231101_135940,11079715.png,443815,96804,347011,0.7818820905106858,3,4,124136,13603,110533,0.8904185731778049,18.573955555555557,2560.8911893333334,14.046892349086676,134,1.4000000000000001E-4
10,test_20231101_135940,11551286.png,271883,417,271466,0.9984662520275266,1,4,40092,59,40033,0.9985283847151551,17.799701333333335,1844.591488,15.471801606446313,134,1.4000000000000001E-4
1,test_20231101_135941,10404007.png,502730,12787,489943,0.9745648757782508,2,3,61265,1869,59396,0.9694931853423652,26.516264888888887,3659.1609973333334,12.496988426862345,134,1.5000000000000001E-4
2,test_20231101_135941,1254659.png,342646,57112,285534,0.8333206866561991,3,4,80080,8046,72034,0.8995254745254745,22.946245333333334,3855.036016,12.270519210290555,134,1.5000000000000001E-4
3,test_20231101_135941,10188041.png,221231,7542,213689,0.9659089368126529,2,4,41731,1070,40661,0.9743595887949007,12.04232,1422.4973813333334,16.60028885290102,134,1.5000000000000001E-4
4,test_20231101_135941,10287332.png,216980,10122,206858,0.9533505392202046,2,3,22337,1393,20944,0.9376371043560012,10.011550222222223,977.165808,18.231120986949595,134,1.5000000000000001E-4
5,test_20231101_135941,11610969.png,368720,18252,350468,0.9504990236493817,2,4,84111,2682,81429,0.968113564218711,23.600170666666667,3494.751157333333,12.696641034884948,134,1.5000000000000001E-4
6,test_20231101_135941,10350842.png,212614,3712,208902,0.9825411308756714,1,4,42529,545,41984,0.9871852147946107,22.243114666666667,3134.937568,13.168514645506416,134,1.5000000000000001E-4
7,test_20231101_135941,10863862.png,317432,6234,311198,0.9803611482144208,2,4,66058,916,65142,0.9861333979230373,36.010332444444444,6595.3394026666665,9.938432111883285,134,1.5000000000000001E-4
8,test_20231101_135941,11382381.png,312486,647,311839,0.9979295072419244,1,4,46745,87,46658,0.9981388383784362,22.33832177777778,2675.8690666666666,13.85615501777858,134,1.5000000000000001E-4
9,test_20231101_135941,11079715.png,443815,96804,347011,0.7818820905106858,3,4,124136,13603,110533,0.8904185731778049,18.573955555555557,2560.8911893333334,14.046892349086676,134,1.5000000000000001E-4
10,test_20231101_135941,11551286.png,271883,417,271466,0.9984662520275266,1,4,40092,59,40033,0.9985283847151551,17.799701333333335,1844.591488,15.471801606446313,134,1.5000000000000001E-4
1,test_20231101_135942,10404007.png,502730,12787,489943,0.9745648757782508,2,4,61265,1869,59396,0.9694931853423652,26.516264888888887,3659.1609973333334,12.496988426862345,134,1.6E-4
2,test_20231101_135942,1254659.png,342646,57112,285534,0.8333206866561991,3,4,80080,8046,72034,0.8995254745254745,22.946245333333334,3855.036016,12.270519210290555,134,1.6E-4
3,test_20231101_135942,10188041.png,221231,7542,213689,0.9659089368126529,1,3,41731,1070,40661,0.9743595887949007,12.04232,1422.4973813333334,16.60028885290102,134,1.6E-4
4,test_20231101_135942,10287332.png,216980,9932,207048,0.9542261959627616,2,4,22337,1369,20968,0.938711554819358,10.139925333333334,1003.4804586666667,18.11571441220159,134,1.6E-4
5,test_20231101_135942,11610969.png,368720,18252,350468,0.9504990236493817,2,4,84111,2682,81429,0.968113564218711,23.600170666666667,3494.751157333333,12.696641034884948,134,1.6E-4
6,test_20231101_135942,10350842.png,212614,3712,208902,0.9825411308756714,1,4,42529,545,41984,0.9871852147946107,22.243114666666667,3134.937568,13.168514645506416,134,1.6E-4
7,test_20231101_135942,10863862.png,317432,6234,311198,0.9803611482144208,1,3,66058,916,65142,0.9861333979230373,36.010332444444444,6595.3394026666665,9.938432111883285,134,1.6E-4
8,test_20231101_135942,11382381.png,312486,647,311839,0.9979295072419244,1,3,46745,87,46658,0.9981388383784362,22.33832177777778,2675.8690666666666,13.85615501777858,134,1.6E-4
9,test_20231101_135942,11079715.png,443815,96804,347011,0.7818820905106858,3,6,124136,13603,110533,0.8904185731778049,18.573955555555557,2560.8911893333334,14.046892349086676,134,1.6E-4
10,test_20231101_135942,11551286.png,271883,417,271466,0.9984662520275266,1,3,40092,59,40033,0.9985283847151551,17.799701333333335,1844.591488,15.471801606446313,134,1.6E-4
1,test_20231101_135943,10404007.png,502730,12787,489943,0.9745648757782508,3,3,61265,1869,59396,0.9694931853423652,26.516264888888887,3659.1609973333334,12.496988426862345,134,1.7E-4
2,test_20231101_135943,1254659.png,342646,57112,285534,0.8333206866561991,3,4,80080,8046,72034,0.8995254745254745,22.946245333333334,3855.036016,12.270519210290555,134,1.7E-4
3,test_20231101_135943,10188041.png,221231,7542,213689,0.9659089368126529,2,3,41731,1070,40661,0.9743595887949007,12.04232,1422.4973813333334,16.60028885290102,134,1.7E-4
4,test_20231101_135943,10287332.png,216980,9932,207048,0.9542261959627616,1,4,22337,1369,20968,0.938711554819358,10.139925333333334,1003.4804586666667,18.11571441220159,134,1.7E-4
5,test_20231101_135943,11610969.png,368720,18252,350468,0.9504990236493817,2,4,84111,2682,81429,0.968113564218711,23.600170666666667,3494.751157333333,12.696641034884948,134,1.7E-4
6,test_20231101_135943,10350842.png,212614,3712,208902,0.9825411308756714,1,4,42529,545,41984,0.9871852147946107,22.243114666666667,3134.937568,13.168514645506416,134,1.7E-4
7,test_20231101_135943,10863862.png,317432,6234,311198,0.9803611482144208,1,4,66058,916,65142,0.9861333979230373,36.010332444444444,6595.3394026666665,9.938432111883285,134,1.7E-4
8,test_20231101_135943,11382381.png,312486,647,311839,0.9979295072419244,1,4,46745,87,46658,0.9981388383784362,22.33832177777778,2675.8690666666666,13.85615501777858,134,1.7E-4
9,test_20231101_135943,11079715.png,443815,96804,347011,0.7818820905106858,3,4,124136,13603,110533,0.8904185731778049,18.573955555555557,2560.8911893333334,14.046892349086676,134,1.7E-4
10,test_20231101_135943,11551286.png,271883,417,271466,0.9984662520275266,1,3,40092,59,40033,0.9985283847151551,17.799701333333335,1844.591488,15.471801606446313,134,1.7E-4
1,test_20231101_135943,10404007.png,502730,12787,489943,0.9745648757782508,2,3,61265,1869,59396,0.9694931853423652,26.516264888888887,3659.1609973333334,12.496988426862345,134,1.8E-4
2,test_20231101_135943,1254659.png,342646,57112,285534,0.8333206866561991,3,4,80080,8046,72034,0.8995254745254745,22.946245333333334,3855.036016,12.270519210290555,134,1.8E-4
3,test_20231101_135943,10188041.png,221231,7542,213689,0.9659089368126529,2,3,41731,1070,40661,0.9743595887949007,12.04232,1422.4973813333334,16.60028885290102,134,1.8E-4
4,test_20231101_135943,10287332.png,216980,9932,207048,0.9542261959627616,2,4,22337,1369,20968,0.938711554819358,10.139925333333334,1003.4804586666667,18.11571441220159,134,1.8E-4
5,test_20231101_135943,11610969.png,368720,18252,350468,0.9504990236493817,3,4,84111,2682,81429,0.968113564218711,23.600170666666667,3494.751157333333,12.696641034884948,134,1.8E-4
6,test_20231101_135943,10350842.png,212614,3712,208902,0.9825411308756714,2,4,42529,545,41984,0.9871852147946107,22.243114666666667,3134.937568,13.168514645506416,134,1.8E-4
7,test_20231101_135943,10863862.png,317432,6234,311198,0.9803611482144208,1,4,66058,916,65142,0.9861333979230373,36.010332444444444,6595.3394026666665,9.938432111883285,134,1.8E-4
8,test_20231101_135943,11382381.png,312486,647,311839,0.9979295072419244,1,4,46745,87,46658,0.9981388383784362,22.33832177777778,2675.8690666666666,13.85615501777858,134,1.8E-4
9,test_20231101_135943,11079715.png,443815,96804,347011,0.7818820905106858,3,4,124136,13603,110533,0.8904185731778049,18.573955555555557,2560.8911893333334,14.046892349086676,134,1.8E-4
10,test_20231101_135943,11551286.png,271883,204,271679,0.9992496772508763,3,4,40092,28,40064,0.9993016063054974,18.067507555555554,1885.468496,15.37661080624634,134,1.8E-4
1,test_20231101_135944,10404007.png,502730,12787,489943,0.9745648757782508,3,3,61265,1869,59396,0.9694931853423652,26.516264888888887,3659.1609973333334,12.496988426862345,134,1.9E-4
2,test_20231101_135944,1254659.png,342646,57112,285534,0.8333206866561991,3,4,80080,8046,72034,0.8995254745254745,22.946245333333334,3855.036016,12.270519210290555,134,1.9E-4
3,test_20231101_135944,10188041.png,221231,7542,213689,0.9659089368126529,2,4,41731,1070,40661,0.9743595887949007,12.04232,1422.4973813333334,16.60028885290102,134,1.9E-4
4,test_20231101_135944,10287332.png,216980,9932,207048,0.9542261959627616,1,4,22337,1369,20968,0.938711554819358,10.139925333333334,1003.4804586666667,18.11571441220159,134,1.9E-4
5,test_20231101_135944,11610969.png,368720,18252,350468,0.9504990236493817,2,3,84111,2682,81429,0.968113564218711,23.600170666666667,3494.751157333333,12.696641034884948,134,1.9E-4
6,test_20231101_135944,10350842.png,212614,3712,208902,0.9825411308756714,1,4,42529,545,41984,0.9871852147946107,22.243114666666667,3134.937568,13.168514645506416,134,1.9E-4
7,test_20231101_135944,10863862.png,317432,6234,311198,0.9803611482144208,2,4,66058,916,65142,0.9861333979230373,36.010332444444444,6595.3394026666665,9.938432111883285,134,1.9E-4
8,test_20231101_135944,11382381.png,312486,647,311839,0.9979295072419244,1,4,46745,87,46658,0.9981388383784362,22.33832177777778,2675.8690666666666,13.85615501777858,134,1.9E-4
9,test_20231101_135944,11079715.png,443815,96804,347011,0.7818820905106858,3,4,124136,13603,110533,0.8904185731778049,18.573955555555557,2560.8911893333334,14.046892349086676,134,1.9E-4
10,test_20231101_135944,11551286.png,271883,204,271679,0.9992496772508763,1,3,40092,28,40064,0.9993016063054974,18.067507555555554,1885.468496,15.37661080624634,134,1.9E-4
1,test_20231101_135945,10404007.png,502730,12787,489943,0.9745648757782508,2,4,61265,1869,59396,0.9694931853423652,26.516264888888887,3659.1609973333334,12.496988426862345,134,2.0E-4
2,test_20231101_135945,1254659.png,342646,57112,285534,0.8333206866561991,3,4,80080,8046,72034,0.8995254745254745,22.946245333333334,3855.036016,12.270519210290555,134,2.0E-4
3,test_20231101_135945,10188041.png,221231,7542,213689,0.9659089368126529,2,4,41731,1070,40661,0.9743595887949007,12.04232,1422.4973813333334,16.60028885290102,134,2.0E-4
4,test_20231101_135945,10287332.png,216980,9932,207048,0.9542261959627616,2,3,22337,1369,20968,0.938711554819358,10.139925333333334,1003.4804586666667,18.11571441220159,134,2.0E-4
5,test_20231101_135945,11610969.png,368720,18252,350468,0.9504990236493817,2,4,84111,2682,81429,0.968113564218711,23.600170666666667,3494.751157333333,12.696641034884948,134,2.0E-4
6,test_20231101_135945,10350842.png,212614,3712,208902,0.9825411308756714,2,4,42529,545,41984,0.9871852147946107,22.243114666666667,3134.937568,13.168514645506416,134,2.0E-4
7,test_20231101_135945,10863862.png,317432,6234,311198,0.9803611482144208,2,4,66058,916,65142,0.9861333979230373,36.010332444444444,6595.3394026666665,9.938432111883285,134,2.0E-4
8,test_20231101_135945,11382381.png,312486,647,311839,0.9979295072419244,1,4,46745,87,46658,0.9981388383784362,22.33832177777778,2675.8690666666666,13.85615501777858,134,2.0E-4
9,test_20231101_135945,11079715.png,443815,96804,347011,0.7818820905106858,4,4,124136,13603,110533,0.8904185731778049,18.573955555555557,2560.8911893333334,14.046892349086676,134,2.0E-4
10,test_20231101_135945,11551286.png,271883,204,271679,0.9992496772508763,1,4,40092,28,40064,0.9993016063054974,18.067507555555554,1885.468496,15.37661080624634,134,2.0E-4
1,test_20231101_135945,10404007.png,502730,12787,489943,0.9745648757782508,2,3,61265,1869,59396,0.9694931853423652,26.516264888888887,3659.1609973333334,12.496988426862345,134,2.1E-4
2,test_20231101_135945,1254659.png,342646,57112,285534,0.8333206866561991,2,3,80080,8046,72034,0.8995254745254745,22.946245333333334,3855.036016,12.270519210290555,134,2.1E-4
3,test_20231101_135945,10188041.png,221231,7542,213689,0.9659089368126529,2,14,41731,1070,40661,0.9743595887949007,12.04232,1422.4973813333334,16.60028885290102,134,2.1E-4
4,test_20231101_135945,10287332.png,216980,9932,207048,0.9542261959627616,2,3,22337,1369,20968,0.938711554819358,10.139925333333334,1003.4804586666667,18.11571441220159,134,2.1E-4
5,test_20231101_135945,11610969.png,368720,18252,350468,0.9504990236493817,3,4,84111,2682,81429,0.968113564218711,23.600170666666667,3494.751157333333,12.696641034884948,134,2.1E-4
6,test_20231101_135945,10350842.png,212614,3712,208902,0.9825411308756714,1,3,42529,545,41984,0.9871852147946107,22.243114666666667,3134.937568,13.168514645506416,134,2.1E-4
7,test_20231101_135945,10863862.png,317432,6234,311198,0.9803611482144208,1,4,66058,916,65142,0.9861333979230373,36.010332444444444,6595.3394026666665,9.938432111883285,134,2.1E-4
8,test_20231101_135945,11382381.png,312486,647,311839,0.9979295072419244,1,3,46745,87,46658,0.9981388383784362,22.33832177777778,2675.8690666666666,13.85615501777858,134,2.1E-4
9,test_20231101_135945,11079715.png,443815,96804,347011,0.7818820905106858,3,5,124136,13603,110533,0.8904185731778049,18.573955555555557,2560.8911893333334,14.046892349086676,134,2.1E-4
10,test_20231101_135945,11551286.png,271883,204,271679,0.9992496772508763,2,3,40092,28,40064,0.9993016063054974,18.067507555555554,1885.468496,15.37661080624634,134,2.1E-4
1,test_20231101_135946,10404007.png,502730,12787,489943,0.9745648757782508,2,3,61265,1869,59396,0.9694931853423652,26.516264888888887,3659.1609973333334,12.496988426862345,134,2.2E-4
2,test_20231101_135946,1254659.png,342646,57112,285534,0.8333206866561991,2,4,80080,8046,72034,0.8995254745254745,22.946245333333334,3855.036016,12.270519210290555,134,2.2E-4
3,test_20231101_135946,10188041.png,221231,7542,213689,0.9659089368126529,2,3,41731,1070,40661,0.9743595887949007,12.04232,1422.4973813333334,16.60028885290102,134,2.2E-4
4,test_20231101_135946,10287332.png,216980,9932,207048,0.9542261959627616,2,4,22337,1369,20968,0.938711554819358,10.139925333333334,1003.4804586666667,18.11571441220159,134,2.2E-4
5,test_20231101_135946,11610969.png,368720,18252,350468,0.9504990236493817,2,7,84111,2682,81429,0.968113564218711,23.600170666666667,3494.751157333333,12.696641034884948,134,2.2E-4
6,test_20231101_135946,10350842.png,212614,3712,208902,0.9825411308756714,1,4,42529,545,41984,0.9871852147946107,22.243114666666667,3134.937568,13.168514645506416,134,2.2E-4
7,test_20231101_135946,10863862.png,317432,6234,311198,0.9803611482144208,1,3,66058,916,65142,0.9861333979230373,36.010332444444444,6595.3394026666665,9.938432111883285,134,2.2E-4
8,test_20231101_135946,11382381.png,312486,647,311839,0.9979295072419244,1,4,46745,87,46658,0.9981388383784362,22.33832177777778,2675.8690666666666,13.85615501777858,134,2.2E-4
9,test_20231101_135946,11079715.png,443815,96804,347011,0.7818820905106858,3,4,124136,13603,110533,0.8904185731778049,18.573955555555557,2560.8911893333334,14.046892349086676,134,2.2E-4
10,test_20231101_135946,11551286.png,271883,204,271679,0.9992496772508763,1,3,40092,28,40064,0.9993016063054974,18.067507555555554,1885.468496,15.37661080624634,134,2.2E-4
1,test_20231101_135947,10404007.png,502730,12787,489943,0.9745648757782508,2,3,61265,1869,59396,0.9694931853423652,26.516264888888887,3659.1609973333334,12.496988426862345,134,2.3E-4
2,test_20231101_135947,1254659.png,342646,57112,285534,0.8333206866561991,3,4,80080,8046,72034,0.8995254745254745,22.946245333333334,3855.036016,12.270519210290555,134,2.3E-4
3,test_20231101_135947,10188041.png,221231,7542,213689,0.9659089368126529,2,4,41731,1070,40661,0.9743595887949007,12.04232,1422.4973813333334,16.60028885290102,134,2.3E-4
4,test_20231101_135947,10287332.png,216980,9932,207048,0.9542261959627616,1,3,22337,1369,20968,0.938711554819358,10.139925333333334,1003.4804586666667,18.11571441220159,134,2.3E-4
5,test_20231101_135947,11610969.png,368720,18252,350468,0.9504990236493817,2,4,84111,2682,81429,0.968113564218711,23.600170666666667,3494.751157333333,12.696641034884948,134,2.3E-4
6,test_20231101_135947,10350842.png,212614,3712,208902,0.9825411308756714,1,3,42529,545,41984,0.9871852147946107,22.243114666666667,3134.937568,13.168514645506416,134,2.3E-4
7,test_20231101_135947,10863862.png,317432,6234,311198,0.9803611482144208,1,4,66058,916,65142,0.9861333979230373,36.010332444444444,6595.3394026666665,9.938432111883285,134,2.3E-4
8,test_20231101_135947,11382381.png,312486,647,311839,0.9979295072419244,1,3,46745,87,46658,0.9981388383784362,22.33832177777778,2675.8690666666666,13.85615501777858,134,2.3E-4
9,test_20231101_135947,11079715.png,443815,96804,347011,0.7818820905106858,3,4,124136,13603,110533,0.8904185731778049,18.573955555555557,2560.8911893333334,14.046892349086676,134,2.3E-4
10,test_20231101_135947,11551286.png,271883,204,271679,0.9992496772508763,1,3,40092,28,40064,0.9993016063054974,18.067507555555554,1885.468496,15.37661080624634,134,2.3E-4
1,test_20231101_135947,10404007.png,502730,12787,489943,0.9745648757782508,3,4,61265,1869,59396,0.9694931853423652,26.516264888888887,3659.1609973333334,12.496988426862345,134,2.4E-4
2,test_20231101_135947,1254659.png,342646,57112,285534,0.8333206866561991,3,4,80080,8046,72034,0.8995254745254745,22.946245333333334,3855.036016,12.270519210290555,134,2.4E-4
3,test_20231101_135947,10188041.png,221231,7542,213689,0.9659089368126529,2,4,41731,1070,40661,0.9743595887949007,12.04232,1422.4973813333334,16.60028885290102,134,2.4E-4
4,test_20231101_135947,10287332.png,216980,9932,207048,0.9542261959627616,2,4,22337,1369,20968,0.938711554819358,10.139925333333334,1003.4804586666667,18.11571441220159,134,2.4E-4
5,test_20231101_135947,11610969.png,368720,18252,350468,0.9504990236493817,2,3,84111,2682,81429,0.968113564218711,23.600170666666667,3494.751157333333,12.696641034884948,134,2.4E-4
6,test_20231101_135947,10350842.png,212614,3712,208902,0.9825411308756714,1,4,42529,545,41984,0.9871852147946107,22.243114666666667,3134.937568,13.168514645506416,134,2.4E-4
7,test_20231101_135947,10863862.png,317432,6234,311198,0.9803611482144208,2,4,66058,916,65142,0.9861333979230373,36.010332444444444,6595.3394026666665,9.938432111883285,134,2.4E-4
8,test_20231101_135947,11382381.png,312486,647,311839,0.9979295072419244,2,3,46745,87,46658,0.9981388383784362,22.33832177777778,2675.8690666666666,13.85615501777858,134,2.4E-4
9,test_20231101_135947,11079715.png,443815,96804,347011,0.7818820905106858,3,4,124136,13603,110533,0.8904185731778049,18.573955555555557,2560.8911893333334,14.046892349086676,134,2.4E-4
10,test_20231101_135947,11551286.png,271883,204,271679,0.9992496772508763,2,4,40092,28,40064,0.9993016063054974,18.067507555555554,1885.468496,15.37661080624634,134,2.4E-4
1,test_20231101_135948,10404007.png,502730,12787,489943,0.9745648757782508,2,4,61265,1869,59396,0.9694931853423652,26.516264888888887,3659.1609973333334,12.496988426862345,134,2.5E-4
2,test_20231101_135948,1254659.png,342646,57112,285534,0.8333206866561991,3,4,80080,8046,72034,0.8995254745254745,22.946245333333334,3855.036016,12.270519210290555,134,2.5E-4
3,test_20231101_135948,10188041.png,221231,7542,213689,0.9659089368126529,2,4,41731,1070,40661,0.9743595887949007,12.04232,1422.4973813333334,16.60028885290102,134,2.5E-4
4,test_20231101_135948,10287332.png,216980,9932,207048,0.9542261959627616,1,3,22337,1369,20968,0.938711554819358,10.139925333333334,1003.4804586666667,18.11571441220159,134,2.5E-4
5,test_20231101_135948,11610969.png,368720,18252,350468,0.9504990236493817,2,3,84111,2682,81429,0.968113564218711,23.600170666666667,3494.751157333333,12.696641034884948,134,2.5E-4
6,test_20231101_135948,10350842.png,212614,3712,208902,0.9825411308756714,1,4,42529,545,41984,0.9871852147946107,22.243114666666667,3134.937568,13.168514645506416,134,2.5E-4
7,test_20231101_135948,10863862.png,317432,6234,311198,0.9803611482144208,1,4,66058,916,65142,0.9861333979230373,36.010332444444444,6595.3394026666665,9.938432111883285,134,2.5E-4
8,test_20231101_135948,11382381.png,312486,647,311839,0.9979295072419244,1,3,46745,87,46658,0.9981388383784362,22.33832177777778,2675.8690666666666,13.85615501777858,134,2.5E-4
9,test_20231101_135948,11079715.png,443815,96804,347011,0.7818820905106858,3,4,124136,13603,110533,0.8904185731778049,18.573955555555557,2560.8911893333334,14.046892349086676,134,2.5E-4
10,test_20231101_135948,11551286.png,271883,204,271679,0.9992496772508763,1,4,40092,28,40064,0.9993016063054974,18.067507555555554,1885.468496,15.37661080624634,134,2.5E-4
1,test_20231101_135949,10404007.png,502730,12687,490043,0.9747637897081932,2,3,61265,1854,59411,0.9697380233412226,26.522814222222223,3660.292986666667,12.495645111565782,134,2.6000000000000003E-4
2,test_20231101_135949,1254659.png,342646,57052,285594,0.8334957944934422,3,4,80080,8040,72040,0.8996003996003996,22.955799111111112,3856.1182026666665,12.269300228832059,134,2.6000000000000003E-4
3,test_20231101_135949,10188041.png,221231,7482,213749,0.966180146543658,2,4,41731,1062,40669,0.9745512928039107,12.276314666666666,1446.37864,16.52798361314215,134,2.6000000000000003E-4
4,test_20231101_135949,10287332.png,216980,9932,207048,0.9542261959627616,2,4,22337,1369,20968,0.938711554819358,10.139925333333334,1003.4804586666667,18.11571441220159,134,2.6000000000000003E-4
5,test_20231101_135949,11610969.png,368720,18132,350588,0.9508244738555001,2,4,84111,2667,81444,0.9682918999892999,24.015946666666668,3561.74064,12.614180691875706,134,2.6000000000000003E-4
6,test_20231101_135949,10350842.png,212614,3632,208982,0.9829173996067991,1,3,42529,533,41996,0.9874673752028028,22.303296,3145.339712,13.154128026352721,134,2.6000000000000003E-4
7,test_20231101_135949,10863862.png,317432,6032,311400,0.980997504977444,1,4,66058,887,65171,0.9865724060673953,36.62354311111111,6752.591344,9.836098931580938,134,2.6000000000000003E-4
8,test_20231101_135949,11382381.png,312486,527,311959,0.9983135244458952,2,3,46745,69,46676,0.9985239063001391,22.832848,2745.811376,13.744096608790418,134,2.6000000000000003E-4
9,test_20231101_135949,11079715.png,443815,96804,347011,0.7818820905106858,3,3,124136,13603,110533,0.8904185731778049,18.573955555555557,2560.8911893333334,14.046892349086676,134,2.6000000000000003E-4
10,test_20231101_135949,11551286.png,271883,164,271719,0.9993967993585476,2,3,40092,22,40070,0.9994512620971765,18.120286222222223,1899.5769013333334,15.344234809036362,134,2.6000000000000003E-4
1,test_20231101_135949,10404007.png,502730,12687,490043,0.9747637897081932,2,4,61265,1854,59411,0.9697380233412226,26.522814222222223,3660.292986666667,12.495645111565782,134,2.7000000000000006E-4
2,test_20231101_135949,1254659.png,342646,57052,285594,0.8334957944934422,3,4,80080,8040,72040,0.8996003996003996,22.955799111111112,3856.1182026666665,12.269300228832059,134,2.7000000000000006E-4
3,test_20231101_135949,10188041.png,221231,7482,213749,0.966180146543658,2,4,41731,1062,40669,0.9745512928039107,12.276314666666666,1446.37864,16.52798361314215,134,2.7000000000000006E-4
4,test_20231101_135949,10287332.png,216980,9932,207048,0.9542261959627616,2,3,22337,1369,20968,0.938711554819358,10.139925333333334,1003.4804586666667,18.11571441220159,134,2.7000000000000006E-4
5,test_20231101_135949,11610969.png,368720,18132,350588,0.9508244738555001,3,3,84111,2667,81444,0.9682918999892999,24.015946666666668,3561.74064,12.614180691875706,134,2.7000000000000006E-4
6,test_20231101_135949,10350842.png,212614,3632,208982,0.9829173996067991,1,4,42529,533,41996,0.9874673752028028,22.303296,3145.339712,13.154128026352721,134,2.7000000000000006E-4
7,test_20231101_135949,10863862.png,317432,6032,311400,0.980997504977444,1,3,66058,887,65171,0.9865724060673953,36.62354311111111,6752.591344,9.836098931580938,134,2.7000000000000006E-4
8,test_20231101_135949,11382381.png,312486,527,311959,0.9983135244458952,2,4,46745,69,46676,0.9985239063001391,22.832848,2745.811376,13.744096608790418,134,2.7000000000000006E-4
9,test_20231101_135949,11079715.png,443815,96804,347011,0.7818820905106858,3,4,124136,13603,110533,0.8904185731778049,18.573955555555557,2560.8911893333334,14.046892349086676,134,2.7000000000000006E-4
10,test_20231101_135949,11551286.png,271883,164,271719,0.9993967993585476,1,3,40092,22,40070,0.9994512620971765,18.120286222222223,1899.5769013333334,15.344234809036362,134,2.7000000000000006E-4
1,test_20231101_135950,10404007.png,502730,12687,490043,0.9747637897081932,2,4,61265,1854,59411,0.9697380233412226,26.522814222222223,3660.292986666667,12.495645111565782,134,2.800000000000001E-4
2,test_20231101_135950,1254659.png,342646,57052,285594,0.8334957944934422,2,3,80080,8040,72040,0.8996003996003996,22.955799111111112,3856.1182026666665,12.269300228832059,134,2.800000000000001E-4
3,test_20231101_135950,10188041.png,221231,7482,213749,0.966180146543658,2,4,41731,1062,40669,0.9745512928039107,12.276314666666666,1446.37864,16.52798361314215,134,2.800000000000001E-4
4,test_20231101_135950,10287332.png,216980,9932,207048,0.9542261959627616,2,4,22337,1369,20968,0.938711554819358,10.139925333333334,1003.4804586666667,18.11571441220159,134,2.800000000000001E-4
5,test_20231101_135950,11610969.png,368720,18132,350588,0.9508244738555001,2,4,84111,2667,81444,0.9682918999892999,24.015946666666668,3561.74064,12.614180691875706,134,2.800000000000001E-4
6,test_20231101_135950,10350842.png,212614,3632,208982,0.9829173996067991,1,3,42529,533,41996,0.9874673752028028,22.303296,3145.339712,13.154128026352721,134,2.800000000000001E-4
7,test_20231101_135950,10863862.png,317432,6032,311400,0.980997504977444,2,3,66058,887,65171,0.9865724060673953,36.62354311111111,6752.591344,9.836098931580938,134,2.800000000000001E-4
8,test_20231101_135950,11382381.png,312486,527,311959,0.9983135244458952,1,4,46745,69,46676,0.9985239063001391,22.832848,2745.811376,13.744096608790418,134,2.800000000000001E-4
9,test_20231101_135950,11079715.png,443815,96804,347011,0.7818820905106858,4,5,124136,13603,110533,0.8904185731778049,18.573955555555557,2560.8911893333334,14.046892349086676,134,2.800000000000001E-4
10,test_20231101_135950,11551286.png,271883,164,271719,0.9993967993585476,1,4,40092,22,40070,0.9994512620971765,18.120286222222223,1899.5769013333334,15.344234809036362,134,2.800000000000001E-4
1,test_20231101_135951,10404007.png,502730,12687,490043,0.9747637897081932,2,4,61265,1854,59411,0.9697380233412226,26.522814222222223,3660.292986666667,12.495645111565782,134,2.900000000000001E-4
2,test_20231101_135951,1254659.png,342646,57052,285594,0.8334957944934422,3,4,80080,8040,72040,0.8996003996003996,22.955799111111112,3856.1182026666665,12.269300228832059,134,2.900000000000001E-4
3,test_20231101_135951,10188041.png,221231,7482,213749,0.966180146543658,2,4,41731,1062,40669,0.9745512928039107,12.276314666666666,1446.37864,16.52798361314215,134,2.900000000000001E-4
4,test_20231101_135951,10287332.png,216980,9932,207048,0.9542261959627616,1,4,22337,1369,20968,0.938711554819358,10.139925333333334,1003.4804586666667,18.11571441220159,134,2.900000000000001E-4
5,test_20231101_135951,11610969.png,368720,18132,350588,0.9508244738555001,3,3,84111,2667,81444,0.9682918999892999,24.015946666666668,3561.74064,12.614180691875706,134,2.900000000000001E-4
6,test_20231101_135951,10350842.png,212614,3632,208982,0.9829173996067991,1,3,42529,533,41996,0.9874673752028028,22.303296,3145.339712,13.154128026352721,134,2.900000000000001E-4
7,test_20231101_135951,10863862.png,317432,6032,311400,0.980997504977444,2,4,66058,887,65171,0.9865724060673953,36.62354311111111,6752.591344,9.836098931580938,134,2.900000000000001E-4
8,test_20231101_135951,11382381.png,312486,527,311959,0.9983135244458952,1,3,46745,69,46676,0.9985239063001391,22.832848,2745.811376,13.744096608790418,134,2.900000000000001E-4
9,test_20231101_135951,11079715.png,443815,96804,347011,0.7818820905106858,3,4,124136,13603,110533,0.8904185731778049,18.573955555555557,2560.8911893333334,14.046892349086676,134,2.900000000000001E-4
10,test_20231101_135951,11551286.png,271883,164,271719,0.9993967993585476,2,3,40092,22,40070,0.9994512620971765,18.120286222222223,1899.5769013333334,15.344234809036362,134,2.900000000000001E-4
1,test_20231101_135951,10404007.png,502730,12687,490043,0.9747637897081932,2,4,61265,1854,59411,0.9697380233412226,26.522814222222223,3660.292986666667,12.495645111565782,134,3.0000000000000014E-4
2,test_20231101_135951,1254659.png,342646,57052,285594,0.8334957944934422,3,4,80080,8040,72040,0.8996003996003996,22.955799111111112,3856.1182026666665,12.269300228832059,134,3.0000000000000014E-4
3,test_20231101_135951,10188041.png,221231,7482,213749,0.966180146543658,2,4,41731,1062,40669,0.9745512928039107,12.276314666666666,1446.37864,16.52798361314215,134,3.0000000000000014E-4
4,test_20231101_135951,10287332.png,216980,9932,207048,0.9542261959627616,2,3,22337,1369,20968,0.938711554819358,10.139925333333334,1003.4804586666667,18.11571441220159,134,3.0000000000000014E-4
5,test_20231101_135951,11610969.png,368720,18132,350588,0.9508244738555001,3,4,84111,2667,81444,0.9682918999892999,24.015946666666668,3561.74064,12.614180691875706,134,3.0000000000000014E-4
6,test_20231101_135951,10350842.png,212614,3632,208982,0.9829173996067991,3,5,42529,533,41996,0.9874673752028028,22.303296,3145.339712,13.154128026352721,134,3.0000000000000014E-4
7,test_20231101_135951,10863862.png,317432,6032,311400,0.980997504977444,1,3,66058,887,65171,0.9865724060673953,36.62354311111111,6752.591344,9.836098931580938,134,3.0000000000000014E-4
8,test_20231101_135951,11382381.png,312486,527,311959,0.9983135244458952,1,3,46745,69,46676,0.9985239063001391,22.832848,2745.811376,13.744096608790418,134,3.0000000000000014E-4
9,test_20231101_135951,11079715.png,443815,96804,347011,0.7818820905106858,3,4,124136,13603,110533,0.8904185731778049,18.573955555555557,2560.8911893333334,14.046892349086676,134,3.0000000000000014E-4
10,test_20231101_135951,11551286.png,271883,164,271719,0.9993967993585476,1,4,40092,22,40070,0.9994512620971765,18.120286222222223,1899.5769013333334,15.344234809036362,134,3.0000000000000014E-4
1,test_20231101_135952,10404007.png,502730,12687,490043,0.9747637897081932,3,3,61265,1854,59411,0.9697380233412226,26.522814222222223,3660.292986666667,12.495645111565782,134,3.1000000000000016E-4
2,test_20231101_135952,1254659.png,342646,57052,285594,0.8334957944934422,3,4,80080,8040,72040,0.8996003996003996,22.955799111111112,3856.1182026666665,12.269300228832059,134,3.1000000000000016E-4
3,test_20231101_135952,10188041.png,221231,7482,213749,0.966180146543658,2,3,41731,1062,40669,0.9745512928039107,12.276314666666666,1446.37864,16.52798361314215,134,3.1000000000000016E-4
4,test_20231101_135952,10287332.png,216980,9932,207048,0.9542261959627616,2,4,22337,1369,20968,0.938711554819358,10.139925333333334,1003.4804586666667,18.11571441220159,134,3.1000000000000016E-4
5,test_20231101_135952,11610969.png,368720,18132,350588,0.9508244738555001,2,4,84111,2667,81444,0.9682918999892999,24.015946666666668,3561.74064,12.614180691875706,134,3.1000000000000016E-4
6,test_20231101_135952,10350842.png,212614,3632,208982,0.9829173996067991,1,11,42529,533,41996,0.9874673752028028,22.303296,3145.339712,13.154128026352721,134,3.1000000000000016E-4
7,test_20231101_135952,10863862.png,317432,6032,311400,0.980997504977444,1,4,66058,887,65171,0.9865724060673953,36.62354311111111,6752.591344,9.836098931580938,134,3.1000000000000016E-4
8,test_20231101_135952,11382381.png,312486,527,311959,0.9983135244458952,1,4,46745,69,46676,0.9985239063001391,22.832848,2745.811376,13.744096608790418,134,3.1000000000000016E-4
9,test_20231101_135952,11079715.png,443815,96804,347011,0.7818820905106858,3,4,124136,13603,110533,0.8904185731778049,18.573955555555557,2560.8911893333334,14.046892349086676,134,3.1000000000000016E-4
10,test_20231101_135952,11551286.png,271883,164,271719,0.9993967993585476,1,4,40092,22,40070,0.9994512620971765,18.120286222222223,1899.5769013333334,15.344234809036362,134,3.1000000000000016E-4
1,test_20231101_135953,10404007.png,502730,12687,490043,0.9747637897081932,2,11,61265,1854,59411,0.9697380233412226,26.522814222222223,3660.292986666667,12.495645111565782,134,3.200000000000002E-4
2,test_20231101_135953,1254659.png,342646,57052,285594,0.8334957944934422,2,3,80080,8040,72040,0.8996003996003996,22.955799111111112,3856.1182026666665,12.269300228832059,134,3.200000000000002E-4
3,test_20231101_135953,10188041.png,221231,7482,213749,0.966180146543658,2,4,41731,1062,40669,0.9745512928039107,12.276314666666666,1446.37864,16.52798361314215,134,3.200000000000002E-4
4,test_20231101_135953,10287332.png,216980,9932,207048,0.9542261959627616,2,4,22337,1369,20968,0.938711554819358,10.139925333333334,1003.4804586666667,18.11571441220159,134,3.200000000000002E-4
5,test_20231101_135953,11610969.png,368720,18132,350588,0.9508244738555001,2,4,84111,2667,81444,0.9682918999892999,24.015946666666668,3561.74064,12.614180691875706,134,3.200000000000002E-4
6,test_20231101_135953,10350842.png,212614,3632,208982,0.9829173996067991,1,3,42529,533,41996,0.9874673752028028,22.303296,3145.339712,13.154128026352721,134,3.200000000000002E-4
7,test_20231101_135953,10863862.png,317432,6032,311400,0.980997504977444,2,3,66058,887,65171,0.9865724060673953,36.62354311111111,6752.591344,9.836098931580938,134,3.200000000000002E-4
8,test_20231101_135953,11382381.png,312486,527,311959,0.9983135244458952,1,4,46745,69,46676,0.9985239063001391,22.832848,2745.811376,13.744096608790418,134,3.200000000000002E-4
9,test_20231101_135953,11079715.png,443815,96804,347011,0.7818820905106858,3,4,124136,13603,110533,0.8904185731778049,18.573955555555557,2560.8911893333334,14.046892349086676,134,3.200000000000002E-4
10,test_20231101_135953,11551286.png,271883,164,271719,0.9993967993585476,1,4,40092,22,40070,0.9994512620971765,18.120286222222223,1899.5769013333334,15.344234809036362,134,3.200000000000002E-4
1,test_20231101_135953,10404007.png,502730,12687,490043,0.9747637897081932,6,4,61265,1854,59411,0.9697380233412226,26.522814222222223,3660.292986666667,12.495645111565782,134,3.300000000000002E-4
2,test_20231101_135953,1254659.png,342646,57052,285594,0.8334957944934422,3,4,80080,8040,72040,0.8996003996003996,22.955799111111112,3856.1182026666665,12.269300228832059,134,3.300000000000002E-4
3,test_20231101_135953,10188041.png,221231,7482,213749,0.966180146543658,2,3,41731,1062,40669,0.9745512928039107,12.276314666666666,1446.37864,16.52798361314215,134,3.300000000000002E-4
4,test_20231101_135953,10287332.png,216980,9932,207048,0.9542261959627616,1,3,22337,1369,20968,0.938711554819358,10.139925333333334,1003.4804586666667,18.11571441220159,134,3.300000000000002E-4
5,test_20231101_135953,11610969.png,368720,18132,350588,0.9508244738555001,3,3,84111,2667,81444,0.9682918999892999,24.015946666666668,3561.74064,12.614180691875706,134,3.300000000000002E-4
6,test_20231101_135953,10350842.png,212614,3632,208982,0.9829173996067991,1,4,42529,533,41996,0.9874673752028028,22.303296,3145.339712,13.154128026352721,134,3.300000000000002E-4
7,test_20231101_135953,10863862.png,317432,6032,311400,0.980997504977444,2,3,66058,887,65171,0.9865724060673953,36.62354311111111,6752.591344,9.836098931580938,134,3.300000000000002E-4
8,test_20231101_135953,11382381.png,312486,527,311959,0.9983135244458952,2,4,46745,69,46676,0.9985239063001391,22.832848,2745.811376,13.744096608790418,134,3.300000000000002E-4
9,test_20231101_135953,11079715.png,443815,96804,347011,0.7818820905106858,4,4,124136,13603,110533,0.8904185731778049,18.573955555555557,2560.8911893333334,14.046892349086676,134,3.300000000000002E-4
10,test_20231101_135953,11551286.png,271883,164,271719,0.9993967993585476,2,4,40092,22,40070,0.9994512620971765,18.120286222222223,1899.5769013333334,15.344234809036362,134,3.300000000000002E-4
1,test_20231101_135954,10404007.png,502730,12687,490043,0.9747637897081932,4,4,61265,1854,59411,0.9697380233412226,26.522814222222223,3660.292986666667,12.495645111565782,134,3.4000000000000024E-4
2,test_20231101_135954,1254659.png,342646,57052,285594,0.8334957944934422,3,4,80080,8040,72040,0.8996003996003996,22.955799111111112,3856.1182026666665,12.269300228832059,134,3.4000000000000024E-4
3,test_20231101_135954,10188041.png,221231,7482,213749,0.966180146543658,2,3,41731,1062,40669,0.9745512928039107,12.276314666666666,1446.37864,16.52798361314215,134,3.4000000000000024E-4
4,test_20231101_135954,10287332.png,216980,9932,207048,0.9542261959627616,1,3,22337,1369,20968,0.938711554819358,10.139925333333334,1003.4804586666667,18.11571441220159,134,3.4000000000000024E-4
5,test_20231101_135954,11610969.png,368720,18132,350588,0.9508244738555001,3,4,84111,2667,81444,0.9682918999892999,24.015946666666668,3561.74064,12.614180691875706,134,3.4000000000000024E-4
6,test_20231101_135954,10350842.png,212614,3632,208982,0.9829173996067991,1,3,42529,533,41996,0.9874673752028028,22.303296,3145.339712,13.154128026352721,134,3.4000000000000024E-4
7,test_20231101_135954,10863862.png,317432,6032,311400,0.980997504977444,2,4,66058,887,65171,0.9865724060673953,36.62354311111111,6752.591344,9.836098931580938,134,3.4000000000000024E-4
8,test_20231101_135954,11382381.png,312486,527,311959,0.9983135244458952,1,3,46745,69,46676,0.9985239063001391,22.832848,2745.811376,13.744096608790418,134,3.4000000000000024E-4
9,test_20231101_135954,11079715.png,443815,96804,347011,0.7818820905106858,4,4,124136,13603,110533,0.8904185731778049,18.573955555555557,2560.8911893333334,14.046892349086676,134,3.4000000000000024E-4
10,test_20231101_135954,11551286.png,271883,164,271719,0.9993967993585476,1,3,40092,22,40070,0.9994512620971765,18.120286222222223,1899.5769013333334,15.344234809036362,134,3.4000000000000024E-4
1,test_20231101_135955,10404007.png,502730,12687,490043,0.9747637897081932,3,12,61265,1854,59411,0.9697380233412226,26.522814222222223,3660.292986666667,12.495645111565782,134,3.5000000000000027E-4
2,test_20231101_135955,1254659.png,342646,57052,285594,0.8334957944934422,3,4,80080,8040,72040,0.8996003996003996,22.955799111111112,3856.1182026666665,12.269300228832059,134,3.5000000000000027E-4
3,test_20231101_135955,10188041.png,221231,7482,213749,0.966180146543658,2,4,41731,1062,40669,0.9745512928039107,12.276314666666666,1446.37864,16.52798361314215,134,3.5000000000000027E-4
4,test_20231101_135955,10287332.png,216980,9932,207048,0.9542261959627616,1,3,22337,1369,20968,0.938711554819358,10.139925333333334,1003.4804586666667,18.11571441220159,134,3.5000000000000027E-4
5,test_20231101_135955,11610969.png,368720,18132,350588,0.9508244738555001,2,4,84111,2667,81444,0.9682918999892999,24.015946666666668,3561.74064,12.614180691875706,134,3.5000000000000027E-4
6,test_20231101_135955,10350842.png,212614,3632,208982,0.9829173996067991,1,3,42529,533,41996,0.9874673752028028,22.303296,3145.339712,13.154128026352721,134,3.5000000000000027E-4
7,test_20231101_135955,10863862.png,317432,6032,311400,0.980997504977444,1,3,66058,887,65171,0.9865724060673953,36.62354311111111,6752.591344,9.836098931580938,134,3.5000000000000027E-4
8,test_20231101_135955,11382381.png,312486,527,311959,0.9983135244458952,1,3,46745,69,46676,0.9985239063001391,22.832848,2745.811376,13.744096608790418,134,3.5000000000000027E-4
9,test_20231101_135955,11079715.png,443815,96804,347011,0.7818820905106858,3,4,124136,13603,110533,0.8904185731778049,18.573955555555557,2560.8911893333334,14.046892349086676,134,3.5000000000000027E-4
10,test_20231101_135955,11551286.png,271883,164,271719,0.9993967993585476,2,3,40092,22,40070,0.9994512620971765,18.120286222222223,1899.5769013333334,15.344234809036362,134,3.5000000000000027E-4
1,test_20231101_135955,10404007.png,502730,12687,490043,0.9747637897081932,2,3,61265,1854,59411,0.9697380233412226,26.522814222222223,3660.292986666667,12.495645111565782,134,3.600000000000003E-4
2,test_20231101_135955,1254659.png,342646,57052,285594,0.8334957944934422,2,4,80080,8040,72040,0.8996003996003996,22.955799111111112,3856.1182026666665,12.269300228832059,134,3.600000000000003E-4
3,test_20231101_135955,10188041.png,221231,7482,213749,0.966180146543658,2,3,41731,1062,40669,0.9745512928039107,12.276314666666666,1446.37864,16.52798361314215,134,3.600000000000003E-4
4,test_20231101_135955,10287332.png,216980,9932,207048,0.9542261959627616,1,4,22337,1369,20968,0.938711554819358,10.139925333333334,1003.4804586666667,18.11571441220159,134,3.600000000000003E-4
5,test_20231101_135955,11610969.png,368720,18132,350588,0.9508244738555001,2,3,84111,2667,81444,0.9682918999892999,24.015946666666668,3561.74064,12.614180691875706,134,3.600000000000003E-4
6,test_20231101_135955,10350842.png,212614,3632,208982,0.9829173996067991,2,4,42529,533,41996,0.9874673752028028,22.303296,3145.339712,13.154128026352721,134,3.600000000000003E-4
7,test_20231101_135955,10863862.png,317432,6032,311400,0.980997504977444,2,3,66058,887,65171,0.9865724060673953,36.62354311111111,6752.591344,9.836098931580938,134,3.600000000000003E-4
8,test_20231101_135955,11382381.png,312486,527,311959,0.9983135244458952,2,3,46745,69,46676,0.9985239063001391,22.832848,2745.811376,13.744096608790418,134,3.600000000000003E-4
9,test_20231101_135955,11079715.png,443815,96804,347011,0.7818820905106858,3,4,124136,13603,110533,0.8904185731778049,18.573955555555557,2560.8911893333334,14.046892349086676,134,3.600000000000003E-4
10,test_20231101_135955,11551286.png,271883,164,271719,0.9993967993585476,1,4,40092,22,40070,0.9994512620971765,18.120286222222223,1899.5769013333334,15.344234809036362,134,3.600000000000003E-4
1,test_20231101_135956,10404007.png,502730,12687,490043,0.9747637897081932,2,3,61265,1854,59411,0.9697380233412226,26.522814222222223,3660.292986666667,12.495645111565782,134,3.700000000000003E-4
2,test_20231101_135956,1254659.png,342646,57052,285594,0.8334957944934422,3,4,80080,8040,72040,0.8996003996003996,22.955799111111112,3856.1182026666665,12.269300228832059,134,3.700000000000003E-4
3,test_20231101_135956,10188041.png,221231,7482,213749,0.966180146543658,2,3,41731,1062,40669,0.9745512928039107,12.276314666666666,1446.37864,16.52798361314215,134,3.700000000000003E-4
4,test_20231101_135956,10287332.png,216980,9932,207048,0.9542261959627616,2,4,22337,1369,20968,0.938711554819358,10.139925333333334,1003.4804586666667,18.11571441220159,134,3.700000000000003E-4
5,test_20231101_135956,11610969.png,368720,18132,350588,0.9508244738555001,2,4,84111,2667,81444,0.9682918999892999,24.015946666666668,3561.74064,12.614180691875706,134,3.700000000000003E-4
6,test_20231101_135956,10350842.png,212614,3632,208982,0.9829173996067991,1,3,42529,533,41996,0.9874673752028028,22.303296,3145.339712,13.154128026352721,134,3.700000000000003E-4
7,test_20231101_135956,10863862.png,317432,6032,311400,0.980997504977444,1,4,66058,887,65171,0.9865724060673953,36.62354311111111,6752.591344,9.836098931580938,134,3.700000000000003E-4
8,test_20231101_135956,11382381.png,312486,527,311959,0.9983135244458952,2,3,46745,69,46676,0.9985239063001391,22.832848,2745.811376,13.744096608790418,134,3.700000000000003E-4
9,test_20231101_135956,11079715.png,443815,96804,347011,0.7818820905106858,3,4,124136,13603,110533,0.8904185731778049,18.573955555555557,2560.8911893333334,14.046892349086676,134,3.700000000000003E-4
10,test_20231101_135956,11551286.png,271883,164,271719,0.9993967993585476,2,3,40092,22,40070,0.9994512620971765,18.120286222222223,1899.5769013333334,15.344234809036362,134,3.700000000000003E-4
1,test_20231101_135957,10404007.png,502730,12687,490043,0.9747637897081932,2,4,61265,1854,59411,0.9697380233412226,26.522814222222223,3660.292986666667,12.495645111565782,134,3.8000000000000035E-4
2,test_20231101_135957,1254659.png,342646,57052,285594,0.8334957944934422,2,3,80080,8040,72040,0.8996003996003996,22.955799111111112,3856.1182026666665,12.269300228832059,134,3.8000000000000035E-4
3,test_20231101_135957,10188041.png,221231,7482,213749,0.966180146543658,2,3,41731,1062,40669,0.9745512928039107,12.276314666666666,1446.37864,16.52798361314215,134,3.8000000000000035E-4
4,test_20231101_135957,10287332.png,216980,9932,207048,0.9542261959627616,2,4,22337,1369,20968,0.938711554819358,10.139925333333334,1003.4804586666667,18.11571441220159,134,3.8000000000000035E-4
5,test_20231101_135957,11610969.png,368720,18132,350588,0.9508244738555001,2,4,84111,2667,81444,0.9682918999892999,24.015946666666668,3561.74064,12.614180691875706,134,3.8000000000000035E-4
6,test_20231101_135957,10350842.png,212614,3632,208982,0.9829173996067991,1,4,42529,533,41996,0.9874673752028028,22.303296,3145.339712,13.154128026352721,134,3.8000000000000035E-4
7,test_20231101_135957,10863862.png,317432,6032,311400,0.980997504977444,1,3,66058,887,65171,0.9865724060673953,36.62354311111111,6752.591344,9.836098931580938,134,3.8000000000000035E-4
8,test_20231101_135957,11382381.png,312486,527,311959,0.9983135244458952,1,4,46745,69,46676,0.9985239063001391,22.832848,2745.811376,13.744096608790418,134,3.8000000000000035E-4
9,test_20231101_135957,11079715.png,443815,96804,347011,0.7818820905106858,3,4,124136,13603,110533,0.8904185731778049,18.573955555555557,2560.8911893333334,14.046892349086676,134,3.8000000000000035E-4
10,test_20231101_135957,11551286.png,271883,164,271719,0.9993967993585476,2,3,40092,22,40070,0.9994512620971765,18.120286222222223,1899.5769013333334,15.344234809036362,134,3.8000000000000035E-4
1,test_20231101_135958,10404007.png,502730,12687,490043,0.9747637897081932,2,3,61265,1854,59411,0.9697380233412226,26.522814222222223,3660.292986666667,12.495645111565782,134,3.9000000000000037E-4
2,test_20231101_135958,1254659.png,342646,57052,285594,0.8334957944934422,3,4,80080,8040,72040,0.8996003996003996,22.955799111111112,3856.1182026666665,12.269300228832059,134,3.9000000000000037E-4
3,test_20231101_135958,10188041.png,221231,7482,213749,0.966180146543658,2,3,41731,1062,40669,0.9745512928039107,12.276314666666666,1446.37864,16.52798361314215,134,3.9000000000000037E-4
4,test_20231101_135958,10287332.png,216980,9932,207048,0.9542261959627616,1,3,22337,1369,20968,0.938711554819358,10.139925333333334,1003.4804586666667,18.11571441220159,134,3.9000000000000037E-4
5,test_20231101_135958,11610969.png,368720,18132,350588,0.9508244738555001,3,3,84111,2667,81444,0.9682918999892999,24.015946666666668,3561.74064,12.614180691875706,134,3.9000000000000037E-4
6,test_20231101_135958,10350842.png,212614,3632,208982,0.9829173996067991,2,4,42529,533,41996,0.9874673752028028,22.303296,3145.339712,13.154128026352721,134,3.9000000000000037E-4
7,test_20231101_135958,10863862.png,317432,6032,311400,0.980997504977444,1,4,66058,887,65171,0.9865724060673953,36.62354311111111,6752.591344,9.836098931580938,134,3.9000000000000037E-4
8,test_20231101_135958,11382381.png,312486,527,311959,0.9983135244458952,1,3,46745,69,46676,0.9985239063001391,22.832848,2745.811376,13.744096608790418,134,3.9000000000000037E-4
9,test_20231101_135958,11079715.png,443815,96804,347011,0.7818820905106858,3,4,124136,13603,110533,0.8904185731778049,18.573955555555557,2560.8911893333334,14.046892349086676,134,3.9000000000000037E-4
10,test_20231101_135958,11551286.png,271883,164,271719,0.9993967993585476,2,3,40092,22,40070,0.9994512620971765,18.120286222222223,1899.5769013333334,15.344234809036362,134,3.9000000000000037E-4
1,test_20231101_135958,10404007.png,502730,12687,490043,0.9747637897081932,3,4,61265,1854,59411,0.9697380233412226,26.522814222222223,3660.292986666667,12.495645111565782,134,4.000000000000004E-4
2,test_20231101_135958,1254659.png,342646,57052,285594,0.8334957944934422,3,3,80080,8040,72040,0.8996003996003996,22.955799111111112,3856.1182026666665,12.269300228832059,134,4.000000000000004E-4
3,test_20231101_135958,10188041.png,221231,7482,213749,0.966180146543658,2,3,41731,1062,40669,0.9745512928039107,12.276314666666666,1446.37864,16.52798361314215,134,4.000000000000004E-4
4,test_20231101_135958,10287332.png,216980,9932,207048,0.9542261959627616,2,4,22337,1369,20968,0.938711554819358,10.139925333333334,1003.4804586666667,18.11571441220159,134,4.000000000000004E-4
5,test_20231101_135958,11610969.png,368720,18132,350588,0.9508244738555001,2,4,84111,2667,81444,0.9682918999892999,24.015946666666668,3561.74064,12.614180691875706,134,4.000000000000004E-4
6,test_20231101_135958,10350842.png,212614,3632,208982,0.9829173996067991,1,3,42529,533,41996,0.9874673752028028,22.303296,3145.339712,13.154128026352721,134,4.000000000000004E-4
7,test_20231101_135958,10863862.png,317432,6032,311400,0.980997504977444,1,3,66058,887,65171,0.9865724060673953,36.62354311111111,6752.591344,9.836098931580938,134,4.000000000000004E-4
8,test_20231101_135958,11382381.png,312486,527,311959,0.9983135244458952,1,3,46745,69,46676,0.9985239063001391,22.832848,2745.811376,13.744096608790418,134,4.000000000000004E-4
9,test_20231101_135958,11079715.png,443815,96804,347011,0.7818820905106858,3,4,124136,13603,110533,0.8904185731778049,18.573955555555557,2560.8911893333334,14.046892349086676,134,4.000000000000004E-4
10,test_20231101_135958,11551286.png,271883,164,271719,0.9993967993585476,1,3,40092,22,40070,0.9994512620971765,18.120286222222223,1899.5769013333334,15.344234809036362,134,4.000000000000004E-4
1,test_20231101_135959,10404007.png,502730,12687,490043,0.9747637897081932,2,3,61265,1854,59411,0.9697380233412226,26.522814222222223,3660.292986666667,12.495645111565782,134,4.100000000000004E-4
2,test_20231101_135959,1254659.png,342646,57052,285594,0.8334957944934422,3,4,80080,8040,72040,0.8996003996003996,22.955799111111112,3856.1182026666665,12.269300228832059,134,4.100000000000004E-4
3,test_20231101_135959,10188041.png,221231,7482,213749,0.966180146543658,2,4,41731,1062,40669,0.9745512928039107,12.276314666666666,1446.37864,16.52798361314215,134,4.100000000000004E-4
4,test_20231101_135959,10287332.png,216980,9932,207048,0.9542261959627616,1,5,22337,1369,20968,0.938711554819358,10.139925333333334,1003.4804586666667,18.11571441220159,134,4.100000000000004E-4
5,test_20231101_135959,11610969.png,368720,18132,350588,0.9508244738555001,2,4,84111,2667,81444,0.9682918999892999,24.015946666666668,3561.74064,12.614180691875706,134,4.100000000000004E-4
6,test_20231101_135959,10350842.png,212614,3632,208982,0.9829173996067991,1,4,42529,533,41996,0.9874673752028028,22.303296,3145.339712,13.154128026352721,134,4.100000000000004E-4
7,test_20231101_135959,10863862.png,317432,6032,311400,0.980997504977444,2,3,66058,887,65171,0.9865724060673953,36.62354311111111,6752.591344,9.836098931580938,134,4.100000000000004E-4
8,test_20231101_135959,11382381.png,312486,527,311959,0.9983135244458952,2,4,46745,69,46676,0.9985239063001391,22.832848,2745.811376,13.744096608790418,134,4.100000000000004E-4
9,test_20231101_135959,11079715.png,443815,96804,347011,0.7818820905106858,3,4,124136,13603,110533,0.8904185731778049,18.573955555555557,2560.8911893333334,14.046892349086676,134,4.100000000000004E-4
10,test_20231101_135959,11551286.png,271883,164,271719,0.9993967993585476,2,4,40092,22,40070,0.9994512620971765,18.120286222222223,1899.5769013333334,15.344234809036362,134,4.100000000000004E-4
1,test_20231101_140000,10404007.png,502730,12687,490043,0.9747637897081932,2,3,61265,1854,59411,0.9697380233412226,26.522814222222223,3660.292986666667,12.495645111565782,134,4.2000000000000045E-4
2,test_20231101_140000,1254659.png,342646,57052,285594,0.8334957944934422,3,5,80080,8040,72040,0.8996003996003996,22.955799111111112,3856.1182026666665,12.269300228832059,134,4.2000000000000045E-4
3,test_20231101_140000,10188041.png,221231,7482,213749,0.966180146543658,2,3,41731,1062,40669,0.9745512928039107,12.276314666666666,1446.37864,16.52798361314215,134,4.2000000000000045E-4
4,test_20231101_140000,10287332.png,216980,9932,207048,0.9542261959627616,1,3,22337,1369,20968,0.938711554819358,10.139925333333334,1003.4804586666667,18.11571441220159,134,4.2000000000000045E-4
5,test_20231101_140000,11610969.png,368720,18132,350588,0.9508244738555001,3,4,84111,2667,81444,0.9682918999892999,24.015946666666668,3561.74064,12.614180691875706,134,4.2000000000000045E-4
6,test_20231101_140000,10350842.png,212614,3632,208982,0.9829173996067991,2,3,42529,533,41996,0.9874673752028028,22.303296,3145.339712,13.154128026352721,134,4.2000000000000045E-4
7,test_20231101_140000,10863862.png,317432,6032,311400,0.980997504977444,2,4,66058,887,65171,0.9865724060673953,36.62354311111111,6752.591344,9.836098931580938,134,4.2000000000000045E-4
8,test_20231101_140000,11382381.png,312486,527,311959,0.9983135244458952,2,3,46745,69,46676,0.9985239063001391,22.832848,2745.811376,13.744096608790418,134,4.2000000000000045E-4
9,test_20231101_140000,11079715.png,443815,96804,347011,0.7818820905106858,3,4,124136,13603,110533,0.8904185731778049,18.573955555555557,2560.8911893333334,14.046892349086676,134,4.2000000000000045E-4
10,test_20231101_140000,11551286.png,271883,164,271719,0.9993967993585476,1,3,40092,22,40070,0.9994512620971765,18.120286222222223,1899.5769013333334,15.344234809036362,134,4.2000000000000045E-4
1,test_20231101_140000,10404007.png,502730,12687,490043,0.9747637897081932,2,4,61265,1854,59411,0.9697380233412226,26.522814222222223,3660.292986666667,12.495645111565782,134,4.300000000000005E-4
2,test_20231101_140000,1254659.png,342646,57052,285594,0.8334957944934422,3,4,80080,8040,72040,0.8996003996003996,22.955799111111112,3856.1182026666665,12.269300228832059,134,4.300000000000005E-4
3,test_20231101_140000,10188041.png,221231,7482,213749,0.966180146543658,2,3,41731,1062,40669,0.9745512928039107,12.276314666666666,1446.37864,16.52798361314215,134,4.300000000000005E-4
4,test_20231101_140000,10287332.png,216980,9932,207048,0.9542261959627616,2,4,22337,1369,20968,0.938711554819358,10.139925333333334,1003.4804586666667,18.11571441220159,134,4.300000000000005E-4
5,test_20231101_140000,11610969.png,368720,18132,350588,0.9508244738555001,2,4,84111,2667,81444,0.9682918999892999,24.015946666666668,3561.74064,12.614180691875706,134,4.300000000000005E-4
6,test_20231101_140000,10350842.png,212614,3632,208982,0.9829173996067991,2,3,42529,533,41996,0.9874673752028028,22.303296,3145.339712,13.154128026352721,134,4.300000000000005E-4
7,test_20231101_140000,10863862.png,317432,6032,311400,0.980997504977444,1,4,66058,887,65171,0.9865724060673953,36.62354311111111,6752.591344,9.836098931580938,134,4.300000000000005E-4
8,test_20231101_140000,11382381.png,312486,527,311959,0.9983135244458952,2,3,46745,69,46676,0.9985239063001391,22.832848,2745.811376,13.744096608790418,134,4.300000000000005E-4
9,test_20231101_140000,11079715.png,443815,96804,347011,0.7818820905106858,3,4,124136,13603,110533,0.8904185731778049,18.573955555555557,2560.8911893333334,14.046892349086676,134,4.300000000000005E-4
10,test_20231101_140000,11551286.png,271883,164,271719,0.9993967993585476,1,4,40092,22,40070,0.9994512620971765,18.120286222222223,1899.5769013333334,15.344234809036362,134,4.300000000000005E-4
1,test_20231101_140001,10404007.png,502730,12687,490043,0.9747637897081932,2,5,61265,1854,59411,0.9697380233412226,26.522814222222223,3660.292986666667,12.495645111565782,134,4.400000000000005E-4
2,test_20231101_140001,1254659.png,342646,57052,285594,0.8334957944934422,3,4,80080,8040,72040,0.8996003996003996,22.955799111111112,3856.1182026666665,12.269300228832059,134,4.400000000000005E-4
3,test_20231101_140001,10188041.png,221231,7482,213749,0.966180146543658,2,4,41731,1062,40669,0.9745512928039107,12.276314666666666,1446.37864,16.52798361314215,134,4.400000000000005E-4
4,test_20231101_140001,10287332.png,216980,9932,207048,0.9542261959627616,2,4,22337,1369,20968,0.938711554819358,10.139925333333334,1003.4804586666667,18.11571441220159,134,4.400000000000005E-4
5,test_20231101_140001,11610969.png,368720,18132,350588,0.9508244738555001,3,4,84111,2667,81444,0.9682918999892999,24.015946666666668,3561.74064,12.614180691875706,134,4.400000000000005E-4
6,test_20231101_140001,10350842.png,212614,3632,208982,0.9829173996067991,1,3,42529,533,41996,0.9874673752028028,22.303296,3145.339712,13.154128026352721,134,4.400000000000005E-4
7,test_20231101_140001,10863862.png,317432,6032,311400,0.980997504977444,2,4,66058,887,65171,0.9865724060673953,36.62354311111111,6752.591344,9.836098931580938,134,4.400000000000005E-4
8,test_20231101_140001,11382381.png,312486,527,311959,0.9983135244458952,1,3,46745,69,46676,0.9985239063001391,22.832848,2745.811376,13.744096608790418,134,4.400000000000005E-4
9,test_20231101_140001,11079715.png,443815,96804,347011,0.7818820905106858,4,5,124136,13603,110533,0.8904185731778049,18.573955555555557,2560.8911893333334,14.046892349086676,134,4.400000000000005E-4
10,test_20231101_140001,11551286.png,271883,164,271719,0.9993967993585476,1,4,40092,22,40070,0.9994512620971765,18.120286222222223,1899.5769013333334,15.344234809036362,134,4.400000000000005E-4
1,test_20231101_140002,10404007.png,502730,12687,490043,0.9747637897081932,2,3,61265,1854,59411,0.9697380233412226,26.522814222222223,3660.292986666667,12.495645111565782,134,4.5000000000000053E-4
2,test_20231101_140002,1254659.png,342646,57052,285594,0.8334957944934422,3,4,80080,8040,72040,0.8996003996003996,22.955799111111112,3856.1182026666665,12.269300228832059,134,4.5000000000000053E-4
3,test_20231101_140002,10188041.png,221231,7482,213749,0.966180146543658,2,4,41731,1062,40669,0.9745512928039107,12.276314666666666,1446.37864,16.52798361314215,134,4.5000000000000053E-4
4,test_20231101_140002,10287332.png,216980,9932,207048,0.9542261959627616,2,4,22337,1369,20968,0.938711554819358,10.139925333333334,1003.4804586666667,18.11571441220159,134,4.5000000000000053E-4
5,test_20231101_140002,11610969.png,368720,18132,350588,0.9508244738555001,6,3,84111,2667,81444,0.9682918999892999,24.015946666666668,3561.74064,12.614180691875706,134,4.5000000000000053E-4
6,test_20231101_140002,10350842.png,212614,3632,208982,0.9829173996067991,1,4,42529,533,41996,0.9874673752028028,22.303296,3145.339712,13.154128026352721,134,4.5000000000000053E-4
7,test_20231101_140002,10863862.png,317432,6032,311400,0.980997504977444,1,3,66058,887,65171,0.9865724060673953,36.62354311111111,6752.591344,9.836098931580938,134,4.5000000000000053E-4
8,test_20231101_140002,11382381.png,312486,527,311959,0.9983135244458952,2,3,46745,69,46676,0.9985239063001391,22.832848,2745.811376,13.744096608790418,134,4.5000000000000053E-4
9,test_20231101_140002,11079715.png,443815,96804,347011,0.7818820905106858,3,4,124136,13603,110533,0.8904185731778049,18.573955555555557,2560.8911893333334,14.046892349086676,134,4.5000000000000053E-4
10,test_20231101_140002,11551286.png,271883,164,271719,0.9993967993585476,1,3,40092,22,40070,0.9994512620971765,18.120286222222223,1899.5769013333334,15.344234809036362,134,4.5000000000000053E-4
1,test_20231101_140002,10404007.png,502730,12687,490043,0.9747637897081932,2,3,61265,1854,59411,0.9697380233412226,26.522814222222223,3660.292986666667,12.495645111565782,134,4.6000000000000056E-4
2,test_20231101_140002,1254659.png,342646,57052,285594,0.8334957944934422,3,4,80080,8040,72040,0.8996003996003996,22.955799111111112,3856.1182026666665,12.269300228832059,134,4.6000000000000056E-4
3,test_20231101_140002,10188041.png,221231,7482,213749,0.966180146543658,3,4,41731,1062,40669,0.9745512928039107,12.276314666666666,1446.37864,16.52798361314215,134,4.6000000000000056E-4
4,test_20231101_140002,10287332.png,216980,9932,207048,0.9542261959627616,2,3,22337,1369,20968,0.938711554819358,10.139925333333334,1003.4804586666667,18.11571441220159,134,4.6000000000000056E-4
5,test_20231101_140002,11610969.png,368720,18132,350588,0.9508244738555001,2,4,84111,2667,81444,0.9682918999892999,24.015946666666668,3561.74064,12.614180691875706,134,4.6000000000000056E-4
6,test_20231101_140002,10350842.png,212614,3632,208982,0.9829173996067991,1,4,42529,533,41996,0.9874673752028028,22.303296,3145.339712,13.154128026352721,134,4.6000000000000056E-4
7,test_20231101_140002,10863862.png,317432,6032,311400,0.980997504977444,2,4,66058,887,65171,0.9865724060673953,36.62354311111111,6752.591344,9.836098931580938,134,4.6000000000000056E-4
8,test_20231101_140002,11382381.png,312486,527,311959,0.9983135244458952,1,4,46745,69,46676,0.9985239063001391,22.832848,2745.811376,13.744096608790418,134,4.6000000000000056E-4
9,test_20231101_140002,11079715.png,443815,96804,347011,0.7818820905106858,3,4,124136,13603,110533,0.8904185731778049,18.573955555555557,2560.8911893333334,14.046892349086676,134,4.6000000000000056E-4
10,test_20231101_140002,11551286.png,271883,164,271719,0.9993967993585476,1,3,40092,22,40070,0.9994512620971765,18.120286222222223,1899.5769013333334,15.344234809036362,134,4.6000000000000056E-4
1,test_20231101_140003,10404007.png,502730,12687,490043,0.9747637897081932,2,4,61265,1854,59411,0.9697380233412226,26.522814222222223,3660.292986666667,12.495645111565782,134,4.700000000000006E-4
2,test_20231101_140003,1254659.png,342646,57052,285594,0.8334957944934422,2,4,80080,8040,72040,0.8996003996003996,22.955799111111112,3856.1182026666665,12.269300228832059,134,4.700000000000006E-4
3,test_20231101_140003,10188041.png,221231,7482,213749,0.966180146543658,2,3,41731,1062,40669,0.9745512928039107,12.276314666666666,1446.37864,16.52798361314215,134,4.700000000000006E-4
4,test_20231101_140003,10287332.png,216980,9932,207048,0.9542261959627616,2,4,22337,1369,20968,0.938711554819358,10.139925333333334,1003.4804586666667,18.11571441220159,134,4.700000000000006E-4
5,test_20231101_140003,11610969.png,368720,18132,350588,0.9508244738555001,2,4,84111,2667,81444,0.9682918999892999,24.015946666666668,3561.74064,12.614180691875706,134,4.700000000000006E-4
6,test_20231101_140003,10350842.png,212614,3632,208982,0.9829173996067991,2,4,42529,533,41996,0.9874673752028028,22.303296,3145.339712,13.154128026352721,134,4.700000000000006E-4
7,test_20231101_140003,10863862.png,317432,6032,311400,0.980997504977444,1,3,66058,887,65171,0.9865724060673953,36.62354311111111,6752.591344,9.836098931580938,134,4.700000000000006E-4
8,test_20231101_140003,11382381.png,312486,527,311959,0.9983135244458952,1,4,46745,69,46676,0.9985239063001391,22.832848,2745.811376,13.744096608790418,134,4.700000000000006E-4
9,test_20231101_140003,11079715.png,443815,96804,347011,0.7818820905106858,3,4,124136,13603,110533,0.8904185731778049,18.573955555555557,2560.8911893333334,14.046892349086676,134,4.700000000000006E-4
10,test_20231101_140003,11551286.png,271883,164,271719,0.9993967993585476,1,3,40092,22,40070,0.9994512620971765,18.120286222222223,1899.5769013333334,15.344234809036362,134,4.700000000000006E-4
1,test_20231101_140004,10404007.png,502730,12687,490043,0.9747637897081932,2,4,61265,1854,59411,0.9697380233412226,26.522814222222223,3660.292986666667,12.495645111565782,134,4.800000000000006E-4
2,test_20231101_140004,1254659.png,342646,57052,285594,0.8334957944934422,2,4,80080,8040,72040,0.8996003996003996,22.955799111111112,3856.1182026666665,12.269300228832059,134,4.800000000000006E-4
3,test_20231101_140004,10188041.png,221231,7482,213749,0.966180146543658,2,4,41731,1062,40669,0.9745512928039107,12.276314666666666,1446.37864,16.52798361314215,134,4.800000000000006E-4
4,test_20231101_140004,10287332.png,216980,9932,207048,0.9542261959627616,2,4,22337,1369,20968,0.938711554819358,10.139925333333334,1003.4804586666667,18.11571441220159,134,4.800000000000006E-4
5,test_20231101_140004,11610969.png,368720,18132,350588,0.9508244738555001,2,4,84111,2667,81444,0.9682918999892999,24.015946666666668,3561.74064,12.614180691875706,134,4.800000000000006E-4
6,test_20231101_140004,10350842.png,212614,3632,208982,0.9829173996067991,2,4,42529,533,41996,0.9874673752028028,22.303296,3145.339712,13.154128026352721,134,4.800000000000006E-4
7,test_20231101_140004,10863862.png,317432,6032,311400,0.980997504977444,1,4,66058,887,65171,0.9865724060673953,36.62354311111111,6752.591344,9.836098931580938,134,4.800000000000006E-4
8,test_20231101_140004,11382381.png,312486,527,311959,0.9983135244458952,1,4,46745,69,46676,0.9985239063001391,22.832848,2745.811376,13.744096608790418,134,4.800000000000006E-4
9,test_20231101_140004,11079715.png,443815,96804,347011,0.7818820905106858,4,4,124136,13603,110533,0.8904185731778049,18.573955555555557,2560.8911893333334,14.046892349086676,134,4.800000000000006E-4
10,test_20231101_140004,11551286.png,271883,164,271719,0.9993967993585476,2,3,40092,22,40070,0.9994512620971765,18.120286222222223,1899.5769013333334,15.344234809036362,134,4.800000000000006E-4
1,test_20231101_140004,10404007.png,502730,12687,490043,0.9747637897081932,2,4,61265,1854,59411,0.9697380233412226,26.522814222222223,3660.292986666667,12.495645111565782,134,4.900000000000006E-4
2,test_20231101_140004,1254659.png,342646,57052,285594,0.8334957944934422,2,4,80080,8040,72040,0.8996003996003996,22.955799111111112,3856.1182026666665,12.269300228832059,134,4.900000000000006E-4
3,test_20231101_140004,10188041.png,221231,7482,213749,0.966180146543658,2,4,41731,1062,40669,0.9745512928039107,12.276314666666666,1446.37864,16.52798361314215,134,4.900000000000006E-4
4,test_20231101_140004,10287332.png,216980,9932,207048,0.9542261959627616,2,3,22337,1369,20968,0.938711554819358,10.139925333333334,1003.4804586666667,18.11571441220159,134,4.900000000000006E-4
5,test_20231101_140004,11610969.png,368720,18132,350588,0.9508244738555001,3,4,84111,2667,81444,0.9682918999892999,24.015946666666668,3561.74064,12.614180691875706,134,4.900000000000006E-4
6,test_20231101_140004,10350842.png,212614,3632,208982,0.9829173996067991,2,3,42529,533,41996,0.9874673752028028,22.303296,3145.339712,13.154128026352721,134,4.900000000000006E-4
7,test_20231101_140004,10863862.png,317432,6032,311400,0.980997504977444,2,4,66058,887,65171,0.9865724060673953,36.62354311111111,6752.591344,9.836098931580938,134,4.900000000000006E-4
8,test_20231101_140004,11382381.png,312486,527,311959,0.9983135244458952,2,3,46745,69,46676,0.9985239063001391,22.832848,2745.811376,13.744096608790418,134,4.900000000000006E-4
9,test_20231101_140004,11079715.png,443815,96804,347011,0.7818820905106858,3,4,124136,13603,110533,0.8904185731778049,18.573955555555557,2560.8911893333334,14.046892349086676,134,4.900000000000006E-4
10,test_20231101_140004,11551286.png,271883,164,271719,0.9993967993585476,1,3,40092,22,40070,0.9994512620971765,18.120286222222223,1899.5769013333334,15.344234809036362,134,4.900000000000006E-4
1,test_20231101_140005,10404007.png,502730,12687,490043,0.9747637897081932,2,4,61265,1854,59411,0.9697380233412226,26.522814222222223,3660.292986666667,12.495645111565782,134,5.000000000000007E-4
2,test_20231101_140005,1254659.png,342646,57052,285594,0.8334957944934422,3,4,80080,8040,72040,0.8996003996003996,22.955799111111112,3856.1182026666665,12.269300228832059,134,5.000000000000007E-4
3,test_20231101_140005,10188041.png,221231,7482,213749,0.966180146543658,2,4,41731,1062,40669,0.9745512928039107,12.276314666666666,1446.37864,16.52798361314215,134,5.000000000000007E-4
4,test_20231101_140005,10287332.png,216980,9932,207048,0.9542261959627616,2,3,22337,1369,20968,0.938711554819358,10.139925333333334,1003.4804586666667,18.11571441220159,134,5.000000000000007E-4
5,test_20231101_140005,11610969.png,368720,18132,350588,0.9508244738555001,2,3,84111,2667,81444,0.9682918999892999,24.015946666666668,3561.74064,12.614180691875706,134,5.000000000000007E-4
6,test_20231101_140005,10350842.png,212614,3632,208982,0.9829173996067991,2,4,42529,533,41996,0.9874673752028028,22.303296,3145.339712,13.154128026352721,134,5.000000000000007E-4
7,test_20231101_140005,10863862.png,317432,6032,311400,0.980997504977444,1,3,66058,887,65171,0.9865724060673953,36.62354311111111,6752.591344,9.836098931580938,134,5.000000000000007E-4
8,test_20231101_140005,11382381.png,312486,527,311959,0.9983135244458952,2,3,46745,69,46676,0.9985239063001391,22.832848,2745.811376,13.744096608790418,134,5.000000000000007E-4
9,test_20231101_140005,11079715.png,443815,96804,347011,0.7818820905106858,3,4,124136,13603,110533,0.8904185731778049,18.573955555555557,2560.8911893333334,14.046892349086676,134,5.000000000000007E-4
10,test_20231101_140005,11551286.png,271883,164,271719,0.9993967993585476,1,3,40092,22,40070,0.9994512620971765,18.120286222222223,1899.5769013333334,15.344234809036362,134,5.000000000000007E-4
1,test_20231101_140006,10404007.png,502730,12667,490063,0.9748035724941818,2,4,61265,1851,59414,0.9697869909409941,26.722133333333332,3704.5875306666667,12.443405002738608,134,5.100000000000007E-4
2,test_20231101_140006,1254659.png,342646,57052,285594,0.8334957944934422,3,4,80080,8040,72040,0.8996003996003996,22.955799111111112,3856.1182026666665,12.269300228832059,134,5.100000000000007E-4
3,test_20231101_140006,10188041.png,221231,7379,213852,0.9666457232485501,2,4,41731,1047,40684,0.9749107378208047,12.369388444444445,1469.7465333333334,16.458379163687432,134,5.100000000000007E-4
4,test_20231101_140006,10287332.png,216980,9932,207048,0.9542261959627616,2,4,22337,1369,20968,0.938711554819358,10.139925333333334,1003.4804586666667,18.11571441220159,134,5.100000000000007E-4
5,test_20231101_140006,11610969.png,368720,18112,350608,0.9508787155565198,2,4,84111,2666,81445,0.9683037890406725,24.121596444444446,3571.91872,12.601787930302118,134,5.100000000000007E-4
6,test_20231101_140006,10350842.png,212614,3632,208982,0.9829173996067991,2,4,42529,533,41996,0.9874673752028028,22.303296,3145.339712,13.154128026352721,134,5.100000000000007E-4
7,test_20231101_140006,10863862.png,317432,5932,311500,0.9813125330779505,2,4,66058,872,65186,0.9867994792455115,36.81728888888889,6801.702789333333,9.804627100093077,134,5.100000000000007E-4
8,test_20231101_140006,11382381.png,312486,527,311959,0.9983135244458952,1,4,46745,69,46676,0.9985239063001391,22.832848,2745.811376,13.744096608790418,134,5.100000000000007E-4
9,test_20231101_140006,11079715.png,443815,96622,347193,0.7822921712875861,3,4,124136,13576,110560,0.8906360765611909,18.811219555555557,2602.9003253333335,13.976228231799347,134,5.100000000000007E-4
10,test_20231101_140006,11551286.png,271883,164,271719,0.9993967993585476,2,3,40092,22,40070,0.9994512620971765,18.120286222222223,1899.5769013333334,15.344234809036362,134,5.100000000000007E-4
1,test_20231101_140006,10404007.png,502730,12667,490063,0.9748035724941818,2,4,61265,1851,59414,0.9697869909409941,26.722133333333332,3704.5875306666667,12.443405002738608,134,5.200000000000007E-4
2,test_20231101_140006,1254659.png,342646,57052,285594,0.8334957944934422,2,4,80080,8040,72040,0.8996003996003996,22.955799111111112,3856.1182026666665,12.269300228832059,134,5.200000000000007E-4
3,test_20231101_140006,10188041.png,221231,7379,213852,0.9666457232485501,2,3,41731,1047,40684,0.9749107378208047,12.369388444444445,1469.7465333333334,16.458379163687432,134,5.200000000000007E-4
4,test_20231101_140006,10287332.png,216980,9932,207048,0.9542261959627616,1,3,22337,1369,20968,0.938711554819358,10.139925333333334,1003.4804586666667,18.11571441220159,134,5.200000000000007E-4
5,test_20231101_140006,11610969.png,368720,18112,350608,0.9508787155565198,2,4,84111,2666,81445,0.9683037890406725,24.121596444444446,3571.91872,12.601787930302118,134,5.200000000000007E-4
6,test_20231101_140006,10350842.png,212614,3632,208982,0.9829173996067991,2,4,42529,533,41996,0.9874673752028028,22.303296,3145.339712,13.154128026352721,134,5.200000000000007E-4
7,test_20231101_140006,10863862.png,317432,5932,311500,0.9813125330779505,2,4,66058,872,65186,0.9867994792455115,36.81728888888889,6801.702789333333,9.804627100093077,134,5.200000000000007E-4
8,test_20231101_140006,11382381.png,312486,527,311959,0.9983135244458952,1,4,46745,69,46676,0.9985239063001391,22.832848,2745.811376,13.744096608790418,134,5.200000000000007E-4
9,test_20231101_140006,11079715.png,443815,96622,347193,0.7822921712875861,3,4,124136,13576,110560,0.8906360765611909,18.811219555555557,2602.9003253333335,13.976228231799347,134,5.200000000000007E-4
10,test_20231101_140006,11551286.png,271883,164,271719,0.9993967993585476,1,4,40092,22,40070,0.9994512620971765,18.120286222222223,1899.5769013333334,15.344234809036362,134,5.200000000000007E-4
1,test_20231101_140007,10404007.png,502730,12667,490063,0.9748035724941818,2,3,61265,1851,59414,0.9697869909409941,26.722133333333332,3704.5875306666667,12.443405002738608,134,5.300000000000007E-4
2,test_20231101_140007,1254659.png,342646,57052,285594,0.8334957944934422,3,4,80080,8040,72040,0.8996003996003996,22.955799111111112,3856.1182026666665,12.269300228832059,134,5.300000000000007E-4
3,test_20231101_140007,10188041.png,221231,7379,213852,0.9666457232485501,2,4,41731,1047,40684,0.9749107378208047,12.369388444444445,1469.7465333333334,16.458379163687432,134,5.300000000000007E-4
4,test_20231101_140007,10287332.png,216980,9932,207048,0.9542261959627616,2,4,22337,1369,20968,0.938711554819358,10.139925333333334,1003.4804586666667,18.11571441220159,134,5.300000000000007E-4
5,test_20231101_140007,11610969.png,368720,18112,350608,0.9508787155565198,2,4,84111,2666,81445,0.9683037890406725,24.121596444444446,3571.91872,12.601787930302118,134,5.300000000000007E-4
6,test_20231101_140007,10350842.png,212614,3632,208982,0.9829173996067991,1,4,42529,533,41996,0.9874673752028028,22.303296,3145.339712,13.154128026352721,134,5.300000000000007E-4
7,test_20231101_140007,10863862.png,317432,5932,311500,0.9813125330779505,2,4,66058,872,65186,0.9867994792455115,36.81728888888889,6801.702789333333,9.804627100093077,134,5.300000000000007E-4
8,test_20231101_140007,11382381.png,312486,527,311959,0.9983135244458952,2,4,46745,69,46676,0.9985239063001391,22.832848,2745.811376,13.744096608790418,134,5.300000000000007E-4
9,test_20231101_140007,11079715.png,443815,96622,347193,0.7822921712875861,3,4,124136,13576,110560,0.8906360765611909,18.811219555555557,2602.9003253333335,13.976228231799347,134,5.300000000000007E-4
10,test_20231101_140007,11551286.png,271883,164,271719,0.9993967993585476,2,4,40092,22,40070,0.9994512620971765,18.120286222222223,1899.5769013333334,15.344234809036362,134,5.300000000000007E-4
1,test_20231101_140008,10404007.png,502730,12667,490063,0.9748035724941818,2,4,61265,1851,59414,0.9697869909409941,26.722133333333332,3704.5875306666667,12.443405002738608,134,5.400000000000008E-4
2,test_20231101_140008,1254659.png,342646,57052,285594,0.8334957944934422,3,4,80080,8040,72040,0.8996003996003996,22.955799111111112,3856.1182026666665,12.269300228832059,134,5.400000000000008E-4
3,test_20231101_140008,10188041.png,221231,7379,213852,0.9666457232485501,2,4,41731,1047,40684,0.9749107378208047,12.369388444444445,1469.7465333333334,16.458379163687432,134,5.400000000000008E-4
4,test_20231101_140008,10287332.png,216980,9932,207048,0.9542261959627616,2,4,22337,1369,20968,0.938711554819358,10.139925333333334,1003.4804586666667,18.11571441220159,134,5.400000000000008E-4
5,test_20231101_140008,11610969.png,368720,18112,350608,0.9508787155565198,4,4,84111,2666,81445,0.9683037890406725,24.121596444444446,3571.91872,12.601787930302118,134,5.400000000000008E-4
6,test_20231101_140008,10350842.png,212614,3632,208982,0.9829173996067991,1,3,42529,533,41996,0.9874673752028028,22.303296,3145.339712,13.154128026352721,134,5.400000000000008E-4
7,test_20231101_140008,10863862.png,317432,5932,311500,0.9813125330779505,1,3,66058,872,65186,0.9867994792455115,36.81728888888889,6801.702789333333,9.804627100093077,134,5.400000000000008E-4
8,test_20231101_140008,11382381.png,312486,527,311959,0.9983135244458952,1,3,46745,69,46676,0.9985239063001391,22.832848,2745.811376,13.744096608790418,134,5.400000000000008E-4
9,test_20231101_140008,11079715.png,443815,96622,347193,0.7822921712875861,4,4,124136,13576,110560,0.8906360765611909,18.811219555555557,2602.9003253333335,13.976228231799347,134,5.400000000000008E-4
10,test_20231101_140008,11551286.png,271883,164,271719,0.9993967993585476,1,4,40092,22,40070,0.9994512620971765,18.120286222222223,1899.5769013333334,15.344234809036362,134,5.400000000000008E-4
1,test_20231101_140009,10404007.png,502730,12667,490063,0.9748035724941818,2,4,61265,1851,59414,0.9697869909409941,26.722133333333332,3704.5875306666667,12.443405002738608,134,5.500000000000008E-4
2,test_20231101_140009,1254659.png,342646,57052,285594,0.8334957944934422,3,4,80080,8040,72040,0.8996003996003996,22.955799111111112,3856.1182026666665,12.269300228832059,134,5.500000000000008E-4
3,test_20231101_140009,10188041.png,221231,7379,213852,0.9666457232485501,2,4,41731,1047,40684,0.9749107378208047,12.369388444444445,1469.7465333333334,16.458379163687432,134,5.500000000000008E-4
4,test_20231101_140009,10287332.png,216980,9932,207048,0.9542261959627616,1,3,22337,1369,20968,0.938711554819358,10.139925333333334,1003.4804586666667,18.11571441220159,134,5.500000000000008E-4
5,test_20231101_140009,11610969.png,368720,18112,350608,0.9508787155565198,3,4,84111,2666,81445,0.9683037890406725,24.121596444444446,3571.91872,12.601787930302118,134,5.500000000000008E-4
6,test_20231101_140009,10350842.png,212614,3632,208982,0.9829173996067991,1,3,42529,533,41996,0.9874673752028028,22.303296,3145.339712,13.154128026352721,134,5.500000000000008E-4
7,test_20231101_140009,10863862.png,317432,5932,311500,0.9813125330779505,2,3,66058,872,65186,0.9867994792455115,36.81728888888889,6801.702789333333,9.804627100093077,134,5.500000000000008E-4
8,test_20231101_140009,11382381.png,312486,527,311959,0.9983135244458952,2,4,46745,69,46676,0.9985239063001391,22.832848,2745.811376,13.744096608790418,134,5.500000000000008E-4
9,test_20231101_140009,11079715.png,443815,96622,347193,0.7822921712875861,3,5,124136,13576,110560,0.8906360765611909,18.811219555555557,2602.9003253333335,13.976228231799347,134,5.500000000000008E-4
10,test_20231101_140009,11551286.png,271883,164,271719,0.9993967993585476,2,4,40092,22,40070,0.9994512620971765,18.120286222222223,1899.5769013333334,15.344234809036362,134,5.500000000000008E-4
1,test_20231101_140009,10404007.png,502730,12667,490063,0.9748035724941818,2,3,61265,1851,59414,0.9697869909409941,26.722133333333332,3704.5875306666667,12.443405002738608,134,5.600000000000008E-4
2,test_20231101_140009,1254659.png,342646,57052,285594,0.8334957944934422,3,4,80080,8040,72040,0.8996003996003996,22.955799111111112,3856.1182026666665,12.269300228832059,134,5.600000000000008E-4
3,test_20231101_140009,10188041.png,221231,7379,213852,0.9666457232485501,2,4,41731,1047,40684,0.9749107378208047,12.369388444444445,1469.7465333333334,16.458379163687432,134,5.600000000000008E-4
4,test_20231101_140009,10287332.png,216980,9932,207048,0.9542261959627616,2,4,22337,1369,20968,0.938711554819358,10.139925333333334,1003.4804586666667,18.11571441220159,134,5.600000000000008E-4
5,test_20231101_140009,11610969.png,368720,18112,350608,0.9508787155565198,5,6,84111,2666,81445,0.9683037890406725,24.121596444444446,3571.91872,12.601787930302118,134,5.600000000000008E-4
6,test_20231101_140009,10350842.png,212614,3632,208982,0.9829173996067991,2,4,42529,533,41996,0.9874673752028028,22.303296,3145.339712,13.154128026352721,134,5.600000000000008E-4
7,test_20231101_140009,10863862.png,317432,5932,311500,0.9813125330779505,2,3,66058,872,65186,0.9867994792455115,36.81728888888889,6801.702789333333,9.804627100093077,134,5.600000000000008E-4
8,test_20231101_140009,11382381.png,312486,527,311959,0.9983135244458952,1,4,46745,69,46676,0.9985239063001391,22.832848,2745.811376,13.744096608790418,134,5.600000000000008E-4
9,test_20231101_140009,11079715.png,443815,96622,347193,0.7822921712875861,4,4,124136,13576,110560,0.8906360765611909,18.811219555555557,2602.9003253333335,13.976228231799347,134,5.600000000000008E-4
10,test_20231101_140009,11551286.png,271883,164,271719,0.9993967993585476,2,4,40092,22,40070,0.9994512620971765,18.120286222222223,1899.5769013333334,15.344234809036362,134,5.600000000000008E-4
1,test_20231101_140010,10404007.png,502730,12667,490063,0.9748035724941818,2,4,61265,1851,59414,0.9697869909409941,26.722133333333332,3704.5875306666667,12.443405002738608,134,5.700000000000008E-4
2,test_20231101_140010,1254659.png,342646,57052,285594,0.8334957944934422,3,4,80080,8040,72040,0.8996003996003996,22.955799111111112,3856.1182026666665,12.269300228832059,134,5.700000000000008E-4
3,test_20231101_140010,10188041.png,221231,7379,213852,0.9666457232485501,2,4,41731,1047,40684,0.9749107378208047,12.369388444444445,1469.7465333333334,16.458379163687432,134,5.700000000000008E-4
4,test_20231101_140010,10287332.png,216980,9932,207048,0.9542261959627616,2,4,22337,1369,20968,0.938711554819358,10.139925333333334,1003.4804586666667,18.11571441220159,134,5.700000000000008E-4
5,test_20231101_140010,11610969.png,368720,18112,350608,0.9508787155565198,3,4,84111,2666,81445,0.9683037890406725,24.121596444444446,3571.91872,12.601787930302118,134,5.700000000000008E-4
6,test_20231101_140010,10350842.png,212614,3632,208982,0.9829173996067991,1,3,42529,533,41996,0.9874673752028028,22.303296,3145.339712,13.154128026352721,134,5.700000000000008E-4
7,test_20231101_140010,10863862.png,317432,5932,311500,0.9813125330779505,2,3,66058,872,65186,0.9867994792455115,36.81728888888889,6801.702789333333,9.804627100093077,134,5.700000000000008E-4
8,test_20231101_140010,11382381.png,312486,527,311959,0.9983135244458952,1,3,46745,69,46676,0.9985239063001391,22.832848,2745.811376,13.744096608790418,134,5.700000000000008E-4
9,test_20231101_140010,11079715.png,443815,96622,347193,0.7822921712875861,3,5,124136,13576,110560,0.8906360765611909,18.811219555555557,2602.9003253333335,13.976228231799347,134,5.700000000000008E-4
10,test_20231101_140010,11551286.png,271883,164,271719,0.9993967993585476,2,3,40092,22,40070,0.9994512620971765,18.120286222222223,1899.5769013333334,15.344234809036362,134,5.700000000000008E-4
1,test_20231101_140011,10404007.png,502730,12667,490063,0.9748035724941818,2,4,61265,1851,59414,0.9697869909409941,26.722133333333332,3704.5875306666667,12.443405002738608,134,5.800000000000009E-4
2,test_20231101_140011,1254659.png,342646,57052,285594,0.8334957944934422,3,4,80080,8040,72040,0.8996003996003996,22.955799111111112,3856.1182026666665,12.269300228832059,134,5.800000000000009E-4
3,test_20231101_140011,10188041.png,221231,7379,213852,0.9666457232485501,2,4,41731,1047,40684,0.9749107378208047,12.369388444444445,1469.7465333333334,16.458379163687432,134,5.800000000000009E-4
4,test_20231101_140011,10287332.png,216980,9932,207048,0.9542261959627616,3,4,22337,1369,20968,0.938711554819358,10.139925333333334,1003.4804586666667,18.11571441220159,134,5.800000000000009E-4
5,test_20231101_140011,11610969.png,368720,18112,350608,0.9508787155565198,2,4,84111,2666,81445,0.9683037890406725,24.121596444444446,3571.91872,12.601787930302118,134,5.800000000000009E-4
6,test_20231101_140011,10350842.png,212614,2887,209727,0.9864214021654265,1,3,42529,423,42106,0.99005384561123,25.03878577777778,3806.7497973333334,12.325260275808251,134,5.800000000000009E-4
7,test_20231101_140011,10863862.png,317432,5932,311500,0.9813125330779505,2,3,66058,872,65186,0.9867994792455115,36.81728888888889,6801.702789333333,9.804627100093077,134,5.800000000000009E-4
8,test_20231101_140011,11382381.png,312486,527,311959,0.9983135244458952,1,4,46745,69,46676,0.9985239063001391,22.832848,2745.811376,13.744096608790418,134,5.800000000000009E-4
9,test_20231101_140011,11079715.png,443815,96622,347193,0.7822921712875861,3,4,124136,13576,110560,0.8906360765611909,18.811219555555557,2602.9003253333335,13.976228231799347,134,5.800000000000009E-4
10,test_20231101_140011,11551286.png,271883,164,271719,0.9993967993585476,2,4,40092,22,40070,0.9994512620971765,18.120286222222223,1899.5769013333334,15.344234809036362,134,5.800000000000009E-4
1,test_20231101_140011,10404007.png,502730,12667,490063,0.9748035724941818,2,4,61265,1851,59414,0.9697869909409941,26.722133333333332,3704.5875306666667,12.443405002738608,134,5.900000000000009E-4
2,test_20231101_140011,1254659.png,342646,57052,285594,0.8334957944934422,3,4,80080,8040,72040,0.8996003996003996,22.955799111111112,3856.1182026666665,12.269300228832059,134,5.900000000000009E-4
3,test_20231101_140011,10188041.png,221231,7379,213852,0.9666457232485501,2,3,41731,1047,40684,0.9749107378208047,12.369388444444445,1469.7465333333334,16.458379163687432,134,5.900000000000009E-4
4,test_20231101_140011,10287332.png,216980,9932,207048,0.9542261959627616,2,4,22337,1369,20968,0.938711554819358,10.139925333333334,1003.4804586666667,18.11571441220159,134,5.900000000000009E-4
5,test_20231101_140011,11610969.png,368720,18112,350608,0.9508787155565198,3,6,84111,2666,81445,0.9683037890406725,24.121596444444446,3571.91872,12.601787930302118,134,5.900000000000009E-4
6,test_20231101_140011,10350842.png,212614,2887,209727,0.9864214021654265,1,4,42529,423,42106,0.99005384561123,25.03878577777778,3806.7497973333334,12.325260275808251,134,5.900000000000009E-4
7,test_20231101_140011,10863862.png,317432,5932,311500,0.9813125330779505,1,3,66058,872,65186,0.9867994792455115,36.81728888888889,6801.702789333333,9.804627100093077,134,5.900000000000009E-4
8,test_20231101_140011,11382381.png,312486,527,311959,0.9983135244458952,2,3,46745,69,46676,0.9985239063001391,22.832848,2745.811376,13.744096608790418,134,5.900000000000009E-4
9,test_20231101_140011,11079715.png,443815,96622,347193,0.7822921712875861,3,5,124136,13576,110560,0.8906360765611909,18.811219555555557,2602.9003253333335,13.976228231799347,134,5.900000000000009E-4
10,test_20231101_140011,11551286.png,271883,164,271719,0.9993967993585476,1,4,40092,22,40070,0.9994512620971765,18.120286222222223,1899.5769013333334,15.344234809036362,134,5.900000000000009E-4
1,test_20231101_140012,10404007.png,502730,12667,490063,0.9748035724941818,2,4,61265,1851,59414,0.9697869909409941,26.722133333333332,3704.5875306666667,12.443405002738608,134,6.000000000000009E-4
2,test_20231101_140012,1254659.png,342646,57052,285594,0.8334957944934422,3,4,80080,8040,72040,0.8996003996003996,22.955799111111112,3856.1182026666665,12.269300228832059,134,6.000000000000009E-4
3,test_20231101_140012,10188041.png,221231,7379,213852,0.9666457232485501,2,4,41731,1047,40684,0.9749107378208047,12.369388444444445,1469.7465333333334,16.458379163687432,134,6.000000000000009E-4
4,test_20231101_140012,10287332.png,216980,9932,207048,0.9542261959627616,1,3,22337,1369,20968,0.938711554819358,10.139925333333334,1003.4804586666667,18.11571441220159,134,6.000000000000009E-4
5,test_20231101_140012,11610969.png,368720,18112,350608,0.9508787155565198,3,3,84111,2666,81445,0.9683037890406725,24.121596444444446,3571.91872,12.601787930302118,134,6.000000000000009E-4
6,test_20231101_140012,10350842.png,212614,2887,209727,0.9864214021654265,1,3,42529,423,42106,0.99005384561123,25.03878577777778,3806.7497973333334,12.325260275808251,134,6.000000000000009E-4
7,test_20231101_140012,10863862.png,317432,5932,311500,0.9813125330779505,2,4,66058,872,65186,0.9867994792455115,36.81728888888889,6801.702789333333,9.804627100093077,134,6.000000000000009E-4
8,test_20231101_140012,11382381.png,312486,527,311959,0.9983135244458952,1,3,46745,69,46676,0.9985239063001391,22.832848,2745.811376,13.744096608790418,134,6.000000000000009E-4
9,test_20231101_140012,11079715.png,443815,96622,347193,0.7822921712875861,3,4,124136,13576,110560,0.8906360765611909,18.811219555555557,2602.9003253333335,13.976228231799347,134,6.000000000000009E-4
10,test_20231101_140012,11551286.png,271883,164,271719,0.9993967993585476,1,4,40092,22,40070,0.9994512620971765,18.120286222222223,1899.5769013333334,15.344234809036362,134,6.000000000000009E-4
1,test_20231101_140013,10404007.png,502730,12667,490063,0.9748035724941818,2,3,61265,1851,59414,0.9697869909409941,26.722133333333332,3704.5875306666667,12.443405002738608,134,6.10000000000001E-4
2,test_20231101_140013,1254659.png,342646,57052,285594,0.8334957944934422,3,4,80080,8040,72040,0.8996003996003996,22.955799111111112,3856.1182026666665,12.269300228832059,134,6.10000000000001E-4
3,test_20231101_140013,10188041.png,221231,7379,213852,0.9666457232485501,2,4,41731,1047,40684,0.9749107378208047,12.369388444444445,1469.7465333333334,16.458379163687432,134,6.10000000000001E-4
4,test_20231101_140013,10287332.png,216980,9932,207048,0.9542261959627616,2,3,22337,1369,20968,0.938711554819358,10.139925333333334,1003.4804586666667,18.11571441220159,134,6.10000000000001E-4
5,test_20231101_140013,11610969.png,368720,18112,350608,0.9508787155565198,3,3,84111,2666,81445,0.9683037890406725,24.121596444444446,3571.91872,12.601787930302118,134,6.10000000000001E-4
6,test_20231101_140013,10350842.png,212614,2887,209727,0.9864214021654265,1,4,42529,423,42106,0.99005384561123,25.03878577777778,3806.7497973333334,12.325260275808251,134,6.10000000000001E-4
7,test_20231101_140013,10863862.png,317432,5932,311500,0.9813125330779505,3,4,66058,872,65186,0.9867994792455115,36.81728888888889,6801.702789333333,9.804627100093077,134,6.10000000000001E-4
8,test_20231101_140013,11382381.png,312486,527,311959,0.9983135244458952,1,3,46745,69,46676,0.9985239063001391,22.832848,2745.811376,13.744096608790418,134,6.10000000000001E-4
9,test_20231101_140013,11079715.png,443815,96622,347193,0.7822921712875861,3,4,124136,13576,110560,0.8906360765611909,18.811219555555557,2602.9003253333335,13.976228231799347,134,6.10000000000001E-4
10,test_20231101_140013,11551286.png,271883,164,271719,0.9993967993585476,1,4,40092,22,40070,0.9994512620971765,18.120286222222223,1899.5769013333334,15.344234809036362,134,6.10000000000001E-4
1,test_20231101_140014,10404007.png,502730,12667,490063,0.9748035724941818,2,4,61265,1851,59414,0.9697869909409941,26.722133333333332,3704.5875306666667,12.443405002738608,134,6.20000000000001E-4
2,test_20231101_140014,1254659.png,342646,57052,285594,0.8334957944934422,3,4,80080,8040,72040,0.8996003996003996,22.955799111111112,3856.1182026666665,12.269300228832059,134,6.20000000000001E-4
3,test_20231101_140014,10188041.png,221231,7379,213852,0.9666457232485501,2,4,41731,1047,40684,0.9749107378208047,12.369388444444445,1469.7465333333334,16.458379163687432,134,6.20000000000001E-4
4,test_20231101_140014,10287332.png,216980,9932,207048,0.9542261959627616,2,4,22337,1369,20968,0.938711554819358,10.139925333333334,1003.4804586666667,18.11571441220159,134,6.20000000000001E-4
5,test_20231101_140014,11610969.png,368720,18112,350608,0.9508787155565198,2,7,84111,2666,81445,0.9683037890406725,24.121596444444446,3571.91872,12.601787930302118,134,6.20000000000001E-4
6,test_20231101_140014,10350842.png,212614,2887,209727,0.9864214021654265,1,4,42529,423,42106,0.99005384561123,25.03878577777778,3806.7497973333334,12.325260275808251,134,6.20000000000001E-4
7,test_20231101_140014,10863862.png,317432,5932,311500,0.9813125330779505,2,4,66058,872,65186,0.9867994792455115,36.81728888888889,6801.702789333333,9.804627100093077,134,6.20000000000001E-4
8,test_20231101_140014,11382381.png,312486,527,311959,0.9983135244458952,1,4,46745,69,46676,0.9985239063001391,22.832848,2745.811376,13.744096608790418,134,6.20000000000001E-4
9,test_20231101_140014,11079715.png,443815,96622,347193,0.7822921712875861,3,5,124136,13576,110560,0.8906360765611909,18.811219555555557,2602.9003253333335,13.976228231799347,134,6.20000000000001E-4
10,test_20231101_140014,11551286.png,271883,164,271719,0.9993967993585476,1,4,40092,22,40070,0.9994512620971765,18.120286222222223,1899.5769013333334,15.344234809036362,134,6.20000000000001E-4
1,test_20231101_140014,10404007.png,502730,12667,490063,0.9748035724941818,2,3,61265,1851,59414,0.9697869909409941,26.722133333333332,3704.5875306666667,12.443405002738608,134,6.30000000000001E-4
2,test_20231101_140014,1254659.png,342646,57052,285594,0.8334957944934422,3,4,80080,8040,72040,0.8996003996003996,22.955799111111112,3856.1182026666665,12.269300228832059,134,6.30000000000001E-4
3,test_20231101_140014,10188041.png,221231,7379,213852,0.9666457232485501,2,4,41731,1047,40684,0.9749107378208047,12.369388444444445,1469.7465333333334,16.458379163687432,134,6.30000000000001E-4
4,test_20231101_140014,10287332.png,216980,9932,207048,0.9542261959627616,2,3,22337,1369,20968,0.938711554819358,10.139925333333334,1003.4804586666667,18.11571441220159,134,6.30000000000001E-4
5,test_20231101_140014,11610969.png,368720,18112,350608,0.9508787155565198,3,4,84111,2666,81445,0.9683037890406725,24.121596444444446,3571.91872,12.601787930302118,134,6.30000000000001E-4
6,test_20231101_140014,10350842.png,212614,2887,209727,0.9864214021654265,2,3,42529,423,42106,0.99005384561123,25.03878577777778,3806.7497973333334,12.325260275808251,134,6.30000000000001E-4
7,test_20231101_140014,10863862.png,317432,5932,311500,0.9813125330779505,1,3,66058,872,65186,0.9867994792455115,36.81728888888889,6801.702789333333,9.804627100093077,134,6.30000000000001E-4
8,test_20231101_140014,11382381.png,312486,527,311959,0.9983135244458952,2,4,46745,69,46676,0.9985239063001391,22.832848,2745.811376,13.744096608790418,134,6.30000000000001E-4
9,test_20231101_140014,11079715.png,443815,96622,347193,0.7822921712875861,3,4,124136,13576,110560,0.8906360765611909,18.811219555555557,2602.9003253333335,13.976228231799347,134,6.30000000000001E-4
10,test_20231101_140014,11551286.png,271883,164,271719,0.9993967993585476,1,3,40092,22,40070,0.9994512620971765,18.120286222222223,1899.5769013333334,15.344234809036362,134,6.30000000000001E-4
1,test_20231101_140015,10404007.png,502730,12667,490063,0.9748035724941818,2,4,61265,1851,59414,0.9697869909409941,26.722133333333332,3704.5875306666667,12.443405002738608,134,6.40000000000001E-4
2,test_20231101_140015,1254659.png,342646,57052,285594,0.8334957944934422,3,4,80080,8040,72040,0.8996003996003996,22.955799111111112,3856.1182026666665,12.269300228832059,134,6.40000000000001E-4
3,test_20231101_140015,10188041.png,221231,7299,213932,0.9670073362232237,2,4,41731,1037,40694,0.9751503678320673,12.408289777777778,1473.8310346666667,16.446326635850774,134,6.40000000000001E-4
4,test_20231101_140015,10287332.png,216980,9932,207048,0.9542261959627616,2,4,22337,1369,20968,0.938711554819358,10.139925333333334,1003.4804586666667,18.11571441220159,134,6.40000000000001E-4
5,test_20231101_140015,11610969.png,368720,18112,350608,0.9508787155565198,2,4,84111,2666,81445,0.9683037890406725,24.121596444444446,3571.91872,12.601787930302118,134,6.40000000000001E-4
6,test_20231101_140015,10350842.png,212614,2887,209727,0.9864214021654265,2,8,42529,423,42106,0.99005384561123,25.03878577777778,3806.7497973333334,12.325260275808251,134,6.40000000000001E-4
7,test_20231101_140015,10863862.png,317432,5672,311760,0.9821316061392676,2,4,66058,833,65225,0.9873898695086136,37.39797155555556,6962.308986666667,9.703270675406442,134,6.40000000000001E-4
8,test_20231101_140015,11382381.png,312486,527,311959,0.9983135244458952,2,4,46745,69,46676,0.9985239063001391,22.832848,2745.811376,13.744096608790418,134,6.40000000000001E-4
9,test_20231101_140015,11079715.png,443815,96622,347193,0.7822921712875861,3,5,124136,13576,110560,0.8906360765611909,18.811219555555557,2602.9003253333335,13.976228231799347,134,6.40000000000001E-4
10,test_20231101_140015,11551286.png,271883,164,271719,0.9993967993585476,1,4,40092,22,40070,0.9994512620971765,18.120286222222223,1899.5769013333334,15.344234809036362,134,6.40000000000001E-4
1,test_20231101_140016,10404007.png,502730,12667,490063,0.9748035724941818,2,3,61265,1851,59414,0.9697869909409941,26.722133333333332,3704.5875306666667,12.443405002738608,134,6.500000000000011E-4
2,test_20231101_140016,1254659.png,342646,57052,285594,0.8334957944934422,2,3,80080,8040,72040,0.8996003996003996,22.955799111111112,3856.1182026666665,12.269300228832059,134,6.500000000000011E-4
3,test_20231101_140016,10188041.png,221231,7299,213932,0.9670073362232237,1,3,41731,1037,40694,0.9751503678320673,12.408289777777778,1473.8310346666667,16.446326635850774,134,6.500000000000011E-4
4,test_20231101_140016,10287332.png,216980,9932,207048,0.9542261959627616,2,4,22337,1369,20968,0.938711554819358,10.139925333333334,1003.4804586666667,18.11571441220159,134,6.500000000000011E-4
5,test_20231101_140016,11610969.png,368720,18112,350608,0.9508787155565198,2,4,84111,2666,81445,0.9683037890406725,24.121596444444446,3571.91872,12.601787930302118,134,6.500000000000011E-4
6,test_20231101_140016,10350842.png,212614,2887,209727,0.9864214021654265,1,4,42529,423,42106,0.99005384561123,25.03878577777778,3806.7497973333334,12.325260275808251,134,6.500000000000011E-4
7,test_20231101_140016,10863862.png,317432,5672,311760,0.9821316061392676,1,3,66058,833,65225,0.9873898695086136,37.39797155555556,6962.308986666667,9.703270675406442,134,6.500000000000011E-4
8,test_20231101_140016,11382381.png,312486,527,311959,0.9983135244458952,1,3,46745,69,46676,0.9985239063001391,22.832848,2745.811376,13.744096608790418,134,6.500000000000011E-4
9,test_20231101_140016,11079715.png,443815,96622,347193,0.7822921712875861,3,4,124136,13576,110560,0.8906360765611909,18.811219555555557,2602.9003253333335,13.976228231799347,134,6.500000000000011E-4
10,test_20231101_140016,11551286.png,271883,164,271719,0.9993967993585476,2,3,40092,22,40070,0.9994512620971765,18.120286222222223,1899.5769013333334,15.344234809036362,134,6.500000000000011E-4
1,test_20231101_140016,10404007.png,502730,12667,490063,0.9748035724941818,2,11,61265,1851,59414,0.9697869909409941,26.722133333333332,3704.5875306666667,12.443405002738608,134,6.600000000000011E-4
2,test_20231101_140016,1254659.png,342646,57052,285594,0.8334957944934422,3,4,80080,8040,72040,0.8996003996003996,22.955799111111112,3856.1182026666665,12.269300228832059,134,6.600000000000011E-4
3,test_20231101_140016,10188041.png,221231,7299,213932,0.9670073362232237,2,3,41731,1037,40694,0.9751503678320673,12.408289777777778,1473.8310346666667,16.446326635850774,134,6.600000000000011E-4
4,test_20231101_140016,10287332.png,216980,9932,207048,0.9542261959627616,2,4,22337,1369,20968,0.938711554819358,10.139925333333334,1003.4804586666667,18.11571441220159,134,6.600000000000011E-4
5,test_20231101_140016,11610969.png,368720,18112,350608,0.9508787155565198,2,4,84111,2666,81445,0.9683037890406725,24.121596444444446,3571.91872,12.601787930302118,134,6.600000000000011E-4
6,test_20231101_140016,10350842.png,212614,2887,209727,0.9864214021654265,2,3,42529,423,42106,0.99005384561123,25.03878577777778,3806.7497973333334,12.325260275808251,134,6.600000000000011E-4
7,test_20231101_140016,10863862.png,317432,5672,311760,0.9821316061392676,2,6,66058,833,65225,0.9873898695086136,37.39797155555556,6962.308986666667,9.703270675406442,134,6.600000000000011E-4
8,test_20231101_140016,11382381.png,312486,527,311959,0.9983135244458952,1,3,46745,69,46676,0.9985239063001391,22.832848,2745.811376,13.744096608790418,134,6.600000000000011E-4
9,test_20231101_140016,11079715.png,443815,96622,347193,0.7822921712875861,3,4,124136,13576,110560,0.8906360765611909,18.811219555555557,2602.9003253333335,13.976228231799347,134,6.600000000000011E-4
10,test_20231101_140016,11551286.png,271883,164,271719,0.9993967993585476,2,3,40092,22,40070,0.9994512620971765,18.120286222222223,1899.5769013333334,15.344234809036362,134,6.600000000000011E-4
1,test_20231101_140017,10404007.png,502730,12667,490063,0.9748035724941818,2,4,61265,1851,59414,0.9697869909409941,26.722133333333332,3704.5875306666667,12.443405002738608,134,6.700000000000011E-4
2,test_20231101_140017,1254659.png,342646,57052,285594,0.8334957944934422,3,4,80080,8040,72040,0.8996003996003996,22.955799111111112,3856.1182026666665,12.269300228832059,134,6.700000000000011E-4
3,test_20231101_140017,10188041.png,221231,7299,213932,0.9670073362232237,2,4,41731,1037,40694,0.9751503678320673,12.408289777777778,1473.8310346666667,16.446326635850774,134,6.700000000000011E-4
4,test_20231101_140017,10287332.png,216980,9932,207048,0.9542261959627616,1,4,22337,1369,20968,0.938711554819358,10.139925333333334,1003.4804586666667,18.11571441220159,134,6.700000000000011E-4
5,test_20231101_140017,11610969.png,368720,18112,350608,0.9508787155565198,2,3,84111,2666,81445,0.9683037890406725,24.121596444444446,3571.91872,12.601787930302118,134,6.700000000000011E-4
6,test_20231101_140017,10350842.png,212614,2887,209727,0.9864214021654265,1,4,42529,423,42106,0.99005384561123,25.03878577777778,3806.7497973333334,12.325260275808251,134,6.700000000000011E-4
7,test_20231101_140017,10863862.png,317432,5672,311760,0.9821316061392676,1,11,66058,833,65225,0.9873898695086136,37.39797155555556,6962.308986666667,9.703270675406442,134,6.700000000000011E-4
8,test_20231101_140017,11382381.png,312486,527,311959,0.9983135244458952,1,4,46745,69,46676,0.9985239063001391,22.832848,2745.811376,13.744096608790418,134,6.700000000000011E-4
9,test_20231101_140017,11079715.png,443815,96622,347193,0.7822921712875861,3,4,124136,13576,110560,0.8906360765611909,18.811219555555557,2602.9003253333335,13.976228231799347,134,6.700000000000011E-4
10,test_20231101_140017,11551286.png,271883,164,271719,0.9993967993585476,1,3,40092,22,40070,0.9994512620971765,18.120286222222223,1899.5769013333334,15.344234809036362,134,6.700000000000011E-4
1,test_20231101_140018,10404007.png,502730,12062,490668,0.976007001770334,1,3,61265,1765,59500,0.9711907288011099,27.093313777777777,3786.4106613333333,12.348526465705234,134,6.800000000000011E-4
2,test_20231101_140018,1254659.png,342646,57052,285594,0.8334957944934422,2,3,80080,8040,72040,0.8996003996003996,22.955799111111112,3856.1182026666665,12.269300228832059,134,6.800000000000011E-4
3,test_20231101_140018,10188041.png,221231,7299,213932,0.9670073362232237,2,4,41731,1037,40694,0.9751503678320673,12.408289777777778,1473.8310346666667,16.446326635850774,134,6.800000000000011E-4
4,test_20231101_140018,10287332.png,216980,9932,207048,0.9542261959627616,1,4,22337,1369,20968,0.938711554819358,10.139925333333334,1003.4804586666667,18.11571441220159,134,6.800000000000011E-4
5,test_20231101_140018,11610969.png,368720,18112,350608,0.9508787155565198,2,4,84111,2666,81445,0.9683037890406725,24.121596444444446,3571.91872,12.601787930302118,134,6.800000000000011E-4
6,test_20231101_140018,10350842.png,212614,2887,209727,0.9864214021654265,2,3,42529,423,42106,0.99005384561123,25.03878577777778,3806.7497973333334,12.325260275808251,134,6.800000000000011E-4
7,test_20231101_140018,10863862.png,317432,5672,311760,0.9821316061392676,1,4,66058,833,65225,0.9873898695086136,37.39797155555556,6962.308986666667,9.703270675406442,134,6.800000000000011E-4
8,test_20231101_140018,11382381.png,312486,527,311959,0.9983135244458952,1,4,46745,69,46676,0.9985239063001391,22.832848,2745.811376,13.744096608790418,134,6.800000000000011E-4
9,test_20231101_140018,11079715.png,443815,96622,347193,0.7822921712875861,3,4,124136,13576,110560,0.8906360765611909,18.811219555555557,2602.9003253333335,13.976228231799347,134,6.800000000000011E-4
10,test_20231101_140018,11551286.png,271883,164,271719,0.9993967993585476,1,3,40092,22,40070,0.9994512620971765,18.120286222222223,1899.5769013333334,15.344234809036362,134,6.800000000000011E-4
1,test_20231101_140018,10404007.png,502730,12062,490668,0.976007001770334,2,3,61265,1765,59500,0.9711907288011099,27.093313777777777,3786.4106613333333,12.348526465705234,134,6.900000000000012E-4
2,test_20231101_140018,1254659.png,342646,57052,285594,0.8334957944934422,3,4,80080,8040,72040,0.8996003996003996,22.955799111111112,3856.1182026666665,12.269300228832059,134,6.900000000000012E-4
3,test_20231101_140018,10188041.png,221231,7299,213932,0.9670073362232237,2,4,41731,1037,40694,0.9751503678320673,12.408289777777778,1473.8310346666667,16.446326635850774,134,6.900000000000012E-4
4,test_20231101_140018,10287332.png,216980,9932,207048,0.9542261959627616,2,4,22337,1369,20968,0.938711554819358,10.139925333333334,1003.4804586666667,18.11571441220159,134,6.900000000000012E-4
5,test_20231101_140018,11610969.png,368720,18112,350608,0.9508787155565198,2,3,84111,2666,81445,0.9683037890406725,24.121596444444446,3571.91872,12.601787930302118,134,6.900000000000012E-4
6,test_20231101_140018,10350842.png,212614,2887,209727,0.9864214021654265,2,4,42529,423,42106,0.99005384561123,25.03878577777778,3806.7497973333334,12.325260275808251,134,6.900000000000012E-4
7,test_20231101_140018,10863862.png,317432,5672,311760,0.9821316061392676,1,3,66058,833,65225,0.9873898695086136,37.39797155555556,6962.308986666667,9.703270675406442,134,6.900000000000012E-4
8,test_20231101_140018,11382381.png,312486,527,311959,0.9983135244458952,2,3,46745,69,46676,0.9985239063001391,22.832848,2745.811376,13.744096608790418,134,6.900000000000012E-4
9,test_20231101_140018,11079715.png,443815,96622,347193,0.7822921712875861,4,4,124136,13576,110560,0.8906360765611909,18.811219555555557,2602.9003253333335,13.976228231799347,134,6.900000000000012E-4
10,test_20231101_140018,11551286.png,271883,24,271859,0.9999117267353972,0,3,40092,1,40091,0.9999750573680535,24.866876444444443,3470.407338666667,12.72699907819776,134,6.900000000000012E-4
1,test_20231101_140019,10404007.png,502730,12062,490668,0.976007001770334,2,3,61265,1765,59500,0.9711907288011099,27.093313777777777,3786.4106613333333,12.348526465705234,134,7.000000000000012E-4
2,test_20231101_140019,1254659.png,342646,57052,285594,0.8334957944934422,3,4,80080,8040,72040,0.8996003996003996,22.955799111111112,3856.1182026666665,12.269300228832059,134,7.000000000000012E-4
3,test_20231101_140019,10188041.png,221231,7299,213932,0.9670073362232237,2,3,41731,1037,40694,0.9751503678320673,12.408289777777778,1473.8310346666667,16.446326635850774,134,7.000000000000012E-4
4,test_20231101_140019,10287332.png,216980,9932,207048,0.9542261959627616,1,3,22337,1369,20968,0.938711554819358,10.139925333333334,1003.4804586666667,18.11571441220159,134,7.000000000000012E-4
5,test_20231101_140019,11610969.png,368720,18112,350608,0.9508787155565198,2,3,84111,2666,81445,0.9683037890406725,24.121596444444446,3571.91872,12.601787930302118,134,7.000000000000012E-4
6,test_20231101_140019,10350842.png,212614,2887,209727,0.9864214021654265,1,4,42529,423,42106,0.99005384561123,25.03878577777778,3806.7497973333334,12.325260275808251,134,7.000000000000012E-4
7,test_20231101_140019,10863862.png,317432,5672,311760,0.9821316061392676,2,3,66058,833,65225,0.9873898695086136,37.39797155555556,6962.308986666667,9.703270675406442,134,7.000000000000012E-4
8,test_20231101_140019,11382381.png,312486,527,311959,0.9983135244458952,1,4,46745,69,46676,0.9985239063001391,22.832848,2745.811376,13.744096608790418,134,7.000000000000012E-4
9,test_20231101_140019,11079715.png,443815,96622,347193,0.7822921712875861,3,4,124136,13576,110560,0.8906360765611909,18.811219555555557,2602.9003253333335,13.976228231799347,134,7.000000000000012E-4
10,test_20231101_140019,11551286.png,271883,24,271859,0.9999117267353972,0,3,40092,1,40091,0.9999750573680535,24.866876444444443,3470.407338666667,12.72699907819776,134,7.000000000000012E-4
1,test_20231101_140020,10404007.png,502730,12062,490668,0.976007001770334,2,4,61265,1765,59500,0.9711907288011099,27.093313777777777,3786.4106613333333,12.348526465705234,134,7.100000000000012E-4
2,test_20231101_140020,1254659.png,342646,57052,285594,0.8334957944934422,3,4,80080,8040,72040,0.8996003996003996,22.955799111111112,3856.1182026666665,12.269300228832059,134,7.100000000000012E-4
3,test_20231101_140020,10188041.png,221231,7299,213932,0.9670073362232237,1,3,41731,1037,40694,0.9751503678320673,12.408289777777778,1473.8310346666667,16.446326635850774,134,7.100000000000012E-4
4,test_20231101_140020,10287332.png,216980,9932,207048,0.9542261959627616,8,4,22337,1369,20968,0.938711554819358,10.139925333333334,1003.4804586666667,18.11571441220159,134,7.100000000000012E-4
5,test_20231101_140020,11610969.png,368720,18112,350608,0.9508787155565198,3,4,84111,2666,81445,0.9683037890406725,24.121596444444446,3571.91872,12.601787930302118,134,7.100000000000012E-4
6,test_20231101_140020,10350842.png,212614,2887,209727,0.9864214021654265,2,4,42529,423,42106,0.99005384561123,25.03878577777778,3806.7497973333334,12.325260275808251,134,7.100000000000012E-4
7,test_20231101_140020,10863862.png,317432,5672,311760,0.9821316061392676,1,4,66058,833,65225,0.9873898695086136,37.39797155555556,6962.308986666667,9.703270675406442,134,7.100000000000012E-4
8,test_20231101_140020,11382381.png,312486,527,311959,0.9983135244458952,1,4,46745,69,46676,0.9985239063001391,22.832848,2745.811376,13.744096608790418,134,7.100000000000012E-4
9,test_20231101_140020,11079715.png,443815,96622,347193,0.7822921712875861,3,4,124136,13576,110560,0.8906360765611909,18.811219555555557,2602.9003253333335,13.976228231799347,134,7.100000000000012E-4
10,test_20231101_140020,11551286.png,271883,24,271859,0.9999117267353972,1,3,40092,1,40091,0.9999750573680535,24.866876444444443,3470.407338666667,12.72699907819776,134,7.100000000000012E-4
1,test_20231101_140020,10404007.png,502730,12062,490668,0.976007001770334,2,3,61265,1765,59500,0.9711907288011099,27.093313777777777,3786.4106613333333,12.348526465705234,134,7.200000000000012E-4
2,test_20231101_140020,1254659.png,342646,57052,285594,0.8334957944934422,3,4,80080,8040,72040,0.8996003996003996,22.955799111111112,3856.1182026666665,12.269300228832059,134,7.200000000000012E-4
3,test_20231101_140020,10188041.png,221231,7299,213932,0.9670073362232237,2,3,41731,1037,40694,0.9751503678320673,12.408289777777778,1473.8310346666667,16.446326635850774,134,7.200000000000012E-4
4,test_20231101_140020,10287332.png,216980,9932,207048,0.9542261959627616,1,4,22337,1369,20968,0.938711554819358,10.139925333333334,1003.4804586666667,18.11571441220159,134,7.200000000000012E-4
5,test_20231101_140020,11610969.png,368720,18112,350608,0.9508787155565198,3,3,84111,2666,81445,0.9683037890406725,24.121596444444446,3571.91872,12.601787930302118,134,7.200000000000012E-4
6,test_20231101_140020,10350842.png,212614,2887,209727,0.9864214021654265,1,4,42529,423,42106,0.99005384561123,25.03878577777778,3806.7497973333334,12.325260275808251,134,7.200000000000012E-4
7,test_20231101_140020,10863862.png,317432,5672,311760,0.9821316061392676,2,4,66058,833,65225,0.9873898695086136,37.39797155555556,6962.308986666667,9.703270675406442,134,7.200000000000012E-4
8,test_20231101_140020,11382381.png,312486,527,311959,0.9983135244458952,1,4,46745,69,46676,0.9985239063001391,22.832848,2745.811376,13.744096608790418,134,7.200000000000012E-4
9,test_20231101_140020,11079715.png,443815,96622,347193,0.7822921712875861,3,4,124136,13576,110560,0.8906360765611909,18.811219555555557,2602.9003253333335,13.976228231799347,134,7.200000000000012E-4
10,test_20231101_140020,11551286.png,271883,24,271859,0.9999117267353972,1,3,40092,1,40091,0.9999750573680535,24.866876444444443,3470.407338666667,12.72699907819776,134,7.200000000000012E-4
1,test_20231101_140021,10404007.png,502730,12062,490668,0.976007001770334,1,3,61265,1765,59500,0.9711907288011099,27.093313777777777,3786.4106613333333,12.348526465705234,134,7.300000000000013E-4
2,test_20231101_140021,1254659.png,342646,57052,285594,0.8334957944934422,3,4,80080,8040,72040,0.8996003996003996,22.955799111111112,3856.1182026666665,12.269300228832059,134,7.300000000000013E-4
3,test_20231101_140021,10188041.png,221231,7299,213932,0.9670073362232237,2,3,41731,1037,40694,0.9751503678320673,12.408289777777778,1473.8310346666667,16.446326635850774,134,7.300000000000013E-4
4,test_20231101_140021,10287332.png,216980,9932,207048,0.9542261959627616,2,3,22337,1369,20968,0.938711554819358,10.139925333333334,1003.4804586666667,18.11571441220159,134,7.300000000000013E-4
5,test_20231101_140021,11610969.png,368720,18112,350608,0.9508787155565198,3,3,84111,2666,81445,0.9683037890406725,24.121596444444446,3571.91872,12.601787930302118,134,7.300000000000013E-4
6,test_20231101_140021,10350842.png,212614,2887,209727,0.9864214021654265,1,3,42529,423,42106,0.99005384561123,25.03878577777778,3806.7497973333334,12.325260275808251,134,7.300000000000013E-4
7,test_20231101_140021,10863862.png,317432,5672,311760,0.9821316061392676,2,4,66058,833,65225,0.9873898695086136,37.39797155555556,6962.308986666667,9.703270675406442,134,7.300000000000013E-4
8,test_20231101_140021,11382381.png,312486,527,311959,0.9983135244458952,1,3,46745,69,46676,0.9985239063001391,22.832848,2745.811376,13.744096608790418,134,7.300000000000013E-4
9,test_20231101_140021,11079715.png,443815,96622,347193,0.7822921712875861,3,4,124136,13576,110560,0.8906360765611909,18.811219555555557,2602.9003253333335,13.976228231799347,134,7.300000000000013E-4
10,test_20231101_140021,11551286.png,271883,24,271859,0.9999117267353972,1,4,40092,1,40091,0.9999750573680535,24.866876444444443,3470.407338666667,12.72699907819776,134,7.300000000000013E-4
1,test_20231101_140022,10404007.png,502730,12062,490668,0.976007001770334,2,4,61265,1765,59500,0.9711907288011099,27.093313777777777,3786.4106613333333,12.348526465705234,134,7.400000000000013E-4
2,test_20231101_140022,1254659.png,342646,57052,285594,0.8334957944934422,3,4,80080,8040,72040,0.8996003996003996,22.955799111111112,3856.1182026666665,12.269300228832059,134,7.400000000000013E-4
3,test_20231101_140022,10188041.png,221231,7299,213932,0.9670073362232237,2,3,41731,1037,40694,0.9751503678320673,12.408289777777778,1473.8310346666667,16.446326635850774,134,7.400000000000013E-4
4,test_20231101_140022,10287332.png,216980,9932,207048,0.9542261959627616,2,4,22337,1369,20968,0.938711554819358,10.139925333333334,1003.4804586666667,18.11571441220159,134,7.400000000000013E-4
5,test_20231101_140022,11610969.png,368720,18112,350608,0.9508787155565198,2,3,84111,2666,81445,0.9683037890406725,24.121596444444446,3571.91872,12.601787930302118,134,7.400000000000013E-4
6,test_20231101_140022,10350842.png,212614,2887,209727,0.9864214021654265,1,3,42529,423,42106,0.99005384561123,25.03878577777778,3806.7497973333334,12.325260275808251,134,7.400000000000013E-4
7,test_20231101_140022,10863862.png,317432,5672,311760,0.9821316061392676,1,4,66058,833,65225,0.9873898695086136,37.39797155555556,6962.308986666667,9.703270675406442,134,7.400000000000013E-4
8,test_20231101_140022,11382381.png,312486,527,311959,0.9983135244458952,2,4,46745,69,46676,0.9985239063001391,22.832848,2745.811376,13.744096608790418,134,7.400000000000013E-4
9,test_20231101_140022,11079715.png,443815,96622,347193,0.7822921712875861,4,4,124136,13576,110560,0.8906360765611909,18.811219555555557,2602.9003253333335,13.976228231799347,134,7.400000000000013E-4
10,test_20231101_140022,11551286.png,271883,24,271859,0.9999117267353972,1,4,40092,1,40091,0.9999750573680535,24.866876444444443,3470.407338666667,12.72699907819776,134,7.400000000000013E-4
1,test_20231101_140022,10404007.png,502730,12062,490668,0.976007001770334,3,4,61265,1765,59500,0.9711907288011099,27.093313777777777,3786.4106613333333,12.348526465705234,134,7.500000000000013E-4
2,test_20231101_140022,1254659.png,342646,57052,285594,0.8334957944934422,4,4,80080,8040,72040,0.8996003996003996,22.955799111111112,3856.1182026666665,12.269300228832059,134,7.500000000000013E-4
3,test_20231101_140022,10188041.png,221231,7299,213932,0.9670073362232237,2,3,41731,1037,40694,0.9751503678320673,12.408289777777778,1473.8310346666667,16.446326635850774,134,7.500000000000013E-4
4,test_20231101_140022,10287332.png,216980,9932,207048,0.9542261959627616,2,4,22337,1369,20968,0.938711554819358,10.139925333333334,1003.4804586666667,18.11571441220159,134,7.500000000000013E-4
5,test_20231101_140022,11610969.png,368720,18112,350608,0.9508787155565198,2,3,84111,2666,81445,0.9683037890406725,24.121596444444446,3571.91872,12.601787930302118,134,7.500000000000013E-4
6,test_20231101_140022,10350842.png,212614,2887,209727,0.9864214021654265,1,4,42529,423,42106,0.99005384561123,25.03878577777778,3806.7497973333334,12.325260275808251,134,7.500000000000013E-4
7,test_20231101_140022,10863862.png,317432,5672,311760,0.9821316061392676,1,3,66058,833,65225,0.9873898695086136,37.39797155555556,6962.308986666667,9.703270675406442,134,7.500000000000013E-4
8,test_20231101_140022,11382381.png,312486,527,311959,0.9983135244458952,1,3,46745,69,46676,0.9985239063001391,22.832848,2745.811376,13.744096608790418,134,7.500000000000013E-4
9,test_20231101_140022,11079715.png,443815,96622,347193,0.7822921712875861,4,7,124136,13576,110560,0.8906360765611909,18.811219555555557,2602.9003253333335,13.976228231799347,134,7.500000000000013E-4
10,test_20231101_140022,11551286.png,271883,24,271859,0.9999117267353972,1,4,40092,1,40091,0.9999750573680535,24.866876444444443,3470.407338666667,12.72699907819776,134,7.500000000000013E-4
1,test_20231101_140023,10404007.png,502730,12062,490668,0.976007001770334,2,4,61265,1765,59500,0.9711907288011099,27.093313777777777,3786.4106613333333,12.348526465705234,134,7.600000000000013E-4
2,test_20231101_140023,1254659.png,342646,57052,285594,0.8334957944934422,3,4,80080,8040,72040,0.8996003996003996,22.955799111111112,3856.1182026666665,12.269300228832059,134,7.600000000000013E-4
3,test_20231101_140023,10188041.png,221231,7299,213932,0.9670073362232237,2,4,41731,1037,40694,0.9751503678320673,12.408289777777778,1473.8310346666667,16.446326635850774,134,7.600000000000013E-4
4,test_20231101_140023,10287332.png,216980,9932,207048,0.9542261959627616,2,4,22337,1369,20968,0.938711554819358,10.139925333333334,1003.4804586666667,18.11571441220159,134,7.600000000000013E-4
5,test_20231101_140023,11610969.png,368720,18112,350608,0.9508787155565198,2,4,84111,2666,81445,0.9683037890406725,24.121596444444446,3571.91872,12.601787930302118,134,7.600000000000013E-4
6,test_20231101_140023,10350842.png,212614,2867,209747,0.9865154693482084,2,4,42529,420,42109,0.990124385713278,25.501523555555554,3887.939909333333,12.233608168684624,134,7.600000000000013E-4
7,test_20231101_140023,10863862.png,317432,5672,311760,0.9821316061392676,2,4,66058,833,65225,0.9873898695086136,37.39797155555556,6962.308986666667,9.703270675406442,134,7.600000000000013E-4
8,test_20231101_140023,11382381.png,312486,527,311959,0.9983135244458952,2,4,46745,69,46676,0.9985239063001391,22.832848,2745.811376,13.744096608790418,134,7.600000000000013E-4
9,test_20231101_140023,11079715.png,443815,96622,347193,0.7822921712875861,3,4,124136,13576,110560,0.8906360765611909,18.811219555555557,2602.9003253333335,13.976228231799347,134,7.600000000000013E-4
10,test_20231101_140023,11551286.png,271883,24,271859,0.9999117267353972,1,4,40092,1,40091,0.9999750573680535,24.866876444444443,3470.407338666667,12.72699907819776,134,7.600000000000013E-4
1,test_20231101_140024,10404007.png,502730,12062,490668,0.976007001770334,2,3,61265,1765,59500,0.9711907288011099,27.093313777777777,3786.4106613333333,12.348526465705234,134,7.700000000000014E-4
2,test_20231101_140024,1254659.png,342646,57052,285594,0.8334957944934422,3,4,80080,8040,72040,0.8996003996003996,22.955799111111112,3856.1182026666665,12.269300228832059,134,7.700000000000014E-4
3,test_20231101_140024,10188041.png,221231,7299,213932,0.9670073362232237,2,3,41731,1037,40694,0.9751503678320673,12.408289777777778,1473.8310346666667,16.446326635850774,134,7.700000000000014E-4
4,test_20231101_140024,10287332.png,216980,9932,207048,0.9542261959627616,2,5,22337,1369,20968,0.938711554819358,10.139925333333334,1003.4804586666667,18.11571441220159,134,7.700000000000014E-4
5,test_20231101_140024,11610969.png,368720,18112,350608,0.9508787155565198,2,3,84111,2666,81445,0.9683037890406725,24.121596444444446,3571.91872,12.601787930302118,134,7.700000000000014E-4
6,test_20231101_140024,10350842.png,212614,2547,210067,0.9880205442727196,1,3,42529,372,42157,0.9912530273460463,26.3728,4101.055466666667,12.00184717719328,134,7.700000000000014E-4
7,test_20231101_140024,10863862.png,317432,5672,311760,0.9821316061392676,2,4,66058,833,65225,0.9873898695086136,37.39797155555556,6962.308986666667,9.703270675406442,134,7.700000000000014E-4
8,test_20231101_140024,11382381.png,312486,527,311959,0.9983135244458952,2,3,46745,69,46676,0.9985239063001391,22.832848,2745.811376,13.744096608790418,134,7.700000000000014E-4
9,test_20231101_140024,11079715.png,443815,96622,347193,0.7822921712875861,3,4,124136,13576,110560,0.8906360765611909,18.811219555555557,2602.9003253333335,13.976228231799347,134,7.700000000000014E-4
10,test_20231101_140024,11551286.png,271883,24,271859,0.9999117267353972,1,4,40092,1,40091,0.9999750573680535,24.866876444444443,3470.407338666667,12.72699907819776,134,7.700000000000014E-4
1,test_20231101_140024,10404007.png,502730,12062,490668,0.976007001770334,2,4,61265,1765,59500,0.9711907288011099,27.093313777777777,3786.4106613333333,12.348526465705234,134,7.800000000000014E-4
2,test_20231101_140024,1254659.png,342646,57052,285594,0.8334957944934422,3,4,80080,8040,72040,0.8996003996003996,22.955799111111112,3856.1182026666665,12.269300228832059,134,7.800000000000014E-4
3,test_20231101_140024,10188041.png,221231,7299,213932,0.9670073362232237,2,3,41731,1037,40694,0.9751503678320673,12.408289777777778,1473.8310346666667,16.446326635850774,134,7.800000000000014E-4
4,test_20231101_140024,10287332.png,216980,9932,207048,0.9542261959627616,2,4,22337,1369,20968,0.938711554819358,10.139925333333334,1003.4804586666667,18.11571441220159,134,7.800000000000014E-4
5,test_20231101_140024,11610969.png,368720,18112,350608,0.9508787155565198,2,3,84111,2666,81445,0.9683037890406725,24.121596444444446,3571.91872,12.601787930302118,134,7.800000000000014E-4
6,test_20231101_140024,10350842.png,212614,2547,210067,0.9880205442727196,2,3,42529,372,42157,0.9912530273460463,26.3728,4101.055466666667,12.00184717719328,134,7.800000000000014E-4
7,test_20231101_140024,10863862.png,317432,5672,311760,0.9821316061392676,2,3,66058,833,65225,0.9873898695086136,37.39797155555556,6962.308986666667,9.703270675406442,134,7.800000000000014E-4
8,test_20231101_140024,11382381.png,312486,527,311959,0.9983135244458952,1,4,46745,69,46676,0.9985239063001391,22.832848,2745.811376,13.744096608790418,134,7.800000000000014E-4
9,test_20231101_140024,11079715.png,443815,96622,347193,0.7822921712875861,3,4,124136,13576,110560,0.8906360765611909,18.811219555555557,2602.9003253333335,13.976228231799347,134,7.800000000000014E-4
10,test_20231101_140024,11551286.png,271883,24,271859,0.9999117267353972,1,3,40092,1,40091,0.9999750573680535,24.866876444444443,3470.407338666667,12.72699907819776,134,7.800000000000014E-4
1,test_20231101_140025,10404007.png,502730,12062,490668,0.976007001770334,2,4,61265,1765,59500,0.9711907288011099,27.093313777777777,3786.4106613333333,12.348526465705234,134,7.900000000000014E-4
2,test_20231101_140025,1254659.png,342646,57052,285594,0.8334957944934422,3,4,80080,8040,72040,0.8996003996003996,22.955799111111112,3856.1182026666665,12.269300228832059,134,7.900000000000014E-4
3,test_20231101_140025,10188041.png,221231,7299,213932,0.9670073362232237,2,3,41731,1037,40694,0.9751503678320673,12.408289777777778,1473.8310346666667,16.446326635850774,134,7.900000000000014E-4
4,test_20231101_140025,10287332.png,216980,9932,207048,0.9542261959627616,2,3,22337,1369,20968,0.938711554819358,10.139925333333334,1003.4804586666667,18.11571441220159,134,7.900000000000014E-4
5,test_20231101_140025,11610969.png,368720,18112,350608,0.9508787155565198,2,4,84111,2666,81445,0.9683037890406725,24.121596444444446,3571.91872,12.601787930302118,134,7.900000000000014E-4
6,test_20231101_140025,10350842.png,212614,2547,210067,0.9880205442727196,1,4,42529,372,42157,0.9912530273460463,26.3728,4101.055466666667,12.00184717719328,134,7.900000000000014E-4
7,test_20231101_140025,10863862.png,317432,5672,311760,0.9821316061392676,1,3,66058,833,65225,0.9873898695086136,37.39797155555556,6962.308986666667,9.703270675406442,134,7.900000000000014E-4
8,test_20231101_140025,11382381.png,312486,527,311959,0.9983135244458952,1,4,46745,69,46676,0.9985239063001391,22.832848,2745.811376,13.744096608790418,134,7.900000000000014E-4
9,test_20231101_140025,11079715.png,443815,96622,347193,0.7822921712875861,3,5,124136,13576,110560,0.8906360765611909,18.811219555555557,2602.9003253333335,13.976228231799347,134,7.900000000000014E-4
10,test_20231101_140025,11551286.png,271883,24,271859,0.9999117267353972,0,4,40092,1,40091,0.9999750573680535,24.866876444444443,3470.407338666667,12.72699907819776,134,7.900000000000014E-4
1,test_20231101_140026,10404007.png,502730,12062,490668,0.976007001770334,2,4,61265,1765,59500,0.9711907288011099,27.093313777777777,3786.4106613333333,12.348526465705234,134,8.000000000000014E-4
2,test_20231101_140026,1254659.png,342646,57052,285594,0.8334957944934422,2,4,80080,8040,72040,0.8996003996003996,22.955799111111112,3856.1182026666665,12.269300228832059,134,8.000000000000014E-4
3,test_20231101_140026,10188041.png,221231,7299,213932,0.9670073362232237,2,4,41731,1037,40694,0.9751503678320673,12.408289777777778,1473.8310346666667,16.446326635850774,134,8.000000000000014E-4
4,test_20231101_140026,10287332.png,216980,9932,207048,0.9542261959627616,2,5,22337,1369,20968,0.938711554819358,10.139925333333334,1003.4804586666667,18.11571441220159,134,8.000000000000014E-4
5,test_20231101_140026,11610969.png,368720,18112,350608,0.9508787155565198,2,3,84111,2666,81445,0.9683037890406725,24.121596444444446,3571.91872,12.601787930302118,134,8.000000000000014E-4
6,test_20231101_140026,10350842.png,212614,2547,210067,0.9880205442727196,1,4,42529,372,42157,0.9912530273460463,26.3728,4101.055466666667,12.00184717719328,134,8.000000000000014E-4
7,test_20231101_140026,10863862.png,317432,5672,311760,0.9821316061392676,2,4,66058,833,65225,0.9873898695086136,37.39797155555556,6962.308986666667,9.703270675406442,134,8.000000000000014E-4
8,test_20231101_140026,11382381.png,312486,527,311959,0.9983135244458952,1,3,46745,69,46676,0.9985239063001391,22.832848,2745.811376,13.744096608790418,134,8.000000000000014E-4
9,test_20231101_140026,11079715.png,443815,96622,347193,0.7822921712875861,3,4,124136,13576,110560,0.8906360765611909,18.811219555555557,2602.9003253333335,13.976228231799347,134,8.000000000000014E-4
10,test_20231101_140026,11551286.png,271883,24,271859,0.9999117267353972,1,3,40092,1,40091,0.9999750573680535,24.866876444444443,3470.407338666667,12.72699907819776,134,8.000000000000014E-4
1,test_20231101_140026,10404007.png,502730,12062,490668,0.976007001770334,2,4,61265,1765,59500,0.9711907288011099,27.093313777777777,3786.4106613333333,12.348526465705234,134,8.100000000000015E-4
2,test_20231101_140026,1254659.png,342646,57052,285594,0.8334957944934422,3,4,80080,8040,72040,0.8996003996003996,22.955799111111112,3856.1182026666665,12.269300228832059,134,8.100000000000015E-4
3,test_20231101_140026,10188041.png,221231,7299,213932,0.9670073362232237,2,4,41731,1037,40694,0.9751503678320673,12.408289777777778,1473.8310346666667,16.446326635850774,134,8.100000000000015E-4
4,test_20231101_140026,10287332.png,216980,9932,207048,0.9542261959627616,2,3,22337,1369,20968,0.938711554819358,10.139925333333334,1003.4804586666667,18.11571441220159,134,8.100000000000015E-4
5,test_20231101_140026,11610969.png,368720,18112,350608,0.9508787155565198,2,4,84111,2666,81445,0.9683037890406725,24.121596444444446,3571.91872,12.601787930302118,134,8.100000000000015E-4
6,test_20231101_140026,10350842.png,212614,2547,210067,0.9880205442727196,1,4,42529,372,42157,0.9912530273460463,26.3728,4101.055466666667,12.00184717719328,134,8.100000000000015E-4
7,test_20231101_140026,10863862.png,317432,5672,311760,0.9821316061392676,1,3,66058,833,65225,0.9873898695086136,37.39797155555556,6962.308986666667,9.703270675406442,134,8.100000000000015E-4
8,test_20231101_140026,11382381.png,312486,527,311959,0.9983135244458952,2,3,46745,69,46676,0.9985239063001391,22.832848,2745.811376,13.744096608790418,134,8.100000000000015E-4
9,test_20231101_140026,11079715.png,443815,96622,347193,0.7822921712875861,3,4,124136,13576,110560,0.8906360765611909,18.811219555555557,2602.9003253333335,13.976228231799347,134,8.100000000000015E-4
10,test_20231101_140026,11551286.png,271883,24,271859,0.9999117267353972,1,3,40092,1,40091,0.9999750573680535,24.866876444444443,3470.407338666667,12.72699907819776,134,8.100000000000015E-4
1,test_20231101_140027,10404007.png,502730,12062,490668,0.976007001770334,2,4,61265,1765,59500,0.9711907288011099,27.093313777777777,3786.4106613333333,12.348526465705234,134,8.200000000000015E-4
2,test_20231101_140027,1254659.png,342646,57052,285594,0.8334957944934422,3,4,80080,8040,72040,0.8996003996003996,22.955799111111112,3856.1182026666665,12.269300228832059,134,8.200000000000015E-4
3,test_20231101_140027,10188041.png,221231,7299,213932,0.9670073362232237,2,4,41731,1037,40694,0.9751503678320673,12.408289777777778,1473.8310346666667,16.446326635850774,134,8.200000000000015E-4
4,test_20231101_140027,10287332.png,216980,9932,207048,0.9542261959627616,1,3,22337,1369,20968,0.938711554819358,10.139925333333334,1003.4804586666667,18.11571441220159,134,8.200000000000015E-4
5,test_20231101_140027,11610969.png,368720,18112,350608,0.9508787155565198,3,4,84111,2666,81445,0.9683037890406725,24.121596444444446,3571.91872,12.601787930302118,134,8.200000000000015E-4
6,test_20231101_140027,10350842.png,212614,2547,210067,0.9880205442727196,1,4,42529,372,42157,0.9912530273460463,26.3728,4101.055466666667,12.00184717719328,134,8.200000000000015E-4
7,test_20231101_140027,10863862.png,317432,5672,311760,0.9821316061392676,1,3,66058,833,65225,0.9873898695086136,37.39797155555556,6962.308986666667,9.703270675406442,134,8.200000000000015E-4
8,test_20231101_140027,11382381.png,312486,527,311959,0.9983135244458952,1,3,46745,69,46676,0.9985239063001391,22.832848,2745.811376,13.744096608790418,134,8.200000000000015E-4
9,test_20231101_140027,11079715.png,443815,96622,347193,0.7822921712875861,3,4,124136,13576,110560,0.8906360765611909,18.811219555555557,2602.9003253333335,13.976228231799347,134,8.200000000000015E-4
10,test_20231101_140027,11551286.png,271883,24,271859,0.9999117267353972,1,3,40092,1,40091,0.9999750573680535,24.866876444444443,3470.407338666667,12.72699907819776,134,8.200000000000015E-4
1,test_20231101_140028,10404007.png,502730,12062,490668,0.976007001770334,2,3,61265,1765,59500,0.9711907288011099,27.093313777777777,3786.4106613333333,12.348526465705234,134,8.300000000000015E-4
2,test_20231101_140028,1254659.png,342646,57052,285594,0.8334957944934422,2,4,80080,8040,72040,0.8996003996003996,22.955799111111112,3856.1182026666665,12.269300228832059,134,8.300000000000015E-4
3,test_20231101_140028,10188041.png,221231,7299,213932,0.9670073362232237,2,3,41731,1037,40694,0.9751503678320673,12.408289777777778,1473.8310346666667,16.446326635850774,134,8.300000000000015E-4
4,test_20231101_140028,10287332.png,216980,9932,207048,0.9542261959627616,2,4,22337,1369,20968,0.938711554819358,10.139925333333334,1003.4804586666667,18.11571441220159,134,8.300000000000015E-4
5,test_20231101_140028,11610969.png,368720,18112,350608,0.9508787155565198,2,4,84111,2666,81445,0.9683037890406725,24.121596444444446,3571.91872,12.601787930302118,134,8.300000000000015E-4
6,test_20231101_140028,10350842.png,212614,2547,210067,0.9880205442727196,2,4,42529,372,42157,0.9912530273460463,26.3728,4101.055466666667,12.00184717719328,134,8.300000000000015E-4
7,test_20231101_140028,10863862.png,317432,5672,311760,0.9821316061392676,3,4,66058,833,65225,0.9873898695086136,37.39797155555556,6962.308986666667,9.703270675406442,134,8.300000000000015E-4
8,test_20231101_140028,11382381.png,312486,527,311959,0.9983135244458952,1,4,46745,69,46676,0.9985239063001391,22.832848,2745.811376,13.744096608790418,134,8.300000000000015E-4
9,test_20231101_140028,11079715.png,443815,96622,347193,0.7822921712875861,3,4,124136,13576,110560,0.8906360765611909,18.811219555555557,2602.9003253333335,13.976228231799347,134,8.300000000000015E-4
10,test_20231101_140028,11551286.png,271883,24,271859,0.9999117267353972,0,3,40092,1,40091,0.9999750573680535,24.866876444444443,3470.407338666667,12.72699907819776,134,8.300000000000015E-4
1,test_20231101_140029,10404007.png,502730,12062,490668,0.976007001770334,2,4,61265,1765,59500,0.9711907288011099,27.093313777777777,3786.4106613333333,12.348526465705234,134,8.400000000000016E-4
2,test_20231101_140029,1254659.png,342646,57052,285594,0.8334957944934422,3,4,80080,8040,72040,0.8996003996003996,22.955799111111112,3856.1182026666665,12.269300228832059,134,8.400000000000016E-4
3,test_20231101_140029,10188041.png,221231,7299,213932,0.9670073362232237,2,4,41731,1037,40694,0.9751503678320673,12.408289777777778,1473.8310346666667,16.446326635850774,134,8.400000000000016E-4
4,test_20231101_140029,10287332.png,216980,9932,207048,0.9542261959627616,2,4,22337,1369,20968,0.938711554819358,10.139925333333334,1003.4804586666667,18.11571441220159,134,8.400000000000016E-4
5,test_20231101_140029,11610969.png,368720,18112,350608,0.9508787155565198,3,4,84111,2666,81445,0.9683037890406725,24.121596444444446,3571.91872,12.601787930302118,134,8.400000000000016E-4
6,test_20231101_140029,10350842.png,212614,2547,210067,0.9880205442727196,1,3,42529,372,42157,0.9912530273460463,26.3728,4101.055466666667,12.00184717719328,134,8.400000000000016E-4
7,test_20231101_140029,10863862.png,317432,5672,311760,0.9821316061392676,2,4,66058,833,65225,0.9873898695086136,37.39797155555556,6962.308986666667,9.703270675406442,134,8.400000000000016E-4
8,test_20231101_140029,11382381.png,312486,527,311959,0.9983135244458952,2,7,46745,69,46676,0.9985239063001391,22.832848,2745.811376,13.744096608790418,134,8.400000000000016E-4
9,test_20231101_140029,11079715.png,443815,96622,347193,0.7822921712875861,3,4,124136,13576,110560,0.8906360765611909,18.811219555555557,2602.9003253333335,13.976228231799347,134,8.400000000000016E-4
10,test_20231101_140029,11551286.png,271883,24,271859,0.9999117267353972,0,3,40092,1,40091,0.9999750573680535,24.866876444444443,3470.407338666667,12.72699907819776,134,8.400000000000016E-4
1,test_20231101_140029,10404007.png,502730,12062,490668,0.976007001770334,2,4,61265,1765,59500,0.9711907288011099,27.093313777777777,3786.4106613333333,12.348526465705234,134,8.500000000000016E-4
2,test_20231101_140029,1254659.png,342646,57052,285594,0.8334957944934422,3,4,80080,8040,72040,0.8996003996003996,22.955799111111112,3856.1182026666665,12.269300228832059,134,8.500000000000016E-4
3,test_20231101_140029,10188041.png,221231,7299,213932,0.9670073362232237,2,4,41731,1037,40694,0.9751503678320673,12.408289777777778,1473.8310346666667,16.446326635850774,134,8.500000000000016E-4
4,test_20231101_140029,10287332.png,216980,9932,207048,0.9542261959627616,2,3,22337,1369,20968,0.938711554819358,10.139925333333334,1003.4804586666667,18.11571441220159,134,8.500000000000016E-4
5,test_20231101_140029,11610969.png,368720,18112,350608,0.9508787155565198,2,4,84111,2666,81445,0.9683037890406725,24.121596444444446,3571.91872,12.601787930302118,134,8.500000000000016E-4
6,test_20231101_140029,10350842.png,212614,2547,210067,0.9880205442727196,1,4,42529,372,42157,0.9912530273460463,26.3728,4101.055466666667,12.00184717719328,134,8.500000000000016E-4
7,test_20231101_140029,10863862.png,317432,5672,311760,0.9821316061392676,2,3,66058,833,65225,0.9873898695086136,37.39797155555556,6962.308986666667,9.703270675406442,134,8.500000000000016E-4
8,test_20231101_140029,11382381.png,312486,527,311959,0.9983135244458952,1,4,46745,69,46676,0.9985239063001391,22.832848,2745.811376,13.744096608790418,134,8.500000000000016E-4
9,test_20231101_140029,11079715.png,443815,96622,347193,0.7822921712875861,3,4,124136,13576,110560,0.8906360765611909,18.811219555555557,2602.9003253333335,13.976228231799347,134,8.500000000000016E-4
10,test_20231101_140029,11551286.png,271883,24,271859,0.9999117267353972,1,4,40092,1,40091,0.9999750573680535,24.866876444444443,3470.407338666667,12.72699907819776,134,8.500000000000016E-4
1,test_20231101_140030,10404007.png,502730,12062,490668,0.976007001770334,2,3,61265,1765,59500,0.9711907288011099,27.093313777777777,3786.4106613333333,12.348526465705234,134,8.600000000000016E-4
2,test_20231101_140030,1254659.png,342646,57052,285594,0.8334957944934422,3,4,80080,8040,72040,0.8996003996003996,22.955799111111112,3856.1182026666665,12.269300228832059,134,8.600000000000016E-4
3,test_20231101_140030,10188041.png,221231,7299,213932,0.9670073362232237,1,3,41731,1037,40694,0.9751503678320673,12.408289777777778,1473.8310346666667,16.446326635850774,134,8.600000000000016E-4
4,test_20231101_140030,10287332.png,216980,9932,207048,0.9542261959627616,2,4,22337,1369,20968,0.938711554819358,10.139925333333334,1003.4804586666667,18.11571441220159,134,8.600000000000016E-4
5,test_20231101_140030,11610969.png,368720,18112,350608,0.9508787155565198,2,3,84111,2666,81445,0.9683037890406725,24.121596444444446,3571.91872,12.601787930302118,134,8.600000000000016E-4
6,test_20231101_140030,10350842.png,212614,2547,210067,0.9880205442727196,1,3,42529,372,42157,0.9912530273460463,26.3728,4101.055466666667,12.00184717719328,134,8.600000000000016E-4
7,test_20231101_140030,10863862.png,317432,5672,311760,0.9821316061392676,1,4,66058,833,65225,0.9873898695086136,37.39797155555556,6962.308986666667,9.703270675406442,134,8.600000000000016E-4
8,test_20231101_140030,11382381.png,312486,527,311959,0.9983135244458952,1,4,46745,69,46676,0.9985239063001391,22.832848,2745.811376,13.744096608790418,134,8.600000000000016E-4
9,test_20231101_140030,11079715.png,443815,96622,347193,0.7822921712875861,3,4,124136,13576,110560,0.8906360765611909,18.811219555555557,2602.9003253333335,13.976228231799347,134,8.600000000000016E-4
10,test_20231101_140030,11551286.png,271883,24,271859,0.9999117267353972,1,3,40092,1,40091,0.9999750573680535,24.866876444444443,3470.407338666667,12.72699907819776,134,8.600000000000016E-4
1,test_20231101_140031,10404007.png,502730,12062,490668,0.976007001770334,1,3,61265,1765,59500,0.9711907288011099,27.093313777777777,3786.4106613333333,12.348526465705234,134,8.700000000000016E-4
2,test_20231101_140031,1254659.png,342646,57052,285594,0.8334957944934422,3,11,80080,8040,72040,0.8996003996003996,22.955799111111112,3856.1182026666665,12.269300228832059,134,8.700000000000016E-4
3,test_20231101_140031,10188041.png,221231,7299,213932,0.9670073362232237,2,3,41731,1037,40694,0.9751503678320673,12.408289777777778,1473.8310346666667,16.446326635850774,134,8.700000000000016E-4
4,test_20231101_140031,10287332.png,216980,9932,207048,0.9542261959627616,2,4,22337,1369,20968,0.938711554819358,10.139925333333334,1003.4804586666667,18.11571441220159,134,8.700000000000016E-4
5,test_20231101_140031,11610969.png,368720,18112,350608,0.9508787155565198,2,3,84111,2666,81445,0.9683037890406725,24.121596444444446,3571.91872,12.601787930302118,134,8.700000000000016E-4
6,test_20231101_140031,10350842.png,212614,2547,210067,0.9880205442727196,1,3,42529,372,42157,0.9912530273460463,26.3728,4101.055466666667,12.00184717719328,134,8.700000000000016E-4
7,test_20231101_140031,10863862.png,317432,5672,311760,0.9821316061392676,1,4,66058,833,65225,0.9873898695086136,37.39797155555556,6962.308986666667,9.703270675406442,134,8.700000000000016E-4
8,test_20231101_140031,11382381.png,312486,527,311959,0.9983135244458952,1,4,46745,69,46676,0.9985239063001391,22.832848,2745.811376,13.744096608790418,134,8.700000000000016E-4
9,test_20231101_140031,11079715.png,443815,96622,347193,0.7822921712875861,4,5,124136,13576,110560,0.8906360765611909,18.811219555555557,2602.9003253333335,13.976228231799347,134,8.700000000000016E-4
10,test_20231101_140031,11551286.png,271883,24,271859,0.9999117267353972,1,4,40092,1,40091,0.9999750573680535,24.866876444444443,3470.407338666667,12.72699907819776,134,8.700000000000016E-4
1,test_20231101_140031,10404007.png,502730,12062,490668,0.976007001770334,2,4,61265,1765,59500,0.9711907288011099,27.093313777777777,3786.4106613333333,12.348526465705234,134,8.800000000000017E-4
2,test_20231101_140031,1254659.png,342646,57052,285594,0.8334957944934422,3,4,80080,8040,72040,0.8996003996003996,22.955799111111112,3856.1182026666665,12.269300228832059,134,8.800000000000017E-4
3,test_20231101_140031,10188041.png,221231,7299,213932,0.9670073362232237,2,4,41731,1037,40694,0.9751503678320673,12.408289777777778,1473.8310346666667,16.446326635850774,134,8.800000000000017E-4
4,test_20231101_140031,10287332.png,216980,9932,207048,0.9542261959627616,1,4,22337,1369,20968,0.938711554819358,10.139925333333334,1003.4804586666667,18.11571441220159,134,8.800000000000017E-4
5,test_20231101_140031,11610969.png,368720,14514,354206,0.9606367975699718,1,3,84111,2149,81962,0.974450428600302,35.376133333333335,6248.818629333334,10.172824413249728,134,8.800000000000017E-4
6,test_20231101_140031,10350842.png,212614,2547,210067,0.9880205442727196,2,4,42529,372,42157,0.9912530273460463,26.3728,4101.055466666667,12.00184717719328,134,8.800000000000017E-4
7,test_20231101_140031,10863862.png,317432,5672,311760,0.9821316061392676,2,4,66058,833,65225,0.9873898695086136,37.39797155555556,6962.308986666667,9.703270675406442,134,8.800000000000017E-4
8,test_20231101_140031,11382381.png,312486,527,311959,0.9983135244458952,1,3,46745,69,46676,0.9985239063001391,22.832848,2745.811376,13.744096608790418,134,8.800000000000017E-4
9,test_20231101_140031,11079715.png,443815,96622,347193,0.7822921712875861,3,4,124136,13576,110560,0.8906360765611909,18.811219555555557,2602.9003253333335,13.976228231799347,134,8.800000000000017E-4
10,test_20231101_140031,11551286.png,271883,24,271859,0.9999117267353972,1,3,40092,1,40091,0.9999750573680535,24.866876444444443,3470.407338666667,12.72699907819776,134,8.800000000000017E-4
1,test_20231101_140032,10404007.png,502730,12062,490668,0.976007001770334,2,3,61265,1765,59500,0.9711907288011099,27.093313777777777,3786.4106613333333,12.348526465705234,134,8.900000000000017E-4
2,test_20231101_140032,1254659.png,342646,57052,285594,0.8334957944934422,2,3,80080,8040,72040,0.8996003996003996,22.955799111111112,3856.1182026666665,12.269300228832059,134,8.900000000000017E-4
3,test_20231101_140032,10188041.png,221231,7299,213932,0.9670073362232237,2,4,41731,1037,40694,0.9751503678320673,12.408289777777778,1473.8310346666667,16.446326635850774,134,8.900000000000017E-4
4,test_20231101_140032,10287332.png,216980,9932,207048,0.9542261959627616,4,4,22337,1369,20968,0.938711554819358,10.139925333333334,1003.4804586666667,18.11571441220159,134,8.900000000000017E-4
5,test_20231101_140032,11610969.png,368720,14514,354206,0.9606367975699718,2,4,84111,2149,81962,0.974450428600302,35.376133333333335,6248.818629333334,10.172824413249728,134,8.900000000000017E-4
6,test_20231101_140032,10350842.png,212614,2547,210067,0.9880205442727196,1,3,42529,372,42157,0.9912530273460463,26.3728,4101.055466666667,12.00184717719328,134,8.900000000000017E-4
7,test_20231101_140032,10863862.png,317432,5672,311760,0.9821316061392676,1,3,66058,833,65225,0.9873898695086136,37.39797155555556,6962.308986666667,9.703270675406442,134,8.900000000000017E-4
8,test_20231101_140032,11382381.png,312486,527,311959,0.9983135244458952,1,3,46745,69,46676,0.9985239063001391,22.832848,2745.811376,13.744096608790418,134,8.900000000000017E-4
9,test_20231101_140032,11079715.png,443815,96622,347193,0.7822921712875861,4,4,124136,13576,110560,0.8906360765611909,18.811219555555557,2602.9003253333335,13.976228231799347,134,8.900000000000017E-4
10,test_20231101_140032,11551286.png,271883,24,271859,0.9999117267353972,0,4,40092,1,40091,0.9999750573680535,24.866876444444443,3470.407338666667,12.72699907819776,134,8.900000000000017E-4
1,test_20231101_140033,10404007.png,502730,12062,490668,0.976007001770334,2,3,61265,1765,59500,0.9711907288011099,27.093313777777777,3786.4106613333333,12.348526465705234,134,9.000000000000017E-4
2,test_20231101_140033,1254659.png,342646,57052,285594,0.8334957944934422,3,4,80080,8040,72040,0.8996003996003996,22.955799111111112,3856.1182026666665,12.269300228832059,134,9.000000000000017E-4
3,test_20231101_140033,10188041.png,221231,7299,213932,0.9670073362232237,2,4,41731,1037,40694,0.9751503678320673,12.408289777777778,1473.8310346666667,16.446326635850774,134,9.000000000000017E-4
4,test_20231101_140033,10287332.png,216980,9932,207048,0.9542261959627616,2,4,22337,1369,20968,0.938711554819358,10.139925333333334,1003.4804586666667,18.11571441220159,134,9.000000000000017E-4
5,test_20231101_140033,11610969.png,368720,14514,354206,0.9606367975699718,2,4,84111,2149,81962,0.974450428600302,35.376133333333335,6248.818629333334,10.172824413249728,134,9.000000000000017E-4
6,test_20231101_140033,10350842.png,212614,2547,210067,0.9880205442727196,2,4,42529,372,42157,0.9912530273460463,26.3728,4101.055466666667,12.00184717719328,134,9.000000000000017E-4
7,test_20231101_140033,10863862.png,317432,5289,312143,0.9833381637642078,1,4,66058,777,65281,0.9882376093735807,40.65938311111111,7895.735845333334,9.156877504405115,134,9.000000000000017E-4
8,test_20231101_140033,11382381.png,312486,527,311959,0.9983135244458952,1,3,46745,69,46676,0.9985239063001391,22.832848,2745.811376,13.744096608790418,134,9.000000000000017E-4
9,test_20231101_140033,11079715.png,443815,96622,347193,0.7822921712875861,3,4,124136,13576,110560,0.8906360765611909,18.811219555555557,2602.9003253333335,13.976228231799347,134,9.000000000000017E-4
10,test_20231101_140033,11551286.png,271883,24,271859,0.9999117267353972,1,3,40092,1,40091,0.9999750573680535,24.866876444444443,3470.407338666667,12.72699907819776,134,9.000000000000017E-4
1,test_20231101_140033,10404007.png,502730,12062,490668,0.976007001770334,1,3,61265,1765,59500,0.9711907288011099,27.093313777777777,3786.4106613333333,12.348526465705234,134,9.100000000000017E-4
2,test_20231101_140033,1254659.png,342646,57052,285594,0.8334957944934422,3,4,80080,8040,72040,0.8996003996003996,22.955799111111112,3856.1182026666665,12.269300228832059,134,9.100000000000017E-4
3,test_20231101_140033,10188041.png,221231,7299,213932,0.9670073362232237,2,3,41731,1037,40694,0.9751503678320673,12.408289777777778,1473.8310346666667,16.446326635850774,134,9.100000000000017E-4
4,test_20231101_140033,10287332.png,216980,9932,207048,0.9542261959627616,1,3,22337,1369,20968,0.938711554819358,10.139925333333334,1003.4804586666667,18.11571441220159,134,9.100000000000017E-4
5,test_20231101_140033,11610969.png,368720,14514,354206,0.9606367975699718,1,3,84111,2149,81962,0.974450428600302,35.376133333333335,6248.818629333334,10.172824413249728,134,9.100000000000017E-4
6,test_20231101_140033,10350842.png,212614,2547,210067,0.9880205442727196,1,4,42529,372,42157,0.9912530273460463,26.3728,4101.055466666667,12.00184717719328,134,9.100000000000017E-4
7,test_20231101_140033,10863862.png,317432,5289,312143,0.9833381637642078,2,3,66058,777,65281,0.9882376093735807,40.65938311111111,7895.735845333334,9.156877504405115,134,9.100000000000017E-4
8,test_20231101_140033,11382381.png,312486,527,311959,0.9983135244458952,1,4,46745,69,46676,0.9985239063001391,22.832848,2745.811376,13.744096608790418,134,9.100000000000017E-4
9,test_20231101_140033,11079715.png,443815,96622,347193,0.7822921712875861,3,4,124136,13576,110560,0.8906360765611909,18.811219555555557,2602.9003253333335,13.976228231799347,134,9.100000000000017E-4
10,test_20231101_140033,11551286.png,271883,24,271859,0.9999117267353972,1,4,40092,1,40091,0.9999750573680535,24.866876444444443,3470.407338666667,12.72699907819776,134,9.100000000000017E-4
1,test_20231101_140034,10404007.png,502730,12062,490668,0.976007001770334,2,4,61265,1765,59500,0.9711907288011099,27.093313777777777,3786.4106613333333,12.348526465705234,134,9.200000000000018E-4
2,test_20231101_140034,1254659.png,342646,57052,285594,0.8334957944934422,2,3,80080,8040,72040,0.8996003996003996,22.955799111111112,3856.1182026666665,12.269300228832059,134,9.200000000000018E-4
3,test_20231101_140034,10188041.png,221231,7299,213932,0.9670073362232237,2,4,41731,1037,40694,0.9751503678320673,12.408289777777778,1473.8310346666667,16.446326635850774,134,9.200000000000018E-4
4,test_20231101_140034,10287332.png,216980,9932,207048,0.9542261959627616,2,4,22337,1369,20968,0.938711554819358,10.139925333333334,1003.4804586666667,18.11571441220159,134,9.200000000000018E-4
5,test_20231101_140034,11610969.png,368720,14514,354206,0.9606367975699718,2,4,84111,2149,81962,0.974450428600302,35.376133333333335,6248.818629333334,10.172824413249728,134,9.200000000000018E-4
6,test_20231101_140034,10350842.png,212614,2547,210067,0.9880205442727196,1,3,42529,372,42157,0.9912530273460463,26.3728,4101.055466666667,12.00184717719328,134,9.200000000000018E-4
7,test_20231101_140034,10863862.png,317432,5289,312143,0.9833381637642078,1,4,66058,777,65281,0.9882376093735807,40.65938311111111,7895.735845333334,9.156877504405115,134,9.200000000000018E-4
8,test_20231101_140034,11382381.png,312486,527,311959,0.9983135244458952,2,3,46745,69,46676,0.9985239063001391,22.832848,2745.811376,13.744096608790418,134,9.200000000000018E-4
9,test_20231101_140034,11079715.png,443815,96622,347193,0.7822921712875861,3,5,124136,13576,110560,0.8906360765611909,18.811219555555557,2602.9003253333335,13.976228231799347,134,9.200000000000018E-4
10,test_20231101_140034,11551286.png,271883,24,271859,0.9999117267353972,1,4,40092,1,40091,0.9999750573680535,24.866876444444443,3470.407338666667,12.72699907819776,134,9.200000000000018E-4
1,test_20231101_140035,10404007.png,502730,12062,490668,0.976007001770334,2,4,61265,1765,59500,0.9711907288011099,27.093313777777777,3786.4106613333333,12.348526465705234,134,9.300000000000018E-4
2,test_20231101_140035,1254659.png,342646,57052,285594,0.8334957944934422,3,4,80080,8040,72040,0.8996003996003996,22.955799111111112,3856.1182026666665,12.269300228832059,134,9.300000000000018E-4
3,test_20231101_140035,10188041.png,221231,7299,213932,0.9670073362232237,2,4,41731,1037,40694,0.9751503678320673,12.408289777777778,1473.8310346666667,16.446326635850774,134,9.300000000000018E-4
4,test_20231101_140035,10287332.png,216980,9932,207048,0.9542261959627616,2,3,22337,1369,20968,0.938711554819358,10.139925333333334,1003.4804586666667,18.11571441220159,134,9.300000000000018E-4
5,test_20231101_140035,11610969.png,368720,14514,354206,0.9606367975699718,2,3,84111,2149,81962,0.974450428600302,35.376133333333335,6248.818629333334,10.172824413249728,134,9.300000000000018E-4
6,test_20231101_140035,10350842.png,212614,2547,210067,0.9880205442727196,2,3,42529,372,42157,0.9912530273460463,26.3728,4101.055466666667,12.00184717719328,134,9.300000000000018E-4
7,test_20231101_140035,10863862.png,317432,5289,312143,0.9833381637642078,2,3,66058,777,65281,0.9882376093735807,40.65938311111111,7895.735845333334,9.156877504405115,134,9.300000000000018E-4
8,test_20231101_140035,11382381.png,312486,527,311959,0.9983135244458952,1,3,46745,69,46676,0.9985239063001391,22.832848,2745.811376,13.744096608790418,134,9.300000000000018E-4
9,test_20231101_140035,11079715.png,443815,96622,347193,0.7822921712875861,3,4,124136,13576,110560,0.8906360765611909,18.811219555555557,2602.9003253333335,13.976228231799347,134,9.300000000000018E-4
10,test_20231101_140035,11551286.png,271883,24,271859,0.9999117267353972,0,3,40092,1,40091,0.9999750573680535,24.866876444444443,3470.407338666667,12.72699907819776,134,9.300000000000018E-4
1,test_20231101_140035,10404007.png,502730,12062,490668,0.976007001770334,1,3,61265,1765,59500,0.9711907288011099,27.093313777777777,3786.4106613333333,12.348526465705234,134,9.400000000000018E-4
2,test_20231101_140035,1254659.png,342646,57052,285594,0.8334957944934422,3,4,80080,8040,72040,0.8996003996003996,22.955799111111112,3856.1182026666665,12.269300228832059,134,9.400000000000018E-4
3,test_20231101_140035,10188041.png,221231,7299,213932,0.9670073362232237,1,3,41731,1037,40694,0.9751503678320673,12.408289777777778,1473.8310346666667,16.446326635850774,134,9.400000000000018E-4
4,test_20231101_140035,10287332.png,216980,9932,207048,0.9542261959627616,2,4,22337,1369,20968,0.938711554819358,10.139925333333334,1003.4804586666667,18.11571441220159,134,9.400000000000018E-4
5,test_20231101_140035,11610969.png,368720,14514,354206,0.9606367975699718,2,4,84111,2149,81962,0.974450428600302,35.376133333333335,6248.818629333334,10.172824413249728,134,9.400000000000018E-4
6,test_20231101_140035,10350842.png,212614,2547,210067,0.9880205442727196,2,4,42529,372,42157,0.9912530273460463,26.3728,4101.055466666667,12.00184717719328,134,9.400000000000018E-4
7,test_20231101_140035,10863862.png,317432,5289,312143,0.9833381637642078,1,3,66058,777,65281,0.9882376093735807,40.65938311111111,7895.735845333334,9.156877504405115,134,9.400000000000018E-4
8,test_20231101_140035,11382381.png,312486,527,311959,0.9983135244458952,1,3,46745,69,46676,0.9985239063001391,22.832848,2745.811376,13.744096608790418,134,9.400000000000018E-4
9,test_20231101_140035,11079715.png,443815,96622,347193,0.7822921712875861,3,4,124136,13576,110560,0.8906360765611909,18.811219555555557,2602.9003253333335,13.976228231799347,134,9.400000000000018E-4
10,test_20231101_140035,11551286.png,271883,24,271859,0.9999117267353972,1,3,40092,1,40091,0.9999750573680535,24.866876444444443,3470.407338666667,12.72699907819776,134,9.400000000000018E-4
1,test_20231101_140036,10404007.png,502730,12062,490668,0.976007001770334,2,3,61265,1765,59500,0.9711907288011099,27.093313777777777,3786.4106613333333,12.348526465705234,134,9.500000000000018E-4
2,test_20231101_140036,1254659.png,342646,57052,285594,0.8334957944934422,3,4,80080,8040,72040,0.8996003996003996,22.955799111111112,3856.1182026666665,12.269300228832059,134,9.500000000000018E-4
3,test_20231101_140036,10188041.png,221231,7299,213932,0.9670073362232237,1,3,41731,1037,40694,0.9751503678320673,12.408289777777778,1473.8310346666667,16.446326635850774,134,9.500000000000018E-4
4,test_20231101_140036,10287332.png,216980,9932,207048,0.9542261959627616,1,3,22337,1369,20968,0.938711554819358,10.139925333333334,1003.4804586666667,18.11571441220159,134,9.500000000000018E-4
5,test_20231101_140036,11610969.png,368720,14514,354206,0.9606367975699718,2,3,84111,2149,81962,0.974450428600302,35.376133333333335,6248.818629333334,10.172824413249728,134,9.500000000000018E-4
6,test_20231101_140036,10350842.png,212614,2547,210067,0.9880205442727196,2,4,42529,372,42157,0.9912530273460463,26.3728,4101.055466666667,12.00184717719328,134,9.500000000000018E-4
7,test_20231101_140036,10863862.png,317432,5289,312143,0.9833381637642078,2,4,66058,777,65281,0.9882376093735807,40.65938311111111,7895.735845333334,9.156877504405115,134,9.500000000000018E-4
8,test_20231101_140036,11382381.png,312486,527,311959,0.9983135244458952,1,3,46745,69,46676,0.9985239063001391,22.832848,2745.811376,13.744096608790418,134,9.500000000000018E-4
9,test_20231101_140036,11079715.png,443815,96622,347193,0.7822921712875861,3,4,124136,13576,110560,0.8906360765611909,18.811219555555557,2602.9003253333335,13.976228231799347,134,9.500000000000018E-4
10,test_20231101_140036,11551286.png,271883,24,271859,0.9999117267353972,0,3,40092,1,40091,0.9999750573680535,24.866876444444443,3470.407338666667,12.72699907819776,134,9.500000000000018E-4
1,test_20231101_140037,10404007.png,502730,12062,490668,0.976007001770334,3,4,61265,1765,59500,0.9711907288011099,27.093313777777777,3786.4106613333333,12.348526465705234,134,9.600000000000019E-4
2,test_20231101_140037,1254659.png,342646,57052,285594,0.8334957944934422,4,5,80080,8040,72040,0.8996003996003996,22.955799111111112,3856.1182026666665,12.269300228832059,134,9.600000000000019E-4
3,test_20231101_140037,10188041.png,221231,7299,213932,0.9670073362232237,2,4,41731,1037,40694,0.9751503678320673,12.408289777777778,1473.8310346666667,16.446326635850774,134,9.600000000000019E-4
4,test_20231101_140037,10287332.png,216980,9932,207048,0.9542261959627616,2,4,22337,1369,20968,0.938711554819358,10.139925333333334,1003.4804586666667,18.11571441220159,134,9.600000000000019E-4
5,test_20231101_140037,11610969.png,368720,14514,354206,0.9606367975699718,2,3,84111,2149,81962,0.974450428600302,35.376133333333335,6248.818629333334,10.172824413249728,134,9.600000000000019E-4
6,test_20231101_140037,10350842.png,212614,2547,210067,0.9880205442727196,1,3,42529,372,42157,0.9912530273460463,26.3728,4101.055466666667,12.00184717719328,134,9.600000000000019E-4
7,test_20231101_140037,10863862.png,317432,5289,312143,0.9833381637642078,2,3,66058,777,65281,0.9882376093735807,40.65938311111111,7895.735845333334,9.156877504405115,134,9.600000000000019E-4
8,test_20231101_140037,11382381.png,312486,527,311959,0.9983135244458952,2,3,46745,69,46676,0.9985239063001391,22.832848,2745.811376,13.744096608790418,134,9.600000000000019E-4
9,test_20231101_140037,11079715.png,443815,96622,347193,0.7822921712875861,3,5,124136,13576,110560,0.8906360765611909,18.811219555555557,2602.9003253333335,13.976228231799347,134,9.600000000000019E-4
10,test_20231101_140037,11551286.png,271883,24,271859,0.9999117267353972,0,14,40092,1,40091,0.9999750573680535,24.866876444444443,3470.407338666667,12.72699907819776,134,9.600000000000019E-4
1,test_20231101_140037,10404007.png,502730,12062,490668,0.976007001770334,2,4,61265,1765,59500,0.9711907288011099,27.093313777777777,3786.4106613333333,12.348526465705234,134,9.700000000000019E-4
2,test_20231101_140037,1254659.png,342646,57052,285594,0.8334957944934422,3,4,80080,8040,72040,0.8996003996003996,22.955799111111112,3856.1182026666665,12.269300228832059,134,9.700000000000019E-4
3,test_20231101_140037,10188041.png,221231,7299,213932,0.9670073362232237,2,4,41731,1037,40694,0.9751503678320673,12.408289777777778,1473.8310346666667,16.446326635850774,134,9.700000000000019E-4
4,test_20231101_140037,10287332.png,216980,9932,207048,0.9542261959627616,2,4,22337,1369,20968,0.938711554819358,10.139925333333334,1003.4804586666667,18.11571441220159,134,9.700000000000019E-4
5,test_20231101_140037,11610969.png,368720,14514,354206,0.9606367975699718,2,4,84111,2149,81962,0.974450428600302,35.376133333333335,6248.818629333334,10.172824413249728,134,9.700000000000019E-4
6,test_20231101_140037,10350842.png,212614,2547,210067,0.9880205442727196,2,3,42529,372,42157,0.9912530273460463,26.3728,4101.055466666667,12.00184717719328,134,9.700000000000019E-4
7,test_20231101_140037,10863862.png,317432,5289,312143,0.9833381637642078,2,8,66058,777,65281,0.9882376093735807,40.65938311111111,7895.735845333334,9.156877504405115,134,9.700000000000019E-4
8,test_20231101_140037,11382381.png,312486,527,311959,0.9983135244458952,2,3,46745,69,46676,0.9985239063001391,22.832848,2745.811376,13.744096608790418,134,9.700000000000019E-4
9,test_20231101_140037,11079715.png,443815,96622,347193,0.7822921712875861,3,5,124136,13576,110560,0.8906360765611909,18.811219555555557,2602.9003253333335,13.976228231799347,134,9.700000000000019E-4
10,test_20231101_140037,11551286.png,271883,24,271859,0.9999117267353972,1,4,40092,1,40091,0.9999750573680535,24.866876444444443,3470.407338666667,12.72699907819776,134,9.700000000000019E-4
1,test_20231101_140038,10404007.png,502730,11419,491311,0.9772860183398644,2,3,61265,1668,59597,0.9727740145270546,27.161996444444444,3806.510064,12.325533785095274,134,9.80000000000002E-4
2,test_20231101_140038,1254659.png,342646,56709,285937,0.8344968276296819,3,5,80080,7999,72081,0.9001123876123877,23.133256888888887,3897.7476533333333,12.222666421233503,134,9.80000000000002E-4
3,test_20231101_140038,10188041.png,221231,7177,214054,0.9675587960096008,2,3,41731,1027,40704,0.9753899978433299,12.417587555555556,1474.70744,16.443744895679117,134,9.80000000000002E-4
4,test_20231101_140038,10287332.png,216980,9852,207128,0.954594893538575,2,4,22337,1357,20980,0.9392487800510364,10.165486222222222,1007.650432,18.097704654487362,134,9.80000000000002E-4
5,test_20231101_140038,11610969.png,368720,14372,354348,0.961021913647212,2,4,84111,2129,81982,0.9746882096277538,35.48248,6266.167098666667,10.160783889208108,134,9.80000000000002E-4
6,test_20231101_140038,10350842.png,212614,2407,210207,0.9886790145521932,1,4,42529,353,42176,0.9916997813256837,26.462236444444443,4114.325845333334,11.987816770030495,134,9.80000000000002E-4
7,test_20231101_140038,10863862.png,317432,5229,312203,0.9835271806245117,1,3,66058,768,65290,0.9883738532804505,40.663344,7896.229146666667,9.156606179022667,134,9.80000000000002E-4
8,test_20231101_140038,11382381.png,312486,367,312119,0.9988255473845228,1,3,46745,48,46697,0.9989731522087923,23.28773511111111,2886.24232,13.527475705549977,134,9.80000000000002E-4
9,test_20231101_140038,11079715.png,443815,96522,347293,0.782517490395773,3,4,124136,13566,110570,0.8907166333698524,18.848616888888888,2607.833498666667,13.968005011541324,134,9.80000000000002E-4
10,test_20231101_140038,11551286.png,271883,24,271859,0.9999117267353972,1,4,40092,1,40091,0.9999750573680535,24.866876444444443,3470.407338666667,12.72699907819776,134,9.80000000000002E-4
1,test_20231101_140039,10404007.png,502730,11419,491311,0.9772860183398644,2,3,61265,1668,59597,0.9727740145270546,27.161996444444444,3806.510064,12.325533785095274,134,9.90000000000002E-4
2,test_20231101_140039,1254659.png,342646,56709,285937,0.8344968276296819,3,4,80080,7999,72081,0.9001123876123877,23.133256888888887,3897.7476533333333,12.222666421233503,134,9.90000000000002E-4
3,test_20231101_140039,10188041.png,221231,7177,214054,0.9675587960096008,2,4,41731,1027,40704,0.9753899978433299,12.417587555555556,1474.70744,16.443744895679117,134,9.90000000000002E-4
4,test_20231101_140039,10287332.png,216980,9852,207128,0.954594893538575,2,4,22337,1357,20980,0.9392487800510364,10.165486222222222,1007.650432,18.097704654487362,134,9.90000000000002E-4
5,test_20231101_140039,11610969.png,368720,14372,354348,0.961021913647212,1,4,84111,2129,81982,0.9746882096277538,35.48248,6266.167098666667,10.160783889208108,134,9.90000000000002E-4
6,test_20231101_140039,10350842.png,212614,2407,210207,0.9886790145521932,1,4,42529,353,42176,0.9916997813256837,26.462236444444443,4114.325845333334,11.987816770030495,134,9.90000000000002E-4
7,test_20231101_140039,10863862.png,317432,5229,312203,0.9835271806245117,2,3,66058,768,65290,0.9883738532804505,40.663344,7896.229146666667,9.156606179022667,134,9.90000000000002E-4
8,test_20231101_140039,11382381.png,312486,367,312119,0.9988255473845228,1,3,46745,48,46697,0.9989731522087923,23.28773511111111,2886.24232,13.527475705549977,134,9.90000000000002E-4
9,test_20231101_140039,11079715.png,443815,96522,347293,0.782517490395773,9,4,124136,13566,110570,0.8907166333698524,18.848616888888888,2607.833498666667,13.968005011541324,134,9.90000000000002E-4
10,test_20231101_140039,11551286.png,271883,24,271859,0.9999117267353972,1,4,40092,1,40091,0.9999750573680535,24.866876444444443,3470.407338666667,12.72699907819776,134,9.90000000000002E-4
1,test_20231101_140039,10404007.png,502730,12162,490568,0.9758080878403914,3,4,61265,1779,59486,0.9709622133355097,26.55992,3673.92888,12.479496158993475,135,0.0
2,test_20231101_140039,1254659.png,342646,55202,287444,0.8388949528084378,3,4,80080,7779,72301,0.9028596403596404,23.353802666666667,3980.109952,12.131852910838479,135,0.0
3,test_20231101_140039,10188041.png,221231,7359,213872,0.9667361264922185,2,4,41731,1044,40687,0.9749826268241835,12.082014222222222,1435.143152,16.561851378307132,135,0.0
4,test_20231101_140039,10287332.png,216980,10022,206958,0.9538114111899714,2,3,22337,1379,20958,0.9382638671262927,10.026462222222221,981.878768,18.210224918577968,135,0.0
5,test_20231101_140039,11610969.png,368720,17337,351383,0.9529805814710349,2,3,84111,2551,81560,0.9696710299485204,24.066007111111112,3590.849722666667,12.578831306185476,135,0.0
6,test_20231101_140039,10350842.png,212614,3512,209102,0.9834818027034908,2,3,42529,517,42012,0.9878435890803922,21.05091377777778,2753.8514826666665,13.731398461516449,135,0.0
7,test_20231101_140039,10863862.png,317432,6032,311400,0.980997504977444,1,4,66058,886,65172,0.9865875442792698,36.04656,6605.741237333334,9.931588035317864,135,0.0
8,test_20231101_140039,11382381.png,312486,787,311699,0.9974814871706252,1,3,46745,107,46638,0.9977109851320997,20.595329777777778,2391.5028426666668,14.344094594342474,135,0.0
9,test_20231101_140039,11079715.png,443815,94754,349061,0.7865011322285187,3,4,124136,13324,110812,0.8926661081394599,18.728499555555555,2605.7314826666666,13.97150700682634,135,0.0
10,test_20231101_140039,11551286.png,271883,517,271366,0.9980984467583482,2,4,40092,74,40018,0.9981542452359573,17.526147555555557,1807.59504,15.559792199013692,135,0.0
1,test_20231101_140040,10404007.png,502730,12162,490568,0.9758080878403914,2,4,61265,1779,59486,0.9709622133355097,26.55992,3673.92888,12.479496158993475,135,1.0E-5
2,test_20231101_140040,1254659.png,342646,55202,287444,0.8388949528084378,3,4,80080,7779,72301,0.9028596403596404,23.353802666666667,3980.109952,12.131852910838479,135,1.0E-5
3,test_20231101_140040,10188041.png,221231,7359,213872,0.9667361264922185,2,4,41731,1044,40687,0.9749826268241835,12.082014222222222,1435.143152,16.561851378307132,135,1.0E-5
4,test_20231101_140040,10287332.png,216980,10022,206958,0.9538114111899714,2,4,22337,1379,20958,0.9382638671262927,10.026462222222221,981.878768,18.210224918577968,135,1.0E-5
5,test_20231101_140040,11610969.png,368720,17337,351383,0.9529805814710349,2,3,84111,2551,81560,0.9696710299485204,24.066007111111112,3590.849722666667,12.578831306185476,135,1.0E-5
6,test_20231101_140040,10350842.png,212614,3512,209102,0.9834818027034908,2,3,42529,517,42012,0.9878435890803922,21.05091377777778,2753.8514826666665,13.731398461516449,135,1.0E-5
7,test_20231101_140040,10863862.png,317432,6032,311400,0.980997504977444,2,4,66058,886,65172,0.9865875442792698,36.04656,6605.741237333334,9.931588035317864,135,1.0E-5
8,test_20231101_140040,11382381.png,312486,787,311699,0.9974814871706252,2,4,46745,107,46638,0.9977109851320997,20.595329777777778,2391.5028426666668,14.344094594342474,135,1.0E-5
9,test_20231101_140040,11079715.png,443815,94754,349061,0.7865011322285187,3,5,124136,13324,110812,0.8926661081394599,18.728499555555555,2605.7314826666666,13.97150700682634,135,1.0E-5
10,test_20231101_140040,11551286.png,271883,517,271366,0.9980984467583482,1,3,40092,74,40018,0.9981542452359573,17.526147555555557,1807.59504,15.559792199013692,135,1.0E-5
1,test_20231101_140041,10404007.png,502730,12162,490568,0.9758080878403914,2,4,61265,1779,59486,0.9709622133355097,26.55992,3673.92888,12.479496158993475,135,2.0E-5
2,test_20231101_140041,1254659.png,342646,55202,287444,0.8388949528084378,3,4,80080,7779,72301,0.9028596403596404,23.353802666666667,3980.109952,12.131852910838479,135,2.0E-5
3,test_20231101_140041,10188041.png,221231,7359,213872,0.9667361264922185,2,3,41731,1044,40687,0.9749826268241835,12.082014222222222,1435.143152,16.561851378307132,135,2.0E-5
4,test_20231101_140041,10287332.png,216980,10022,206958,0.9538114111899714,1,3,22337,1379,20958,0.9382638671262927,10.026462222222221,981.878768,18.210224918577968,135,2.0E-5
5,test_20231101_140041,11610969.png,368720,17337,351383,0.9529805814710349,2,3,84111,2551,81560,0.9696710299485204,24.066007111111112,3590.849722666667,12.578831306185476,135,2.0E-5
6,test_20231101_140041,10350842.png,212614,3512,209102,0.9834818027034908,2,4,42529,517,42012,0.9878435890803922,21.05091377777778,2753.8514826666665,13.731398461516449,135,2.0E-5
7,test_20231101_140041,10863862.png,317432,6032,311400,0.980997504977444,2,4,66058,886,65172,0.9865875442792698,36.04656,6605.741237333334,9.931588035317864,135,2.0E-5
8,test_20231101_140041,11382381.png,312486,777,311709,0.9975134886042895,1,3,46745,106,46639,0.9977323777944165,21.325146666666665,2490.063653333333,14.168699117890078,135,2.0E-5
9,test_20231101_140041,11079715.png,443815,94754,349061,0.7865011322285187,3,4,124136,13324,110812,0.8926661081394599,18.728499555555555,2605.7314826666666,13.97150700682634,135,2.0E-5
10,test_20231101_140041,11551286.png,271883,517,271366,0.9980984467583482,1,4,40092,74,40018,0.9981542452359573,17.526147555555557,1807.59504,15.559792199013692,135,2.0E-5
1,test_20231101_140041,10404007.png,502730,12162,490568,0.9758080878403914,3,4,61265,1779,59486,0.9709622133355097,26.55992,3673.92888,12.479496158993475,135,3.0000000000000004E-5
2,test_20231101_140041,1254659.png,342646,55202,287444,0.8388949528084378,3,4,80080,7779,72301,0.9028596403596404,23.353802666666667,3980.109952,12.131852910838479,135,3.0000000000000004E-5
3,test_20231101_140041,10188041.png,221231,7359,213872,0.9667361264922185,2,3,41731,1044,40687,0.9749826268241835,12.082014222222222,1435.143152,16.561851378307132,135,3.0000000000000004E-5
4,test_20231101_140041,10287332.png,216980,10022,206958,0.9538114111899714,1,3,22337,1379,20958,0.9382638671262927,10.026462222222221,981.878768,18.210224918577968,135,3.0000000000000004E-5
5,test_20231101_140041,11610969.png,368720,17337,351383,0.9529805814710349,2,3,84111,2551,81560,0.9696710299485204,24.066007111111112,3590.849722666667,12.578831306185476,135,3.0000000000000004E-5
6,test_20231101_140041,10350842.png,212614,3512,209102,0.9834818027034908,2,4,42529,517,42012,0.9878435890803922,21.05091377777778,2753.8514826666665,13.731398461516449,135,3.0000000000000004E-5
7,test_20231101_140041,10863862.png,317432,6032,311400,0.980997504977444,1,4,66058,886,65172,0.9865875442792698,36.04656,6605.741237333334,9.931588035317864,135,3.0000000000000004E-5
8,test_20231101_140041,11382381.png,312486,777,311709,0.9975134886042895,2,4,46745,106,46639,0.9977323777944165,21.325146666666665,2490.063653333333,14.168699117890078,135,3.0000000000000004E-5
9,test_20231101_140041,11079715.png,443815,94754,349061,0.7865011322285187,3,4,124136,13324,110812,0.8926661081394599,18.728499555555555,2605.7314826666666,13.97150700682634,135,3.0000000000000004E-5
10,test_20231101_140041,11551286.png,271883,517,271366,0.9980984467583482,1,3,40092,74,40018,0.9981542452359573,17.526147555555557,1807.59504,15.559792199013692,135,3.0000000000000004E-5
1,test_20231101_140042,10404007.png,502730,12162,490568,0.9758080878403914,2,3,61265,1779,59486,0.9709622133355097,26.55992,3673.92888,12.479496158993475,135,4.0E-5
2,test_20231101_140042,1254659.png,342646,55202,287444,0.8388949528084378,2,4,80080,7779,72301,0.9028596403596404,23.353802666666667,3980.109952,12.131852910838479,135,4.0E-5
3,test_20231101_140042,10188041.png,221231,7359,213872,0.9667361264922185,2,4,41731,1044,40687,0.9749826268241835,12.082014222222222,1435.143152,16.561851378307132,135,4.0E-5
4,test_20231101_140042,10287332.png,216980,10022,206958,0.9538114111899714,3,30,22337,1379,20958,0.9382638671262927,10.026462222222221,981.878768,18.210224918577968,135,4.0E-5
5,test_20231101_140042,11610969.png,368720,17337,351383,0.9529805814710349,2,4,84111,2551,81560,0.9696710299485204,24.066007111111112,3590.849722666667,12.578831306185476,135,4.0E-5
6,test_20231101_140042,10350842.png,212614,3512,209102,0.9834818027034908,1,4,42529,517,42012,0.9878435890803922,21.05091377777778,2753.8514826666665,13.731398461516449,135,4.0E-5
7,test_20231101_140042,10863862.png,317432,6032,311400,0.980997504977444,1,4,66058,886,65172,0.9865875442792698,36.04656,6605.741237333334,9.931588035317864,135,4.0E-5
8,test_20231101_140042,11382381.png,312486,777,311709,0.9975134886042895,2,3,46745,106,46639,0.9977323777944165,21.325146666666665,2490.063653333333,14.168699117890078,135,4.0E-5
9,test_20231101_140042,11079715.png,443815,94754,349061,0.7865011322285187,3,5,124136,13324,110812,0.8926661081394599,18.728499555555555,2605.7314826666666,13.97150700682634,135,4.0E-5
10,test_20231101_140042,11551286.png,271883,517,271366,0.9980984467583482,1,4,40092,74,40018,0.9981542452359573,17.526147555555557,1807.59504,15.559792199013692,135,4.0E-5
1,test_20231101_140043,10404007.png,502730,12162,490568,0.9758080878403914,2,3,61265,1779,59486,0.9709622133355097,26.55992,3673.92888,12.479496158993475,135,5.0E-5
2,test_20231101_140043,1254659.png,342646,55202,287444,0.8388949528084378,2,4,80080,7779,72301,0.9028596403596404,23.353802666666667,3980.109952,12.131852910838479,135,5.0E-5
3,test_20231101_140043,10188041.png,221231,7359,213872,0.9667361264922185,2,3,41731,1044,40687,0.9749826268241835,12.082014222222222,1435.143152,16.561851378307132,135,5.0E-5
4,test_20231101_140043,10287332.png,216980,10022,206958,0.9538114111899714,2,4,22337,1379,20958,0.9382638671262927,10.026462222222221,981.878768,18.210224918577968,135,5.0E-5
5,test_20231101_140043,11610969.png,368720,17337,351383,0.9529805814710349,2,5,84111,2551,81560,0.9696710299485204,24.066007111111112,3590.849722666667,12.578831306185476,135,5.0E-5
6,test_20231101_140043,10350842.png,212614,3512,209102,0.9834818027034908,2,4,42529,517,42012,0.9878435890803922,21.05091377777778,2753.8514826666665,13.731398461516449,135,5.0E-5
7,test_20231101_140043,10863862.png,317432,6032,311400,0.980997504977444,2,4,66058,886,65172,0.9865875442792698,36.04656,6605.741237333334,9.931588035317864,135,5.0E-5
8,test_20231101_140043,11382381.png,312486,777,311709,0.9975134886042895,1,3,46745,106,46639,0.9977323777944165,21.325146666666665,2490.063653333333,14.168699117890078,135,5.0E-5
9,test_20231101_140043,11079715.png,443815,94754,349061,0.7865011322285187,4,4,124136,13324,110812,0.8926661081394599,18.728499555555555,2605.7314826666666,13.97150700682634,135,5.0E-5
10,test_20231101_140043,11551286.png,271883,517,271366,0.9980984467583482,1,4,40092,74,40018,0.9981542452359573,17.526147555555557,1807.59504,15.559792199013692,135,5.0E-5
1,test_20231101_140043,10404007.png,502730,12162,490568,0.9758080878403914,2,3,61265,1779,59486,0.9709622133355097,26.55992,3673.92888,12.479496158993475,135,6.0E-5
2,test_20231101_140043,1254659.png,342646,55202,287444,0.8388949528084378,3,4,80080,7779,72301,0.9028596403596404,23.353802666666667,3980.109952,12.131852910838479,135,6.0E-5
3,test_20231101_140043,10188041.png,221231,7359,213872,0.9667361264922185,2,3,41731,1044,40687,0.9749826268241835,12.082014222222222,1435.143152,16.561851378307132,135,6.0E-5
4,test_20231101_140043,10287332.png,216980,10022,206958,0.9538114111899714,2,4,22337,1379,20958,0.9382638671262927,10.026462222222221,981.878768,18.210224918577968,135,6.0E-5
5,test_20231101_140043,11610969.png,368720,17337,351383,0.9529805814710349,2,4,84111,2551,81560,0.9696710299485204,24.066007111111112,3590.849722666667,12.578831306185476,135,6.0E-5
6,test_20231101_140043,10350842.png,212614,3512,209102,0.9834818027034908,1,3,42529,517,42012,0.9878435890803922,21.05091377777778,2753.8514826666665,13.731398461516449,135,6.0E-5
7,test_20231101_140043,10863862.png,317432,6032,311400,0.980997504977444,2,4,66058,886,65172,0.9865875442792698,36.04656,6605.741237333334,9.931588035317864,135,6.0E-5
8,test_20231101_140043,11382381.png,312486,777,311709,0.9975134886042895,2,3,46745,106,46639,0.9977323777944165,21.325146666666665,2490.063653333333,14.168699117890078,135,6.0E-5
9,test_20231101_140043,11079715.png,443815,94754,349061,0.7865011322285187,2,4,124136,13324,110812,0.8926661081394599,18.728499555555555,2605.7314826666666,13.97150700682634,135,6.0E-5
10,test_20231101_140043,11551286.png,271883,517,271366,0.9980984467583482,2,4,40092,74,40018,0.9981542452359573,17.526147555555557,1807.59504,15.559792199013692,135,6.0E-5
1,test_20231101_140044,10404007.png,502730,12162,490568,0.9758080878403914,2,4,61265,1779,59486,0.9709622133355097,26.55992,3673.92888,12.479496158993475,135,7.000000000000001E-5
2,test_20231101_140044,1254659.png,342646,55202,287444,0.8388949528084378,2,4,80080,7779,72301,0.9028596403596404,23.353802666666667,3980.109952,12.131852910838479,135,7.000000000000001E-5
3,test_20231101_140044,10188041.png,221231,7359,213872,0.9667361264922185,2,4,41731,1044,40687,0.9749826268241835,12.082014222222222,1435.143152,16.561851378307132,135,7.000000000000001E-5
4,test_20231101_140044,10287332.png,216980,10022,206958,0.9538114111899714,1,3,22337,1379,20958,0.9382638671262927,10.026462222222221,981.878768,18.210224918577968,135,7.000000000000001E-5
5,test_20231101_140044,11610969.png,368720,17337,351383,0.9529805814710349,2,3,84111,2551,81560,0.9696710299485204,24.066007111111112,3590.849722666667,12.578831306185476,135,7.000000000000001E-5
6,test_20231101_140044,10350842.png,212614,3392,209222,0.9840462058001825,1,4,42529,499,42030,0.9882668296926803,22.827879111111113,3246.082464,13.0172081235082,135,7.000000000000001E-5
7,test_20231101_140044,10863862.png,317432,6032,311400,0.980997504977444,2,3,66058,886,65172,0.9865875442792698,36.04656,6605.741237333334,9.931588035317864,135,7.000000000000001E-5
8,test_20231101_140044,11382381.png,312486,757,311729,0.9975774914716179,2,3,46745,103,46642,0.997796555781367,22.081843555555555,2635.736901333333,13.921783039602623,135,7.000000000000001E-5
9,test_20231101_140044,11079715.png,443815,94754,349061,0.7865011322285187,3,4,124136,13324,110812,0.8926661081394599,18.728499555555555,2605.7314826666666,13.97150700682634,135,7.000000000000001E-5
10,test_20231101_140044,11551286.png,271883,377,271506,0.9986133741351979,2,3,40092,53,40039,0.9986780405068343,17.85248,1858.6998933333334,15.438710868521719,135,7.000000000000001E-5
1,test_20231101_140045,10404007.png,502730,12162,490568,0.9758080878403914,2,4,61265,1779,59486,0.9709622133355097,26.55992,3673.92888,12.479496158993475,135,8.0E-5
2,test_20231101_140045,1254659.png,342646,55202,287444,0.8388949528084378,3,4,80080,7779,72301,0.9028596403596404,23.353802666666667,3980.109952,12.131852910838479,135,8.0E-5
3,test_20231101_140045,10188041.png,221231,7359,213872,0.9667361264922185,2,4,41731,1044,40687,0.9749826268241835,12.082014222222222,1435.143152,16.561851378307132,135,8.0E-5
4,test_20231101_140045,10287332.png,216980,10022,206958,0.9538114111899714,2,4,22337,1379,20958,0.9382638671262927,10.026462222222221,981.878768,18.210224918577968,135,8.0E-5
5,test_20231101_140045,11610969.png,368720,17337,351383,0.9529805814710349,2,4,84111,2551,81560,0.9696710299485204,24.066007111111112,3590.849722666667,12.578831306185476,135,8.0E-5
6,test_20231101_140045,10350842.png,212614,3392,209222,0.9840462058001825,2,4,42529,499,42030,0.9882668296926803,22.827879111111113,3246.082464,13.0172081235082,135,8.0E-5
7,test_20231101_140045,10863862.png,317432,6032,311400,0.980997504977444,1,3,66058,886,65172,0.9865875442792698,36.04656,6605.741237333334,9.931588035317864,135,8.0E-5
8,test_20231101_140045,11382381.png,312486,757,311729,0.9975774914716179,1,4,46745,103,46642,0.997796555781367,22.081843555555555,2635.736901333333,13.921783039602623,135,8.0E-5
9,test_20231101_140045,11079715.png,443815,94754,349061,0.7865011322285187,3,4,124136,13324,110812,0.8926661081394599,18.728499555555555,2605.7314826666666,13.97150700682634,135,8.0E-5
10,test_20231101_140045,11551286.png,271883,377,271506,0.9986133741351979,1,3,40092,53,40039,0.9986780405068343,17.85248,1858.6998933333334,15.438710868521719,135,8.0E-5
1,test_20231101_140045,10404007.png,502730,12162,490568,0.9758080878403914,2,4,61265,1779,59486,0.9709622133355097,26.55992,3673.92888,12.479496158993475,135,9.0E-5
2,test_20231101_140045,1254659.png,342646,55202,287444,0.8388949528084378,3,4,80080,7779,72301,0.9028596403596404,23.353802666666667,3980.109952,12.131852910838479,135,9.0E-5
3,test_20231101_140045,10188041.png,221231,7359,213872,0.9667361264922185,1,3,41731,1044,40687,0.9749826268241835,12.082014222222222,1435.143152,16.561851378307132,135,9.0E-5
4,test_20231101_140045,10287332.png,216980,10022,206958,0.9538114111899714,2,3,22337,1379,20958,0.9382638671262927,10.026462222222221,981.878768,18.210224918577968,135,9.0E-5
5,test_20231101_140045,11610969.png,368720,17337,351383,0.9529805814710349,2,3,84111,2551,81560,0.9696710299485204,24.066007111111112,3590.849722666667,12.578831306185476,135,9.0E-5
6,test_20231101_140045,10350842.png,212614,3392,209222,0.9840462058001825,2,3,42529,499,42030,0.9882668296926803,22.827879111111113,3246.082464,13.0172081235082,135,9.0E-5
7,test_20231101_140045,10863862.png,317432,6032,311400,0.980997504977444,1,3,66058,886,65172,0.9865875442792698,36.04656,6605.741237333334,9.931588035317864,135,9.0E-5
8,test_20231101_140045,11382381.png,312486,757,311729,0.9975774914716179,2,3,46745,103,46642,0.997796555781367,22.081843555555555,2635.736901333333,13.921783039602623,135,9.0E-5
9,test_20231101_140045,11079715.png,443815,94754,349061,0.7865011322285187,3,4,124136,13324,110812,0.8926661081394599,18.728499555555555,2605.7314826666666,13.97150700682634,135,9.0E-5
10,test_20231101_140045,11551286.png,271883,377,271506,0.9986133741351979,2,3,40092,53,40039,0.9986780405068343,17.85248,1858.6998933333334,15.438710868521719,135,9.0E-5
1,test_20231101_140046,10404007.png,502730,12162,490568,0.9758080878403914,2,4,61265,1779,59486,0.9709622133355097,26.55992,3673.92888,12.479496158993475,135,1.0E-4
2,test_20231101_140046,1254659.png,342646,55202,287444,0.8388949528084378,3,4,80080,7779,72301,0.9028596403596404,23.353802666666667,3980.109952,12.131852910838479,135,1.0E-4
3,test_20231101_140046,10188041.png,221231,7359,213872,0.9667361264922185,2,3,41731,1044,40687,0.9749826268241835,12.082014222222222,1435.143152,16.561851378307132,135,1.0E-4
4,test_20231101_140046,10287332.png,216980,10022,206958,0.9538114111899714,2,4,22337,1379,20958,0.9382638671262927,10.026462222222221,981.878768,18.210224918577968,135,1.0E-4
5,test_20231101_140046,11610969.png,368720,17337,351383,0.9529805814710349,2,4,84111,2551,81560,0.9696710299485204,24.066007111111112,3590.849722666667,12.578831306185476,135,1.0E-4
6,test_20231101_140046,10350842.png,212614,3392,209222,0.9840462058001825,2,3,42529,499,42030,0.9882668296926803,22.827879111111113,3246.082464,13.0172081235082,135,1.0E-4
7,test_20231101_140046,10863862.png,317432,6032,311400,0.980997504977444,1,3,66058,886,65172,0.9865875442792698,36.04656,6605.741237333334,9.931588035317864,135,1.0E-4
8,test_20231101_140046,11382381.png,312486,757,311729,0.9975774914716179,1,3,46745,103,46642,0.997796555781367,22.081843555555555,2635.736901333333,13.921783039602623,135,1.0E-4
9,test_20231101_140046,11079715.png,443815,94754,349061,0.7865011322285187,3,4,124136,13324,110812,0.8926661081394599,18.728499555555555,2605.7314826666666,13.97150700682634,135,1.0E-4
10,test_20231101_140046,11551286.png,271883,377,271506,0.9986133741351979,1,4,40092,53,40039,0.9986780405068343,17.85248,1858.6998933333334,15.438710868521719,135,1.0E-4
1,test_20231101_140047,10404007.png,502730,12162,490568,0.9758080878403914,2,3,61265,1779,59486,0.9709622133355097,26.55992,3673.92888,12.479496158993475,135,1.1E-4
2,test_20231101_140047,1254659.png,342646,55202,287444,0.8388949528084378,2,4,80080,7779,72301,0.9028596403596404,23.353802666666667,3980.109952,12.131852910838479,135,1.1E-4
3,test_20231101_140047,10188041.png,221231,7359,213872,0.9667361264922185,2,4,41731,1044,40687,0.9749826268241835,12.082014222222222,1435.143152,16.561851378307132,135,1.1E-4
4,test_20231101_140047,10287332.png,216980,10022,206958,0.9538114111899714,1,3,22337,1379,20958,0.9382638671262927,10.026462222222221,981.878768,18.210224918577968,135,1.1E-4
5,test_20231101_140047,11610969.png,368720,17337,351383,0.9529805814710349,2,3,84111,2551,81560,0.9696710299485204,24.066007111111112,3590.849722666667,12.578831306185476,135,1.1E-4
6,test_20231101_140047,10350842.png,212614,3392,209222,0.9840462058001825,2,3,42529,499,42030,0.9882668296926803,22.827879111111113,3246.082464,13.0172081235082,135,1.1E-4
7,test_20231101_140047,10863862.png,317432,6032,311400,0.980997504977444,2,4,66058,886,65172,0.9865875442792698,36.04656,6605.741237333334,9.931588035317864,135,1.1E-4
8,test_20231101_140047,11382381.png,312486,757,311729,0.9975774914716179,1,4,46745,103,46642,0.997796555781367,22.081843555555555,2635.736901333333,13.921783039602623,135,1.1E-4
9,test_20231101_140047,11079715.png,443815,94754,349061,0.7865011322285187,3,5,124136,13324,110812,0.8926661081394599,18.728499555555555,2605.7314826666666,13.97150700682634,135,1.1E-4
10,test_20231101_140047,11551286.png,271883,377,271506,0.9986133741351979,1,3,40092,53,40039,0.9986780405068343,17.85248,1858.6998933333334,15.438710868521719,135,1.1E-4
1,test_20231101_140047,10404007.png,502730,12162,490568,0.9758080878403914,2,4,61265,1779,59486,0.9709622133355097,26.55992,3673.92888,12.479496158993475,135,1.2E-4
2,test_20231101_140047,1254659.png,342646,55202,287444,0.8388949528084378,3,4,80080,7779,72301,0.9028596403596404,23.353802666666667,3980.109952,12.131852910838479,135,1.2E-4
3,test_20231101_140047,10188041.png,221231,7359,213872,0.9667361264922185,2,4,41731,1044,40687,0.9749826268241835,12.082014222222222,1435.143152,16.561851378307132,135,1.2E-4
4,test_20231101_140047,10287332.png,216980,10022,206958,0.9538114111899714,2,4,22337,1379,20958,0.9382638671262927,10.026462222222221,981.878768,18.210224918577968,135,1.2E-4
5,test_20231101_140047,11610969.png,368720,17337,351383,0.9529805814710349,2,4,84111,2551,81560,0.9696710299485204,24.066007111111112,3590.849722666667,12.578831306185476,135,1.2E-4
6,test_20231101_140047,10350842.png,212614,3392,209222,0.9840462058001825,1,4,42529,499,42030,0.9882668296926803,22.827879111111113,3246.082464,13.0172081235082,135,1.2E-4
7,test_20231101_140047,10863862.png,317432,6032,311400,0.980997504977444,1,3,66058,886,65172,0.9865875442792698,36.04656,6605.741237333334,9.931588035317864,135,1.2E-4
8,test_20231101_140047,11382381.png,312486,647,311839,0.9979295072419244,1,4,46745,87,46658,0.9981388383784362,22.33832177777778,2675.8690666666666,13.85615501777858,135,1.2E-4
9,test_20231101_140047,11079715.png,443815,94754,349061,0.7865011322285187,3,4,124136,13324,110812,0.8926661081394599,18.728499555555555,2605.7314826666666,13.97150700682634,135,1.2E-4
10,test_20231101_140047,11551286.png,271883,377,271506,0.9986133741351979,1,3,40092,53,40039,0.9986780405068343,17.85248,1858.6998933333334,15.438710868521719,135,1.2E-4
1,test_20231101_140048,10404007.png,502730,12162,490568,0.9758080878403914,1,3,61265,1779,59486,0.9709622133355097,26.55992,3673.92888,12.479496158993475,135,1.3000000000000002E-4
2,test_20231101_140048,1254659.png,342646,55202,287444,0.8388949528084378,2,4,80080,7779,72301,0.9028596403596404,23.353802666666667,3980.109952,12.131852910838479,135,1.3000000000000002E-4
3,test_20231101_140048,10188041.png,221231,7359,213872,0.9667361264922185,2,4,41731,1044,40687,0.9749826268241835,12.082014222222222,1435.143152,16.561851378307132,135,1.3000000000000002E-4
4,test_20231101_140048,10287332.png,216980,10022,206958,0.9538114111899714,2,4,22337,1379,20958,0.9382638671262927,10.026462222222221,981.878768,18.210224918577968,135,1.3000000000000002E-4
5,test_20231101_140048,11610969.png,368720,17337,351383,0.9529805814710349,2,4,84111,2551,81560,0.9696710299485204,24.066007111111112,3590.849722666667,12.578831306185476,135,1.3000000000000002E-4
6,test_20231101_140048,10350842.png,212614,3392,209222,0.9840462058001825,1,3,42529,499,42030,0.9882668296926803,22.827879111111113,3246.082464,13.0172081235082,135,1.3000000000000002E-4
7,test_20231101_140048,10863862.png,317432,6032,311400,0.980997504977444,2,3,66058,886,65172,0.9865875442792698,36.04656,6605.741237333334,9.931588035317864,135,1.3000000000000002E-4
8,test_20231101_140048,11382381.png,312486,647,311839,0.9979295072419244,2,3,46745,87,46658,0.9981388383784362,22.33832177777778,2675.8690666666666,13.85615501777858,135,1.3000000000000002E-4
9,test_20231101_140048,11079715.png,443815,94754,349061,0.7865011322285187,3,4,124136,13324,110812,0.8926661081394599,18.728499555555555,2605.7314826666666,13.97150700682634,135,1.3000000000000002E-4
10,test_20231101_140048,11551286.png,271883,377,271506,0.9986133741351979,2,3,40092,53,40039,0.9986780405068343,17.85248,1858.6998933333334,15.438710868521719,135,1.3000000000000002E-4
1,test_20231101_140049,10404007.png,502730,12162,490568,0.9758080878403914,2,4,61265,1779,59486,0.9709622133355097,26.55992,3673.92888,12.479496158993475,135,1.4000000000000001E-4
2,test_20231101_140049,1254659.png,342646,55202,287444,0.8388949528084378,2,4,80080,7779,72301,0.9028596403596404,23.353802666666667,3980.109952,12.131852910838479,135,1.4000000000000001E-4
3,test_20231101_140049,10188041.png,221231,7359,213872,0.9667361264922185,2,4,41731,1044,40687,0.9749826268241835,12.082014222222222,1435.143152,16.561851378307132,135,1.4000000000000001E-4
4,test_20231101_140049,10287332.png,216980,10022,206958,0.9538114111899714,2,4,22337,1379,20958,0.9382638671262927,10.026462222222221,981.878768,18.210224918577968,135,1.4000000000000001E-4
5,test_20231101_140049,11610969.png,368720,17337,351383,0.9529805814710349,2,3,84111,2551,81560,0.9696710299485204,24.066007111111112,3590.849722666667,12.578831306185476,135,1.4000000000000001E-4
6,test_20231101_140049,10350842.png,212614,3392,209222,0.9840462058001825,2,3,42529,499,42030,0.9882668296926803,22.827879111111113,3246.082464,13.0172081235082,135,1.4000000000000001E-4
7,test_20231101_140049,10863862.png,317432,6032,311400,0.980997504977444,1,3,66058,886,65172,0.9865875442792698,36.04656,6605.741237333334,9.931588035317864,135,1.4000000000000001E-4
8,test_20231101_140049,11382381.png,312486,647,311839,0.9979295072419244,1,3,46745,87,46658,0.9981388383784362,22.33832177777778,2675.8690666666666,13.85615501777858,135,1.4000000000000001E-4
9,test_20231101_140049,11079715.png,443815,94754,349061,0.7865011322285187,4,4,124136,13324,110812,0.8926661081394599,18.728499555555555,2605.7314826666666,13.97150700682634,135,1.4000000000000001E-4
10,test_20231101_140049,11551286.png,271883,377,271506,0.9986133741351979,1,4,40092,53,40039,0.9986780405068343,17.85248,1858.6998933333334,15.438710868521719,135,1.4000000000000001E-4
1,test_20231101_140050,10404007.png,502730,12162,490568,0.9758080878403914,2,4,61265,1779,59486,0.9709622133355097,26.55992,3673.92888,12.479496158993475,135,1.5000000000000001E-4
2,test_20231101_140050,1254659.png,342646,55202,287444,0.8388949528084378,3,4,80080,7779,72301,0.9028596403596404,23.353802666666667,3980.109952,12.131852910838479,135,1.5000000000000001E-4
3,test_20231101_140050,10188041.png,221231,7359,213872,0.9667361264922185,1,3,41731,1044,40687,0.9749826268241835,12.082014222222222,1435.143152,16.561851378307132,135,1.5000000000000001E-4
4,test_20231101_140050,10287332.png,216980,10022,206958,0.9538114111899714,1,3,22337,1379,20958,0.9382638671262927,10.026462222222221,981.878768,18.210224918577968,135,1.5000000000000001E-4
5,test_20231101_140050,11610969.png,368720,17337,351383,0.9529805814710349,2,4,84111,2551,81560,0.9696710299485204,24.066007111111112,3590.849722666667,12.578831306185476,135,1.5000000000000001E-4
6,test_20231101_140050,10350842.png,212614,3392,209222,0.9840462058001825,1,4,42529,499,42030,0.9882668296926803,22.827879111111113,3246.082464,13.0172081235082,135,1.5000000000000001E-4
7,test_20231101_140050,10863862.png,317432,6032,311400,0.980997504977444,2,3,66058,886,65172,0.9865875442792698,36.04656,6605.741237333334,9.931588035317864,135,1.5000000000000001E-4
8,test_20231101_140050,11382381.png,312486,647,311839,0.9979295072419244,1,4,46745,87,46658,0.9981388383784362,22.33832177777778,2675.8690666666666,13.85615501777858,135,1.5000000000000001E-4
9,test_20231101_140050,11079715.png,443815,94754,349061,0.7865011322285187,4,4,124136,13324,110812,0.8926661081394599,18.728499555555555,2605.7314826666666,13.97150700682634,135,1.5000000000000001E-4
10,test_20231101_140050,11551286.png,271883,377,271506,0.9986133741351979,1,4,40092,53,40039,0.9986780405068343,17.85248,1858.6998933333334,15.438710868521719,135,1.5000000000000001E-4
1,test_20231101_140050,10404007.png,502730,12162,490568,0.9758080878403914,3,4,61265,1779,59486,0.9709622133355097,26.55992,3673.92888,12.479496158993475,135,1.6E-4
2,test_20231101_140050,1254659.png,342646,55202,287444,0.8388949528084378,3,4,80080,7779,72301,0.9028596403596404,23.353802666666667,3980.109952,12.131852910838479,135,1.6E-4
3,test_20231101_140050,10188041.png,221231,7359,213872,0.9667361264922185,2,4,41731,1044,40687,0.9749826268241835,12.082014222222222,1435.143152,16.561851378307132,135,1.6E-4
4,test_20231101_140050,10287332.png,216980,9832,207148,0.9546870679325283,1,4,22337,1355,20982,0.9393383175896495,10.154837333333333,1008.1934186666666,18.095365027648654,135,1.6E-4
5,test_20231101_140050,11610969.png,368720,17337,351383,0.9529805814710349,2,4,84111,2551,81560,0.9696710299485204,24.066007111111112,3590.849722666667,12.578831306185476,135,1.6E-4
6,test_20231101_140050,10350842.png,212614,3392,209222,0.9840462058001825,1,3,42529,499,42030,0.9882668296926803,22.827879111111113,3246.082464,13.0172081235082,135,1.6E-4
7,test_20231101_140050,10863862.png,317432,6032,311400,0.980997504977444,1,3,66058,886,65172,0.9865875442792698,36.04656,6605.741237333334,9.931588035317864,135,1.6E-4
8,test_20231101_140050,11382381.png,312486,647,311839,0.9979295072419244,1,4,46745,87,46658,0.9981388383784362,22.33832177777778,2675.8690666666666,13.85615501777858,135,1.6E-4
9,test_20231101_140050,11079715.png,443815,94754,349061,0.7865011322285187,3,4,124136,13324,110812,0.8926661081394599,18.728499555555555,2605.7314826666666,13.97150700682634,135,1.6E-4
10,test_20231101_140050,11551286.png,271883,377,271506,0.9986133741351979,1,4,40092,53,40039,0.9986780405068343,17.85248,1858.6998933333334,15.438710868521719,135,1.6E-4
1,test_20231101_140051,10404007.png,502730,12162,490568,0.9758080878403914,2,3,61265,1779,59486,0.9709622133355097,26.55992,3673.92888,12.479496158993475,135,1.7E-4
2,test_20231101_140051,1254659.png,342646,55202,287444,0.8388949528084378,3,4,80080,7779,72301,0.9028596403596404,23.353802666666667,3980.109952,12.131852910838479,135,1.7E-4
3,test_20231101_140051,10188041.png,221231,7359,213872,0.9667361264922185,2,4,41731,1044,40687,0.9749826268241835,12.082014222222222,1435.143152,16.561851378307132,135,1.7E-4
4,test_20231101_140051,10287332.png,216980,9832,207148,0.9546870679325283,1,4,22337,1355,20982,0.9393383175896495,10.154837333333333,1008.1934186666666,18.095365027648654,135,1.7E-4
5,test_20231101_140051,11610969.png,368720,17337,351383,0.9529805814710349,2,4,84111,2551,81560,0.9696710299485204,24.066007111111112,3590.849722666667,12.578831306185476,135,1.7E-4
6,test_20231101_140051,10350842.png,212614,3392,209222,0.9840462058001825,1,4,42529,499,42030,0.9882668296926803,22.827879111111113,3246.082464,13.0172081235082,135,1.7E-4
7,test_20231101_140051,10863862.png,317432,6032,311400,0.980997504977444,1,3,66058,886,65172,0.9865875442792698,36.04656,6605.741237333334,9.931588035317864,135,1.7E-4
8,test_20231101_140051,11382381.png,312486,647,311839,0.9979295072419244,1,3,46745,87,46658,0.9981388383784362,22.33832177777778,2675.8690666666666,13.85615501777858,135,1.7E-4
9,test_20231101_140051,11079715.png,443815,94754,349061,0.7865011322285187,3,4,124136,13324,110812,0.8926661081394599,18.728499555555555,2605.7314826666666,13.97150700682634,135,1.7E-4
10,test_20231101_140051,11551286.png,271883,377,271506,0.9986133741351979,2,3,40092,53,40039,0.9986780405068343,17.85248,1858.6998933333334,15.438710868521719,135,1.7E-4
1,test_20231101_140052,10404007.png,502730,12162,490568,0.9758080878403914,2,4,61265,1779,59486,0.9709622133355097,26.55992,3673.92888,12.479496158993475,135,1.8E-4
2,test_20231101_140052,1254659.png,342646,55202,287444,0.8388949528084378,2,4,80080,7779,72301,0.9028596403596404,23.353802666666667,3980.109952,12.131852910838479,135,1.8E-4
3,test_20231101_140052,10188041.png,221231,7359,213872,0.9667361264922185,2,3,41731,1044,40687,0.9749826268241835,12.082014222222222,1435.143152,16.561851378307132,135,1.8E-4
4,test_20231101_140052,10287332.png,216980,9832,207148,0.9546870679325283,1,12,22337,1355,20982,0.9393383175896495,10.154837333333333,1008.1934186666666,18.095365027648654,135,1.8E-4
5,test_20231101_140052,11610969.png,368720,17337,351383,0.9529805814710349,2,3,84111,2551,81560,0.9696710299485204,24.066007111111112,3590.849722666667,12.578831306185476,135,1.8E-4
6,test_20231101_140052,10350842.png,212614,3392,209222,0.9840462058001825,1,4,42529,499,42030,0.9882668296926803,22.827879111111113,3246.082464,13.0172081235082,135,1.8E-4
7,test_20231101_140052,10863862.png,317432,6032,311400,0.980997504977444,1,4,66058,886,65172,0.9865875442792698,36.04656,6605.741237333334,9.931588035317864,135,1.8E-4
8,test_20231101_140052,11382381.png,312486,647,311839,0.9979295072419244,2,4,46745,87,46658,0.9981388383784362,22.33832177777778,2675.8690666666666,13.85615501777858,135,1.8E-4
9,test_20231101_140052,11079715.png,443815,94754,349061,0.7865011322285187,3,4,124136,13324,110812,0.8926661081394599,18.728499555555555,2605.7314826666666,13.97150700682634,135,1.8E-4
10,test_20231101_140052,11551286.png,271883,164,271719,0.9993967993585476,1,3,40092,22,40070,0.9994512620971765,18.120286222222223,1899.5769013333334,15.344234809036362,135,1.8E-4
1,test_20231101_140052,10404007.png,502730,12162,490568,0.9758080878403914,2,4,61265,1779,59486,0.9709622133355097,26.55992,3673.92888,12.479496158993475,135,1.9E-4
2,test_20231101_140052,1254659.png,342646,55202,287444,0.8388949528084378,3,4,80080,7779,72301,0.9028596403596404,23.353802666666667,3980.109952,12.131852910838479,135,1.9E-4
3,test_20231101_140052,10188041.png,221231,7359,213872,0.9667361264922185,2,4,41731,1044,40687,0.9749826268241835,12.082014222222222,1435.143152,16.561851378307132,135,1.9E-4
4,test_20231101_140052,10287332.png,216980,9832,207148,0.9546870679325283,1,3,22337,1355,20982,0.9393383175896495,10.154837333333333,1008.1934186666666,18.095365027648654,135,1.9E-4
5,test_20231101_140052,11610969.png,368720,17337,351383,0.9529805814710349,2,4,84111,2551,81560,0.9696710299485204,24.066007111111112,3590.849722666667,12.578831306185476,135,1.9E-4
6,test_20231101_140052,10350842.png,212614,3392,209222,0.9840462058001825,1,3,42529,499,42030,0.9882668296926803,22.827879111111113,3246.082464,13.0172081235082,135,1.9E-4
7,test_20231101_140052,10863862.png,317432,6032,311400,0.980997504977444,2,4,66058,886,65172,0.9865875442792698,36.04656,6605.741237333334,9.931588035317864,135,1.9E-4
8,test_20231101_140052,11382381.png,312486,647,311839,0.9979295072419244,1,3,46745,87,46658,0.9981388383784362,22.33832177777778,2675.8690666666666,13.85615501777858,135,1.9E-4
9,test_20231101_140052,11079715.png,443815,94754,349061,0.7865011322285187,3,6,124136,13324,110812,0.8926661081394599,18.728499555555555,2605.7314826666666,13.97150700682634,135,1.9E-4
10,test_20231101_140052,11551286.png,271883,164,271719,0.9993967993585476,2,4,40092,22,40070,0.9994512620971765,18.120286222222223,1899.5769013333334,15.344234809036362,135,1.9E-4
1,test_20231101_140053,10404007.png,502730,12162,490568,0.9758080878403914,2,3,61265,1779,59486,0.9709622133355097,26.55992,3673.92888,12.479496158993475,135,2.0E-4
2,test_20231101_140053,1254659.png,342646,55202,287444,0.8388949528084378,3,4,80080,7779,72301,0.9028596403596404,23.353802666666667,3980.109952,12.131852910838479,135,2.0E-4
3,test_20231101_140053,10188041.png,221231,7359,213872,0.9667361264922185,3,4,41731,1044,40687,0.9749826268241835,12.082014222222222,1435.143152,16.561851378307132,135,2.0E-4
4,test_20231101_140053,10287332.png,216980,9832,207148,0.9546870679325283,1,3,22337,1355,20982,0.9393383175896495,10.154837333333333,1008.1934186666666,18.095365027648654,135,2.0E-4
5,test_20231101_140053,11610969.png,368720,17337,351383,0.9529805814710349,2,4,84111,2551,81560,0.9696710299485204,24.066007111111112,3590.849722666667,12.578831306185476,135,2.0E-4
6,test_20231101_140053,10350842.png,212614,3392,209222,0.9840462058001825,1,4,42529,499,42030,0.9882668296926803,22.827879111111113,3246.082464,13.0172081235082,135,2.0E-4
7,test_20231101_140053,10863862.png,317432,6032,311400,0.980997504977444,1,4,66058,886,65172,0.9865875442792698,36.04656,6605.741237333334,9.931588035317864,135,2.0E-4
8,test_20231101_140053,11382381.png,312486,647,311839,0.9979295072419244,1,3,46745,87,46658,0.9981388383784362,22.33832177777778,2675.8690666666666,13.85615501777858,135,2.0E-4
9,test_20231101_140053,11079715.png,443815,94754,349061,0.7865011322285187,7,4,124136,13324,110812,0.8926661081394599,18.728499555555555,2605.7314826666666,13.97150700682634,135,2.0E-4
10,test_20231101_140053,11551286.png,271883,164,271719,0.9993967993585476,1,5,40092,22,40070,0.9994512620971765,18.120286222222223,1899.5769013333334,15.344234809036362,135,2.0E-4
1,test_20231101_140054,10404007.png,502730,12162,490568,0.9758080878403914,3,4,61265,1779,59486,0.9709622133355097,26.55992,3673.92888,12.479496158993475,135,2.1E-4
2,test_20231101_140054,1254659.png,342646,55202,287444,0.8388949528084378,3,4,80080,7779,72301,0.9028596403596404,23.353802666666667,3980.109952,12.131852910838479,135,2.1E-4
3,test_20231101_140054,10188041.png,221231,7359,213872,0.9667361264922185,2,4,41731,1044,40687,0.9749826268241835,12.082014222222222,1435.143152,16.561851378307132,135,2.1E-4
4,test_20231101_140054,10287332.png,216980,9832,207148,0.9546870679325283,1,3,22337,1355,20982,0.9393383175896495,10.154837333333333,1008.1934186666666,18.095365027648654,135,2.1E-4
5,test_20231101_140054,11610969.png,368720,17337,351383,0.9529805814710349,2,4,84111,2551,81560,0.9696710299485204,24.066007111111112,3590.849722666667,12.578831306185476,135,2.1E-4
6,test_20231101_140054,10350842.png,212614,3392,209222,0.9840462058001825,2,3,42529,499,42030,0.9882668296926803,22.827879111111113,3246.082464,13.0172081235082,135,2.1E-4
7,test_20231101_140054,10863862.png,317432,6032,311400,0.980997504977444,2,3,66058,886,65172,0.9865875442792698,36.04656,6605.741237333334,9.931588035317864,135,2.1E-4
8,test_20231101_140054,11382381.png,312486,647,311839,0.9979295072419244,1,4,46745,87,46658,0.9981388383784362,22.33832177777778,2675.8690666666666,13.85615501777858,135,2.1E-4
9,test_20231101_140054,11079715.png,443815,94754,349061,0.7865011322285187,2,4,124136,13324,110812,0.8926661081394599,18.728499555555555,2605.7314826666666,13.97150700682634,135,2.1E-4
10,test_20231101_140054,11551286.png,271883,164,271719,0.9993967993585476,1,3,40092,22,40070,0.9994512620971765,18.120286222222223,1899.5769013333334,15.344234809036362,135,2.1E-4
1,test_20231101_140054,10404007.png,502730,12162,490568,0.9758080878403914,2,4,61265,1779,59486,0.9709622133355097,26.55992,3673.92888,12.479496158993475,135,2.2E-4
2,test_20231101_140054,1254659.png,342646,55202,287444,0.8388949528084378,3,4,80080,7779,72301,0.9028596403596404,23.353802666666667,3980.109952,12.131852910838479,135,2.2E-4
3,test_20231101_140054,10188041.png,221231,7359,213872,0.9667361264922185,2,3,41731,1044,40687,0.9749826268241835,12.082014222222222,1435.143152,16.561851378307132,135,2.2E-4
4,test_20231101_140054,10287332.png,216980,9832,207148,0.9546870679325283,2,4,22337,1355,20982,0.9393383175896495,10.154837333333333,1008.1934186666666,18.095365027648654,135,2.2E-4
5,test_20231101_140054,11610969.png,368720,17337,351383,0.9529805814710349,2,3,84111,2551,81560,0.9696710299485204,24.066007111111112,3590.849722666667,12.578831306185476,135,2.2E-4
6,test_20231101_140054,10350842.png,212614,3392,209222,0.9840462058001825,2,4,42529,499,42030,0.9882668296926803,22.827879111111113,3246.082464,13.0172081235082,135,2.2E-4
7,test_20231101_140054,10863862.png,317432,6032,311400,0.980997504977444,1,4,66058,886,65172,0.9865875442792698,36.04656,6605.741237333334,9.931588035317864,135,2.2E-4
8,test_20231101_140054,11382381.png,312486,647,311839,0.9979295072419244,1,6,46745,87,46658,0.9981388383784362,22.33832177777778,2675.8690666666666,13.85615501777858,135,2.2E-4
9,test_20231101_140054,11079715.png,443815,94754,349061,0.7865011322285187,3,4,124136,13324,110812,0.8926661081394599,18.728499555555555,2605.7314826666666,13.97150700682634,135,2.2E-4
10,test_20231101_140054,11551286.png,271883,164,271719,0.9993967993585476,2,4,40092,22,40070,0.9994512620971765,18.120286222222223,1899.5769013333334,15.344234809036362,135,2.2E-4
1,test_20231101_140055,10404007.png,502730,12162,490568,0.9758080878403914,2,3,61265,1779,59486,0.9709622133355097,26.55992,3673.92888,12.479496158993475,135,2.3E-4
2,test_20231101_140055,1254659.png,342646,55202,287444,0.8388949528084378,2,4,80080,7779,72301,0.9028596403596404,23.353802666666667,3980.109952,12.131852910838479,135,2.3E-4
3,test_20231101_140055,10188041.png,221231,7359,213872,0.9667361264922185,2,3,41731,1044,40687,0.9749826268241835,12.082014222222222,1435.143152,16.561851378307132,135,2.3E-4
4,test_20231101_140055,10287332.png,216980,9832,207148,0.9546870679325283,1,4,22337,1355,20982,0.9393383175896495,10.154837333333333,1008.1934186666666,18.095365027648654,135,2.3E-4
5,test_20231101_140055,11610969.png,368720,17337,351383,0.9529805814710349,2,4,84111,2551,81560,0.9696710299485204,24.066007111111112,3590.849722666667,12.578831306185476,135,2.3E-4
6,test_20231101_140055,10350842.png,212614,3392,209222,0.9840462058001825,2,3,42529,499,42030,0.9882668296926803,22.827879111111113,3246.082464,13.0172081235082,135,2.3E-4
7,test_20231101_140055,10863862.png,317432,6032,311400,0.980997504977444,2,4,66058,886,65172,0.9865875442792698,36.04656,6605.741237333334,9.931588035317864,135,2.3E-4
8,test_20231101_140055,11382381.png,312486,647,311839,0.9979295072419244,1,3,46745,87,46658,0.9981388383784362,22.33832177777778,2675.8690666666666,13.85615501777858,135,2.3E-4
9,test_20231101_140055,11079715.png,443815,94754,349061,0.7865011322285187,3,4,124136,13324,110812,0.8926661081394599,18.728499555555555,2605.7314826666666,13.97150700682634,135,2.3E-4
10,test_20231101_140055,11551286.png,271883,164,271719,0.9993967993585476,3,4,40092,22,40070,0.9994512620971765,18.120286222222223,1899.5769013333334,15.344234809036362,135,2.3E-4
1,test_20231101_140056,10404007.png,502730,12162,490568,0.9758080878403914,2,4,61265,1779,59486,0.9709622133355097,26.55992,3673.92888,12.479496158993475,135,2.4E-4
2,test_20231101_140056,1254659.png,342646,55202,287444,0.8388949528084378,3,12,80080,7779,72301,0.9028596403596404,23.353802666666667,3980.109952,12.131852910838479,135,2.4E-4
3,test_20231101_140056,10188041.png,221231,7359,213872,0.9667361264922185,2,5,41731,1044,40687,0.9749826268241835,12.082014222222222,1435.143152,16.561851378307132,135,2.4E-4
4,test_20231101_140056,10287332.png,216980,9832,207148,0.9546870679325283,1,4,22337,1355,20982,0.9393383175896495,10.154837333333333,1008.1934186666666,18.095365027648654,135,2.4E-4
5,test_20231101_140056,11610969.png,368720,17337,351383,0.9529805814710349,2,3,84111,2551,81560,0.9696710299485204,24.066007111111112,3590.849722666667,12.578831306185476,135,2.4E-4
6,test_20231101_140056,10350842.png,212614,3392,209222,0.9840462058001825,2,3,42529,499,42030,0.9882668296926803,22.827879111111113,3246.082464,13.0172081235082,135,2.4E-4
7,test_20231101_140056,10863862.png,317432,6032,311400,0.980997504977444,2,4,66058,886,65172,0.9865875442792698,36.04656,6605.741237333334,9.931588035317864,135,2.4E-4
8,test_20231101_140056,11382381.png,312486,647,311839,0.9979295072419244,1,4,46745,87,46658,0.9981388383784362,22.33832177777778,2675.8690666666666,13.85615501777858,135,2.4E-4
9,test_20231101_140056,11079715.png,443815,94754,349061,0.7865011322285187,3,4,124136,13324,110812,0.8926661081394599,18.728499555555555,2605.7314826666666,13.97150700682634,135,2.4E-4
10,test_20231101_140056,11551286.png,271883,164,271719,0.9993967993585476,1,4,40092,22,40070,0.9994512620971765,18.120286222222223,1899.5769013333334,15.344234809036362,135,2.4E-4
1,test_20231101_140056,10404007.png,502730,12162,490568,0.9758080878403914,2,4,61265,1779,59486,0.9709622133355097,26.55992,3673.92888,12.479496158993475,135,2.5E-4
2,test_20231101_140056,1254659.png,342646,55202,287444,0.8388949528084378,3,4,80080,7779,72301,0.9028596403596404,23.353802666666667,3980.109952,12.131852910838479,135,2.5E-4
3,test_20231101_140056,10188041.png,221231,7359,213872,0.9667361264922185,1,3,41731,1044,40687,0.9749826268241835,12.082014222222222,1435.143152,16.561851378307132,135,2.5E-4
4,test_20231101_140056,10287332.png,216980,9832,207148,0.9546870679325283,1,4,22337,1355,20982,0.9393383175896495,10.154837333333333,1008.1934186666666,18.095365027648654,135,2.5E-4
5,test_20231101_140056,11610969.png,368720,17337,351383,0.9529805814710349,2,3,84111,2551,81560,0.9696710299485204,24.066007111111112,3590.849722666667,12.578831306185476,135,2.5E-4
6,test_20231101_140056,10350842.png,212614,3392,209222,0.9840462058001825,1,4,42529,499,42030,0.9882668296926803,22.827879111111113,3246.082464,13.0172081235082,135,2.5E-4
7,test_20231101_140056,10863862.png,317432,6032,311400,0.980997504977444,1,3,66058,886,65172,0.9865875442792698,36.04656,6605.741237333334,9.931588035317864,135,2.5E-4
8,test_20231101_140056,11382381.png,312486,647,311839,0.9979295072419244,2,3,46745,87,46658,0.9981388383784362,22.33832177777778,2675.8690666666666,13.85615501777858,135,2.5E-4
9,test_20231101_140056,11079715.png,443815,94754,349061,0.7865011322285187,3,4,124136,13324,110812,0.8926661081394599,18.728499555555555,2605.7314826666666,13.97150700682634,135,2.5E-4
10,test_20231101_140056,11551286.png,271883,164,271719,0.9993967993585476,2,4,40092,22,40070,0.9994512620971765,18.120286222222223,1899.5769013333334,15.344234809036362,135,2.5E-4
1,test_20231101_140057,10404007.png,502730,11982,490748,0.976166132914288,2,3,61265,1754,59511,0.9713702766669388,26.782478222222224,3724.0032213333334,12.420703128854885,135,2.6000000000000003E-4
2,test_20231101_140057,1254659.png,342646,55142,287504,0.8390700606456809,3,4,80080,7773,72307,0.9029345654345654,23.363356444444445,3981.192138666667,12.13067223035364,135,2.6000000000000003E-4
3,test_20231101_140057,10188041.png,221231,7197,214034,0.9674683927659324,2,3,41731,1021,40710,0.9755337758500875,12.409082666666666,1482.392304,16.42117209237998,135,2.6000000000000003E-4
4,test_20231101_140057,10287332.png,216980,9832,207148,0.9546870679325283,1,4,22337,1355,20982,0.9393383175896495,10.154837333333333,1008.1934186666666,18.095365027648654,135,2.6000000000000003E-4
5,test_20231101_140057,11610969.png,368720,17257,351463,0.9531975482751139,2,4,84111,2540,81571,0.9698018095136189,24.103752888888888,3594.7265653333334,12.574144997187485,135,2.6000000000000003E-4
6,test_20231101_140057,10350842.png,212614,3329,209285,0.9843425174259456,1,4,42529,490,42039,0.9884784499988243,22.883356444444445,3250.8236266666668,13.010869533660298,135,2.6000000000000003E-4
7,test_20231101_140057,10863862.png,317432,5752,311680,0.9818795836588624,3,4,66058,845,65213,0.9872082109661207,36.77768711111111,6782.79896,9.81671415962192,135,2.6000000000000003E-4
8,test_20231101_140057,11382381.png,312486,527,311959,0.9983135244458952,2,3,46745,69,46676,0.9985239063001391,22.832848,2745.811376,13.744096608790418,135,2.6000000000000003E-4
9,test_20231101_140057,11079715.png,443815,94754,349061,0.7865011322285187,3,4,124136,13324,110812,0.8926661081394599,18.728499555555555,2605.7314826666666,13.97150700682634,135,2.6000000000000003E-4
10,test_20231101_140057,11551286.png,271883,164,271719,0.9993967993585476,2,3,40092,22,40070,0.9994512620971765,18.120286222222223,1899.5769013333334,15.344234809036362,135,2.6000000000000003E-4
1,test_20231101_140058,10404007.png,502730,11982,490748,0.976166132914288,2,3,61265,1754,59511,0.9713702766669388,26.782478222222224,3724.0032213333334,12.420703128854885,135,2.7000000000000006E-4
2,test_20231101_140058,1254659.png,342646,55142,287504,0.8390700606456809,3,4,80080,7773,72307,0.9029345654345654,23.363356444444445,3981.192138666667,12.13067223035364,135,2.7000000000000006E-4
3,test_20231101_140058,10188041.png,221231,7197,214034,0.9674683927659324,2,3,41731,1021,40710,0.9755337758500875,12.409082666666666,1482.392304,16.42117209237998,135,2.7000000000000006E-4
4,test_20231101_140058,10287332.png,216980,9832,207148,0.9546870679325283,1,4,22337,1355,20982,0.9393383175896495,10.154837333333333,1008.1934186666666,18.095365027648654,135,2.7000000000000006E-4
5,test_20231101_140058,11610969.png,368720,17257,351463,0.9531975482751139,2,3,84111,2540,81571,0.9698018095136189,24.103752888888888,3594.7265653333334,12.574144997187485,135,2.7000000000000006E-4
6,test_20231101_140058,10350842.png,212614,3329,209285,0.9843425174259456,1,4,42529,490,42039,0.9884784499988243,22.883356444444445,3250.8236266666668,13.010869533660298,135,2.7000000000000006E-4
7,test_20231101_140058,10863862.png,317432,5752,311680,0.9818795836588624,1,3,66058,845,65213,0.9872082109661207,36.77768711111111,6782.79896,9.81671415962192,135,2.7000000000000006E-4
8,test_20231101_140058,11382381.png,312486,527,311959,0.9983135244458952,1,4,46745,69,46676,0.9985239063001391,22.832848,2745.811376,13.744096608790418,135,2.7000000000000006E-4
9,test_20231101_140058,11079715.png,443815,94754,349061,0.7865011322285187,3,4,124136,13324,110812,0.8926661081394599,18.728499555555555,2605.7314826666666,13.97150700682634,135,2.7000000000000006E-4
10,test_20231101_140058,11551286.png,271883,164,271719,0.9993967993585476,1,5,40092,22,40070,0.9994512620971765,18.120286222222223,1899.5769013333334,15.344234809036362,135,2.7000000000000006E-4
1,test_20231101_140058,10404007.png,502730,11982,490748,0.976166132914288,2,3,61265,1754,59511,0.9713702766669388,26.782478222222224,3724.0032213333334,12.420703128854885,135,2.800000000000001E-4
2,test_20231101_140058,1254659.png,342646,55142,287504,0.8390700606456809,12,4,80080,7773,72307,0.9029345654345654,23.363356444444445,3981.192138666667,12.13067223035364,135,2.800000000000001E-4
3,test_20231101_140058,10188041.png,221231,7197,214034,0.9674683927659324,2,4,41731,1021,40710,0.9755337758500875,12.409082666666666,1482.392304,16.42117209237998,135,2.800000000000001E-4
4,test_20231101_140058,10287332.png,216980,9832,207148,0.9546870679325283,1,4,22337,1355,20982,0.9393383175896495,10.154837333333333,1008.1934186666666,18.095365027648654,135,2.800000000000001E-4
5,test_20231101_140058,11610969.png,368720,17257,351463,0.9531975482751139,2,4,84111,2540,81571,0.9698018095136189,24.103752888888888,3594.7265653333334,12.574144997187485,135,2.800000000000001E-4
6,test_20231101_140058,10350842.png,212614,3329,209285,0.9843425174259456,2,4,42529,490,42039,0.9884784499988243,22.883356444444445,3250.8236266666668,13.010869533660298,135,2.800000000000001E-4
7,test_20231101_140058,10863862.png,317432,5752,311680,0.9818795836588624,1,4,66058,845,65213,0.9872082109661207,36.77768711111111,6782.79896,9.81671415962192,135,2.800000000000001E-4
8,test_20231101_140058,11382381.png,312486,527,311959,0.9983135244458952,1,3,46745,69,46676,0.9985239063001391,22.832848,2745.811376,13.744096608790418,135,2.800000000000001E-4
9,test_20231101_140058,11079715.png,443815,94754,349061,0.7865011322285187,3,4,124136,13324,110812,0.8926661081394599,18.728499555555555,2605.7314826666666,13.97150700682634,135,2.800000000000001E-4
10,test_20231101_140058,11551286.png,271883,164,271719,0.9993967993585476,1,3,40092,22,40070,0.9994512620971765,18.120286222222223,1899.5769013333334,15.344234809036362,135,2.800000000000001E-4
1,test_20231101_140059,10404007.png,502730,11982,490748,0.976166132914288,2,4,61265,1754,59511,0.9713702766669388,26.782478222222224,3724.0032213333334,12.420703128854885,135,2.900000000000001E-4
2,test_20231101_140059,1254659.png,342646,55142,287504,0.8390700606456809,2,4,80080,7773,72307,0.9029345654345654,23.363356444444445,3981.192138666667,12.13067223035364,135,2.900000000000001E-4
3,test_20231101_140059,10188041.png,221231,7197,214034,0.9674683927659324,2,3,41731,1021,40710,0.9755337758500875,12.409082666666666,1482.392304,16.42117209237998,135,2.900000000000001E-4
4,test_20231101_140059,10287332.png,216980,9832,207148,0.9546870679325283,1,4,22337,1355,20982,0.9393383175896495,10.154837333333333,1008.1934186666666,18.095365027648654,135,2.900000000000001E-4
5,test_20231101_140059,11610969.png,368720,17257,351463,0.9531975482751139,2,3,84111,2540,81571,0.9698018095136189,24.103752888888888,3594.7265653333334,12.574144997187485,135,2.900000000000001E-4
6,test_20231101_140059,10350842.png,212614,3329,209285,0.9843425174259456,2,4,42529,490,42039,0.9884784499988243,22.883356444444445,3250.8236266666668,13.010869533660298,135,2.900000000000001E-4
7,test_20231101_140059,10863862.png,317432,5752,311680,0.9818795836588624,1,3,66058,845,65213,0.9872082109661207,36.77768711111111,6782.79896,9.81671415962192,135,2.900000000000001E-4
8,test_20231101_140059,11382381.png,312486,527,311959,0.9983135244458952,1,4,46745,69,46676,0.9985239063001391,22.832848,2745.811376,13.744096608790418,135,2.900000000000001E-4
9,test_20231101_140059,11079715.png,443815,94754,349061,0.7865011322285187,3,4,124136,13324,110812,0.8926661081394599,18.728499555555555,2605.7314826666666,13.97150700682634,135,2.900000000000001E-4
10,test_20231101_140059,11551286.png,271883,164,271719,0.9993967993585476,2,3,40092,22,40070,0.9994512620971765,18.120286222222223,1899.5769013333334,15.344234809036362,135,2.900000000000001E-4
1,test_20231101_140100,10404007.png,502730,11982,490748,0.976166132914288,2,4,61265,1754,59511,0.9713702766669388,26.782478222222224,3724.0032213333334,12.420703128854885,135,3.0000000000000014E-4
2,test_20231101_140100,1254659.png,342646,55142,287504,0.8390700606456809,3,4,80080,7773,72307,0.9029345654345654,23.363356444444445,3981.192138666667,12.13067223035364,135,3.0000000000000014E-4
3,test_20231101_140100,10188041.png,221231,7197,214034,0.9674683927659324,2,4,41731,1021,40710,0.9755337758500875,12.409082666666666,1482.392304,16.42117209237998,135,3.0000000000000014E-4
4,test_20231101_140100,10287332.png,216980,9832,207148,0.9546870679325283,2,4,22337,1355,20982,0.9393383175896495,10.154837333333333,1008.1934186666666,18.095365027648654,135,3.0000000000000014E-4
5,test_20231101_140100,11610969.png,368720,17257,351463,0.9531975482751139,2,4,84111,2540,81571,0.9698018095136189,24.103752888888888,3594.7265653333334,12.574144997187485,135,3.0000000000000014E-4
6,test_20231101_140100,10350842.png,212614,3329,209285,0.9843425174259456,2,3,42529,490,42039,0.9884784499988243,22.883356444444445,3250.8236266666668,13.010869533660298,135,3.0000000000000014E-4
7,test_20231101_140100,10863862.png,317432,5752,311680,0.9818795836588624,1,4,66058,845,65213,0.9872082109661207,36.77768711111111,6782.79896,9.81671415962192,135,3.0000000000000014E-4
8,test_20231101_140100,11382381.png,312486,527,311959,0.9983135244458952,2,4,46745,69,46676,0.9985239063001391,22.832848,2745.811376,13.744096608790418,135,3.0000000000000014E-4
9,test_20231101_140100,11079715.png,443815,94754,349061,0.7865011322285187,3,4,124136,13324,110812,0.8926661081394599,18.728499555555555,2605.7314826666666,13.97150700682634,135,3.0000000000000014E-4
10,test_20231101_140100,11551286.png,271883,164,271719,0.9993967993585476,1,3,40092,22,40070,0.9994512620971765,18.120286222222223,1899.5769013333334,15.344234809036362,135,3.0000000000000014E-4
1,test_20231101_140100,10404007.png,502730,11982,490748,0.976166132914288,2,3,61265,1754,59511,0.9713702766669388,26.782478222222224,3724.0032213333334,12.420703128854885,135,3.1000000000000016E-4
2,test_20231101_140100,1254659.png,342646,55142,287504,0.8390700606456809,2,3,80080,7773,72307,0.9029345654345654,23.363356444444445,3981.192138666667,12.13067223035364,135,3.1000000000000016E-4
3,test_20231101_140100,10188041.png,221231,7197,214034,0.9674683927659324,2,3,41731,1021,40710,0.9755337758500875,12.409082666666666,1482.392304,16.42117209237998,135,3.1000000000000016E-4
4,test_20231101_140100,10287332.png,216980,9832,207148,0.9546870679325283,1,3,22337,1355,20982,0.9393383175896495,10.154837333333333,1008.1934186666666,18.095365027648654,135,3.1000000000000016E-4
5,test_20231101_140100,11610969.png,368720,17257,351463,0.9531975482751139,2,3,84111,2540,81571,0.9698018095136189,24.103752888888888,3594.7265653333334,12.574144997187485,135,3.1000000000000016E-4
6,test_20231101_140100,10350842.png,212614,3329,209285,0.9843425174259456,1,3,42529,490,42039,0.9884784499988243,22.883356444444445,3250.8236266666668,13.010869533660298,135,3.1000000000000016E-4
7,test_20231101_140100,10863862.png,317432,5752,311680,0.9818795836588624,2,4,66058,845,65213,0.9872082109661207,36.77768711111111,6782.79896,9.81671415962192,135,3.1000000000000016E-4
8,test_20231101_140100,11382381.png,312486,527,311959,0.9983135244458952,1,4,46745,69,46676,0.9985239063001391,22.832848,2745.811376,13.744096608790418,135,3.1000000000000016E-4
9,test_20231101_140100,11079715.png,443815,94754,349061,0.7865011322285187,3,5,124136,13324,110812,0.8926661081394599,18.728499555555555,2605.7314826666666,13.97150700682634,135,3.1000000000000016E-4
10,test_20231101_140100,11551286.png,271883,164,271719,0.9993967993585476,1,3,40092,22,40070,0.9994512620971765,18.120286222222223,1899.5769013333334,15.344234809036362,135,3.1000000000000016E-4
1,test_20231101_140101,10404007.png,502730,11982,490748,0.976166132914288,2,4,61265,1754,59511,0.9713702766669388,26.782478222222224,3724.0032213333334,12.420703128854885,135,3.200000000000002E-4
2,test_20231101_140101,1254659.png,342646,55142,287504,0.8390700606456809,3,4,80080,7773,72307,0.9029345654345654,23.363356444444445,3981.192138666667,12.13067223035364,135,3.200000000000002E-4
3,test_20231101_140101,10188041.png,221231,7197,214034,0.9674683927659324,2,4,41731,1021,40710,0.9755337758500875,12.409082666666666,1482.392304,16.42117209237998,135,3.200000000000002E-4
4,test_20231101_140101,10287332.png,216980,9832,207148,0.9546870679325283,2,4,22337,1355,20982,0.9393383175896495,10.154837333333333,1008.1934186666666,18.095365027648654,135,3.200000000000002E-4
5,test_20231101_140101,11610969.png,368720,13662,355058,0.9629474940334128,2,4,84111,2025,82086,0.9759246709705033,35.46244266666667,6281.286944,10.150317274145863,135,3.200000000000002E-4
6,test_20231101_140101,10350842.png,212614,3329,209285,0.9843425174259456,2,4,42529,490,42039,0.9884784499988243,22.883356444444445,3250.8236266666668,13.010869533660298,135,3.200000000000002E-4
7,test_20231101_140101,10863862.png,317432,5752,311680,0.9818795836588624,1,4,66058,845,65213,0.9872082109661207,36.77768711111111,6782.79896,9.81671415962192,135,3.200000000000002E-4
8,test_20231101_140101,11382381.png,312486,527,311959,0.9983135244458952,2,4,46745,69,46676,0.9985239063001391,22.832848,2745.811376,13.744096608790418,135,3.200000000000002E-4
9,test_20231101_140101,11079715.png,443815,94754,349061,0.7865011322285187,3,4,124136,13324,110812,0.8926661081394599,18.728499555555555,2605.7314826666666,13.97150700682634,135,3.200000000000002E-4
10,test_20231101_140101,11551286.png,271883,164,271719,0.9993967993585476,2,4,40092,22,40070,0.9994512620971765,18.120286222222223,1899.5769013333334,15.344234809036362,135,3.200000000000002E-4
1,test_20231101_140102,10404007.png,502730,11982,490748,0.976166132914288,2,3,61265,1754,59511,0.9713702766669388,26.782478222222224,3724.0032213333334,12.420703128854885,135,3.300000000000002E-4
2,test_20231101_140102,1254659.png,342646,55142,287504,0.8390700606456809,3,4,80080,7773,72307,0.9029345654345654,23.363356444444445,3981.192138666667,12.13067223035364,135,3.300000000000002E-4
3,test_20231101_140102,10188041.png,221231,7197,214034,0.9674683927659324,2,4,41731,1021,40710,0.9755337758500875,12.409082666666666,1482.392304,16.42117209237998,135,3.300000000000002E-4
4,test_20231101_140102,10287332.png,216980,9832,207148,0.9546870679325283,2,3,22337,1355,20982,0.9393383175896495,10.154837333333333,1008.1934186666666,18.095365027648654,135,3.300000000000002E-4
5,test_20231101_140102,11610969.png,368720,13662,355058,0.9629474940334128,2,4,84111,2025,82086,0.9759246709705033,35.46244266666667,6281.286944,10.150317274145863,135,3.300000000000002E-4
6,test_20231101_140102,10350842.png,212614,3329,209285,0.9843425174259456,1,3,42529,490,42039,0.9884784499988243,22.883356444444445,3250.8236266666668,13.010869533660298,135,3.300000000000002E-4
7,test_20231101_140102,10863862.png,317432,5752,311680,0.9818795836588624,2,4,66058,845,65213,0.9872082109661207,36.77768711111111,6782.79896,9.81671415962192,135,3.300000000000002E-4
8,test_20231101_140102,11382381.png,312486,527,311959,0.9983135244458952,1,3,46745,69,46676,0.9985239063001391,22.832848,2745.811376,13.744096608790418,135,3.300000000000002E-4
9,test_20231101_140102,11079715.png,443815,94754,349061,0.7865011322285187,3,4,124136,13324,110812,0.8926661081394599,18.728499555555555,2605.7314826666666,13.97150700682634,135,3.300000000000002E-4
10,test_20231101_140102,11551286.png,271883,164,271719,0.9993967993585476,1,3,40092,22,40070,0.9994512620971765,18.120286222222223,1899.5769013333334,15.344234809036362,135,3.300000000000002E-4
1,test_20231101_140102,10404007.png,502730,11982,490748,0.976166132914288,2,4,61265,1754,59511,0.9713702766669388,26.782478222222224,3724.0032213333334,12.420703128854885,135,3.4000000000000024E-4
2,test_20231101_140102,1254659.png,342646,55142,287504,0.8390700606456809,3,4,80080,7773,72307,0.9029345654345654,23.363356444444445,3981.192138666667,12.13067223035364,135,3.4000000000000024E-4
3,test_20231101_140102,10188041.png,221231,7197,214034,0.9674683927659324,2,4,41731,1021,40710,0.9755337758500875,12.409082666666666,1482.392304,16.42117209237998,135,3.4000000000000024E-4
4,test_20231101_140102,10287332.png,216980,9832,207148,0.9546870679325283,2,4,22337,1355,20982,0.9393383175896495,10.154837333333333,1008.1934186666666,18.095365027648654,135,3.4000000000000024E-4
5,test_20231101_140102,11610969.png,368720,13662,355058,0.9629474940334128,4,3,84111,2025,82086,0.9759246709705033,35.46244266666667,6281.286944,10.150317274145863,135,3.4000000000000024E-4
6,test_20231101_140102,10350842.png,212614,3329,209285,0.9843425174259456,1,4,42529,490,42039,0.9884784499988243,22.883356444444445,3250.8236266666668,13.010869533660298,135,3.4000000000000024E-4
7,test_20231101_140102,10863862.png,317432,5752,311680,0.9818795836588624,2,3,66058,845,65213,0.9872082109661207,36.77768711111111,6782.79896,9.81671415962192,135,3.4000000000000024E-4
8,test_20231101_140102,11382381.png,312486,527,311959,0.9983135244458952,1,4,46745,69,46676,0.9985239063001391,22.832848,2745.811376,13.744096608790418,135,3.4000000000000024E-4
9,test_20231101_140102,11079715.png,443815,94754,349061,0.7865011322285187,3,4,124136,13324,110812,0.8926661081394599,18.728499555555555,2605.7314826666666,13.97150700682634,135,3.4000000000000024E-4
10,test_20231101_140102,11551286.png,271883,164,271719,0.9993967993585476,1,3,40092,22,40070,0.9994512620971765,18.120286222222223,1899.5769013333334,15.344234809036362,135,3.4000000000000024E-4
1,test_20231101_140103,10404007.png,502730,11982,490748,0.976166132914288,2,3,61265,1754,59511,0.9713702766669388,26.782478222222224,3724.0032213333334,12.420703128854885,135,3.5000000000000027E-4
2,test_20231101_140103,1254659.png,342646,55142,287504,0.8390700606456809,3,4,80080,7773,72307,0.9029345654345654,23.363356444444445,3981.192138666667,12.13067223035364,135,3.5000000000000027E-4
3,test_20231101_140103,10188041.png,221231,7197,214034,0.9674683927659324,2,3,41731,1021,40710,0.9755337758500875,12.409082666666666,1482.392304,16.42117209237998,135,3.5000000000000027E-4
4,test_20231101_140103,10287332.png,216980,9832,207148,0.9546870679325283,2,4,22337,1355,20982,0.9393383175896495,10.154837333333333,1008.1934186666666,18.095365027648654,135,3.5000000000000027E-4
5,test_20231101_140103,11610969.png,368720,13662,355058,0.9629474940334128,2,3,84111,2025,82086,0.9759246709705033,35.46244266666667,6281.286944,10.150317274145863,135,3.5000000000000027E-4
6,test_20231101_140103,10350842.png,212614,3329,209285,0.9843425174259456,1,3,42529,490,42039,0.9884784499988243,22.883356444444445,3250.8236266666668,13.010869533660298,135,3.5000000000000027E-4
7,test_20231101_140103,10863862.png,317432,5752,311680,0.9818795836588624,2,3,66058,845,65213,0.9872082109661207,36.77768711111111,6782.79896,9.81671415962192,135,3.5000000000000027E-4
8,test_20231101_140103,11382381.png,312486,527,311959,0.9983135244458952,1,3,46745,69,46676,0.9985239063001391,22.832848,2745.811376,13.744096608790418,135,3.5000000000000027E-4
9,test_20231101_140103,11079715.png,443815,94754,349061,0.7865011322285187,4,4,124136,13324,110812,0.8926661081394599,18.728499555555555,2605.7314826666666,13.97150700682634,135,3.5000000000000027E-4
10,test_20231101_140103,11551286.png,271883,164,271719,0.9993967993585476,1,3,40092,22,40070,0.9994512620971765,18.120286222222223,1899.5769013333334,15.344234809036362,135,3.5000000000000027E-4
1,test_20231101_140104,10404007.png,502730,11982,490748,0.976166132914288,2,4,61265,1754,59511,0.9713702766669388,26.782478222222224,3724.0032213333334,12.420703128854885,135,3.600000000000003E-4
2,test_20231101_140104,1254659.png,342646,55142,287504,0.8390700606456809,3,4,80080,7773,72307,0.9029345654345654,23.363356444444445,3981.192138666667,12.13067223035364,135,3.600000000000003E-4
3,test_20231101_140104,10188041.png,221231,7197,214034,0.9674683927659324,2,4,41731,1021,40710,0.9755337758500875,12.409082666666666,1482.392304,16.42117209237998,135,3.600000000000003E-4
4,test_20231101_140104,10287332.png,216980,9832,207148,0.9546870679325283,1,3,22337,1355,20982,0.9393383175896495,10.154837333333333,1008.1934186666666,18.095365027648654,135,3.600000000000003E-4
5,test_20231101_140104,11610969.png,368720,13662,355058,0.9629474940334128,2,3,84111,2025,82086,0.9759246709705033,35.46244266666667,6281.286944,10.150317274145863,135,3.600000000000003E-4
6,test_20231101_140104,10350842.png,212614,3329,209285,0.9843425174259456,1,3,42529,490,42039,0.9884784499988243,22.883356444444445,3250.8236266666668,13.010869533660298,135,3.600000000000003E-4
7,test_20231101_140104,10863862.png,317432,5752,311680,0.9818795836588624,2,4,66058,845,65213,0.9872082109661207,36.77768711111111,6782.79896,9.81671415962192,135,3.600000000000003E-4
8,test_20231101_140104,11382381.png,312486,527,311959,0.9983135244458952,1,4,46745,69,46676,0.9985239063001391,22.832848,2745.811376,13.744096608790418,135,3.600000000000003E-4
9,test_20231101_140104,11079715.png,443815,94754,349061,0.7865011322285187,3,4,124136,13324,110812,0.8926661081394599,18.728499555555555,2605.7314826666666,13.97150700682634,135,3.600000000000003E-4
10,test_20231101_140104,11551286.png,271883,164,271719,0.9993967993585476,2,3,40092,22,40070,0.9994512620971765,18.120286222222223,1899.5769013333334,15.344234809036362,135,3.600000000000003E-4
1,test_20231101_140105,10404007.png,502730,11982,490748,0.976166132914288,2,3,61265,1754,59511,0.9713702766669388,26.782478222222224,3724.0032213333334,12.420703128854885,135,3.700000000000003E-4
2,test_20231101_140105,1254659.png,342646,55142,287504,0.8390700606456809,2,4,80080,7773,72307,0.9029345654345654,23.363356444444445,3981.192138666667,12.13067223035364,135,3.700000000000003E-4
3,test_20231101_140105,10188041.png,221231,7197,214034,0.9674683927659324,2,4,41731,1021,40710,0.9755337758500875,12.409082666666666,1482.392304,16.42117209237998,135,3.700000000000003E-4
4,test_20231101_140105,10287332.png,216980,9832,207148,0.9546870679325283,1,3,22337,1355,20982,0.9393383175896495,10.154837333333333,1008.1934186666666,18.095365027648654,135,3.700000000000003E-4
5,test_20231101_140105,11610969.png,368720,13662,355058,0.9629474940334128,3,4,84111,2025,82086,0.9759246709705033,35.46244266666667,6281.286944,10.150317274145863,135,3.700000000000003E-4
6,test_20231101_140105,10350842.png,212614,3329,209285,0.9843425174259456,2,3,42529,490,42039,0.9884784499988243,22.883356444444445,3250.8236266666668,13.010869533660298,135,3.700000000000003E-4
7,test_20231101_140105,10863862.png,317432,5752,311680,0.9818795836588624,1,3,66058,845,65213,0.9872082109661207,36.77768711111111,6782.79896,9.81671415962192,135,3.700000000000003E-4
8,test_20231101_140105,11382381.png,312486,527,311959,0.9983135244458952,1,4,46745,69,46676,0.9985239063001391,22.832848,2745.811376,13.744096608790418,135,3.700000000000003E-4
9,test_20231101_140105,11079715.png,443815,94754,349061,0.7865011322285187,3,4,124136,13324,110812,0.8926661081394599,18.728499555555555,2605.7314826666666,13.97150700682634,135,3.700000000000003E-4
10,test_20231101_140105,11551286.png,271883,164,271719,0.9993967993585476,1,4,40092,22,40070,0.9994512620971765,18.120286222222223,1899.5769013333334,15.344234809036362,135,3.700000000000003E-4
1,test_20231101_140105,10404007.png,502730,11982,490748,0.976166132914288,2,3,61265,1754,59511,0.9713702766669388,26.782478222222224,3724.0032213333334,12.420703128854885,135,3.8000000000000035E-4
2,test_20231101_140105,1254659.png,342646,55142,287504,0.8390700606456809,3,4,80080,7773,72307,0.9029345654345654,23.363356444444445,3981.192138666667,12.13067223035364,135,3.8000000000000035E-4
3,test_20231101_140105,10188041.png,221231,7197,214034,0.9674683927659324,1,4,41731,1021,40710,0.9755337758500875,12.409082666666666,1482.392304,16.42117209237998,135,3.8000000000000035E-4
4,test_20231101_140105,10287332.png,216980,9832,207148,0.9546870679325283,2,4,22337,1355,20982,0.9393383175896495,10.154837333333333,1008.1934186666666,18.095365027648654,135,3.8000000000000035E-4
5,test_20231101_140105,11610969.png,368720,13662,355058,0.9629474940334128,1,3,84111,2025,82086,0.9759246709705033,35.46244266666667,6281.286944,10.150317274145863,135,3.8000000000000035E-4
6,test_20231101_140105,10350842.png,212614,3329,209285,0.9843425174259456,1,3,42529,490,42039,0.9884784499988243,22.883356444444445,3250.8236266666668,13.010869533660298,135,3.8000000000000035E-4
7,test_20231101_140105,10863862.png,317432,5752,311680,0.9818795836588624,2,4,66058,845,65213,0.9872082109661207,36.77768711111111,6782.79896,9.81671415962192,135,3.8000000000000035E-4
8,test_20231101_140105,11382381.png,312486,527,311959,0.9983135244458952,1,4,46745,69,46676,0.9985239063001391,22.832848,2745.811376,13.744096608790418,135,3.8000000000000035E-4
9,test_20231101_140105,11079715.png,443815,94754,349061,0.7865011322285187,3,4,124136,13324,110812,0.8926661081394599,18.728499555555555,2605.7314826666666,13.97150700682634,135,3.8000000000000035E-4
10,test_20231101_140105,11551286.png,271883,164,271719,0.9993967993585476,2,3,40092,22,40070,0.9994512620971765,18.120286222222223,1899.5769013333334,15.344234809036362,135,3.8000000000000035E-4
1,test_20231101_140106,10404007.png,502730,11982,490748,0.976166132914288,2,4,61265,1754,59511,0.9713702766669388,26.782478222222224,3724.0032213333334,12.420703128854885,135,3.9000000000000037E-4
2,test_20231101_140106,1254659.png,342646,55142,287504,0.8390700606456809,3,4,80080,7773,72307,0.9029345654345654,23.363356444444445,3981.192138666667,12.13067223035364,135,3.9000000000000037E-4
3,test_20231101_140106,10188041.png,221231,7197,214034,0.9674683927659324,2,3,41731,1021,40710,0.9755337758500875,12.409082666666666,1482.392304,16.42117209237998,135,3.9000000000000037E-4
4,test_20231101_140106,10287332.png,216980,9832,207148,0.9546870679325283,2,3,22337,1355,20982,0.9393383175896495,10.154837333333333,1008.1934186666666,18.095365027648654,135,3.9000000000000037E-4
5,test_20231101_140106,11610969.png,368720,13662,355058,0.9629474940334128,2,4,84111,2025,82086,0.9759246709705033,35.46244266666667,6281.286944,10.150317274145863,135,3.9000000000000037E-4
6,test_20231101_140106,10350842.png,212614,3329,209285,0.9843425174259456,2,3,42529,490,42039,0.9884784499988243,22.883356444444445,3250.8236266666668,13.010869533660298,135,3.9000000000000037E-4
7,test_20231101_140106,10863862.png,317432,5752,311680,0.9818795836588624,2,4,66058,845,65213,0.9872082109661207,36.77768711111111,6782.79896,9.81671415962192,135,3.9000000000000037E-4
8,test_20231101_140106,11382381.png,312486,527,311959,0.9983135244458952,1,3,46745,69,46676,0.9985239063001391,22.832848,2745.811376,13.744096608790418,135,3.9000000000000037E-4
9,test_20231101_140106,11079715.png,443815,94754,349061,0.7865011322285187,3,5,124136,13324,110812,0.8926661081394599,18.728499555555555,2605.7314826666666,13.97150700682634,135,3.9000000000000037E-4
10,test_20231101_140106,11551286.png,271883,164,271719,0.9993967993585476,1,4,40092,22,40070,0.9994512620971765,18.120286222222223,1899.5769013333334,15.344234809036362,135,3.9000000000000037E-4
1,test_20231101_140107,10404007.png,502730,11982,490748,0.976166132914288,2,3,61265,1754,59511,0.9713702766669388,26.782478222222224,3724.0032213333334,12.420703128854885,135,4.000000000000004E-4
2,test_20231101_140107,1254659.png,342646,55142,287504,0.8390700606456809,3,4,80080,7773,72307,0.9029345654345654,23.363356444444445,3981.192138666667,12.13067223035364,135,4.000000000000004E-4
3,test_20231101_140107,10188041.png,221231,7197,214034,0.9674683927659324,2,3,41731,1021,40710,0.9755337758500875,12.409082666666666,1482.392304,16.42117209237998,135,4.000000000000004E-4
4,test_20231101_140107,10287332.png,216980,9832,207148,0.9546870679325283,1,4,22337,1355,20982,0.9393383175896495,10.154837333333333,1008.1934186666666,18.095365027648654,135,4.000000000000004E-4
5,test_20231101_140107,11610969.png,368720,13662,355058,0.9629474940334128,2,12,84111,2025,82086,0.9759246709705033,35.46244266666667,6281.286944,10.150317274145863,135,4.000000000000004E-4
6,test_20231101_140107,10350842.png,212614,3329,209285,0.9843425174259456,2,3,42529,490,42039,0.9884784499988243,22.883356444444445,3250.8236266666668,13.010869533660298,135,4.000000000000004E-4
7,test_20231101_140107,10863862.png,317432,5752,311680,0.9818795836588624,1,3,66058,845,65213,0.9872082109661207,36.77768711111111,6782.79896,9.81671415962192,135,4.000000000000004E-4
8,test_20231101_140107,11382381.png,312486,527,311959,0.9983135244458952,1,4,46745,69,46676,0.9985239063001391,22.832848,2745.811376,13.744096608790418,135,4.000000000000004E-4
9,test_20231101_140107,11079715.png,443815,94754,349061,0.7865011322285187,4,4,124136,13324,110812,0.8926661081394599,18.728499555555555,2605.7314826666666,13.97150700682634,135,4.000000000000004E-4
10,test_20231101_140107,11551286.png,271883,164,271719,0.9993967993585476,2,3,40092,22,40070,0.9994512620971765,18.120286222222223,1899.5769013333334,15.344234809036362,135,4.000000000000004E-4
1,test_20231101_140107,10404007.png,502730,11982,490748,0.976166132914288,2,3,61265,1754,59511,0.9713702766669388,26.782478222222224,3724.0032213333334,12.420703128854885,135,4.100000000000004E-4
2,test_20231101_140107,1254659.png,342646,55142,287504,0.8390700606456809,3,4,80080,7773,72307,0.9029345654345654,23.363356444444445,3981.192138666667,12.13067223035364,135,4.100000000000004E-4
3,test_20231101_140107,10188041.png,221231,7197,214034,0.9674683927659324,2,4,41731,1021,40710,0.9755337758500875,12.409082666666666,1482.392304,16.42117209237998,135,4.100000000000004E-4
4,test_20231101_140107,10287332.png,216980,9832,207148,0.9546870679325283,1,3,22337,1355,20982,0.9393383175896495,10.154837333333333,1008.1934186666666,18.095365027648654,135,4.100000000000004E-4
5,test_20231101_140107,11610969.png,368720,13662,355058,0.9629474940334128,2,3,84111,2025,82086,0.9759246709705033,35.46244266666667,6281.286944,10.150317274145863,135,4.100000000000004E-4
6,test_20231101_140107,10350842.png,212614,3329,209285,0.9843425174259456,2,3,42529,490,42039,0.9884784499988243,22.883356444444445,3250.8236266666668,13.010869533660298,135,4.100000000000004E-4
7,test_20231101_140107,10863862.png,317432,5752,311680,0.9818795836588624,2,3,66058,845,65213,0.9872082109661207,36.77768711111111,6782.79896,9.81671415962192,135,4.100000000000004E-4
8,test_20231101_140107,11382381.png,312486,527,311959,0.9983135244458952,2,3,46745,69,46676,0.9985239063001391,22.832848,2745.811376,13.744096608790418,135,4.100000000000004E-4
9,test_20231101_140107,11079715.png,443815,94754,349061,0.7865011322285187,3,5,124136,13324,110812,0.8926661081394599,18.728499555555555,2605.7314826666666,13.97150700682634,135,4.100000000000004E-4
10,test_20231101_140107,11551286.png,271883,164,271719,0.9993967993585476,1,4,40092,22,40070,0.9994512620971765,18.120286222222223,1899.5769013333334,15.344234809036362,135,4.100000000000004E-4
1,test_20231101_140108,10404007.png,502730,11982,490748,0.976166132914288,2,4,61265,1754,59511,0.9713702766669388,26.782478222222224,3724.0032213333334,12.420703128854885,135,4.2000000000000045E-4
2,test_20231101_140108,1254659.png,342646,55142,287504,0.8390700606456809,3,4,80080,7773,72307,0.9029345654345654,23.363356444444445,3981.192138666667,12.13067223035364,135,4.2000000000000045E-4
3,test_20231101_140108,10188041.png,221231,7197,214034,0.9674683927659324,2,4,41731,1021,40710,0.9755337758500875,12.409082666666666,1482.392304,16.42117209237998,135,4.2000000000000045E-4
4,test_20231101_140108,10287332.png,216980,9832,207148,0.9546870679325283,2,4,22337,1355,20982,0.9393383175896495,10.154837333333333,1008.1934186666666,18.095365027648654,135,4.2000000000000045E-4
5,test_20231101_140108,11610969.png,368720,13662,355058,0.9629474940334128,2,3,84111,2025,82086,0.9759246709705033,35.46244266666667,6281.286944,10.150317274145863,135,4.2000000000000045E-4
6,test_20231101_140108,10350842.png,212614,3329,209285,0.9843425174259456,1,4,42529,490,42039,0.9884784499988243,22.883356444444445,3250.8236266666668,13.010869533660298,135,4.2000000000000045E-4
7,test_20231101_140108,10863862.png,317432,5752,311680,0.9818795836588624,1,3,66058,845,65213,0.9872082109661207,36.77768711111111,6782.79896,9.81671415962192,135,4.2000000000000045E-4
8,test_20231101_140108,11382381.png,312486,527,311959,0.9983135244458952,1,4,46745,69,46676,0.9985239063001391,22.832848,2745.811376,13.744096608790418,135,4.2000000000000045E-4
9,test_20231101_140108,11079715.png,443815,94754,349061,0.7865011322285187,3,4,124136,13324,110812,0.8926661081394599,18.728499555555555,2605.7314826666666,13.97150700682634,135,4.2000000000000045E-4
10,test_20231101_140108,11551286.png,271883,164,271719,0.9993967993585476,2,3,40092,22,40070,0.9994512620971765,18.120286222222223,1899.5769013333334,15.344234809036362,135,4.2000000000000045E-4
1,test_20231101_140109,10404007.png,502730,11982,490748,0.976166132914288,2,7,61265,1754,59511,0.9713702766669388,26.782478222222224,3724.0032213333334,12.420703128854885,135,4.300000000000005E-4
2,test_20231101_140109,1254659.png,342646,55142,287504,0.8390700606456809,3,4,80080,7773,72307,0.9029345654345654,23.363356444444445,3981.192138666667,12.13067223035364,135,4.300000000000005E-4
3,test_20231101_140109,10188041.png,221231,7197,214034,0.9674683927659324,1,4,41731,1021,40710,0.9755337758500875,12.409082666666666,1482.392304,16.42117209237998,135,4.300000000000005E-4
4,test_20231101_140109,10287332.png,216980,9832,207148,0.9546870679325283,1,3,22337,1355,20982,0.9393383175896495,10.154837333333333,1008.1934186666666,18.095365027648654,135,4.300000000000005E-4
5,test_20231101_140109,11610969.png,368720,13662,355058,0.9629474940334128,2,4,84111,2025,82086,0.9759246709705033,35.46244266666667,6281.286944,10.150317274145863,135,4.300000000000005E-4
6,test_20231101_140109,10350842.png,212614,3329,209285,0.9843425174259456,2,3,42529,490,42039,0.9884784499988243,22.883356444444445,3250.8236266666668,13.010869533660298,135,4.300000000000005E-4
7,test_20231101_140109,10863862.png,317432,5752,311680,0.9818795836588624,2,4,66058,845,65213,0.9872082109661207,36.77768711111111,6782.79896,9.81671415962192,135,4.300000000000005E-4
8,test_20231101_140109,11382381.png,312486,527,311959,0.9983135244458952,1,4,46745,69,46676,0.9985239063001391,22.832848,2745.811376,13.744096608790418,135,4.300000000000005E-4
9,test_20231101_140109,11079715.png,443815,94754,349061,0.7865011322285187,4,4,124136,13324,110812,0.8926661081394599,18.728499555555555,2605.7314826666666,13.97150700682634,135,4.300000000000005E-4
10,test_20231101_140109,11551286.png,271883,164,271719,0.9993967993585476,2,3,40092,22,40070,0.9994512620971765,18.120286222222223,1899.5769013333334,15.344234809036362,135,4.300000000000005E-4
1,test_20231101_140109,10404007.png,502730,11982,490748,0.976166132914288,2,4,61265,1754,59511,0.9713702766669388,26.782478222222224,3724.0032213333334,12.420703128854885,135,4.400000000000005E-4
2,test_20231101_140109,1254659.png,342646,55142,287504,0.8390700606456809,2,3,80080,7773,72307,0.9029345654345654,23.363356444444445,3981.192138666667,12.13067223035364,135,4.400000000000005E-4
3,test_20231101_140109,10188041.png,221231,7197,214034,0.9674683927659324,2,3,41731,1021,40710,0.9755337758500875,12.409082666666666,1482.392304,16.42117209237998,135,4.400000000000005E-4
4,test_20231101_140109,10287332.png,216980,9832,207148,0.9546870679325283,2,3,22337,1355,20982,0.9393383175896495,10.154837333333333,1008.1934186666666,18.095365027648654,135,4.400000000000005E-4
5,test_20231101_140109,11610969.png,368720,13662,355058,0.9629474940334128,1,3,84111,2025,82086,0.9759246709705033,35.46244266666667,6281.286944,10.150317274145863,135,4.400000000000005E-4
6,test_20231101_140109,10350842.png,212614,3329,209285,0.9843425174259456,1,3,42529,490,42039,0.9884784499988243,22.883356444444445,3250.8236266666668,13.010869533660298,135,4.400000000000005E-4
7,test_20231101_140109,10863862.png,317432,5752,311680,0.9818795836588624,2,3,66058,845,65213,0.9872082109661207,36.77768711111111,6782.79896,9.81671415962192,135,4.400000000000005E-4
8,test_20231101_140109,11382381.png,312486,527,311959,0.9983135244458952,1,3,46745,69,46676,0.9985239063001391,22.832848,2745.811376,13.744096608790418,135,4.400000000000005E-4
9,test_20231101_140109,11079715.png,443815,94754,349061,0.7865011322285187,4,4,124136,13324,110812,0.8926661081394599,18.728499555555555,2605.7314826666666,13.97150700682634,135,4.400000000000005E-4
10,test_20231101_140109,11551286.png,271883,164,271719,0.9993967993585476,2,3,40092,22,40070,0.9994512620971765,18.120286222222223,1899.5769013333334,15.344234809036362,135,4.400000000000005E-4
1,test_20231101_140110,10404007.png,502730,11862,490868,0.976404829630219,2,4,61265,1736,59529,0.9716640822655677,26.797180444444443,3727.662016,12.416438325186887,135,4.5000000000000053E-4
2,test_20231101_140110,1254659.png,342646,55142,287504,0.8390700606456809,2,3,80080,7773,72307,0.9029345654345654,23.363356444444445,3981.192138666667,12.13067223035364,135,4.5000000000000053E-4
3,test_20231101_140110,10188041.png,221231,7197,214034,0.9674683927659324,2,4,41731,1021,40710,0.9755337758500875,12.409082666666666,1482.392304,16.42117209237998,135,4.5000000000000053E-4
4,test_20231101_140110,10287332.png,216980,9832,207148,0.9546870679325283,2,3,22337,1355,20982,0.9393383175896495,10.154837333333333,1008.1934186666666,18.095365027648654,135,4.5000000000000053E-4
5,test_20231101_140110,11610969.png,368720,13662,355058,0.9629474940334128,2,7,84111,2025,82086,0.9759246709705033,35.46244266666667,6281.286944,10.150317274145863,135,4.5000000000000053E-4
6,test_20231101_140110,10350842.png,212614,3329,209285,0.9843425174259456,1,4,42529,490,42039,0.9884784499988243,22.883356444444445,3250.8236266666668,13.010869533660298,135,4.5000000000000053E-4
7,test_20231101_140110,10863862.png,317432,5752,311680,0.9818795836588624,1,3,66058,845,65213,0.9872082109661207,36.77768711111111,6782.79896,9.81671415962192,135,4.5000000000000053E-4
8,test_20231101_140110,11382381.png,312486,527,311959,0.9983135244458952,1,4,46745,69,46676,0.9985239063001391,22.832848,2745.811376,13.744096608790418,135,4.5000000000000053E-4
9,test_20231101_140110,11079715.png,443815,94754,349061,0.7865011322285187,3,4,124136,13324,110812,0.8926661081394599,18.728499555555555,2605.7314826666666,13.97150700682634,135,4.5000000000000053E-4
10,test_20231101_140110,11551286.png,271883,164,271719,0.9993967993585476,2,3,40092,22,40070,0.9994512620971765,18.120286222222223,1899.5769013333334,15.344234809036362,135,4.5000000000000053E-4
1,test_20231101_140111,10404007.png,502730,11862,490868,0.976404829630219,2,4,61265,1736,59529,0.9716640822655677,26.797180444444443,3727.662016,12.416438325186887,135,4.6000000000000056E-4
2,test_20231101_140111,1254659.png,342646,55142,287504,0.8390700606456809,3,4,80080,7773,72307,0.9029345654345654,23.363356444444445,3981.192138666667,12.13067223035364,135,4.6000000000000056E-4
3,test_20231101_140111,10188041.png,221231,7197,214034,0.9674683927659324,1,3,41731,1021,40710,0.9755337758500875,12.409082666666666,1482.392304,16.42117209237998,135,4.6000000000000056E-4
4,test_20231101_140111,10287332.png,216980,9832,207148,0.9546870679325283,2,4,22337,1355,20982,0.9393383175896495,10.154837333333333,1008.1934186666666,18.095365027648654,135,4.6000000000000056E-4
5,test_20231101_140111,11610969.png,368720,13662,355058,0.9629474940334128,2,4,84111,2025,82086,0.9759246709705033,35.46244266666667,6281.286944,10.150317274145863,135,4.6000000000000056E-4
6,test_20231101_140111,10350842.png,212614,3329,209285,0.9843425174259456,2,3,42529,490,42039,0.9884784499988243,22.883356444444445,3250.8236266666668,13.010869533660298,135,4.6000000000000056E-4
7,test_20231101_140111,10863862.png,317432,5752,311680,0.9818795836588624,2,4,66058,845,65213,0.9872082109661207,36.77768711111111,6782.79896,9.81671415962192,135,4.6000000000000056E-4
8,test_20231101_140111,11382381.png,312486,527,311959,0.9983135244458952,1,3,46745,69,46676,0.9985239063001391,22.832848,2745.811376,13.744096608790418,135,4.6000000000000056E-4
9,test_20231101_140111,11079715.png,443815,94754,349061,0.7865011322285187,3,4,124136,13324,110812,0.8926661081394599,18.728499555555555,2605.7314826666666,13.97150700682634,135,4.6000000000000056E-4
10,test_20231101_140111,11551286.png,271883,164,271719,0.9993967993585476,2,3,40092,22,40070,0.9994512620971765,18.120286222222223,1899.5769013333334,15.344234809036362,135,4.6000000000000056E-4
1,test_20231101_140111,10404007.png,502730,11862,490868,0.976404829630219,2,3,61265,1736,59529,0.9716640822655677,26.797180444444443,3727.662016,12.416438325186887,135,4.700000000000006E-4
2,test_20231101_140111,1254659.png,342646,55142,287504,0.8390700606456809,2,4,80080,7773,72307,0.9029345654345654,23.363356444444445,3981.192138666667,12.13067223035364,135,4.700000000000006E-4
3,test_20231101_140111,10188041.png,221231,7197,214034,0.9674683927659324,2,4,41731,1021,40710,0.9755337758500875,12.409082666666666,1482.392304,16.42117209237998,135,4.700000000000006E-4
4,test_20231101_140111,10287332.png,216980,9832,207148,0.9546870679325283,2,4,22337,1355,20982,0.9393383175896495,10.154837333333333,1008.1934186666666,18.095365027648654,135,4.700000000000006E-4
5,test_20231101_140111,11610969.png,368720,13662,355058,0.9629474940334128,2,3,84111,2025,82086,0.9759246709705033,35.46244266666667,6281.286944,10.150317274145863,135,4.700000000000006E-4
6,test_20231101_140111,10350842.png,212614,3329,209285,0.9843425174259456,2,3,42529,490,42039,0.9884784499988243,22.883356444444445,3250.8236266666668,13.010869533660298,135,4.700000000000006E-4
7,test_20231101_140111,10863862.png,317432,5752,311680,0.9818795836588624,1,4,66058,845,65213,0.9872082109661207,36.77768711111111,6782.79896,9.81671415962192,135,4.700000000000006E-4
8,test_20231101_140111,11382381.png,312486,527,311959,0.9983135244458952,2,3,46745,69,46676,0.9985239063001391,22.832848,2745.811376,13.744096608790418,135,4.700000000000006E-4
9,test_20231101_140111,11079715.png,443815,94754,349061,0.7865011322285187,3,5,124136,13324,110812,0.8926661081394599,18.728499555555555,2605.7314826666666,13.97150700682634,135,4.700000000000006E-4
10,test_20231101_140111,11551286.png,271883,164,271719,0.9993967993585476,1,3,40092,22,40070,0.9994512620971765,18.120286222222223,1899.5769013333334,15.344234809036362,135,4.700000000000006E-4
1,test_20231101_140112,10404007.png,502730,11862,490868,0.976404829630219,2,4,61265,1736,59529,0.9716640822655677,26.797180444444443,3727.662016,12.416438325186887,135,4.800000000000006E-4
2,test_20231101_140112,1254659.png,342646,55142,287504,0.8390700606456809,3,4,80080,7773,72307,0.9029345654345654,23.363356444444445,3981.192138666667,12.13067223035364,135,4.800000000000006E-4
3,test_20231101_140112,10188041.png,221231,7197,214034,0.9674683927659324,2,3,41731,1021,40710,0.9755337758500875,12.409082666666666,1482.392304,16.42117209237998,135,4.800000000000006E-4
4,test_20231101_140112,10287332.png,216980,9832,207148,0.9546870679325283,3,4,22337,1355,20982,0.9393383175896495,10.154837333333333,1008.1934186666666,18.095365027648654,135,4.800000000000006E-4
5,test_20231101_140112,11610969.png,368720,13662,355058,0.9629474940334128,2,3,84111,2025,82086,0.9759246709705033,35.46244266666667,6281.286944,10.150317274145863,135,4.800000000000006E-4
6,test_20231101_140112,10350842.png,212614,3329,209285,0.9843425174259456,2,4,42529,490,42039,0.9884784499988243,22.883356444444445,3250.8236266666668,13.010869533660298,135,4.800000000000006E-4
7,test_20231101_140112,10863862.png,317432,5752,311680,0.9818795836588624,1,3,66058,845,65213,0.9872082109661207,36.77768711111111,6782.79896,9.81671415962192,135,4.800000000000006E-4
8,test_20231101_140112,11382381.png,312486,527,311959,0.9983135244458952,1,3,46745,69,46676,0.9985239063001391,22.832848,2745.811376,13.744096608790418,135,4.800000000000006E-4
9,test_20231101_140112,11079715.png,443815,94754,349061,0.7865011322285187,3,4,124136,13324,110812,0.8926661081394599,18.728499555555555,2605.7314826666666,13.97150700682634,135,4.800000000000006E-4
10,test_20231101_140112,11551286.png,271883,164,271719,0.9993967993585476,2,3,40092,22,40070,0.9994512620971765,18.120286222222223,1899.5769013333334,15.344234809036362,135,4.800000000000006E-4
1,test_20231101_140113,10404007.png,502730,11862,490868,0.976404829630219,3,3,61265,1736,59529,0.9716640822655677,26.797180444444443,3727.662016,12.416438325186887,135,4.900000000000006E-4
2,test_20231101_140113,1254659.png,342646,55142,287504,0.8390700606456809,3,4,80080,7773,72307,0.9029345654345654,23.363356444444445,3981.192138666667,12.13067223035364,135,4.900000000000006E-4
3,test_20231101_140113,10188041.png,221231,7197,214034,0.9674683927659324,2,4,41731,1021,40710,0.9755337758500875,12.409082666666666,1482.392304,16.42117209237998,135,4.900000000000006E-4
4,test_20231101_140113,10287332.png,216980,9832,207148,0.9546870679325283,1,3,22337,1355,20982,0.9393383175896495,10.154837333333333,1008.1934186666666,18.095365027648654,135,4.900000000000006E-4
5,test_20231101_140113,11610969.png,368720,13662,355058,0.9629474940334128,1,3,84111,2025,82086,0.9759246709705033,35.46244266666667,6281.286944,10.150317274145863,135,4.900000000000006E-4
6,test_20231101_140113,10350842.png,212614,3329,209285,0.9843425174259456,1,3,42529,490,42039,0.9884784499988243,22.883356444444445,3250.8236266666668,13.010869533660298,135,4.900000000000006E-4
7,test_20231101_140113,10863862.png,317432,5752,311680,0.9818795836588624,2,3,66058,845,65213,0.9872082109661207,36.77768711111111,6782.79896,9.81671415962192,135,4.900000000000006E-4
8,test_20231101_140113,11382381.png,312486,527,311959,0.9983135244458952,1,4,46745,69,46676,0.9985239063001391,22.832848,2745.811376,13.744096608790418,135,4.900000000000006E-4
9,test_20231101_140113,11079715.png,443815,94754,349061,0.7865011322285187,3,4,124136,13324,110812,0.8926661081394599,18.728499555555555,2605.7314826666666,13.97150700682634,135,4.900000000000006E-4
10,test_20231101_140113,11551286.png,271883,164,271719,0.9993967993585476,1,4,40092,22,40070,0.9994512620971765,18.120286222222223,1899.5769013333334,15.344234809036362,135,4.900000000000006E-4
1,test_20231101_140113,10404007.png,502730,11862,490868,0.976404829630219,2,3,61265,1736,59529,0.9716640822655677,26.797180444444443,3727.662016,12.416438325186887,135,5.000000000000007E-4
2,test_20231101_140113,1254659.png,342646,55142,287504,0.8390700606456809,3,4,80080,7773,72307,0.9029345654345654,23.363356444444445,3981.192138666667,12.13067223035364,135,5.000000000000007E-4
3,test_20231101_140113,10188041.png,221231,7197,214034,0.9674683927659324,2,3,41731,1021,40710,0.9755337758500875,12.409082666666666,1482.392304,16.42117209237998,135,5.000000000000007E-4
4,test_20231101_140113,10287332.png,216980,9832,207148,0.9546870679325283,2,4,22337,1355,20982,0.9393383175896495,10.154837333333333,1008.1934186666666,18.095365027648654,135,5.000000000000007E-4
5,test_20231101_140113,11610969.png,368720,13662,355058,0.9629474940334128,2,4,84111,2025,82086,0.9759246709705033,35.46244266666667,6281.286944,10.150317274145863,135,5.000000000000007E-4
6,test_20231101_140113,10350842.png,212614,3329,209285,0.9843425174259456,2,3,42529,490,42039,0.9884784499988243,22.883356444444445,3250.8236266666668,13.010869533660298,135,5.000000000000007E-4
7,test_20231101_140113,10863862.png,317432,5752,311680,0.9818795836588624,2,5,66058,845,65213,0.9872082109661207,36.77768711111111,6782.79896,9.81671415962192,135,5.000000000000007E-4
8,test_20231101_140113,11382381.png,312486,527,311959,0.9983135244458952,1,3,46745,69,46676,0.9985239063001391,22.832848,2745.811376,13.744096608790418,135,5.000000000000007E-4
9,test_20231101_140113,11079715.png,443815,94754,349061,0.7865011322285187,3,4,124136,13324,110812,0.8926661081394599,18.728499555555555,2605.7314826666666,13.97150700682634,135,5.000000000000007E-4
10,test_20231101_140113,11551286.png,271883,164,271719,0.9993967993585476,1,4,40092,22,40070,0.9994512620971765,18.120286222222223,1899.5769013333334,15.344234809036362,135,5.000000000000007E-4
1,test_20231101_140114,10404007.png,502730,11862,490868,0.976404829630219,2,4,61265,1736,59529,0.9716640822655677,26.797180444444443,3727.662016,12.416438325186887,135,5.100000000000007E-4
2,test_20231101_140114,1254659.png,342646,55142,287504,0.8390700606456809,4,4,80080,7773,72307,0.9029345654345654,23.363356444444445,3981.192138666667,12.13067223035364,135,5.100000000000007E-4
3,test_20231101_140114,10188041.png,221231,7197,214034,0.9674683927659324,2,3,41731,1021,40710,0.9755337758500875,12.409082666666666,1482.392304,16.42117209237998,135,5.100000000000007E-4
4,test_20231101_140114,10287332.png,216980,9832,207148,0.9546870679325283,2,4,22337,1355,20982,0.9393383175896495,10.154837333333333,1008.1934186666666,18.095365027648654,135,5.100000000000007E-4
5,test_20231101_140114,11610969.png,368720,13662,355058,0.9629474940334128,2,4,84111,2025,82086,0.9759246709705033,35.46244266666667,6281.286944,10.150317274145863,135,5.100000000000007E-4
6,test_20231101_140114,10350842.png,212614,3329,209285,0.9843425174259456,1,4,42529,490,42039,0.9884784499988243,22.883356444444445,3250.8236266666668,13.010869533660298,135,5.100000000000007E-4
7,test_20231101_140114,10863862.png,317432,5712,311720,0.982005594899065,2,4,66058,839,65219,0.9872990402373671,36.955265777777775,6853.766906666667,9.771510306704478,135,5.100000000000007E-4
8,test_20231101_140114,11382381.png,312486,527,311959,0.9983135244458952,1,4,46745,69,46676,0.9985239063001391,22.832848,2745.811376,13.744096608790418,135,5.100000000000007E-4
9,test_20231101_140114,11079715.png,443815,94572,349243,0.7869112130054189,3,4,124136,13297,110839,0.8928836115228459,18.965763555555554,2647.7406186666667,13.902049229247469,135,5.100000000000007E-4
10,test_20231101_140114,11551286.png,271883,164,271719,0.9993967993585476,2,3,40092,22,40070,0.9994512620971765,18.120286222222223,1899.5769013333334,15.344234809036362,135,5.100000000000007E-4
1,test_20231101_140115,10404007.png,502730,11862,490868,0.976404829630219,3,3,61265,1736,59529,0.9716640822655677,26.797180444444443,3727.662016,12.416438325186887,135,5.200000000000007E-4
2,test_20231101_140115,1254659.png,342646,55142,287504,0.8390700606456809,3,3,80080,7773,72307,0.9029345654345654,23.363356444444445,3981.192138666667,12.13067223035364,135,5.200000000000007E-4
3,test_20231101_140115,10188041.png,221231,7197,214034,0.9674683927659324,2,3,41731,1021,40710,0.9755337758500875,12.409082666666666,1482.392304,16.42117209237998,135,5.200000000000007E-4
4,test_20231101_140115,10287332.png,216980,9832,207148,0.9546870679325283,2,3,22337,1355,20982,0.9393383175896495,10.154837333333333,1008.1934186666666,18.095365027648654,135,5.200000000000007E-4
5,test_20231101_140115,11610969.png,368720,13662,355058,0.9629474940334128,2,4,84111,2025,82086,0.9759246709705033,35.46244266666667,6281.286944,10.150317274145863,135,5.200000000000007E-4
6,test_20231101_140115,10350842.png,212614,2627,209987,0.9876442755415918,1,3,42529,386,42143,0.9909238402031555,25.61189511111111,3910.4018613333333,12.208589699192402,135,5.200000000000007E-4
7,test_20231101_140115,10863862.png,317432,5712,311720,0.982005594899065,2,3,66058,839,65219,0.9872990402373671,36.955265777777775,6853.766906666667,9.771510306704478,135,5.200000000000007E-4
8,test_20231101_140115,11382381.png,312486,527,311959,0.9983135244458952,2,3,46745,69,46676,0.9985239063001391,22.832848,2745.811376,13.744096608790418,135,5.200000000000007E-4
9,test_20231101_140115,11079715.png,443815,94572,349243,0.7869112130054189,4,4,124136,13297,110839,0.8928836115228459,18.965763555555554,2647.7406186666667,13.902049229247469,135,5.200000000000007E-4
10,test_20231101_140115,11551286.png,271883,164,271719,0.9993967993585476,2,3,40092,22,40070,0.9994512620971765,18.120286222222223,1899.5769013333334,15.344234809036362,135,5.200000000000007E-4
1,test_20231101_140115,10404007.png,502730,11862,490868,0.976404829630219,2,4,61265,1736,59529,0.9716640822655677,26.797180444444443,3727.662016,12.416438325186887,135,5.300000000000007E-4
2,test_20231101_140115,1254659.png,342646,55142,287504,0.8390700606456809,3,4,80080,7773,72307,0.9029345654345654,23.363356444444445,3981.192138666667,12.13067223035364,135,5.300000000000007E-4
3,test_20231101_140115,10188041.png,221231,7197,214034,0.9674683927659324,2,3,41731,1021,40710,0.9755337758500875,12.409082666666666,1482.392304,16.42117209237998,135,5.300000000000007E-4
4,test_20231101_140115,10287332.png,216980,9832,207148,0.9546870679325283,1,3,22337,1355,20982,0.9393383175896495,10.154837333333333,1008.1934186666666,18.095365027648654,135,5.300000000000007E-4
5,test_20231101_140115,11610969.png,368720,13662,355058,0.9629474940334128,2,3,84111,2025,82086,0.9759246709705033,35.46244266666667,6281.286944,10.150317274145863,135,5.300000000000007E-4
6,test_20231101_140115,10350842.png,212614,2627,209987,0.9876442755415918,1,3,42529,386,42143,0.9909238402031555,25.61189511111111,3910.4018613333333,12.208589699192402,135,5.300000000000007E-4
7,test_20231101_140115,10863862.png,317432,5712,311720,0.982005594899065,2,3,66058,839,65219,0.9872990402373671,36.955265777777775,6853.766906666667,9.771510306704478,135,5.300000000000007E-4
8,test_20231101_140115,11382381.png,312486,527,311959,0.9983135244458952,1,3,46745,69,46676,0.9985239063001391,22.832848,2745.811376,13.744096608790418,135,5.300000000000007E-4
9,test_20231101_140115,11079715.png,443815,94572,349243,0.7869112130054189,3,4,124136,13297,110839,0.8928836115228459,18.965763555555554,2647.7406186666667,13.902049229247469,135,5.300000000000007E-4
10,test_20231101_140115,11551286.png,271883,164,271719,0.9993967993585476,2,11,40092,22,40070,0.9994512620971765,18.120286222222223,1899.5769013333334,15.344234809036362,135,5.300000000000007E-4
1,test_20231101_140116,10404007.png,502730,11862,490868,0.976404829630219,2,4,61265,1736,59529,0.9716640822655677,26.797180444444443,3727.662016,12.416438325186887,135,5.400000000000008E-4
2,test_20231101_140116,1254659.png,342646,55142,287504,0.8390700606456809,3,4,80080,7773,72307,0.9029345654345654,23.363356444444445,3981.192138666667,12.13067223035364,135,5.400000000000008E-4
3,test_20231101_140116,10188041.png,221231,7197,214034,0.9674683927659324,3,3,41731,1021,40710,0.9755337758500875,12.409082666666666,1482.392304,16.42117209237998,135,5.400000000000008E-4
4,test_20231101_140116,10287332.png,216980,9832,207148,0.9546870679325283,2,4,22337,1355,20982,0.9393383175896495,10.154837333333333,1008.1934186666666,18.095365027648654,135,5.400000000000008E-4
5,test_20231101_140116,11610969.png,368720,13662,355058,0.9629474940334128,2,4,84111,2025,82086,0.9759246709705033,35.46244266666667,6281.286944,10.150317274145863,135,5.400000000000008E-4
6,test_20231101_140116,10350842.png,212614,2627,209987,0.9876442755415918,1,3,42529,386,42143,0.9909238402031555,25.61189511111111,3910.4018613333333,12.208589699192402,135,5.400000000000008E-4
7,test_20231101_140116,10863862.png,317432,5712,311720,0.982005594899065,1,3,66058,839,65219,0.9872990402373671,36.955265777777775,6853.766906666667,9.771510306704478,135,5.400000000000008E-4
8,test_20231101_140116,11382381.png,312486,527,311959,0.9983135244458952,1,4,46745,69,46676,0.9985239063001391,22.832848,2745.811376,13.744096608790418,135,5.400000000000008E-4
9,test_20231101_140116,11079715.png,443815,94572,349243,0.7869112130054189,4,5,124136,13297,110839,0.8928836115228459,18.965763555555554,2647.7406186666667,13.902049229247469,135,5.400000000000008E-4
10,test_20231101_140116,11551286.png,271883,164,271719,0.9993967993585476,1,3,40092,22,40070,0.9994512620971765,18.120286222222223,1899.5769013333334,15.344234809036362,135,5.400000000000008E-4
1,test_20231101_140117,10404007.png,502730,11862,490868,0.976404829630219,2,3,61265,1736,59529,0.9716640822655677,26.797180444444443,3727.662016,12.416438325186887,135,5.500000000000008E-4
2,test_20231101_140117,1254659.png,342646,55142,287504,0.8390700606456809,3,4,80080,7773,72307,0.9029345654345654,23.363356444444445,3981.192138666667,12.13067223035364,135,5.500000000000008E-4
3,test_20231101_140117,10188041.png,221231,7197,214034,0.9674683927659324,2,3,41731,1021,40710,0.9755337758500875,12.409082666666666,1482.392304,16.42117209237998,135,5.500000000000008E-4
4,test_20231101_140117,10287332.png,216980,9832,207148,0.9546870679325283,2,4,22337,1355,20982,0.9393383175896495,10.154837333333333,1008.1934186666666,18.095365027648654,135,5.500000000000008E-4
5,test_20231101_140117,11610969.png,368720,13662,355058,0.9629474940334128,2,4,84111,2025,82086,0.9759246709705033,35.46244266666667,6281.286944,10.150317274145863,135,5.500000000000008E-4
6,test_20231101_140117,10350842.png,212614,2627,209987,0.9876442755415918,2,3,42529,386,42143,0.9909238402031555,25.61189511111111,3910.4018613333333,12.208589699192402,135,5.500000000000008E-4
7,test_20231101_140117,10863862.png,317432,5712,311720,0.982005594899065,2,3,66058,839,65219,0.9872990402373671,36.955265777777775,6853.766906666667,9.771510306704478,135,5.500000000000008E-4
8,test_20231101_140117,11382381.png,312486,527,311959,0.9983135244458952,1,4,46745,69,46676,0.9985239063001391,22.832848,2745.811376,13.744096608790418,135,5.500000000000008E-4
9,test_20231101_140117,11079715.png,443815,94572,349243,0.7869112130054189,3,4,124136,13297,110839,0.8928836115228459,18.965763555555554,2647.7406186666667,13.902049229247469,135,5.500000000000008E-4
10,test_20231101_140117,11551286.png,271883,164,271719,0.9993967993585476,1,4,40092,22,40070,0.9994512620971765,18.120286222222223,1899.5769013333334,15.344234809036362,135,5.500000000000008E-4
1,test_20231101_140117,10404007.png,502730,11862,490868,0.976404829630219,2,3,61265,1736,59529,0.9716640822655677,26.797180444444443,3727.662016,12.416438325186887,135,5.600000000000008E-4
2,test_20231101_140117,1254659.png,342646,55142,287504,0.8390700606456809,2,3,80080,7773,72307,0.9029345654345654,23.363356444444445,3981.192138666667,12.13067223035364,135,5.600000000000008E-4
3,test_20231101_140117,10188041.png,221231,7197,214034,0.9674683927659324,2,3,41731,1021,40710,0.9755337758500875,12.409082666666666,1482.392304,16.42117209237998,135,5.600000000000008E-4
4,test_20231101_140117,10287332.png,216980,9832,207148,0.9546870679325283,1,4,22337,1355,20982,0.9393383175896495,10.154837333333333,1008.1934186666666,18.095365027648654,135,5.600000000000008E-4
5,test_20231101_140117,11610969.png,368720,13662,355058,0.9629474940334128,1,3,84111,2025,82086,0.9759246709705033,35.46244266666667,6281.286944,10.150317274145863,135,5.600000000000008E-4
6,test_20231101_140117,10350842.png,212614,2627,209987,0.9876442755415918,1,3,42529,386,42143,0.9909238402031555,25.61189511111111,3910.4018613333333,12.208589699192402,135,5.600000000000008E-4
7,test_20231101_140117,10863862.png,317432,5712,311720,0.982005594899065,2,4,66058,839,65219,0.9872990402373671,36.955265777777775,6853.766906666667,9.771510306704478,135,5.600000000000008E-4
8,test_20231101_140117,11382381.png,312486,527,311959,0.9983135244458952,1,3,46745,69,46676,0.9985239063001391,22.832848,2745.811376,13.744096608790418,135,5.600000000000008E-4
9,test_20231101_140117,11079715.png,443815,94572,349243,0.7869112130054189,3,4,124136,13297,110839,0.8928836115228459,18.965763555555554,2647.7406186666667,13.902049229247469,135,5.600000000000008E-4
10,test_20231101_140117,11551286.png,271883,164,271719,0.9993967993585476,1,4,40092,22,40070,0.9994512620971765,18.120286222222223,1899.5769013333334,15.344234809036362,135,5.600000000000008E-4
1,test_20231101_140118,10404007.png,502730,11862,490868,0.976404829630219,2,4,61265,1736,59529,0.9716640822655677,26.797180444444443,3727.662016,12.416438325186887,135,5.700000000000008E-4
2,test_20231101_140118,1254659.png,342646,55142,287504,0.8390700606456809,3,4,80080,7773,72307,0.9029345654345654,23.363356444444445,3981.192138666667,12.13067223035364,135,5.700000000000008E-4
3,test_20231101_140118,10188041.png,221231,7197,214034,0.9674683927659324,1,3,41731,1021,40710,0.9755337758500875,12.409082666666666,1482.392304,16.42117209237998,135,5.700000000000008E-4
4,test_20231101_140118,10287332.png,216980,9832,207148,0.9546870679325283,2,4,22337,1355,20982,0.9393383175896495,10.154837333333333,1008.1934186666666,18.095365027648654,135,5.700000000000008E-4
5,test_20231101_140118,11610969.png,368720,13662,355058,0.9629474940334128,2,3,84111,2025,82086,0.9759246709705033,35.46244266666667,6281.286944,10.150317274145863,135,5.700000000000008E-4
6,test_20231101_140118,10350842.png,212614,2627,209987,0.9876442755415918,2,3,42529,386,42143,0.9909238402031555,25.61189511111111,3910.4018613333333,12.208589699192402,135,5.700000000000008E-4
7,test_20231101_140118,10863862.png,317432,5712,311720,0.982005594899065,2,4,66058,839,65219,0.9872990402373671,36.955265777777775,6853.766906666667,9.771510306704478,135,5.700000000000008E-4
8,test_20231101_140118,11382381.png,312486,527,311959,0.9983135244458952,2,3,46745,69,46676,0.9985239063001391,22.832848,2745.811376,13.744096608790418,135,5.700000000000008E-4
9,test_20231101_140118,11079715.png,443815,94572,349243,0.7869112130054189,3,4,124136,13297,110839,0.8928836115228459,18.965763555555554,2647.7406186666667,13.902049229247469,135,5.700000000000008E-4
10,test_20231101_140118,11551286.png,271883,164,271719,0.9993967993585476,1,3,40092,22,40070,0.9994512620971765,18.120286222222223,1899.5769013333334,15.344234809036362,135,5.700000000000008E-4
1,test_20231101_140119,10404007.png,502730,11862,490868,0.976404829630219,2,3,61265,1736,59529,0.9716640822655677,26.797180444444443,3727.662016,12.416438325186887,135,5.800000000000009E-4
2,test_20231101_140119,1254659.png,342646,55142,287504,0.8390700606456809,2,3,80080,7773,72307,0.9029345654345654,23.363356444444445,3981.192138666667,12.13067223035364,135,5.800000000000009E-4
3,test_20231101_140119,10188041.png,221231,7117,214114,0.967830005740606,2,3,41731,1011,40720,0.9757734058613501,12.447984,1486.4768053333332,16.409222239124453,135,5.800000000000009E-4
4,test_20231101_140119,10287332.png,216980,9832,207148,0.9546870679325283,1,3,22337,1355,20982,0.9393383175896495,10.154837333333333,1008.1934186666666,18.095365027648654,135,5.800000000000009E-4
5,test_20231101_140119,11610969.png,368720,13662,355058,0.9629474940334128,1,3,84111,2025,82086,0.9759246709705033,35.46244266666667,6281.286944,10.150317274145863,135,5.800000000000009E-4
6,test_20231101_140119,10350842.png,212614,2627,209987,0.9876442755415918,1,3,42529,386,42143,0.9909238402031555,25.61189511111111,3910.4018613333333,12.208589699192402,135,5.800000000000009E-4
7,test_20231101_140119,10863862.png,317432,5712,311720,0.982005594899065,1,3,66058,839,65219,0.9872990402373671,36.955265777777775,6853.766906666667,9.771510306704478,135,5.800000000000009E-4
8,test_20231101_140119,11382381.png,312486,527,311959,0.9983135244458952,1,4,46745,69,46676,0.9985239063001391,22.832848,2745.811376,13.744096608790418,135,5.800000000000009E-4
9,test_20231101_140119,11079715.png,443815,94572,349243,0.7869112130054189,3,10,124136,13297,110839,0.8928836115228459,18.965763555555554,2647.7406186666667,13.902049229247469,135,5.800000000000009E-4
10,test_20231101_140119,11551286.png,271883,164,271719,0.9993967993585476,1,4,40092,22,40070,0.9994512620971765,18.120286222222223,1899.5769013333334,15.344234809036362,135,5.800000000000009E-4
1,test_20231101_140119,10404007.png,502730,11862,490868,0.976404829630219,2,4,61265,1736,59529,0.9716640822655677,26.797180444444443,3727.662016,12.416438325186887,135,5.900000000000009E-4
2,test_20231101_140119,1254659.png,342646,55142,287504,0.8390700606456809,2,3,80080,7773,72307,0.9029345654345654,23.363356444444445,3981.192138666667,12.13067223035364,135,5.900000000000009E-4
3,test_20231101_140119,10188041.png,221231,7117,214114,0.967830005740606,2,3,41731,1011,40720,0.9757734058613501,12.447984,1486.4768053333332,16.409222239124453,135,5.900000000000009E-4
4,test_20231101_140119,10287332.png,216980,9832,207148,0.9546870679325283,1,4,22337,1355,20982,0.9393383175896495,10.154837333333333,1008.1934186666666,18.095365027648654,135,5.900000000000009E-4
5,test_20231101_140119,11610969.png,368720,13662,355058,0.9629474940334128,2,4,84111,2025,82086,0.9759246709705033,35.46244266666667,6281.286944,10.150317274145863,135,5.900000000000009E-4
6,test_20231101_140119,10350842.png,212614,2627,209987,0.9876442755415918,1,4,42529,386,42143,0.9909238402031555,25.61189511111111,3910.4018613333333,12.208589699192402,135,5.900000000000009E-4
7,test_20231101_140119,10863862.png,317432,5712,311720,0.982005594899065,2,3,66058,839,65219,0.9872990402373671,36.955265777777775,6853.766906666667,9.771510306704478,135,5.900000000000009E-4
8,test_20231101_140119,11382381.png,312486,527,311959,0.9983135244458952,2,3,46745,69,46676,0.9985239063001391,22.832848,2745.811376,13.744096608790418,135,5.900000000000009E-4
9,test_20231101_140119,11079715.png,443815,94572,349243,0.7869112130054189,3,5,124136,13297,110839,0.8928836115228459,18.965763555555554,2647.7406186666667,13.902049229247469,135,5.900000000000009E-4
10,test_20231101_140119,11551286.png,271883,164,271719,0.9993967993585476,1,4,40092,22,40070,0.9994512620971765,18.120286222222223,1899.5769013333334,15.344234809036362,135,5.900000000000009E-4
1,test_20231101_140120,10404007.png,502730,11862,490868,0.976404829630219,2,4,61265,1736,59529,0.9716640822655677,26.797180444444443,3727.662016,12.416438325186887,135,6.000000000000009E-4
2,test_20231101_140120,1254659.png,342646,55142,287504,0.8390700606456809,3,4,80080,7773,72307,0.9029345654345654,23.363356444444445,3981.192138666667,12.13067223035364,135,6.000000000000009E-4
3,test_20231101_140120,10188041.png,221231,7117,214114,0.967830005740606,2,3,41731,1011,40720,0.9757734058613501,12.447984,1486.4768053333332,16.409222239124453,135,6.000000000000009E-4
4,test_20231101_140120,10287332.png,216980,9832,207148,0.9546870679325283,1,3,22337,1355,20982,0.9393383175896495,10.154837333333333,1008.1934186666666,18.095365027648654,135,6.000000000000009E-4
5,test_20231101_140120,11610969.png,368720,13662,355058,0.9629474940334128,2,4,84111,2025,82086,0.9759246709705033,35.46244266666667,6281.286944,10.150317274145863,135,6.000000000000009E-4
6,test_20231101_140120,10350842.png,212614,2627,209987,0.9876442755415918,1,4,42529,386,42143,0.9909238402031555,25.61189511111111,3910.4018613333333,12.208589699192402,135,6.000000000000009E-4
7,test_20231101_140120,10863862.png,317432,5712,311720,0.982005594899065,2,3,66058,839,65219,0.9872990402373671,36.955265777777775,6853.766906666667,9.771510306704478,135,6.000000000000009E-4
8,test_20231101_140120,11382381.png,312486,527,311959,0.9983135244458952,2,3,46745,69,46676,0.9985239063001391,22.832848,2745.811376,13.744096608790418,135,6.000000000000009E-4
9,test_20231101_140120,11079715.png,443815,94572,349243,0.7869112130054189,3,4,124136,13297,110839,0.8928836115228459,18.965763555555554,2647.7406186666667,13.902049229247469,135,6.000000000000009E-4
10,test_20231101_140120,11551286.png,271883,164,271719,0.9993967993585476,2,4,40092,22,40070,0.9994512620971765,18.120286222222223,1899.5769013333334,15.344234809036362,135,6.000000000000009E-4
1,test_20231101_140121,10404007.png,502730,11862,490868,0.976404829630219,2,4,61265,1736,59529,0.9716640822655677,26.797180444444443,3727.662016,12.416438325186887,135,6.10000000000001E-4
2,test_20231101_140121,1254659.png,342646,55142,287504,0.8390700606456809,2,4,80080,7773,72307,0.9029345654345654,23.363356444444445,3981.192138666667,12.13067223035364,135,6.10000000000001E-4
3,test_20231101_140121,10188041.png,221231,7117,214114,0.967830005740606,2,4,41731,1011,40720,0.9757734058613501,12.447984,1486.4768053333332,16.409222239124453,135,6.10000000000001E-4
4,test_20231101_140121,10287332.png,216980,9832,207148,0.9546870679325283,1,4,22337,1355,20982,0.9393383175896495,10.154837333333333,1008.1934186666666,18.095365027648654,135,6.10000000000001E-4
5,test_20231101_140121,11610969.png,368720,13662,355058,0.9629474940334128,2,3,84111,2025,82086,0.9759246709705033,35.46244266666667,6281.286944,10.150317274145863,135,6.10000000000001E-4
6,test_20231101_140121,10350842.png,212614,2627,209987,0.9876442755415918,1,4,42529,386,42143,0.9909238402031555,25.61189511111111,3910.4018613333333,12.208589699192402,135,6.10000000000001E-4
7,test_20231101_140121,10863862.png,317432,5712,311720,0.982005594899065,1,3,66058,839,65219,0.9872990402373671,36.955265777777775,6853.766906666667,9.771510306704478,135,6.10000000000001E-4
8,test_20231101_140121,11382381.png,312486,527,311959,0.9983135244458952,1,3,46745,69,46676,0.9985239063001391,22.832848,2745.811376,13.744096608790418,135,6.10000000000001E-4
9,test_20231101_140121,11079715.png,443815,94572,349243,0.7869112130054189,4,4,124136,13297,110839,0.8928836115228459,18.965763555555554,2647.7406186666667,13.902049229247469,135,6.10000000000001E-4
10,test_20231101_140121,11551286.png,271883,164,271719,0.9993967993585476,1,3,40092,22,40070,0.9994512620971765,18.120286222222223,1899.5769013333334,15.344234809036362,135,6.10000000000001E-4
1,test_20231101_140122,10404007.png,502730,11862,490868,0.976404829630219,2,3,61265,1736,59529,0.9716640822655677,26.797180444444443,3727.662016,12.416438325186887,135,6.20000000000001E-4
2,test_20231101_140122,1254659.png,342646,55142,287504,0.8390700606456809,3,4,80080,7773,72307,0.9029345654345654,23.363356444444445,3981.192138666667,12.13067223035364,135,6.20000000000001E-4
3,test_20231101_140122,10188041.png,221231,7117,214114,0.967830005740606,1,12,41731,1011,40720,0.9757734058613501,12.447984,1486.4768053333332,16.409222239124453,135,6.20000000000001E-4
4,test_20231101_140122,10287332.png,216980,9832,207148,0.9546870679325283,1,3,22337,1355,20982,0.9393383175896495,10.154837333333333,1008.1934186666666,18.095365027648654,135,6.20000000000001E-4
5,test_20231101_140122,11610969.png,368720,13662,355058,0.9629474940334128,1,3,84111,2025,82086,0.9759246709705033,35.46244266666667,6281.286944,10.150317274145863,135,6.20000000000001E-4
6,test_20231101_140122,10350842.png,212614,2627,209987,0.9876442755415918,1,3,42529,386,42143,0.9909238402031555,25.61189511111111,3910.4018613333333,12.208589699192402,135,6.20000000000001E-4
7,test_20231101_140122,10863862.png,317432,5712,311720,0.982005594899065,1,3,66058,839,65219,0.9872990402373671,36.955265777777775,6853.766906666667,9.771510306704478,135,6.20000000000001E-4
8,test_20231101_140122,11382381.png,312486,527,311959,0.9983135244458952,1,4,46745,69,46676,0.9985239063001391,22.832848,2745.811376,13.744096608790418,135,6.20000000000001E-4
9,test_20231101_140122,11079715.png,443815,94572,349243,0.7869112130054189,3,4,124136,13297,110839,0.8928836115228459,18.965763555555554,2647.7406186666667,13.902049229247469,135,6.20000000000001E-4
10,test_20231101_140122,11551286.png,271883,164,271719,0.9993967993585476,2,4,40092,22,40070,0.9994512620971765,18.120286222222223,1899.5769013333334,15.344234809036362,135,6.20000000000001E-4
1,test_20231101_140122,10404007.png,502730,11862,490868,0.976404829630219,2,4,61265,1736,59529,0.9716640822655677,26.797180444444443,3727.662016,12.416438325186887,135,6.30000000000001E-4
2,test_20231101_140122,1254659.png,342646,55142,287504,0.8390700606456809,3,4,80080,7773,72307,0.9029345654345654,23.363356444444445,3981.192138666667,12.13067223035364,135,6.30000000000001E-4
3,test_20231101_140122,10188041.png,221231,7117,214114,0.967830005740606,1,4,41731,1011,40720,0.9757734058613501,12.447984,1486.4768053333332,16.409222239124453,135,6.30000000000001E-4
4,test_20231101_140122,10287332.png,216980,9832,207148,0.9546870679325283,2,6,22337,1355,20982,0.9393383175896495,10.154837333333333,1008.1934186666666,18.095365027648654,135,6.30000000000001E-4
5,test_20231101_140122,11610969.png,368720,13662,355058,0.9629474940334128,2,4,84111,2025,82086,0.9759246709705033,35.46244266666667,6281.286944,10.150317274145863,135,6.30000000000001E-4
6,test_20231101_140122,10350842.png,212614,2627,209987,0.9876442755415918,2,3,42529,386,42143,0.9909238402031555,25.61189511111111,3910.4018613333333,12.208589699192402,135,6.30000000000001E-4
7,test_20231101_140122,10863862.png,317432,5712,311720,0.982005594899065,2,4,66058,839,65219,0.9872990402373671,36.955265777777775,6853.766906666667,9.771510306704478,135,6.30000000000001E-4
8,test_20231101_140122,11382381.png,312486,527,311959,0.9983135244458952,1,4,46745,69,46676,0.9985239063001391,22.832848,2745.811376,13.744096608790418,135,6.30000000000001E-4
9,test_20231101_140122,11079715.png,443815,94572,349243,0.7869112130054189,3,4,124136,13297,110839,0.8928836115228459,18.965763555555554,2647.7406186666667,13.902049229247469,135,6.30000000000001E-4
10,test_20231101_140122,11551286.png,271883,24,271859,0.9999117267353972,0,3,40092,1,40091,0.9999750573680535,24.866876444444443,3470.407338666667,12.72699907819776,135,6.30000000000001E-4
1,test_20231101_140123,10404007.png,502730,11479,491251,0.9771666699818988,2,3,61265,1680,59585,0.9725781441279686,27.133662222222224,3800.1239946666665,12.332825933771614,135,6.40000000000001E-4
2,test_20231101_140123,1254659.png,342646,55142,287504,0.8390700606456809,3,3,80080,7773,72307,0.9029345654345654,23.363356444444445,3981.192138666667,12.13067223035364,135,6.40000000000001E-4
3,test_20231101_140123,10188041.png,221231,7117,214114,0.967830005740606,2,4,41731,1011,40720,0.9757734058613501,12.447984,1486.4768053333332,16.409222239124453,135,6.40000000000001E-4
4,test_20231101_140123,10287332.png,216980,9832,207148,0.9546870679325283,2,4,22337,1355,20982,0.9393383175896495,10.154837333333333,1008.1934186666666,18.095365027648654,135,6.40000000000001E-4
5,test_20231101_140123,11610969.png,368720,13662,355058,0.9629474940334128,2,4,84111,2025,82086,0.9759246709705033,35.46244266666667,6281.286944,10.150317274145863,135,6.40000000000001E-4
6,test_20231101_140123,10350842.png,212614,2627,209987,0.9876442755415918,1,3,42529,386,42143,0.9909238402031555,25.61189511111111,3910.4018613333333,12.208589699192402,135,6.40000000000001E-4
7,test_20231101_140123,10863862.png,317432,5107,312325,0.9839115149071297,2,4,66058,750,65308,0.9886463410941899,40.688538666666666,7904.047792,9.152308033091979,135,6.40000000000001E-4
8,test_20231101_140123,11382381.png,312486,527,311959,0.9983135244458952,1,3,46745,69,46676,0.9985239063001391,22.832848,2745.811376,13.744096608790418,135,6.40000000000001E-4
9,test_20231101_140123,11079715.png,443815,94572,349243,0.7869112130054189,3,4,124136,13297,110839,0.8928836115228459,18.965763555555554,2647.7406186666667,13.902049229247469,135,6.40000000000001E-4
10,test_20231101_140123,11551286.png,271883,24,271859,0.9999117267353972,0,3,40092,1,40091,0.9999750573680535,24.866876444444443,3470.407338666667,12.72699907819776,135,6.40000000000001E-4
1,test_20231101_140124,10404007.png,502730,11479,491251,0.9771666699818988,2,8,61265,1680,59585,0.9725781441279686,27.133662222222224,3800.1239946666665,12.332825933771614,135,6.500000000000011E-4
2,test_20231101_140124,1254659.png,342646,55142,287504,0.8390700606456809,3,4,80080,7773,72307,0.9029345654345654,23.363356444444445,3981.192138666667,12.13067223035364,135,6.500000000000011E-4
3,test_20231101_140124,10188041.png,221231,7117,214114,0.967830005740606,2,4,41731,1011,40720,0.9757734058613501,12.447984,1486.4768053333332,16.409222239124453,135,6.500000000000011E-4
4,test_20231101_140124,10287332.png,216980,9832,207148,0.9546870679325283,2,3,22337,1355,20982,0.9393383175896495,10.154837333333333,1008.1934186666666,18.095365027648654,135,6.500000000000011E-4
5,test_20231101_140124,11610969.png,368720,13662,355058,0.9629474940334128,2,4,84111,2025,82086,0.9759246709705033,35.46244266666667,6281.286944,10.150317274145863,135,6.500000000000011E-4
6,test_20231101_140124,10350842.png,212614,2627,209987,0.9876442755415918,1,4,42529,386,42143,0.9909238402031555,25.61189511111111,3910.4018613333333,12.208589699192402,135,6.500000000000011E-4
7,test_20231101_140124,10863862.png,317432,5107,312325,0.9839115149071297,1,3,66058,750,65308,0.9886463410941899,40.688538666666666,7904.047792,9.152308033091979,135,6.500000000000011E-4
8,test_20231101_140124,11382381.png,312486,527,311959,0.9983135244458952,1,4,46745,69,46676,0.9985239063001391,22.832848,2745.811376,13.744096608790418,135,6.500000000000011E-4
9,test_20231101_140124,11079715.png,443815,94572,349243,0.7869112130054189,3,4,124136,13297,110839,0.8928836115228459,18.965763555555554,2647.7406186666667,13.902049229247469,135,6.500000000000011E-4
10,test_20231101_140124,11551286.png,271883,24,271859,0.9999117267353972,0,3,40092,1,40091,0.9999750573680535,24.866876444444443,3470.407338666667,12.72699907819776,135,6.500000000000011E-4
1,test_20231101_140124,10404007.png,502730,11479,491251,0.9771666699818988,1,3,61265,1680,59585,0.9725781441279686,27.133662222222224,3800.1239946666665,12.332825933771614,135,6.600000000000011E-4
2,test_20231101_140124,1254659.png,342646,55142,287504,0.8390700606456809,3,4,80080,7773,72307,0.9029345654345654,23.363356444444445,3981.192138666667,12.13067223035364,135,6.600000000000011E-4
3,test_20231101_140124,10188041.png,221231,7117,214114,0.967830005740606,2,4,41731,1011,40720,0.9757734058613501,12.447984,1486.4768053333332,16.409222239124453,135,6.600000000000011E-4
4,test_20231101_140124,10287332.png,216980,9832,207148,0.9546870679325283,2,4,22337,1355,20982,0.9393383175896495,10.154837333333333,1008.1934186666666,18.095365027648654,135,6.600000000000011E-4
5,test_20231101_140124,11610969.png,368720,13662,355058,0.9629474940334128,2,3,84111,2025,82086,0.9759246709705033,35.46244266666667,6281.286944,10.150317274145863,135,6.600000000000011E-4
6,test_20231101_140124,10350842.png,212614,2627,209987,0.9876442755415918,1,3,42529,386,42143,0.9909238402031555,25.61189511111111,3910.4018613333333,12.208589699192402,135,6.600000000000011E-4
7,test_20231101_140124,10863862.png,317432,5107,312325,0.9839115149071297,2,3,66058,750,65308,0.9886463410941899,40.688538666666666,7904.047792,9.152308033091979,135,6.600000000000011E-4
8,test_20231101_140124,11382381.png,312486,527,311959,0.9983135244458952,1,4,46745,69,46676,0.9985239063001391,22.832848,2745.811376,13.744096608790418,135,6.600000000000011E-4
9,test_20231101_140124,11079715.png,443815,94572,349243,0.7869112130054189,3,4,124136,13297,110839,0.8928836115228459,18.965763555555554,2647.7406186666667,13.902049229247469,135,6.600000000000011E-4
10,test_20231101_140124,11551286.png,271883,24,271859,0.9999117267353972,0,3,40092,1,40091,0.9999750573680535,24.866876444444443,3470.407338666667,12.72699907819776,135,6.600000000000011E-4
1,test_20231101_140125,10404007.png,502730,11479,491251,0.9771666699818988,2,4,61265,1680,59585,0.9725781441279686,27.133662222222224,3800.1239946666665,12.332825933771614,135,6.700000000000011E-4
2,test_20231101_140125,1254659.png,342646,55142,287504,0.8390700606456809,3,4,80080,7773,72307,0.9029345654345654,23.363356444444445,3981.192138666667,12.13067223035364,135,6.700000000000011E-4
3,test_20231101_140125,10188041.png,221231,7117,214114,0.967830005740606,1,3,41731,1011,40720,0.9757734058613501,12.447984,1486.4768053333332,16.409222239124453,135,6.700000000000011E-4
4,test_20231101_140125,10287332.png,216980,9832,207148,0.9546870679325283,2,4,22337,1355,20982,0.9393383175896495,10.154837333333333,1008.1934186666666,18.095365027648654,135,6.700000000000011E-4
5,test_20231101_140125,11610969.png,368720,13662,355058,0.9629474940334128,1,4,84111,2025,82086,0.9759246709705033,35.46244266666667,6281.286944,10.150317274145863,135,6.700000000000011E-4
6,test_20231101_140125,10350842.png,212614,2627,209987,0.9876442755415918,2,3,42529,386,42143,0.9909238402031555,25.61189511111111,3910.4018613333333,12.208589699192402,135,6.700000000000011E-4
7,test_20231101_140125,10863862.png,317432,5107,312325,0.9839115149071297,1,3,66058,750,65308,0.9886463410941899,40.688538666666666,7904.047792,9.152308033091979,135,6.700000000000011E-4
8,test_20231101_140125,11382381.png,312486,527,311959,0.9983135244458952,1,4,46745,69,46676,0.9985239063001391,22.832848,2745.811376,13.744096608790418,135,6.700000000000011E-4
9,test_20231101_140125,11079715.png,443815,94572,349243,0.7869112130054189,3,5,124136,13297,110839,0.8928836115228459,18.965763555555554,2647.7406186666667,13.902049229247469,135,6.700000000000011E-4
10,test_20231101_140125,11551286.png,271883,24,271859,0.9999117267353972,1,4,40092,1,40091,0.9999750573680535,24.866876444444443,3470.407338666667,12.72699907819776,135,6.700000000000011E-4
1,test_20231101_140126,10404007.png,502730,11479,491251,0.9771666699818988,2,4,61265,1680,59585,0.9725781441279686,27.133662222222224,3800.1239946666665,12.332825933771614,135,6.800000000000011E-4
2,test_20231101_140126,1254659.png,342646,55142,287504,0.8390700606456809,3,4,80080,7773,72307,0.9029345654345654,23.363356444444445,3981.192138666667,12.13067223035364,135,6.800000000000011E-4
3,test_20231101_140126,10188041.png,221231,7117,214114,0.967830005740606,2,3,41731,1011,40720,0.9757734058613501,12.447984,1486.4768053333332,16.409222239124453,135,6.800000000000011E-4
4,test_20231101_140126,10287332.png,216980,9832,207148,0.9546870679325283,2,3,22337,1355,20982,0.9393383175896495,10.154837333333333,1008.1934186666666,18.095365027648654,135,6.800000000000011E-4
5,test_20231101_140126,11610969.png,368720,13662,355058,0.9629474940334128,2,4,84111,2025,82086,0.9759246709705033,35.46244266666667,6281.286944,10.150317274145863,135,6.800000000000011E-4
6,test_20231101_140126,10350842.png,212614,2627,209987,0.9876442755415918,1,3,42529,386,42143,0.9909238402031555,25.61189511111111,3910.4018613333333,12.208589699192402,135,6.800000000000011E-4
7,test_20231101_140126,10863862.png,317432,5107,312325,0.9839115149071297,1,4,66058,750,65308,0.9886463410941899,40.688538666666666,7904.047792,9.152308033091979,135,6.800000000000011E-4
8,test_20231101_140126,11382381.png,312486,527,311959,0.9983135244458952,1,3,46745,69,46676,0.9985239063001391,22.832848,2745.811376,13.744096608790418,135,6.800000000000011E-4
9,test_20231101_140126,11079715.png,443815,94572,349243,0.7869112130054189,3,4,124136,13297,110839,0.8928836115228459,18.965763555555554,2647.7406186666667,13.902049229247469,135,6.800000000000011E-4
10,test_20231101_140126,11551286.png,271883,24,271859,0.9999117267353972,1,3,40092,1,40091,0.9999750573680535,24.866876444444443,3470.407338666667,12.72699907819776,135,6.800000000000011E-4
1,test_20231101_140126,10404007.png,502730,11479,491251,0.9771666699818988,2,3,61265,1680,59585,0.9725781441279686,27.133662222222224,3800.1239946666665,12.332825933771614,135,6.900000000000012E-4
2,test_20231101_140126,1254659.png,342646,55142,287504,0.8390700606456809,3,4,80080,7773,72307,0.9029345654345654,23.363356444444445,3981.192138666667,12.13067223035364,135,6.900000000000012E-4
3,test_20231101_140126,10188041.png,221231,7117,214114,0.967830005740606,2,4,41731,1011,40720,0.9757734058613501,12.447984,1486.4768053333332,16.409222239124453,135,6.900000000000012E-4
4,test_20231101_140126,10287332.png,216980,9832,207148,0.9546870679325283,1,4,22337,1355,20982,0.9393383175896495,10.154837333333333,1008.1934186666666,18.095365027648654,135,6.900000000000012E-4
5,test_20231101_140126,11610969.png,368720,13662,355058,0.9629474940334128,2,3,84111,2025,82086,0.9759246709705033,35.46244266666667,6281.286944,10.150317274145863,135,6.900000000000012E-4
6,test_20231101_140126,10350842.png,212614,2627,209987,0.9876442755415918,1,3,42529,386,42143,0.9909238402031555,25.61189511111111,3910.4018613333333,12.208589699192402,135,6.900000000000012E-4
7,test_20231101_140126,10863862.png,317432,5107,312325,0.9839115149071297,1,4,66058,750,65308,0.9886463410941899,40.688538666666666,7904.047792,9.152308033091979,135,6.900000000000012E-4
8,test_20231101_140126,11382381.png,312486,527,311959,0.9983135244458952,1,3,46745,69,46676,0.9985239063001391,22.832848,2745.811376,13.744096608790418,135,6.900000000000012E-4
9,test_20231101_140126,11079715.png,443815,94572,349243,0.7869112130054189,3,4,124136,13297,110839,0.8928836115228459,18.965763555555554,2647.7406186666667,13.902049229247469,135,6.900000000000012E-4
10,test_20231101_140126,11551286.png,271883,24,271859,0.9999117267353972,0,4,40092,1,40091,0.9999750573680535,24.866876444444443,3470.407338666667,12.72699907819776,135,6.900000000000012E-4
1,test_20231101_140127,10404007.png,502730,11479,491251,0.9771666699818988,2,5,61265,1680,59585,0.9725781441279686,27.133662222222224,3800.1239946666665,12.332825933771614,135,7.000000000000012E-4
2,test_20231101_140127,1254659.png,342646,55142,287504,0.8390700606456809,3,4,80080,7773,72307,0.9029345654345654,23.363356444444445,3981.192138666667,12.13067223035364,135,7.000000000000012E-4
3,test_20231101_140127,10188041.png,221231,7117,214114,0.967830005740606,2,4,41731,1011,40720,0.9757734058613501,12.447984,1486.4768053333332,16.409222239124453,135,7.000000000000012E-4
4,test_20231101_140127,10287332.png,216980,9832,207148,0.9546870679325283,2,4,22337,1355,20982,0.9393383175896495,10.154837333333333,1008.1934186666666,18.095365027648654,135,7.000000000000012E-4
5,test_20231101_140127,11610969.png,368720,13662,355058,0.9629474940334128,2,3,84111,2025,82086,0.9759246709705033,35.46244266666667,6281.286944,10.150317274145863,135,7.000000000000012E-4
6,test_20231101_140127,10350842.png,212614,2627,209987,0.9876442755415918,1,4,42529,386,42143,0.9909238402031555,25.61189511111111,3910.4018613333333,12.208589699192402,135,7.000000000000012E-4
7,test_20231101_140127,10863862.png,317432,5107,312325,0.9839115149071297,1,4,66058,750,65308,0.9886463410941899,40.688538666666666,7904.047792,9.152308033091979,135,7.000000000000012E-4
8,test_20231101_140127,11382381.png,312486,527,311959,0.9983135244458952,1,4,46745,69,46676,0.9985239063001391,22.832848,2745.811376,13.744096608790418,135,7.000000000000012E-4
9,test_20231101_140127,11079715.png,443815,94572,349243,0.7869112130054189,3,4,124136,13297,110839,0.8928836115228459,18.965763555555554,2647.7406186666667,13.902049229247469,135,7.000000000000012E-4
10,test_20231101_140127,11551286.png,271883,24,271859,0.9999117267353972,1,6,40092,1,40091,0.9999750573680535,24.866876444444443,3470.407338666667,12.72699907819776,135,7.000000000000012E-4
1,test_20231101_140128,10404007.png,502730,11479,491251,0.9771666699818988,2,4,61265,1680,59585,0.9725781441279686,27.133662222222224,3800.1239946666665,12.332825933771614,135,7.100000000000012E-4
2,test_20231101_140128,1254659.png,342646,55142,287504,0.8390700606456809,3,4,80080,7773,72307,0.9029345654345654,23.363356444444445,3981.192138666667,12.13067223035364,135,7.100000000000012E-4
3,test_20231101_140128,10188041.png,221231,7117,214114,0.967830005740606,2,4,41731,1011,40720,0.9757734058613501,12.447984,1486.4768053333332,16.409222239124453,135,7.100000000000012E-4
4,test_20231101_140128,10287332.png,216980,9832,207148,0.9546870679325283,2,3,22337,1355,20982,0.9393383175896495,10.154837333333333,1008.1934186666666,18.095365027648654,135,7.100000000000012E-4
5,test_20231101_140128,11610969.png,368720,13662,355058,0.9629474940334128,1,3,84111,2025,82086,0.9759246709705033,35.46244266666667,6281.286944,10.150317274145863,135,7.100000000000012E-4
6,test_20231101_140128,10350842.png,212614,2304,210310,0.9891634605435202,2,3,42529,338,42191,0.9920524818359238,26.483171555555554,4123.517418666666,11.978125274071413,135,7.100000000000012E-4
7,test_20231101_140128,10863862.png,317432,5107,312325,0.9839115149071297,2,4,66058,750,65308,0.9886463410941899,40.688538666666666,7904.047792,9.152308033091979,135,7.100000000000012E-4
8,test_20231101_140128,11382381.png,312486,527,311959,0.9983135244458952,2,4,46745,69,46676,0.9985239063001391,22.832848,2745.811376,13.744096608790418,135,7.100000000000012E-4
9,test_20231101_140128,11079715.png,443815,94572,349243,0.7869112130054189,3,4,124136,13297,110839,0.8928836115228459,18.965763555555554,2647.7406186666667,13.902049229247469,135,7.100000000000012E-4
10,test_20231101_140128,11551286.png,271883,24,271859,0.9999117267353972,1,4,40092,1,40091,0.9999750573680535,24.866876444444443,3470.407338666667,12.72699907819776,135,7.100000000000012E-4
1,test_20231101_140128,10404007.png,502730,11479,491251,0.9771666699818988,2,4,61265,1680,59585,0.9725781441279686,27.133662222222224,3800.1239946666665,12.332825933771614,135,7.200000000000012E-4
2,test_20231101_140128,1254659.png,342646,55142,287504,0.8390700606456809,2,4,80080,7773,72307,0.9029345654345654,23.363356444444445,3981.192138666667,12.13067223035364,135,7.200000000000012E-4
3,test_20231101_140128,10188041.png,221231,7117,214114,0.967830005740606,2,4,41731,1011,40720,0.9757734058613501,12.447984,1486.4768053333332,16.409222239124453,135,7.200000000000012E-4
4,test_20231101_140128,10287332.png,216980,9832,207148,0.9546870679325283,2,4,22337,1355,20982,0.9393383175896495,10.154837333333333,1008.1934186666666,18.095365027648654,135,7.200000000000012E-4
5,test_20231101_140128,11610969.png,368720,13662,355058,0.9629474940334128,2,4,84111,2025,82086,0.9759246709705033,35.46244266666667,6281.286944,10.150317274145863,135,7.200000000000012E-4
6,test_20231101_140128,10350842.png,212614,2304,210310,0.9891634605435202,1,4,42529,338,42191,0.9920524818359238,26.483171555555554,4123.517418666666,11.978125274071413,135,7.200000000000012E-4
7,test_20231101_140128,10863862.png,317432,5107,312325,0.9839115149071297,1,4,66058,750,65308,0.9886463410941899,40.688538666666666,7904.047792,9.152308033091979,135,7.200000000000012E-4
8,test_20231101_140128,11382381.png,312486,527,311959,0.9983135244458952,2,3,46745,69,46676,0.9985239063001391,22.832848,2745.811376,13.744096608790418,135,7.200000000000012E-4
9,test_20231101_140128,11079715.png,443815,94572,349243,0.7869112130054189,3,4,124136,13297,110839,0.8928836115228459,18.965763555555554,2647.7406186666667,13.902049229247469,135,7.200000000000012E-4
10,test_20231101_140128,11551286.png,271883,24,271859,0.9999117267353972,0,13,40092,1,40091,0.9999750573680535,24.866876444444443,3470.407338666667,12.72699907819776,135,7.200000000000012E-4
1,test_20231101_140129,10404007.png,502730,11479,491251,0.9771666699818988,1,3,61265,1680,59585,0.9725781441279686,27.133662222222224,3800.1239946666665,12.332825933771614,135,7.300000000000013E-4
2,test_20231101_140129,1254659.png,342646,55142,287504,0.8390700606456809,3,4,80080,7773,72307,0.9029345654345654,23.363356444444445,3981.192138666667,12.13067223035364,135,7.300000000000013E-4
3,test_20231101_140129,10188041.png,221231,7117,214114,0.967830005740606,2,4,41731,1011,40720,0.9757734058613501,12.447984,1486.4768053333332,16.409222239124453,135,7.300000000000013E-4
4,test_20231101_140129,10287332.png,216980,9832,207148,0.9546870679325283,2,4,22337,1355,20982,0.9393383175896495,10.154837333333333,1008.1934186666666,18.095365027648654,135,7.300000000000013E-4
5,test_20231101_140129,11610969.png,368720,13662,355058,0.9629474940334128,2,3,84111,2025,82086,0.9759246709705033,35.46244266666667,6281.286944,10.150317274145863,135,7.300000000000013E-4
6,test_20231101_140129,10350842.png,212614,2304,210310,0.9891634605435202,1,4,42529,338,42191,0.9920524818359238,26.483171555555554,4123.517418666666,11.978125274071413,135,7.300000000000013E-4
7,test_20231101_140129,10863862.png,317432,5107,312325,0.9839115149071297,1,3,66058,750,65308,0.9886463410941899,40.688538666666666,7904.047792,9.152308033091979,135,7.300000000000013E-4
8,test_20231101_140129,11382381.png,312486,527,311959,0.9983135244458952,1,3,46745,69,46676,0.9985239063001391,22.832848,2745.811376,13.744096608790418,135,7.300000000000013E-4
9,test_20231101_140129,11079715.png,443815,94572,349243,0.7869112130054189,6,5,124136,13297,110839,0.8928836115228459,18.965763555555554,2647.7406186666667,13.902049229247469,135,7.300000000000013E-4
10,test_20231101_140129,11551286.png,271883,24,271859,0.9999117267353972,0,4,40092,1,40091,0.9999750573680535,24.866876444444443,3470.407338666667,12.72699907819776,135,7.300000000000013E-4
1,test_20231101_140130,10404007.png,502730,11479,491251,0.9771666699818988,2,4,61265,1680,59585,0.9725781441279686,27.133662222222224,3800.1239946666665,12.332825933771614,135,7.400000000000013E-4
2,test_20231101_140130,1254659.png,342646,55142,287504,0.8390700606456809,3,4,80080,7773,72307,0.9029345654345654,23.363356444444445,3981.192138666667,12.13067223035364,135,7.400000000000013E-4
3,test_20231101_140130,10188041.png,221231,7117,214114,0.967830005740606,2,4,41731,1011,40720,0.9757734058613501,12.447984,1486.4768053333332,16.409222239124453,135,7.400000000000013E-4
4,test_20231101_140130,10287332.png,216980,9832,207148,0.9546870679325283,2,4,22337,1355,20982,0.9393383175896495,10.154837333333333,1008.1934186666666,18.095365027648654,135,7.400000000000013E-4
5,test_20231101_140130,11610969.png,368720,13662,355058,0.9629474940334128,1,3,84111,2025,82086,0.9759246709705033,35.46244266666667,6281.286944,10.150317274145863,135,7.400000000000013E-4
6,test_20231101_140130,10350842.png,212614,2304,210310,0.9891634605435202,1,4,42529,338,42191,0.9920524818359238,26.483171555555554,4123.517418666666,11.978125274071413,135,7.400000000000013E-4
7,test_20231101_140130,10863862.png,317432,5107,312325,0.9839115149071297,2,4,66058,750,65308,0.9886463410941899,40.688538666666666,7904.047792,9.152308033091979,135,7.400000000000013E-4
8,test_20231101_140130,11382381.png,312486,527,311959,0.9983135244458952,1,4,46745,69,46676,0.9985239063001391,22.832848,2745.811376,13.744096608790418,135,7.400000000000013E-4
9,test_20231101_140130,11079715.png,443815,94572,349243,0.7869112130054189,3,4,124136,13297,110839,0.8928836115228459,18.965763555555554,2647.7406186666667,13.902049229247469,135,7.400000000000013E-4
10,test_20231101_140130,11551286.png,271883,24,271859,0.9999117267353972,0,3,40092,1,40091,0.9999750573680535,24.866876444444443,3470.407338666667,12.72699907819776,135,7.400000000000013E-4
1,test_20231101_140130,10404007.png,502730,11479,491251,0.9771666699818988,2,3,61265,1680,59585,0.9725781441279686,27.133662222222224,3800.1239946666665,12.332825933771614,135,7.500000000000013E-4
2,test_20231101_140130,1254659.png,342646,55142,287504,0.8390700606456809,2,4,80080,7773,72307,0.9029345654345654,23.363356444444445,3981.192138666667,12.13067223035364,135,7.500000000000013E-4
3,test_20231101_140130,10188041.png,221231,7117,214114,0.967830005740606,2,4,41731,1011,40720,0.9757734058613501,12.447984,1486.4768053333332,16.409222239124453,135,7.500000000000013E-4
4,test_20231101_140130,10287332.png,216980,9832,207148,0.9546870679325283,1,3,22337,1355,20982,0.9393383175896495,10.154837333333333,1008.1934186666666,18.095365027648654,135,7.500000000000013E-4
5,test_20231101_140130,11610969.png,368720,13662,355058,0.9629474940334128,2,4,84111,2025,82086,0.9759246709705033,35.46244266666667,6281.286944,10.150317274145863,135,7.500000000000013E-4
6,test_20231101_140130,10350842.png,212614,2304,210310,0.9891634605435202,2,3,42529,338,42191,0.9920524818359238,26.483171555555554,4123.517418666666,11.978125274071413,135,7.500000000000013E-4
7,test_20231101_140130,10863862.png,317432,5107,312325,0.9839115149071297,2,4,66058,750,65308,0.9886463410941899,40.688538666666666,7904.047792,9.152308033091979,135,7.500000000000013E-4
8,test_20231101_140130,11382381.png,312486,527,311959,0.9983135244458952,1,4,46745,69,46676,0.9985239063001391,22.832848,2745.811376,13.744096608790418,135,7.500000000000013E-4
9,test_20231101_140130,11079715.png,443815,94572,349243,0.7869112130054189,3,4,124136,13297,110839,0.8928836115228459,18.965763555555554,2647.7406186666667,13.902049229247469,135,7.500000000000013E-4
10,test_20231101_140130,11551286.png,271883,24,271859,0.9999117267353972,0,3,40092,1,40091,0.9999750573680535,24.866876444444443,3470.407338666667,12.72699907819776,135,7.500000000000013E-4
1,test_20231101_140131,10404007.png,502730,11479,491251,0.9771666699818988,2,3,61265,1680,59585,0.9725781441279686,27.133662222222224,3800.1239946666665,12.332825933771614,135,7.600000000000013E-4
2,test_20231101_140131,1254659.png,342646,55142,287504,0.8390700606456809,3,4,80080,7773,72307,0.9029345654345654,23.363356444444445,3981.192138666667,12.13067223035364,135,7.600000000000013E-4
3,test_20231101_140131,10188041.png,221231,7117,214114,0.967830005740606,1,3,41731,1011,40720,0.9757734058613501,12.447984,1486.4768053333332,16.409222239124453,135,7.600000000000013E-4
4,test_20231101_140131,10287332.png,216980,9832,207148,0.9546870679325283,2,4,22337,1355,20982,0.9393383175896495,10.154837333333333,1008.1934186666666,18.095365027648654,135,7.600000000000013E-4
5,test_20231101_140131,11610969.png,368720,13662,355058,0.9629474940334128,1,3,84111,2025,82086,0.9759246709705033,35.46244266666667,6281.286944,10.150317274145863,135,7.600000000000013E-4
6,test_20231101_140131,10350842.png,212614,2304,210310,0.9891634605435202,1,4,42529,338,42191,0.9920524818359238,26.483171555555554,4123.517418666666,11.978125274071413,135,7.600000000000013E-4
7,test_20231101_140131,10863862.png,317432,5107,312325,0.9839115149071297,2,3,66058,750,65308,0.9886463410941899,40.688538666666666,7904.047792,9.152308033091979,135,7.600000000000013E-4
8,test_20231101_140131,11382381.png,312486,527,311959,0.9983135244458952,1,3,46745,69,46676,0.9985239063001391,22.832848,2745.811376,13.744096608790418,135,7.600000000000013E-4
9,test_20231101_140131,11079715.png,443815,94572,349243,0.7869112130054189,3,4,124136,13297,110839,0.8928836115228459,18.965763555555554,2647.7406186666667,13.902049229247469,135,7.600000000000013E-4
10,test_20231101_140131,11551286.png,271883,24,271859,0.9999117267353972,1,4,40092,1,40091,0.9999750573680535,24.866876444444443,3470.407338666667,12.72699907819776,135,7.600000000000013E-4
1,test_20231101_140132,10404007.png,502730,11479,491251,0.9771666699818988,1,3,61265,1680,59585,0.9725781441279686,27.133662222222224,3800.1239946666665,12.332825933771614,135,7.700000000000014E-4
2,test_20231101_140132,1254659.png,342646,55142,287504,0.8390700606456809,3,4,80080,7773,72307,0.9029345654345654,23.363356444444445,3981.192138666667,12.13067223035364,135,7.700000000000014E-4
3,test_20231101_140132,10188041.png,221231,7117,214114,0.967830005740606,1,3,41731,1011,40720,0.9757734058613501,12.447984,1486.4768053333332,16.409222239124453,135,7.700000000000014E-4
4,test_20231101_140132,10287332.png,216980,9832,207148,0.9546870679325283,2,4,22337,1355,20982,0.9393383175896495,10.154837333333333,1008.1934186666666,18.095365027648654,135,7.700000000000014E-4
5,test_20231101_140132,11610969.png,368720,13662,355058,0.9629474940334128,2,13,84111,2025,82086,0.9759246709705033,35.46244266666667,6281.286944,10.150317274145863,135,7.700000000000014E-4
6,test_20231101_140132,10350842.png,212614,2304,210310,0.9891634605435202,2,4,42529,338,42191,0.9920524818359238,26.483171555555554,4123.517418666666,11.978125274071413,135,7.700000000000014E-4
7,test_20231101_140132,10863862.png,317432,5107,312325,0.9839115149071297,1,3,66058,750,65308,0.9886463410941899,40.688538666666666,7904.047792,9.152308033091979,135,7.700000000000014E-4
8,test_20231101_140132,11382381.png,312486,527,311959,0.9983135244458952,2,3,46745,69,46676,0.9985239063001391,22.832848,2745.811376,13.744096608790418,135,7.700000000000014E-4
9,test_20231101_140132,11079715.png,443815,94572,349243,0.7869112130054189,3,4,124136,13297,110839,0.8928836115228459,18.965763555555554,2647.7406186666667,13.902049229247469,135,7.700000000000014E-4
10,test_20231101_140132,11551286.png,271883,24,271859,0.9999117267353972,0,3,40092,1,40091,0.9999750573680535,24.866876444444443,3470.407338666667,12.72699907819776,135,7.700000000000014E-4
1,test_20231101_140132,10404007.png,502730,11479,491251,0.9771666699818988,1,3,61265,1680,59585,0.9725781441279686,27.133662222222224,3800.1239946666665,12.332825933771614,135,7.800000000000014E-4
2,test_20231101_140132,1254659.png,342646,55142,287504,0.8390700606456809,3,4,80080,7773,72307,0.9029345654345654,23.363356444444445,3981.192138666667,12.13067223035364,135,7.800000000000014E-4
3,test_20231101_140132,10188041.png,221231,7117,214114,0.967830005740606,2,4,41731,1011,40720,0.9757734058613501,12.447984,1486.4768053333332,16.409222239124453,135,7.800000000000014E-4
4,test_20231101_140132,10287332.png,216980,9832,207148,0.9546870679325283,1,4,22337,1355,20982,0.9393383175896495,10.154837333333333,1008.1934186666666,18.095365027648654,135,7.800000000000014E-4
5,test_20231101_140132,11610969.png,368720,13662,355058,0.9629474940334128,2,4,84111,2025,82086,0.9759246709705033,35.46244266666667,6281.286944,10.150317274145863,135,7.800000000000014E-4
6,test_20231101_140132,10350842.png,212614,2304,210310,0.9891634605435202,1,3,42529,338,42191,0.9920524818359238,26.483171555555554,4123.517418666666,11.978125274071413,135,7.800000000000014E-4
7,test_20231101_140132,10863862.png,317432,5107,312325,0.9839115149071297,1,4,66058,750,65308,0.9886463410941899,40.688538666666666,7904.047792,9.152308033091979,135,7.800000000000014E-4
8,test_20231101_140132,11382381.png,312486,527,311959,0.9983135244458952,1,3,46745,69,46676,0.9985239063001391,22.832848,2745.811376,13.744096608790418,135,7.800000000000014E-4
9,test_20231101_140132,11079715.png,443815,94572,349243,0.7869112130054189,3,4,124136,13297,110839,0.8928836115228459,18.965763555555554,2647.7406186666667,13.902049229247469,135,7.800000000000014E-4
10,test_20231101_140132,11551286.png,271883,24,271859,0.9999117267353972,0,3,40092,1,40091,0.9999750573680535,24.866876444444443,3470.407338666667,12.72699907819776,135,7.800000000000014E-4
1,test_20231101_140133,10404007.png,502730,11479,491251,0.9771666699818988,2,4,61265,1680,59585,0.9725781441279686,27.133662222222224,3800.1239946666665,12.332825933771614,135,7.900000000000014E-4
2,test_20231101_140133,1254659.png,342646,55142,287504,0.8390700606456809,3,4,80080,7773,72307,0.9029345654345654,23.363356444444445,3981.192138666667,12.13067223035364,135,7.900000000000014E-4
3,test_20231101_140133,10188041.png,221231,7117,214114,0.967830005740606,2,3,41731,1011,40720,0.9757734058613501,12.447984,1486.4768053333332,16.409222239124453,135,7.900000000000014E-4
4,test_20231101_140133,10287332.png,216980,9832,207148,0.9546870679325283,1,3,22337,1355,20982,0.9393383175896495,10.154837333333333,1008.1934186666666,18.095365027648654,135,7.900000000000014E-4
5,test_20231101_140133,11610969.png,368720,13662,355058,0.9629474940334128,2,4,84111,2025,82086,0.9759246709705033,35.46244266666667,6281.286944,10.150317274145863,135,7.900000000000014E-4
6,test_20231101_140133,10350842.png,212614,2304,210310,0.9891634605435202,2,3,42529,338,42191,0.9920524818359238,26.483171555555554,4123.517418666666,11.978125274071413,135,7.900000000000014E-4
7,test_20231101_140133,10863862.png,317432,5107,312325,0.9839115149071297,2,4,66058,750,65308,0.9886463410941899,40.688538666666666,7904.047792,9.152308033091979,135,7.900000000000014E-4
8,test_20231101_140133,11382381.png,312486,527,311959,0.9983135244458952,1,4,46745,69,46676,0.9985239063001391,22.832848,2745.811376,13.744096608790418,135,7.900000000000014E-4
9,test_20231101_140133,11079715.png,443815,94572,349243,0.7869112130054189,3,5,124136,13297,110839,0.8928836115228459,18.965763555555554,2647.7406186666667,13.902049229247469,135,7.900000000000014E-4
10,test_20231101_140133,11551286.png,271883,24,271859,0.9999117267353972,1,4,40092,1,40091,0.9999750573680535,24.866876444444443,3470.407338666667,12.72699907819776,135,7.900000000000014E-4
1,test_20231101_140134,10404007.png,502730,11479,491251,0.9771666699818988,2,3,61265,1680,59585,0.9725781441279686,27.133662222222224,3800.1239946666665,12.332825933771614,135,8.000000000000014E-4
2,test_20231101_140134,1254659.png,342646,55142,287504,0.8390700606456809,3,4,80080,7773,72307,0.9029345654345654,23.363356444444445,3981.192138666667,12.13067223035364,135,8.000000000000014E-4
3,test_20231101_140134,10188041.png,221231,7117,214114,0.967830005740606,2,4,41731,1011,40720,0.9757734058613501,12.447984,1486.4768053333332,16.409222239124453,135,8.000000000000014E-4
4,test_20231101_140134,10287332.png,216980,9832,207148,0.9546870679325283,1,3,22337,1355,20982,0.9393383175896495,10.154837333333333,1008.1934186666666,18.095365027648654,135,8.000000000000014E-4
5,test_20231101_140134,11610969.png,368720,13662,355058,0.9629474940334128,2,4,84111,2025,82086,0.9759246709705033,35.46244266666667,6281.286944,10.150317274145863,135,8.000000000000014E-4
6,test_20231101_140134,10350842.png,212614,2304,210310,0.9891634605435202,1,3,42529,338,42191,0.9920524818359238,26.483171555555554,4123.517418666666,11.978125274071413,135,8.000000000000014E-4
7,test_20231101_140134,10863862.png,317432,5107,312325,0.9839115149071297,2,5,66058,750,65308,0.9886463410941899,40.688538666666666,7904.047792,9.152308033091979,135,8.000000000000014E-4
8,test_20231101_140134,11382381.png,312486,527,311959,0.9983135244458952,1,3,46745,69,46676,0.9985239063001391,22.832848,2745.811376,13.744096608790418,135,8.000000000000014E-4
9,test_20231101_140134,11079715.png,443815,94572,349243,0.7869112130054189,4,4,124136,13297,110839,0.8928836115228459,18.965763555555554,2647.7406186666667,13.902049229247469,135,8.000000000000014E-4
10,test_20231101_140134,11551286.png,271883,24,271859,0.9999117267353972,1,4,40092,1,40091,0.9999750573680535,24.866876444444443,3470.407338666667,12.72699907819776,135,8.000000000000014E-4
1,test_20231101_140134,10404007.png,502730,11479,491251,0.9771666699818988,2,4,61265,1680,59585,0.9725781441279686,27.133662222222224,3800.1239946666665,12.332825933771614,135,8.100000000000015E-4
2,test_20231101_140134,1254659.png,342646,55142,287504,0.8390700606456809,2,4,80080,7773,72307,0.9029345654345654,23.363356444444445,3981.192138666667,12.13067223035364,135,8.100000000000015E-4
3,test_20231101_140134,10188041.png,221231,7117,214114,0.967830005740606,2,4,41731,1011,40720,0.9757734058613501,12.447984,1486.4768053333332,16.409222239124453,135,8.100000000000015E-4
4,test_20231101_140134,10287332.png,216980,9832,207148,0.9546870679325283,2,3,22337,1355,20982,0.9393383175896495,10.154837333333333,1008.1934186666666,18.095365027648654,135,8.100000000000015E-4
5,test_20231101_140134,11610969.png,368720,13662,355058,0.9629474940334128,2,4,84111,2025,82086,0.9759246709705033,35.46244266666667,6281.286944,10.150317274145863,135,8.100000000000015E-4
6,test_20231101_140134,10350842.png,212614,2304,210310,0.9891634605435202,2,3,42529,338,42191,0.9920524818359238,26.483171555555554,4123.517418666666,11.978125274071413,135,8.100000000000015E-4
7,test_20231101_140134,10863862.png,317432,5107,312325,0.9839115149071297,1,4,66058,750,65308,0.9886463410941899,40.688538666666666,7904.047792,9.152308033091979,135,8.100000000000015E-4
8,test_20231101_140134,11382381.png,312486,527,311959,0.9983135244458952,1,3,46745,69,46676,0.9985239063001391,22.832848,2745.811376,13.744096608790418,135,8.100000000000015E-4
9,test_20231101_140134,11079715.png,443815,94572,349243,0.7869112130054189,3,4,124136,13297,110839,0.8928836115228459,18.965763555555554,2647.7406186666667,13.902049229247469,135,8.100000000000015E-4
10,test_20231101_140134,11551286.png,271883,24,271859,0.9999117267353972,1,4,40092,1,40091,0.9999750573680535,24.866876444444443,3470.407338666667,12.72699907819776,135,8.100000000000015E-4
1,test_20231101_140135,10404007.png,502730,11479,491251,0.9771666699818988,1,4,61265,1680,59585,0.9725781441279686,27.133662222222224,3800.1239946666665,12.332825933771614,135,8.200000000000015E-4
2,test_20231101_140135,1254659.png,342646,55142,287504,0.8390700606456809,3,4,80080,7773,72307,0.9029345654345654,23.363356444444445,3981.192138666667,12.13067223035364,135,8.200000000000015E-4
3,test_20231101_140135,10188041.png,221231,7117,214114,0.967830005740606,1,3,41731,1011,40720,0.9757734058613501,12.447984,1486.4768053333332,16.409222239124453,135,8.200000000000015E-4
4,test_20231101_140135,10287332.png,216980,9832,207148,0.9546870679325283,2,3,22337,1355,20982,0.9393383175896495,10.154837333333333,1008.1934186666666,18.095365027648654,135,8.200000000000015E-4
5,test_20231101_140135,11610969.png,368720,13662,355058,0.9629474940334128,2,3,84111,2025,82086,0.9759246709705033,35.46244266666667,6281.286944,10.150317274145863,135,8.200000000000015E-4
6,test_20231101_140135,10350842.png,212614,2304,210310,0.9891634605435202,1,4,42529,338,42191,0.9920524818359238,26.483171555555554,4123.517418666666,11.978125274071413,135,8.200000000000015E-4
7,test_20231101_140135,10863862.png,317432,5107,312325,0.9839115149071297,1,4,66058,750,65308,0.9886463410941899,40.688538666666666,7904.047792,9.152308033091979,135,8.200000000000015E-4
8,test_20231101_140135,11382381.png,312486,527,311959,0.9983135244458952,2,3,46745,69,46676,0.9985239063001391,22.832848,2745.811376,13.744096608790418,135,8.200000000000015E-4
9,test_20231101_140135,11079715.png,443815,94572,349243,0.7869112130054189,3,4,124136,13297,110839,0.8928836115228459,18.965763555555554,2647.7406186666667,13.902049229247469,135,8.200000000000015E-4
10,test_20231101_140135,11551286.png,271883,24,271859,0.9999117267353972,1,3,40092,1,40091,0.9999750573680535,24.866876444444443,3470.407338666667,12.72699907819776,135,8.200000000000015E-4
1,test_20231101_140136,10404007.png,502730,11479,491251,0.9771666699818988,2,3,61265,1680,59585,0.9725781441279686,27.133662222222224,3800.1239946666665,12.332825933771614,135,8.300000000000015E-4
2,test_20231101_140136,1254659.png,342646,55142,287504,0.8390700606456809,3,4,80080,7773,72307,0.9029345654345654,23.363356444444445,3981.192138666667,12.13067223035364,135,8.300000000000015E-4
3,test_20231101_140136,10188041.png,221231,7117,214114,0.967830005740606,2,4,41731,1011,40720,0.9757734058613501,12.447984,1486.4768053333332,16.409222239124453,135,8.300000000000015E-4
4,test_20231101_140136,10287332.png,216980,9832,207148,0.9546870679325283,2,3,22337,1355,20982,0.9393383175896495,10.154837333333333,1008.1934186666666,18.095365027648654,135,8.300000000000015E-4
5,test_20231101_140136,11610969.png,368720,13662,355058,0.9629474940334128,2,4,84111,2025,82086,0.9759246709705033,35.46244266666667,6281.286944,10.150317274145863,135,8.300000000000015E-4
6,test_20231101_140136,10350842.png,212614,2304,210310,0.9891634605435202,1,4,42529,338,42191,0.9920524818359238,26.483171555555554,4123.517418666666,11.978125274071413,135,8.300000000000015E-4
7,test_20231101_140136,10863862.png,317432,5107,312325,0.9839115149071297,1,3,66058,750,65308,0.9886463410941899,40.688538666666666,7904.047792,9.152308033091979,135,8.300000000000015E-4
8,test_20231101_140136,11382381.png,312486,527,311959,0.9983135244458952,1,3,46745,69,46676,0.9985239063001391,22.832848,2745.811376,13.744096608790418,135,8.300000000000015E-4
9,test_20231101_140136,11079715.png,443815,94572,349243,0.7869112130054189,3,4,124136,13297,110839,0.8928836115228459,18.965763555555554,2647.7406186666667,13.902049229247469,135,8.300000000000015E-4
10,test_20231101_140136,11551286.png,271883,24,271859,0.9999117267353972,1,4,40092,1,40091,0.9999750573680535,24.866876444444443,3470.407338666667,12.72699907819776,135,8.300000000000015E-4
1,test_20231101_140136,10404007.png,502730,11479,491251,0.9771666699818988,1,3,61265,1680,59585,0.9725781441279686,27.133662222222224,3800.1239946666665,12.332825933771614,135,8.400000000000016E-4
2,test_20231101_140136,1254659.png,342646,55142,287504,0.8390700606456809,3,4,80080,7773,72307,0.9029345654345654,23.363356444444445,3981.192138666667,12.13067223035364,135,8.400000000000016E-4
3,test_20231101_140136,10188041.png,221231,7117,214114,0.967830005740606,2,4,41731,1011,40720,0.9757734058613501,12.447984,1486.4768053333332,16.409222239124453,135,8.400000000000016E-4
4,test_20231101_140136,10287332.png,216980,9832,207148,0.9546870679325283,2,6,22337,1355,20982,0.9393383175896495,10.154837333333333,1008.1934186666666,18.095365027648654,135,8.400000000000016E-4
5,test_20231101_140136,11610969.png,368720,13662,355058,0.9629474940334128,2,4,84111,2025,82086,0.9759246709705033,35.46244266666667,6281.286944,10.150317274145863,135,8.400000000000016E-4
6,test_20231101_140136,10350842.png,212614,2304,210310,0.9891634605435202,2,3,42529,338,42191,0.9920524818359238,26.483171555555554,4123.517418666666,11.978125274071413,135,8.400000000000016E-4
7,test_20231101_140136,10863862.png,317432,5107,312325,0.9839115149071297,2,4,66058,750,65308,0.9886463410941899,40.688538666666666,7904.047792,9.152308033091979,135,8.400000000000016E-4
8,test_20231101_140136,11382381.png,312486,527,311959,0.9983135244458952,2,3,46745,69,46676,0.9985239063001391,22.832848,2745.811376,13.744096608790418,135,8.400000000000016E-4
9,test_20231101_140136,11079715.png,443815,94572,349243,0.7869112130054189,3,6,124136,13297,110839,0.8928836115228459,18.965763555555554,2647.7406186666667,13.902049229247469,135,8.400000000000016E-4
10,test_20231101_140136,11551286.png,271883,24,271859,0.9999117267353972,1,4,40092,1,40091,0.9999750573680535,24.866876444444443,3470.407338666667,12.72699907819776,135,8.400000000000016E-4
1,test_20231101_140137,10404007.png,502730,11479,491251,0.9771666699818988,2,4,61265,1680,59585,0.9725781441279686,27.133662222222224,3800.1239946666665,12.332825933771614,135,8.500000000000016E-4
2,test_20231101_140137,1254659.png,342646,55142,287504,0.8390700606456809,3,4,80080,7773,72307,0.9029345654345654,23.363356444444445,3981.192138666667,12.13067223035364,135,8.500000000000016E-4
3,test_20231101_140137,10188041.png,221231,7117,214114,0.967830005740606,1,3,41731,1011,40720,0.9757734058613501,12.447984,1486.4768053333332,16.409222239124453,135,8.500000000000016E-4
4,test_20231101_140137,10287332.png,216980,9832,207148,0.9546870679325283,1,3,22337,1355,20982,0.9393383175896495,10.154837333333333,1008.1934186666666,18.095365027648654,135,8.500000000000016E-4
5,test_20231101_140137,11610969.png,368720,13662,355058,0.9629474940334128,2,3,84111,2025,82086,0.9759246709705033,35.46244266666667,6281.286944,10.150317274145863,135,8.500000000000016E-4
6,test_20231101_140137,10350842.png,212614,2304,210310,0.9891634605435202,1,4,42529,338,42191,0.9920524818359238,26.483171555555554,4123.517418666666,11.978125274071413,135,8.500000000000016E-4
7,test_20231101_140137,10863862.png,317432,5107,312325,0.9839115149071297,2,3,66058,750,65308,0.9886463410941899,40.688538666666666,7904.047792,9.152308033091979,135,8.500000000000016E-4
8,test_20231101_140137,11382381.png,312486,527,311959,0.9983135244458952,1,4,46745,69,46676,0.9985239063001391,22.832848,2745.811376,13.744096608790418,135,8.500000000000016E-4
9,test_20231101_140137,11079715.png,443815,94572,349243,0.7869112130054189,3,4,124136,13297,110839,0.8928836115228459,18.965763555555554,2647.7406186666667,13.902049229247469,135,8.500000000000016E-4
10,test_20231101_140137,11551286.png,271883,24,271859,0.9999117267353972,1,4,40092,1,40091,0.9999750573680535,24.866876444444443,3470.407338666667,12.72699907819776,135,8.500000000000016E-4
1,test_20231101_140138,10404007.png,502730,11479,491251,0.9771666699818988,2,4,61265,1680,59585,0.9725781441279686,27.133662222222224,3800.1239946666665,12.332825933771614,135,8.600000000000016E-4
2,test_20231101_140138,1254659.png,342646,55142,287504,0.8390700606456809,2,4,80080,7773,72307,0.9029345654345654,23.363356444444445,3981.192138666667,12.13067223035364,135,8.600000000000016E-4
3,test_20231101_140138,10188041.png,221231,7117,214114,0.967830005740606,2,4,41731,1011,40720,0.9757734058613501,12.447984,1486.4768053333332,16.409222239124453,135,8.600000000000016E-4
4,test_20231101_140138,10287332.png,216980,9832,207148,0.9546870679325283,1,3,22337,1355,20982,0.9393383175896495,10.154837333333333,1008.1934186666666,18.095365027648654,135,8.600000000000016E-4
5,test_20231101_140138,11610969.png,368720,13662,355058,0.9629474940334128,2,3,84111,2025,82086,0.9759246709705033,35.46244266666667,6281.286944,10.150317274145863,135,8.600000000000016E-4
6,test_20231101_140138,10350842.png,212614,2304,210310,0.9891634605435202,1,4,42529,338,42191,0.9920524818359238,26.483171555555554,4123.517418666666,11.978125274071413,135,8.600000000000016E-4
7,test_20231101_140138,10863862.png,317432,5107,312325,0.9839115149071297,2,3,66058,750,65308,0.9886463410941899,40.688538666666666,7904.047792,9.152308033091979,135,8.600000000000016E-4
8,test_20231101_140138,11382381.png,312486,527,311959,0.9983135244458952,2,3,46745,69,46676,0.9985239063001391,22.832848,2745.811376,13.744096608790418,135,8.600000000000016E-4
9,test_20231101_140138,11079715.png,443815,94572,349243,0.7869112130054189,3,4,124136,13297,110839,0.8928836115228459,18.965763555555554,2647.7406186666667,13.902049229247469,135,8.600000000000016E-4
10,test_20231101_140138,11551286.png,271883,24,271859,0.9999117267353972,1,4,40092,1,40091,0.9999750573680535,24.866876444444443,3470.407338666667,12.72699907819776,135,8.600000000000016E-4
1,test_20231101_140138,10404007.png,502730,11479,491251,0.9771666699818988,2,4,61265,1680,59585,0.9725781441279686,27.133662222222224,3800.1239946666665,12.332825933771614,135,8.700000000000016E-4
2,test_20231101_140138,1254659.png,342646,55142,287504,0.8390700606456809,3,4,80080,7773,72307,0.9029345654345654,23.363356444444445,3981.192138666667,12.13067223035364,135,8.700000000000016E-4
3,test_20231101_140138,10188041.png,221231,7117,214114,0.967830005740606,2,3,41731,1011,40720,0.9757734058613501,12.447984,1486.4768053333332,16.409222239124453,135,8.700000000000016E-4
4,test_20231101_140138,10287332.png,216980,9832,207148,0.9546870679325283,2,4,22337,1355,20982,0.9393383175896495,10.154837333333333,1008.1934186666666,18.095365027648654,135,8.700000000000016E-4
5,test_20231101_140138,11610969.png,368720,13662,355058,0.9629474940334128,2,4,84111,2025,82086,0.9759246709705033,35.46244266666667,6281.286944,10.150317274145863,135,8.700000000000016E-4
6,test_20231101_140138,10350842.png,212614,2304,210310,0.9891634605435202,2,4,42529,338,42191,0.9920524818359238,26.483171555555554,4123.517418666666,11.978125274071413,135,8.700000000000016E-4
7,test_20231101_140138,10863862.png,317432,5107,312325,0.9839115149071297,1,3,66058,750,65308,0.9886463410941899,40.688538666666666,7904.047792,9.152308033091979,135,8.700000000000016E-4
8,test_20231101_140138,11382381.png,312486,527,311959,0.9983135244458952,1,4,46745,69,46676,0.9985239063001391,22.832848,2745.811376,13.744096608790418,135,8.700000000000016E-4
9,test_20231101_140138,11079715.png,443815,94572,349243,0.7869112130054189,3,4,124136,13297,110839,0.8928836115228459,18.965763555555554,2647.7406186666667,13.902049229247469,135,8.700000000000016E-4
10,test_20231101_140138,11551286.png,271883,24,271859,0.9999117267353972,0,4,40092,1,40091,0.9999750573680535,24.866876444444443,3470.407338666667,12.72699907819776,135,8.700000000000016E-4
1,test_20231101_140139,10404007.png,502730,11479,491251,0.9771666699818988,2,4,61265,1680,59585,0.9725781441279686,27.133662222222224,3800.1239946666665,12.332825933771614,135,8.800000000000017E-4
2,test_20231101_140139,1254659.png,342646,55142,287504,0.8390700606456809,2,4,80080,7773,72307,0.9029345654345654,23.363356444444445,3981.192138666667,12.13067223035364,135,8.800000000000017E-4
3,test_20231101_140139,10188041.png,221231,7117,214114,0.967830005740606,2,4,41731,1011,40720,0.9757734058613501,12.447984,1486.4768053333332,16.409222239124453,135,8.800000000000017E-4
4,test_20231101_140139,10287332.png,216980,9832,207148,0.9546870679325283,2,4,22337,1355,20982,0.9393383175896495,10.154837333333333,1008.1934186666666,18.095365027648654,135,8.800000000000017E-4
5,test_20231101_140139,11610969.png,368720,13662,355058,0.9629474940334128,2,3,84111,2025,82086,0.9759246709705033,35.46244266666667,6281.286944,10.150317274145863,135,8.800000000000017E-4
6,test_20231101_140139,10350842.png,212614,2304,210310,0.9891634605435202,1,4,42529,338,42191,0.9920524818359238,26.483171555555554,4123.517418666666,11.978125274071413,135,8.800000000000017E-4
7,test_20231101_140139,10863862.png,317432,5107,312325,0.9839115149071297,1,3,66058,750,65308,0.9886463410941899,40.688538666666666,7904.047792,9.152308033091979,135,8.800000000000017E-4
8,test_20231101_140139,11382381.png,312486,527,311959,0.9983135244458952,2,4,46745,69,46676,0.9985239063001391,22.832848,2745.811376,13.744096608790418,135,8.800000000000017E-4
9,test_20231101_140139,11079715.png,443815,94572,349243,0.7869112130054189,4,4,124136,13297,110839,0.8928836115228459,18.965763555555554,2647.7406186666667,13.902049229247469,135,8.800000000000017E-4
10,test_20231101_140139,11551286.png,271883,24,271859,0.9999117267353972,1,4,40092,1,40091,0.9999750573680535,24.866876444444443,3470.407338666667,12.72699907819776,135,8.800000000000017E-4
1,test_20231101_140140,10404007.png,502730,11479,491251,0.9771666699818988,2,4,61265,1680,59585,0.9725781441279686,27.133662222222224,3800.1239946666665,12.332825933771614,135,8.900000000000017E-4
2,test_20231101_140140,1254659.png,342646,55142,287504,0.8390700606456809,3,4,80080,7773,72307,0.9029345654345654,23.363356444444445,3981.192138666667,12.13067223035364,135,8.900000000000017E-4
3,test_20231101_140140,10188041.png,221231,7117,214114,0.967830005740606,2,4,41731,1011,40720,0.9757734058613501,12.447984,1486.4768053333332,16.409222239124453,135,8.900000000000017E-4
4,test_20231101_140140,10287332.png,216980,9832,207148,0.9546870679325283,1,3,22337,1355,20982,0.9393383175896495,10.154837333333333,1008.1934186666666,18.095365027648654,135,8.900000000000017E-4
5,test_20231101_140140,11610969.png,368720,13662,355058,0.9629474940334128,2,4,84111,2025,82086,0.9759246709705033,35.46244266666667,6281.286944,10.150317274145863,135,8.900000000000017E-4
6,test_20231101_140140,10350842.png,212614,2304,210310,0.9891634605435202,4,4,42529,338,42191,0.9920524818359238,26.483171555555554,4123.517418666666,11.978125274071413,135,8.900000000000017E-4
7,test_20231101_140140,10863862.png,317432,5107,312325,0.9839115149071297,1,3,66058,750,65308,0.9886463410941899,40.688538666666666,7904.047792,9.152308033091979,135,8.900000000000017E-4
8,test_20231101_140140,11382381.png,312486,527,311959,0.9983135244458952,2,3,46745,69,46676,0.9985239063001391,22.832848,2745.811376,13.744096608790418,135,8.900000000000017E-4
9,test_20231101_140140,11079715.png,443815,94572,349243,0.7869112130054189,3,5,124136,13297,110839,0.8928836115228459,18.965763555555554,2647.7406186666667,13.902049229247469,135,8.900000000000017E-4
10,test_20231101_140140,11551286.png,271883,24,271859,0.9999117267353972,1,4,40092,1,40091,0.9999750573680535,24.866876444444443,3470.407338666667,12.72699907819776,135,8.900000000000017E-4
1,test_20231101_140140,10404007.png,502730,11479,491251,0.9771666699818988,2,4,61265,1680,59585,0.9725781441279686,27.133662222222224,3800.1239946666665,12.332825933771614,135,9.000000000000017E-4
2,test_20231101_140140,1254659.png,342646,55142,287504,0.8390700606456809,3,4,80080,7773,72307,0.9029345654345654,23.363356444444445,3981.192138666667,12.13067223035364,135,9.000000000000017E-4
3,test_20231101_140140,10188041.png,221231,7117,214114,0.967830005740606,2,3,41731,1011,40720,0.9757734058613501,12.447984,1486.4768053333332,16.409222239124453,135,9.000000000000017E-4
4,test_20231101_140140,10287332.png,216980,9832,207148,0.9546870679325283,2,4,22337,1355,20982,0.9393383175896495,10.154837333333333,1008.1934186666666,18.095365027648654,135,9.000000000000017E-4
5,test_20231101_140140,11610969.png,368720,13662,355058,0.9629474940334128,2,3,84111,2025,82086,0.9759246709705033,35.46244266666667,6281.286944,10.150317274145863,135,9.000000000000017E-4
6,test_20231101_140140,10350842.png,212614,2304,210310,0.9891634605435202,1,4,42529,338,42191,0.9920524818359238,26.483171555555554,4123.517418666666,11.978125274071413,135,9.000000000000017E-4
7,test_20231101_140140,10863862.png,317432,5107,312325,0.9839115149071297,1,4,66058,750,65308,0.9886463410941899,40.688538666666666,7904.047792,9.152308033091979,135,9.000000000000017E-4
8,test_20231101_140140,11382381.png,312486,527,311959,0.9983135244458952,2,3,46745,69,46676,0.9985239063001391,22.832848,2745.811376,13.744096608790418,135,9.000000000000017E-4
9,test_20231101_140140,11079715.png,443815,94572,349243,0.7869112130054189,3,4,124136,13297,110839,0.8928836115228459,18.965763555555554,2647.7406186666667,13.902049229247469,135,9.000000000000017E-4
10,test_20231101_140140,11551286.png,271883,24,271859,0.9999117267353972,0,4,40092,1,40091,0.9999750573680535,24.866876444444443,3470.407338666667,12.72699907819776,135,9.000000000000017E-4
1,test_20231101_140141,10404007.png,502730,11479,491251,0.9771666699818988,2,13,61265,1680,59585,0.9725781441279686,27.133662222222224,3800.1239946666665,12.332825933771614,135,9.100000000000017E-4
2,test_20231101_140141,1254659.png,342646,55142,287504,0.8390700606456809,4,4,80080,7773,72307,0.9029345654345654,23.363356444444445,3981.192138666667,12.13067223035364,135,9.100000000000017E-4
3,test_20231101_140141,10188041.png,221231,7117,214114,0.967830005740606,2,4,41731,1011,40720,0.9757734058613501,12.447984,1486.4768053333332,16.409222239124453,135,9.100000000000017E-4
4,test_20231101_140141,10287332.png,216980,9832,207148,0.9546870679325283,1,4,22337,1355,20982,0.9393383175896495,10.154837333333333,1008.1934186666666,18.095365027648654,135,9.100000000000017E-4
5,test_20231101_140141,11610969.png,368720,13662,355058,0.9629474940334128,2,4,84111,2025,82086,0.9759246709705033,35.46244266666667,6281.286944,10.150317274145863,135,9.100000000000017E-4
6,test_20231101_140141,10350842.png,212614,2304,210310,0.9891634605435202,1,4,42529,338,42191,0.9920524818359238,26.483171555555554,4123.517418666666,11.978125274071413,135,9.100000000000017E-4
7,test_20231101_140141,10863862.png,317432,5107,312325,0.9839115149071297,1,4,66058,750,65308,0.9886463410941899,40.688538666666666,7904.047792,9.152308033091979,135,9.100000000000017E-4
8,test_20231101_140141,11382381.png,312486,527,311959,0.9983135244458952,1,3,46745,69,46676,0.9985239063001391,22.832848,2745.811376,13.744096608790418,135,9.100000000000017E-4
9,test_20231101_140141,11079715.png,443815,94572,349243,0.7869112130054189,3,4,124136,13297,110839,0.8928836115228459,18.965763555555554,2647.7406186666667,13.902049229247469,135,9.100000000000017E-4
10,test_20231101_140141,11551286.png,271883,24,271859,0.9999117267353972,1,4,40092,1,40091,0.9999750573680535,24.866876444444443,3470.407338666667,12.72699907819776,135,9.100000000000017E-4
1,test_20231101_140142,10404007.png,502730,11479,491251,0.9771666699818988,2,3,61265,1680,59585,0.9725781441279686,27.133662222222224,3800.1239946666665,12.332825933771614,135,9.200000000000018E-4
2,test_20231101_140142,1254659.png,342646,55142,287504,0.8390700606456809,3,4,80080,7773,72307,0.9029345654345654,23.363356444444445,3981.192138666667,12.13067223035364,135,9.200000000000018E-4
3,test_20231101_140142,10188041.png,221231,7117,214114,0.967830005740606,2,4,41731,1011,40720,0.9757734058613501,12.447984,1486.4768053333332,16.409222239124453,135,9.200000000000018E-4
4,test_20231101_140142,10287332.png,216980,9832,207148,0.9546870679325283,1,3,22337,1355,20982,0.9393383175896495,10.154837333333333,1008.1934186666666,18.095365027648654,135,9.200000000000018E-4
5,test_20231101_140142,11610969.png,368720,13662,355058,0.9629474940334128,2,3,84111,2025,82086,0.9759246709705033,35.46244266666667,6281.286944,10.150317274145863,135,9.200000000000018E-4
6,test_20231101_140142,10350842.png,212614,2304,210310,0.9891634605435202,1,4,42529,338,42191,0.9920524818359238,26.483171555555554,4123.517418666666,11.978125274071413,135,9.200000000000018E-4
7,test_20231101_140142,10863862.png,317432,5107,312325,0.9839115149071297,2,4,66058,750,65308,0.9886463410941899,40.688538666666666,7904.047792,9.152308033091979,135,9.200000000000018E-4
8,test_20231101_140142,11382381.png,312486,527,311959,0.9983135244458952,1,4,46745,69,46676,0.9985239063001391,22.832848,2745.811376,13.744096608790418,135,9.200000000000018E-4
9,test_20231101_140142,11079715.png,443815,94572,349243,0.7869112130054189,3,4,124136,13297,110839,0.8928836115228459,18.965763555555554,2647.7406186666667,13.902049229247469,135,9.200000000000018E-4
10,test_20231101_140142,11551286.png,271883,24,271859,0.9999117267353972,1,4,40092,1,40091,0.9999750573680535,24.866876444444443,3470.407338666667,12.72699907819776,135,9.200000000000018E-4
1,test_20231101_140142,10404007.png,502730,11479,491251,0.9771666699818988,2,4,61265,1680,59585,0.9725781441279686,27.133662222222224,3800.1239946666665,12.332825933771614,135,9.300000000000018E-4
2,test_20231101_140142,1254659.png,342646,55142,287504,0.8390700606456809,3,5,80080,7773,72307,0.9029345654345654,23.363356444444445,3981.192138666667,12.13067223035364,135,9.300000000000018E-4
3,test_20231101_140142,10188041.png,221231,7117,214114,0.967830005740606,2,4,41731,1011,40720,0.9757734058613501,12.447984,1486.4768053333332,16.409222239124453,135,9.300000000000018E-4
4,test_20231101_140142,10287332.png,216980,9832,207148,0.9546870679325283,1,3,22337,1355,20982,0.9393383175896495,10.154837333333333,1008.1934186666666,18.095365027648654,135,9.300000000000018E-4
5,test_20231101_140142,11610969.png,368720,13662,355058,0.9629474940334128,3,3,84111,2025,82086,0.9759246709705033,35.46244266666667,6281.286944,10.150317274145863,135,9.300000000000018E-4
6,test_20231101_140142,10350842.png,212614,2304,210310,0.9891634605435202,1,4,42529,338,42191,0.9920524818359238,26.483171555555554,4123.517418666666,11.978125274071413,135,9.300000000000018E-4
7,test_20231101_140142,10863862.png,317432,5107,312325,0.9839115149071297,1,4,66058,750,65308,0.9886463410941899,40.688538666666666,7904.047792,9.152308033091979,135,9.300000000000018E-4
8,test_20231101_140142,11382381.png,312486,527,311959,0.9983135244458952,1,4,46745,69,46676,0.9985239063001391,22.832848,2745.811376,13.744096608790418,135,9.300000000000018E-4
9,test_20231101_140142,11079715.png,443815,94572,349243,0.7869112130054189,3,4,124136,13297,110839,0.8928836115228459,18.965763555555554,2647.7406186666667,13.902049229247469,135,9.300000000000018E-4
10,test_20231101_140142,11551286.png,271883,24,271859,0.9999117267353972,0,3,40092,1,40091,0.9999750573680535,24.866876444444443,3470.407338666667,12.72699907819776,135,9.300000000000018E-4
1,test_20231101_140143,10404007.png,502730,11479,491251,0.9771666699818988,2,3,61265,1680,59585,0.9725781441279686,27.133662222222224,3800.1239946666665,12.332825933771614,135,9.400000000000018E-4
2,test_20231101_140143,1254659.png,342646,55142,287504,0.8390700606456809,2,3,80080,7773,72307,0.9029345654345654,23.363356444444445,3981.192138666667,12.13067223035364,135,9.400000000000018E-4
3,test_20231101_140143,10188041.png,221231,7117,214114,0.967830005740606,2,4,41731,1011,40720,0.9757734058613501,12.447984,1486.4768053333332,16.409222239124453,135,9.400000000000018E-4
4,test_20231101_140143,10287332.png,216980,9832,207148,0.9546870679325283,2,4,22337,1355,20982,0.9393383175896495,10.154837333333333,1008.1934186666666,18.095365027648654,135,9.400000000000018E-4
5,test_20231101_140143,11610969.png,368720,13662,355058,0.9629474940334128,2,4,84111,2025,82086,0.9759246709705033,35.46244266666667,6281.286944,10.150317274145863,135,9.400000000000018E-4
6,test_20231101_140143,10350842.png,212614,2304,210310,0.9891634605435202,1,4,42529,338,42191,0.9920524818359238,26.483171555555554,4123.517418666666,11.978125274071413,135,9.400000000000018E-4
7,test_20231101_140143,10863862.png,317432,5107,312325,0.9839115149071297,2,4,66058,750,65308,0.9886463410941899,40.688538666666666,7904.047792,9.152308033091979,135,9.400000000000018E-4
8,test_20231101_140143,11382381.png,312486,527,311959,0.9983135244458952,1,3,46745,69,46676,0.9985239063001391,22.832848,2745.811376,13.744096608790418,135,9.400000000000018E-4
9,test_20231101_140143,11079715.png,443815,94572,349243,0.7869112130054189,4,4,124136,13297,110839,0.8928836115228459,18.965763555555554,2647.7406186666667,13.902049229247469,135,9.400000000000018E-4
10,test_20231101_140143,11551286.png,271883,24,271859,0.9999117267353972,0,9,40092,1,40091,0.9999750573680535,24.866876444444443,3470.407338666667,12.72699907819776,135,9.400000000000018E-4
1,test_20231101_140144,10404007.png,502730,11479,491251,0.9771666699818988,2,4,61265,1680,59585,0.9725781441279686,27.133662222222224,3800.1239946666665,12.332825933771614,135,9.500000000000018E-4
2,test_20231101_140144,1254659.png,342646,55142,287504,0.8390700606456809,3,12,80080,7773,72307,0.9029345654345654,23.363356444444445,3981.192138666667,12.13067223035364,135,9.500000000000018E-4
3,test_20231101_140144,10188041.png,221231,7117,214114,0.967830005740606,2,4,41731,1011,40720,0.9757734058613501,12.447984,1486.4768053333332,16.409222239124453,135,9.500000000000018E-4
4,test_20231101_140144,10287332.png,216980,9832,207148,0.9546870679325283,3,4,22337,1355,20982,0.9393383175896495,10.154837333333333,1008.1934186666666,18.095365027648654,135,9.500000000000018E-4
5,test_20231101_140144,11610969.png,368720,13662,355058,0.9629474940334128,2,3,84111,2025,82086,0.9759246709705033,35.46244266666667,6281.286944,10.150317274145863,135,9.500000000000018E-4
6,test_20231101_140144,10350842.png,212614,2304,210310,0.9891634605435202,1,3,42529,338,42191,0.9920524818359238,26.483171555555554,4123.517418666666,11.978125274071413,135,9.500000000000018E-4
7,test_20231101_140144,10863862.png,317432,5107,312325,0.9839115149071297,1,11,66058,750,65308,0.9886463410941899,40.688538666666666,7904.047792,9.152308033091979,135,9.500000000000018E-4
8,test_20231101_140144,11382381.png,312486,527,311959,0.9983135244458952,1,3,46745,69,46676,0.9985239063001391,22.832848,2745.811376,13.744096608790418,135,9.500000000000018E-4
9,test_20231101_140144,11079715.png,443815,94572,349243,0.7869112130054189,4,4,124136,13297,110839,0.8928836115228459,18.965763555555554,2647.7406186666667,13.902049229247469,135,9.500000000000018E-4
10,test_20231101_140144,11551286.png,271883,24,271859,0.9999117267353972,1,4,40092,1,40091,0.9999750573680535,24.866876444444443,3470.407338666667,12.72699907819776,135,9.500000000000018E-4
1,test_20231101_140145,10404007.png,502730,11479,491251,0.9771666699818988,2,4,61265,1680,59585,0.9725781441279686,27.133662222222224,3800.1239946666665,12.332825933771614,135,9.600000000000019E-4
2,test_20231101_140145,1254659.png,342646,55142,287504,0.8390700606456809,5,12,80080,7773,72307,0.9029345654345654,23.363356444444445,3981.192138666667,12.13067223035364,135,9.600000000000019E-4
3,test_20231101_140145,10188041.png,221231,7117,214114,0.967830005740606,2,4,41731,1011,40720,0.9757734058613501,12.447984,1486.4768053333332,16.409222239124453,135,9.600000000000019E-4
4,test_20231101_140145,10287332.png,216980,9832,207148,0.9546870679325283,2,3,22337,1355,20982,0.9393383175896495,10.154837333333333,1008.1934186666666,18.095365027648654,135,9.600000000000019E-4
5,test_20231101_140145,11610969.png,368720,13662,355058,0.9629474940334128,2,4,84111,2025,82086,0.9759246709705033,35.46244266666667,6281.286944,10.150317274145863,135,9.600000000000019E-4
6,test_20231101_140145,10350842.png,212614,2304,210310,0.9891634605435202,2,4,42529,338,42191,0.9920524818359238,26.483171555555554,4123.517418666666,11.978125274071413,135,9.600000000000019E-4
7,test_20231101_140145,10863862.png,317432,5107,312325,0.9839115149071297,2,11,66058,750,65308,0.9886463410941899,40.688538666666666,7904.047792,9.152308033091979,135,9.600000000000019E-4
8,test_20231101_140145,11382381.png,312486,527,311959,0.9983135244458952,1,3,46745,69,46676,0.9985239063001391,22.832848,2745.811376,13.744096608790418,135,9.600000000000019E-4
9,test_20231101_140145,11079715.png,443815,94572,349243,0.7869112130054189,3,4,124136,13297,110839,0.8928836115228459,18.965763555555554,2647.7406186666667,13.902049229247469,135,9.600000000000019E-4
10,test_20231101_140145,11551286.png,271883,24,271859,0.9999117267353972,1,4,40092,1,40091,0.9999750573680535,24.866876444444443,3470.407338666667,12.72699907819776,135,9.600000000000019E-4
1,test_20231101_140145,10404007.png,502730,11479,491251,0.9771666699818988,2,4,61265,1680,59585,0.9725781441279686,27.133662222222224,3800.1239946666665,12.332825933771614,135,9.700000000000019E-4
2,test_20231101_140145,1254659.png,342646,55142,287504,0.8390700606456809,3,4,80080,7773,72307,0.9029345654345654,23.363356444444445,3981.192138666667,12.13067223035364,135,9.700000000000019E-4
3,test_20231101_140145,10188041.png,221231,7117,214114,0.967830005740606,2,4,41731,1011,40720,0.9757734058613501,12.447984,1486.4768053333332,16.409222239124453,135,9.700000000000019E-4
4,test_20231101_140145,10287332.png,216980,9832,207148,0.9546870679325283,1,4,22337,1355,20982,0.9393383175896495,10.154837333333333,1008.1934186666666,18.095365027648654,135,9.700000000000019E-4
5,test_20231101_140145,11610969.png,368720,13662,355058,0.9629474940334128,2,4,84111,2025,82086,0.9759246709705033,35.46244266666667,6281.286944,10.150317274145863,135,9.700000000000019E-4
6,test_20231101_140145,10350842.png,212614,2304,210310,0.9891634605435202,1,3,42529,338,42191,0.9920524818359238,26.483171555555554,4123.517418666666,11.978125274071413,135,9.700000000000019E-4
7,test_20231101_140145,10863862.png,317432,5107,312325,0.9839115149071297,1,3,66058,750,65308,0.9886463410941899,40.688538666666666,7904.047792,9.152308033091979,135,9.700000000000019E-4
8,test_20231101_140145,11382381.png,312486,527,311959,0.9983135244458952,1,3,46745,69,46676,0.9985239063001391,22.832848,2745.811376,13.744096608790418,135,9.700000000000019E-4
9,test_20231101_140145,11079715.png,443815,94572,349243,0.7869112130054189,3,4,124136,13297,110839,0.8928836115228459,18.965763555555554,2647.7406186666667,13.902049229247469,135,9.700000000000019E-4
10,test_20231101_140145,11551286.png,271883,24,271859,0.9999117267353972,0,3,40092,1,40091,0.9999750573680535,24.866876444444443,3470.407338666667,12.72699907819776,135,9.700000000000019E-4
1,test_20231101_140146,10404007.png,502730,10817,491913,0.9784834801981183,2,4,61265,1583,59682,0.9741614298539133,27.20249422222222,3819.834032,12.310358672107643,135,9.80000000000002E-4
2,test_20231101_140146,1254659.png,342646,54842,287804,0.8399455998318965,3,4,80080,7738,72342,0.9033716283716284,23.519498666666667,4019.802944,12.08875596945386,135,9.80000000000002E-4
3,test_20231101_140146,10188041.png,221231,6937,214294,0.9686436349336214,2,4,41731,992,40739,0.976228702882749,12.537249777777777,1506.007792,16.352531419820806,135,9.80000000000002E-4
4,test_20231101_140146,10287332.png,216980,9752,207228,0.9550557655083418,1,3,22337,1343,20994,0.9398755428213278,10.180398222222221,1012.363392,18.077439285893636,135,9.80000000000002E-4
5,test_20231101_140146,11610969.png,368720,13459,355261,0.9634980472987633,2,4,84111,1996,82115,0.9762694534603084,35.602016,6305.765109333333,10.13342571687286,135,9.80000000000002E-4
6,test_20231101_140146,10350842.png,212614,2244,210370,0.989445662091866,1,4,42529,329,42200,0.9922641021420677,26.49875911111111,4126.1278293333335,11.97537682380042,135,9.80000000000002E-4
7,test_20231101_140146,10863862.png,317432,4807,312625,0.9848565992086494,1,4,66058,705,65353,0.9893275606285385,40.76568,7923.938661333334,9.141392558322396,135,9.80000000000002E-4
8,test_20231101_140146,11382381.png,312486,367,312119,0.9988255473845228,2,3,46745,48,46697,0.9989731522087923,23.28773511111111,2886.24232,13.527475705549977,135,9.80000000000002E-4
9,test_20231101_140146,11079715.png,443815,94472,349343,0.7871365321136059,3,4,124136,13287,110849,0.8929641683315074,19.00316088888889,2652.673792,13.89396514219478,135,9.80000000000002E-4
10,test_20231101_140146,11551286.png,271883,24,271859,0.9999117267353972,0,4,40092,1,40091,0.9999750573680535,24.866876444444443,3470.407338666667,12.72699907819776,135,9.80000000000002E-4
1,test_20231101_140147,10404007.png,502730,10817,491913,0.9784834801981183,2,4,61265,1583,59682,0.9741614298539133,27.20249422222222,3819.834032,12.310358672107643,135,9.90000000000002E-4
2,test_20231101_140147,1254659.png,342646,54842,287804,0.8399455998318965,2,3,80080,7738,72342,0.9033716283716284,23.519498666666667,4019.802944,12.08875596945386,135,9.90000000000002E-4
3,test_20231101_140147,10188041.png,221231,6937,214294,0.9686436349336214,2,3,41731,992,40739,0.976228702882749,12.537249777777777,1506.007792,16.352531419820806,135,9.90000000000002E-4
4,test_20231101_140147,10287332.png,216980,9752,207228,0.9550557655083418,1,3,22337,1343,20994,0.9398755428213278,10.180398222222221,1012.363392,18.077439285893636,135,9.90000000000002E-4
5,test_20231101_140147,11610969.png,368720,13459,355261,0.9634980472987633,2,4,84111,1996,82115,0.9762694534603084,35.602016,6305.765109333333,10.13342571687286,135,9.90000000000002E-4
6,test_20231101_140147,10350842.png,212614,2244,210370,0.989445662091866,2,4,42529,329,42200,0.9922641021420677,26.49875911111111,4126.1278293333335,11.97537682380042,135,9.90000000000002E-4
7,test_20231101_140147,10863862.png,317432,4807,312625,0.9848565992086494,1,3,66058,705,65353,0.9893275606285385,40.76568,7923.938661333334,9.141392558322396,135,9.90000000000002E-4
8,test_20231101_140147,11382381.png,312486,367,312119,0.9988255473845228,1,3,46745,48,46697,0.9989731522087923,23.28773511111111,2886.24232,13.527475705549977,135,9.90000000000002E-4
9,test_20231101_140147,11079715.png,443815,94472,349343,0.7871365321136059,3,4,124136,13287,110849,0.8929641683315074,19.00316088888889,2652.673792,13.89396514219478,135,9.90000000000002E-4
10,test_20231101_140147,11551286.png,271883,24,271859,0.9999117267353972,0,3,40092,1,40091,0.9999750573680535,24.866876444444443,3470.407338666667,12.72699907819776,135,9.90000000000002E-4
1,test_20231101_140147,10404007.png,502730,11682,491048,0.9767628747041155,2,3,61265,1709,59556,0.972104790663511,26.58351822222222,3681.7308106666665,12.470283289312524,136,0.0
2,test_20231101_140147,1254659.png,342646,52719,289927,0.8461414988063483,2,4,80080,7444,72636,0.907042957042957,23.99747911111111,4207.514922666666,11.890546959181364,136,0.0
3,test_20231101_140147,10188041.png,221231,7037,214194,0.9681916187152795,2,3,41731,998,40733,0.9760849248759915,12.408926222222222,1533.9216373333334,16.272771872673378,136,0.0
4,test_20231101_140147,10287332.png,216980,8254,208726,0.9619596276154484,2,3,22337,1132,21205,0.949321753145006,11.671928888888889,1532.94096,16.275549321974697,136,0.0
5,test_20231101_140147,11610969.png,368720,16032,352688,0.9565198524625732,2,4,84111,2360,81751,0.9719418387606853,24.42743111111111,3678.597184,12.473981268133281,136,0.0
6,test_20231101_140147,10350842.png,212614,3372,209242,0.9841402729829645,1,4,42529,496,42033,0.9883373697947283,21.076389333333335,2761.394149333333,13.719519605077451,136,0.0
7,test_20231101_140147,10863862.png,317432,5832,311600,0.9816275611784571,1,3,66058,856,65202,0.9870416906355022,36.069536,6613.262826666667,9.926645779336518,136,0.0
8,test_20231101_140147,11382381.png,312486,667,311819,0.997865504374596,2,4,46745,93,46652,0.9980104824045353,20.769573333333334,2445.751248,14.246680770615956,136,0.0
9,test_20231101_140147,11079715.png,443815,92442,351373,0.7917105100098014,3,4,124136,13015,111121,0.8951553135270993,18.872316444444444,2645.8680106666666,13.905121852903795,136,0.0
10,test_20231101_140147,11551286.png,271883,517,271366,0.9980984467583482,1,3,40092,74,40018,0.9981542452359573,17.526147555555557,1807.59504,15.559792199013692,136,0.0
1,test_20231101_140148,10404007.png,502730,11682,491048,0.9767628747041155,2,4,61265,1709,59556,0.972104790663511,26.58351822222222,3681.7308106666665,12.470283289312524,136,1.0E-5
2,test_20231101_140148,1254659.png,342646,52719,289927,0.8461414988063483,3,4,80080,7444,72636,0.907042957042957,23.99747911111111,4207.514922666666,11.890546959181364,136,1.0E-5
3,test_20231101_140148,10188041.png,221231,7037,214194,0.9681916187152795,2,3,41731,998,40733,0.9760849248759915,12.408926222222222,1533.9216373333334,16.272771872673378,136,1.0E-5
4,test_20231101_140148,10287332.png,216980,8254,208726,0.9619596276154484,2,4,22337,1132,21205,0.949321753145006,11.671928888888889,1532.94096,16.275549321974697,136,1.0E-5
5,test_20231101_140148,11610969.png,368720,16032,352688,0.9565198524625732,2,3,84111,2360,81751,0.9719418387606853,24.42743111111111,3678.597184,12.473981268133281,136,1.0E-5
6,test_20231101_140148,10350842.png,212614,3372,209242,0.9841402729829645,2,3,42529,496,42033,0.9883373697947283,21.076389333333335,2761.394149333333,13.719519605077451,136,1.0E-5
7,test_20231101_140148,10863862.png,317432,5832,311600,0.9816275611784571,1,3,66058,856,65202,0.9870416906355022,36.069536,6613.262826666667,9.926645779336518,136,1.0E-5
8,test_20231101_140148,11382381.png,312486,667,311819,0.997865504374596,1,3,46745,93,46652,0.9980104824045353,20.769573333333334,2445.751248,14.246680770615956,136,1.0E-5
9,test_20231101_140148,11079715.png,443815,92442,351373,0.7917105100098014,3,4,124136,13015,111121,0.8951553135270993,18.872316444444444,2645.8680106666666,13.905121852903795,136,1.0E-5
10,test_20231101_140148,11551286.png,271883,517,271366,0.9980984467583482,2,4,40092,74,40018,0.9981542452359573,17.526147555555557,1807.59504,15.559792199013692,136,1.0E-5
1,test_20231101_140149,10404007.png,502730,11682,491048,0.9767628747041155,2,3,61265,1709,59556,0.972104790663511,26.58351822222222,3681.7308106666665,12.470283289312524,136,2.0E-5
2,test_20231101_140149,1254659.png,342646,52719,289927,0.8461414988063483,3,4,80080,7444,72636,0.907042957042957,23.99747911111111,4207.514922666666,11.890546959181364,136,2.0E-5
3,test_20231101_140149,10188041.png,221231,7037,214194,0.9681916187152795,2,4,41731,998,40733,0.9760849248759915,12.408926222222222,1533.9216373333334,16.272771872673378,136,2.0E-5
4,test_20231101_140149,10287332.png,216980,8254,208726,0.9619596276154484,1,3,22337,1132,21205,0.949321753145006,11.671928888888889,1532.94096,16.275549321974697,136,2.0E-5
5,test_20231101_140149,11610969.png,368720,16032,352688,0.9565198524625732,2,4,84111,2360,81751,0.9719418387606853,24.42743111111111,3678.597184,12.473981268133281,136,2.0E-5
6,test_20231101_140149,10350842.png,212614,3372,209242,0.9841402729829645,2,4,42529,496,42033,0.9883373697947283,21.076389333333335,2761.394149333333,13.719519605077451,136,2.0E-5
7,test_20231101_140149,10863862.png,317432,5832,311600,0.9816275611784571,2,4,66058,856,65202,0.9870416906355022,36.069536,6613.262826666667,9.926645779336518,136,2.0E-5
8,test_20231101_140149,11382381.png,312486,657,311829,0.9978975058082602,2,4,46745,92,46653,0.9980318750668521,21.49939022222222,2544.312058666667,14.075099846126175,136,2.0E-5
9,test_20231101_140149,11079715.png,443815,92442,351373,0.7917105100098014,3,5,124136,13015,111121,0.8951553135270993,18.872316444444444,2645.8680106666666,13.905121852903795,136,2.0E-5
10,test_20231101_140149,11551286.png,271883,517,271366,0.9980984467583482,2,3,40092,74,40018,0.9981542452359573,17.526147555555557,1807.59504,15.559792199013692,136,2.0E-5
1,test_20231101_140149,10404007.png,502730,11682,491048,0.9767628747041155,2,4,61265,1709,59556,0.972104790663511,26.58351822222222,3681.7308106666665,12.470283289312524,136,3.0000000000000004E-5
2,test_20231101_140149,1254659.png,342646,52719,289927,0.8461414988063483,3,4,80080,7444,72636,0.907042957042957,23.99747911111111,4207.514922666666,11.890546959181364,136,3.0000000000000004E-5
3,test_20231101_140149,10188041.png,221231,7037,214194,0.9681916187152795,2,5,41731,998,40733,0.9760849248759915,12.408926222222222,1533.9216373333334,16.272771872673378,136,3.0000000000000004E-5
4,test_20231101_140149,10287332.png,216980,8254,208726,0.9619596276154484,1,3,22337,1132,21205,0.949321753145006,11.671928888888889,1532.94096,16.275549321974697,136,3.0000000000000004E-5
5,test_20231101_140149,11610969.png,368720,16032,352688,0.9565198524625732,2,3,84111,2360,81751,0.9719418387606853,24.42743111111111,3678.597184,12.473981268133281,136,3.0000000000000004E-5
6,test_20231101_140149,10350842.png,212614,3372,209242,0.9841402729829645,1,4,42529,496,42033,0.9883373697947283,21.076389333333335,2761.394149333333,13.719519605077451,136,3.0000000000000004E-5
7,test_20231101_140149,10863862.png,317432,5832,311600,0.9816275611784571,2,3,66058,856,65202,0.9870416906355022,36.069536,6613.262826666667,9.926645779336518,136,3.0000000000000004E-5
8,test_20231101_140149,11382381.png,312486,657,311829,0.9978975058082602,1,3,46745,92,46653,0.9980318750668521,21.49939022222222,2544.312058666667,14.075099846126175,136,3.0000000000000004E-5
9,test_20231101_140149,11079715.png,443815,92442,351373,0.7917105100098014,3,6,124136,13015,111121,0.8951553135270993,18.872316444444444,2645.8680106666666,13.905121852903795,136,3.0000000000000004E-5
10,test_20231101_140149,11551286.png,271883,517,271366,0.9980984467583482,1,4,40092,74,40018,0.9981542452359573,17.526147555555557,1807.59504,15.559792199013692,136,3.0000000000000004E-5
1,test_20231101_140150,10404007.png,502730,11682,491048,0.9767628747041155,2,4,61265,1709,59556,0.972104790663511,26.58351822222222,3681.7308106666665,12.470283289312524,136,4.0E-5
2,test_20231101_140150,1254659.png,342646,52719,289927,0.8461414988063483,3,4,80080,7444,72636,0.907042957042957,23.99747911111111,4207.514922666666,11.890546959181364,136,4.0E-5
3,test_20231101_140150,10188041.png,221231,7037,214194,0.9681916187152795,2,3,41731,998,40733,0.9760849248759915,12.408926222222222,1533.9216373333334,16.272771872673378,136,4.0E-5
4,test_20231101_140150,10287332.png,216980,8254,208726,0.9619596276154484,1,4,22337,1132,21205,0.949321753145006,11.671928888888889,1532.94096,16.275549321974697,136,4.0E-5
5,test_20231101_140150,11610969.png,368720,16032,352688,0.9565198524625732,5,5,84111,2360,81751,0.9719418387606853,24.42743111111111,3678.597184,12.473981268133281,136,4.0E-5
6,test_20231101_140150,10350842.png,212614,3372,209242,0.9841402729829645,1,4,42529,496,42033,0.9883373697947283,21.076389333333335,2761.394149333333,13.719519605077451,136,4.0E-5
7,test_20231101_140150,10863862.png,317432,5832,311600,0.9816275611784571,1,3,66058,856,65202,0.9870416906355022,36.069536,6613.262826666667,9.926645779336518,136,4.0E-5
8,test_20231101_140150,11382381.png,312486,637,311849,0.9979615086755886,2,4,46745,89,46656,0.9980960530538026,22.25608711111111,2689.9853066666665,13.833304530777756,136,4.0E-5
9,test_20231101_140150,11079715.png,443815,92442,351373,0.7917105100098014,3,5,124136,13015,111121,0.8951553135270993,18.872316444444444,2645.8680106666666,13.905121852903795,136,4.0E-5
10,test_20231101_140150,11551286.png,271883,517,271366,0.9980984467583482,2,3,40092,74,40018,0.9981542452359573,17.526147555555557,1807.59504,15.559792199013692,136,4.0E-5
1,test_20231101_140151,10404007.png,502730,11682,491048,0.9767628747041155,3,3,61265,1709,59556,0.972104790663511,26.58351822222222,3681.7308106666665,12.470283289312524,136,5.0E-5
2,test_20231101_140151,1254659.png,342646,52719,289927,0.8461414988063483,3,4,80080,7444,72636,0.907042957042957,23.99747911111111,4207.514922666666,11.890546959181364,136,5.0E-5
3,test_20231101_140151,10188041.png,221231,7037,214194,0.9681916187152795,1,3,41731,998,40733,0.9760849248759915,12.408926222222222,1533.9216373333334,16.272771872673378,136,5.0E-5
4,test_20231101_140151,10287332.png,216980,8254,208726,0.9619596276154484,2,4,22337,1132,21205,0.949321753145006,11.671928888888889,1532.94096,16.275549321974697,136,5.0E-5
5,test_20231101_140151,11610969.png,368720,16032,352688,0.9565198524625732,2,3,84111,2360,81751,0.9719418387606853,24.42743111111111,3678.597184,12.473981268133281,136,5.0E-5
6,test_20231101_140151,10350842.png,212614,3372,209242,0.9841402729829645,2,4,42529,496,42033,0.9883373697947283,21.076389333333335,2761.394149333333,13.719519605077451,136,5.0E-5
7,test_20231101_140151,10863862.png,317432,5832,311600,0.9816275611784571,1,4,66058,856,65202,0.9870416906355022,36.069536,6613.262826666667,9.926645779336518,136,5.0E-5
8,test_20231101_140151,11382381.png,312486,637,311849,0.9979615086755886,2,4,46745,89,46656,0.9980960530538026,22.25608711111111,2689.9853066666665,13.833304530777756,136,5.0E-5
9,test_20231101_140151,11079715.png,443815,92442,351373,0.7917105100098014,3,5,124136,13015,111121,0.8951553135270993,18.872316444444444,2645.8680106666666,13.905121852903795,136,5.0E-5
10,test_20231101_140151,11551286.png,271883,517,271366,0.9980984467583482,2,3,40092,74,40018,0.9981542452359573,17.526147555555557,1807.59504,15.559792199013692,136,5.0E-5
1,test_20231101_140151,10404007.png,502730,11682,491048,0.9767628747041155,2,4,61265,1709,59556,0.972104790663511,26.58351822222222,3681.7308106666665,12.470283289312524,136,6.0E-5
2,test_20231101_140151,1254659.png,342646,52719,289927,0.8461414988063483,3,4,80080,7444,72636,0.907042957042957,23.99747911111111,4207.514922666666,11.890546959181364,136,6.0E-5
3,test_20231101_140151,10188041.png,221231,7037,214194,0.9681916187152795,2,3,41731,998,40733,0.9760849248759915,12.408926222222222,1533.9216373333334,16.272771872673378,136,6.0E-5
4,test_20231101_140151,10287332.png,216980,8254,208726,0.9619596276154484,1,4,22337,1132,21205,0.949321753145006,11.671928888888889,1532.94096,16.275549321974697,136,6.0E-5
5,test_20231101_140151,11610969.png,368720,16032,352688,0.9565198524625732,2,4,84111,2360,81751,0.9719418387606853,24.42743111111111,3678.597184,12.473981268133281,136,6.0E-5
6,test_20231101_140151,10350842.png,212614,3372,209242,0.9841402729829645,1,3,42529,496,42033,0.9883373697947283,21.076389333333335,2761.394149333333,13.719519605077451,136,6.0E-5
7,test_20231101_140151,10863862.png,317432,5832,311600,0.9816275611784571,2,4,66058,856,65202,0.9870416906355022,36.069536,6613.262826666667,9.926645779336518,136,6.0E-5
8,test_20231101_140151,11382381.png,312486,637,311849,0.9979615086755886,2,4,46745,89,46656,0.9980960530538026,22.25608711111111,2689.9853066666665,13.833304530777756,136,6.0E-5
9,test_20231101_140151,11079715.png,443815,92442,351373,0.7917105100098014,3,5,124136,13015,111121,0.8951553135270993,18.872316444444444,2645.8680106666666,13.905121852903795,136,6.0E-5
10,test_20231101_140151,11551286.png,271883,517,271366,0.9980984467583482,1,4,40092,74,40018,0.9981542452359573,17.526147555555557,1807.59504,15.559792199013692,136,6.0E-5
1,test_20231101_140152,10404007.png,502730,11682,491048,0.9767628747041155,3,3,61265,1709,59556,0.972104790663511,26.58351822222222,3681.7308106666665,12.470283289312524,136,7.000000000000001E-5
2,test_20231101_140152,1254659.png,342646,52719,289927,0.8461414988063483,3,4,80080,7444,72636,0.907042957042957,23.99747911111111,4207.514922666666,11.890546959181364,136,7.000000000000001E-5
3,test_20231101_140152,10188041.png,221231,7037,214194,0.9681916187152795,2,4,41731,998,40733,0.9760849248759915,12.408926222222222,1533.9216373333334,16.272771872673378,136,7.000000000000001E-5
4,test_20231101_140152,10287332.png,216980,8254,208726,0.9619596276154484,2,3,22337,1132,21205,0.949321753145006,11.671928888888889,1532.94096,16.275549321974697,136,7.000000000000001E-5
5,test_20231101_140152,11610969.png,368720,15649,353071,0.9575585810371013,2,3,84111,2303,81808,0.9726195146889229,25.888266666666667,4013.632789333333,12.095427248692527,136,7.000000000000001E-5
6,test_20231101_140152,10350842.png,212614,3269,209345,0.9846247189742915,1,3,42529,481,42048,0.9886900703049684,22.85024,3253.0792426666667,13.007857183565136,136,7.000000000000001E-5
7,test_20231101_140152,10863862.png,317432,5452,311980,0.982824667960382,1,3,66058,800,65258,0.9878894305004693,39.330947555555554,7546.689685333334,9.35323868398459,136,7.000000000000001E-5
8,test_20231101_140152,11382381.png,312486,637,311849,0.9979615086755886,2,4,46745,89,46656,0.9980960530538026,22.25608711111111,2689.9853066666665,13.833304530777756,136,7.000000000000001E-5
9,test_20231101_140152,11079715.png,443815,92442,351373,0.7917105100098014,3,4,124136,13015,111121,0.8951553135270993,18.872316444444444,2645.8680106666666,13.905121852903795,136,7.000000000000001E-5
10,test_20231101_140152,11551286.png,271883,377,271506,0.9986133741351979,2,3,40092,53,40039,0.9986780405068343,17.85248,1858.6998933333334,15.438710868521719,136,7.000000000000001E-5
1,test_20231101_140153,10404007.png,502730,11682,491048,0.9767628747041155,2,4,61265,1709,59556,0.972104790663511,26.58351822222222,3681.7308106666665,12.470283289312524,136,8.0E-5
2,test_20231101_140153,1254659.png,342646,52719,289927,0.8461414988063483,3,4,80080,7444,72636,0.907042957042957,23.99747911111111,4207.514922666666,11.890546959181364,136,8.0E-5
3,test_20231101_140153,10188041.png,221231,7037,214194,0.9681916187152795,2,4,41731,998,40733,0.9760849248759915,12.408926222222222,1533.9216373333334,16.272771872673378,136,8.0E-5
4,test_20231101_140153,10287332.png,216980,8254,208726,0.9619596276154484,1,3,22337,1132,21205,0.949321753145006,11.671928888888889,1532.94096,16.275549321974697,136,8.0E-5
5,test_20231101_140153,11610969.png,368720,15649,353071,0.9575585810371013,2,4,84111,2303,81808,0.9726195146889229,25.888266666666667,4013.632789333333,12.095427248692527,136,8.0E-5
6,test_20231101_140153,10350842.png,212614,3269,209345,0.9846247189742915,1,3,42529,481,42048,0.9886900703049684,22.85024,3253.0792426666667,13.007857183565136,136,8.0E-5
7,test_20231101_140153,10863862.png,317432,5452,311980,0.982824667960382,1,4,66058,800,65258,0.9878894305004693,39.330947555555554,7546.689685333334,9.35323868398459,136,8.0E-5
8,test_20231101_140153,11382381.png,312486,637,311849,0.9979615086755886,2,4,46745,89,46656,0.9980960530538026,22.25608711111111,2689.9853066666665,13.833304530777756,136,8.0E-5
9,test_20231101_140153,11079715.png,443815,92442,351373,0.7917105100098014,3,4,124136,13015,111121,0.8951553135270993,18.872316444444444,2645.8680106666666,13.905121852903795,136,8.0E-5
10,test_20231101_140153,11551286.png,271883,377,271506,0.9986133741351979,1,4,40092,53,40039,0.9986780405068343,17.85248,1858.6998933333334,15.438710868521719,136,8.0E-5
1,test_20231101_140153,10404007.png,502730,11682,491048,0.9767628747041155,2,3,61265,1709,59556,0.972104790663511,26.58351822222222,3681.7308106666665,12.470283289312524,136,9.0E-5
2,test_20231101_140153,1254659.png,342646,52719,289927,0.8461414988063483,2,4,80080,7444,72636,0.907042957042957,23.99747911111111,4207.514922666666,11.890546959181364,136,9.0E-5
3,test_20231101_140153,10188041.png,221231,7037,214194,0.9681916187152795,2,3,41731,998,40733,0.9760849248759915,12.408926222222222,1533.9216373333334,16.272771872673378,136,9.0E-5
4,test_20231101_140153,10287332.png,216980,8254,208726,0.9619596276154484,1,3,22337,1132,21205,0.949321753145006,11.671928888888889,1532.94096,16.275549321974697,136,9.0E-5
5,test_20231101_140153,11610969.png,368720,15649,353071,0.9575585810371013,2,3,84111,2303,81808,0.9726195146889229,25.888266666666667,4013.632789333333,12.095427248692527,136,9.0E-5
6,test_20231101_140153,10350842.png,212614,3269,209345,0.9846247189742915,1,4,42529,481,42048,0.9886900703049684,22.85024,3253.0792426666667,13.007857183565136,136,9.0E-5
7,test_20231101_140153,10863862.png,317432,5452,311980,0.982824667960382,2,3,66058,800,65258,0.9878894305004693,39.330947555555554,7546.689685333334,9.35323868398459,136,9.0E-5
8,test_20231101_140153,11382381.png,312486,637,311849,0.9979615086755886,2,4,46745,89,46656,0.9980960530538026,22.25608711111111,2689.9853066666665,13.833304530777756,136,9.0E-5
9,test_20231101_140153,11079715.png,443815,92442,351373,0.7917105100098014,3,4,124136,13015,111121,0.8951553135270993,18.872316444444444,2645.8680106666666,13.905121852903795,136,9.0E-5
10,test_20231101_140153,11551286.png,271883,377,271506,0.9986133741351979,1,4,40092,53,40039,0.9986780405068343,17.85248,1858.6998933333334,15.438710868521719,136,9.0E-5
1,test_20231101_140154,10404007.png,502730,11682,491048,0.9767628747041155,2,3,61265,1709,59556,0.972104790663511,26.58351822222222,3681.7308106666665,12.470283289312524,136,1.0E-4
2,test_20231101_140154,1254659.png,342646,52719,289927,0.8461414988063483,3,4,80080,7444,72636,0.907042957042957,23.99747911111111,4207.514922666666,11.890546959181364,136,1.0E-4
3,test_20231101_140154,10188041.png,221231,7037,214194,0.9681916187152795,2,4,41731,998,40733,0.9760849248759915,12.408926222222222,1533.9216373333334,16.272771872673378,136,1.0E-4
4,test_20231101_140154,10287332.png,216980,8254,208726,0.9619596276154484,2,6,22337,1132,21205,0.949321753145006,11.671928888888889,1532.94096,16.275549321974697,136,1.0E-4
5,test_20231101_140154,11610969.png,368720,15649,353071,0.9575585810371013,2,4,84111,2303,81808,0.9726195146889229,25.888266666666667,4013.632789333333,12.095427248692527,136,1.0E-4
6,test_20231101_140154,10350842.png,212614,3269,209345,0.9846247189742915,2,4,42529,481,42048,0.9886900703049684,22.85024,3253.0792426666667,13.007857183565136,136,1.0E-4
7,test_20231101_140154,10863862.png,317432,5452,311980,0.982824667960382,1,4,66058,800,65258,0.9878894305004693,39.330947555555554,7546.689685333334,9.35323868398459,136,1.0E-4
8,test_20231101_140154,11382381.png,312486,637,311849,0.9979615086755886,1,3,46745,89,46656,0.9980960530538026,22.25608711111111,2689.9853066666665,13.833304530777756,136,1.0E-4
9,test_20231101_140154,11079715.png,443815,92442,351373,0.7917105100098014,3,4,124136,13015,111121,0.8951553135270993,18.872316444444444,2645.8680106666666,13.905121852903795,136,1.0E-4
10,test_20231101_140154,11551286.png,271883,377,271506,0.9986133741351979,2,3,40092,53,40039,0.9986780405068343,17.85248,1858.6998933333334,15.438710868521719,136,1.0E-4
1,test_20231101_140155,10404007.png,502730,11682,491048,0.9767628747041155,2,4,61265,1709,59556,0.972104790663511,26.58351822222222,3681.7308106666665,12.470283289312524,136,1.1E-4
2,test_20231101_140155,1254659.png,342646,52719,289927,0.8461414988063483,2,4,80080,7444,72636,0.907042957042957,23.99747911111111,4207.514922666666,11.890546959181364,136,1.1E-4
3,test_20231101_140155,10188041.png,221231,7037,214194,0.9681916187152795,2,4,41731,998,40733,0.9760849248759915,12.408926222222222,1533.9216373333334,16.272771872673378,136,1.1E-4
4,test_20231101_140155,10287332.png,216980,8254,208726,0.9619596276154484,1,3,22337,1132,21205,0.949321753145006,11.671928888888889,1532.94096,16.275549321974697,136,1.1E-4
5,test_20231101_140155,11610969.png,368720,15649,353071,0.9575585810371013,2,4,84111,2303,81808,0.9726195146889229,25.888266666666667,4013.632789333333,12.095427248692527,136,1.1E-4
6,test_20231101_140155,10350842.png,212614,3269,209345,0.9846247189742915,1,3,42529,481,42048,0.9886900703049684,22.85024,3253.0792426666667,13.007857183565136,136,1.1E-4
7,test_20231101_140155,10863862.png,317432,5452,311980,0.982824667960382,1,4,66058,800,65258,0.9878894305004693,39.330947555555554,7546.689685333334,9.35323868398459,136,1.1E-4
8,test_20231101_140155,11382381.png,312486,637,311849,0.9979615086755886,2,4,46745,89,46656,0.9980960530538026,22.25608711111111,2689.9853066666665,13.833304530777756,136,1.1E-4
9,test_20231101_140155,11079715.png,443815,92442,351373,0.7917105100098014,3,4,124136,13015,111121,0.8951553135270993,18.872316444444444,2645.8680106666666,13.905121852903795,136,1.1E-4
10,test_20231101_140155,11551286.png,271883,377,271506,0.9986133741351979,2,4,40092,53,40039,0.9986780405068343,17.85248,1858.6998933333334,15.438710868521719,136,1.1E-4
1,test_20231101_140155,10404007.png,502730,11682,491048,0.9767628747041155,2,4,61265,1709,59556,0.972104790663511,26.58351822222222,3681.7308106666665,12.470283289312524,136,1.2E-4
2,test_20231101_140155,1254659.png,342646,52719,289927,0.8461414988063483,3,4,80080,7444,72636,0.907042957042957,23.99747911111111,4207.514922666666,11.890546959181364,136,1.2E-4
3,test_20231101_140155,10188041.png,221231,7037,214194,0.9681916187152795,3,3,41731,998,40733,0.9760849248759915,12.408926222222222,1533.9216373333334,16.272771872673378,136,1.2E-4
4,test_20231101_140155,10287332.png,216980,8254,208726,0.9619596276154484,1,10,22337,1132,21205,0.949321753145006,11.671928888888889,1532.94096,16.275549321974697,136,1.2E-4
5,test_20231101_140155,11610969.png,368720,15649,353071,0.9575585810371013,2,4,84111,2303,81808,0.9726195146889229,25.888266666666667,4013.632789333333,12.095427248692527,136,1.2E-4
6,test_20231101_140155,10350842.png,212614,3269,209345,0.9846247189742915,1,4,42529,481,42048,0.9886900703049684,22.85024,3253.0792426666667,13.007857183565136,136,1.2E-4
7,test_20231101_140155,10863862.png,317432,5452,311980,0.982824667960382,1,4,66058,800,65258,0.9878894305004693,39.330947555555554,7546.689685333334,9.35323868398459,136,1.2E-4
8,test_20231101_140155,11382381.png,312486,527,311959,0.9983135244458952,2,4,46745,73,46672,0.9984383356508717,22.512565333333335,2730.117472,13.768990265217447,136,1.2E-4
9,test_20231101_140155,11079715.png,443815,92442,351373,0.7917105100098014,3,4,124136,13015,111121,0.8951553135270993,18.872316444444444,2645.8680106666666,13.905121852903795,136,1.2E-4
10,test_20231101_140155,11551286.png,271883,377,271506,0.9986133741351979,2,4,40092,53,40039,0.9986780405068343,17.85248,1858.6998933333334,15.438710868521719,136,1.2E-4
1,test_20231101_140156,10404007.png,502730,11682,491048,0.9767628747041155,2,3,61265,1709,59556,0.972104790663511,26.58351822222222,3681.7308106666665,12.470283289312524,136,1.3000000000000002E-4
2,test_20231101_140156,1254659.png,342646,52719,289927,0.8461414988063483,3,4,80080,7444,72636,0.907042957042957,23.99747911111111,4207.514922666666,11.890546959181364,136,1.3000000000000002E-4
3,test_20231101_140156,10188041.png,221231,7037,214194,0.9681916187152795,2,3,41731,998,40733,0.9760849248759915,12.408926222222222,1533.9216373333334,16.272771872673378,136,1.3000000000000002E-4
4,test_20231101_140156,10287332.png,216980,8254,208726,0.9619596276154484,1,3,22337,1132,21205,0.949321753145006,11.671928888888889,1532.94096,16.275549321974697,136,1.3000000000000002E-4
5,test_20231101_140156,11610969.png,368720,15649,353071,0.9575585810371013,2,4,84111,2303,81808,0.9726195146889229,25.888266666666667,4013.632789333333,12.095427248692527,136,1.3000000000000002E-4
6,test_20231101_140156,10350842.png,212614,3269,209345,0.9846247189742915,2,3,42529,481,42048,0.9886900703049684,22.85024,3253.0792426666667,13.007857183565136,136,1.3000000000000002E-4
7,test_20231101_140156,10863862.png,317432,5452,311980,0.982824667960382,2,4,66058,800,65258,0.9878894305004693,39.330947555555554,7546.689685333334,9.35323868398459,136,1.3000000000000002E-4
8,test_20231101_140156,11382381.png,312486,527,311959,0.9983135244458952,1,4,46745,73,46672,0.9984383356508717,22.512565333333335,2730.117472,13.768990265217447,136,1.3000000000000002E-4
9,test_20231101_140156,11079715.png,443815,92442,351373,0.7917105100098014,3,4,124136,13015,111121,0.8951553135270993,18.872316444444444,2645.8680106666666,13.905121852903795,136,1.3000000000000002E-4
10,test_20231101_140156,11551286.png,271883,377,271506,0.9986133741351979,1,4,40092,53,40039,0.9986780405068343,17.85248,1858.6998933333334,15.438710868521719,136,1.3000000000000002E-4
1,test_20231101_140157,10404007.png,502730,11682,491048,0.9767628747041155,2,3,61265,1709,59556,0.972104790663511,26.58351822222222,3681.7308106666665,12.470283289312524,136,1.4000000000000001E-4
2,test_20231101_140157,1254659.png,342646,52719,289927,0.8461414988063483,3,4,80080,7444,72636,0.907042957042957,23.99747911111111,4207.514922666666,11.890546959181364,136,1.4000000000000001E-4
3,test_20231101_140157,10188041.png,221231,7037,214194,0.9681916187152795,2,3,41731,998,40733,0.9760849248759915,12.408926222222222,1533.9216373333334,16.272771872673378,136,1.4000000000000001E-4
4,test_20231101_140157,10287332.png,216980,8254,208726,0.9619596276154484,1,4,22337,1132,21205,0.949321753145006,11.671928888888889,1532.94096,16.275549321974697,136,1.4000000000000001E-4
5,test_20231101_140157,11610969.png,368720,15649,353071,0.9575585810371013,2,3,84111,2303,81808,0.9726195146889229,25.888266666666667,4013.632789333333,12.095427248692527,136,1.4000000000000001E-4
6,test_20231101_140157,10350842.png,212614,3269,209345,0.9846247189742915,1,4,42529,481,42048,0.9886900703049684,22.85024,3253.0792426666667,13.007857183565136,136,1.4000000000000001E-4
7,test_20231101_140157,10863862.png,317432,5452,311980,0.982824667960382,2,4,66058,800,65258,0.9878894305004693,39.330947555555554,7546.689685333334,9.35323868398459,136,1.4000000000000001E-4
8,test_20231101_140157,11382381.png,312486,527,311959,0.9983135244458952,1,4,46745,73,46672,0.9984383356508717,22.512565333333335,2730.117472,13.768990265217447,136,1.4000000000000001E-4
9,test_20231101_140157,11079715.png,443815,92442,351373,0.7917105100098014,3,4,124136,13015,111121,0.8951553135270993,18.872316444444444,2645.8680106666666,13.905121852903795,136,1.4000000000000001E-4
10,test_20231101_140157,11551286.png,271883,377,271506,0.9986133741351979,1,4,40092,53,40039,0.9986780405068343,17.85248,1858.6998933333334,15.438710868521719,136,1.4000000000000001E-4
1,test_20231101_140158,10404007.png,502730,11682,491048,0.9767628747041155,2,4,61265,1709,59556,0.972104790663511,26.58351822222222,3681.7308106666665,12.470283289312524,136,1.5000000000000001E-4
2,test_20231101_140158,1254659.png,342646,52719,289927,0.8461414988063483,16,4,80080,7444,72636,0.907042957042957,23.99747911111111,4207.514922666666,11.890546959181364,136,1.5000000000000001E-4
3,test_20231101_140158,10188041.png,221231,7037,214194,0.9681916187152795,2,4,41731,998,40733,0.9760849248759915,12.408926222222222,1533.9216373333334,16.272771872673378,136,1.5000000000000001E-4
4,test_20231101_140158,10287332.png,216980,8254,208726,0.9619596276154484,2,4,22337,1132,21205,0.949321753145006,11.671928888888889,1532.94096,16.275549321974697,136,1.5000000000000001E-4
5,test_20231101_140158,11610969.png,368720,15649,353071,0.9575585810371013,2,4,84111,2303,81808,0.9726195146889229,25.888266666666667,4013.632789333333,12.095427248692527,136,1.5000000000000001E-4
6,test_20231101_140158,10350842.png,212614,3269,209345,0.9846247189742915,1,4,42529,481,42048,0.9886900703049684,22.85024,3253.0792426666667,13.007857183565136,136,1.5000000000000001E-4
7,test_20231101_140158,10863862.png,317432,5452,311980,0.982824667960382,2,3,66058,800,65258,0.9878894305004693,39.330947555555554,7546.689685333334,9.35323868398459,136,1.5000000000000001E-4
8,test_20231101_140158,11382381.png,312486,527,311959,0.9983135244458952,1,4,46745,73,46672,0.9984383356508717,22.512565333333335,2730.117472,13.768990265217447,136,1.5000000000000001E-4
9,test_20231101_140158,11079715.png,443815,92442,351373,0.7917105100098014,2,4,124136,13015,111121,0.8951553135270993,18.872316444444444,2645.8680106666666,13.905121852903795,136,1.5000000000000001E-4
10,test_20231101_140158,11551286.png,271883,377,271506,0.9986133741351979,2,4,40092,53,40039,0.9986780405068343,17.85248,1858.6998933333334,15.438710868521719,136,1.5000000000000001E-4
1,test_20231101_140158,10404007.png,502730,11682,491048,0.9767628747041155,2,3,61265,1709,59556,0.972104790663511,26.58351822222222,3681.7308106666665,12.470283289312524,136,1.6E-4
2,test_20231101_140158,1254659.png,342646,52719,289927,0.8461414988063483,3,4,80080,7444,72636,0.907042957042957,23.99747911111111,4207.514922666666,11.890546959181364,136,1.6E-4
3,test_20231101_140158,10188041.png,221231,7037,214194,0.9681916187152795,2,4,41731,998,40733,0.9760849248759915,12.408926222222222,1533.9216373333334,16.272771872673378,136,1.6E-4
4,test_20231101_140158,10287332.png,216980,8062,208918,0.9628445017974007,2,3,22337,1108,21229,0.9503962036083629,11.800304,1559.2556106666666,16.201630454208743,136,1.6E-4
5,test_20231101_140158,11610969.png,368720,15649,353071,0.9575585810371013,2,4,84111,2303,81808,0.9726195146889229,25.888266666666667,4013.632789333333,12.095427248692527,136,1.6E-4
6,test_20231101_140158,10350842.png,212614,3269,209345,0.9846247189742915,2,3,42529,481,42048,0.9886900703049684,22.85024,3253.0792426666667,13.007857183565136,136,1.6E-4
7,test_20231101_140158,10863862.png,317432,5452,311980,0.982824667960382,2,3,66058,800,65258,0.9878894305004693,39.330947555555554,7546.689685333334,9.35323868398459,136,1.6E-4
8,test_20231101_140158,11382381.png,312486,527,311959,0.9983135244458952,2,3,46745,73,46672,0.9984383356508717,22.512565333333335,2730.117472,13.768990265217447,136,1.6E-4
9,test_20231101_140158,11079715.png,443815,92442,351373,0.7917105100098014,3,4,124136,13015,111121,0.8951553135270993,18.872316444444444,2645.8680106666666,13.905121852903795,136,1.6E-4
10,test_20231101_140158,11551286.png,271883,377,271506,0.9986133741351979,2,3,40092,53,40039,0.9986780405068343,17.85248,1858.6998933333334,15.438710868521719,136,1.6E-4
1,test_20231101_140159,10404007.png,502730,11682,491048,0.9767628747041155,3,3,61265,1709,59556,0.972104790663511,26.58351822222222,3681.7308106666665,12.470283289312524,136,1.7E-4
2,test_20231101_140159,1254659.png,342646,52719,289927,0.8461414988063483,3,4,80080,7444,72636,0.907042957042957,23.99747911111111,4207.514922666666,11.890546959181364,136,1.7E-4
3,test_20231101_140159,10188041.png,221231,7037,214194,0.9681916187152795,2,3,41731,998,40733,0.9760849248759915,12.408926222222222,1533.9216373333334,16.272771872673378,136,1.7E-4
4,test_20231101_140159,10287332.png,216980,8062,208918,0.9628445017974007,1,4,22337,1108,21229,0.9503962036083629,11.800304,1559.2556106666666,16.201630454208743,136,1.7E-4
5,test_20231101_140159,11610969.png,368720,15649,353071,0.9575585810371013,2,4,84111,2303,81808,0.9726195146889229,25.888266666666667,4013.632789333333,12.095427248692527,136,1.7E-4
6,test_20231101_140159,10350842.png,212614,3269,209345,0.9846247189742915,1,3,42529,481,42048,0.9886900703049684,22.85024,3253.0792426666667,13.007857183565136,136,1.7E-4
7,test_20231101_140159,10863862.png,317432,5452,311980,0.982824667960382,1,4,66058,800,65258,0.9878894305004693,39.330947555555554,7546.689685333334,9.35323868398459,136,1.7E-4
8,test_20231101_140159,11382381.png,312486,527,311959,0.9983135244458952,2,3,46745,73,46672,0.9984383356508717,22.512565333333335,2730.117472,13.768990265217447,136,1.7E-4
9,test_20231101_140159,11079715.png,443815,92442,351373,0.7917105100098014,3,4,124136,13015,111121,0.8951553135270993,18.872316444444444,2645.8680106666666,13.905121852903795,136,1.7E-4
10,test_20231101_140159,11551286.png,271883,377,271506,0.9986133741351979,1,4,40092,53,40039,0.9986780405068343,17.85248,1858.6998933333334,15.438710868521719,136,1.7E-4
1,test_20231101_140200,10404007.png,502730,11682,491048,0.9767628747041155,2,4,61265,1709,59556,0.972104790663511,26.58351822222222,3681.7308106666665,12.470283289312524,136,1.8E-4
2,test_20231101_140200,1254659.png,342646,52719,289927,0.8461414988063483,3,4,80080,7444,72636,0.907042957042957,23.99747911111111,4207.514922666666,11.890546959181364,136,1.8E-4
3,test_20231101_140200,10188041.png,221231,7037,214194,0.9681916187152795,2,4,41731,998,40733,0.9760849248759915,12.408926222222222,1533.9216373333334,16.272771872673378,136,1.8E-4
4,test_20231101_140200,10287332.png,216980,8062,208918,0.9628445017974007,2,4,22337,1108,21229,0.9503962036083629,11.800304,1559.2556106666666,16.201630454208743,136,1.8E-4
5,test_20231101_140200,11610969.png,368720,15649,353071,0.9575585810371013,2,4,84111,2303,81808,0.9726195146889229,25.888266666666667,4013.632789333333,12.095427248692527,136,1.8E-4
6,test_20231101_140200,10350842.png,212614,3269,209345,0.9846247189742915,1,4,42529,481,42048,0.9886900703049684,22.85024,3253.0792426666667,13.007857183565136,136,1.8E-4
7,test_20231101_140200,10863862.png,317432,5452,311980,0.982824667960382,2,10,66058,800,65258,0.9878894305004693,39.330947555555554,7546.689685333334,9.35323868398459,136,1.8E-4
8,test_20231101_140200,11382381.png,312486,527,311959,0.9983135244458952,2,4,46745,73,46672,0.9984383356508717,22.512565333333335,2730.117472,13.768990265217447,136,1.8E-4
9,test_20231101_140200,11079715.png,443815,92442,351373,0.7917105100098014,4,5,124136,13015,111121,0.8951553135270993,18.872316444444444,2645.8680106666666,13.905121852903795,136,1.8E-4
10,test_20231101_140200,11551286.png,271883,164,271719,0.9993967993585476,2,4,40092,22,40070,0.9994512620971765,18.120286222222223,1899.5769013333334,15.344234809036362,136,1.8E-4
1,test_20231101_140200,10404007.png,502730,11682,491048,0.9767628747041155,3,4,61265,1709,59556,0.972104790663511,26.58351822222222,3681.7308106666665,12.470283289312524,136,1.9E-4
2,test_20231101_140200,1254659.png,342646,52719,289927,0.8461414988063483,2,4,80080,7444,72636,0.907042957042957,23.99747911111111,4207.514922666666,11.890546959181364,136,1.9E-4
3,test_20231101_140200,10188041.png,221231,7037,214194,0.9681916187152795,3,4,41731,998,40733,0.9760849248759915,12.408926222222222,1533.9216373333334,16.272771872673378,136,1.9E-4
4,test_20231101_140200,10287332.png,216980,8062,208918,0.9628445017974007,2,4,22337,1108,21229,0.9503962036083629,11.800304,1559.2556106666666,16.201630454208743,136,1.9E-4
5,test_20231101_140200,11610969.png,368720,15649,353071,0.9575585810371013,2,3,84111,2303,81808,0.9726195146889229,25.888266666666667,4013.632789333333,12.095427248692527,136,1.9E-4
6,test_20231101_140200,10350842.png,212614,3269,209345,0.9846247189742915,2,3,42529,481,42048,0.9886900703049684,22.85024,3253.0792426666667,13.007857183565136,136,1.9E-4
7,test_20231101_140200,10863862.png,317432,5452,311980,0.982824667960382,2,4,66058,800,65258,0.9878894305004693,39.330947555555554,7546.689685333334,9.35323868398459,136,1.9E-4
8,test_20231101_140200,11382381.png,312486,527,311959,0.9983135244458952,1,4,46745,73,46672,0.9984383356508717,22.512565333333335,2730.117472,13.768990265217447,136,1.9E-4
9,test_20231101_140200,11079715.png,443815,92442,351373,0.7917105100098014,3,4,124136,13015,111121,0.8951553135270993,18.872316444444444,2645.8680106666666,13.905121852903795,136,1.9E-4
10,test_20231101_140200,11551286.png,271883,164,271719,0.9993967993585476,1,4,40092,22,40070,0.9994512620971765,18.120286222222223,1899.5769013333334,15.344234809036362,136,1.9E-4
1,test_20231101_140201,10404007.png,502730,11682,491048,0.9767628747041155,2,4,61265,1709,59556,0.972104790663511,26.58351822222222,3681.7308106666665,12.470283289312524,136,2.0E-4
2,test_20231101_140201,1254659.png,342646,52719,289927,0.8461414988063483,2,4,80080,7444,72636,0.907042957042957,23.99747911111111,4207.514922666666,11.890546959181364,136,2.0E-4
3,test_20231101_140201,10188041.png,221231,7037,214194,0.9681916187152795,2,4,41731,998,40733,0.9760849248759915,12.408926222222222,1533.9216373333334,16.272771872673378,136,2.0E-4
4,test_20231101_140201,10287332.png,216980,8062,208918,0.9628445017974007,2,4,22337,1108,21229,0.9503962036083629,11.800304,1559.2556106666666,16.201630454208743,136,2.0E-4
5,test_20231101_140201,11610969.png,368720,15649,353071,0.9575585810371013,2,3,84111,2303,81808,0.9726195146889229,25.888266666666667,4013.632789333333,12.095427248692527,136,2.0E-4
6,test_20231101_140201,10350842.png,212614,3269,209345,0.9846247189742915,1,4,42529,481,42048,0.9886900703049684,22.85024,3253.0792426666667,13.007857183565136,136,2.0E-4
7,test_20231101_140201,10863862.png,317432,5452,311980,0.982824667960382,2,3,66058,800,65258,0.9878894305004693,39.330947555555554,7546.689685333334,9.35323868398459,136,2.0E-4
8,test_20231101_140201,11382381.png,312486,527,311959,0.9983135244458952,1,10,46745,73,46672,0.9984383356508717,22.512565333333335,2730.117472,13.768990265217447,136,2.0E-4
9,test_20231101_140201,11079715.png,443815,92442,351373,0.7917105100098014,3,4,124136,13015,111121,0.8951553135270993,18.872316444444444,2645.8680106666666,13.905121852903795,136,2.0E-4
10,test_20231101_140201,11551286.png,271883,164,271719,0.9993967993585476,1,4,40092,22,40070,0.9994512620971765,18.120286222222223,1899.5769013333334,15.344234809036362,136,2.0E-4
1,test_20231101_140202,10404007.png,502730,11682,491048,0.9767628747041155,3,3,61265,1709,59556,0.972104790663511,26.58351822222222,3681.7308106666665,12.470283289312524,136,2.1E-4
2,test_20231101_140202,1254659.png,342646,52719,289927,0.8461414988063483,2,3,80080,7444,72636,0.907042957042957,23.99747911111111,4207.514922666666,11.890546959181364,136,2.1E-4
3,test_20231101_140202,10188041.png,221231,7037,214194,0.9681916187152795,2,4,41731,998,40733,0.9760849248759915,12.408926222222222,1533.9216373333334,16.272771872673378,136,2.1E-4
4,test_20231101_140202,10287332.png,216980,8062,208918,0.9628445017974007,1,3,22337,1108,21229,0.9503962036083629,11.800304,1559.2556106666666,16.201630454208743,136,2.1E-4
5,test_20231101_140202,11610969.png,368720,15649,353071,0.9575585810371013,2,4,84111,2303,81808,0.9726195146889229,25.888266666666667,4013.632789333333,12.095427248692527,136,2.1E-4
6,test_20231101_140202,10350842.png,212614,3269,209345,0.9846247189742915,2,3,42529,481,42048,0.9886900703049684,22.85024,3253.0792426666667,13.007857183565136,136,2.1E-4
7,test_20231101_140202,10863862.png,317432,5452,311980,0.982824667960382,1,4,66058,800,65258,0.9878894305004693,39.330947555555554,7546.689685333334,9.35323868398459,136,2.1E-4
8,test_20231101_140202,11382381.png,312486,527,311959,0.9983135244458952,1,4,46745,73,46672,0.9984383356508717,22.512565333333335,2730.117472,13.768990265217447,136,2.1E-4
9,test_20231101_140202,11079715.png,443815,92442,351373,0.7917105100098014,3,4,124136,13015,111121,0.8951553135270993,18.872316444444444,2645.8680106666666,13.905121852903795,136,2.1E-4
10,test_20231101_140202,11551286.png,271883,164,271719,0.9993967993585476,1,3,40092,22,40070,0.9994512620971765,18.120286222222223,1899.5769013333334,15.344234809036362,136,2.1E-4
1,test_20231101_140202,10404007.png,502730,11682,491048,0.9767628747041155,2,3,61265,1709,59556,0.972104790663511,26.58351822222222,3681.7308106666665,12.470283289312524,136,2.2E-4
2,test_20231101_140202,1254659.png,342646,52719,289927,0.8461414988063483,2,4,80080,7444,72636,0.907042957042957,23.99747911111111,4207.514922666666,11.890546959181364,136,2.2E-4
3,test_20231101_140202,10188041.png,221231,7037,214194,0.9681916187152795,2,3,41731,998,40733,0.9760849248759915,12.408926222222222,1533.9216373333334,16.272771872673378,136,2.2E-4
4,test_20231101_140202,10287332.png,216980,8062,208918,0.9628445017974007,2,4,22337,1108,21229,0.9503962036083629,11.800304,1559.2556106666666,16.201630454208743,136,2.2E-4
5,test_20231101_140202,11610969.png,368720,15649,353071,0.9575585810371013,2,3,84111,2303,81808,0.9726195146889229,25.888266666666667,4013.632789333333,12.095427248692527,136,2.2E-4
6,test_20231101_140202,10350842.png,212614,3269,209345,0.9846247189742915,2,3,42529,481,42048,0.9886900703049684,22.85024,3253.0792426666667,13.007857183565136,136,2.2E-4
7,test_20231101_140202,10863862.png,317432,5452,311980,0.982824667960382,2,3,66058,800,65258,0.9878894305004693,39.330947555555554,7546.689685333334,9.35323868398459,136,2.2E-4
8,test_20231101_140202,11382381.png,312486,527,311959,0.9983135244458952,2,3,46745,73,46672,0.9984383356508717,22.512565333333335,2730.117472,13.768990265217447,136,2.2E-4
9,test_20231101_140202,11079715.png,443815,92442,351373,0.7917105100098014,4,5,124136,13015,111121,0.8951553135270993,18.872316444444444,2645.8680106666666,13.905121852903795,136,2.2E-4
10,test_20231101_140202,11551286.png,271883,164,271719,0.9993967993585476,2,3,40092,22,40070,0.9994512620971765,18.120286222222223,1899.5769013333334,15.344234809036362,136,2.2E-4
1,test_20231101_140203,10404007.png,502730,11682,491048,0.9767628747041155,2,4,61265,1709,59556,0.972104790663511,26.58351822222222,3681.7308106666665,12.470283289312524,136,2.3E-4
2,test_20231101_140203,1254659.png,342646,52719,289927,0.8461414988063483,2,4,80080,7444,72636,0.907042957042957,23.99747911111111,4207.514922666666,11.890546959181364,136,2.3E-4
3,test_20231101_140203,10188041.png,221231,7037,214194,0.9681916187152795,2,4,41731,998,40733,0.9760849248759915,12.408926222222222,1533.9216373333334,16.272771872673378,136,2.3E-4
4,test_20231101_140203,10287332.png,216980,8062,208918,0.9628445017974007,2,3,22337,1108,21229,0.9503962036083629,11.800304,1559.2556106666666,16.201630454208743,136,2.3E-4
5,test_20231101_140203,11610969.png,368720,15649,353071,0.9575585810371013,2,4,84111,2303,81808,0.9726195146889229,25.888266666666667,4013.632789333333,12.095427248692527,136,2.3E-4
6,test_20231101_140203,10350842.png,212614,3269,209345,0.9846247189742915,2,4,42529,481,42048,0.9886900703049684,22.85024,3253.0792426666667,13.007857183565136,136,2.3E-4
7,test_20231101_140203,10863862.png,317432,5452,311980,0.982824667960382,1,3,66058,800,65258,0.9878894305004693,39.330947555555554,7546.689685333334,9.35323868398459,136,2.3E-4
8,test_20231101_140203,11382381.png,312486,527,311959,0.9983135244458952,1,3,46745,73,46672,0.9984383356508717,22.512565333333335,2730.117472,13.768990265217447,136,2.3E-4
9,test_20231101_140203,11079715.png,443815,92442,351373,0.7917105100098014,3,4,124136,13015,111121,0.8951553135270993,18.872316444444444,2645.8680106666666,13.905121852903795,136,2.3E-4
10,test_20231101_140203,11551286.png,271883,164,271719,0.9993967993585476,1,3,40092,22,40070,0.9994512620971765,18.120286222222223,1899.5769013333334,15.344234809036362,136,2.3E-4
1,test_20231101_140204,10404007.png,502730,11682,491048,0.9767628747041155,2,3,61265,1709,59556,0.972104790663511,26.58351822222222,3681.7308106666665,12.470283289312524,136,2.4E-4
2,test_20231101_140204,1254659.png,342646,52719,289927,0.8461414988063483,2,3,80080,7444,72636,0.907042957042957,23.99747911111111,4207.514922666666,11.890546959181364,136,2.4E-4
3,test_20231101_140204,10188041.png,221231,7037,214194,0.9681916187152795,2,3,41731,998,40733,0.9760849248759915,12.408926222222222,1533.9216373333334,16.272771872673378,136,2.4E-4
4,test_20231101_140204,10287332.png,216980,8062,208918,0.9628445017974007,1,3,22337,1108,21229,0.9503962036083629,11.800304,1559.2556106666666,16.201630454208743,136,2.4E-4
5,test_20231101_140204,11610969.png,368720,15649,353071,0.9575585810371013,2,4,84111,2303,81808,0.9726195146889229,25.888266666666667,4013.632789333333,12.095427248692527,136,2.4E-4
6,test_20231101_140204,10350842.png,212614,3269,209345,0.9846247189742915,2,4,42529,481,42048,0.9886900703049684,22.85024,3253.0792426666667,13.007857183565136,136,2.4E-4
7,test_20231101_140204,10863862.png,317432,5452,311980,0.982824667960382,2,3,66058,800,65258,0.9878894305004693,39.330947555555554,7546.689685333334,9.35323868398459,136,2.4E-4
8,test_20231101_140204,11382381.png,312486,527,311959,0.9983135244458952,1,3,46745,73,46672,0.9984383356508717,22.512565333333335,2730.117472,13.768990265217447,136,2.4E-4
9,test_20231101_140204,11079715.png,443815,92442,351373,0.7917105100098014,3,4,124136,13015,111121,0.8951553135270993,18.872316444444444,2645.8680106666666,13.905121852903795,136,2.4E-4
10,test_20231101_140204,11551286.png,271883,164,271719,0.9993967993585476,1,4,40092,22,40070,0.9994512620971765,18.120286222222223,1899.5769013333334,15.344234809036362,136,2.4E-4
1,test_20231101_140204,10404007.png,502730,11682,491048,0.9767628747041155,2,3,61265,1709,59556,0.972104790663511,26.58351822222222,3681.7308106666665,12.470283289312524,136,2.5E-4
2,test_20231101_140204,1254659.png,342646,52719,289927,0.8461414988063483,3,4,80080,7444,72636,0.907042957042957,23.99747911111111,4207.514922666666,11.890546959181364,136,2.5E-4
3,test_20231101_140204,10188041.png,221231,7037,214194,0.9681916187152795,2,4,41731,998,40733,0.9760849248759915,12.408926222222222,1533.9216373333334,16.272771872673378,136,2.5E-4
4,test_20231101_140204,10287332.png,216980,8062,208918,0.9628445017974007,1,4,22337,1108,21229,0.9503962036083629,11.800304,1559.2556106666666,16.201630454208743,136,2.5E-4
5,test_20231101_140204,11610969.png,368720,15649,353071,0.9575585810371013,2,4,84111,2303,81808,0.9726195146889229,25.888266666666667,4013.632789333333,12.095427248692527,136,2.5E-4
6,test_20231101_140204,10350842.png,212614,3269,209345,0.9846247189742915,1,4,42529,481,42048,0.9886900703049684,22.85024,3253.0792426666667,13.007857183565136,136,2.5E-4
7,test_20231101_140204,10863862.png,317432,5452,311980,0.982824667960382,1,3,66058,800,65258,0.9878894305004693,39.330947555555554,7546.689685333334,9.35323868398459,136,2.5E-4
8,test_20231101_140204,11382381.png,312486,527,311959,0.9983135244458952,1,3,46745,73,46672,0.9984383356508717,22.512565333333335,2730.117472,13.768990265217447,136,2.5E-4
9,test_20231101_140204,11079715.png,443815,92442,351373,0.7917105100098014,3,4,124136,13015,111121,0.8951553135270993,18.872316444444444,2645.8680106666666,13.905121852903795,136,2.5E-4
10,test_20231101_140204,11551286.png,271883,164,271719,0.9993967993585476,1,4,40092,22,40070,0.9994512620971765,18.120286222222223,1899.5769013333334,15.344234809036362,136,2.5E-4
1,test_20231101_140205,10404007.png,502730,11499,491231,0.9771268871959103,2,3,61265,1684,59581,0.97251285399494,26.806076444444443,3731.805152,12.411614009328725,136,2.6000000000000003E-4
2,test_20231101_140205,1254659.png,342646,52679,289967,0.8462582373645103,3,4,80080,7440,72640,0.9070929070929071,24.00547911111111,4208.260053333333,11.889777912626299,136,2.6000000000000003E-4
3,test_20231101_140205,10188041.png,221231,6877,214354,0.9689148446646265,2,4,41731,975,40756,0.9766360739018954,12.735994666666667,1581.1707893333332,16.14101578311401,136,2.6000000000000003E-4
4,test_20231101_140205,10287332.png,216980,8062,208918,0.9628445017974007,2,3,22337,1108,21229,0.9503962036083629,11.800304,1559.2556106666666,16.201630454208743,136,2.6000000000000003E-4
5,test_20231101_140205,11610969.png,368720,15569,353151,0.9577755478411802,2,4,84111,2292,81819,0.9727502942540215,25.926012444444446,4017.509632,12.091234342080266,136,2.6000000000000003E-4
6,test_20231101_140205,10350842.png,212614,3209,209405,0.9849069205226373,1,3,42529,472,42057,0.9889016906111124,22.90571733333333,3257.8204053333334,13.001532216942387,136,2.6000000000000003E-4
7,test_20231101_140205,10863862.png,317432,5147,312285,0.9837855036669271,1,4,66058,756,65302,0.9885555118229434,40.163824,7765.409690666666,9.229159875126465,136,2.6000000000000003E-4
8,test_20231101_140205,11382381.png,312486,407,312079,0.9986975416498659,1,4,46745,55,46690,0.9988234035725746,23.007091555555554,2800.0597813333334,13.659130572306793,136,2.6000000000000003E-4
9,test_20231101_140205,11079715.png,443815,92442,351373,0.7917105100098014,3,4,124136,13015,111121,0.8951553135270993,18.872316444444444,2645.8680106666666,13.905121852903795,136,2.6000000000000003E-4
10,test_20231101_140205,11551286.png,271883,164,271719,0.9993967993585476,1,4,40092,22,40070,0.9994512620971765,18.120286222222223,1899.5769013333334,15.344234809036362,136,2.6000000000000003E-4
1,test_20231101_140206,10404007.png,502730,11499,491231,0.9771268871959103,2,3,61265,1684,59581,0.97251285399494,26.806076444444443,3731.805152,12.411614009328725,136,2.7000000000000006E-4
2,test_20231101_140206,1254659.png,342646,52679,289967,0.8462582373645103,3,4,80080,7440,72640,0.9070929070929071,24.00547911111111,4208.260053333333,11.889777912626299,136,2.7000000000000006E-4
3,test_20231101_140206,10188041.png,221231,6877,214354,0.9689148446646265,2,4,41731,975,40756,0.9766360739018954,12.735994666666667,1581.1707893333332,16.14101578311401,136,2.7000000000000006E-4
4,test_20231101_140206,10287332.png,216980,8062,208918,0.9628445017974007,1,4,22337,1108,21229,0.9503962036083629,11.800304,1559.2556106666666,16.201630454208743,136,2.7000000000000006E-4
5,test_20231101_140206,11610969.png,368720,15569,353151,0.9577755478411802,2,4,84111,2292,81819,0.9727502942540215,25.926012444444446,4017.509632,12.091234342080266,136,2.7000000000000006E-4
6,test_20231101_140206,10350842.png,212614,3209,209405,0.9849069205226373,1,3,42529,472,42057,0.9889016906111124,22.90571733333333,3257.8204053333334,13.001532216942387,136,2.7000000000000006E-4
7,test_20231101_140206,10863862.png,317432,5147,312285,0.9837855036669271,2,4,66058,756,65302,0.9885555118229434,40.163824,7765.409690666666,9.229159875126465,136,2.7000000000000006E-4
8,test_20231101_140206,11382381.png,312486,407,312079,0.9986975416498659,2,4,46745,55,46690,0.9988234035725746,23.007091555555554,2800.0597813333334,13.659130572306793,136,2.7000000000000006E-4
9,test_20231101_140206,11079715.png,443815,92442,351373,0.7917105100098014,4,4,124136,13015,111121,0.8951553135270993,18.872316444444444,2645.8680106666666,13.905121852903795,136,2.7000000000000006E-4
10,test_20231101_140206,11551286.png,271883,164,271719,0.9993967993585476,2,4,40092,22,40070,0.9994512620971765,18.120286222222223,1899.5769013333334,15.344234809036362,136,2.7000000000000006E-4
1,test_20231101_140206,10404007.png,502730,11499,491231,0.9771268871959103,3,4,61265,1684,59581,0.97251285399494,26.806076444444443,3731.805152,12.411614009328725,136,2.800000000000001E-4
2,test_20231101_140206,1254659.png,342646,52679,289967,0.8462582373645103,3,5,80080,7440,72640,0.9070929070929071,24.00547911111111,4208.260053333333,11.889777912626299,136,2.800000000000001E-4
3,test_20231101_140206,10188041.png,221231,6877,214354,0.9689148446646265,2,4,41731,975,40756,0.9766360739018954,12.735994666666667,1581.1707893333332,16.14101578311401,136,2.800000000000001E-4
4,test_20231101_140206,10287332.png,216980,8062,208918,0.9628445017974007,1,3,22337,1108,21229,0.9503962036083629,11.800304,1559.2556106666666,16.201630454208743,136,2.800000000000001E-4
5,test_20231101_140206,11610969.png,368720,15569,353151,0.9577755478411802,3,3,84111,2292,81819,0.9727502942540215,25.926012444444446,4017.509632,12.091234342080266,136,2.800000000000001E-4
6,test_20231101_140206,10350842.png,212614,3209,209405,0.9849069205226373,1,4,42529,472,42057,0.9889016906111124,22.90571733333333,3257.8204053333334,13.001532216942387,136,2.800000000000001E-4
7,test_20231101_140206,10863862.png,317432,5147,312285,0.9837855036669271,2,4,66058,756,65302,0.9885555118229434,40.163824,7765.409690666666,9.229159875126465,136,2.800000000000001E-4
8,test_20231101_140206,11382381.png,312486,407,312079,0.9986975416498659,2,3,46745,55,46690,0.9988234035725746,23.007091555555554,2800.0597813333334,13.659130572306793,136,2.800000000000001E-4
9,test_20231101_140206,11079715.png,443815,92442,351373,0.7917105100098014,4,4,124136,13015,111121,0.8951553135270993,18.872316444444444,2645.8680106666666,13.905121852903795,136,2.800000000000001E-4
10,test_20231101_140206,11551286.png,271883,164,271719,0.9993967993585476,1,4,40092,22,40070,0.9994512620971765,18.120286222222223,1899.5769013333334,15.344234809036362,136,2.800000000000001E-4
1,test_20231101_140207,10404007.png,502730,11499,491231,0.9771268871959103,3,3,61265,1684,59581,0.97251285399494,26.806076444444443,3731.805152,12.411614009328725,136,2.900000000000001E-4
2,test_20231101_140207,1254659.png,342646,52679,289967,0.8462582373645103,3,4,80080,7440,72640,0.9070929070929071,24.00547911111111,4208.260053333333,11.889777912626299,136,2.900000000000001E-4
3,test_20231101_140207,10188041.png,221231,6877,214354,0.9689148446646265,2,4,41731,975,40756,0.9766360739018954,12.735994666666667,1581.1707893333332,16.14101578311401,136,2.900000000000001E-4
4,test_20231101_140207,10287332.png,216980,8062,208918,0.9628445017974007,2,3,22337,1108,21229,0.9503962036083629,11.800304,1559.2556106666666,16.201630454208743,136,2.900000000000001E-4
5,test_20231101_140207,11610969.png,368720,12112,356608,0.9671512258624431,2,4,84111,1796,82315,0.9786472637348266,37.26566577777778,6699.524229333333,9.87036398750934,136,2.900000000000001E-4
6,test_20231101_140207,10350842.png,212614,3209,209405,0.9849069205226373,2,4,42529,472,42057,0.9889016906111124,22.90571733333333,3257.8204053333334,13.001532216942387,136,2.900000000000001E-4
7,test_20231101_140207,10863862.png,317432,5147,312285,0.9837855036669271,2,4,66058,756,65302,0.9885555118229434,40.163824,7765.409690666666,9.229159875126465,136,2.900000000000001E-4
8,test_20231101_140207,11382381.png,312486,407,312079,0.9986975416498659,1,4,46745,55,46690,0.9988234035725746,23.007091555555554,2800.0597813333334,13.659130572306793,136,2.900000000000001E-4
9,test_20231101_140207,11079715.png,443815,92442,351373,0.7917105100098014,3,5,124136,13015,111121,0.8951553135270993,18.872316444444444,2645.8680106666666,13.905121852903795,136,2.900000000000001E-4
10,test_20231101_140207,11551286.png,271883,164,271719,0.9993967993585476,1,4,40092,22,40070,0.9994512620971765,18.120286222222223,1899.5769013333334,15.344234809036362,136,2.900000000000001E-4
1,test_20231101_140208,10404007.png,502730,11499,491231,0.9771268871959103,2,4,61265,1684,59581,0.97251285399494,26.806076444444443,3731.805152,12.411614009328725,136,3.0000000000000014E-4
2,test_20231101_140208,1254659.png,342646,52679,289967,0.8462582373645103,3,4,80080,7440,72640,0.9070929070929071,24.00547911111111,4208.260053333333,11.889777912626299,136,3.0000000000000014E-4
3,test_20231101_140208,10188041.png,221231,6877,214354,0.9689148446646265,3,4,41731,975,40756,0.9766360739018954,12.735994666666667,1581.1707893333332,16.14101578311401,136,3.0000000000000014E-4
4,test_20231101_140208,10287332.png,216980,8062,208918,0.9628445017974007,1,3,22337,1108,21229,0.9503962036083629,11.800304,1559.2556106666666,16.201630454208743,136,3.0000000000000014E-4
5,test_20231101_140208,11610969.png,368720,12112,356608,0.9671512258624431,2,4,84111,1796,82315,0.9786472637348266,37.26566577777778,6699.524229333333,9.87036398750934,136,3.0000000000000014E-4
6,test_20231101_140208,10350842.png,212614,3209,209405,0.9849069205226373,1,3,42529,472,42057,0.9889016906111124,22.90571733333333,3257.8204053333334,13.001532216942387,136,3.0000000000000014E-4
7,test_20231101_140208,10863862.png,317432,5147,312285,0.9837855036669271,1,3,66058,756,65302,0.9885555118229434,40.163824,7765.409690666666,9.229159875126465,136,3.0000000000000014E-4
8,test_20231101_140208,11382381.png,312486,407,312079,0.9986975416498659,1,3,46745,55,46690,0.9988234035725746,23.007091555555554,2800.0597813333334,13.659130572306793,136,3.0000000000000014E-4
9,test_20231101_140208,11079715.png,443815,92442,351373,0.7917105100098014,3,4,124136,13015,111121,0.8951553135270993,18.872316444444444,2645.8680106666666,13.905121852903795,136,3.0000000000000014E-4
10,test_20231101_140208,11551286.png,271883,164,271719,0.9993967993585476,1,4,40092,22,40070,0.9994512620971765,18.120286222222223,1899.5769013333334,15.344234809036362,136,3.0000000000000014E-4
1,test_20231101_140208,10404007.png,502730,11499,491231,0.9771268871959103,3,4,61265,1684,59581,0.97251285399494,26.806076444444443,3731.805152,12.411614009328725,136,3.1000000000000016E-4
2,test_20231101_140208,1254659.png,342646,52679,289967,0.8462582373645103,3,4,80080,7440,72640,0.9070929070929071,24.00547911111111,4208.260053333333,11.889777912626299,136,3.1000000000000016E-4
3,test_20231101_140208,10188041.png,221231,6877,214354,0.9689148446646265,2,4,41731,975,40756,0.9766360739018954,12.735994666666667,1581.1707893333332,16.14101578311401,136,3.1000000000000016E-4
4,test_20231101_140208,10287332.png,216980,8062,208918,0.9628445017974007,2,5,22337,1108,21229,0.9503962036083629,11.800304,1559.2556106666666,16.201630454208743,136,3.1000000000000016E-4
5,test_20231101_140208,11610969.png,368720,12112,356608,0.9671512258624431,1,4,84111,1796,82315,0.9786472637348266,37.26566577777778,6699.524229333333,9.87036398750934,136,3.1000000000000016E-4
6,test_20231101_140208,10350842.png,212614,3209,209405,0.9849069205226373,2,4,42529,472,42057,0.9889016906111124,22.90571733333333,3257.8204053333334,13.001532216942387,136,3.1000000000000016E-4
7,test_20231101_140208,10863862.png,317432,5147,312285,0.9837855036669271,1,4,66058,756,65302,0.9885555118229434,40.163824,7765.409690666666,9.229159875126465,136,3.1000000000000016E-4
8,test_20231101_140208,11382381.png,312486,407,312079,0.9986975416498659,1,3,46745,55,46690,0.9988234035725746,23.007091555555554,2800.0597813333334,13.659130572306793,136,3.1000000000000016E-4
9,test_20231101_140208,11079715.png,443815,92442,351373,0.7917105100098014,3,4,124136,13015,111121,0.8951553135270993,18.872316444444444,2645.8680106666666,13.905121852903795,136,3.1000000000000016E-4
10,test_20231101_140208,11551286.png,271883,164,271719,0.9993967993585476,2,3,40092,22,40070,0.9994512620971765,18.120286222222223,1899.5769013333334,15.344234809036362,136,3.1000000000000016E-4
1,test_20231101_140209,10404007.png,502730,11499,491231,0.9771268871959103,2,3,61265,1684,59581,0.97251285399494,26.806076444444443,3731.805152,12.411614009328725,136,3.200000000000002E-4
2,test_20231101_140209,1254659.png,342646,52679,289967,0.8462582373645103,3,4,80080,7440,72640,0.9070929070929071,24.00547911111111,4208.260053333333,11.889777912626299,136,3.200000000000002E-4
3,test_20231101_140209,10188041.png,221231,6877,214354,0.9689148446646265,2,3,41731,975,40756,0.9766360739018954,12.735994666666667,1581.1707893333332,16.14101578311401,136,3.200000000000002E-4
4,test_20231101_140209,10287332.png,216980,8062,208918,0.9628445017974007,2,3,22337,1108,21229,0.9503962036083629,11.800304,1559.2556106666666,16.201630454208743,136,3.200000000000002E-4
5,test_20231101_140209,11610969.png,368720,12112,356608,0.9671512258624431,1,4,84111,1796,82315,0.9786472637348266,37.26566577777778,6699.524229333333,9.87036398750934,136,3.200000000000002E-4
6,test_20231101_140209,10350842.png,212614,3209,209405,0.9849069205226373,2,3,42529,472,42057,0.9889016906111124,22.90571733333333,3257.8204053333334,13.001532216942387,136,3.200000000000002E-4
7,test_20231101_140209,10863862.png,317432,5147,312285,0.9837855036669271,1,3,66058,756,65302,0.9885555118229434,40.163824,7765.409690666666,9.229159875126465,136,3.200000000000002E-4
8,test_20231101_140209,11382381.png,312486,407,312079,0.9986975416498659,1,3,46745,55,46690,0.9988234035725746,23.007091555555554,2800.0597813333334,13.659130572306793,136,3.200000000000002E-4
9,test_20231101_140209,11079715.png,443815,92442,351373,0.7917105100098014,3,4,124136,13015,111121,0.8951553135270993,18.872316444444444,2645.8680106666666,13.905121852903795,136,3.200000000000002E-4
10,test_20231101_140209,11551286.png,271883,164,271719,0.9993967993585476,2,3,40092,22,40070,0.9994512620971765,18.120286222222223,1899.5769013333334,15.344234809036362,136,3.200000000000002E-4
1,test_20231101_140210,10404007.png,502730,11499,491231,0.9771268871959103,2,3,61265,1684,59581,0.97251285399494,26.806076444444443,3731.805152,12.411614009328725,136,3.300000000000002E-4
2,test_20231101_140210,1254659.png,342646,52679,289967,0.8462582373645103,2,3,80080,7440,72640,0.9070929070929071,24.00547911111111,4208.260053333333,11.889777912626299,136,3.300000000000002E-4
3,test_20231101_140210,10188041.png,221231,6877,214354,0.9689148446646265,2,4,41731,975,40756,0.9766360739018954,12.735994666666667,1581.1707893333332,16.14101578311401,136,3.300000000000002E-4
4,test_20231101_140210,10287332.png,216980,8062,208918,0.9628445017974007,2,4,22337,1108,21229,0.9503962036083629,11.800304,1559.2556106666666,16.201630454208743,136,3.300000000000002E-4
5,test_20231101_140210,11610969.png,368720,12112,356608,0.9671512258624431,1,3,84111,1796,82315,0.9786472637348266,37.26566577777778,6699.524229333333,9.87036398750934,136,3.300000000000002E-4
6,test_20231101_140210,10350842.png,212614,3209,209405,0.9849069205226373,2,4,42529,472,42057,0.9889016906111124,22.90571733333333,3257.8204053333334,13.001532216942387,136,3.300000000000002E-4
7,test_20231101_140210,10863862.png,317432,5147,312285,0.9837855036669271,1,4,66058,756,65302,0.9885555118229434,40.163824,7765.409690666666,9.229159875126465,136,3.300000000000002E-4
8,test_20231101_140210,11382381.png,312486,407,312079,0.9986975416498659,1,3,46745,55,46690,0.9988234035725746,23.007091555555554,2800.0597813333334,13.659130572306793,136,3.300000000000002E-4
9,test_20231101_140210,11079715.png,443815,92442,351373,0.7917105100098014,3,4,124136,13015,111121,0.8951553135270993,18.872316444444444,2645.8680106666666,13.905121852903795,136,3.300000000000002E-4
10,test_20231101_140210,11551286.png,271883,164,271719,0.9993967993585476,1,4,40092,22,40070,0.9994512620971765,18.120286222222223,1899.5769013333334,15.344234809036362,136,3.300000000000002E-4
1,test_20231101_140210,10404007.png,502730,11499,491231,0.9771268871959103,2,4,61265,1684,59581,0.97251285399494,26.806076444444443,3731.805152,12.411614009328725,136,3.4000000000000024E-4
2,test_20231101_140210,1254659.png,342646,52679,289967,0.8462582373645103,2,4,80080,7440,72640,0.9070929070929071,24.00547911111111,4208.260053333333,11.889777912626299,136,3.4000000000000024E-4
3,test_20231101_140210,10188041.png,221231,6877,214354,0.9689148446646265,2,4,41731,975,40756,0.9766360739018954,12.735994666666667,1581.1707893333332,16.14101578311401,136,3.4000000000000024E-4
4,test_20231101_140210,10287332.png,216980,8062,208918,0.9628445017974007,2,5,22337,1108,21229,0.9503962036083629,11.800304,1559.2556106666666,16.201630454208743,136,3.4000000000000024E-4
5,test_20231101_140210,11610969.png,368720,12112,356608,0.9671512258624431,2,4,84111,1796,82315,0.9786472637348266,37.26566577777778,6699.524229333333,9.87036398750934,136,3.4000000000000024E-4
6,test_20231101_140210,10350842.png,212614,3209,209405,0.9849069205226373,2,3,42529,472,42057,0.9889016906111124,22.90571733333333,3257.8204053333334,13.001532216942387,136,3.4000000000000024E-4
7,test_20231101_140210,10863862.png,317432,5147,312285,0.9837855036669271,2,4,66058,756,65302,0.9885555118229434,40.163824,7765.409690666666,9.229159875126465,136,3.4000000000000024E-4
8,test_20231101_140210,11382381.png,312486,407,312079,0.9986975416498659,1,4,46745,55,46690,0.9988234035725746,23.007091555555554,2800.0597813333334,13.659130572306793,136,3.4000000000000024E-4
9,test_20231101_140210,11079715.png,443815,92442,351373,0.7917105100098014,3,4,124136,13015,111121,0.8951553135270993,18.872316444444444,2645.8680106666666,13.905121852903795,136,3.4000000000000024E-4
10,test_20231101_140210,11551286.png,271883,164,271719,0.9993967993585476,1,4,40092,22,40070,0.9994512620971765,18.120286222222223,1899.5769013333334,15.344234809036362,136,3.4000000000000024E-4
1,test_20231101_140211,10404007.png,502730,11499,491231,0.9771268871959103,2,4,61265,1684,59581,0.97251285399494,26.806076444444443,3731.805152,12.411614009328725,136,3.5000000000000027E-4
2,test_20231101_140211,1254659.png,342646,52679,289967,0.8462582373645103,3,4,80080,7440,72640,0.9070929070929071,24.00547911111111,4208.260053333333,11.889777912626299,136,3.5000000000000027E-4
3,test_20231101_140211,10188041.png,221231,6877,214354,0.9689148446646265,2,3,41731,975,40756,0.9766360739018954,12.735994666666667,1581.1707893333332,16.14101578311401,136,3.5000000000000027E-4
4,test_20231101_140211,10287332.png,216980,8062,208918,0.9628445017974007,1,4,22337,1108,21229,0.9503962036083629,11.800304,1559.2556106666666,16.201630454208743,136,3.5000000000000027E-4
5,test_20231101_140211,11610969.png,368720,12112,356608,0.9671512258624431,2,4,84111,1796,82315,0.9786472637348266,37.26566577777778,6699.524229333333,9.87036398750934,136,3.5000000000000027E-4
6,test_20231101_140211,10350842.png,212614,3209,209405,0.9849069205226373,1,4,42529,472,42057,0.9889016906111124,22.90571733333333,3257.8204053333334,13.001532216942387,136,3.5000000000000027E-4
7,test_20231101_140211,10863862.png,317432,5147,312285,0.9837855036669271,2,4,66058,756,65302,0.9885555118229434,40.163824,7765.409690666666,9.229159875126465,136,3.5000000000000027E-4
8,test_20231101_140211,11382381.png,312486,407,312079,0.9986975416498659,1,4,46745,55,46690,0.9988234035725746,23.007091555555554,2800.0597813333334,13.659130572306793,136,3.5000000000000027E-4
9,test_20231101_140211,11079715.png,443815,92442,351373,0.7917105100098014,3,4,124136,13015,111121,0.8951553135270993,18.872316444444444,2645.8680106666666,13.905121852903795,136,3.5000000000000027E-4
10,test_20231101_140211,11551286.png,271883,164,271719,0.9993967993585476,1,4,40092,22,40070,0.9994512620971765,18.120286222222223,1899.5769013333334,15.344234809036362,136,3.5000000000000027E-4
1,test_20231101_140212,10404007.png,502730,11499,491231,0.9771268871959103,2,4,61265,1684,59581,0.97251285399494,26.806076444444443,3731.805152,12.411614009328725,136,3.600000000000003E-4
2,test_20231101_140212,1254659.png,342646,52679,289967,0.8462582373645103,3,4,80080,7440,72640,0.9070929070929071,24.00547911111111,4208.260053333333,11.889777912626299,136,3.600000000000003E-4
3,test_20231101_140212,10188041.png,221231,6877,214354,0.9689148446646265,2,4,41731,975,40756,0.9766360739018954,12.735994666666667,1581.1707893333332,16.14101578311401,136,3.600000000000003E-4
4,test_20231101_140212,10287332.png,216980,8062,208918,0.9628445017974007,1,3,22337,1108,21229,0.9503962036083629,11.800304,1559.2556106666666,16.201630454208743,136,3.600000000000003E-4
5,test_20231101_140212,11610969.png,368720,12112,356608,0.9671512258624431,2,3,84111,1796,82315,0.9786472637348266,37.26566577777778,6699.524229333333,9.87036398750934,136,3.600000000000003E-4
6,test_20231101_140212,10350842.png,212614,3209,209405,0.9849069205226373,1,3,42529,472,42057,0.9889016906111124,22.90571733333333,3257.8204053333334,13.001532216942387,136,3.600000000000003E-4
7,test_20231101_140212,10863862.png,317432,5147,312285,0.9837855036669271,2,3,66058,756,65302,0.9885555118229434,40.163824,7765.409690666666,9.229159875126465,136,3.600000000000003E-4
8,test_20231101_140212,11382381.png,312486,407,312079,0.9986975416498659,1,4,46745,55,46690,0.9988234035725746,23.007091555555554,2800.0597813333334,13.659130572306793,136,3.600000000000003E-4
9,test_20231101_140212,11079715.png,443815,92442,351373,0.7917105100098014,2,4,124136,13015,111121,0.8951553135270993,18.872316444444444,2645.8680106666666,13.905121852903795,136,3.600000000000003E-4
10,test_20231101_140212,11551286.png,271883,164,271719,0.9993967993585476,1,3,40092,22,40070,0.9994512620971765,18.120286222222223,1899.5769013333334,15.344234809036362,136,3.600000000000003E-4
1,test_20231101_140212,10404007.png,502730,11499,491231,0.9771268871959103,2,3,61265,1684,59581,0.97251285399494,26.806076444444443,3731.805152,12.411614009328725,136,3.700000000000003E-4
2,test_20231101_140212,1254659.png,342646,52679,289967,0.8462582373645103,3,12,80080,7440,72640,0.9070929070929071,24.00547911111111,4208.260053333333,11.889777912626299,136,3.700000000000003E-4
3,test_20231101_140212,10188041.png,221231,6877,214354,0.9689148446646265,2,3,41731,975,40756,0.9766360739018954,12.735994666666667,1581.1707893333332,16.14101578311401,136,3.700000000000003E-4
4,test_20231101_140212,10287332.png,216980,8062,208918,0.9628445017974007,2,4,22337,1108,21229,0.9503962036083629,11.800304,1559.2556106666666,16.201630454208743,136,3.700000000000003E-4
5,test_20231101_140212,11610969.png,368720,12112,356608,0.9671512258624431,2,4,84111,1796,82315,0.9786472637348266,37.26566577777778,6699.524229333333,9.87036398750934,136,3.700000000000003E-4
6,test_20231101_140212,10350842.png,212614,3209,209405,0.9849069205226373,1,4,42529,472,42057,0.9889016906111124,22.90571733333333,3257.8204053333334,13.001532216942387,136,3.700000000000003E-4
7,test_20231101_140212,10863862.png,317432,5147,312285,0.9837855036669271,1,4,66058,756,65302,0.9885555118229434,40.163824,7765.409690666666,9.229159875126465,136,3.700000000000003E-4
8,test_20231101_140212,11382381.png,312486,407,312079,0.9986975416498659,1,3,46745,55,46690,0.9988234035725746,23.007091555555554,2800.0597813333334,13.659130572306793,136,3.700000000000003E-4
9,test_20231101_140212,11079715.png,443815,92442,351373,0.7917105100098014,4,4,124136,13015,111121,0.8951553135270993,18.872316444444444,2645.8680106666666,13.905121852903795,136,3.700000000000003E-4
10,test_20231101_140212,11551286.png,271883,164,271719,0.9993967993585476,1,3,40092,22,40070,0.9994512620971765,18.120286222222223,1899.5769013333334,15.344234809036362,136,3.700000000000003E-4
1,test_20231101_140213,10404007.png,502730,11499,491231,0.9771268871959103,2,4,61265,1684,59581,0.97251285399494,26.806076444444443,3731.805152,12.411614009328725,136,3.8000000000000035E-4
2,test_20231101_140213,1254659.png,342646,52679,289967,0.8462582373645103,2,4,80080,7440,72640,0.9070929070929071,24.00547911111111,4208.260053333333,11.889777912626299,136,3.8000000000000035E-4
3,test_20231101_140213,10188041.png,221231,6877,214354,0.9689148446646265,2,3,41731,975,40756,0.9766360739018954,12.735994666666667,1581.1707893333332,16.14101578311401,136,3.8000000000000035E-4
4,test_20231101_140213,10287332.png,216980,8062,208918,0.9628445017974007,1,4,22337,1108,21229,0.9503962036083629,11.800304,1559.2556106666666,16.201630454208743,136,3.8000000000000035E-4
5,test_20231101_140213,11610969.png,368720,12112,356608,0.9671512258624431,2,3,84111,1796,82315,0.9786472637348266,37.26566577777778,6699.524229333333,9.87036398750934,136,3.8000000000000035E-4
6,test_20231101_140213,10350842.png,212614,3209,209405,0.9849069205226373,1,3,42529,472,42057,0.9889016906111124,22.90571733333333,3257.8204053333334,13.001532216942387,136,3.8000000000000035E-4
7,test_20231101_140213,10863862.png,317432,5147,312285,0.9837855036669271,1,3,66058,756,65302,0.9885555118229434,40.163824,7765.409690666666,9.229159875126465,136,3.8000000000000035E-4
8,test_20231101_140213,11382381.png,312486,407,312079,0.9986975416498659,1,3,46745,55,46690,0.9988234035725746,23.007091555555554,2800.0597813333334,13.659130572306793,136,3.8000000000000035E-4
9,test_20231101_140213,11079715.png,443815,92442,351373,0.7917105100098014,4,4,124136,13015,111121,0.8951553135270993,18.872316444444444,2645.8680106666666,13.905121852903795,136,3.8000000000000035E-4
10,test_20231101_140213,11551286.png,271883,164,271719,0.9993967993585476,1,4,40092,22,40070,0.9994512620971765,18.120286222222223,1899.5769013333334,15.344234809036362,136,3.8000000000000035E-4
1,test_20231101_140214,10404007.png,502730,11499,491231,0.9771268871959103,2,3,61265,1684,59581,0.97251285399494,26.806076444444443,3731.805152,12.411614009328725,136,3.9000000000000037E-4
2,test_20231101_140214,1254659.png,342646,52679,289967,0.8462582373645103,3,4,80080,7440,72640,0.9070929070929071,24.00547911111111,4208.260053333333,11.889777912626299,136,3.9000000000000037E-4
3,test_20231101_140214,10188041.png,221231,6877,214354,0.9689148446646265,2,4,41731,975,40756,0.9766360739018954,12.735994666666667,1581.1707893333332,16.14101578311401,136,3.9000000000000037E-4
4,test_20231101_140214,10287332.png,216980,8062,208918,0.9628445017974007,2,3,22337,1108,21229,0.9503962036083629,11.800304,1559.2556106666666,16.201630454208743,136,3.9000000000000037E-4
5,test_20231101_140214,11610969.png,368720,12112,356608,0.9671512258624431,1,3,84111,1796,82315,0.9786472637348266,37.26566577777778,6699.524229333333,9.87036398750934,136,3.9000000000000037E-4
6,test_20231101_140214,10350842.png,212614,3209,209405,0.9849069205226373,2,10,42529,472,42057,0.9889016906111124,22.90571733333333,3257.8204053333334,13.001532216942387,136,3.9000000000000037E-4
7,test_20231101_140214,10863862.png,317432,5147,312285,0.9837855036669271,1,3,66058,756,65302,0.9885555118229434,40.163824,7765.409690666666,9.229159875126465,136,3.9000000000000037E-4
8,test_20231101_140214,11382381.png,312486,407,312079,0.9986975416498659,2,3,46745,55,46690,0.9988234035725746,23.007091555555554,2800.0597813333334,13.659130572306793,136,3.9000000000000037E-4
9,test_20231101_140214,11079715.png,443815,92442,351373,0.7917105100098014,3,4,124136,13015,111121,0.8951553135270993,18.872316444444444,2645.8680106666666,13.905121852903795,136,3.9000000000000037E-4
10,test_20231101_140214,11551286.png,271883,164,271719,0.9993967993585476,2,3,40092,22,40070,0.9994512620971765,18.120286222222223,1899.5769013333334,15.344234809036362,136,3.9000000000000037E-4
1,test_20231101_140215,10404007.png,502730,11499,491231,0.9771268871959103,2,11,61265,1684,59581,0.97251285399494,26.806076444444443,3731.805152,12.411614009328725,136,4.000000000000004E-4
2,test_20231101_140215,1254659.png,342646,52679,289967,0.8462582373645103,3,4,80080,7440,72640,0.9070929070929071,24.00547911111111,4208.260053333333,11.889777912626299,136,4.000000000000004E-4
3,test_20231101_140215,10188041.png,221231,6877,214354,0.9689148446646265,2,3,41731,975,40756,0.9766360739018954,12.735994666666667,1581.1707893333332,16.14101578311401,136,4.000000000000004E-4
4,test_20231101_140215,10287332.png,216980,8062,208918,0.9628445017974007,2,3,22337,1108,21229,0.9503962036083629,11.800304,1559.2556106666666,16.201630454208743,136,4.000000000000004E-4
5,test_20231101_140215,11610969.png,368720,12112,356608,0.9671512258624431,2,4,84111,1796,82315,0.9786472637348266,37.26566577777778,6699.524229333333,9.87036398750934,136,4.000000000000004E-4
6,test_20231101_140215,10350842.png,212614,3209,209405,0.9849069205226373,2,4,42529,472,42057,0.9889016906111124,22.90571733333333,3257.8204053333334,13.001532216942387,136,4.000000000000004E-4
7,test_20231101_140215,10863862.png,317432,5147,312285,0.9837855036669271,1,3,66058,756,65302,0.9885555118229434,40.163824,7765.409690666666,9.229159875126465,136,4.000000000000004E-4
8,test_20231101_140215,11382381.png,312486,407,312079,0.9986975416498659,2,3,46745,55,46690,0.9988234035725746,23.007091555555554,2800.0597813333334,13.659130572306793,136,4.000000000000004E-4
9,test_20231101_140215,11079715.png,443815,92442,351373,0.7917105100098014,3,4,124136,13015,111121,0.8951553135270993,18.872316444444444,2645.8680106666666,13.905121852903795,136,4.000000000000004E-4
10,test_20231101_140215,11551286.png,271883,164,271719,0.9993967993585476,1,4,40092,22,40070,0.9994512620971765,18.120286222222223,1899.5769013333334,15.344234809036362,136,4.000000000000004E-4
1,test_20231101_140215,10404007.png,502730,11499,491231,0.9771268871959103,3,4,61265,1684,59581,0.97251285399494,26.806076444444443,3731.805152,12.411614009328725,136,4.100000000000004E-4
2,test_20231101_140215,1254659.png,342646,52679,289967,0.8462582373645103,3,4,80080,7440,72640,0.9070929070929071,24.00547911111111,4208.260053333333,11.889777912626299,136,4.100000000000004E-4
3,test_20231101_140215,10188041.png,221231,6877,214354,0.9689148446646265,2,4,41731,975,40756,0.9766360739018954,12.735994666666667,1581.1707893333332,16.14101578311401,136,4.100000000000004E-4
4,test_20231101_140215,10287332.png,216980,8062,208918,0.9628445017974007,2,3,22337,1108,21229,0.9503962036083629,11.800304,1559.2556106666666,16.201630454208743,136,4.100000000000004E-4
5,test_20231101_140215,11610969.png,368720,12112,356608,0.9671512258624431,1,3,84111,1796,82315,0.9786472637348266,37.26566577777778,6699.524229333333,9.87036398750934,136,4.100000000000004E-4
6,test_20231101_140215,10350842.png,212614,3209,209405,0.9849069205226373,2,3,42529,472,42057,0.9889016906111124,22.90571733333333,3257.8204053333334,13.001532216942387,136,4.100000000000004E-4
7,test_20231101_140215,10863862.png,317432,5147,312285,0.9837855036669271,2,4,66058,756,65302,0.9885555118229434,40.163824,7765.409690666666,9.229159875126465,136,4.100000000000004E-4
8,test_20231101_140215,11382381.png,312486,407,312079,0.9986975416498659,1,3,46745,55,46690,0.9988234035725746,23.007091555555554,2800.0597813333334,13.659130572306793,136,4.100000000000004E-4
9,test_20231101_140215,11079715.png,443815,92442,351373,0.7917105100098014,3,5,124136,13015,111121,0.8951553135270993,18.872316444444444,2645.8680106666666,13.905121852903795,136,4.100000000000004E-4
10,test_20231101_140215,11551286.png,271883,164,271719,0.9993967993585476,1,4,40092,22,40070,0.9994512620971765,18.120286222222223,1899.5769013333334,15.344234809036362,136,4.100000000000004E-4
1,test_20231101_140216,10404007.png,502730,11499,491231,0.9771268871959103,2,4,61265,1684,59581,0.97251285399494,26.806076444444443,3731.805152,12.411614009328725,136,4.2000000000000045E-4
2,test_20231101_140216,1254659.png,342646,52679,289967,0.8462582373645103,3,4,80080,7440,72640,0.9070929070929071,24.00547911111111,4208.260053333333,11.889777912626299,136,4.2000000000000045E-4
3,test_20231101_140216,10188041.png,221231,6877,214354,0.9689148446646265,2,3,41731,975,40756,0.9766360739018954,12.735994666666667,1581.1707893333332,16.14101578311401,136,4.2000000000000045E-4
4,test_20231101_140216,10287332.png,216980,8062,208918,0.9628445017974007,2,4,22337,1108,21229,0.9503962036083629,11.800304,1559.2556106666666,16.201630454208743,136,4.2000000000000045E-4
5,test_20231101_140216,11610969.png,368720,12112,356608,0.9671512258624431,2,4,84111,1796,82315,0.9786472637348266,37.26566577777778,6699.524229333333,9.87036398750934,136,4.2000000000000045E-4
6,test_20231101_140216,10350842.png,212614,3209,209405,0.9849069205226373,2,4,42529,472,42057,0.9889016906111124,22.90571733333333,3257.8204053333334,13.001532216942387,136,4.2000000000000045E-4
7,test_20231101_140216,10863862.png,317432,5147,312285,0.9837855036669271,1,4,66058,756,65302,0.9885555118229434,40.163824,7765.409690666666,9.229159875126465,136,4.2000000000000045E-4
8,test_20231101_140216,11382381.png,312486,407,312079,0.9986975416498659,1,3,46745,55,46690,0.9988234035725746,23.007091555555554,2800.0597813333334,13.659130572306793,136,4.2000000000000045E-4
9,test_20231101_140216,11079715.png,443815,92442,351373,0.7917105100098014,3,4,124136,13015,111121,0.8951553135270993,18.872316444444444,2645.8680106666666,13.905121852903795,136,4.2000000000000045E-4
10,test_20231101_140216,11551286.png,271883,164,271719,0.9993967993585476,2,3,40092,22,40070,0.9994512620971765,18.120286222222223,1899.5769013333334,15.344234809036362,136,4.2000000000000045E-4
1,test_20231101_140217,10404007.png,502730,11499,491231,0.9771268871959103,2,4,61265,1684,59581,0.97251285399494,26.806076444444443,3731.805152,12.411614009328725,136,4.300000000000005E-4
2,test_20231101_140217,1254659.png,342646,52679,289967,0.8462582373645103,2,4,80080,7440,72640,0.9070929070929071,24.00547911111111,4208.260053333333,11.889777912626299,136,4.300000000000005E-4
3,test_20231101_140217,10188041.png,221231,6877,214354,0.9689148446646265,2,4,41731,975,40756,0.9766360739018954,12.735994666666667,1581.1707893333332,16.14101578311401,136,4.300000000000005E-4
4,test_20231101_140217,10287332.png,216980,8062,208918,0.9628445017974007,2,4,22337,1108,21229,0.9503962036083629,11.800304,1559.2556106666666,16.201630454208743,136,4.300000000000005E-4
5,test_20231101_140217,11610969.png,368720,12112,356608,0.9671512258624431,2,4,84111,1796,82315,0.9786472637348266,37.26566577777778,6699.524229333333,9.87036398750934,136,4.300000000000005E-4
6,test_20231101_140217,10350842.png,212614,3209,209405,0.9849069205226373,1,3,42529,472,42057,0.9889016906111124,22.90571733333333,3257.8204053333334,13.001532216942387,136,4.300000000000005E-4
7,test_20231101_140217,10863862.png,317432,5147,312285,0.9837855036669271,1,3,66058,756,65302,0.9885555118229434,40.163824,7765.409690666666,9.229159875126465,136,4.300000000000005E-4
8,test_20231101_140217,11382381.png,312486,407,312079,0.9986975416498659,1,3,46745,55,46690,0.9988234035725746,23.007091555555554,2800.0597813333334,13.659130572306793,136,4.300000000000005E-4
9,test_20231101_140217,11079715.png,443815,92442,351373,0.7917105100098014,3,4,124136,13015,111121,0.8951553135270993,18.872316444444444,2645.8680106666666,13.905121852903795,136,4.300000000000005E-4
10,test_20231101_140217,11551286.png,271883,164,271719,0.9993967993585476,1,3,40092,22,40070,0.9994512620971765,18.120286222222223,1899.5769013333334,15.344234809036362,136,4.300000000000005E-4
1,test_20231101_140217,10404007.png,502730,11499,491231,0.9771268871959103,2,4,61265,1684,59581,0.97251285399494,26.806076444444443,3731.805152,12.411614009328725,136,4.400000000000005E-4
2,test_20231101_140217,1254659.png,342646,52679,289967,0.8462582373645103,3,4,80080,7440,72640,0.9070929070929071,24.00547911111111,4208.260053333333,11.889777912626299,136,4.400000000000005E-4
3,test_20231101_140217,10188041.png,221231,6877,214354,0.9689148446646265,2,3,41731,975,40756,0.9766360739018954,12.735994666666667,1581.1707893333332,16.14101578311401,136,4.400000000000005E-4
4,test_20231101_140217,10287332.png,216980,8062,208918,0.9628445017974007,2,3,22337,1108,21229,0.9503962036083629,11.800304,1559.2556106666666,16.201630454208743,136,4.400000000000005E-4
5,test_20231101_140217,11610969.png,368720,12112,356608,0.9671512258624431,1,3,84111,1796,82315,0.9786472637348266,37.26566577777778,6699.524229333333,9.87036398750934,136,4.400000000000005E-4
6,test_20231101_140217,10350842.png,212614,3209,209405,0.9849069205226373,1,4,42529,472,42057,0.9889016906111124,22.90571733333333,3257.8204053333334,13.001532216942387,136,4.400000000000005E-4
7,test_20231101_140217,10863862.png,317432,5147,312285,0.9837855036669271,1,3,66058,756,65302,0.9885555118229434,40.163824,7765.409690666666,9.229159875126465,136,4.400000000000005E-4
8,test_20231101_140217,11382381.png,312486,407,312079,0.9986975416498659,1,4,46745,55,46690,0.9988234035725746,23.007091555555554,2800.0597813333334,13.659130572306793,136,4.400000000000005E-4
9,test_20231101_140217,11079715.png,443815,92442,351373,0.7917105100098014,3,4,124136,13015,111121,0.8951553135270993,18.872316444444444,2645.8680106666666,13.905121852903795,136,4.400000000000005E-4
10,test_20231101_140217,11551286.png,271883,164,271719,0.9993967993585476,1,4,40092,22,40070,0.9994512620971765,18.120286222222223,1899.5769013333334,15.344234809036362,136,4.400000000000005E-4
1,test_20231101_140218,10404007.png,502730,11379,491351,0.9773655839118414,2,4,61265,1666,59599,0.9728066595935689,26.820778666666666,3735.4639466666667,12.407358117542007,136,4.5000000000000053E-4
2,test_20231101_140218,1254659.png,342646,52679,289967,0.8462582373645103,3,4,80080,7440,72640,0.9070929070929071,24.00547911111111,4208.260053333333,11.889777912626299,136,4.5000000000000053E-4
3,test_20231101_140218,10188041.png,221231,6877,214354,0.9689148446646265,2,4,41731,975,40756,0.9766360739018954,12.735994666666667,1581.1707893333332,16.14101578311401,136,4.5000000000000053E-4
4,test_20231101_140218,10287332.png,216980,8062,208918,0.9628445017974007,2,3,22337,1108,21229,0.9503962036083629,11.800304,1559.2556106666666,16.201630454208743,136,4.5000000000000053E-4
5,test_20231101_140218,11610969.png,368720,12112,356608,0.9671512258624431,1,3,84111,1796,82315,0.9786472637348266,37.26566577777778,6699.524229333333,9.87036398750934,136,4.5000000000000053E-4
6,test_20231101_140218,10350842.png,212614,2527,210087,0.9881146114555015,2,3,42529,371,42158,0.9912765407133955,25.633363555555555,3917.2427253333335,12.200998781617834,136,4.5000000000000053E-4
7,test_20231101_140218,10863862.png,317432,4907,312525,0.9845415711081429,1,3,66058,720,65338,0.9891004874504223,40.711514666666666,7911.569381333334,9.148177198420042,136,4.5000000000000053E-4
8,test_20231101_140218,11382381.png,312486,407,312079,0.9986975416498659,2,3,46745,55,46690,0.9988234035725746,23.007091555555554,2800.0597813333334,13.659130572306793,136,4.5000000000000053E-4
9,test_20231101_140218,11079715.png,443815,92442,351373,0.7917105100098014,3,4,124136,13015,111121,0.8951553135270993,18.872316444444444,2645.8680106666666,13.905121852903795,136,4.5000000000000053E-4
10,test_20231101_140218,11551286.png,271883,164,271719,0.9993967993585476,1,4,40092,22,40070,0.9994512620971765,18.120286222222223,1899.5769013333334,15.344234809036362,136,4.5000000000000053E-4
1,test_20231101_140219,10404007.png,502730,11379,491351,0.9773655839118414,2,3,61265,1666,59599,0.9728066595935689,26.820778666666666,3735.4639466666667,12.407358117542007,136,4.6000000000000056E-4
2,test_20231101_140219,1254659.png,342646,52679,289967,0.8462582373645103,3,4,80080,7440,72640,0.9070929070929071,24.00547911111111,4208.260053333333,11.889777912626299,136,4.6000000000000056E-4
3,test_20231101_140219,10188041.png,221231,6877,214354,0.9689148446646265,2,4,41731,975,40756,0.9766360739018954,12.735994666666667,1581.1707893333332,16.14101578311401,136,4.6000000000000056E-4
4,test_20231101_140219,10287332.png,216980,8062,208918,0.9628445017974007,2,4,22337,1108,21229,0.9503962036083629,11.800304,1559.2556106666666,16.201630454208743,136,4.6000000000000056E-4
5,test_20231101_140219,11610969.png,368720,12112,356608,0.9671512258624431,1,3,84111,1796,82315,0.9786472637348266,37.26566577777778,6699.524229333333,9.87036398750934,136,4.6000000000000056E-4
6,test_20231101_140219,10350842.png,212614,2527,210087,0.9881146114555015,2,4,42529,371,42158,0.9912765407133955,25.633363555555555,3917.2427253333335,12.200998781617834,136,4.6000000000000056E-4
7,test_20231101_140219,10863862.png,317432,4907,312525,0.9845415711081429,2,3,66058,720,65338,0.9891004874504223,40.711514666666666,7911.569381333334,9.148177198420042,136,4.6000000000000056E-4
8,test_20231101_140219,11382381.png,312486,407,312079,0.9986975416498659,1,3,46745,55,46690,0.9988234035725746,23.007091555555554,2800.0597813333334,13.659130572306793,136,4.6000000000000056E-4
9,test_20231101_140219,11079715.png,443815,92442,351373,0.7917105100098014,4,4,124136,13015,111121,0.8951553135270993,18.872316444444444,2645.8680106666666,13.905121852903795,136,4.6000000000000056E-4
10,test_20231101_140219,11551286.png,271883,164,271719,0.9993967993585476,1,4,40092,22,40070,0.9994512620971765,18.120286222222223,1899.5769013333334,15.344234809036362,136,4.6000000000000056E-4
1,test_20231101_140219,10404007.png,502730,11379,491351,0.9773655839118414,2,3,61265,1666,59599,0.9728066595935689,26.820778666666666,3735.4639466666667,12.407358117542007,136,4.700000000000006E-4
2,test_20231101_140219,1254659.png,342646,52679,289967,0.8462582373645103,3,4,80080,7440,72640,0.9070929070929071,24.00547911111111,4208.260053333333,11.889777912626299,136,4.700000000000006E-4
3,test_20231101_140219,10188041.png,221231,6877,214354,0.9689148446646265,2,4,41731,975,40756,0.9766360739018954,12.735994666666667,1581.1707893333332,16.14101578311401,136,4.700000000000006E-4
4,test_20231101_140219,10287332.png,216980,8062,208918,0.9628445017974007,2,4,22337,1108,21229,0.9503962036083629,11.800304,1559.2556106666666,16.201630454208743,136,4.700000000000006E-4
5,test_20231101_140219,11610969.png,368720,12112,356608,0.9671512258624431,1,3,84111,1796,82315,0.9786472637348266,37.26566577777778,6699.524229333333,9.87036398750934,136,4.700000000000006E-4
6,test_20231101_140219,10350842.png,212614,2527,210087,0.9881146114555015,1,4,42529,371,42158,0.9912765407133955,25.633363555555555,3917.2427253333335,12.200998781617834,136,4.700000000000006E-4
7,test_20231101_140219,10863862.png,317432,4907,312525,0.9845415711081429,1,3,66058,720,65338,0.9891004874504223,40.711514666666666,7911.569381333334,9.148177198420042,136,4.700000000000006E-4
8,test_20231101_140219,11382381.png,312486,407,312079,0.9986975416498659,1,7,46745,55,46690,0.9988234035725746,23.007091555555554,2800.0597813333334,13.659130572306793,136,4.700000000000006E-4
9,test_20231101_140219,11079715.png,443815,92442,351373,0.7917105100098014,7,5,124136,13015,111121,0.8951553135270993,18.872316444444444,2645.8680106666666,13.905121852903795,136,4.700000000000006E-4
10,test_20231101_140219,11551286.png,271883,164,271719,0.9993967993585476,2,3,40092,22,40070,0.9994512620971765,18.120286222222223,1899.5769013333334,15.344234809036362,136,4.700000000000006E-4
1,test_20231101_140220,10404007.png,502730,11379,491351,0.9773655839118414,2,4,61265,1666,59599,0.9728066595935689,26.820778666666666,3735.4639466666667,12.407358117542007,136,4.800000000000006E-4
2,test_20231101_140220,1254659.png,342646,52679,289967,0.8462582373645103,2,4,80080,7440,72640,0.9070929070929071,24.00547911111111,4208.260053333333,11.889777912626299,136,4.800000000000006E-4
3,test_20231101_140220,10188041.png,221231,6877,214354,0.9689148446646265,2,4,41731,975,40756,0.9766360739018954,12.735994666666667,1581.1707893333332,16.14101578311401,136,4.800000000000006E-4
4,test_20231101_140220,10287332.png,216980,8062,208918,0.9628445017974007,2,3,22337,1108,21229,0.9503962036083629,11.800304,1559.2556106666666,16.201630454208743,136,4.800000000000006E-4
5,test_20231101_140220,11610969.png,368720,12112,356608,0.9671512258624431,2,4,84111,1796,82315,0.9786472637348266,37.26566577777778,6699.524229333333,9.87036398750934,136,4.800000000000006E-4
6,test_20231101_140220,10350842.png,212614,2527,210087,0.9881146114555015,1,4,42529,371,42158,0.9912765407133955,25.633363555555555,3917.2427253333335,12.200998781617834,136,4.800000000000006E-4
7,test_20231101_140220,10863862.png,317432,4907,312525,0.9845415711081429,2,3,66058,720,65338,0.9891004874504223,40.711514666666666,7911.569381333334,9.148177198420042,136,4.800000000000006E-4
8,test_20231101_140220,11382381.png,312486,407,312079,0.9986975416498659,2,3,46745,55,46690,0.9988234035725746,23.007091555555554,2800.0597813333334,13.659130572306793,136,4.800000000000006E-4
9,test_20231101_140220,11079715.png,443815,92442,351373,0.7917105100098014,3,5,124136,13015,111121,0.8951553135270993,18.872316444444444,2645.8680106666666,13.905121852903795,136,4.800000000000006E-4
10,test_20231101_140220,11551286.png,271883,164,271719,0.9993967993585476,1,3,40092,22,40070,0.9994512620971765,18.120286222222223,1899.5769013333334,15.344234809036362,136,4.800000000000006E-4
1,test_20231101_140221,10404007.png,502730,11379,491351,0.9773655839118414,2,3,61265,1666,59599,0.9728066595935689,26.820778666666666,3735.4639466666667,12.407358117542007,136,4.900000000000006E-4
2,test_20231101_140221,1254659.png,342646,52679,289967,0.8462582373645103,3,4,80080,7440,72640,0.9070929070929071,24.00547911111111,4208.260053333333,11.889777912626299,136,4.900000000000006E-4
3,test_20231101_140221,10188041.png,221231,6877,214354,0.9689148446646265,2,4,41731,975,40756,0.9766360739018954,12.735994666666667,1581.1707893333332,16.14101578311401,136,4.900000000000006E-4
4,test_20231101_140221,10287332.png,216980,8062,208918,0.9628445017974007,2,4,22337,1108,21229,0.9503962036083629,11.800304,1559.2556106666666,16.201630454208743,136,4.900000000000006E-4
5,test_20231101_140221,11610969.png,368720,12112,356608,0.9671512258624431,2,4,84111,1796,82315,0.9786472637348266,37.26566577777778,6699.524229333333,9.87036398750934,136,4.900000000000006E-4
6,test_20231101_140221,10350842.png,212614,2527,210087,0.9881146114555015,1,4,42529,371,42158,0.9912765407133955,25.633363555555555,3917.2427253333335,12.200998781617834,136,4.900000000000006E-4
7,test_20231101_140221,10863862.png,317432,4907,312525,0.9845415711081429,1,3,66058,720,65338,0.9891004874504223,40.711514666666666,7911.569381333334,9.148177198420042,136,4.900000000000006E-4
8,test_20231101_140221,11382381.png,312486,407,312079,0.9986975416498659,1,4,46745,55,46690,0.9988234035725746,23.007091555555554,2800.0597813333334,13.659130572306793,136,4.900000000000006E-4
9,test_20231101_140221,11079715.png,443815,92442,351373,0.7917105100098014,3,4,124136,13015,111121,0.8951553135270993,18.872316444444444,2645.8680106666666,13.905121852903795,136,4.900000000000006E-4
10,test_20231101_140221,11551286.png,271883,164,271719,0.9993967993585476,1,4,40092,22,40070,0.9994512620971765,18.120286222222223,1899.5769013333334,15.344234809036362,136,4.900000000000006E-4
1,test_20231101_140221,10404007.png,502730,11379,491351,0.9773655839118414,2,4,61265,1666,59599,0.9728066595935689,26.820778666666666,3735.4639466666667,12.407358117542007,136,5.000000000000007E-4
2,test_20231101_140221,1254659.png,342646,52679,289967,0.8462582373645103,3,3,80080,7440,72640,0.9070929070929071,24.00547911111111,4208.260053333333,11.889777912626299,136,5.000000000000007E-4
3,test_20231101_140221,10188041.png,221231,6877,214354,0.9689148446646265,2,3,41731,975,40756,0.9766360739018954,12.735994666666667,1581.1707893333332,16.14101578311401,136,5.000000000000007E-4
4,test_20231101_140221,10287332.png,216980,8062,208918,0.9628445017974007,2,4,22337,1108,21229,0.9503962036083629,11.800304,1559.2556106666666,16.201630454208743,136,5.000000000000007E-4
5,test_20231101_140221,11610969.png,368720,12112,356608,0.9671512258624431,2,3,84111,1796,82315,0.9786472637348266,37.26566577777778,6699.524229333333,9.87036398750934,136,5.000000000000007E-4
6,test_20231101_140221,10350842.png,212614,2527,210087,0.9881146114555015,2,3,42529,371,42158,0.9912765407133955,25.633363555555555,3917.2427253333335,12.200998781617834,136,5.000000000000007E-4
7,test_20231101_140221,10863862.png,317432,4907,312525,0.9845415711081429,1,3,66058,720,65338,0.9891004874504223,40.711514666666666,7911.569381333334,9.148177198420042,136,5.000000000000007E-4
8,test_20231101_140221,11382381.png,312486,407,312079,0.9986975416498659,1,3,46745,55,46690,0.9988234035725746,23.007091555555554,2800.0597813333334,13.659130572306793,136,5.000000000000007E-4
9,test_20231101_140221,11079715.png,443815,92442,351373,0.7917105100098014,3,4,124136,13015,111121,0.8951553135270993,18.872316444444444,2645.8680106666666,13.905121852903795,136,5.000000000000007E-4
10,test_20231101_140221,11551286.png,271883,164,271719,0.9993967993585476,1,4,40092,22,40070,0.9994512620971765,18.120286222222223,1899.5769013333334,15.344234809036362,136,5.000000000000007E-4
1,test_20231101_140222,10404007.png,502730,11379,491351,0.9773655839118414,2,3,61265,1666,59599,0.9728066595935689,26.820778666666666,3735.4639466666667,12.407358117542007,136,5.100000000000007E-4
2,test_20231101_140222,1254659.png,342646,52679,289967,0.8462582373645103,3,4,80080,7440,72640,0.9070929070929071,24.00547911111111,4208.260053333333,11.889777912626299,136,5.100000000000007E-4
3,test_20231101_140222,10188041.png,221231,6877,214354,0.9689148446646265,2,3,41731,975,40756,0.9766360739018954,12.735994666666667,1581.1707893333332,16.14101578311401,136,5.100000000000007E-4
4,test_20231101_140222,10287332.png,216980,8062,208918,0.9628445017974007,2,4,22337,1108,21229,0.9503962036083629,11.800304,1559.2556106666666,16.201630454208743,136,5.100000000000007E-4
5,test_20231101_140222,11610969.png,368720,11329,357391,0.969274788457366,2,3,84111,1680,82431,0.9800263936940472,37.622933333333336,6794.08832,9.80949172670179,136,5.100000000000007E-4
6,test_20231101_140222,10350842.png,212614,2527,210087,0.9881146114555015,7,3,42529,371,42158,0.9912765407133955,25.633363555555555,3917.2427253333335,12.200998781617834,136,5.100000000000007E-4
7,test_20231101_140222,10863862.png,317432,4907,312525,0.9845415711081429,1,4,66058,720,65338,0.9891004874504223,40.711514666666666,7911.569381333334,9.148177198420042,136,5.100000000000007E-4
8,test_20231101_140222,11382381.png,312486,407,312079,0.9986975416498659,1,3,46745,55,46690,0.9988234035725746,23.007091555555554,2800.0597813333334,13.659130572306793,136,5.100000000000007E-4
9,test_20231101_140222,11079715.png,443815,92262,351553,0.792116084404538,3,4,124136,12988,111148,0.8953728169104853,19.109580444444443,2687.8771466666667,13.836709460932859,136,5.100000000000007E-4
10,test_20231101_140222,11551286.png,271883,164,271719,0.9993967993585476,2,3,40092,22,40070,0.9994512620971765,18.120286222222223,1899.5769013333334,15.344234809036362,136,5.100000000000007E-4
1,test_20231101_140223,10404007.png,502730,11379,491351,0.9773655839118414,2,3,61265,1666,59599,0.9728066595935689,26.820778666666666,3735.4639466666667,12.407358117542007,136,5.200000000000007E-4
2,test_20231101_140223,1254659.png,342646,52679,289967,0.8462582373645103,3,4,80080,7440,72640,0.9070929070929071,24.00547911111111,4208.260053333333,11.889777912626299,136,5.200000000000007E-4
3,test_20231101_140223,10188041.png,221231,6877,214354,0.9689148446646265,2,4,41731,975,40756,0.9766360739018954,12.735994666666667,1581.1707893333332,16.14101578311401,136,5.200000000000007E-4
4,test_20231101_140223,10287332.png,216980,8062,208918,0.9628445017974007,2,4,22337,1108,21229,0.9503962036083629,11.800304,1559.2556106666666,16.201630454208743,136,5.200000000000007E-4
5,test_20231101_140223,11610969.png,368720,11329,357391,0.969274788457366,1,3,84111,1680,82431,0.9800263936940472,37.622933333333336,6794.08832,9.80949172670179,136,5.200000000000007E-4
6,test_20231101_140223,10350842.png,212614,2527,210087,0.9881146114555015,1,3,42529,371,42158,0.9912765407133955,25.633363555555555,3917.2427253333335,12.200998781617834,136,5.200000000000007E-4
7,test_20231101_140223,10863862.png,317432,4907,312525,0.9845415711081429,2,3,66058,720,65338,0.9891004874504223,40.711514666666666,7911.569381333334,9.148177198420042,136,5.200000000000007E-4
8,test_20231101_140223,11382381.png,312486,407,312079,0.9986975416498659,1,3,46745,55,46690,0.9988234035725746,23.007091555555554,2800.0597813333334,13.659130572306793,136,5.200000000000007E-4
9,test_20231101_140223,11079715.png,443815,92262,351553,0.792116084404538,3,4,124136,12988,111148,0.8953728169104853,19.109580444444443,2687.8771466666667,13.836709460932859,136,5.200000000000007E-4
10,test_20231101_140223,11551286.png,271883,164,271719,0.9993967993585476,1,3,40092,22,40070,0.9994512620971765,18.120286222222223,1899.5769013333334,15.344234809036362,136,5.200000000000007E-4
1,test_20231101_140223,10404007.png,502730,11379,491351,0.9773655839118414,2,4,61265,1666,59599,0.9728066595935689,26.820778666666666,3735.4639466666667,12.407358117542007,136,5.300000000000007E-4
2,test_20231101_140223,1254659.png,342646,52679,289967,0.8462582373645103,3,5,80080,7440,72640,0.9070929070929071,24.00547911111111,4208.260053333333,11.889777912626299,136,5.300000000000007E-4
3,test_20231101_140223,10188041.png,221231,6877,214354,0.9689148446646265,2,3,41731,975,40756,0.9766360739018954,12.735994666666667,1581.1707893333332,16.14101578311401,136,5.300000000000007E-4
4,test_20231101_140223,10287332.png,216980,8062,208918,0.9628445017974007,2,3,22337,1108,21229,0.9503962036083629,11.800304,1559.2556106666666,16.201630454208743,136,5.300000000000007E-4
5,test_20231101_140223,11610969.png,368720,11329,357391,0.969274788457366,1,3,84111,1680,82431,0.9800263936940472,37.622933333333336,6794.08832,9.80949172670179,136,5.300000000000007E-4
6,test_20231101_140223,10350842.png,212614,2527,210087,0.9881146114555015,1,3,42529,371,42158,0.9912765407133955,25.633363555555555,3917.2427253333335,12.200998781617834,136,5.300000000000007E-4
7,test_20231101_140223,10863862.png,317432,4907,312525,0.9845415711081429,2,4,66058,720,65338,0.9891004874504223,40.711514666666666,7911.569381333334,9.148177198420042,136,5.300000000000007E-4
8,test_20231101_140223,11382381.png,312486,407,312079,0.9986975416498659,1,3,46745,55,46690,0.9988234035725746,23.007091555555554,2800.0597813333334,13.659130572306793,136,5.300000000000007E-4
9,test_20231101_140223,11079715.png,443815,92262,351553,0.792116084404538,3,5,124136,12988,111148,0.8953728169104853,19.109580444444443,2687.8771466666667,13.836709460932859,136,5.300000000000007E-4
10,test_20231101_140223,11551286.png,271883,164,271719,0.9993967993585476,2,4,40092,22,40070,0.9994512620971765,18.120286222222223,1899.5769013333334,15.344234809036362,136,5.300000000000007E-4
1,test_20231101_140224,10404007.png,502730,11379,491351,0.9773655839118414,2,4,61265,1666,59599,0.9728066595935689,26.820778666666666,3735.4639466666667,12.407358117542007,136,5.400000000000008E-4
2,test_20231101_140224,1254659.png,342646,52679,289967,0.8462582373645103,3,4,80080,7440,72640,0.9070929070929071,24.00547911111111,4208.260053333333,11.889777912626299,136,5.400000000000008E-4
3,test_20231101_140224,10188041.png,221231,6877,214354,0.9689148446646265,2,4,41731,975,40756,0.9766360739018954,12.735994666666667,1581.1707893333332,16.14101578311401,136,5.400000000000008E-4
4,test_20231101_140224,10287332.png,216980,8062,208918,0.9628445017974007,2,4,22337,1108,21229,0.9503962036083629,11.800304,1559.2556106666666,16.201630454208743,136,5.400000000000008E-4
5,test_20231101_140224,11610969.png,368720,11329,357391,0.969274788457366,2,4,84111,1680,82431,0.9800263936940472,37.622933333333336,6794.08832,9.80949172670179,136,5.400000000000008E-4
6,test_20231101_140224,10350842.png,212614,2527,210087,0.9881146114555015,1,4,42529,371,42158,0.9912765407133955,25.633363555555555,3917.2427253333335,12.200998781617834,136,5.400000000000008E-4
7,test_20231101_140224,10863862.png,317432,4907,312525,0.9845415711081429,2,5,66058,720,65338,0.9891004874504223,40.711514666666666,7911.569381333334,9.148177198420042,136,5.400000000000008E-4
8,test_20231101_140224,11382381.png,312486,407,312079,0.9986975416498659,1,4,46745,55,46690,0.9988234035725746,23.007091555555554,2800.0597813333334,13.659130572306793,136,5.400000000000008E-4
9,test_20231101_140224,11079715.png,443815,92262,351553,0.792116084404538,3,4,124136,12988,111148,0.8953728169104853,19.109580444444443,2687.8771466666667,13.836709460932859,136,5.400000000000008E-4
10,test_20231101_140224,11551286.png,271883,24,271859,0.9999117267353972,1,3,40092,1,40091,0.9999750573680535,24.866876444444443,3470.407338666667,12.72699907819776,136,5.400000000000008E-4
1,test_20231101_140225,10404007.png,502730,11379,491351,0.9773655839118414,2,4,61265,1666,59599,0.9728066595935689,26.820778666666666,3735.4639466666667,12.407358117542007,136,5.500000000000008E-4
2,test_20231101_140225,1254659.png,342646,52679,289967,0.8462582373645103,3,5,80080,7440,72640,0.9070929070929071,24.00547911111111,4208.260053333333,11.889777912626299,136,5.500000000000008E-4
3,test_20231101_140225,10188041.png,221231,6877,214354,0.9689148446646265,2,3,41731,975,40756,0.9766360739018954,12.735994666666667,1581.1707893333332,16.14101578311401,136,5.500000000000008E-4
4,test_20231101_140225,10287332.png,216980,8062,208918,0.9628445017974007,2,4,22337,1108,21229,0.9503962036083629,11.800304,1559.2556106666666,16.201630454208743,136,5.500000000000008E-4
5,test_20231101_140225,11610969.png,368720,11329,357391,0.969274788457366,2,4,84111,1680,82431,0.9800263936940472,37.622933333333336,6794.08832,9.80949172670179,136,5.500000000000008E-4
6,test_20231101_140225,10350842.png,212614,2527,210087,0.9881146114555015,1,4,42529,371,42158,0.9912765407133955,25.633363555555555,3917.2427253333335,12.200998781617834,136,5.500000000000008E-4
7,test_20231101_140225,10863862.png,317432,4907,312525,0.9845415711081429,2,3,66058,720,65338,0.9891004874504223,40.711514666666666,7911.569381333334,9.148177198420042,136,5.500000000000008E-4
8,test_20231101_140225,11382381.png,312486,407,312079,0.9986975416498659,1,4,46745,55,46690,0.9988234035725746,23.007091555555554,2800.0597813333334,13.659130572306793,136,5.500000000000008E-4
9,test_20231101_140225,11079715.png,443815,92262,351553,0.792116084404538,3,4,124136,12988,111148,0.8953728169104853,19.109580444444443,2687.8771466666667,13.836709460932859,136,5.500000000000008E-4
10,test_20231101_140225,11551286.png,271883,24,271859,0.9999117267353972,1,4,40092,1,40091,0.9999750573680535,24.866876444444443,3470.407338666667,12.72699907819776,136,5.500000000000008E-4
1,test_20231101_140225,10404007.png,502730,11379,491351,0.9773655839118414,2,3,61265,1666,59599,0.9728066595935689,26.820778666666666,3735.4639466666667,12.407358117542007,136,5.600000000000008E-4
2,test_20231101_140225,1254659.png,342646,52679,289967,0.8462582373645103,2,3,80080,7440,72640,0.9070929070929071,24.00547911111111,4208.260053333333,11.889777912626299,136,5.600000000000008E-4
3,test_20231101_140225,10188041.png,221231,6877,214354,0.9689148446646265,2,3,41731,975,40756,0.9766360739018954,12.735994666666667,1581.1707893333332,16.14101578311401,136,5.600000000000008E-4
4,test_20231101_140225,10287332.png,216980,8062,208918,0.9628445017974007,2,4,22337,1108,21229,0.9503962036083629,11.800304,1559.2556106666666,16.201630454208743,136,5.600000000000008E-4
5,test_20231101_140225,11610969.png,368720,11329,357391,0.969274788457366,1,3,84111,1680,82431,0.9800263936940472,37.622933333333336,6794.08832,9.80949172670179,136,5.600000000000008E-4
6,test_20231101_140225,10350842.png,212614,2527,210087,0.9881146114555015,2,3,42529,371,42158,0.9912765407133955,25.633363555555555,3917.2427253333335,12.200998781617834,136,5.600000000000008E-4
7,test_20231101_140225,10863862.png,317432,4907,312525,0.9845415711081429,1,4,66058,720,65338,0.9891004874504223,40.711514666666666,7911.569381333334,9.148177198420042,136,5.600000000000008E-4
8,test_20231101_140225,11382381.png,312486,407,312079,0.9986975416498659,2,3,46745,55,46690,0.9988234035725746,23.007091555555554,2800.0597813333334,13.659130572306793,136,5.600000000000008E-4
9,test_20231101_140225,11079715.png,443815,92262,351553,0.792116084404538,3,4,124136,12988,111148,0.8953728169104853,19.109580444444443,2687.8771466666667,13.836709460932859,136,5.600000000000008E-4
10,test_20231101_140225,11551286.png,271883,24,271859,0.9999117267353972,1,4,40092,1,40091,0.9999750573680535,24.866876444444443,3470.407338666667,12.72699907819776,136,5.600000000000008E-4
1,test_20231101_140226,10404007.png,502730,11379,491351,0.9773655839118414,3,4,61265,1666,59599,0.9728066595935689,26.820778666666666,3735.4639466666667,12.407358117542007,136,5.700000000000008E-4
2,test_20231101_140226,1254659.png,342646,52679,289967,0.8462582373645103,3,4,80080,7440,72640,0.9070929070929071,24.00547911111111,4208.260053333333,11.889777912626299,136,5.700000000000008E-4
3,test_20231101_140226,10188041.png,221231,6877,214354,0.9689148446646265,2,4,41731,975,40756,0.9766360739018954,12.735994666666667,1581.1707893333332,16.14101578311401,136,5.700000000000008E-4
4,test_20231101_140226,10287332.png,216980,8062,208918,0.9628445017974007,2,4,22337,1108,21229,0.9503962036083629,11.800304,1559.2556106666666,16.201630454208743,136,5.700000000000008E-4
5,test_20231101_140226,11610969.png,368720,11329,357391,0.969274788457366,1,4,84111,1680,82431,0.9800263936940472,37.622933333333336,6794.08832,9.80949172670179,136,5.700000000000008E-4
6,test_20231101_140226,10350842.png,212614,2527,210087,0.9881146114555015,2,3,42529,371,42158,0.9912765407133955,25.633363555555555,3917.2427253333335,12.200998781617834,136,5.700000000000008E-4
7,test_20231101_140226,10863862.png,317432,4907,312525,0.9845415711081429,2,3,66058,720,65338,0.9891004874504223,40.711514666666666,7911.569381333334,9.148177198420042,136,5.700000000000008E-4
8,test_20231101_140226,11382381.png,312486,407,312079,0.9986975416498659,1,3,46745,55,46690,0.9988234035725746,23.007091555555554,2800.0597813333334,13.659130572306793,136,5.700000000000008E-4
9,test_20231101_140226,11079715.png,443815,92262,351553,0.792116084404538,3,4,124136,12988,111148,0.8953728169104853,19.109580444444443,2687.8771466666667,13.836709460932859,136,5.700000000000008E-4
10,test_20231101_140226,11551286.png,271883,24,271859,0.9999117267353972,1,4,40092,1,40091,0.9999750573680535,24.866876444444443,3470.407338666667,12.72699907819776,136,5.700000000000008E-4
1,test_20231101_140227,10404007.png,502730,11379,491351,0.9773655839118414,2,4,61265,1666,59599,0.9728066595935689,26.820778666666666,3735.4639466666667,12.407358117542007,136,5.800000000000009E-4
2,test_20231101_140227,1254659.png,342646,52679,289967,0.8462582373645103,3,4,80080,7440,72640,0.9070929070929071,24.00547911111111,4208.260053333333,11.889777912626299,136,5.800000000000009E-4
3,test_20231101_140227,10188041.png,221231,6797,214434,0.9692764576393001,1,3,41731,965,40766,0.976875703913158,12.774896,1585.2552906666667,16.12981149582319,136,5.800000000000009E-4
4,test_20231101_140227,10287332.png,216980,8062,208918,0.9628445017974007,2,4,22337,1108,21229,0.9503962036083629,11.800304,1559.2556106666666,16.201630454208743,136,5.800000000000009E-4
5,test_20231101_140227,11610969.png,368720,11329,357391,0.969274788457366,2,3,84111,1680,82431,0.9800263936940472,37.622933333333336,6794.08832,9.80949172670179,136,5.800000000000009E-4
6,test_20231101_140227,10350842.png,212614,2527,210087,0.9881146114555015,2,3,42529,371,42158,0.9912765407133955,25.633363555555555,3917.2427253333335,12.200998781617834,136,5.800000000000009E-4
7,test_20231101_140227,10863862.png,317432,4907,312525,0.9845415711081429,2,3,66058,720,65338,0.9891004874504223,40.711514666666666,7911.569381333334,9.148177198420042,136,5.800000000000009E-4
8,test_20231101_140227,11382381.png,312486,407,312079,0.9986975416498659,1,3,46745,55,46690,0.9988234035725746,23.007091555555554,2800.0597813333334,13.659130572306793,136,5.800000000000009E-4
9,test_20231101_140227,11079715.png,443815,92262,351553,0.792116084404538,4,4,124136,12988,111148,0.8953728169104853,19.109580444444443,2687.8771466666667,13.836709460932859,136,5.800000000000009E-4
10,test_20231101_140227,11551286.png,271883,24,271859,0.9999117267353972,1,4,40092,1,40091,0.9999750573680535,24.866876444444443,3470.407338666667,12.72699907819776,136,5.800000000000009E-4
1,test_20231101_140227,10404007.png,502730,11379,491351,0.9773655839118414,2,3,61265,1666,59599,0.9728066595935689,26.820778666666666,3735.4639466666667,12.407358117542007,136,5.900000000000009E-4
2,test_20231101_140227,1254659.png,342646,52679,289967,0.8462582373645103,2,4,80080,7440,72640,0.9070929070929071,24.00547911111111,4208.260053333333,11.889777912626299,136,5.900000000000009E-4
3,test_20231101_140227,10188041.png,221231,6797,214434,0.9692764576393001,2,4,41731,965,40766,0.976875703913158,12.774896,1585.2552906666667,16.12981149582319,136,5.900000000000009E-4
4,test_20231101_140227,10287332.png,216980,8062,208918,0.9628445017974007,1,4,22337,1108,21229,0.9503962036083629,11.800304,1559.2556106666666,16.201630454208743,136,5.900000000000009E-4
5,test_20231101_140227,11610969.png,368720,11329,357391,0.969274788457366,1,3,84111,1680,82431,0.9800263936940472,37.622933333333336,6794.08832,9.80949172670179,136,5.900000000000009E-4
6,test_20231101_140227,10350842.png,212614,2527,210087,0.9881146114555015,1,3,42529,371,42158,0.9912765407133955,25.633363555555555,3917.2427253333335,12.200998781617834,136,5.900000000000009E-4
7,test_20231101_140227,10863862.png,317432,4907,312525,0.9845415711081429,1,4,66058,720,65338,0.9891004874504223,40.711514666666666,7911.569381333334,9.148177198420042,136,5.900000000000009E-4
8,test_20231101_140227,11382381.png,312486,407,312079,0.9986975416498659,1,4,46745,55,46690,0.9988234035725746,23.007091555555554,2800.0597813333334,13.659130572306793,136,5.900000000000009E-4
9,test_20231101_140227,11079715.png,443815,92262,351553,0.792116084404538,3,5,124136,12988,111148,0.8953728169104853,19.109580444444443,2687.8771466666667,13.836709460932859,136,5.900000000000009E-4
10,test_20231101_140227,11551286.png,271883,24,271859,0.9999117267353972,1,4,40092,1,40091,0.9999750573680535,24.866876444444443,3470.407338666667,12.72699907819776,136,5.900000000000009E-4
1,test_20231101_140228,10404007.png,502730,11037,491693,0.9780458695522447,2,4,61265,1616,59649,0.973622786256427,27.155781333333334,3807.485072,12.324421515941006,136,6.000000000000009E-4
2,test_20231101_140228,1254659.png,342646,52679,289967,0.8462582373645103,3,4,80080,7440,72640,0.9070929070929071,24.00547911111111,4208.260053333333,11.889777912626299,136,6.000000000000009E-4
3,test_20231101_140228,10188041.png,221231,6797,214434,0.9692764576393001,2,4,41731,965,40766,0.976875703913158,12.774896,1585.2552906666667,16.12981149582319,136,6.000000000000009E-4
4,test_20231101_140228,10287332.png,216980,8062,208918,0.9628445017974007,2,3,22337,1108,21229,0.9503962036083629,11.800304,1559.2556106666666,16.201630454208743,136,6.000000000000009E-4
5,test_20231101_140228,11610969.png,368720,11329,357391,0.969274788457366,2,4,84111,1680,82431,0.9800263936940472,37.622933333333336,6794.08832,9.80949172670179,136,6.000000000000009E-4
6,test_20231101_140228,10350842.png,212614,2527,210087,0.9881146114555015,1,4,42529,371,42158,0.9912765407133955,25.633363555555555,3917.2427253333335,12.200998781617834,136,6.000000000000009E-4
7,test_20231101_140228,10863862.png,317432,4907,312525,0.9845415711081429,2,4,66058,720,65338,0.9891004874504223,40.711514666666666,7911.569381333334,9.148177198420042,136,6.000000000000009E-4
8,test_20231101_140228,11382381.png,312486,407,312079,0.9986975416498659,3,4,46745,55,46690,0.9988234035725746,23.007091555555554,2800.0597813333334,13.659130572306793,136,6.000000000000009E-4
9,test_20231101_140228,11079715.png,443815,92262,351553,0.792116084404538,3,4,124136,12988,111148,0.8953728169104853,19.109580444444443,2687.8771466666667,13.836709460932859,136,6.000000000000009E-4
10,test_20231101_140228,11551286.png,271883,24,271859,0.9999117267353972,0,3,40092,1,40091,0.9999750573680535,24.866876444444443,3470.407338666667,12.72699907819776,136,6.000000000000009E-4
1,test_20231101_140229,10404007.png,502730,11037,491693,0.9780458695522447,2,3,61265,1616,59649,0.973622786256427,27.155781333333334,3807.485072,12.324421515941006,136,6.10000000000001E-4
2,test_20231101_140229,1254659.png,342646,52679,289967,0.8462582373645103,2,4,80080,7440,72640,0.9070929070929071,24.00547911111111,4208.260053333333,11.889777912626299,136,6.10000000000001E-4
3,test_20231101_140229,10188041.png,221231,6797,214434,0.9692764576393001,1,3,41731,965,40766,0.976875703913158,12.774896,1585.2552906666667,16.12981149582319,136,6.10000000000001E-4
4,test_20231101_140229,10287332.png,216980,8062,208918,0.9628445017974007,1,3,22337,1108,21229,0.9503962036083629,11.800304,1559.2556106666666,16.201630454208743,136,6.10000000000001E-4
5,test_20231101_140229,11610969.png,368720,11329,357391,0.969274788457366,2,4,84111,1680,82431,0.9800263936940472,37.622933333333336,6794.08832,9.80949172670179,136,6.10000000000001E-4
6,test_20231101_140229,10350842.png,212614,2527,210087,0.9881146114555015,1,4,42529,371,42158,0.9912765407133955,25.633363555555555,3917.2427253333335,12.200998781617834,136,6.10000000000001E-4
7,test_20231101_140229,10863862.png,317432,4907,312525,0.9845415711081429,1,4,66058,720,65338,0.9891004874504223,40.711514666666666,7911.569381333334,9.148177198420042,136,6.10000000000001E-4
8,test_20231101_140229,11382381.png,312486,407,312079,0.9986975416498659,2,3,46745,55,46690,0.9988234035725746,23.007091555555554,2800.0597813333334,13.659130572306793,136,6.10000000000001E-4
9,test_20231101_140229,11079715.png,443815,92262,351553,0.792116084404538,3,4,124136,12988,111148,0.8953728169104853,19.109580444444443,2687.8771466666667,13.836709460932859,136,6.10000000000001E-4
10,test_20231101_140229,11551286.png,271883,24,271859,0.9999117267353972,1,4,40092,1,40091,0.9999750573680535,24.866876444444443,3470.407338666667,12.72699907819776,136,6.10000000000001E-4
1,test_20231101_140229,10404007.png,502730,11037,491693,0.9780458695522447,1,3,61265,1616,59649,0.973622786256427,27.155781333333334,3807.485072,12.324421515941006,136,6.20000000000001E-4
2,test_20231101_140229,1254659.png,342646,52679,289967,0.8462582373645103,3,4,80080,7440,72640,0.9070929070929071,24.00547911111111,4208.260053333333,11.889777912626299,136,6.20000000000001E-4
3,test_20231101_140229,10188041.png,221231,6797,214434,0.9692764576393001,2,3,41731,965,40766,0.976875703913158,12.774896,1585.2552906666667,16.12981149582319,136,6.20000000000001E-4
4,test_20231101_140229,10287332.png,216980,8062,208918,0.9628445017974007,2,4,22337,1108,21229,0.9503962036083629,11.800304,1559.2556106666666,16.201630454208743,136,6.20000000000001E-4
5,test_20231101_140229,11610969.png,368720,11329,357391,0.969274788457366,2,4,84111,1680,82431,0.9800263936940472,37.622933333333336,6794.08832,9.80949172670179,136,6.20000000000001E-4
6,test_20231101_140229,10350842.png,212614,2527,210087,0.9881146114555015,2,3,42529,371,42158,0.9912765407133955,25.633363555555555,3917.2427253333335,12.200998781617834,136,6.20000000000001E-4
7,test_20231101_140229,10863862.png,317432,4907,312525,0.9845415711081429,2,4,66058,720,65338,0.9891004874504223,40.711514666666666,7911.569381333334,9.148177198420042,136,6.20000000000001E-4
8,test_20231101_140229,11382381.png,312486,407,312079,0.9986975416498659,1,3,46745,55,46690,0.9988234035725746,23.007091555555554,2800.0597813333334,13.659130572306793,136,6.20000000000001E-4
9,test_20231101_140229,11079715.png,443815,92262,351553,0.792116084404538,4,4,124136,12988,111148,0.8953728169104853,19.109580444444443,2687.8771466666667,13.836709460932859,136,6.20000000000001E-4
10,test_20231101_140229,11551286.png,271883,24,271859,0.9999117267353972,0,3,40092,1,40091,0.9999750573680535,24.866876444444443,3470.407338666667,12.72699907819776,136,6.20000000000001E-4
1,test_20231101_140230,10404007.png,502730,11037,491693,0.9780458695522447,2,4,61265,1616,59649,0.973622786256427,27.155781333333334,3807.485072,12.324421515941006,136,6.30000000000001E-4
2,test_20231101_140230,1254659.png,342646,52679,289967,0.8462582373645103,3,4,80080,7440,72640,0.9070929070929071,24.00547911111111,4208.260053333333,11.889777912626299,136,6.30000000000001E-4
3,test_20231101_140230,10188041.png,221231,6797,214434,0.9692764576393001,2,3,41731,965,40766,0.976875703913158,12.774896,1585.2552906666667,16.12981149582319,136,6.30000000000001E-4
4,test_20231101_140230,10287332.png,216980,8062,208918,0.9628445017974007,2,4,22337,1108,21229,0.9503962036083629,11.800304,1559.2556106666666,16.201630454208743,136,6.30000000000001E-4
5,test_20231101_140230,11610969.png,368720,11329,357391,0.969274788457366,2,4,84111,1680,82431,0.9800263936940472,37.622933333333336,6794.08832,9.80949172670179,136,6.30000000000001E-4
6,test_20231101_140230,10350842.png,212614,2527,210087,0.9881146114555015,2,3,42529,371,42158,0.9912765407133955,25.633363555555555,3917.2427253333335,12.200998781617834,136,6.30000000000001E-4
7,test_20231101_140230,10863862.png,317432,4907,312525,0.9845415711081429,2,4,66058,720,65338,0.9891004874504223,40.711514666666666,7911.569381333334,9.148177198420042,136,6.30000000000001E-4
8,test_20231101_140230,11382381.png,312486,407,312079,0.9986975416498659,1,4,46745,55,46690,0.9988234035725746,23.007091555555554,2800.0597813333334,13.659130572306793,136,6.30000000000001E-4
9,test_20231101_140230,11079715.png,443815,92262,351553,0.792116084404538,3,4,124136,12988,111148,0.8953728169104853,19.109580444444443,2687.8771466666667,13.836709460932859,136,6.30000000000001E-4
10,test_20231101_140230,11551286.png,271883,24,271859,0.9999117267353972,1,3,40092,1,40091,0.9999750573680535,24.866876444444443,3470.407338666667,12.72699907819776,136,6.30000000000001E-4
1,test_20231101_140231,10404007.png,502730,11037,491693,0.9780458695522447,2,3,61265,1616,59649,0.973622786256427,27.155781333333334,3807.485072,12.324421515941006,136,6.40000000000001E-4
2,test_20231101_140231,1254659.png,342646,52679,289967,0.8462582373645103,4,4,80080,7440,72640,0.9070929070929071,24.00547911111111,4208.260053333333,11.889777912626299,136,6.40000000000001E-4
3,test_20231101_140231,10188041.png,221231,6797,214434,0.9692764576393001,2,4,41731,965,40766,0.976875703913158,12.774896,1585.2552906666667,16.12981149582319,136,6.40000000000001E-4
4,test_20231101_140231,10287332.png,216980,8062,208918,0.9628445017974007,1,3,22337,1108,21229,0.9503962036083629,11.800304,1559.2556106666666,16.201630454208743,136,6.40000000000001E-4
5,test_20231101_140231,11610969.png,368720,11329,357391,0.969274788457366,1,3,84111,1680,82431,0.9800263936940472,37.622933333333336,6794.08832,9.80949172670179,136,6.40000000000001E-4
6,test_20231101_140231,10350842.png,212614,2527,210087,0.9881146114555015,2,3,42529,371,42158,0.9912765407133955,25.633363555555555,3917.2427253333335,12.200998781617834,136,6.40000000000001E-4
7,test_20231101_140231,10863862.png,317432,4907,312525,0.9845415711081429,2,4,66058,720,65338,0.9891004874504223,40.711514666666666,7911.569381333334,9.148177198420042,136,6.40000000000001E-4
8,test_20231101_140231,11382381.png,312486,407,312079,0.9986975416498659,1,3,46745,55,46690,0.9988234035725746,23.007091555555554,2800.0597813333334,13.659130572306793,136,6.40000000000001E-4
9,test_20231101_140231,11079715.png,443815,92262,351553,0.792116084404538,4,4,124136,12988,111148,0.8953728169104853,19.109580444444443,2687.8771466666667,13.836709460932859,136,6.40000000000001E-4
10,test_20231101_140231,11551286.png,271883,24,271859,0.9999117267353972,1,4,40092,1,40091,0.9999750573680535,24.866876444444443,3470.407338666667,12.72699907819776,136,6.40000000000001E-4
1,test_20231101_140231,10404007.png,502730,11037,491693,0.9780458695522447,2,3,61265,1616,59649,0.973622786256427,27.155781333333334,3807.485072,12.324421515941006,136,6.500000000000011E-4
2,test_20231101_140231,1254659.png,342646,52679,289967,0.8462582373645103,3,4,80080,7440,72640,0.9070929070929071,24.00547911111111,4208.260053333333,11.889777912626299,136,6.500000000000011E-4
3,test_20231101_140231,10188041.png,221231,6797,214434,0.9692764576393001,2,4,41731,965,40766,0.976875703913158,12.774896,1585.2552906666667,16.12981149582319,136,6.500000000000011E-4
4,test_20231101_140231,10287332.png,216980,8062,208918,0.9628445017974007,2,4,22337,1108,21229,0.9503962036083629,11.800304,1559.2556106666666,16.201630454208743,136,6.500000000000011E-4
5,test_20231101_140231,11610969.png,368720,11329,357391,0.969274788457366,2,4,84111,1680,82431,0.9800263936940472,37.622933333333336,6794.08832,9.80949172670179,136,6.500000000000011E-4
6,test_20231101_140231,10350842.png,212614,2527,210087,0.9881146114555015,1,4,42529,371,42158,0.9912765407133955,25.633363555555555,3917.2427253333335,12.200998781617834,136,6.500000000000011E-4
7,test_20231101_140231,10863862.png,317432,4907,312525,0.9845415711081429,1,4,66058,720,65338,0.9891004874504223,40.711514666666666,7911.569381333334,9.148177198420042,136,6.500000000000011E-4
8,test_20231101_140231,11382381.png,312486,407,312079,0.9986975416498659,1,6,46745,55,46690,0.9988234035725746,23.007091555555554,2800.0597813333334,13.659130572306793,136,6.500000000000011E-4
9,test_20231101_140231,11079715.png,443815,92262,351553,0.792116084404538,4,4,124136,12988,111148,0.8953728169104853,19.109580444444443,2687.8771466666667,13.836709460932859,136,6.500000000000011E-4
10,test_20231101_140231,11551286.png,271883,24,271859,0.9999117267353972,1,3,40092,1,40091,0.9999750573680535,24.866876444444443,3470.407338666667,12.72699907819776,136,6.500000000000011E-4
1,test_20231101_140232,10404007.png,502730,11037,491693,0.9780458695522447,2,4,61265,1616,59649,0.973622786256427,27.155781333333334,3807.485072,12.324421515941006,136,6.600000000000011E-4
2,test_20231101_140232,1254659.png,342646,52679,289967,0.8462582373645103,3,4,80080,7440,72640,0.9070929070929071,24.00547911111111,4208.260053333333,11.889777912626299,136,6.600000000000011E-4
3,test_20231101_140232,10188041.png,221231,6797,214434,0.9692764576393001,2,4,41731,965,40766,0.976875703913158,12.774896,1585.2552906666667,16.12981149582319,136,6.600000000000011E-4
4,test_20231101_140232,10287332.png,216980,8062,208918,0.9628445017974007,1,4,22337,1108,21229,0.9503962036083629,11.800304,1559.2556106666666,16.201630454208743,136,6.600000000000011E-4
5,test_20231101_140232,11610969.png,368720,11329,357391,0.969274788457366,2,4,84111,1680,82431,0.9800263936940472,37.622933333333336,6794.08832,9.80949172670179,136,6.600000000000011E-4
6,test_20231101_140232,10350842.png,212614,2527,210087,0.9881146114555015,1,4,42529,371,42158,0.9912765407133955,25.633363555555555,3917.2427253333335,12.200998781617834,136,6.600000000000011E-4
7,test_20231101_140232,10863862.png,317432,4907,312525,0.9845415711081429,2,4,66058,720,65338,0.9891004874504223,40.711514666666666,7911.569381333334,9.148177198420042,136,6.600000000000011E-4
8,test_20231101_140232,11382381.png,312486,407,312079,0.9986975416498659,1,4,46745,55,46690,0.9988234035725746,23.007091555555554,2800.0597813333334,13.659130572306793,136,6.600000000000011E-4
9,test_20231101_140232,11079715.png,443815,92262,351553,0.792116084404538,3,4,124136,12988,111148,0.8953728169104853,19.109580444444443,2687.8771466666667,13.836709460932859,136,6.600000000000011E-4
10,test_20231101_140232,11551286.png,271883,24,271859,0.9999117267353972,0,10,40092,1,40091,0.9999750573680535,24.866876444444443,3470.407338666667,12.72699907819776,136,6.600000000000011E-4
1,test_20231101_140233,10404007.png,502730,11037,491693,0.9780458695522447,2,4,61265,1616,59649,0.973622786256427,27.155781333333334,3807.485072,12.324421515941006,136,6.700000000000011E-4
2,test_20231101_140233,1254659.png,342646,52679,289967,0.8462582373645103,3,4,80080,7440,72640,0.9070929070929071,24.00547911111111,4208.260053333333,11.889777912626299,136,6.700000000000011E-4
3,test_20231101_140233,10188041.png,221231,6797,214434,0.9692764576393001,1,3,41731,965,40766,0.976875703913158,12.774896,1585.2552906666667,16.12981149582319,136,6.700000000000011E-4
4,test_20231101_140233,10287332.png,216980,8062,208918,0.9628445017974007,2,3,22337,1108,21229,0.9503962036083629,11.800304,1559.2556106666666,16.201630454208743,136,6.700000000000011E-4
5,test_20231101_140233,11610969.png,368720,11329,357391,0.969274788457366,1,3,84111,1680,82431,0.9800263936940472,37.622933333333336,6794.08832,9.80949172670179,136,6.700000000000011E-4
6,test_20231101_140233,10350842.png,212614,2527,210087,0.9881146114555015,2,4,42529,371,42158,0.9912765407133955,25.633363555555555,3917.2427253333335,12.200998781617834,136,6.700000000000011E-4
7,test_20231101_140233,10863862.png,317432,4907,312525,0.9845415711081429,2,4,66058,720,65338,0.9891004874504223,40.711514666666666,7911.569381333334,9.148177198420042,136,6.700000000000011E-4
8,test_20231101_140233,11382381.png,312486,407,312079,0.9986975416498659,2,3,46745,55,46690,0.9988234035725746,23.007091555555554,2800.0597813333334,13.659130572306793,136,6.700000000000011E-4
9,test_20231101_140233,11079715.png,443815,92262,351553,0.792116084404538,3,4,124136,12988,111148,0.8953728169104853,19.109580444444443,2687.8771466666667,13.836709460932859,136,6.700000000000011E-4
10,test_20231101_140233,11551286.png,271883,24,271859,0.9999117267353972,0,3,40092,1,40091,0.9999750573680535,24.866876444444443,3470.407338666667,12.72699907819776,136,6.700000000000011E-4
1,test_20231101_140233,10404007.png,502730,11037,491693,0.9780458695522447,2,3,61265,1616,59649,0.973622786256427,27.155781333333334,3807.485072,12.324421515941006,136,6.800000000000011E-4
2,test_20231101_140233,1254659.png,342646,52679,289967,0.8462582373645103,3,4,80080,7440,72640,0.9070929070929071,24.00547911111111,4208.260053333333,11.889777912626299,136,6.800000000000011E-4
3,test_20231101_140233,10188041.png,221231,6797,214434,0.9692764576393001,2,4,41731,965,40766,0.976875703913158,12.774896,1585.2552906666667,16.12981149582319,136,6.800000000000011E-4
4,test_20231101_140233,10287332.png,216980,8062,208918,0.9628445017974007,2,4,22337,1108,21229,0.9503962036083629,11.800304,1559.2556106666666,16.201630454208743,136,6.800000000000011E-4
5,test_20231101_140233,11610969.png,368720,11329,357391,0.969274788457366,2,3,84111,1680,82431,0.9800263936940472,37.622933333333336,6794.08832,9.80949172670179,136,6.800000000000011E-4
6,test_20231101_140233,10350842.png,212614,2527,210087,0.9881146114555015,1,4,42529,371,42158,0.9912765407133955,25.633363555555555,3917.2427253333335,12.200998781617834,136,6.800000000000011E-4
7,test_20231101_140233,10863862.png,317432,4907,312525,0.9845415711081429,1,3,66058,720,65338,0.9891004874504223,40.711514666666666,7911.569381333334,9.148177198420042,136,6.800000000000011E-4
8,test_20231101_140233,11382381.png,312486,407,312079,0.9986975416498659,1,4,46745,55,46690,0.9988234035725746,23.007091555555554,2800.0597813333334,13.659130572306793,136,6.800000000000011E-4
9,test_20231101_140233,11079715.png,443815,92262,351553,0.792116084404538,3,4,124136,12988,111148,0.8953728169104853,19.109580444444443,2687.8771466666667,13.836709460932859,136,6.800000000000011E-4
10,test_20231101_140233,11551286.png,271883,24,271859,0.9999117267353972,0,3,40092,1,40091,0.9999750573680535,24.866876444444443,3470.407338666667,12.72699907819776,136,6.800000000000011E-4
1,test_20231101_140234,10404007.png,502730,11037,491693,0.9780458695522447,2,4,61265,1616,59649,0.973622786256427,27.155781333333334,3807.485072,12.324421515941006,136,6.900000000000012E-4
2,test_20231101_140234,1254659.png,342646,52679,289967,0.8462582373645103,2,3,80080,7440,72640,0.9070929070929071,24.00547911111111,4208.260053333333,11.889777912626299,136,6.900000000000012E-4
3,test_20231101_140234,10188041.png,221231,6797,214434,0.9692764576393001,2,4,41731,965,40766,0.976875703913158,12.774896,1585.2552906666667,16.12981149582319,136,6.900000000000012E-4
4,test_20231101_140234,10287332.png,216980,8062,208918,0.9628445017974007,2,3,22337,1108,21229,0.9503962036083629,11.800304,1559.2556106666666,16.201630454208743,136,6.900000000000012E-4
5,test_20231101_140234,11610969.png,368720,11329,357391,0.969274788457366,2,3,84111,1680,82431,0.9800263936940472,37.622933333333336,6794.08832,9.80949172670179,136,6.900000000000012E-4
6,test_20231101_140234,10350842.png,212614,2527,210087,0.9881146114555015,1,4,42529,371,42158,0.9912765407133955,25.633363555555555,3917.2427253333335,12.200998781617834,136,6.900000000000012E-4
7,test_20231101_140234,10863862.png,317432,4907,312525,0.9845415711081429,2,4,66058,720,65338,0.9891004874504223,40.711514666666666,7911.569381333334,9.148177198420042,136,6.900000000000012E-4
8,test_20231101_140234,11382381.png,312486,407,312079,0.9986975416498659,1,3,46745,55,46690,0.9988234035725746,23.007091555555554,2800.0597813333334,13.659130572306793,136,6.900000000000012E-4
9,test_20231101_140234,11079715.png,443815,92262,351553,0.792116084404538,3,4,124136,12988,111148,0.8953728169104853,19.109580444444443,2687.8771466666667,13.836709460932859,136,6.900000000000012E-4
10,test_20231101_140234,11551286.png,271883,24,271859,0.9999117267353972,1,4,40092,1,40091,0.9999750573680535,24.866876444444443,3470.407338666667,12.72699907819776,136,6.900000000000012E-4
1,test_20231101_140235,10404007.png,502730,11037,491693,0.9780458695522447,2,4,61265,1616,59649,0.973622786256427,27.155781333333334,3807.485072,12.324421515941006,136,7.000000000000012E-4
2,test_20231101_140235,1254659.png,342646,52679,289967,0.8462582373645103,2,3,80080,7440,72640,0.9070929070929071,24.00547911111111,4208.260053333333,11.889777912626299,136,7.000000000000012E-4
3,test_20231101_140235,10188041.png,221231,6797,214434,0.9692764576393001,2,3,41731,965,40766,0.976875703913158,12.774896,1585.2552906666667,16.12981149582319,136,7.000000000000012E-4
4,test_20231101_140235,10287332.png,216980,8062,208918,0.9628445017974007,1,3,22337,1108,21229,0.9503962036083629,11.800304,1559.2556106666666,16.201630454208743,136,7.000000000000012E-4
5,test_20231101_140235,11610969.png,368720,11329,357391,0.969274788457366,1,4,84111,1680,82431,0.9800263936940472,37.622933333333336,6794.08832,9.80949172670179,136,7.000000000000012E-4
6,test_20231101_140235,10350842.png,212614,2527,210087,0.9881146114555015,2,3,42529,371,42158,0.9912765407133955,25.633363555555555,3917.2427253333335,12.200998781617834,136,7.000000000000012E-4
7,test_20231101_140235,10863862.png,317432,4907,312525,0.9845415711081429,1,4,66058,720,65338,0.9891004874504223,40.711514666666666,7911.569381333334,9.148177198420042,136,7.000000000000012E-4
8,test_20231101_140235,11382381.png,312486,407,312079,0.9986975416498659,1,4,46745,55,46690,0.9988234035725746,23.007091555555554,2800.0597813333334,13.659130572306793,136,7.000000000000012E-4
9,test_20231101_140235,11079715.png,443815,92262,351553,0.792116084404538,3,3,124136,12988,111148,0.8953728169104853,19.109580444444443,2687.8771466666667,13.836709460932859,136,7.000000000000012E-4
10,test_20231101_140235,11551286.png,271883,24,271859,0.9999117267353972,1,4,40092,1,40091,0.9999750573680535,24.866876444444443,3470.407338666667,12.72699907819776,136,7.000000000000012E-4
1,test_20231101_140235,10404007.png,502730,11037,491693,0.9780458695522447,2,3,61265,1616,59649,0.973622786256427,27.155781333333334,3807.485072,12.324421515941006,136,7.100000000000012E-4
2,test_20231101_140235,1254659.png,342646,52679,289967,0.8462582373645103,2,4,80080,7440,72640,0.9070929070929071,24.00547911111111,4208.260053333333,11.889777912626299,136,7.100000000000012E-4
3,test_20231101_140235,10188041.png,221231,6797,214434,0.9692764576393001,2,4,41731,965,40766,0.976875703913158,12.774896,1585.2552906666667,16.12981149582319,136,7.100000000000012E-4
4,test_20231101_140235,10287332.png,216980,8062,208918,0.9628445017974007,2,3,22337,1108,21229,0.9503962036083629,11.800304,1559.2556106666666,16.201630454208743,136,7.100000000000012E-4
5,test_20231101_140235,11610969.png,368720,11329,357391,0.969274788457366,1,3,84111,1680,82431,0.9800263936940472,37.622933333333336,6794.08832,9.80949172670179,136,7.100000000000012E-4
6,test_20231101_140235,10350842.png,212614,2204,210410,0.9896337964574299,2,4,42529,323,42206,0.9924051823461638,26.50464,4130.358282666667,11.970926352560056,136,7.100000000000012E-4
7,test_20231101_140235,10863862.png,317432,4907,312525,0.9845415711081429,2,3,66058,720,65338,0.9891004874504223,40.711514666666666,7911.569381333334,9.148177198420042,136,7.100000000000012E-4
8,test_20231101_140235,11382381.png,312486,407,312079,0.9986975416498659,2,3,46745,55,46690,0.9988234035725746,23.007091555555554,2800.0597813333334,13.659130572306793,136,7.100000000000012E-4
9,test_20231101_140235,11079715.png,443815,92262,351553,0.792116084404538,3,4,124136,12988,111148,0.8953728169104853,19.109580444444443,2687.8771466666667,13.836709460932859,136,7.100000000000012E-4
10,test_20231101_140235,11551286.png,271883,24,271859,0.9999117267353972,0,3,40092,1,40091,0.9999750573680535,24.866876444444443,3470.407338666667,12.72699907819776,136,7.100000000000012E-4
1,test_20231101_140236,10404007.png,502730,11037,491693,0.9780458695522447,2,4,61265,1616,59649,0.973622786256427,27.155781333333334,3807.485072,12.324421515941006,136,7.200000000000012E-4
2,test_20231101_140236,1254659.png,342646,52679,289967,0.8462582373645103,3,4,80080,7440,72640,0.9070929070929071,24.00547911111111,4208.260053333333,11.889777912626299,136,7.200000000000012E-4
3,test_20231101_140236,10188041.png,221231,6797,214434,0.9692764576393001,2,4,41731,965,40766,0.976875703913158,12.774896,1585.2552906666667,16.12981149582319,136,7.200000000000012E-4
4,test_20231101_140236,10287332.png,216980,8062,208918,0.9628445017974007,1,3,22337,1108,21229,0.9503962036083629,11.800304,1559.2556106666666,16.201630454208743,136,7.200000000000012E-4
5,test_20231101_140236,11610969.png,368720,11329,357391,0.969274788457366,1,3,84111,1680,82431,0.9800263936940472,37.622933333333336,6794.08832,9.80949172670179,136,7.200000000000012E-4
6,test_20231101_140236,10350842.png,212614,2204,210410,0.9896337964574299,2,3,42529,323,42206,0.9924051823461638,26.50464,4130.358282666667,11.970926352560056,136,7.200000000000012E-4
7,test_20231101_140236,10863862.png,317432,4907,312525,0.9845415711081429,2,3,66058,720,65338,0.9891004874504223,40.711514666666666,7911.569381333334,9.148177198420042,136,7.200000000000012E-4
8,test_20231101_140236,11382381.png,312486,407,312079,0.9986975416498659,2,3,46745,55,46690,0.9988234035725746,23.007091555555554,2800.0597813333334,13.659130572306793,136,7.200000000000012E-4
9,test_20231101_140236,11079715.png,443815,92262,351553,0.792116084404538,3,5,124136,12988,111148,0.8953728169104853,19.109580444444443,2687.8771466666667,13.836709460932859,136,7.200000000000012E-4
10,test_20231101_140236,11551286.png,271883,24,271859,0.9999117267353972,1,3,40092,1,40091,0.9999750573680535,24.866876444444443,3470.407338666667,12.72699907819776,136,7.200000000000012E-4
1,test_20231101_140237,10404007.png,502730,11037,491693,0.9780458695522447,2,3,61265,1616,59649,0.973622786256427,27.155781333333334,3807.485072,12.324421515941006,136,7.300000000000013E-4
2,test_20231101_140237,1254659.png,342646,52679,289967,0.8462582373645103,3,4,80080,7440,72640,0.9070929070929071,24.00547911111111,4208.260053333333,11.889777912626299,136,7.300000000000013E-4
3,test_20231101_140237,10188041.png,221231,6797,214434,0.9692764576393001,2,4,41731,965,40766,0.976875703913158,12.774896,1585.2552906666667,16.12981149582319,136,7.300000000000013E-4
4,test_20231101_140237,10287332.png,216980,8062,208918,0.9628445017974007,1,4,22337,1108,21229,0.9503962036083629,11.800304,1559.2556106666666,16.201630454208743,136,7.300000000000013E-4
5,test_20231101_140237,11610969.png,368720,11329,357391,0.969274788457366,2,4,84111,1680,82431,0.9800263936940472,37.622933333333336,6794.08832,9.80949172670179,136,7.300000000000013E-4
6,test_20231101_140237,10350842.png,212614,2204,210410,0.9896337964574299,2,3,42529,323,42206,0.9924051823461638,26.50464,4130.358282666667,11.970926352560056,136,7.300000000000013E-4
7,test_20231101_140237,10863862.png,317432,4907,312525,0.9845415711081429,2,4,66058,720,65338,0.9891004874504223,40.711514666666666,7911.569381333334,9.148177198420042,136,7.300000000000013E-4
8,test_20231101_140237,11382381.png,312486,407,312079,0.9986975416498659,2,3,46745,55,46690,0.9988234035725746,23.007091555555554,2800.0597813333334,13.659130572306793,136,7.300000000000013E-4
9,test_20231101_140237,11079715.png,443815,92262,351553,0.792116084404538,3,4,124136,12988,111148,0.8953728169104853,19.109580444444443,2687.8771466666667,13.836709460932859,136,7.300000000000013E-4
10,test_20231101_140237,11551286.png,271883,24,271859,0.9999117267353972,1,4,40092,1,40091,0.9999750573680535,24.866876444444443,3470.407338666667,12.72699907819776,136,7.300000000000013E-4
1,test_20231101_140237,10404007.png,502730,11037,491693,0.9780458695522447,2,3,61265,1616,59649,0.973622786256427,27.155781333333334,3807.485072,12.324421515941006,136,7.400000000000013E-4
2,test_20231101_140237,1254659.png,342646,52679,289967,0.8462582373645103,2,3,80080,7440,72640,0.9070929070929071,24.00547911111111,4208.260053333333,11.889777912626299,136,7.400000000000013E-4
3,test_20231101_140237,10188041.png,221231,6797,214434,0.9692764576393001,2,4,41731,965,40766,0.976875703913158,12.774896,1585.2552906666667,16.12981149582319,136,7.400000000000013E-4
4,test_20231101_140237,10287332.png,216980,8062,208918,0.9628445017974007,3,3,22337,1108,21229,0.9503962036083629,11.800304,1559.2556106666666,16.201630454208743,136,7.400000000000013E-4
5,test_20231101_140237,11610969.png,368720,11329,357391,0.969274788457366,1,4,84111,1680,82431,0.9800263936940472,37.622933333333336,6794.08832,9.80949172670179,136,7.400000000000013E-4
6,test_20231101_140237,10350842.png,212614,2204,210410,0.9896337964574299,1,4,42529,323,42206,0.9924051823461638,26.50464,4130.358282666667,11.970926352560056,136,7.400000000000013E-4
7,test_20231101_140237,10863862.png,317432,4907,312525,0.9845415711081429,2,7,66058,720,65338,0.9891004874504223,40.711514666666666,7911.569381333334,9.148177198420042,136,7.400000000000013E-4
8,test_20231101_140237,11382381.png,312486,407,312079,0.9986975416498659,1,3,46745,55,46690,0.9988234035725746,23.007091555555554,2800.0597813333334,13.659130572306793,136,7.400000000000013E-4
9,test_20231101_140237,11079715.png,443815,92262,351553,0.792116084404538,3,4,124136,12988,111148,0.8953728169104853,19.109580444444443,2687.8771466666667,13.836709460932859,136,7.400000000000013E-4
10,test_20231101_140237,11551286.png,271883,24,271859,0.9999117267353972,1,4,40092,1,40091,0.9999750573680535,24.866876444444443,3470.407338666667,12.72699907819776,136,7.400000000000013E-4
1,test_20231101_140238,10404007.png,502730,11037,491693,0.9780458695522447,2,4,61265,1616,59649,0.973622786256427,27.155781333333334,3807.485072,12.324421515941006,136,7.500000000000013E-4
2,test_20231101_140238,1254659.png,342646,52679,289967,0.8462582373645103,2,4,80080,7440,72640,0.9070929070929071,24.00547911111111,4208.260053333333,11.889777912626299,136,7.500000000000013E-4
3,test_20231101_140238,10188041.png,221231,6797,214434,0.9692764576393001,2,4,41731,965,40766,0.976875703913158,12.774896,1585.2552906666667,16.12981149582319,136,7.500000000000013E-4
4,test_20231101_140238,10287332.png,216980,8062,208918,0.9628445017974007,2,4,22337,1108,21229,0.9503962036083629,11.800304,1559.2556106666666,16.201630454208743,136,7.500000000000013E-4
5,test_20231101_140238,11610969.png,368720,11329,357391,0.969274788457366,1,3,84111,1680,82431,0.9800263936940472,37.622933333333336,6794.08832,9.80949172670179,136,7.500000000000013E-4
6,test_20231101_140238,10350842.png,212614,2204,210410,0.9896337964574299,2,3,42529,323,42206,0.9924051823461638,26.50464,4130.358282666667,11.970926352560056,136,7.500000000000013E-4
7,test_20231101_140238,10863862.png,317432,4907,312525,0.9845415711081429,2,3,66058,720,65338,0.9891004874504223,40.711514666666666,7911.569381333334,9.148177198420042,136,7.500000000000013E-4
8,test_20231101_140238,11382381.png,312486,407,312079,0.9986975416498659,1,4,46745,55,46690,0.9988234035725746,23.007091555555554,2800.0597813333334,13.659130572306793,136,7.500000000000013E-4
9,test_20231101_140238,11079715.png,443815,92262,351553,0.792116084404538,3,4,124136,12988,111148,0.8953728169104853,19.109580444444443,2687.8771466666667,13.836709460932859,136,7.500000000000013E-4
10,test_20231101_140238,11551286.png,271883,24,271859,0.9999117267353972,1,4,40092,1,40091,0.9999750573680535,24.866876444444443,3470.407338666667,12.72699907819776,136,7.500000000000013E-4
1,test_20231101_140239,10404007.png,502730,11037,491693,0.9780458695522447,2,4,61265,1616,59649,0.973622786256427,27.155781333333334,3807.485072,12.324421515941006,136,7.600000000000013E-4
2,test_20231101_140239,1254659.png,342646,52679,289967,0.8462582373645103,3,4,80080,7440,72640,0.9070929070929071,24.00547911111111,4208.260053333333,11.889777912626299,136,7.600000000000013E-4
3,test_20231101_140239,10188041.png,221231,6797,214434,0.9692764576393001,2,4,41731,965,40766,0.976875703913158,12.774896,1585.2552906666667,16.12981149582319,136,7.600000000000013E-4
4,test_20231101_140239,10287332.png,216980,7922,209058,0.9634897225550743,1,4,22337,1087,21250,0.9513363477637999,11.867955555555556,1570.254576,16.171102931789015,136,7.600000000000013E-4
5,test_20231101_140239,11610969.png,368720,11187,357533,0.9696599045346062,2,4,84111,1659,82452,0.9802760637728716,37.71299911111111,6819.937888,9.792999414932048,136,7.600000000000013E-4
6,test_20231101_140239,10350842.png,212614,2204,210410,0.9896337964574299,1,4,42529,323,42206,0.9924051823461638,26.50464,4130.358282666667,11.970926352560056,136,7.600000000000013E-4
7,test_20231101_140239,10863862.png,317432,4887,312545,0.9846045767282442,2,5,66058,717,65341,0.9891459020860456,40.798846222222224,7939.739397333334,9.132741128687087,136,7.600000000000013E-4
8,test_20231101_140239,11382381.png,312486,407,312079,0.9986975416498659,1,3,46745,55,46690,0.9988234035725746,23.007091555555554,2800.0597813333334,13.659130572306793,136,7.600000000000013E-4
9,test_20231101_140239,11079715.png,443815,92262,351553,0.792116084404538,3,3,124136,12988,111148,0.8953728169104853,19.109580444444443,2687.8771466666667,13.836709460932859,136,7.600000000000013E-4
10,test_20231101_140239,11551286.png,271883,24,271859,0.9999117267353972,1,3,40092,1,40091,0.9999750573680535,24.866876444444443,3470.407338666667,12.72699907819776,136,7.600000000000013E-4
1,test_20231101_140240,10404007.png,502730,11037,491693,0.9780458695522447,2,3,61265,1616,59649,0.973622786256427,27.155781333333334,3807.485072,12.324421515941006,136,7.700000000000014E-4
2,test_20231101_140240,1254659.png,342646,52679,289967,0.8462582373645103,3,4,80080,7440,72640,0.9070929070929071,24.00547911111111,4208.260053333333,11.889777912626299,136,7.700000000000014E-4
3,test_20231101_140240,10188041.png,221231,6797,214434,0.9692764576393001,2,4,41731,965,40766,0.976875703913158,12.774896,1585.2552906666667,16.12981149582319,136,7.700000000000014E-4
4,test_20231101_140240,10287332.png,216980,7922,209058,0.9634897225550743,1,4,22337,1087,21250,0.9513363477637999,11.867955555555556,1570.254576,16.171102931789015,136,7.700000000000014E-4
5,test_20231101_140240,11610969.png,368720,11187,357533,0.9696599045346062,1,4,84111,1659,82452,0.9802760637728716,37.71299911111111,6819.937888,9.792999414932048,136,7.700000000000014E-4
6,test_20231101_140240,10350842.png,212614,2204,210410,0.9896337964574299,2,3,42529,323,42206,0.9924051823461638,26.50464,4130.358282666667,11.970926352560056,136,7.700000000000014E-4
7,test_20231101_140240,10863862.png,317432,4887,312545,0.9846045767282442,2,4,66058,717,65341,0.9891459020860456,40.798846222222224,7939.739397333334,9.132741128687087,136,7.700000000000014E-4
8,test_20231101_140240,11382381.png,312486,407,312079,0.9986975416498659,2,3,46745,55,46690,0.9988234035725746,23.007091555555554,2800.0597813333334,13.659130572306793,136,7.700000000000014E-4
9,test_20231101_140240,11079715.png,443815,92262,351553,0.792116084404538,3,4,124136,12988,111148,0.8953728169104853,19.109580444444443,2687.8771466666667,13.836709460932859,136,7.700000000000014E-4
10,test_20231101_140240,11551286.png,271883,24,271859,0.9999117267353972,0,3,40092,1,40091,0.9999750573680535,24.866876444444443,3470.407338666667,12.72699907819776,136,7.700000000000014E-4
1,test_20231101_140240,10404007.png,502730,11037,491693,0.9780458695522447,3,4,61265,1616,59649,0.973622786256427,27.155781333333334,3807.485072,12.324421515941006,136,7.800000000000014E-4
2,test_20231101_140240,1254659.png,342646,52679,289967,0.8462582373645103,2,3,80080,7440,72640,0.9070929070929071,24.00547911111111,4208.260053333333,11.889777912626299,136,7.800000000000014E-4
3,test_20231101_140240,10188041.png,221231,6797,214434,0.9692764576393001,2,3,41731,965,40766,0.976875703913158,12.774896,1585.2552906666667,16.12981149582319,136,7.800000000000014E-4
4,test_20231101_140240,10287332.png,216980,7922,209058,0.9634897225550743,1,10,22337,1087,21250,0.9513363477637999,11.867955555555556,1570.254576,16.171102931789015,136,7.800000000000014E-4
5,test_20231101_140240,11610969.png,368720,11187,357533,0.9696599045346062,2,4,84111,1659,82452,0.9802760637728716,37.71299911111111,6819.937888,9.792999414932048,136,7.800000000000014E-4
6,test_20231101_140240,10350842.png,212614,2204,210410,0.9896337964574299,2,4,42529,323,42206,0.9924051823461638,26.50464,4130.358282666667,11.970926352560056,136,7.800000000000014E-4
7,test_20231101_140240,10863862.png,317432,4887,312545,0.9846045767282442,1,4,66058,717,65341,0.9891459020860456,40.798846222222224,7939.739397333334,9.132741128687087,136,7.800000000000014E-4
8,test_20231101_140240,11382381.png,312486,407,312079,0.9986975416498659,1,4,46745,55,46690,0.9988234035725746,23.007091555555554,2800.0597813333334,13.659130572306793,136,7.800000000000014E-4
9,test_20231101_140240,11079715.png,443815,92262,351553,0.792116084404538,3,4,124136,12988,111148,0.8953728169104853,19.109580444444443,2687.8771466666667,13.836709460932859,136,7.800000000000014E-4
10,test_20231101_140240,11551286.png,271883,24,271859,0.9999117267353972,1,4,40092,1,40091,0.9999750573680535,24.866876444444443,3470.407338666667,12.72699907819776,136,7.800000000000014E-4
1,test_20231101_140241,10404007.png,502730,11037,491693,0.9780458695522447,2,4,61265,1616,59649,0.973622786256427,27.155781333333334,3807.485072,12.324421515941006,136,7.900000000000014E-4
2,test_20231101_140241,1254659.png,342646,52679,289967,0.8462582373645103,3,4,80080,7440,72640,0.9070929070929071,24.00547911111111,4208.260053333333,11.889777912626299,136,7.900000000000014E-4
3,test_20231101_140241,10188041.png,221231,6797,214434,0.9692764576393001,2,3,41731,965,40766,0.976875703913158,12.774896,1585.2552906666667,16.12981149582319,136,7.900000000000014E-4
4,test_20231101_140241,10287332.png,216980,7922,209058,0.9634897225550743,2,4,22337,1087,21250,0.9513363477637999,11.867955555555556,1570.254576,16.171102931789015,136,7.900000000000014E-4
5,test_20231101_140241,11610969.png,368720,11187,357533,0.9696599045346062,2,6,84111,1659,82452,0.9802760637728716,37.71299911111111,6819.937888,9.792999414932048,136,7.900000000000014E-4
6,test_20231101_140241,10350842.png,212614,2204,210410,0.9896337964574299,2,3,42529,323,42206,0.9924051823461638,26.50464,4130.358282666667,11.970926352560056,136,7.900000000000014E-4
7,test_20231101_140241,10863862.png,317432,4887,312545,0.9846045767282442,2,3,66058,717,65341,0.9891459020860456,40.798846222222224,7939.739397333334,9.132741128687087,136,7.900000000000014E-4
8,test_20231101_140241,11382381.png,312486,407,312079,0.9986975416498659,1,4,46745,55,46690,0.9988234035725746,23.007091555555554,2800.0597813333334,13.659130572306793,136,7.900000000000014E-4
9,test_20231101_140241,11079715.png,443815,92262,351553,0.792116084404538,4,5,124136,12988,111148,0.8953728169104853,19.109580444444443,2687.8771466666667,13.836709460932859,136,7.900000000000014E-4
10,test_20231101_140241,11551286.png,271883,24,271859,0.9999117267353972,1,3,40092,1,40091,0.9999750573680535,24.866876444444443,3470.407338666667,12.72699907819776,136,7.900000000000014E-4
1,test_20231101_140242,10404007.png,502730,11037,491693,0.9780458695522447,2,3,61265,1616,59649,0.973622786256427,27.155781333333334,3807.485072,12.324421515941006,136,8.000000000000014E-4
2,test_20231101_140242,1254659.png,342646,52679,289967,0.8462582373645103,3,4,80080,7440,72640,0.9070929070929071,24.00547911111111,4208.260053333333,11.889777912626299,136,8.000000000000014E-4
3,test_20231101_140242,10188041.png,221231,6797,214434,0.9692764576393001,2,5,41731,965,40766,0.976875703913158,12.774896,1585.2552906666667,16.12981149582319,136,8.000000000000014E-4
4,test_20231101_140242,10287332.png,216980,7922,209058,0.9634897225550743,2,3,22337,1087,21250,0.9513363477637999,11.867955555555556,1570.254576,16.171102931789015,136,8.000000000000014E-4
5,test_20231101_140242,11610969.png,368720,11187,357533,0.9696599045346062,2,4,84111,1659,82452,0.9802760637728716,37.71299911111111,6819.937888,9.792999414932048,136,8.000000000000014E-4
6,test_20231101_140242,10350842.png,212614,2204,210410,0.9896337964574299,1,4,42529,323,42206,0.9924051823461638,26.50464,4130.358282666667,11.970926352560056,136,8.000000000000014E-4
7,test_20231101_140242,10863862.png,317432,4887,312545,0.9846045767282442,2,6,66058,717,65341,0.9891459020860456,40.798846222222224,7939.739397333334,9.132741128687087,136,8.000000000000014E-4
8,test_20231101_140242,11382381.png,312486,407,312079,0.9986975416498659,2,4,46745,55,46690,0.9988234035725746,23.007091555555554,2800.0597813333334,13.659130572306793,136,8.000000000000014E-4
9,test_20231101_140242,11079715.png,443815,92262,351553,0.792116084404538,3,4,124136,12988,111148,0.8953728169104853,19.109580444444443,2687.8771466666667,13.836709460932859,136,8.000000000000014E-4
10,test_20231101_140242,11551286.png,271883,24,271859,0.9999117267353972,1,3,40092,1,40091,0.9999750573680535,24.866876444444443,3470.407338666667,12.72699907819776,136,8.000000000000014E-4
1,test_20231101_140242,10404007.png,502730,11037,491693,0.9780458695522447,2,4,61265,1616,59649,0.973622786256427,27.155781333333334,3807.485072,12.324421515941006,136,8.100000000000015E-4
2,test_20231101_140242,1254659.png,342646,52679,289967,0.8462582373645103,2,3,80080,7440,72640,0.9070929070929071,24.00547911111111,4208.260053333333,11.889777912626299,136,8.100000000000015E-4
3,test_20231101_140242,10188041.png,221231,6797,214434,0.9692764576393001,2,3,41731,965,40766,0.976875703913158,12.774896,1585.2552906666667,16.12981149582319,136,8.100000000000015E-4
4,test_20231101_140242,10287332.png,216980,7922,209058,0.9634897225550743,1,3,22337,1087,21250,0.9513363477637999,11.867955555555556,1570.254576,16.171102931789015,136,8.100000000000015E-4
5,test_20231101_140242,11610969.png,368720,11187,357533,0.9696599045346062,2,4,84111,1659,82452,0.9802760637728716,37.71299911111111,6819.937888,9.792999414932048,136,8.100000000000015E-4
6,test_20231101_140242,10350842.png,212614,2204,210410,0.9896337964574299,1,3,42529,323,42206,0.9924051823461638,26.50464,4130.358282666667,11.970926352560056,136,8.100000000000015E-4
7,test_20231101_140242,10863862.png,317432,4887,312545,0.9846045767282442,1,4,66058,717,65341,0.9891459020860456,40.798846222222224,7939.739397333334,9.132741128687087,136,8.100000000000015E-4
8,test_20231101_140242,11382381.png,312486,407,312079,0.9986975416498659,1,4,46745,55,46690,0.9988234035725746,23.007091555555554,2800.0597813333334,13.659130572306793,136,8.100000000000015E-4
9,test_20231101_140242,11079715.png,443815,92262,351553,0.792116084404538,4,4,124136,12988,111148,0.8953728169104853,19.109580444444443,2687.8771466666667,13.836709460932859,136,8.100000000000015E-4
10,test_20231101_140242,11551286.png,271883,24,271859,0.9999117267353972,1,4,40092,1,40091,0.9999750573680535,24.866876444444443,3470.407338666667,12.72699907819776,136,8.100000000000015E-4
1,test_20231101_140243,10404007.png,502730,11037,491693,0.9780458695522447,1,3,61265,1616,59649,0.973622786256427,27.155781333333334,3807.485072,12.324421515941006,136,8.200000000000015E-4
2,test_20231101_140243,1254659.png,342646,52679,289967,0.8462582373645103,2,4,80080,7440,72640,0.9070929070929071,24.00547911111111,4208.260053333333,11.889777912626299,136,8.200000000000015E-4
3,test_20231101_140243,10188041.png,221231,6797,214434,0.9692764576393001,2,3,41731,965,40766,0.976875703913158,12.774896,1585.2552906666667,16.12981149582319,136,8.200000000000015E-4
4,test_20231101_140243,10287332.png,216980,7922,209058,0.9634897225550743,2,3,22337,1087,21250,0.9513363477637999,11.867955555555556,1570.254576,16.171102931789015,136,8.200000000000015E-4
5,test_20231101_140243,11610969.png,368720,11187,357533,0.9696599045346062,2,3,84111,1659,82452,0.9802760637728716,37.71299911111111,6819.937888,9.792999414932048,136,8.200000000000015E-4
6,test_20231101_140243,10350842.png,212614,2204,210410,0.9896337964574299,1,4,42529,323,42206,0.9924051823461638,26.50464,4130.358282666667,11.970926352560056,136,8.200000000000015E-4
7,test_20231101_140243,10863862.png,317432,4887,312545,0.9846045767282442,1,4,66058,717,65341,0.9891459020860456,40.798846222222224,7939.739397333334,9.132741128687087,136,8.200000000000015E-4
8,test_20231101_140243,11382381.png,312486,407,312079,0.9986975416498659,1,4,46745,55,46690,0.9988234035725746,23.007091555555554,2800.0597813333334,13.659130572306793,136,8.200000000000015E-4
9,test_20231101_140243,11079715.png,443815,92262,351553,0.792116084404538,3,4,124136,12988,111148,0.8953728169104853,19.109580444444443,2687.8771466666667,13.836709460932859,136,8.200000000000015E-4
10,test_20231101_140243,11551286.png,271883,24,271859,0.9999117267353972,1,4,40092,1,40091,0.9999750573680535,24.866876444444443,3470.407338666667,12.72699907819776,136,8.200000000000015E-4
1,test_20231101_140244,10404007.png,502730,11037,491693,0.9780458695522447,2,4,61265,1616,59649,0.973622786256427,27.155781333333334,3807.485072,12.324421515941006,136,8.300000000000015E-4
2,test_20231101_140244,1254659.png,342646,52679,289967,0.8462582373645103,2,4,80080,7440,72640,0.9070929070929071,24.00547911111111,4208.260053333333,11.889777912626299,136,8.300000000000015E-4
3,test_20231101_140244,10188041.png,221231,6797,214434,0.9692764576393001,3,4,41731,965,40766,0.976875703913158,12.774896,1585.2552906666667,16.12981149582319,136,8.300000000000015E-4
4,test_20231101_140244,10287332.png,216980,7922,209058,0.9634897225550743,1,4,22337,1087,21250,0.9513363477637999,11.867955555555556,1570.254576,16.171102931789015,136,8.300000000000015E-4
5,test_20231101_140244,11610969.png,368720,11187,357533,0.9696599045346062,1,4,84111,1659,82452,0.9802760637728716,37.71299911111111,6819.937888,9.792999414932048,136,8.300000000000015E-4
6,test_20231101_140244,10350842.png,212614,2204,210410,0.9896337964574299,1,4,42529,323,42206,0.9924051823461638,26.50464,4130.358282666667,11.970926352560056,136,8.300000000000015E-4
7,test_20231101_140244,10863862.png,317432,4887,312545,0.9846045767282442,7,4,66058,717,65341,0.9891459020860456,40.798846222222224,7939.739397333334,9.132741128687087,136,8.300000000000015E-4
8,test_20231101_140244,11382381.png,312486,407,312079,0.9986975416498659,1,3,46745,55,46690,0.9988234035725746,23.007091555555554,2800.0597813333334,13.659130572306793,136,8.300000000000015E-4
9,test_20231101_140244,11079715.png,443815,92262,351553,0.792116084404538,3,4,124136,12988,111148,0.8953728169104853,19.109580444444443,2687.8771466666667,13.836709460932859,136,8.300000000000015E-4
10,test_20231101_140244,11551286.png,271883,24,271859,0.9999117267353972,1,4,40092,1,40091,0.9999750573680535,24.866876444444443,3470.407338666667,12.72699907819776,136,8.300000000000015E-4
1,test_20231101_140244,10404007.png,502730,11037,491693,0.9780458695522447,2,4,61265,1616,59649,0.973622786256427,27.155781333333334,3807.485072,12.324421515941006,136,8.400000000000016E-4
2,test_20231101_140244,1254659.png,342646,52679,289967,0.8462582373645103,3,4,80080,7440,72640,0.9070929070929071,24.00547911111111,4208.260053333333,11.889777912626299,136,8.400000000000016E-4
3,test_20231101_140244,10188041.png,221231,6797,214434,0.9692764576393001,2,4,41731,965,40766,0.976875703913158,12.774896,1585.2552906666667,16.12981149582319,136,8.400000000000016E-4
4,test_20231101_140244,10287332.png,216980,7922,209058,0.9634897225550743,2,4,22337,1087,21250,0.9513363477637999,11.867955555555556,1570.254576,16.171102931789015,136,8.400000000000016E-4
5,test_20231101_140244,11610969.png,368720,11187,357533,0.9696599045346062,2,3,84111,1659,82452,0.9802760637728716,37.71299911111111,6819.937888,9.792999414932048,136,8.400000000000016E-4
6,test_20231101_140244,10350842.png,212614,2204,210410,0.9896337964574299,1,3,42529,323,42206,0.9924051823461638,26.50464,4130.358282666667,11.970926352560056,136,8.400000000000016E-4
7,test_20231101_140244,10863862.png,317432,4887,312545,0.9846045767282442,1,3,66058,717,65341,0.9891459020860456,40.798846222222224,7939.739397333334,9.132741128687087,136,8.400000000000016E-4
8,test_20231101_140244,11382381.png,312486,407,312079,0.9986975416498659,2,3,46745,55,46690,0.9988234035725746,23.007091555555554,2800.0597813333334,13.659130572306793,136,8.400000000000016E-4
9,test_20231101_140244,11079715.png,443815,92262,351553,0.792116084404538,6,4,124136,12988,111148,0.8953728169104853,19.109580444444443,2687.8771466666667,13.836709460932859,136,8.400000000000016E-4
10,test_20231101_140244,11551286.png,271883,24,271859,0.9999117267353972,1,3,40092,1,40091,0.9999750573680535,24.866876444444443,3470.407338666667,12.72699907819776,136,8.400000000000016E-4
1,test_20231101_140245,10404007.png,502730,11037,491693,0.9780458695522447,2,3,61265,1616,59649,0.973622786256427,27.155781333333334,3807.485072,12.324421515941006,136,8.500000000000016E-4
2,test_20231101_140245,1254659.png,342646,52679,289967,0.8462582373645103,3,11,80080,7440,72640,0.9070929070929071,24.00547911111111,4208.260053333333,11.889777912626299,136,8.500000000000016E-4
3,test_20231101_140245,10188041.png,221231,6797,214434,0.9692764576393001,1,3,41731,965,40766,0.976875703913158,12.774896,1585.2552906666667,16.12981149582319,136,8.500000000000016E-4
4,test_20231101_140245,10287332.png,216980,7922,209058,0.9634897225550743,2,4,22337,1087,21250,0.9513363477637999,11.867955555555556,1570.254576,16.171102931789015,136,8.500000000000016E-4
5,test_20231101_140245,11610969.png,368720,11187,357533,0.9696599045346062,2,11,84111,1659,82452,0.9802760637728716,37.71299911111111,6819.937888,9.792999414932048,136,8.500000000000016E-4
6,test_20231101_140245,10350842.png,212614,2204,210410,0.9896337964574299,2,4,42529,323,42206,0.9924051823461638,26.50464,4130.358282666667,11.970926352560056,136,8.500000000000016E-4
7,test_20231101_140245,10863862.png,317432,4887,312545,0.9846045767282442,1,4,66058,717,65341,0.9891459020860456,40.798846222222224,7939.739397333334,9.132741128687087,136,8.500000000000016E-4
8,test_20231101_140245,11382381.png,312486,407,312079,0.9986975416498659,1,4,46745,55,46690,0.9988234035725746,23.007091555555554,2800.0597813333334,13.659130572306793,136,8.500000000000016E-4
9,test_20231101_140245,11079715.png,443815,92262,351553,0.792116084404538,3,4,124136,12988,111148,0.8953728169104853,19.109580444444443,2687.8771466666667,13.836709460932859,136,8.500000000000016E-4
10,test_20231101_140245,11551286.png,271883,24,271859,0.9999117267353972,1,4,40092,1,40091,0.9999750573680535,24.866876444444443,3470.407338666667,12.72699907819776,136,8.500000000000016E-4
1,test_20231101_140246,10404007.png,502730,11037,491693,0.9780458695522447,2,3,61265,1616,59649,0.973622786256427,27.155781333333334,3807.485072,12.324421515941006,136,8.600000000000016E-4
2,test_20231101_140246,1254659.png,342646,52679,289967,0.8462582373645103,3,4,80080,7440,72640,0.9070929070929071,24.00547911111111,4208.260053333333,11.889777912626299,136,8.600000000000016E-4
3,test_20231101_140246,10188041.png,221231,6797,214434,0.9692764576393001,2,4,41731,965,40766,0.976875703913158,12.774896,1585.2552906666667,16.12981149582319,136,8.600000000000016E-4
4,test_20231101_140246,10287332.png,216980,7922,209058,0.9634897225550743,2,3,22337,1087,21250,0.9513363477637999,11.867955555555556,1570.254576,16.171102931789015,136,8.600000000000016E-4
5,test_20231101_140246,11610969.png,368720,11187,357533,0.9696599045346062,2,4,84111,1659,82452,0.9802760637728716,37.71299911111111,6819.937888,9.792999414932048,136,8.600000000000016E-4
6,test_20231101_140246,10350842.png,212614,2204,210410,0.9896337964574299,2,3,42529,323,42206,0.9924051823461638,26.50464,4130.358282666667,11.970926352560056,136,8.600000000000016E-4
7,test_20231101_140246,10863862.png,317432,4887,312545,0.9846045767282442,2,4,66058,717,65341,0.9891459020860456,40.798846222222224,7939.739397333334,9.132741128687087,136,8.600000000000016E-4
8,test_20231101_140246,11382381.png,312486,407,312079,0.9986975416498659,1,4,46745,55,46690,0.9988234035725746,23.007091555555554,2800.0597813333334,13.659130572306793,136,8.600000000000016E-4
9,test_20231101_140246,11079715.png,443815,92262,351553,0.792116084404538,3,4,124136,12988,111148,0.8953728169104853,19.109580444444443,2687.8771466666667,13.836709460932859,136,8.600000000000016E-4
10,test_20231101_140246,11551286.png,271883,24,271859,0.9999117267353972,1,3,40092,1,40091,0.9999750573680535,24.866876444444443,3470.407338666667,12.72699907819776,136,8.600000000000016E-4
1,test_20231101_140246,10404007.png,502730,11037,491693,0.9780458695522447,2,4,61265,1616,59649,0.973622786256427,27.155781333333334,3807.485072,12.324421515941006,136,8.700000000000016E-4
2,test_20231101_140246,1254659.png,342646,52679,289967,0.8462582373645103,3,4,80080,7440,72640,0.9070929070929071,24.00547911111111,4208.260053333333,11.889777912626299,136,8.700000000000016E-4
3,test_20231101_140246,10188041.png,221231,6797,214434,0.9692764576393001,2,4,41731,965,40766,0.976875703913158,12.774896,1585.2552906666667,16.12981149582319,136,8.700000000000016E-4
4,test_20231101_140246,10287332.png,216980,7922,209058,0.9634897225550743,2,4,22337,1087,21250,0.9513363477637999,11.867955555555556,1570.254576,16.171102931789015,136,8.700000000000016E-4
5,test_20231101_140246,11610969.png,368720,11187,357533,0.9696599045346062,2,6,84111,1659,82452,0.9802760637728716,37.71299911111111,6819.937888,9.792999414932048,136,8.700000000000016E-4
6,test_20231101_140246,10350842.png,212614,2204,210410,0.9896337964574299,1,3,42529,323,42206,0.9924051823461638,26.50464,4130.358282666667,11.970926352560056,136,8.700000000000016E-4
7,test_20231101_140246,10863862.png,317432,4887,312545,0.9846045767282442,1,4,66058,717,65341,0.9891459020860456,40.798846222222224,7939.739397333334,9.132741128687087,136,8.700000000000016E-4
8,test_20231101_140246,11382381.png,312486,407,312079,0.9986975416498659,2,3,46745,55,46690,0.9988234035725746,23.007091555555554,2800.0597813333334,13.659130572306793,136,8.700000000000016E-4
9,test_20231101_140246,11079715.png,443815,92262,351553,0.792116084404538,3,5,124136,12988,111148,0.8953728169104853,19.109580444444443,2687.8771466666667,13.836709460932859,136,8.700000000000016E-4
10,test_20231101_140246,11551286.png,271883,24,271859,0.9999117267353972,0,3,40092,1,40091,0.9999750573680535,24.866876444444443,3470.407338666667,12.72699907819776,136,8.700000000000016E-4
1,test_20231101_140247,10404007.png,502730,11037,491693,0.9780458695522447,1,3,61265,1616,59649,0.973622786256427,27.155781333333334,3807.485072,12.324421515941006,136,8.800000000000017E-4
2,test_20231101_140247,1254659.png,342646,52679,289967,0.8462582373645103,3,4,80080,7440,72640,0.9070929070929071,24.00547911111111,4208.260053333333,11.889777912626299,136,8.800000000000017E-4
3,test_20231101_140247,10188041.png,221231,6797,214434,0.9692764576393001,2,4,41731,965,40766,0.976875703913158,12.774896,1585.2552906666667,16.12981149582319,136,8.800000000000017E-4
4,test_20231101_140247,10287332.png,216980,7922,209058,0.9634897225550743,1,3,22337,1087,21250,0.9513363477637999,11.867955555555556,1570.254576,16.171102931789015,136,8.800000000000017E-4
5,test_20231101_140247,11610969.png,368720,11187,357533,0.9696599045346062,2,3,84111,1659,82452,0.9802760637728716,37.71299911111111,6819.937888,9.792999414932048,136,8.800000000000017E-4
6,test_20231101_140247,10350842.png,212614,2204,210410,0.9896337964574299,1,4,42529,323,42206,0.9924051823461638,26.50464,4130.358282666667,11.970926352560056,136,8.800000000000017E-4
7,test_20231101_140247,10863862.png,317432,4887,312545,0.9846045767282442,1,5,66058,717,65341,0.9891459020860456,40.798846222222224,7939.739397333334,9.132741128687087,136,8.800000000000017E-4
8,test_20231101_140247,11382381.png,312486,407,312079,0.9986975416498659,1,4,46745,55,46690,0.9988234035725746,23.007091555555554,2800.0597813333334,13.659130572306793,136,8.800000000000017E-4
9,test_20231101_140247,11079715.png,443815,92262,351553,0.792116084404538,4,4,124136,12988,111148,0.8953728169104853,19.109580444444443,2687.8771466666667,13.836709460932859,136,8.800000000000017E-4
10,test_20231101_140247,11551286.png,271883,24,271859,0.9999117267353972,1,4,40092,1,40091,0.9999750573680535,24.866876444444443,3470.407338666667,12.72699907819776,136,8.800000000000017E-4
1,test_20231101_140248,10404007.png,502730,11037,491693,0.9780458695522447,1,3,61265,1616,59649,0.973622786256427,27.155781333333334,3807.485072,12.324421515941006,136,8.900000000000017E-4
2,test_20231101_140248,1254659.png,342646,52679,289967,0.8462582373645103,3,4,80080,7440,72640,0.9070929070929071,24.00547911111111,4208.260053333333,11.889777912626299,136,8.900000000000017E-4
3,test_20231101_140248,10188041.png,221231,6797,214434,0.9692764576393001,3,3,41731,965,40766,0.976875703913158,12.774896,1585.2552906666667,16.12981149582319,136,8.900000000000017E-4
4,test_20231101_140248,10287332.png,216980,7922,209058,0.9634897225550743,2,4,22337,1087,21250,0.9513363477637999,11.867955555555556,1570.254576,16.171102931789015,136,8.900000000000017E-4
5,test_20231101_140248,11610969.png,368720,11187,357533,0.9696599045346062,2,4,84111,1659,82452,0.9802760637728716,37.71299911111111,6819.937888,9.792999414932048,136,8.900000000000017E-4
6,test_20231101_140248,10350842.png,212614,2204,210410,0.9896337964574299,1,4,42529,323,42206,0.9924051823461638,26.50464,4130.358282666667,11.970926352560056,136,8.900000000000017E-4
7,test_20231101_140248,10863862.png,317432,4887,312545,0.9846045767282442,1,4,66058,717,65341,0.9891459020860456,40.798846222222224,7939.739397333334,9.132741128687087,136,8.900000000000017E-4
8,test_20231101_140248,11382381.png,312486,407,312079,0.9986975416498659,1,4,46745,55,46690,0.9988234035725746,23.007091555555554,2800.0597813333334,13.659130572306793,136,8.900000000000017E-4
9,test_20231101_140248,11079715.png,443815,92262,351553,0.792116084404538,3,4,124136,12988,111148,0.8953728169104853,19.109580444444443,2687.8771466666667,13.836709460932859,136,8.900000000000017E-4
10,test_20231101_140248,11551286.png,271883,24,271859,0.9999117267353972,1,3,40092,1,40091,0.9999750573680535,24.866876444444443,3470.407338666667,12.72699907819776,136,8.900000000000017E-4
1,test_20231101_140248,10404007.png,502730,11037,491693,0.9780458695522447,2,4,61265,1616,59649,0.973622786256427,27.155781333333334,3807.485072,12.324421515941006,136,9.000000000000017E-4
2,test_20231101_140248,1254659.png,342646,52679,289967,0.8462582373645103,2,4,80080,7440,72640,0.9070929070929071,24.00547911111111,4208.260053333333,11.889777912626299,136,9.000000000000017E-4
3,test_20231101_140248,10188041.png,221231,6797,214434,0.9692764576393001,2,3,41731,965,40766,0.976875703913158,12.774896,1585.2552906666667,16.12981149582319,136,9.000000000000017E-4
4,test_20231101_140248,10287332.png,216980,7922,209058,0.9634897225550743,1,3,22337,1087,21250,0.9513363477637999,11.867955555555556,1570.254576,16.171102931789015,136,9.000000000000017E-4
5,test_20231101_140248,11610969.png,368720,11187,357533,0.9696599045346062,2,4,84111,1659,82452,0.9802760637728716,37.71299911111111,6819.937888,9.792999414932048,136,9.000000000000017E-4
6,test_20231101_140248,10350842.png,212614,2204,210410,0.9896337964574299,2,3,42529,323,42206,0.9924051823461638,26.50464,4130.358282666667,11.970926352560056,136,9.000000000000017E-4
7,test_20231101_140248,10863862.png,317432,4887,312545,0.9846045767282442,1,4,66058,717,65341,0.9891459020860456,40.798846222222224,7939.739397333334,9.132741128687087,136,9.000000000000017E-4
8,test_20231101_140248,11382381.png,312486,407,312079,0.9986975416498659,1,4,46745,55,46690,0.9988234035725746,23.007091555555554,2800.0597813333334,13.659130572306793,136,9.000000000000017E-4
9,test_20231101_140248,11079715.png,443815,92262,351553,0.792116084404538,3,3,124136,12988,111148,0.8953728169104853,19.109580444444443,2687.8771466666667,13.836709460932859,136,9.000000000000017E-4
10,test_20231101_140248,11551286.png,271883,24,271859,0.9999117267353972,1,3,40092,1,40091,0.9999750573680535,24.866876444444443,3470.407338666667,12.72699907819776,136,9.000000000000017E-4
1,test_20231101_140249,10404007.png,502730,11037,491693,0.9780458695522447,2,4,61265,1616,59649,0.973622786256427,27.155781333333334,3807.485072,12.324421515941006,136,9.100000000000017E-4
2,test_20231101_140249,1254659.png,342646,52679,289967,0.8462582373645103,3,4,80080,7440,72640,0.9070929070929071,24.00547911111111,4208.260053333333,11.889777912626299,136,9.100000000000017E-4
3,test_20231101_140249,10188041.png,221231,6797,214434,0.9692764576393001,2,4,41731,965,40766,0.976875703913158,12.774896,1585.2552906666667,16.12981149582319,136,9.100000000000017E-4
4,test_20231101_140249,10287332.png,216980,7922,209058,0.9634897225550743,2,4,22337,1087,21250,0.9513363477637999,11.867955555555556,1570.254576,16.171102931789015,136,9.100000000000017E-4
5,test_20231101_140249,11610969.png,368720,11187,357533,0.9696599045346062,1,4,84111,1659,82452,0.9802760637728716,37.71299911111111,6819.937888,9.792999414932048,136,9.100000000000017E-4
6,test_20231101_140249,10350842.png,212614,2204,210410,0.9896337964574299,1,3,42529,323,42206,0.9924051823461638,26.50464,4130.358282666667,11.970926352560056,136,9.100000000000017E-4
7,test_20231101_140249,10863862.png,317432,4887,312545,0.9846045767282442,2,4,66058,717,65341,0.9891459020860456,40.798846222222224,7939.739397333334,9.132741128687087,136,9.100000000000017E-4
8,test_20231101_140249,11382381.png,312486,407,312079,0.9986975416498659,1,10,46745,55,46690,0.9988234035725746,23.007091555555554,2800.0597813333334,13.659130572306793,136,9.100000000000017E-4
9,test_20231101_140249,11079715.png,443815,92262,351553,0.792116084404538,3,4,124136,12988,111148,0.8953728169104853,19.109580444444443,2687.8771466666667,13.836709460932859,136,9.100000000000017E-4
10,test_20231101_140249,11551286.png,271883,24,271859,0.9999117267353972,0,3,40092,1,40091,0.9999750573680535,24.866876444444443,3470.407338666667,12.72699907819776,136,9.100000000000017E-4
1,test_20231101_140250,10404007.png,502730,11037,491693,0.9780458695522447,2,4,61265,1616,59649,0.973622786256427,27.155781333333334,3807.485072,12.324421515941006,136,9.200000000000018E-4
2,test_20231101_140250,1254659.png,342646,52679,289967,0.8462582373645103,2,4,80080,7440,72640,0.9070929070929071,24.00547911111111,4208.260053333333,11.889777912626299,136,9.200000000000018E-4
3,test_20231101_140250,10188041.png,221231,6797,214434,0.9692764576393001,2,4,41731,965,40766,0.976875703913158,12.774896,1585.2552906666667,16.12981149582319,136,9.200000000000018E-4
4,test_20231101_140250,10287332.png,216980,7922,209058,0.9634897225550743,1,3,22337,1087,21250,0.9513363477637999,11.867955555555556,1570.254576,16.171102931789015,136,9.200000000000018E-4
5,test_20231101_140250,11610969.png,368720,11187,357533,0.9696599045346062,2,3,84111,1659,82452,0.9802760637728716,37.71299911111111,6819.937888,9.792999414932048,136,9.200000000000018E-4
6,test_20231101_140250,10350842.png,212614,2204,210410,0.9896337964574299,1,3,42529,323,42206,0.9924051823461638,26.50464,4130.358282666667,11.970926352560056,136,9.200000000000018E-4
7,test_20231101_140250,10863862.png,317432,4887,312545,0.9846045767282442,1,4,66058,717,65341,0.9891459020860456,40.798846222222224,7939.739397333334,9.132741128687087,136,9.200000000000018E-4
8,test_20231101_140250,11382381.png,312486,407,312079,0.9986975416498659,1,4,46745,55,46690,0.9988234035725746,23.007091555555554,2800.0597813333334,13.659130572306793,136,9.200000000000018E-4
9,test_20231101_140250,11079715.png,443815,92262,351553,0.792116084404538,3,4,124136,12988,111148,0.8953728169104853,19.109580444444443,2687.8771466666667,13.836709460932859,136,9.200000000000018E-4
10,test_20231101_140250,11551286.png,271883,24,271859,0.9999117267353972,1,3,40092,1,40091,0.9999750573680535,24.866876444444443,3470.407338666667,12.72699907819776,136,9.200000000000018E-4
1,test_20231101_140250,10404007.png,502730,11037,491693,0.9780458695522447,2,4,61265,1616,59649,0.973622786256427,27.155781333333334,3807.485072,12.324421515941006,136,9.300000000000018E-4
2,test_20231101_140250,1254659.png,342646,52679,289967,0.8462582373645103,3,4,80080,7440,72640,0.9070929070929071,24.00547911111111,4208.260053333333,11.889777912626299,136,9.300000000000018E-4
3,test_20231101_140250,10188041.png,221231,6797,214434,0.9692764576393001,2,4,41731,965,40766,0.976875703913158,12.774896,1585.2552906666667,16.12981149582319,136,9.300000000000018E-4
4,test_20231101_140250,10287332.png,216980,7922,209058,0.9634897225550743,2,4,22337,1087,21250,0.9513363477637999,11.867955555555556,1570.254576,16.171102931789015,136,9.300000000000018E-4
5,test_20231101_140250,11610969.png,368720,11187,357533,0.9696599045346062,2,3,84111,1659,82452,0.9802760637728716,37.71299911111111,6819.937888,9.792999414932048,136,9.300000000000018E-4
6,test_20231101_140250,10350842.png,212614,2204,210410,0.9896337964574299,1,4,42529,323,42206,0.9924051823461638,26.50464,4130.358282666667,11.970926352560056,136,9.300000000000018E-4
7,test_20231101_140250,10863862.png,317432,4887,312545,0.9846045767282442,1,4,66058,717,65341,0.9891459020860456,40.798846222222224,7939.739397333334,9.132741128687087,136,9.300000000000018E-4
8,test_20231101_140250,11382381.png,312486,407,312079,0.9986975416498659,1,12,46745,55,46690,0.9988234035725746,23.007091555555554,2800.0597813333334,13.659130572306793,136,9.300000000000018E-4
9,test_20231101_140250,11079715.png,443815,92262,351553,0.792116084404538,3,4,124136,12988,111148,0.8953728169104853,19.109580444444443,2687.8771466666667,13.836709460932859,136,9.300000000000018E-4
10,test_20231101_140250,11551286.png,271883,24,271859,0.9999117267353972,0,3,40092,1,40091,0.9999750573680535,24.866876444444443,3470.407338666667,12.72699907819776,136,9.300000000000018E-4
1,test_20231101_140251,10404007.png,502730,11037,491693,0.9780458695522447,2,4,61265,1616,59649,0.973622786256427,27.155781333333334,3807.485072,12.324421515941006,136,9.400000000000018E-4
2,test_20231101_140251,1254659.png,342646,52679,289967,0.8462582373645103,3,4,80080,7440,72640,0.9070929070929071,24.00547911111111,4208.260053333333,11.889777912626299,136,9.400000000000018E-4
3,test_20231101_140251,10188041.png,221231,6797,214434,0.9692764576393001,2,3,41731,965,40766,0.976875703913158,12.774896,1585.2552906666667,16.12981149582319,136,9.400000000000018E-4
4,test_20231101_140251,10287332.png,216980,7922,209058,0.9634897225550743,2,3,22337,1087,21250,0.9513363477637999,11.867955555555556,1570.254576,16.171102931789015,136,9.400000000000018E-4
5,test_20231101_140251,11610969.png,368720,11187,357533,0.9696599045346062,1,3,84111,1659,82452,0.9802760637728716,37.71299911111111,6819.937888,9.792999414932048,136,9.400000000000018E-4
6,test_20231101_140251,10350842.png,212614,2204,210410,0.9896337964574299,2,4,42529,323,42206,0.9924051823461638,26.50464,4130.358282666667,11.970926352560056,136,9.400000000000018E-4
7,test_20231101_140251,10863862.png,317432,4887,312545,0.9846045767282442,2,3,66058,717,65341,0.9891459020860456,40.798846222222224,7939.739397333334,9.132741128687087,136,9.400000000000018E-4
8,test_20231101_140251,11382381.png,312486,407,312079,0.9986975416498659,1,4,46745,55,46690,0.9988234035725746,23.007091555555554,2800.0597813333334,13.659130572306793,136,9.400000000000018E-4
9,test_20231101_140251,11079715.png,443815,92262,351553,0.792116084404538,3,12,124136,12988,111148,0.8953728169104853,19.109580444444443,2687.8771466666667,13.836709460932859,136,9.400000000000018E-4
10,test_20231101_140251,11551286.png,271883,24,271859,0.9999117267353972,1,4,40092,1,40091,0.9999750573680535,24.866876444444443,3470.407338666667,12.72699907819776,136,9.400000000000018E-4
1,test_20231101_140252,10404007.png,502730,11037,491693,0.9780458695522447,2,3,61265,1616,59649,0.973622786256427,27.155781333333334,3807.485072,12.324421515941006,136,9.500000000000018E-4
2,test_20231101_140252,1254659.png,342646,52679,289967,0.8462582373645103,3,4,80080,7440,72640,0.9070929070929071,24.00547911111111,4208.260053333333,11.889777912626299,136,9.500000000000018E-4
3,test_20231101_140252,10188041.png,221231,6797,214434,0.9692764576393001,2,3,41731,965,40766,0.976875703913158,12.774896,1585.2552906666667,16.12981149582319,136,9.500000000000018E-4
4,test_20231101_140252,10287332.png,216980,7922,209058,0.9634897225550743,2,3,22337,1087,21250,0.9513363477637999,11.867955555555556,1570.254576,16.171102931789015,136,9.500000000000018E-4
5,test_20231101_140252,11610969.png,368720,11187,357533,0.9696599045346062,2,4,84111,1659,82452,0.9802760637728716,37.71299911111111,6819.937888,9.792999414932048,136,9.500000000000018E-4
6,test_20231101_140252,10350842.png,212614,2204,210410,0.9896337964574299,1,4,42529,323,42206,0.9924051823461638,26.50464,4130.358282666667,11.970926352560056,136,9.500000000000018E-4
7,test_20231101_140252,10863862.png,317432,4887,312545,0.9846045767282442,2,4,66058,717,65341,0.9891459020860456,40.798846222222224,7939.739397333334,9.132741128687087,136,9.500000000000018E-4
8,test_20231101_140252,11382381.png,312486,407,312079,0.9986975416498659,1,3,46745,55,46690,0.9988234035725746,23.007091555555554,2800.0597813333334,13.659130572306793,136,9.500000000000018E-4
9,test_20231101_140252,11079715.png,443815,92262,351553,0.792116084404538,3,4,124136,12988,111148,0.8953728169104853,19.109580444444443,2687.8771466666667,13.836709460932859,136,9.500000000000018E-4
10,test_20231101_140252,11551286.png,271883,24,271859,0.9999117267353972,1,12,40092,1,40091,0.9999750573680535,24.866876444444443,3470.407338666667,12.72699907819776,136,9.500000000000018E-4
1,test_20231101_140252,10404007.png,502730,11037,491693,0.9780458695522447,2,4,61265,1616,59649,0.973622786256427,27.155781333333334,3807.485072,12.324421515941006,136,9.600000000000019E-4
2,test_20231101_140252,1254659.png,342646,52679,289967,0.8462582373645103,3,4,80080,7440,72640,0.9070929070929071,24.00547911111111,4208.260053333333,11.889777912626299,136,9.600000000000019E-4
3,test_20231101_140252,10188041.png,221231,6797,214434,0.9692764576393001,2,3,41731,965,40766,0.976875703913158,12.774896,1585.2552906666667,16.12981149582319,136,9.600000000000019E-4
4,test_20231101_140252,10287332.png,216980,7922,209058,0.9634897225550743,1,4,22337,1087,21250,0.9513363477637999,11.867955555555556,1570.254576,16.171102931789015,136,9.600000000000019E-4
5,test_20231101_140252,11610969.png,368720,11187,357533,0.9696599045346062,6,4,84111,1659,82452,0.9802760637728716,37.71299911111111,6819.937888,9.792999414932048,136,9.600000000000019E-4
6,test_20231101_140252,10350842.png,212614,2204,210410,0.9896337964574299,2,3,42529,323,42206,0.9924051823461638,26.50464,4130.358282666667,11.970926352560056,136,9.600000000000019E-4
7,test_20231101_140252,10863862.png,317432,4887,312545,0.9846045767282442,2,3,66058,717,65341,0.9891459020860456,40.798846222222224,7939.739397333334,9.132741128687087,136,9.600000000000019E-4
8,test_20231101_140252,11382381.png,312486,407,312079,0.9986975416498659,1,3,46745,55,46690,0.9988234035725746,23.007091555555554,2800.0597813333334,13.659130572306793,136,9.600000000000019E-4
9,test_20231101_140252,11079715.png,443815,92262,351553,0.792116084404538,3,4,124136,12988,111148,0.8953728169104853,19.109580444444443,2687.8771466666667,13.836709460932859,136,9.600000000000019E-4
10,test_20231101_140252,11551286.png,271883,24,271859,0.9999117267353972,0,3,40092,1,40091,0.9999750573680535,24.866876444444443,3470.407338666667,12.72699907819776,136,9.600000000000019E-4
1,test_20231101_140253,10404007.png,502730,11037,491693,0.9780458695522447,2,11,61265,1616,59649,0.973622786256427,27.155781333333334,3807.485072,12.324421515941006,136,9.700000000000019E-4
2,test_20231101_140253,1254659.png,342646,52679,289967,0.8462582373645103,3,4,80080,7440,72640,0.9070929070929071,24.00547911111111,4208.260053333333,11.889777912626299,136,9.700000000000019E-4
3,test_20231101_140253,10188041.png,221231,6797,214434,0.9692764576393001,2,4,41731,965,40766,0.976875703913158,12.774896,1585.2552906666667,16.12981149582319,136,9.700000000000019E-4
4,test_20231101_140253,10287332.png,216980,7922,209058,0.9634897225550743,2,4,22337,1087,21250,0.9513363477637999,11.867955555555556,1570.254576,16.171102931789015,136,9.700000000000019E-4
5,test_20231101_140253,11610969.png,368720,11187,357533,0.9696599045346062,2,5,84111,1659,82452,0.9802760637728716,37.71299911111111,6819.937888,9.792999414932048,136,9.700000000000019E-4
6,test_20231101_140253,10350842.png,212614,2204,210410,0.9896337964574299,2,3,42529,323,42206,0.9924051823461638,26.50464,4130.358282666667,11.970926352560056,136,9.700000000000019E-4
7,test_20231101_140253,10863862.png,317432,4887,312545,0.9846045767282442,2,3,66058,717,65341,0.9891459020860456,40.798846222222224,7939.739397333334,9.132741128687087,136,9.700000000000019E-4
8,test_20231101_140253,11382381.png,312486,407,312079,0.9986975416498659,1,4,46745,55,46690,0.9988234035725746,23.007091555555554,2800.0597813333334,13.659130572306793,136,9.700000000000019E-4
9,test_20231101_140253,11079715.png,443815,92262,351553,0.792116084404538,3,4,124136,12988,111148,0.8953728169104853,19.109580444444443,2687.8771466666667,13.836709460932859,136,9.700000000000019E-4
10,test_20231101_140253,11551286.png,271883,24,271859,0.9999117267353972,0,3,40092,1,40091,0.9999750573680535,24.866876444444443,3470.407338666667,12.72699907819776,136,9.700000000000019E-4
1,test_20231101_140254,10404007.png,502730,10454,492276,0.9792055377638096,5,4,61265,1532,59733,0.9749938790500285,27.22304888888889,3827.072496,12.302136717517067,136,9.80000000000002E-4
2,test_20231101_140254,1254659.png,342646,52397,290249,0.8470812441995529,4,4,80080,7408,72672,0.9074925074925075,24.158734222222222,4246.138453333333,11.850862098183498,136,9.80000000000002E-4
3,test_20231101_140254,10188041.png,221231,6637,214594,0.9699996835886472,2,3,41731,949,40782,0.9772591119311782,12.862487111111111,1604.4617013333334,16.077510059668395,136,9.80000000000002E-4
4,test_20231101_140254,10287332.png,216980,7842,209138,0.9638584201308876,1,3,22337,1075,21262,0.9518735729954784,11.893516444444444,1574.4245493333333,16.159585079584392,136,9.80000000000002E-4
5,test_20231101_140254,11610969.png,368720,11067,357653,0.9699853547407247,2,4,84111,1641,82470,0.9804900666975782,37.75626311111111,6828.67056,9.787441995955836,136,9.80000000000002E-4
6,test_20231101_140254,10350842.png,212614,2144,210470,0.9899159980057757,1,4,42529,314,42215,0.9926168026523078,26.520227555555557,4132.968693333333,11.968182452944227,136,9.80000000000002E-4
7,test_20231101_140254,10863862.png,317432,4647,312785,0.9853606441694599,2,4,66058,681,65377,0.9896908777135245,40.87301866666667,7958.677018666666,9.122394804726161,136,9.80000000000002E-4
8,test_20231101_140254,11382381.png,312486,347,312139,0.9988895502518513,1,3,46745,47,46698,0.9989945448711092,23.287856,2886.376976,13.527273092646656,136,9.80000000000002E-4
9,test_20231101_140254,11079715.png,443815,92182,351633,0.7922963396910875,3,4,124136,12980,111156,0.8954372623574145,19.146245333333333,2692.751578666667,13.828840716935836,136,9.80000000000002E-4
10,test_20231101_140254,11551286.png,271883,24,271859,0.9999117267353972,0,3,40092,1,40091,0.9999750573680535,24.866876444444443,3470.407338666667,12.72699907819776,136,9.80000000000002E-4
1,test_20231101_140254,10404007.png,502730,10454,492276,0.9792055377638096,2,3,61265,1532,59733,0.9749938790500285,27.22304888888889,3827.072496,12.302136717517067,136,9.90000000000002E-4
2,test_20231101_140254,1254659.png,342646,52397,290249,0.8470812441995529,3,4,80080,7408,72672,0.9074925074925075,24.158734222222222,4246.138453333333,11.850862098183498,136,9.90000000000002E-4
3,test_20231101_140254,10188041.png,221231,6637,214594,0.9699996835886472,1,3,41731,949,40782,0.9772591119311782,12.862487111111111,1604.4617013333334,16.077510059668395,136,9.90000000000002E-4
4,test_20231101_140254,10287332.png,216980,7842,209138,0.9638584201308876,1,3,22337,1075,21262,0.9518735729954784,11.893516444444444,1574.4245493333333,16.159585079584392,136,9.90000000000002E-4
5,test_20231101_140254,11610969.png,368720,11067,357653,0.9699853547407247,2,3,84111,1641,82470,0.9804900666975782,37.75626311111111,6828.67056,9.787441995955836,136,9.90000000000002E-4
6,test_20231101_140254,10350842.png,212614,2144,210470,0.9899159980057757,1,4,42529,314,42215,0.9926168026523078,26.520227555555557,4132.968693333333,11.968182452944227,136,9.90000000000002E-4
7,test_20231101_140254,10863862.png,317432,4647,312785,0.9853606441694599,1,3,66058,681,65377,0.9896908777135245,40.87301866666667,7958.677018666666,9.122394804726161,136,9.90000000000002E-4
8,test_20231101_140254,11382381.png,312486,347,312139,0.9988895502518513,1,4,46745,47,46698,0.9989945448711092,23.287856,2886.376976,13.527273092646656,136,9.90000000000002E-4
9,test_20231101_140254,11079715.png,443815,92182,351633,0.7922963396910875,3,4,124136,12980,111156,0.8954372623574145,19.146245333333333,2692.751578666667,13.828840716935836,136,9.90000000000002E-4
10,test_20231101_140254,11551286.png,271883,24,271859,0.9999117267353972,1,3,40092,1,40091,0.9999750573680535,24.866876444444443,3470.407338666667,12.72699907819776,136,9.90000000000002E-4
1,test_20231101_140255,10404007.png,502730,10797,491933,0.9785232629841067,2,4,61265,1582,59683,0.9741777523871705,26.916595555555556,3763.959173333333,12.37435456764181,137,0.0
2,test_20231101_140255,1254659.png,342646,51352,291294,0.8501310390315369,2,4,80080,7256,72824,0.9093906093906095,24.16980977777778,4265.197770666667,11.831411873296966,137,0.0
3,test_20231101_140255,10188041.png,221231,6857,214374,0.9690052479082949,2,4,41731,971,40760,0.9767319259064006,12.429425777777778,1541.395904,16.251661602808255,137,0.0
4,test_20231101_140255,10287332.png,216980,7912,209068,0.9635358097520509,1,4,22337,1084,21253,0.9514706540717196,11.779068444444444,1567.4318186666667,16.178917022237478,137,0.0
5,test_20231101_140255,11610969.png,368720,11307,357413,0.9693344543284877,2,4,84111,1677,82434,0.9800620608481649,36.18637866666667,6477.1144,10.016987931563099,137,0.0
6,test_20231101_140255,10350842.png,212614,3149,209465,0.9851891220709831,2,3,42529,463,42066,0.9891133109172565,22.868401777777777,3257.391989333333,13.002103368560345,137,0.0
7,test_20231101_140255,10863862.png,317432,5127,312305,0.9838485092870284,1,4,66058,754,65304,0.9885857882466923,39.95056888888889,7705.409882666667,9.26284615276712,137,0.0
8,test_20231101_140255,11382381.png,312486,547,311939,0.9982495215785667,1,4,46745,76,46669,0.9983741576639212,21.96234488888889,2754.930384,13.729697319910494,137,0.0
9,test_20231101_140255,11079715.png,443815,89749,354066,0.7977783535932765,3,4,124136,12651,111485,0.8980875813623768,19.09621511111111,2710.2879413333335,13.800649280417671,137,0.0
10,test_20231101_140255,11551286.png,271883,457,271426,0.9983191299198553,2,4,40092,65,40027,0.998378728923476,17.545795555555557,1811.9301333333333,15.549389132736895,137,0.0
1,test_20231101_140256,10404007.png,502730,10797,491933,0.9785232629841067,2,4,61265,1582,59683,0.9741777523871705,26.916595555555556,3763.959173333333,12.37435456764181,137,1.0E-5
2,test_20231101_140256,1254659.png,342646,51352,291294,0.8501310390315369,2,4,80080,7256,72824,0.9093906093906095,24.16980977777778,4265.197770666667,11.831411873296966,137,1.0E-5
3,test_20231101_140256,10188041.png,221231,6857,214374,0.9690052479082949,2,4,41731,971,40760,0.9767319259064006,12.429425777777778,1541.395904,16.251661602808255,137,1.0E-5
4,test_20231101_140256,10287332.png,216980,7912,209068,0.9635358097520509,1,3,22337,1084,21253,0.9514706540717196,11.779068444444444,1567.4318186666667,16.178917022237478,137,1.0E-5
5,test_20231101_140256,11610969.png,368720,11307,357413,0.9693344543284877,1,4,84111,1677,82434,0.9800620608481649,36.18637866666667,6477.1144,10.016987931563099,137,1.0E-5
6,test_20231101_140256,10350842.png,212614,3149,209465,0.9851891220709831,2,3,42529,463,42066,0.9891133109172565,22.868401777777777,3257.391989333333,13.002103368560345,137,1.0E-5
7,test_20231101_140256,10863862.png,317432,5127,312305,0.9838485092870284,2,4,66058,754,65304,0.9885857882466923,39.95056888888889,7705.409882666667,9.26284615276712,137,1.0E-5
8,test_20231101_140256,11382381.png,312486,547,311939,0.9982495215785667,2,4,46745,76,46669,0.9983741576639212,21.96234488888889,2754.930384,13.729697319910494,137,1.0E-5
9,test_20231101_140256,11079715.png,443815,89749,354066,0.7977783535932765,4,4,124136,12651,111485,0.8980875813623768,19.09621511111111,2710.2879413333335,13.800649280417671,137,1.0E-5
10,test_20231101_140256,11551286.png,271883,457,271426,0.9983191299198553,1,10,40092,65,40027,0.998378728923476,17.545795555555557,1811.9301333333333,15.549389132736895,137,1.0E-5
1,test_20231101_140256,10404007.png,502730,10797,491933,0.9785232629841067,2,4,61265,1582,59683,0.9741777523871705,26.916595555555556,3763.959173333333,12.37435456764181,137,2.0E-5
2,test_20231101_140256,1254659.png,342646,51352,291294,0.8501310390315369,3,9,80080,7256,72824,0.9093906093906095,24.16980977777778,4265.197770666667,11.831411873296966,137,2.0E-5
3,test_20231101_140256,10188041.png,221231,6857,214374,0.9690052479082949,2,4,41731,971,40760,0.9767319259064006,12.429425777777778,1541.395904,16.251661602808255,137,2.0E-5
4,test_20231101_140256,10287332.png,216980,7912,209068,0.9635358097520509,2,4,22337,1084,21253,0.9514706540717196,11.779068444444444,1567.4318186666667,16.178917022237478,137,2.0E-5
5,test_20231101_140256,11610969.png,368720,11307,357413,0.9693344543284877,2,4,84111,1677,82434,0.9800620608481649,36.18637866666667,6477.1144,10.016987931563099,137,2.0E-5
6,test_20231101_140256,10350842.png,212614,3149,209465,0.9851891220709831,2,3,42529,463,42066,0.9891133109172565,22.868401777777777,3257.391989333333,13.002103368560345,137,2.0E-5
7,test_20231101_140256,10863862.png,317432,5127,312305,0.9838485092870284,2,4,66058,754,65304,0.9885857882466923,39.95056888888889,7705.409882666667,9.26284615276712,137,2.0E-5
8,test_20231101_140256,11382381.png,312486,537,311949,0.9982815230122309,2,3,46745,75,46670,0.9983955503262381,22.692161777777777,2853.4911946666666,13.577038241313751,137,2.0E-5
9,test_20231101_140256,11079715.png,443815,89749,354066,0.7977783535932765,3,7,124136,12651,111485,0.8980875813623768,19.09621511111111,2710.2879413333335,13.800649280417671,137,2.0E-5
10,test_20231101_140256,11551286.png,271883,457,271426,0.9983191299198553,2,4,40092,65,40027,0.998378728923476,17.545795555555557,1811.9301333333333,15.549389132736895,137,2.0E-5
1,test_20231101_140257,10404007.png,502730,10797,491933,0.9785232629841067,2,3,61265,1582,59683,0.9741777523871705,26.916595555555556,3763.959173333333,12.37435456764181,137,3.0000000000000004E-5
2,test_20231101_140257,1254659.png,342646,51352,291294,0.8501310390315369,3,4,80080,7256,72824,0.9093906093906095,24.16980977777778,4265.197770666667,11.831411873296966,137,3.0000000000000004E-5
3,test_20231101_140257,10188041.png,221231,6857,214374,0.9690052479082949,2,3,41731,971,40760,0.9767319259064006,12.429425777777778,1541.395904,16.251661602808255,137,3.0000000000000004E-5
4,test_20231101_140257,10287332.png,216980,7912,209068,0.9635358097520509,2,4,22337,1084,21253,0.9514706540717196,11.779068444444444,1567.4318186666667,16.178917022237478,137,3.0000000000000004E-5
5,test_20231101_140257,11610969.png,368720,11307,357413,0.9693344543284877,2,3,84111,1677,82434,0.9800620608481649,36.18637866666667,6477.1144,10.016987931563099,137,3.0000000000000004E-5
6,test_20231101_140257,10350842.png,212614,3149,209465,0.9851891220709831,1,4,42529,463,42066,0.9891133109172565,22.868401777777777,3257.391989333333,13.002103368560345,137,3.0000000000000004E-5
7,test_20231101_140257,10863862.png,317432,5127,312305,0.9838485092870284,2,4,66058,754,65304,0.9885857882466923,39.95056888888889,7705.409882666667,9.26284615276712,137,3.0000000000000004E-5
8,test_20231101_140257,11382381.png,312486,537,311949,0.9982815230122309,1,3,46745,75,46670,0.9983955503262381,22.692161777777777,2853.4911946666666,13.577038241313751,137,3.0000000000000004E-5
9,test_20231101_140257,11079715.png,443815,89749,354066,0.7977783535932765,3,4,124136,12651,111485,0.8980875813623768,19.09621511111111,2710.2879413333335,13.800649280417671,137,3.0000000000000004E-5
10,test_20231101_140257,11551286.png,271883,457,271426,0.9983191299198553,1,4,40092,65,40027,0.998378728923476,17.545795555555557,1811.9301333333333,15.549389132736895,137,3.0000000000000004E-5
1,test_20231101_140258,10404007.png,502730,10797,491933,0.9785232629841067,2,4,61265,1582,59683,0.9741777523871705,26.916595555555556,3763.959173333333,12.37435456764181,137,4.0E-5
2,test_20231101_140258,1254659.png,342646,51352,291294,0.8501310390315369,3,5,80080,7256,72824,0.9093906093906095,24.16980977777778,4265.197770666667,11.831411873296966,137,4.0E-5
3,test_20231101_140258,10188041.png,221231,6857,214374,0.9690052479082949,2,4,41731,971,40760,0.9767319259064006,12.429425777777778,1541.395904,16.251661602808255,137,4.0E-5
4,test_20231101_140258,10287332.png,216980,7912,209068,0.9635358097520509,2,4,22337,1084,21253,0.9514706540717196,11.779068444444444,1567.4318186666667,16.178917022237478,137,4.0E-5
5,test_20231101_140258,11610969.png,368720,11307,357413,0.9693344543284877,2,4,84111,1677,82434,0.9800620608481649,36.18637866666667,6477.1144,10.016987931563099,137,4.0E-5
6,test_20231101_140258,10350842.png,212614,3149,209465,0.9851891220709831,1,4,42529,463,42066,0.9891133109172565,22.868401777777777,3257.391989333333,13.002103368560345,137,4.0E-5
7,test_20231101_140258,10863862.png,317432,5127,312305,0.9838485092870284,1,4,66058,754,65304,0.9885857882466923,39.95056888888889,7705.409882666667,9.26284615276712,137,4.0E-5
8,test_20231101_140258,11382381.png,312486,537,311949,0.9982815230122309,2,4,46745,75,46670,0.9983955503262381,22.692161777777777,2853.4911946666666,13.577038241313751,137,4.0E-5
9,test_20231101_140258,11079715.png,443815,89749,354066,0.7977783535932765,3,4,124136,12651,111485,0.8980875813623768,19.09621511111111,2710.2879413333335,13.800649280417671,137,4.0E-5
10,test_20231101_140258,11551286.png,271883,457,271426,0.9983191299198553,1,4,40092,65,40027,0.998378728923476,17.545795555555557,1811.9301333333333,15.549389132736895,137,4.0E-5
1,test_20231101_140258,10404007.png,502730,10797,491933,0.9785232629841067,2,4,61265,1582,59683,0.9741777523871705,26.916595555555556,3763.959173333333,12.37435456764181,137,5.0E-5
2,test_20231101_140258,1254659.png,342646,51352,291294,0.8501310390315369,3,4,80080,7256,72824,0.9093906093906095,24.16980977777778,4265.197770666667,11.831411873296966,137,5.0E-5
3,test_20231101_140258,10188041.png,221231,6857,214374,0.9690052479082949,2,4,41731,971,40760,0.9767319259064006,12.429425777777778,1541.395904,16.251661602808255,137,5.0E-5
4,test_20231101_140258,10287332.png,216980,7912,209068,0.9635358097520509,1,3,22337,1084,21253,0.9514706540717196,11.779068444444444,1567.4318186666667,16.178917022237478,137,5.0E-5
5,test_20231101_140258,11610969.png,368720,11307,357413,0.9693344543284877,2,4,84111,1677,82434,0.9800620608481649,36.18637866666667,6477.1144,10.016987931563099,137,5.0E-5
6,test_20231101_140258,10350842.png,212614,3149,209465,0.9851891220709831,1,4,42529,463,42066,0.9891133109172565,22.868401777777777,3257.391989333333,13.002103368560345,137,5.0E-5
7,test_20231101_140258,10863862.png,317432,5127,312305,0.9838485092870284,1,4,66058,754,65304,0.9885857882466923,39.95056888888889,7705.409882666667,9.26284615276712,137,5.0E-5
8,test_20231101_140258,11382381.png,312486,537,311949,0.9982815230122309,1,3,46745,75,46670,0.9983955503262381,22.692161777777777,2853.4911946666666,13.577038241313751,137,5.0E-5
9,test_20231101_140258,11079715.png,443815,89749,354066,0.7977783535932765,3,5,124136,12651,111485,0.8980875813623768,19.09621511111111,2710.2879413333335,13.800649280417671,137,5.0E-5
10,test_20231101_140258,11551286.png,271883,457,271426,0.9983191299198553,1,4,40092,65,40027,0.998378728923476,17.545795555555557,1811.9301333333333,15.549389132736895,137,5.0E-5
1,test_20231101_140259,10404007.png,502730,10797,491933,0.9785232629841067,2,3,61265,1582,59683,0.9741777523871705,26.916595555555556,3763.959173333333,12.37435456764181,137,6.0E-5
2,test_20231101_140259,1254659.png,342646,51352,291294,0.8501310390315369,3,4,80080,7256,72824,0.9093906093906095,24.16980977777778,4265.197770666667,11.831411873296966,137,6.0E-5
3,test_20231101_140259,10188041.png,221231,6857,214374,0.9690052479082949,2,4,41731,971,40760,0.9767319259064006,12.429425777777778,1541.395904,16.251661602808255,137,6.0E-5
4,test_20231101_140259,10287332.png,216980,7912,209068,0.9635358097520509,2,3,22337,1084,21253,0.9514706540717196,11.779068444444444,1567.4318186666667,16.178917022237478,137,6.0E-5
5,test_20231101_140259,11610969.png,368720,11307,357413,0.9693344543284877,1,3,84111,1677,82434,0.9800620608481649,36.18637866666667,6477.1144,10.016987931563099,137,6.0E-5
6,test_20231101_140259,10350842.png,212614,3149,209465,0.9851891220709831,1,3,42529,463,42066,0.9891133109172565,22.868401777777777,3257.391989333333,13.002103368560345,137,6.0E-5
7,test_20231101_140259,10863862.png,317432,5127,312305,0.9838485092870284,1,3,66058,754,65304,0.9885857882466923,39.95056888888889,7705.409882666667,9.26284615276712,137,6.0E-5
8,test_20231101_140259,11382381.png,312486,537,311949,0.9982815230122309,2,3,46745,75,46670,0.9983955503262381,22.692161777777777,2853.4911946666666,13.577038241313751,137,6.0E-5
9,test_20231101_140259,11079715.png,443815,89749,354066,0.7977783535932765,3,4,124136,12651,111485,0.8980875813623768,19.09621511111111,2710.2879413333335,13.800649280417671,137,6.0E-5
10,test_20231101_140259,11551286.png,271883,457,271426,0.9983191299198553,1,5,40092,65,40027,0.998378728923476,17.545795555555557,1811.9301333333333,15.549389132736895,137,6.0E-5
1,test_20231101_140300,10404007.png,502730,10797,491933,0.9785232629841067,2,4,61265,1582,59683,0.9741777523871705,26.916595555555556,3763.959173333333,12.37435456764181,137,7.000000000000001E-5
2,test_20231101_140300,1254659.png,342646,51352,291294,0.8501310390315369,3,4,80080,7256,72824,0.9093906093906095,24.16980977777778,4265.197770666667,11.831411873296966,137,7.000000000000001E-5
3,test_20231101_140300,10188041.png,221231,6857,214374,0.9690052479082949,2,9,41731,971,40760,0.9767319259064006,12.429425777777778,1541.395904,16.251661602808255,137,7.000000000000001E-5
4,test_20231101_140300,10287332.png,216980,7912,209068,0.9635358097520509,2,4,22337,1084,21253,0.9514706540717196,11.779068444444444,1567.4318186666667,16.178917022237478,137,7.000000000000001E-5
5,test_20231101_140300,11610969.png,368720,10927,357793,0.9703650466478628,2,3,84111,1620,82491,0.9807397367764026,37.647214222222225,6812.150005333333,9.797961581934295,137,7.000000000000001E-5
6,test_20231101_140300,10350842.png,212614,3149,209465,0.9851891220709831,2,3,42529,463,42066,0.9891133109172565,22.868401777777777,3257.391989333333,13.002103368560345,137,7.000000000000001E-5
7,test_20231101_140300,10863862.png,317432,5127,312305,0.9838485092870284,2,3,66058,754,65304,0.9885857882466923,39.95056888888889,7705.409882666667,9.26284615276712,137,7.000000000000001E-5
8,test_20231101_140300,11382381.png,312486,537,311949,0.9982815230122309,1,3,46745,75,46670,0.9983955503262381,22.692161777777777,2853.4911946666666,13.577038241313751,137,7.000000000000001E-5
9,test_20231101_140300,11079715.png,443815,89749,354066,0.7977783535932765,3,4,124136,12651,111485,0.8980875813623768,19.09621511111111,2710.2879413333335,13.800649280417671,137,7.000000000000001E-5
10,test_20231101_140300,11551286.png,271883,317,271566,0.9988340572967048,1,3,40092,44,40048,0.998902524194353,17.872128,1863.0349866666666,15.428593501082213,137,7.000000000000001E-5
1,test_20231101_140301,10404007.png,502730,10797,491933,0.9785232629841067,2,4,61265,1582,59683,0.9741777523871705,26.916595555555556,3763.959173333333,12.37435456764181,137,8.0E-5
2,test_20231101_140301,1254659.png,342646,51352,291294,0.8501310390315369,2,4,80080,7256,72824,0.9093906093906095,24.16980977777778,4265.197770666667,11.831411873296966,137,8.0E-5
3,test_20231101_140301,10188041.png,221231,6857,214374,0.9690052479082949,1,3,41731,971,40760,0.9767319259064006,12.429425777777778,1541.395904,16.251661602808255,137,8.0E-5
4,test_20231101_140301,10287332.png,216980,7912,209068,0.9635358097520509,2,4,22337,1084,21253,0.9514706540717196,11.779068444444444,1567.4318186666667,16.178917022237478,137,8.0E-5
5,test_20231101_140301,11610969.png,368720,10927,357793,0.9703650466478628,1,4,84111,1620,82491,0.9807397367764026,37.647214222222225,6812.150005333333,9.797961581934295,137,8.0E-5
6,test_20231101_140301,10350842.png,212614,3149,209465,0.9851891220709831,2,3,42529,463,42066,0.9891133109172565,22.868401777777777,3257.391989333333,13.002103368560345,137,8.0E-5
7,test_20231101_140301,10863862.png,317432,5127,312305,0.9838485092870284,2,4,66058,754,65304,0.9885857882466923,39.95056888888889,7705.409882666667,9.26284615276712,137,8.0E-5
8,test_20231101_140301,11382381.png,312486,427,312059,0.9986335387825375,1,4,46745,59,46686,0.9987378329233073,22.94864,2893.62336,13.516383590740695,137,8.0E-5
9,test_20231101_140301,11079715.png,443815,89749,354066,0.7977783535932765,3,4,124136,12651,111485,0.8980875813623768,19.09621511111111,2710.2879413333335,13.800649280417671,137,8.0E-5
10,test_20231101_140301,11551286.png,271883,317,271566,0.9988340572967048,1,4,40092,44,40048,0.998902524194353,17.872128,1863.0349866666666,15.428593501082213,137,8.0E-5
1,test_20231101_140301,10404007.png,502730,10797,491933,0.9785232629841067,2,3,61265,1582,59683,0.9741777523871705,26.916595555555556,3763.959173333333,12.37435456764181,137,9.0E-5
2,test_20231101_140301,1254659.png,342646,51352,291294,0.8501310390315369,2,3,80080,7256,72824,0.9093906093906095,24.16980977777778,4265.197770666667,11.831411873296966,137,9.0E-5
3,test_20231101_140301,10188041.png,221231,6857,214374,0.9690052479082949,2,4,41731,971,40760,0.9767319259064006,12.429425777777778,1541.395904,16.251661602808255,137,9.0E-5
4,test_20231101_140301,10287332.png,216980,7912,209068,0.9635358097520509,1,3,22337,1084,21253,0.9514706540717196,11.779068444444444,1567.4318186666667,16.178917022237478,137,9.0E-5
5,test_20231101_140301,11610969.png,368720,10927,357793,0.9703650466478628,2,4,84111,1620,82491,0.9807397367764026,37.647214222222225,6812.150005333333,9.797961581934295,137,9.0E-5
6,test_20231101_140301,10350842.png,212614,3149,209465,0.9851891220709831,2,3,42529,463,42066,0.9891133109172565,22.868401777777777,3257.391989333333,13.002103368560345,137,9.0E-5
7,test_20231101_140301,10863862.png,317432,5127,312305,0.9838485092870284,2,4,66058,754,65304,0.9885857882466923,39.95056888888889,7705.409882666667,9.26284615276712,137,9.0E-5
8,test_20231101_140301,11382381.png,312486,427,312059,0.9986335387825375,1,4,46745,59,46686,0.9987378329233073,22.94864,2893.62336,13.516383590740695,137,9.0E-5
9,test_20231101_140301,11079715.png,443815,89749,354066,0.7977783535932765,3,5,124136,12651,111485,0.8980875813623768,19.09621511111111,2710.2879413333335,13.800649280417671,137,9.0E-5
10,test_20231101_140301,11551286.png,271883,317,271566,0.9988340572967048,1,6,40092,44,40048,0.998902524194353,17.872128,1863.0349866666666,15.428593501082213,137,9.0E-5
1,test_20231101_140302,10404007.png,502730,10797,491933,0.9785232629841067,2,4,61265,1582,59683,0.9741777523871705,26.916595555555556,3763.959173333333,12.37435456764181,137,1.0E-4
2,test_20231101_140302,1254659.png,342646,51352,291294,0.8501310390315369,3,4,80080,7256,72824,0.9093906093906095,24.16980977777778,4265.197770666667,11.831411873296966,137,1.0E-4
3,test_20231101_140302,10188041.png,221231,6857,214374,0.9690052479082949,2,3,41731,971,40760,0.9767319259064006,12.429425777777778,1541.395904,16.251661602808255,137,1.0E-4
4,test_20231101_140302,10287332.png,216980,7912,209068,0.9635358097520509,2,3,22337,1084,21253,0.9514706540717196,11.779068444444444,1567.4318186666667,16.178917022237478,137,1.0E-4
5,test_20231101_140302,11610969.png,368720,10927,357793,0.9703650466478628,1,3,84111,1620,82491,0.9807397367764026,37.647214222222225,6812.150005333333,9.797961581934295,137,1.0E-4
6,test_20231101_140302,10350842.png,212614,3149,209465,0.9851891220709831,1,4,42529,463,42066,0.9891133109172565,22.868401777777777,3257.391989333333,13.002103368560345,137,1.0E-4
7,test_20231101_140302,10863862.png,317432,5127,312305,0.9838485092870284,2,4,66058,754,65304,0.9885857882466923,39.95056888888889,7705.409882666667,9.26284615276712,137,1.0E-4
8,test_20231101_140302,11382381.png,312486,427,312059,0.9986335387825375,1,3,46745,59,46686,0.9987378329233073,22.94864,2893.62336,13.516383590740695,137,1.0E-4
9,test_20231101_140302,11079715.png,443815,89749,354066,0.7977783535932765,3,4,124136,12651,111485,0.8980875813623768,19.09621511111111,2710.2879413333335,13.800649280417671,137,1.0E-4
10,test_20231101_140302,11551286.png,271883,317,271566,0.9988340572967048,1,4,40092,44,40048,0.998902524194353,17.872128,1863.0349866666666,15.428593501082213,137,1.0E-4
1,test_20231101_140303,10404007.png,502730,10797,491933,0.9785232629841067,2,11,61265,1582,59683,0.9741777523871705,26.916595555555556,3763.959173333333,12.37435456764181,137,1.1E-4
2,test_20231101_140303,1254659.png,342646,51352,291294,0.8501310390315369,3,4,80080,7256,72824,0.9093906093906095,24.16980977777778,4265.197770666667,11.831411873296966,137,1.1E-4
3,test_20231101_140303,10188041.png,221231,6857,214374,0.9690052479082949,1,3,41731,971,40760,0.9767319259064006,12.429425777777778,1541.395904,16.251661602808255,137,1.1E-4
4,test_20231101_140303,10287332.png,216980,7912,209068,0.9635358097520509,1,3,22337,1084,21253,0.9514706540717196,11.779068444444444,1567.4318186666667,16.178917022237478,137,1.1E-4
5,test_20231101_140303,11610969.png,368720,10927,357793,0.9703650466478628,3,4,84111,1620,82491,0.9807397367764026,37.647214222222225,6812.150005333333,9.797961581934295,137,1.1E-4
6,test_20231101_140303,10350842.png,212614,3149,209465,0.9851891220709831,1,4,42529,463,42066,0.9891133109172565,22.868401777777777,3257.391989333333,13.002103368560345,137,1.1E-4
7,test_20231101_140303,10863862.png,317432,5127,312305,0.9838485092870284,2,4,66058,754,65304,0.9885857882466923,39.95056888888889,7705.409882666667,9.26284615276712,137,1.1E-4
8,test_20231101_140303,11382381.png,312486,427,312059,0.9986335387825375,1,4,46745,59,46686,0.9987378329233073,22.94864,2893.62336,13.516383590740695,137,1.1E-4
9,test_20231101_140303,11079715.png,443815,89749,354066,0.7977783535932765,3,4,124136,12651,111485,0.8980875813623768,19.09621511111111,2710.2879413333335,13.800649280417671,137,1.1E-4
10,test_20231101_140303,11551286.png,271883,317,271566,0.9988340572967048,1,4,40092,44,40048,0.998902524194353,17.872128,1863.0349866666666,15.428593501082213,137,1.1E-4
1,test_20231101_140303,10404007.png,502730,10797,491933,0.9785232629841067,2,3,61265,1582,59683,0.9741777523871705,26.916595555555556,3763.959173333333,12.37435456764181,137,1.2E-4
2,test_20231101_140303,1254659.png,342646,51352,291294,0.8501310390315369,3,4,80080,7256,72824,0.9093906093906095,24.16980977777778,4265.197770666667,11.831411873296966,137,1.2E-4
3,test_20231101_140303,10188041.png,221231,6857,214374,0.9690052479082949,2,4,41731,971,40760,0.9767319259064006,12.429425777777778,1541.395904,16.251661602808255,137,1.2E-4
4,test_20231101_140303,10287332.png,216980,7912,209068,0.9635358097520509,1,3,22337,1084,21253,0.9514706540717196,11.779068444444444,1567.4318186666667,16.178917022237478,137,1.2E-4
5,test_20231101_140303,11610969.png,368720,10927,357793,0.9703650466478628,1,3,84111,1620,82491,0.9807397367764026,37.647214222222225,6812.150005333333,9.797961581934295,137,1.2E-4
6,test_20231101_140303,10350842.png,212614,3149,209465,0.9851891220709831,1,3,42529,463,42066,0.9891133109172565,22.868401777777777,3257.391989333333,13.002103368560345,137,1.2E-4
7,test_20231101_140303,10863862.png,317432,5127,312305,0.9838485092870284,1,4,66058,754,65304,0.9885857882466923,39.95056888888889,7705.409882666667,9.26284615276712,137,1.2E-4
8,test_20231101_140303,11382381.png,312486,427,312059,0.9986335387825375,1,3,46745,59,46686,0.9987378329233073,22.94864,2893.62336,13.516383590740695,137,1.2E-4
9,test_20231101_140303,11079715.png,443815,89749,354066,0.7977783535932765,3,4,124136,12651,111485,0.8980875813623768,19.09621511111111,2710.2879413333335,13.800649280417671,137,1.2E-4
10,test_20231101_140303,11551286.png,271883,317,271566,0.9988340572967048,2,3,40092,44,40048,0.998902524194353,17.872128,1863.0349866666666,15.428593501082213,137,1.2E-4
1,test_20231101_140304,10404007.png,502730,10797,491933,0.9785232629841067,3,4,61265,1582,59683,0.9741777523871705,26.916595555555556,3763.959173333333,12.37435456764181,137,1.3000000000000002E-4
2,test_20231101_140304,1254659.png,342646,51352,291294,0.8501310390315369,3,4,80080,7256,72824,0.9093906093906095,24.16980977777778,4265.197770666667,11.831411873296966,137,1.3000000000000002E-4
3,test_20231101_140304,10188041.png,221231,6857,214374,0.9690052479082949,2,4,41731,971,40760,0.9767319259064006,12.429425777777778,1541.395904,16.251661602808255,137,1.3000000000000002E-4
4,test_20231101_140304,10287332.png,216980,7912,209068,0.9635358097520509,1,3,22337,1084,21253,0.9514706540717196,11.779068444444444,1567.4318186666667,16.178917022237478,137,1.3000000000000002E-4
5,test_20231101_140304,11610969.png,368720,10927,357793,0.9703650466478628,1,3,84111,1620,82491,0.9807397367764026,37.647214222222225,6812.150005333333,9.797961581934295,137,1.3000000000000002E-4
6,test_20231101_140304,10350842.png,212614,3149,209465,0.9851891220709831,1,3,42529,463,42066,0.9891133109172565,22.868401777777777,3257.391989333333,13.002103368560345,137,1.3000000000000002E-4
7,test_20231101_140304,10863862.png,317432,5127,312305,0.9838485092870284,2,3,66058,754,65304,0.9885857882466923,39.95056888888889,7705.409882666667,9.26284615276712,137,1.3000000000000002E-4
8,test_20231101_140304,11382381.png,312486,427,312059,0.9986335387825375,1,3,46745,59,46686,0.9987378329233073,22.94864,2893.62336,13.516383590740695,137,1.3000000000000002E-4
9,test_20231101_140304,11079715.png,443815,89749,354066,0.7977783535932765,3,4,124136,12651,111485,0.8980875813623768,19.09621511111111,2710.2879413333335,13.800649280417671,137,1.3000000000000002E-4
10,test_20231101_140304,11551286.png,271883,317,271566,0.9988340572967048,1,3,40092,44,40048,0.998902524194353,17.872128,1863.0349866666666,15.428593501082213,137,1.3000000000000002E-4
1,test_20231101_140305,10404007.png,502730,10797,491933,0.9785232629841067,2,4,61265,1582,59683,0.9741777523871705,26.916595555555556,3763.959173333333,12.37435456764181,137,1.4000000000000001E-4
2,test_20231101_140305,1254659.png,342646,51352,291294,0.8501310390315369,2,4,80080,7256,72824,0.9093906093906095,24.16980977777778,4265.197770666667,11.831411873296966,137,1.4000000000000001E-4
3,test_20231101_140305,10188041.png,221231,6857,214374,0.9690052479082949,2,4,41731,971,40760,0.9767319259064006,12.429425777777778,1541.395904,16.251661602808255,137,1.4000000000000001E-4
4,test_20231101_140305,10287332.png,216980,7912,209068,0.9635358097520509,2,4,22337,1084,21253,0.9514706540717196,11.779068444444444,1567.4318186666667,16.178917022237478,137,1.4000000000000001E-4
5,test_20231101_140305,11610969.png,368720,10927,357793,0.9703650466478628,2,4,84111,1620,82491,0.9807397367764026,37.647214222222225,6812.150005333333,9.797961581934295,137,1.4000000000000001E-4
6,test_20231101_140305,10350842.png,212614,3149,209465,0.9851891220709831,2,4,42529,463,42066,0.9891133109172565,22.868401777777777,3257.391989333333,13.002103368560345,137,1.4000000000000001E-4
7,test_20231101_140305,10863862.png,317432,5127,312305,0.9838485092870284,2,4,66058,754,65304,0.9885857882466923,39.95056888888889,7705.409882666667,9.26284615276712,137,1.4000000000000001E-4
8,test_20231101_140305,11382381.png,312486,427,312059,0.9986335387825375,1,4,46745,59,46686,0.9987378329233073,22.94864,2893.62336,13.516383590740695,137,1.4000000000000001E-4
9,test_20231101_140305,11079715.png,443815,89749,354066,0.7977783535932765,3,4,124136,12651,111485,0.8980875813623768,19.09621511111111,2710.2879413333335,13.800649280417671,137,1.4000000000000001E-4
10,test_20231101_140305,11551286.png,271883,317,271566,0.9988340572967048,2,3,40092,44,40048,0.998902524194353,17.872128,1863.0349866666666,15.428593501082213,137,1.4000000000000001E-4
1,test_20231101_140305,10404007.png,502730,10797,491933,0.9785232629841067,2,4,61265,1582,59683,0.9741777523871705,26.916595555555556,3763.959173333333,12.37435456764181,137,1.5000000000000001E-4
2,test_20231101_140305,1254659.png,342646,51352,291294,0.8501310390315369,3,4,80080,7256,72824,0.9093906093906095,24.16980977777778,4265.197770666667,11.831411873296966,137,1.5000000000000001E-4
3,test_20231101_140305,10188041.png,221231,6857,214374,0.9690052479082949,2,4,41731,971,40760,0.9767319259064006,12.429425777777778,1541.395904,16.251661602808255,137,1.5000000000000001E-4
4,test_20231101_140305,10287332.png,216980,7912,209068,0.9635358097520509,1,3,22337,1084,21253,0.9514706540717196,11.779068444444444,1567.4318186666667,16.178917022237478,137,1.5000000000000001E-4
5,test_20231101_140305,11610969.png,368720,10927,357793,0.9703650466478628,1,4,84111,1620,82491,0.9807397367764026,37.647214222222225,6812.150005333333,9.797961581934295,137,1.5000000000000001E-4
6,test_20231101_140305,10350842.png,212614,3149,209465,0.9851891220709831,1,4,42529,463,42066,0.9891133109172565,22.868401777777777,3257.391989333333,13.002103368560345,137,1.5000000000000001E-4
7,test_20231101_140305,10863862.png,317432,5127,312305,0.9838485092870284,1,3,66058,754,65304,0.9885857882466923,39.95056888888889,7705.409882666667,9.26284615276712,137,1.5000000000000001E-4
8,test_20231101_140305,11382381.png,312486,427,312059,0.9986335387825375,2,3,46745,59,46686,0.9987378329233073,22.94864,2893.62336,13.516383590740695,137,1.5000000000000001E-4
9,test_20231101_140305,11079715.png,443815,89749,354066,0.7977783535932765,3,4,124136,12651,111485,0.8980875813623768,19.09621511111111,2710.2879413333335,13.800649280417671,137,1.5000000000000001E-4
10,test_20231101_140305,11551286.png,271883,317,271566,0.9988340572967048,1,4,40092,44,40048,0.998902524194353,17.872128,1863.0349866666666,15.428593501082213,137,1.5000000000000001E-4
1,test_20231101_140306,10404007.png,502730,10797,491933,0.9785232629841067,2,3,61265,1582,59683,0.9741777523871705,26.916595555555556,3763.959173333333,12.37435456764181,137,1.6E-4
2,test_20231101_140306,1254659.png,342646,51352,291294,0.8501310390315369,2,4,80080,7256,72824,0.9093906093906095,24.16980977777778,4265.197770666667,11.831411873296966,137,1.6E-4
3,test_20231101_140306,10188041.png,221231,6857,214374,0.9690052479082949,2,3,41731,971,40760,0.9767319259064006,12.429425777777778,1541.395904,16.251661602808255,137,1.6E-4
4,test_20231101_140306,10287332.png,216980,7742,209238,0.9643192921006545,2,4,22337,1063,21274,0.9524107982271567,11.905411555555556,1593.1080746666667,16.108351220163833,137,1.6E-4
5,test_20231101_140306,11610969.png,368720,10927,357793,0.9703650466478628,1,3,84111,1620,82491,0.9807397367764026,37.647214222222225,6812.150005333333,9.797961581934295,137,1.6E-4
6,test_20231101_140306,10350842.png,212614,3149,209465,0.9851891220709831,1,3,42529,463,42066,0.9891133109172565,22.868401777777777,3257.391989333333,13.002103368560345,137,1.6E-4
7,test_20231101_140306,10863862.png,317432,5127,312305,0.9838485092870284,2,3,66058,754,65304,0.9885857882466923,39.95056888888889,7705.409882666667,9.26284615276712,137,1.6E-4
8,test_20231101_140306,11382381.png,312486,427,312059,0.9986335387825375,2,3,46745,59,46686,0.9987378329233073,22.94864,2893.62336,13.516383590740695,137,1.6E-4
9,test_20231101_140306,11079715.png,443815,89749,354066,0.7977783535932765,3,4,124136,12651,111485,0.8980875813623768,19.09621511111111,2710.2879413333335,13.800649280417671,137,1.6E-4
10,test_20231101_140306,11551286.png,271883,124,271759,0.999543921466219,1,4,40092,16,40076,0.9996009178888556,18.13910577777778,1903.2464906666667,15.335853231830718,137,1.6E-4
1,test_20231101_140307,10404007.png,502730,10797,491933,0.9785232629841067,2,4,61265,1582,59683,0.9741777523871705,26.916595555555556,3763.959173333333,12.37435456764181,137,1.7E-4
2,test_20231101_140307,1254659.png,342646,51352,291294,0.8501310390315369,3,4,80080,7256,72824,0.9093906093906095,24.16980977777778,4265.197770666667,11.831411873296966,137,1.7E-4
3,test_20231101_140307,10188041.png,221231,6857,214374,0.9690052479082949,2,4,41731,971,40760,0.9767319259064006,12.429425777777778,1541.395904,16.251661602808255,137,1.7E-4
4,test_20231101_140307,10287332.png,216980,7742,209238,0.9643192921006545,2,4,22337,1063,21274,0.9524107982271567,11.905411555555556,1593.1080746666667,16.108351220163833,137,1.7E-4
5,test_20231101_140307,11610969.png,368720,10927,357793,0.9703650466478628,2,5,84111,1620,82491,0.9807397367764026,37.647214222222225,6812.150005333333,9.797961581934295,137,1.7E-4
6,test_20231101_140307,10350842.png,212614,3149,209465,0.9851891220709831,1,3,42529,463,42066,0.9891133109172565,22.868401777777777,3257.391989333333,13.002103368560345,137,1.7E-4
7,test_20231101_140307,10863862.png,317432,5127,312305,0.9838485092870284,2,4,66058,754,65304,0.9885857882466923,39.95056888888889,7705.409882666667,9.26284615276712,137,1.7E-4
8,test_20231101_140307,11382381.png,312486,427,312059,0.9986335387825375,1,3,46745,59,46686,0.9987378329233073,22.94864,2893.62336,13.516383590740695,137,1.7E-4
9,test_20231101_140307,11079715.png,443815,89749,354066,0.7977783535932765,3,4,124136,12651,111485,0.8980875813623768,19.09621511111111,2710.2879413333335,13.800649280417671,137,1.7E-4
10,test_20231101_140307,11551286.png,271883,124,271759,0.999543921466219,1,4,40092,16,40076,0.9996009178888556,18.13910577777778,1903.2464906666667,15.335853231830718,137,1.7E-4
1,test_20231101_140307,10404007.png,502730,10797,491933,0.9785232629841067,2,4,61265,1582,59683,0.9741777523871705,26.916595555555556,3763.959173333333,12.37435456764181,137,1.8E-4
2,test_20231101_140307,1254659.png,342646,51352,291294,0.8501310390315369,3,4,80080,7256,72824,0.9093906093906095,24.16980977777778,4265.197770666667,11.831411873296966,137,1.8E-4
3,test_20231101_140307,10188041.png,221231,6857,214374,0.9690052479082949,2,3,41731,971,40760,0.9767319259064006,12.429425777777778,1541.395904,16.251661602808255,137,1.8E-4
4,test_20231101_140307,10287332.png,216980,7742,209238,0.9643192921006545,1,4,22337,1063,21274,0.9524107982271567,11.905411555555556,1593.1080746666667,16.108351220163833,137,1.8E-4
5,test_20231101_140307,11610969.png,368720,10927,357793,0.9703650466478628,1,4,84111,1620,82491,0.9807397367764026,37.647214222222225,6812.150005333333,9.797961581934295,137,1.8E-4
6,test_20231101_140307,10350842.png,212614,3149,209465,0.9851891220709831,1,4,42529,463,42066,0.9891133109172565,22.868401777777777,3257.391989333333,13.002103368560345,137,1.8E-4
7,test_20231101_140307,10863862.png,317432,5127,312305,0.9838485092870284,2,3,66058,754,65304,0.9885857882466923,39.95056888888889,7705.409882666667,9.26284615276712,137,1.8E-4
8,test_20231101_140307,11382381.png,312486,427,312059,0.9986335387825375,1,4,46745,59,46686,0.9987378329233073,22.94864,2893.62336,13.516383590740695,137,1.8E-4
9,test_20231101_140307,11079715.png,443815,89749,354066,0.7977783535932765,3,4,124136,12651,111485,0.8980875813623768,19.09621511111111,2710.2879413333335,13.800649280417671,137,1.8E-4
10,test_20231101_140307,11551286.png,271883,124,271759,0.999543921466219,1,3,40092,16,40076,0.9996009178888556,18.13910577777778,1903.2464906666667,15.335853231830718,137,1.8E-4
1,test_20231101_140308,10404007.png,502730,10797,491933,0.9785232629841067,2,4,61265,1582,59683,0.9741777523871705,26.916595555555556,3763.959173333333,12.37435456764181,137,1.9E-4
2,test_20231101_140308,1254659.png,342646,51352,291294,0.8501310390315369,3,4,80080,7256,72824,0.9093906093906095,24.16980977777778,4265.197770666667,11.831411873296966,137,1.9E-4
3,test_20231101_140308,10188041.png,221231,6857,214374,0.9690052479082949,2,3,41731,971,40760,0.9767319259064006,12.429425777777778,1541.395904,16.251661602808255,137,1.9E-4
4,test_20231101_140308,10287332.png,216980,7742,209238,0.9643192921006545,2,4,22337,1063,21274,0.9524107982271567,11.905411555555556,1593.1080746666667,16.108351220163833,137,1.9E-4
5,test_20231101_140308,11610969.png,368720,10927,357793,0.9703650466478628,2,4,84111,1620,82491,0.9807397367764026,37.647214222222225,6812.150005333333,9.797961581934295,137,1.9E-4
6,test_20231101_140308,10350842.png,212614,3149,209465,0.9851891220709831,2,3,42529,463,42066,0.9891133109172565,22.868401777777777,3257.391989333333,13.002103368560345,137,1.9E-4
7,test_20231101_140308,10863862.png,317432,5127,312305,0.9838485092870284,2,4,66058,754,65304,0.9885857882466923,39.95056888888889,7705.409882666667,9.26284615276712,137,1.9E-4
8,test_20231101_140308,11382381.png,312486,427,312059,0.9986335387825375,1,4,46745,59,46686,0.9987378329233073,22.94864,2893.62336,13.516383590740695,137,1.9E-4
9,test_20231101_140308,11079715.png,443815,89749,354066,0.7977783535932765,3,4,124136,12651,111485,0.8980875813623768,19.09621511111111,2710.2879413333335,13.800649280417671,137,1.9E-4
10,test_20231101_140308,11551286.png,271883,124,271759,0.999543921466219,1,4,40092,16,40076,0.9996009178888556,18.13910577777778,1903.2464906666667,15.335853231830718,137,1.9E-4
1,test_20231101_140309,10404007.png,502730,10797,491933,0.9785232629841067,2,3,61265,1582,59683,0.9741777523871705,26.916595555555556,3763.959173333333,12.37435456764181,137,2.0E-4
2,test_20231101_140309,1254659.png,342646,51352,291294,0.8501310390315369,3,4,80080,7256,72824,0.9093906093906095,24.16980977777778,4265.197770666667,11.831411873296966,137,2.0E-4
3,test_20231101_140309,10188041.png,221231,6857,214374,0.9690052479082949,2,3,41731,971,40760,0.9767319259064006,12.429425777777778,1541.395904,16.251661602808255,137,2.0E-4
4,test_20231101_140309,10287332.png,216980,7742,209238,0.9643192921006545,2,4,22337,1063,21274,0.9524107982271567,11.905411555555556,1593.1080746666667,16.108351220163833,137,2.0E-4
5,test_20231101_140309,11610969.png,368720,10927,357793,0.9703650466478628,1,3,84111,1620,82491,0.9807397367764026,37.647214222222225,6812.150005333333,9.797961581934295,137,2.0E-4
6,test_20231101_140309,10350842.png,212614,3149,209465,0.9851891220709831,1,3,42529,463,42066,0.9891133109172565,22.868401777777777,3257.391989333333,13.002103368560345,137,2.0E-4
7,test_20231101_140309,10863862.png,317432,5127,312305,0.9838485092870284,1,4,66058,754,65304,0.9885857882466923,39.95056888888889,7705.409882666667,9.26284615276712,137,2.0E-4
8,test_20231101_140309,11382381.png,312486,427,312059,0.9986335387825375,1,4,46745,59,46686,0.9987378329233073,22.94864,2893.62336,13.516383590740695,137,2.0E-4
9,test_20231101_140309,11079715.png,443815,89749,354066,0.7977783535932765,3,5,124136,12651,111485,0.8980875813623768,19.09621511111111,2710.2879413333335,13.800649280417671,137,2.0E-4
10,test_20231101_140309,11551286.png,271883,124,271759,0.999543921466219,1,3,40092,16,40076,0.9996009178888556,18.13910577777778,1903.2464906666667,15.335853231830718,137,2.0E-4
1,test_20231101_140309,10404007.png,502730,10797,491933,0.9785232629841067,2,4,61265,1582,59683,0.9741777523871705,26.916595555555556,3763.959173333333,12.37435456764181,137,2.1E-4
2,test_20231101_140309,1254659.png,342646,51352,291294,0.8501310390315369,3,4,80080,7256,72824,0.9093906093906095,24.16980977777778,4265.197770666667,11.831411873296966,137,2.1E-4
3,test_20231101_140309,10188041.png,221231,6857,214374,0.9690052479082949,2,4,41731,971,40760,0.9767319259064006,12.429425777777778,1541.395904,16.251661602808255,137,2.1E-4
4,test_20231101_140309,10287332.png,216980,7742,209238,0.9643192921006545,2,3,22337,1063,21274,0.9524107982271567,11.905411555555556,1593.1080746666667,16.108351220163833,137,2.1E-4
5,test_20231101_140309,11610969.png,368720,10927,357793,0.9703650466478628,1,3,84111,1620,82491,0.9807397367764026,37.647214222222225,6812.150005333333,9.797961581934295,137,2.1E-4
6,test_20231101_140309,10350842.png,212614,3149,209465,0.9851891220709831,2,3,42529,463,42066,0.9891133109172565,22.868401777777777,3257.391989333333,13.002103368560345,137,2.1E-4
7,test_20231101_140309,10863862.png,317432,5127,312305,0.9838485092870284,1,4,66058,754,65304,0.9885857882466923,39.95056888888889,7705.409882666667,9.26284615276712,137,2.1E-4
8,test_20231101_140309,11382381.png,312486,427,312059,0.9986335387825375,1,4,46745,59,46686,0.9987378329233073,22.94864,2893.62336,13.516383590740695,137,2.1E-4
9,test_20231101_140309,11079715.png,443815,89749,354066,0.7977783535932765,3,4,124136,12651,111485,0.8980875813623768,19.09621511111111,2710.2879413333335,13.800649280417671,137,2.1E-4
10,test_20231101_140309,11551286.png,271883,124,271759,0.999543921466219,2,4,40092,16,40076,0.9996009178888556,18.13910577777778,1903.2464906666667,15.335853231830718,137,2.1E-4
1,test_20231101_140310,10404007.png,502730,10797,491933,0.9785232629841067,2,3,61265,1582,59683,0.9741777523871705,26.916595555555556,3763.959173333333,12.37435456764181,137,2.2E-4
2,test_20231101_140310,1254659.png,342646,51352,291294,0.8501310390315369,3,4,80080,7256,72824,0.9093906093906095,24.16980977777778,4265.197770666667,11.831411873296966,137,2.2E-4
3,test_20231101_140310,10188041.png,221231,6857,214374,0.9690052479082949,2,4,41731,971,40760,0.9767319259064006,12.429425777777778,1541.395904,16.251661602808255,137,2.2E-4
4,test_20231101_140310,10287332.png,216980,7742,209238,0.9643192921006545,2,4,22337,1063,21274,0.9524107982271567,11.905411555555556,1593.1080746666667,16.108351220163833,137,2.2E-4
5,test_20231101_140310,11610969.png,368720,10927,357793,0.9703650466478628,2,4,84111,1620,82491,0.9807397367764026,37.647214222222225,6812.150005333333,9.797961581934295,137,2.2E-4
6,test_20231101_140310,10350842.png,212614,3149,209465,0.9851891220709831,1,4,42529,463,42066,0.9891133109172565,22.868401777777777,3257.391989333333,13.002103368560345,137,2.2E-4
7,test_20231101_140310,10863862.png,317432,5127,312305,0.9838485092870284,2,4,66058,754,65304,0.9885857882466923,39.95056888888889,7705.409882666667,9.26284615276712,137,2.2E-4
8,test_20231101_140310,11382381.png,312486,427,312059,0.9986335387825375,2,6,46745,59,46686,0.9987378329233073,22.94864,2893.62336,13.516383590740695,137,2.2E-4
9,test_20231101_140310,11079715.png,443815,89749,354066,0.7977783535932765,3,4,124136,12651,111485,0.8980875813623768,19.09621511111111,2710.2879413333335,13.800649280417671,137,2.2E-4
10,test_20231101_140310,11551286.png,271883,124,271759,0.999543921466219,1,3,40092,16,40076,0.9996009178888556,18.13910577777778,1903.2464906666667,15.335853231830718,137,2.2E-4
1,test_20231101_140311,10404007.png,502730,10797,491933,0.9785232629841067,2,4,61265,1582,59683,0.9741777523871705,26.916595555555556,3763.959173333333,12.37435456764181,137,2.3E-4
2,test_20231101_140311,1254659.png,342646,51352,291294,0.8501310390315369,2,4,80080,7256,72824,0.9093906093906095,24.16980977777778,4265.197770666667,11.831411873296966,137,2.3E-4
3,test_20231101_140311,10188041.png,221231,6857,214374,0.9690052479082949,2,3,41731,971,40760,0.9767319259064006,12.429425777777778,1541.395904,16.251661602808255,137,2.3E-4
4,test_20231101_140311,10287332.png,216980,7742,209238,0.9643192921006545,1,3,22337,1063,21274,0.9524107982271567,11.905411555555556,1593.1080746666667,16.108351220163833,137,2.3E-4
5,test_20231101_140311,11610969.png,368720,10927,357793,0.9703650466478628,1,4,84111,1620,82491,0.9807397367764026,37.647214222222225,6812.150005333333,9.797961581934295,137,2.3E-4
6,test_20231101_140311,10350842.png,212614,3149,209465,0.9851891220709831,2,4,42529,463,42066,0.9891133109172565,22.868401777777777,3257.391989333333,13.002103368560345,137,2.3E-4
7,test_20231101_140311,10863862.png,317432,5127,312305,0.9838485092870284,1,4,66058,754,65304,0.9885857882466923,39.95056888888889,7705.409882666667,9.26284615276712,137,2.3E-4
8,test_20231101_140311,11382381.png,312486,427,312059,0.9986335387825375,1,4,46745,59,46686,0.9987378329233073,22.94864,2893.62336,13.516383590740695,137,2.3E-4
9,test_20231101_140311,11079715.png,443815,89749,354066,0.7977783535932765,3,5,124136,12651,111485,0.8980875813623768,19.09621511111111,2710.2879413333335,13.800649280417671,137,2.3E-4
10,test_20231101_140311,11551286.png,271883,124,271759,0.999543921466219,1,4,40092,16,40076,0.9996009178888556,18.13910577777778,1903.2464906666667,15.335853231830718,137,2.3E-4
1,test_20231101_140311,10404007.png,502730,10797,491933,0.9785232629841067,2,3,61265,1582,59683,0.9741777523871705,26.916595555555556,3763.959173333333,12.37435456764181,137,2.4E-4
2,test_20231101_140311,1254659.png,342646,51352,291294,0.8501310390315369,3,4,80080,7256,72824,0.9093906093906095,24.16980977777778,4265.197770666667,11.831411873296966,137,2.4E-4
3,test_20231101_140311,10188041.png,221231,6857,214374,0.9690052479082949,2,4,41731,971,40760,0.9767319259064006,12.429425777777778,1541.395904,16.251661602808255,137,2.4E-4
4,test_20231101_140311,10287332.png,216980,7742,209238,0.9643192921006545,2,3,22337,1063,21274,0.9524107982271567,11.905411555555556,1593.1080746666667,16.108351220163833,137,2.4E-4
5,test_20231101_140311,11610969.png,368720,10927,357793,0.9703650466478628,1,3,84111,1620,82491,0.9807397367764026,37.647214222222225,6812.150005333333,9.797961581934295,137,2.4E-4
6,test_20231101_140311,10350842.png,212614,3149,209465,0.9851891220709831,1,4,42529,463,42066,0.9891133109172565,22.868401777777777,3257.391989333333,13.002103368560345,137,2.4E-4
7,test_20231101_140311,10863862.png,317432,5127,312305,0.9838485092870284,1,3,66058,754,65304,0.9885857882466923,39.95056888888889,7705.409882666667,9.26284615276712,137,2.4E-4
8,test_20231101_140311,11382381.png,312486,427,312059,0.9986335387825375,1,3,46745,59,46686,0.9987378329233073,22.94864,2893.62336,13.516383590740695,137,2.4E-4
9,test_20231101_140311,11079715.png,443815,89749,354066,0.7977783535932765,4,4,124136,12651,111485,0.8980875813623768,19.09621511111111,2710.2879413333335,13.800649280417671,137,2.4E-4
10,test_20231101_140311,11551286.png,271883,124,271759,0.999543921466219,2,3,40092,16,40076,0.9996009178888556,18.13910577777778,1903.2464906666667,15.335853231830718,137,2.4E-4
1,test_20231101_140312,10404007.png,502730,10797,491933,0.9785232629841067,2,4,61265,1582,59683,0.9741777523871705,26.916595555555556,3763.959173333333,12.37435456764181,137,2.5E-4
2,test_20231101_140312,1254659.png,342646,51352,291294,0.8501310390315369,3,4,80080,7256,72824,0.9093906093906095,24.16980977777778,4265.197770666667,11.831411873296966,137,2.5E-4
3,test_20231101_140312,10188041.png,221231,6857,214374,0.9690052479082949,2,11,41731,971,40760,0.9767319259064006,12.429425777777778,1541.395904,16.251661602808255,137,2.5E-4
4,test_20231101_140312,10287332.png,216980,7742,209238,0.9643192921006545,1,4,22337,1063,21274,0.9524107982271567,11.905411555555556,1593.1080746666667,16.108351220163833,137,2.5E-4
5,test_20231101_140312,11610969.png,368720,10927,357793,0.9703650466478628,1,4,84111,1620,82491,0.9807397367764026,37.647214222222225,6812.150005333333,9.797961581934295,137,2.5E-4
6,test_20231101_140312,10350842.png,212614,3149,209465,0.9851891220709831,1,4,42529,463,42066,0.9891133109172565,22.868401777777777,3257.391989333333,13.002103368560345,137,2.5E-4
7,test_20231101_140312,10863862.png,317432,5127,312305,0.9838485092870284,2,4,66058,754,65304,0.9885857882466923,39.95056888888889,7705.409882666667,9.26284615276712,137,2.5E-4
8,test_20231101_140312,11382381.png,312486,427,312059,0.9986335387825375,1,3,46745,59,46686,0.9987378329233073,22.94864,2893.62336,13.516383590740695,137,2.5E-4
9,test_20231101_140312,11079715.png,443815,89749,354066,0.7977783535932765,3,4,124136,12651,111485,0.8980875813623768,19.09621511111111,2710.2879413333335,13.800649280417671,137,2.5E-4
10,test_20231101_140312,11551286.png,271883,124,271759,0.999543921466219,1,4,40092,16,40076,0.9996009178888556,18.13910577777778,1903.2464906666667,15.335853231830718,137,2.5E-4
1,test_20231101_140313,10404007.png,502730,10697,492033,0.9787221769140493,2,4,61265,1567,59698,0.974422590386028,26.92314488888889,3765.0911626666666,12.373048648029627,137,2.6000000000000003E-4
2,test_20231101_140313,1254659.png,342646,51312,291334,0.850247777589699,3,4,80080,7252,72828,0.9094405594405595,24.177809777777778,4265.942901333333,11.830653226475647,137,2.6000000000000003E-4
3,test_20231101_140313,10188041.png,221231,6697,214534,0.969728473857642,1,3,41731,948,40783,0.9772830749323045,12.756494222222223,1588.645056,16.12053485334449,137,2.6000000000000003E-4
4,test_20231101_140313,10287332.png,216980,7742,209238,0.9643192921006545,2,4,22337,1063,21274,0.9524107982271567,11.905411555555556,1593.1080746666667,16.108351220163833,137,2.6000000000000003E-4
5,test_20231101_140313,11610969.png,368720,10847,357873,0.9705820134519418,1,3,84111,1608,82503,0.9808824053928737,37.68496,6816.026848,9.79549068440944,137,2.6000000000000003E-4
6,test_20231101_140313,10350842.png,212614,3087,209527,0.9854807303376071,1,3,42529,454,42075,0.9893249312234005,22.923879111111113,3262.133152,12.995786770028136,137,2.6000000000000003E-4
7,test_20231101_140313,10863862.png,317432,5027,312405,0.9841635373875349,1,4,66058,739,65319,0.9888128614248085,40.246081777777775,7796.218885333334,9.211963370721508,137,2.6000000000000003E-4
8,test_20231101_140313,11382381.png,312486,327,312159,0.9989535531191798,1,4,46745,44,46701,0.9990587228580596,23.441726222222222,2963.055792,13.413405318888326,137,2.6000000000000003E-4
9,test_20231101_140313,11079715.png,443815,89749,354066,0.7977783535932765,4,4,124136,12651,111485,0.8980875813623768,19.09621511111111,2710.2879413333335,13.800649280417671,137,2.6000000000000003E-4
10,test_20231101_140313,11551286.png,271883,124,271759,0.999543921466219,1,3,40092,16,40076,0.9996009178888556,18.13910577777778,1903.2464906666667,15.335853231830718,137,2.6000000000000003E-4
1,test_20231101_140313,10404007.png,502730,10697,492033,0.9787221769140493,2,7,61265,1567,59698,0.974422590386028,26.92314488888889,3765.0911626666666,12.373048648029627,137,2.7000000000000006E-4
2,test_20231101_140313,1254659.png,342646,51312,291334,0.850247777589699,2,4,80080,7252,72828,0.9094405594405595,24.177809777777778,4265.942901333333,11.830653226475647,137,2.7000000000000006E-4
3,test_20231101_140313,10188041.png,221231,6697,214534,0.969728473857642,2,4,41731,948,40783,0.9772830749323045,12.756494222222223,1588.645056,16.12053485334449,137,2.7000000000000006E-4
4,test_20231101_140313,10287332.png,216980,7742,209238,0.9643192921006545,2,4,22337,1063,21274,0.9524107982271567,11.905411555555556,1593.1080746666667,16.108351220163833,137,2.7000000000000006E-4
5,test_20231101_140313,11610969.png,368720,10847,357873,0.9705820134519418,2,3,84111,1608,82503,0.9808824053928737,37.68496,6816.026848,9.79549068440944,137,2.7000000000000006E-4
6,test_20231101_140313,10350842.png,212614,3087,209527,0.9854807303376071,2,3,42529,454,42075,0.9893249312234005,22.923879111111113,3262.133152,12.995786770028136,137,2.7000000000000006E-4
7,test_20231101_140313,10863862.png,317432,5027,312405,0.9841635373875349,1,3,66058,739,65319,0.9888128614248085,40.246081777777775,7796.218885333334,9.211963370721508,137,2.7000000000000006E-4
8,test_20231101_140313,11382381.png,312486,327,312159,0.9989535531191798,1,3,46745,44,46701,0.9990587228580596,23.441726222222222,2963.055792,13.413405318888326,137,2.7000000000000006E-4
9,test_20231101_140313,11079715.png,443815,89749,354066,0.7977783535932765,3,4,124136,12651,111485,0.8980875813623768,19.09621511111111,2710.2879413333335,13.800649280417671,137,2.7000000000000006E-4
10,test_20231101_140313,11551286.png,271883,124,271759,0.999543921466219,1,3,40092,16,40076,0.9996009178888556,18.13910577777778,1903.2464906666667,15.335853231830718,137,2.7000000000000006E-4
1,test_20231101_140314,10404007.png,502730,10697,492033,0.9787221769140493,2,4,61265,1567,59698,0.974422590386028,26.92314488888889,3765.0911626666666,12.373048648029627,137,2.800000000000001E-4
2,test_20231101_140314,1254659.png,342646,51312,291334,0.850247777589699,2,4,80080,7252,72828,0.9094405594405595,24.177809777777778,4265.942901333333,11.830653226475647,137,2.800000000000001E-4
3,test_20231101_140314,10188041.png,221231,6697,214534,0.969728473857642,2,4,41731,948,40783,0.9772830749323045,12.756494222222223,1588.645056,16.12053485334449,137,2.800000000000001E-4
4,test_20231101_140314,10287332.png,216980,7742,209238,0.9643192921006545,1,4,22337,1063,21274,0.9524107982271567,11.905411555555556,1593.1080746666667,16.108351220163833,137,2.800000000000001E-4
5,test_20231101_140314,11610969.png,368720,10847,357873,0.9705820134519418,2,3,84111,1608,82503,0.9808824053928737,37.68496,6816.026848,9.79549068440944,137,2.800000000000001E-4
6,test_20231101_140314,10350842.png,212614,3087,209527,0.9854807303376071,1,3,42529,454,42075,0.9893249312234005,22.923879111111113,3262.133152,12.995786770028136,137,2.800000000000001E-4
7,test_20231101_140314,10863862.png,317432,5027,312405,0.9841635373875349,2,3,66058,739,65319,0.9888128614248085,40.246081777777775,7796.218885333334,9.211963370721508,137,2.800000000000001E-4
8,test_20231101_140314,11382381.png,312486,327,312159,0.9989535531191798,1,4,46745,44,46701,0.9990587228580596,23.441726222222222,2963.055792,13.413405318888326,137,2.800000000000001E-4
9,test_20231101_140314,11079715.png,443815,89749,354066,0.7977783535932765,3,4,124136,12651,111485,0.8980875813623768,19.09621511111111,2710.2879413333335,13.800649280417671,137,2.800000000000001E-4
10,test_20231101_140314,11551286.png,271883,124,271759,0.999543921466219,1,4,40092,16,40076,0.9996009178888556,18.13910577777778,1903.2464906666667,15.335853231830718,137,2.800000000000001E-4
1,test_20231101_140315,10404007.png,502730,10697,492033,0.9787221769140493,2,4,61265,1567,59698,0.974422590386028,26.92314488888889,3765.0911626666666,12.373048648029627,137,2.900000000000001E-4
2,test_20231101_140315,1254659.png,342646,51312,291334,0.850247777589699,2,4,80080,7252,72828,0.9094405594405595,24.177809777777778,4265.942901333333,11.830653226475647,137,2.900000000000001E-4
3,test_20231101_140315,10188041.png,221231,6697,214534,0.969728473857642,2,4,41731,948,40783,0.9772830749323045,12.756494222222223,1588.645056,16.12053485334449,137,2.900000000000001E-4
4,test_20231101_140315,10287332.png,216980,7742,209238,0.9643192921006545,2,4,22337,1063,21274,0.9524107982271567,11.905411555555556,1593.1080746666667,16.108351220163833,137,2.900000000000001E-4
5,test_20231101_140315,11610969.png,368720,10847,357873,0.9705820134519418,2,4,84111,1608,82503,0.9808824053928737,37.68496,6816.026848,9.79549068440944,137,2.900000000000001E-4
6,test_20231101_140315,10350842.png,212614,3087,209527,0.9854807303376071,2,4,42529,454,42075,0.9893249312234005,22.923879111111113,3262.133152,12.995786770028136,137,2.900000000000001E-4
7,test_20231101_140315,10863862.png,317432,5027,312405,0.9841635373875349,1,4,66058,739,65319,0.9888128614248085,40.246081777777775,7796.218885333334,9.211963370721508,137,2.900000000000001E-4
8,test_20231101_140315,11382381.png,312486,327,312159,0.9989535531191798,2,3,46745,44,46701,0.9990587228580596,23.441726222222222,2963.055792,13.413405318888326,137,2.900000000000001E-4
9,test_20231101_140315,11079715.png,443815,89749,354066,0.7977783535932765,3,4,124136,12651,111485,0.8980875813623768,19.09621511111111,2710.2879413333335,13.800649280417671,137,2.900000000000001E-4
10,test_20231101_140315,11551286.png,271883,124,271759,0.999543921466219,1,4,40092,16,40076,0.9996009178888556,18.13910577777778,1903.2464906666667,15.335853231830718,137,2.900000000000001E-4
1,test_20231101_140315,10404007.png,502730,10697,492033,0.9787221769140493,2,3,61265,1567,59698,0.974422590386028,26.92314488888889,3765.0911626666666,12.373048648029627,137,3.0000000000000014E-4
2,test_20231101_140315,1254659.png,342646,51312,291334,0.850247777589699,2,4,80080,7252,72828,0.9094405594405595,24.177809777777778,4265.942901333333,11.830653226475647,137,3.0000000000000014E-4
3,test_20231101_140315,10188041.png,221231,6697,214534,0.969728473857642,2,4,41731,948,40783,0.9772830749323045,12.756494222222223,1588.645056,16.12053485334449,137,3.0000000000000014E-4
4,test_20231101_140315,10287332.png,216980,7742,209238,0.9643192921006545,1,3,22337,1063,21274,0.9524107982271567,11.905411555555556,1593.1080746666667,16.108351220163833,137,3.0000000000000014E-4
5,test_20231101_140315,11610969.png,368720,10847,357873,0.9705820134519418,2,3,84111,1608,82503,0.9808824053928737,37.68496,6816.026848,9.79549068440944,137,3.0000000000000014E-4
6,test_20231101_140315,10350842.png,212614,3087,209527,0.9854807303376071,2,3,42529,454,42075,0.9893249312234005,22.923879111111113,3262.133152,12.995786770028136,137,3.0000000000000014E-4
7,test_20231101_140315,10863862.png,317432,5027,312405,0.9841635373875349,2,4,66058,739,65319,0.9888128614248085,40.246081777777775,7796.218885333334,9.211963370721508,137,3.0000000000000014E-4
8,test_20231101_140315,11382381.png,312486,327,312159,0.9989535531191798,1,3,46745,44,46701,0.9990587228580596,23.441726222222222,2963.055792,13.413405318888326,137,3.0000000000000014E-4
9,test_20231101_140315,11079715.png,443815,89749,354066,0.7977783535932765,3,4,124136,12651,111485,0.8980875813623768,19.09621511111111,2710.2879413333335,13.800649280417671,137,3.0000000000000014E-4
10,test_20231101_140315,11551286.png,271883,124,271759,0.999543921466219,1,3,40092,16,40076,0.9996009178888556,18.13910577777778,1903.2464906666667,15.335853231830718,137,3.0000000000000014E-4
1,test_20231101_140316,10404007.png,502730,10697,492033,0.9787221769140493,2,3,61265,1567,59698,0.974422590386028,26.92314488888889,3765.0911626666666,12.373048648029627,137,3.1000000000000016E-4
2,test_20231101_140316,1254659.png,342646,51312,291334,0.850247777589699,2,4,80080,7252,72828,0.9094405594405595,24.177809777777778,4265.942901333333,11.830653226475647,137,3.1000000000000016E-4
3,test_20231101_140316,10188041.png,221231,6697,214534,0.969728473857642,2,3,41731,948,40783,0.9772830749323045,12.756494222222223,1588.645056,16.12053485334449,137,3.1000000000000016E-4
4,test_20231101_140316,10287332.png,216980,7742,209238,0.9643192921006545,1,4,22337,1063,21274,0.9524107982271567,11.905411555555556,1593.1080746666667,16.108351220163833,137,3.1000000000000016E-4
5,test_20231101_140316,11610969.png,368720,10847,357873,0.9705820134519418,1,3,84111,1608,82503,0.9808824053928737,37.68496,6816.026848,9.79549068440944,137,3.1000000000000016E-4
6,test_20231101_140316,10350842.png,212614,3087,209527,0.9854807303376071,1,3,42529,454,42075,0.9893249312234005,22.923879111111113,3262.133152,12.995786770028136,137,3.1000000000000016E-4
7,test_20231101_140316,10863862.png,317432,5027,312405,0.9841635373875349,2,4,66058,739,65319,0.9888128614248085,40.246081777777775,7796.218885333334,9.211963370721508,137,3.1000000000000016E-4
8,test_20231101_140316,11382381.png,312486,327,312159,0.9989535531191798,2,3,46745,44,46701,0.9990587228580596,23.441726222222222,2963.055792,13.413405318888326,137,3.1000000000000016E-4
9,test_20231101_140316,11079715.png,443815,89749,354066,0.7977783535932765,3,11,124136,12651,111485,0.8980875813623768,19.09621511111111,2710.2879413333335,13.800649280417671,137,3.1000000000000016E-4
10,test_20231101_140316,11551286.png,271883,124,271759,0.999543921466219,1,4,40092,16,40076,0.9996009178888556,18.13910577777778,1903.2464906666667,15.335853231830718,137,3.1000000000000016E-4
1,test_20231101_140317,10404007.png,502730,10697,492033,0.9787221769140493,2,4,61265,1567,59698,0.974422590386028,26.92314488888889,3765.0911626666666,12.373048648029627,137,3.200000000000002E-4
2,test_20231101_140317,1254659.png,342646,51312,291334,0.850247777589699,3,4,80080,7252,72828,0.9094405594405595,24.177809777777778,4265.942901333333,11.830653226475647,137,3.200000000000002E-4
3,test_20231101_140317,10188041.png,221231,6697,214534,0.969728473857642,2,13,41731,948,40783,0.9772830749323045,12.756494222222223,1588.645056,16.12053485334449,137,3.200000000000002E-4
4,test_20231101_140317,10287332.png,216980,7742,209238,0.9643192921006545,2,3,22337,1063,21274,0.9524107982271567,11.905411555555556,1593.1080746666667,16.108351220163833,137,3.200000000000002E-4
5,test_20231101_140317,11610969.png,368720,10847,357873,0.9705820134519418,2,3,84111,1608,82503,0.9808824053928737,37.68496,6816.026848,9.79549068440944,137,3.200000000000002E-4
6,test_20231101_140317,10350842.png,212614,3087,209527,0.9854807303376071,1,4,42529,454,42075,0.9893249312234005,22.923879111111113,3262.133152,12.995786770028136,137,3.200000000000002E-4
7,test_20231101_140317,10863862.png,317432,5027,312405,0.9841635373875349,2,3,66058,739,65319,0.9888128614248085,40.246081777777775,7796.218885333334,9.211963370721508,137,3.200000000000002E-4
8,test_20231101_140317,11382381.png,312486,327,312159,0.9989535531191798,1,4,46745,44,46701,0.9990587228580596,23.441726222222222,2963.055792,13.413405318888326,137,3.200000000000002E-4
9,test_20231101_140317,11079715.png,443815,89749,354066,0.7977783535932765,3,4,124136,12651,111485,0.8980875813623768,19.09621511111111,2710.2879413333335,13.800649280417671,137,3.200000000000002E-4
10,test_20231101_140317,11551286.png,271883,124,271759,0.999543921466219,1,3,40092,16,40076,0.9996009178888556,18.13910577777778,1903.2464906666667,15.335853231830718,137,3.200000000000002E-4
1,test_20231101_140317,10404007.png,502730,10697,492033,0.9787221769140493,2,4,61265,1567,59698,0.974422590386028,26.92314488888889,3765.0911626666666,12.373048648029627,137,3.300000000000002E-4
2,test_20231101_140317,1254659.png,342646,51312,291334,0.850247777589699,2,4,80080,7252,72828,0.9094405594405595,24.177809777777778,4265.942901333333,11.830653226475647,137,3.300000000000002E-4
3,test_20231101_140317,10188041.png,221231,6697,214534,0.969728473857642,1,3,41731,948,40783,0.9772830749323045,12.756494222222223,1588.645056,16.12053485334449,137,3.300000000000002E-4
4,test_20231101_140317,10287332.png,216980,7742,209238,0.9643192921006545,2,4,22337,1063,21274,0.9524107982271567,11.905411555555556,1593.1080746666667,16.108351220163833,137,3.300000000000002E-4
5,test_20231101_140317,11610969.png,368720,10847,357873,0.9705820134519418,1,4,84111,1608,82503,0.9808824053928737,37.68496,6816.026848,9.79549068440944,137,3.300000000000002E-4
6,test_20231101_140317,10350842.png,212614,3087,209527,0.9854807303376071,2,4,42529,454,42075,0.9893249312234005,22.923879111111113,3262.133152,12.995786770028136,137,3.300000000000002E-4
7,test_20231101_140317,10863862.png,317432,5027,312405,0.9841635373875349,2,4,66058,739,65319,0.9888128614248085,40.246081777777775,7796.218885333334,9.211963370721508,137,3.300000000000002E-4
8,test_20231101_140317,11382381.png,312486,327,312159,0.9989535531191798,1,3,46745,44,46701,0.9990587228580596,23.441726222222222,2963.055792,13.413405318888326,137,3.300000000000002E-4
9,test_20231101_140317,11079715.png,443815,89749,354066,0.7977783535932765,3,4,124136,12651,111485,0.8980875813623768,19.09621511111111,2710.2879413333335,13.800649280417671,137,3.300000000000002E-4
10,test_20231101_140317,11551286.png,271883,124,271759,0.999543921466219,1,4,40092,16,40076,0.9996009178888556,18.13910577777778,1903.2464906666667,15.335853231830718,137,3.300000000000002E-4
1,test_20231101_140318,10404007.png,502730,10697,492033,0.9787221769140493,2,4,61265,1567,59698,0.974422590386028,26.92314488888889,3765.0911626666666,12.373048648029627,137,3.4000000000000024E-4
2,test_20231101_140318,1254659.png,342646,51312,291334,0.850247777589699,2,4,80080,7252,72828,0.9094405594405595,24.177809777777778,4265.942901333333,11.830653226475647,137,3.4000000000000024E-4
3,test_20231101_140318,10188041.png,221231,6697,214534,0.969728473857642,2,4,41731,948,40783,0.9772830749323045,12.756494222222223,1588.645056,16.12053485334449,137,3.4000000000000024E-4
4,test_20231101_140318,10287332.png,216980,7742,209238,0.9643192921006545,1,3,22337,1063,21274,0.9524107982271567,11.905411555555556,1593.1080746666667,16.108351220163833,137,3.4000000000000024E-4
5,test_20231101_140318,11610969.png,368720,10847,357873,0.9705820134519418,2,4,84111,1608,82503,0.9808824053928737,37.68496,6816.026848,9.79549068440944,137,3.4000000000000024E-4
6,test_20231101_140318,10350842.png,212614,3087,209527,0.9854807303376071,2,4,42529,454,42075,0.9893249312234005,22.923879111111113,3262.133152,12.995786770028136,137,3.4000000000000024E-4
7,test_20231101_140318,10863862.png,317432,5027,312405,0.9841635373875349,2,5,66058,739,65319,0.9888128614248085,40.246081777777775,7796.218885333334,9.211963370721508,137,3.4000000000000024E-4
8,test_20231101_140318,11382381.png,312486,327,312159,0.9989535531191798,2,3,46745,44,46701,0.9990587228580596,23.441726222222222,2963.055792,13.413405318888326,137,3.4000000000000024E-4
9,test_20231101_140318,11079715.png,443815,89749,354066,0.7977783535932765,3,4,124136,12651,111485,0.8980875813623768,19.09621511111111,2710.2879413333335,13.800649280417671,137,3.4000000000000024E-4
10,test_20231101_140318,11551286.png,271883,124,271759,0.999543921466219,1,4,40092,16,40076,0.9996009178888556,18.13910577777778,1903.2464906666667,15.335853231830718,137,3.4000000000000024E-4
1,test_20231101_140319,10404007.png,502730,10697,492033,0.9787221769140493,2,4,61265,1567,59698,0.974422590386028,26.92314488888889,3765.0911626666666,12.373048648029627,137,3.5000000000000027E-4
2,test_20231101_140319,1254659.png,342646,51312,291334,0.850247777589699,3,4,80080,7252,72828,0.9094405594405595,24.177809777777778,4265.942901333333,11.830653226475647,137,3.5000000000000027E-4
3,test_20231101_140319,10188041.png,221231,6697,214534,0.969728473857642,2,4,41731,948,40783,0.9772830749323045,12.756494222222223,1588.645056,16.12053485334449,137,3.5000000000000027E-4
4,test_20231101_140319,10287332.png,216980,7742,209238,0.9643192921006545,1,3,22337,1063,21274,0.9524107982271567,11.905411555555556,1593.1080746666667,16.108351220163833,137,3.5000000000000027E-4
5,test_20231101_140319,11610969.png,368720,10847,357873,0.9705820134519418,2,3,84111,1608,82503,0.9808824053928737,37.68496,6816.026848,9.79549068440944,137,3.5000000000000027E-4
6,test_20231101_140319,10350842.png,212614,3087,209527,0.9854807303376071,1,4,42529,454,42075,0.9893249312234005,22.923879111111113,3262.133152,12.995786770028136,137,3.5000000000000027E-4
7,test_20231101_140319,10863862.png,317432,5027,312405,0.9841635373875349,1,3,66058,739,65319,0.9888128614248085,40.246081777777775,7796.218885333334,9.211963370721508,137,3.5000000000000027E-4
8,test_20231101_140319,11382381.png,312486,327,312159,0.9989535531191798,1,3,46745,44,46701,0.9990587228580596,23.441726222222222,2963.055792,13.413405318888326,137,3.5000000000000027E-4
9,test_20231101_140319,11079715.png,443815,89749,354066,0.7977783535932765,3,4,124136,12651,111485,0.8980875813623768,19.09621511111111,2710.2879413333335,13.800649280417671,137,3.5000000000000027E-4
10,test_20231101_140319,11551286.png,271883,124,271759,0.999543921466219,1,4,40092,16,40076,0.9996009178888556,18.13910577777778,1903.2464906666667,15.335853231830718,137,3.5000000000000027E-4
1,test_20231101_140319,10404007.png,502730,10697,492033,0.9787221769140493,2,4,61265,1567,59698,0.974422590386028,26.92314488888889,3765.0911626666666,12.373048648029627,137,3.600000000000003E-4
2,test_20231101_140319,1254659.png,342646,51312,291334,0.850247777589699,3,4,80080,7252,72828,0.9094405594405595,24.177809777777778,4265.942901333333,11.830653226475647,137,3.600000000000003E-4
3,test_20231101_140319,10188041.png,221231,6697,214534,0.969728473857642,2,3,41731,948,40783,0.9772830749323045,12.756494222222223,1588.645056,16.12053485334449,137,3.600000000000003E-4
4,test_20231101_140319,10287332.png,216980,7742,209238,0.9643192921006545,1,3,22337,1063,21274,0.9524107982271567,11.905411555555556,1593.1080746666667,16.108351220163833,137,3.600000000000003E-4
5,test_20231101_140319,11610969.png,368720,10847,357873,0.9705820134519418,2,4,84111,1608,82503,0.9808824053928737,37.68496,6816.026848,9.79549068440944,137,3.600000000000003E-4
6,test_20231101_140319,10350842.png,212614,3087,209527,0.9854807303376071,2,3,42529,454,42075,0.9893249312234005,22.923879111111113,3262.133152,12.995786770028136,137,3.600000000000003E-4
7,test_20231101_140319,10863862.png,317432,5027,312405,0.9841635373875349,1,4,66058,739,65319,0.9888128614248085,40.246081777777775,7796.218885333334,9.211963370721508,137,3.600000000000003E-4
8,test_20231101_140319,11382381.png,312486,327,312159,0.9989535531191798,1,4,46745,44,46701,0.9990587228580596,23.441726222222222,2963.055792,13.413405318888326,137,3.600000000000003E-4
9,test_20231101_140319,11079715.png,443815,89749,354066,0.7977783535932765,3,4,124136,12651,111485,0.8980875813623768,19.09621511111111,2710.2879413333335,13.800649280417671,137,3.600000000000003E-4
10,test_20231101_140319,11551286.png,271883,124,271759,0.999543921466219,1,4,40092,16,40076,0.9996009178888556,18.13910577777778,1903.2464906666667,15.335853231830718,137,3.600000000000003E-4
1,test_20231101_140320,10404007.png,502730,10697,492033,0.9787221769140493,2,3,61265,1567,59698,0.974422590386028,26.92314488888889,3765.0911626666666,12.373048648029627,137,3.700000000000003E-4
2,test_20231101_140320,1254659.png,342646,51312,291334,0.850247777589699,3,5,80080,7252,72828,0.9094405594405595,24.177809777777778,4265.942901333333,11.830653226475647,137,3.700000000000003E-4
3,test_20231101_140320,10188041.png,221231,6697,214534,0.969728473857642,2,3,41731,948,40783,0.9772830749323045,12.756494222222223,1588.645056,16.12053485334449,137,3.700000000000003E-4
4,test_20231101_140320,10287332.png,216980,7742,209238,0.9643192921006545,1,4,22337,1063,21274,0.9524107982271567,11.905411555555556,1593.1080746666667,16.108351220163833,137,3.700000000000003E-4
5,test_20231101_140320,11610969.png,368720,10847,357873,0.9705820134519418,2,4,84111,1608,82503,0.9808824053928737,37.68496,6816.026848,9.79549068440944,137,3.700000000000003E-4
6,test_20231101_140320,10350842.png,212614,3087,209527,0.9854807303376071,1,3,42529,454,42075,0.9893249312234005,22.923879111111113,3262.133152,12.995786770028136,137,3.700000000000003E-4
7,test_20231101_140320,10863862.png,317432,5027,312405,0.9841635373875349,2,4,66058,739,65319,0.9888128614248085,40.246081777777775,7796.218885333334,9.211963370721508,137,3.700000000000003E-4
8,test_20231101_140320,11382381.png,312486,327,312159,0.9989535531191798,1,3,46745,44,46701,0.9990587228580596,23.441726222222222,2963.055792,13.413405318888326,137,3.700000000000003E-4
9,test_20231101_140320,11079715.png,443815,89749,354066,0.7977783535932765,3,4,124136,12651,111485,0.8980875813623768,19.09621511111111,2710.2879413333335,13.800649280417671,137,3.700000000000003E-4
10,test_20231101_140320,11551286.png,271883,124,271759,0.999543921466219,1,4,40092,16,40076,0.9996009178888556,18.13910577777778,1903.2464906666667,15.335853231830718,137,3.700000000000003E-4
1,test_20231101_140321,10404007.png,502730,10697,492033,0.9787221769140493,2,4,61265,1567,59698,0.974422590386028,26.92314488888889,3765.0911626666666,12.373048648029627,137,3.8000000000000035E-4
2,test_20231101_140321,1254659.png,342646,51312,291334,0.850247777589699,3,5,80080,7252,72828,0.9094405594405595,24.177809777777778,4265.942901333333,11.830653226475647,137,3.8000000000000035E-4
3,test_20231101_140321,10188041.png,221231,6697,214534,0.969728473857642,2,4,41731,948,40783,0.9772830749323045,12.756494222222223,1588.645056,16.12053485334449,137,3.8000000000000035E-4
4,test_20231101_140321,10287332.png,216980,7742,209238,0.9643192921006545,1,5,22337,1063,21274,0.9524107982271567,11.905411555555556,1593.1080746666667,16.108351220163833,137,3.8000000000000035E-4
5,test_20231101_140321,11610969.png,368720,10847,357873,0.9705820134519418,3,4,84111,1608,82503,0.9808824053928737,37.68496,6816.026848,9.79549068440944,137,3.8000000000000035E-4
6,test_20231101_140321,10350842.png,212614,3087,209527,0.9854807303376071,1,4,42529,454,42075,0.9893249312234005,22.923879111111113,3262.133152,12.995786770028136,137,3.8000000000000035E-4
7,test_20231101_140321,10863862.png,317432,5027,312405,0.9841635373875349,2,4,66058,739,65319,0.9888128614248085,40.246081777777775,7796.218885333334,9.211963370721508,137,3.8000000000000035E-4
8,test_20231101_140321,11382381.png,312486,327,312159,0.9989535531191798,1,4,46745,44,46701,0.9990587228580596,23.441726222222222,2963.055792,13.413405318888326,137,3.8000000000000035E-4
9,test_20231101_140321,11079715.png,443815,89749,354066,0.7977783535932765,4,4,124136,12651,111485,0.8980875813623768,19.09621511111111,2710.2879413333335,13.800649280417671,137,3.8000000000000035E-4
10,test_20231101_140321,11551286.png,271883,124,271759,0.999543921466219,1,4,40092,16,40076,0.9996009178888556,18.13910577777778,1903.2464906666667,15.335853231830718,137,3.8000000000000035E-4
1,test_20231101_140322,10404007.png,502730,10697,492033,0.9787221769140493,2,4,61265,1567,59698,0.974422590386028,26.92314488888889,3765.0911626666666,12.373048648029627,137,3.9000000000000037E-4
2,test_20231101_140322,1254659.png,342646,51312,291334,0.850247777589699,3,3,80080,7252,72828,0.9094405594405595,24.177809777777778,4265.942901333333,11.830653226475647,137,3.9000000000000037E-4
3,test_20231101_140322,10188041.png,221231,6697,214534,0.969728473857642,2,4,41731,948,40783,0.9772830749323045,12.756494222222223,1588.645056,16.12053485334449,137,3.9000000000000037E-4
4,test_20231101_140322,10287332.png,216980,7742,209238,0.9643192921006545,2,3,22337,1063,21274,0.9524107982271567,11.905411555555556,1593.1080746666667,16.108351220163833,137,3.9000000000000037E-4
5,test_20231101_140322,11610969.png,368720,10847,357873,0.9705820134519418,2,4,84111,1608,82503,0.9808824053928737,37.68496,6816.026848,9.79549068440944,137,3.9000000000000037E-4
6,test_20231101_140322,10350842.png,212614,3087,209527,0.9854807303376071,1,3,42529,454,42075,0.9893249312234005,22.923879111111113,3262.133152,12.995786770028136,137,3.9000000000000037E-4
7,test_20231101_140322,10863862.png,317432,4807,312625,0.9848565992086494,1,3,66058,706,65352,0.9893124224166642,40.71794311111111,7913.072912,9.14735193480679,137,3.9000000000000037E-4
8,test_20231101_140322,11382381.png,312486,327,312159,0.9989535531191798,1,3,46745,44,46701,0.9990587228580596,23.441726222222222,2963.055792,13.413405318888326,137,3.9000000000000037E-4
9,test_20231101_140322,11079715.png,443815,89749,354066,0.7977783535932765,3,4,124136,12651,111485,0.8980875813623768,19.09621511111111,2710.2879413333335,13.800649280417671,137,3.9000000000000037E-4
10,test_20231101_140322,11551286.png,271883,124,271759,0.999543921466219,2,3,40092,16,40076,0.9996009178888556,18.13910577777778,1903.2464906666667,15.335853231830718,137,3.9000000000000037E-4
1,test_20231101_140322,10404007.png,502730,10697,492033,0.9787221769140493,2,4,61265,1567,59698,0.974422590386028,26.92314488888889,3765.0911626666666,12.373048648029627,137,4.000000000000004E-4
2,test_20231101_140322,1254659.png,342646,51312,291334,0.850247777589699,3,4,80080,7252,72828,0.9094405594405595,24.177809777777778,4265.942901333333,11.830653226475647,137,4.000000000000004E-4
3,test_20231101_140322,10188041.png,221231,6697,214534,0.969728473857642,2,3,41731,948,40783,0.9772830749323045,12.756494222222223,1588.645056,16.12053485334449,137,4.000000000000004E-4
4,test_20231101_140322,10287332.png,216980,7742,209238,0.9643192921006545,1,4,22337,1063,21274,0.9524107982271567,11.905411555555556,1593.1080746666667,16.108351220163833,137,4.000000000000004E-4
5,test_20231101_140322,11610969.png,368720,10847,357873,0.9705820134519418,1,4,84111,1608,82503,0.9808824053928737,37.68496,6816.026848,9.79549068440944,137,4.000000000000004E-4
6,test_20231101_140322,10350842.png,212614,3087,209527,0.9854807303376071,2,3,42529,454,42075,0.9893249312234005,22.923879111111113,3262.133152,12.995786770028136,137,4.000000000000004E-4
7,test_20231101_140322,10863862.png,317432,4807,312625,0.9848565992086494,1,4,66058,706,65352,0.9893124224166642,40.71794311111111,7913.072912,9.14735193480679,137,4.000000000000004E-4
8,test_20231101_140322,11382381.png,312486,327,312159,0.9989535531191798,2,3,46745,44,46701,0.9990587228580596,23.441726222222222,2963.055792,13.413405318888326,137,4.000000000000004E-4
9,test_20231101_140322,11079715.png,443815,89749,354066,0.7977783535932765,3,4,124136,12651,111485,0.8980875813623768,19.09621511111111,2710.2879413333335,13.800649280417671,137,4.000000000000004E-4
10,test_20231101_140322,11551286.png,271883,124,271759,0.999543921466219,1,4,40092,16,40076,0.9996009178888556,18.13910577777778,1903.2464906666667,15.335853231830718,137,4.000000000000004E-4
1,test_20231101_140323,10404007.png,502730,10697,492033,0.9787221769140493,2,4,61265,1567,59698,0.974422590386028,26.92314488888889,3765.0911626666666,12.373048648029627,137,4.100000000000004E-4
2,test_20231101_140323,1254659.png,342646,51312,291334,0.850247777589699,3,3,80080,7252,72828,0.9094405594405595,24.177809777777778,4265.942901333333,11.830653226475647,137,4.100000000000004E-4
3,test_20231101_140323,10188041.png,221231,6697,214534,0.969728473857642,2,3,41731,948,40783,0.9772830749323045,12.756494222222223,1588.645056,16.12053485334449,137,4.100000000000004E-4
4,test_20231101_140323,10287332.png,216980,7742,209238,0.9643192921006545,2,4,22337,1063,21274,0.9524107982271567,11.905411555555556,1593.1080746666667,16.108351220163833,137,4.100000000000004E-4
5,test_20231101_140323,11610969.png,368720,10847,357873,0.9705820134519418,1,3,84111,1608,82503,0.9808824053928737,37.68496,6816.026848,9.79549068440944,137,4.100000000000004E-4
6,test_20231101_140323,10350842.png,212614,3087,209527,0.9854807303376071,1,4,42529,454,42075,0.9893249312234005,22.923879111111113,3262.133152,12.995786770028136,137,4.100000000000004E-4
7,test_20231101_140323,10863862.png,317432,4807,312625,0.9848565992086494,2,4,66058,706,65352,0.9893124224166642,40.71794311111111,7913.072912,9.14735193480679,137,4.100000000000004E-4
8,test_20231101_140323,11382381.png,312486,327,312159,0.9989535531191798,2,3,46745,44,46701,0.9990587228580596,23.441726222222222,2963.055792,13.413405318888326,137,4.100000000000004E-4
9,test_20231101_140323,11079715.png,443815,89749,354066,0.7977783535932765,4,4,124136,12651,111485,0.8980875813623768,19.09621511111111,2710.2879413333335,13.800649280417671,137,4.100000000000004E-4
10,test_20231101_140323,11551286.png,271883,124,271759,0.999543921466219,1,4,40092,16,40076,0.9996009178888556,18.13910577777778,1903.2464906666667,15.335853231830718,137,4.100000000000004E-4
1,test_20231101_140324,10404007.png,502730,10697,492033,0.9787221769140493,2,4,61265,1567,59698,0.974422590386028,26.92314488888889,3765.0911626666666,12.373048648029627,137,4.2000000000000045E-4
2,test_20231101_140324,1254659.png,342646,51312,291334,0.850247777589699,2,4,80080,7252,72828,0.9094405594405595,24.177809777777778,4265.942901333333,11.830653226475647,137,4.2000000000000045E-4
3,test_20231101_140324,10188041.png,221231,6697,214534,0.969728473857642,2,4,41731,948,40783,0.9772830749323045,12.756494222222223,1588.645056,16.12053485334449,137,4.2000000000000045E-4
4,test_20231101_140324,10287332.png,216980,7742,209238,0.9643192921006545,2,4,22337,1063,21274,0.9524107982271567,11.905411555555556,1593.1080746666667,16.108351220163833,137,4.2000000000000045E-4
5,test_20231101_140324,11610969.png,368720,10847,357873,0.9705820134519418,2,3,84111,1608,82503,0.9808824053928737,37.68496,6816.026848,9.79549068440944,137,4.2000000000000045E-4
6,test_20231101_140324,10350842.png,212614,3087,209527,0.9854807303376071,1,4,42529,454,42075,0.9893249312234005,22.923879111111113,3262.133152,12.995786770028136,137,4.2000000000000045E-4
7,test_20231101_140324,10863862.png,317432,4807,312625,0.9848565992086494,1,3,66058,706,65352,0.9893124224166642,40.71794311111111,7913.072912,9.14735193480679,137,4.2000000000000045E-4
8,test_20231101_140324,11382381.png,312486,327,312159,0.9989535531191798,1,4,46745,44,46701,0.9990587228580596,23.441726222222222,2963.055792,13.413405318888326,137,4.2000000000000045E-4
9,test_20231101_140324,11079715.png,443815,89749,354066,0.7977783535932765,3,4,124136,12651,111485,0.8980875813623768,19.09621511111111,2710.2879413333335,13.800649280417671,137,4.2000000000000045E-4
10,test_20231101_140324,11551286.png,271883,124,271759,0.999543921466219,2,4,40092,16,40076,0.9996009178888556,18.13910577777778,1903.2464906666667,15.335853231830718,137,4.2000000000000045E-4
1,test_20231101_140324,10404007.png,502730,10697,492033,0.9787221769140493,2,3,61265,1567,59698,0.974422590386028,26.92314488888889,3765.0911626666666,12.373048648029627,137,4.300000000000005E-4
2,test_20231101_140324,1254659.png,342646,51312,291334,0.850247777589699,4,4,80080,7252,72828,0.9094405594405595,24.177809777777778,4265.942901333333,11.830653226475647,137,4.300000000000005E-4
3,test_20231101_140324,10188041.png,221231,6697,214534,0.969728473857642,2,4,41731,948,40783,0.9772830749323045,12.756494222222223,1588.645056,16.12053485334449,137,4.300000000000005E-4
4,test_20231101_140324,10287332.png,216980,7742,209238,0.9643192921006545,2,4,22337,1063,21274,0.9524107982271567,11.905411555555556,1593.1080746666667,16.108351220163833,137,4.300000000000005E-4
5,test_20231101_140324,11610969.png,368720,10847,357873,0.9705820134519418,2,4,84111,1608,82503,0.9808824053928737,37.68496,6816.026848,9.79549068440944,137,4.300000000000005E-4
6,test_20231101_140324,10350842.png,212614,3087,209527,0.9854807303376071,2,4,42529,454,42075,0.9893249312234005,22.923879111111113,3262.133152,12.995786770028136,137,4.300000000000005E-4
7,test_20231101_140324,10863862.png,317432,4807,312625,0.9848565992086494,2,4,66058,706,65352,0.9893124224166642,40.71794311111111,7913.072912,9.14735193480679,137,4.300000000000005E-4
8,test_20231101_140324,11382381.png,312486,327,312159,0.9989535531191798,1,4,46745,44,46701,0.9990587228580596,23.441726222222222,2963.055792,13.413405318888326,137,4.300000000000005E-4
9,test_20231101_140324,11079715.png,443815,89749,354066,0.7977783535932765,3,4,124136,12651,111485,0.8980875813623768,19.09621511111111,2710.2879413333335,13.800649280417671,137,4.300000000000005E-4
10,test_20231101_140324,11551286.png,271883,124,271759,0.999543921466219,2,4,40092,16,40076,0.9996009178888556,18.13910577777778,1903.2464906666667,15.335853231830718,137,4.300000000000005E-4
1,test_20231101_140325,10404007.png,502730,10697,492033,0.9787221769140493,2,3,61265,1567,59698,0.974422590386028,26.92314488888889,3765.0911626666666,12.373048648029627,137,4.400000000000005E-4
2,test_20231101_140325,1254659.png,342646,51312,291334,0.850247777589699,3,4,80080,7252,72828,0.9094405594405595,24.177809777777778,4265.942901333333,11.830653226475647,137,4.400000000000005E-4
3,test_20231101_140325,10188041.png,221231,6697,214534,0.969728473857642,1,3,41731,948,40783,0.9772830749323045,12.756494222222223,1588.645056,16.12053485334449,137,4.400000000000005E-4
4,test_20231101_140325,10287332.png,216980,7742,209238,0.9643192921006545,1,9,22337,1063,21274,0.9524107982271567,11.905411555555556,1593.1080746666667,16.108351220163833,137,4.400000000000005E-4
5,test_20231101_140325,11610969.png,368720,10847,357873,0.9705820134519418,1,3,84111,1608,82503,0.9808824053928737,37.68496,6816.026848,9.79549068440944,137,4.400000000000005E-4
6,test_20231101_140325,10350842.png,212614,3087,209527,0.9854807303376071,2,4,42529,454,42075,0.9893249312234005,22.923879111111113,3262.133152,12.995786770028136,137,4.400000000000005E-4
7,test_20231101_140325,10863862.png,317432,4807,312625,0.9848565992086494,2,3,66058,706,65352,0.9893124224166642,40.71794311111111,7913.072912,9.14735193480679,137,4.400000000000005E-4
8,test_20231101_140325,11382381.png,312486,327,312159,0.9989535531191798,1,4,46745,44,46701,0.9990587228580596,23.441726222222222,2963.055792,13.413405318888326,137,4.400000000000005E-4
9,test_20231101_140325,11079715.png,443815,89749,354066,0.7977783535932765,5,4,124136,12651,111485,0.8980875813623768,19.09621511111111,2710.2879413333335,13.800649280417671,137,4.400000000000005E-4
10,test_20231101_140325,11551286.png,271883,124,271759,0.999543921466219,1,4,40092,16,40076,0.9996009178888556,18.13910577777778,1903.2464906666667,15.335853231830718,137,4.400000000000005E-4
1,test_20231101_140326,10404007.png,502730,10577,492153,0.9789608736299803,2,4,61265,1549,59716,0.9747163959846569,26.93784711111111,3768.7499573333334,12.368830363004065,137,4.5000000000000053E-4
2,test_20231101_140326,1254659.png,342646,51312,291334,0.850247777589699,2,4,80080,7252,72828,0.9094405594405595,24.177809777777778,4265.942901333333,11.830653226475647,137,4.5000000000000053E-4
3,test_20231101_140326,10188041.png,221231,6697,214534,0.969728473857642,2,4,41731,948,40783,0.9772830749323045,12.756494222222223,1588.645056,16.12053485334449,137,4.5000000000000053E-4
4,test_20231101_140326,10287332.png,216980,7742,209238,0.9643192921006545,2,3,22337,1063,21274,0.9524107982271567,11.905411555555556,1593.1080746666667,16.108351220163833,137,4.5000000000000053E-4
5,test_20231101_140326,11610969.png,368720,10847,357873,0.9705820134519418,1,4,84111,1608,82503,0.9808824053928737,37.68496,6816.026848,9.79549068440944,137,4.5000000000000053E-4
6,test_20231101_140326,10350842.png,212614,2427,210187,0.9885849473694113,1,3,42529,356,42173,0.9916292412236356,25.651312,3921.524976,12.196253755127639,137,4.5000000000000053E-4
7,test_20231101_140326,10863862.png,317432,4807,312625,0.9848565992086494,1,4,66058,706,65352,0.9893124224166642,40.71794311111111,7913.072912,9.14735193480679,137,4.5000000000000053E-4
8,test_20231101_140326,11382381.png,312486,327,312159,0.9989535531191798,1,3,46745,44,46701,0.9990587228580596,23.441726222222222,2963.055792,13.413405318888326,137,4.5000000000000053E-4
9,test_20231101_140326,11079715.png,443815,89749,354066,0.7977783535932765,4,4,124136,12651,111485,0.8980875813623768,19.09621511111111,2710.2879413333335,13.800649280417671,137,4.5000000000000053E-4
10,test_20231101_140326,11551286.png,271883,124,271759,0.999543921466219,1,4,40092,16,40076,0.9996009178888556,18.13910577777778,1903.2464906666667,15.335853231830718,137,4.5000000000000053E-4
1,test_20231101_140326,10404007.png,502730,10577,492153,0.9789608736299803,2,3,61265,1549,59716,0.9747163959846569,26.93784711111111,3768.7499573333334,12.368830363004065,137,4.6000000000000056E-4
2,test_20231101_140326,1254659.png,342646,51312,291334,0.850247777589699,3,4,80080,7252,72828,0.9094405594405595,24.177809777777778,4265.942901333333,11.830653226475647,137,4.6000000000000056E-4
3,test_20231101_140326,10188041.png,221231,6697,214534,0.969728473857642,3,3,41731,948,40783,0.9772830749323045,12.756494222222223,1588.645056,16.12053485334449,137,4.6000000000000056E-4
4,test_20231101_140326,10287332.png,216980,7742,209238,0.9643192921006545,1,3,22337,1063,21274,0.9524107982271567,11.905411555555556,1593.1080746666667,16.108351220163833,137,4.6000000000000056E-4
5,test_20231101_140326,11610969.png,368720,10847,357873,0.9705820134519418,1,3,84111,1608,82503,0.9808824053928737,37.68496,6816.026848,9.79549068440944,137,4.6000000000000056E-4
6,test_20231101_140326,10350842.png,212614,2427,210187,0.9885849473694113,2,4,42529,356,42173,0.9916292412236356,25.651312,3921.524976,12.196253755127639,137,4.6000000000000056E-4
7,test_20231101_140326,10863862.png,317432,4807,312625,0.9848565992086494,1,4,66058,706,65352,0.9893124224166642,40.71794311111111,7913.072912,9.14735193480679,137,4.6000000000000056E-4
8,test_20231101_140326,11382381.png,312486,327,312159,0.9989535531191798,1,4,46745,44,46701,0.9990587228580596,23.441726222222222,2963.055792,13.413405318888326,137,4.6000000000000056E-4
9,test_20231101_140326,11079715.png,443815,89749,354066,0.7977783535932765,3,4,124136,12651,111485,0.8980875813623768,19.09621511111111,2710.2879413333335,13.800649280417671,137,4.6000000000000056E-4
10,test_20231101_140326,11551286.png,271883,124,271759,0.999543921466219,1,3,40092,16,40076,0.9996009178888556,18.13910577777778,1903.2464906666667,15.335853231830718,137,4.6000000000000056E-4
1,test_20231101_140327,10404007.png,502730,10577,492153,0.9789608736299803,2,4,61265,1549,59716,0.9747163959846569,26.93784711111111,3768.7499573333334,12.368830363004065,137,4.700000000000006E-4
2,test_20231101_140327,1254659.png,342646,51312,291334,0.850247777589699,3,4,80080,7252,72828,0.9094405594405595,24.177809777777778,4265.942901333333,11.830653226475647,137,4.700000000000006E-4
3,test_20231101_140327,10188041.png,221231,6697,214534,0.969728473857642,2,4,41731,948,40783,0.9772830749323045,12.756494222222223,1588.645056,16.12053485334449,137,4.700000000000006E-4
4,test_20231101_140327,10287332.png,216980,7742,209238,0.9643192921006545,4,4,22337,1063,21274,0.9524107982271567,11.905411555555556,1593.1080746666667,16.108351220163833,137,4.700000000000006E-4
5,test_20231101_140327,11610969.png,368720,10847,357873,0.9705820134519418,1,4,84111,1608,82503,0.9808824053928737,37.68496,6816.026848,9.79549068440944,137,4.700000000000006E-4
6,test_20231101_140327,10350842.png,212614,2427,210187,0.9885849473694113,1,3,42529,356,42173,0.9916292412236356,25.651312,3921.524976,12.196253755127639,137,4.700000000000006E-4
7,test_20231101_140327,10863862.png,317432,4807,312625,0.9848565992086494,2,8,66058,706,65352,0.9893124224166642,40.71794311111111,7913.072912,9.14735193480679,137,4.700000000000006E-4
8,test_20231101_140327,11382381.png,312486,327,312159,0.9989535531191798,1,4,46745,44,46701,0.9990587228580596,23.441726222222222,2963.055792,13.413405318888326,137,4.700000000000006E-4
9,test_20231101_140327,11079715.png,443815,89749,354066,0.7977783535932765,3,5,124136,12651,111485,0.8980875813623768,19.09621511111111,2710.2879413333335,13.800649280417671,137,4.700000000000006E-4
10,test_20231101_140327,11551286.png,271883,124,271759,0.999543921466219,2,3,40092,16,40076,0.9996009178888556,18.13910577777778,1903.2464906666667,15.335853231830718,137,4.700000000000006E-4
1,test_20231101_140328,10404007.png,502730,10577,492153,0.9789608736299803,2,4,61265,1549,59716,0.9747163959846569,26.93784711111111,3768.7499573333334,12.368830363004065,137,4.800000000000006E-4
2,test_20231101_140328,1254659.png,342646,51312,291334,0.850247777589699,3,4,80080,7252,72828,0.9094405594405595,24.177809777777778,4265.942901333333,11.830653226475647,137,4.800000000000006E-4
3,test_20231101_140328,10188041.png,221231,6697,214534,0.969728473857642,2,4,41731,948,40783,0.9772830749323045,12.756494222222223,1588.645056,16.12053485334449,137,4.800000000000006E-4
4,test_20231101_140328,10287332.png,216980,7742,209238,0.9643192921006545,2,4,22337,1063,21274,0.9524107982271567,11.905411555555556,1593.1080746666667,16.108351220163833,137,4.800000000000006E-4
5,test_20231101_140328,11610969.png,368720,10847,357873,0.9705820134519418,2,4,84111,1608,82503,0.9808824053928737,37.68496,6816.026848,9.79549068440944,137,4.800000000000006E-4
6,test_20231101_140328,10350842.png,212614,2427,210187,0.9885849473694113,2,3,42529,356,42173,0.9916292412236356,25.651312,3921.524976,12.196253755127639,137,4.800000000000006E-4
7,test_20231101_140328,10863862.png,317432,4807,312625,0.9848565992086494,2,3,66058,706,65352,0.9893124224166642,40.71794311111111,7913.072912,9.14735193480679,137,4.800000000000006E-4
8,test_20231101_140328,11382381.png,312486,327,312159,0.9989535531191798,1,3,46745,44,46701,0.9990587228580596,23.441726222222222,2963.055792,13.413405318888326,137,4.800000000000006E-4
9,test_20231101_140328,11079715.png,443815,89749,354066,0.7977783535932765,3,4,124136,12651,111485,0.8980875813623768,19.09621511111111,2710.2879413333335,13.800649280417671,137,4.800000000000006E-4
10,test_20231101_140328,11551286.png,271883,124,271759,0.999543921466219,2,3,40092,16,40076,0.9996009178888556,18.13910577777778,1903.2464906666667,15.335853231830718,137,4.800000000000006E-4
1,test_20231101_140328,10404007.png,502730,10577,492153,0.9789608736299803,3,4,61265,1549,59716,0.9747163959846569,26.93784711111111,3768.7499573333334,12.368830363004065,137,4.900000000000006E-4
2,test_20231101_140328,1254659.png,342646,51312,291334,0.850247777589699,2,3,80080,7252,72828,0.9094405594405595,24.177809777777778,4265.942901333333,11.830653226475647,137,4.900000000000006E-4
3,test_20231101_140328,10188041.png,221231,6697,214534,0.969728473857642,2,3,41731,948,40783,0.9772830749323045,12.756494222222223,1588.645056,16.12053485334449,137,4.900000000000006E-4
4,test_20231101_140328,10287332.png,216980,7742,209238,0.9643192921006545,2,3,22337,1063,21274,0.9524107982271567,11.905411555555556,1593.1080746666667,16.108351220163833,137,4.900000000000006E-4
5,test_20231101_140328,11610969.png,368720,10847,357873,0.9705820134519418,2,3,84111,1608,82503,0.9808824053928737,37.68496,6816.026848,9.79549068440944,137,4.900000000000006E-4
6,test_20231101_140328,10350842.png,212614,2427,210187,0.9885849473694113,2,4,42529,356,42173,0.9916292412236356,25.651312,3921.524976,12.196253755127639,137,4.900000000000006E-4
7,test_20231101_140328,10863862.png,317432,4807,312625,0.9848565992086494,2,3,66058,706,65352,0.9893124224166642,40.71794311111111,7913.072912,9.14735193480679,137,4.900000000000006E-4
8,test_20231101_140328,11382381.png,312486,327,312159,0.9989535531191798,1,3,46745,44,46701,0.9990587228580596,23.441726222222222,2963.055792,13.413405318888326,137,4.900000000000006E-4
9,test_20231101_140328,11079715.png,443815,89749,354066,0.7977783535932765,3,4,124136,12651,111485,0.8980875813623768,19.09621511111111,2710.2879413333335,13.800649280417671,137,4.900000000000006E-4
10,test_20231101_140328,11551286.png,271883,124,271759,0.999543921466219,2,3,40092,16,40076,0.9996009178888556,18.13910577777778,1903.2464906666667,15.335853231830718,137,4.900000000000006E-4
1,test_20231101_140329,10404007.png,502730,10577,492153,0.9789608736299803,2,3,61265,1549,59716,0.9747163959846569,26.93784711111111,3768.7499573333334,12.368830363004065,137,5.000000000000007E-4
2,test_20231101_140329,1254659.png,342646,51312,291334,0.850247777589699,2,4,80080,7252,72828,0.9094405594405595,24.177809777777778,4265.942901333333,11.830653226475647,137,5.000000000000007E-4
3,test_20231101_140329,10188041.png,221231,6697,214534,0.969728473857642,2,4,41731,948,40783,0.9772830749323045,12.756494222222223,1588.645056,16.12053485334449,137,5.000000000000007E-4
4,test_20231101_140329,10287332.png,216980,7742,209238,0.9643192921006545,1,4,22337,1063,21274,0.9524107982271567,11.905411555555556,1593.1080746666667,16.108351220163833,137,5.000000000000007E-4
5,test_20231101_140329,11610969.png,368720,10847,357873,0.9705820134519418,1,3,84111,1608,82503,0.9808824053928737,37.68496,6816.026848,9.79549068440944,137,5.000000000000007E-4
6,test_20231101_140329,10350842.png,212614,2427,210187,0.9885849473694113,1,3,42529,356,42173,0.9916292412236356,25.651312,3921.524976,12.196253755127639,137,5.000000000000007E-4
7,test_20231101_140329,10863862.png,317432,4807,312625,0.9848565992086494,2,3,66058,706,65352,0.9893124224166642,40.71794311111111,7913.072912,9.14735193480679,137,5.000000000000007E-4
8,test_20231101_140329,11382381.png,312486,327,312159,0.9989535531191798,1,4,46745,44,46701,0.9990587228580596,23.441726222222222,2963.055792,13.413405318888326,137,5.000000000000007E-4
9,test_20231101_140329,11079715.png,443815,89749,354066,0.7977783535932765,3,3,124136,12651,111485,0.8980875813623768,19.09621511111111,2710.2879413333335,13.800649280417671,137,5.000000000000007E-4
10,test_20231101_140329,11551286.png,271883,124,271759,0.999543921466219,2,4,40092,16,40076,0.9996009178888556,18.13910577777778,1903.2464906666667,15.335853231830718,137,5.000000000000007E-4
1,test_20231101_140330,10404007.png,502730,10414,492316,0.9792851033357866,2,5,61265,1527,59738,0.9750754917163144,26.95387911111111,3773.3945226666665,12.363481461626115,137,5.100000000000007E-4
2,test_20231101_140330,1254659.png,342646,51312,291334,0.850247777589699,3,4,80080,7252,72828,0.9094405594405595,24.177809777777778,4265.942901333333,11.830653226475647,137,5.100000000000007E-4
3,test_20231101_140330,10188041.png,221231,6697,214534,0.969728473857642,2,3,41731,948,40783,0.9772830749323045,12.756494222222223,1588.645056,16.12053485334449,137,5.100000000000007E-4
4,test_20231101_140330,10287332.png,216980,7742,209238,0.9643192921006545,1,3,22337,1063,21274,0.9524107982271567,11.905411555555556,1593.1080746666667,16.108351220163833,137,5.100000000000007E-4
5,test_20231101_140330,11610969.png,368720,10847,357873,0.9705820134519418,1,4,84111,1608,82503,0.9808824053928737,37.68496,6816.026848,9.79549068440944,137,5.100000000000007E-4
6,test_20231101_140330,10350842.png,212614,2427,210187,0.9885849473694113,1,4,42529,356,42173,0.9916292412236356,25.651312,3921.524976,12.196253755127639,137,5.100000000000007E-4
7,test_20231101_140330,10863862.png,317432,4807,312625,0.9848565992086494,1,3,66058,706,65352,0.9893124224166642,40.71794311111111,7913.072912,9.14735193480679,137,5.100000000000007E-4
8,test_20231101_140330,11382381.png,312486,327,312159,0.9989535531191798,1,4,46745,44,46701,0.9990587228580596,23.441726222222222,2963.055792,13.413405318888326,137,5.100000000000007E-4
9,test_20231101_140330,11079715.png,443815,89569,354246,0.798183927988013,3,4,124136,12624,111512,0.8983050847457628,19.33347911111111,2752.297077333333,13.73385051913707,137,5.100000000000007E-4
10,test_20231101_140330,11551286.png,271883,124,271759,0.999543921466219,2,3,40092,16,40076,0.9996009178888556,18.13910577777778,1903.2464906666667,15.335853231830718,137,5.100000000000007E-4
1,test_20231101_140330,10404007.png,502730,10072,492658,0.97996538897619,2,4,61265,1477,59788,0.9758916183791725,27.288881777777778,3845.415648,12.281370716389981,137,5.200000000000007E-4
2,test_20231101_140330,1254659.png,342646,51312,291334,0.850247777589699,2,4,80080,7252,72828,0.9094405594405595,24.177809777777778,4265.942901333333,11.830653226475647,137,5.200000000000007E-4
3,test_20231101_140330,10188041.png,221231,6697,214534,0.969728473857642,1,3,41731,948,40783,0.9772830749323045,12.756494222222223,1588.645056,16.12053485334449,137,5.200000000000007E-4
4,test_20231101_140330,10287332.png,216980,7742,209238,0.9643192921006545,1,4,22337,1063,21274,0.9524107982271567,11.905411555555556,1593.1080746666667,16.108351220163833,137,5.200000000000007E-4
5,test_20231101_140330,11610969.png,368720,10847,357873,0.9705820134519418,2,4,84111,1608,82503,0.9808824053928737,37.68496,6816.026848,9.79549068440944,137,5.200000000000007E-4
6,test_20231101_140330,10350842.png,212614,2427,210187,0.9885849473694113,1,4,42529,356,42173,0.9916292412236356,25.651312,3921.524976,12.196253755127639,137,5.200000000000007E-4
7,test_20231101_140330,10863862.png,317432,4807,312625,0.9848565992086494,1,4,66058,706,65352,0.9893124224166642,40.71794311111111,7913.072912,9.14735193480679,137,5.200000000000007E-4
8,test_20231101_140330,11382381.png,312486,327,312159,0.9989535531191798,1,3,46745,44,46701,0.9990587228580596,23.441726222222222,2963.055792,13.413405318888326,137,5.200000000000007E-4
9,test_20231101_140330,11079715.png,443815,89569,354246,0.798183927988013,3,4,124136,12624,111512,0.8983050847457628,19.33347911111111,2752.297077333333,13.73385051913707,137,5.200000000000007E-4
10,test_20231101_140330,11551286.png,271883,24,271859,0.9999117267353972,0,3,40092,1,40091,0.9999750573680535,24.866876444444443,3470.407338666667,12.72699907819776,137,5.200000000000007E-4
1,test_20231101_140331,10404007.png,502730,10072,492658,0.97996538897619,2,4,61265,1477,59788,0.9758916183791725,27.288881777777778,3845.415648,12.281370716389981,137,5.300000000000007E-4
2,test_20231101_140331,1254659.png,342646,51312,291334,0.850247777589699,3,4,80080,7252,72828,0.9094405594405595,24.177809777777778,4265.942901333333,11.830653226475647,137,5.300000000000007E-4
3,test_20231101_140331,10188041.png,221231,6697,214534,0.969728473857642,2,4,41731,948,40783,0.9772830749323045,12.756494222222223,1588.645056,16.12053485334449,137,5.300000000000007E-4
4,test_20231101_140331,10287332.png,216980,7742,209238,0.9643192921006545,2,4,22337,1063,21274,0.9524107982271567,11.905411555555556,1593.1080746666667,16.108351220163833,137,5.300000000000007E-4
5,test_20231101_140331,11610969.png,368720,10847,357873,0.9705820134519418,2,4,84111,1608,82503,0.9808824053928737,37.68496,6816.026848,9.79549068440944,137,5.300000000000007E-4
6,test_20231101_140331,10350842.png,212614,2427,210187,0.9885849473694113,1,4,42529,356,42173,0.9916292412236356,25.651312,3921.524976,12.196253755127639,137,5.300000000000007E-4
7,test_20231101_140331,10863862.png,317432,4807,312625,0.9848565992086494,2,3,66058,706,65352,0.9893124224166642,40.71794311111111,7913.072912,9.14735193480679,137,5.300000000000007E-4
8,test_20231101_140331,11382381.png,312486,327,312159,0.9989535531191798,1,4,46745,44,46701,0.9990587228580596,23.441726222222222,2963.055792,13.413405318888326,137,5.300000000000007E-4
9,test_20231101_140331,11079715.png,443815,89569,354246,0.798183927988013,3,3,124136,12624,111512,0.8983050847457628,19.33347911111111,2752.297077333333,13.73385051913707,137,5.300000000000007E-4
10,test_20231101_140331,11551286.png,271883,24,271859,0.9999117267353972,0,3,40092,1,40091,0.9999750573680535,24.866876444444443,3470.407338666667,12.72699907819776,137,5.300000000000007E-4
1,test_20231101_140332,10404007.png,502730,10072,492658,0.97996538897619,2,4,61265,1477,59788,0.9758916183791725,27.288881777777778,3845.415648,12.281370716389981,137,5.400000000000008E-4
2,test_20231101_140332,1254659.png,342646,51312,291334,0.850247777589699,3,3,80080,7252,72828,0.9094405594405595,24.177809777777778,4265.942901333333,11.830653226475647,137,5.400000000000008E-4
3,test_20231101_140332,10188041.png,221231,6697,214534,0.969728473857642,1,3,41731,948,40783,0.9772830749323045,12.756494222222223,1588.645056,16.12053485334449,137,5.400000000000008E-4
4,test_20231101_140332,10287332.png,216980,7742,209238,0.9643192921006545,1,3,22337,1063,21274,0.9524107982271567,11.905411555555556,1593.1080746666667,16.108351220163833,137,5.400000000000008E-4
5,test_20231101_140332,11610969.png,368720,10847,357873,0.9705820134519418,1,4,84111,1608,82503,0.9808824053928737,37.68496,6816.026848,9.79549068440944,137,5.400000000000008E-4
6,test_20231101_140332,10350842.png,212614,2427,210187,0.9885849473694113,1,4,42529,356,42173,0.9916292412236356,25.651312,3921.524976,12.196253755127639,137,5.400000000000008E-4
7,test_20231101_140332,10863862.png,317432,4807,312625,0.9848565992086494,1,3,66058,706,65352,0.9893124224166642,40.71794311111111,7913.072912,9.14735193480679,137,5.400000000000008E-4
8,test_20231101_140332,11382381.png,312486,327,312159,0.9989535531191798,1,3,46745,44,46701,0.9990587228580596,23.441726222222222,2963.055792,13.413405318888326,137,5.400000000000008E-4
9,test_20231101_140332,11079715.png,443815,89569,354246,0.798183927988013,3,4,124136,12624,111512,0.8983050847457628,19.33347911111111,2752.297077333333,13.73385051913707,137,5.400000000000008E-4
10,test_20231101_140332,11551286.png,271883,24,271859,0.9999117267353972,0,3,40092,1,40091,0.9999750573680535,24.866876444444443,3470.407338666667,12.72699907819776,137,5.400000000000008E-4
1,test_20231101_140332,10404007.png,502730,10072,492658,0.97996538897619,2,4,61265,1477,59788,0.9758916183791725,27.288881777777778,3845.415648,12.281370716389981,137,5.500000000000008E-4
2,test_20231101_140332,1254659.png,342646,51312,291334,0.850247777589699,3,4,80080,7252,72828,0.9094405594405595,24.177809777777778,4265.942901333333,11.830653226475647,137,5.500000000000008E-4
3,test_20231101_140332,10188041.png,221231,6697,214534,0.969728473857642,2,3,41731,948,40783,0.9772830749323045,12.756494222222223,1588.645056,16.12053485334449,137,5.500000000000008E-4
4,test_20231101_140332,10287332.png,216980,7742,209238,0.9643192921006545,1,4,22337,1063,21274,0.9524107982271567,11.905411555555556,1593.1080746666667,16.108351220163833,137,5.500000000000008E-4
5,test_20231101_140332,11610969.png,368720,10847,357873,0.9705820134519418,2,4,84111,1608,82503,0.9808824053928737,37.68496,6816.026848,9.79549068440944,137,5.500000000000008E-4
6,test_20231101_140332,10350842.png,212614,2427,210187,0.9885849473694113,1,3,42529,356,42173,0.9916292412236356,25.651312,3921.524976,12.196253755127639,137,5.500000000000008E-4
7,test_20231101_140332,10863862.png,317432,4807,312625,0.9848565992086494,1,4,66058,706,65352,0.9893124224166642,40.71794311111111,7913.072912,9.14735193480679,137,5.500000000000008E-4
8,test_20231101_140332,11382381.png,312486,327,312159,0.9989535531191798,1,4,46745,44,46701,0.9990587228580596,23.441726222222222,2963.055792,13.413405318888326,137,5.500000000000008E-4
9,test_20231101_140332,11079715.png,443815,89569,354246,0.798183927988013,3,4,124136,12624,111512,0.8983050847457628,19.33347911111111,2752.297077333333,13.73385051913707,137,5.500000000000008E-4
10,test_20231101_140332,11551286.png,271883,24,271859,0.9999117267353972,1,13,40092,1,40091,0.9999750573680535,24.866876444444443,3470.407338666667,12.72699907819776,137,5.500000000000008E-4
1,test_20231101_140333,10404007.png,502730,10072,492658,0.97996538897619,2,4,61265,1477,59788,0.9758916183791725,27.288881777777778,3845.415648,12.281370716389981,137,5.600000000000008E-4
2,test_20231101_140333,1254659.png,342646,51312,291334,0.850247777589699,3,4,80080,7252,72828,0.9094405594405595,24.177809777777778,4265.942901333333,11.830653226475647,137,5.600000000000008E-4
3,test_20231101_140333,10188041.png,221231,6697,214534,0.969728473857642,2,4,41731,948,40783,0.9772830749323045,12.756494222222223,1588.645056,16.12053485334449,137,5.600000000000008E-4
4,test_20231101_140333,10287332.png,216980,7742,209238,0.9643192921006545,1,4,22337,1063,21274,0.9524107982271567,11.905411555555556,1593.1080746666667,16.108351220163833,137,5.600000000000008E-4
5,test_20231101_140333,11610969.png,368720,10847,357873,0.9705820134519418,2,4,84111,1608,82503,0.9808824053928737,37.68496,6816.026848,9.79549068440944,137,5.600000000000008E-4
6,test_20231101_140333,10350842.png,212614,2427,210187,0.9885849473694113,1,4,42529,356,42173,0.9916292412236356,25.651312,3921.524976,12.196253755127639,137,5.600000000000008E-4
7,test_20231101_140333,10863862.png,317432,4807,312625,0.9848565992086494,1,3,66058,706,65352,0.9893124224166642,40.71794311111111,7913.072912,9.14735193480679,137,5.600000000000008E-4
8,test_20231101_140333,11382381.png,312486,327,312159,0.9989535531191798,1,3,46745,44,46701,0.9990587228580596,23.441726222222222,2963.055792,13.413405318888326,137,5.600000000000008E-4
9,test_20231101_140333,11079715.png,443815,89569,354246,0.798183927988013,3,4,124136,12624,111512,0.8983050847457628,19.33347911111111,2752.297077333333,13.73385051913707,137,5.600000000000008E-4
10,test_20231101_140333,11551286.png,271883,24,271859,0.9999117267353972,0,3,40092,1,40091,0.9999750573680535,24.866876444444443,3470.407338666667,12.72699907819776,137,5.600000000000008E-4
1,test_20231101_140334,10404007.png,502730,10072,492658,0.97996538897619,2,3,61265,1477,59788,0.9758916183791725,27.288881777777778,3845.415648,12.281370716389981,137,5.700000000000008E-4
2,test_20231101_140334,1254659.png,342646,51312,291334,0.850247777589699,3,4,80080,7252,72828,0.9094405594405595,24.177809777777778,4265.942901333333,11.830653226475647,137,5.700000000000008E-4
3,test_20231101_140334,10188041.png,221231,6697,214534,0.969728473857642,2,4,41731,948,40783,0.9772830749323045,12.756494222222223,1588.645056,16.12053485334449,137,5.700000000000008E-4
4,test_20231101_140334,10287332.png,216980,7742,209238,0.9643192921006545,2,4,22337,1063,21274,0.9524107982271567,11.905411555555556,1593.1080746666667,16.108351220163833,137,5.700000000000008E-4
5,test_20231101_140334,11610969.png,368720,10847,357873,0.9705820134519418,2,3,84111,1608,82503,0.9808824053928737,37.68496,6816.026848,9.79549068440944,137,5.700000000000008E-4
6,test_20231101_140334,10350842.png,212614,2427,210187,0.9885849473694113,1,4,42529,356,42173,0.9916292412236356,25.651312,3921.524976,12.196253755127639,137,5.700000000000008E-4
7,test_20231101_140334,10863862.png,317432,4807,312625,0.9848565992086494,1,3,66058,706,65352,0.9893124224166642,40.71794311111111,7913.072912,9.14735193480679,137,5.700000000000008E-4
8,test_20231101_140334,11382381.png,312486,327,312159,0.9989535531191798,1,3,46745,44,46701,0.9990587228580596,23.441726222222222,2963.055792,13.413405318888326,137,5.700000000000008E-4
9,test_20231101_140334,11079715.png,443815,89569,354246,0.798183927988013,3,4,124136,12624,111512,0.8983050847457628,19.33347911111111,2752.297077333333,13.73385051913707,137,5.700000000000008E-4
10,test_20231101_140334,11551286.png,271883,24,271859,0.9999117267353972,1,4,40092,1,40091,0.9999750573680535,24.866876444444443,3470.407338666667,12.72699907819776,137,5.700000000000008E-4
1,test_20231101_140334,10404007.png,502730,10072,492658,0.97996538897619,2,4,61265,1477,59788,0.9758916183791725,27.288881777777778,3845.415648,12.281370716389981,137,5.800000000000009E-4
2,test_20231101_140334,1254659.png,342646,51312,291334,0.850247777589699,3,4,80080,7252,72828,0.9094405594405595,24.177809777777778,4265.942901333333,11.830653226475647,137,5.800000000000009E-4
3,test_20231101_140334,10188041.png,221231,6617,214614,0.9700900868323156,2,3,41731,938,40793,0.9775227049435671,12.795395555555556,1592.7295573333333,16.10938321243044,137,5.800000000000009E-4
4,test_20231101_140334,10287332.png,216980,7742,209238,0.9643192921006545,1,4,22337,1063,21274,0.9524107982271567,11.905411555555556,1593.1080746666667,16.108351220163833,137,5.800000000000009E-4
5,test_20231101_140334,11610969.png,368720,10847,357873,0.9705820134519418,2,4,84111,1608,82503,0.9808824053928737,37.68496,6816.026848,9.79549068440944,137,5.800000000000009E-4
6,test_20231101_140334,10350842.png,212614,2427,210187,0.9885849473694113,2,4,42529,356,42173,0.9916292412236356,25.651312,3921.524976,12.196253755127639,137,5.800000000000009E-4
7,test_20231101_140334,10863862.png,317432,4807,312625,0.9848565992086494,2,4,66058,706,65352,0.9893124224166642,40.71794311111111,7913.072912,9.14735193480679,137,5.800000000000009E-4
8,test_20231101_140334,11382381.png,312486,327,312159,0.9989535531191798,2,3,46745,44,46701,0.9990587228580596,23.441726222222222,2963.055792,13.413405318888326,137,5.800000000000009E-4
9,test_20231101_140334,11079715.png,443815,89569,354246,0.798183927988013,3,4,124136,12624,111512,0.8983050847457628,19.33347911111111,2752.297077333333,13.73385051913707,137,5.800000000000009E-4
10,test_20231101_140334,11551286.png,271883,24,271859,0.9999117267353972,0,4,40092,1,40091,0.9999750573680535,24.866876444444443,3470.407338666667,12.72699907819776,137,5.800000000000009E-4
1,test_20231101_140335,10404007.png,502730,10072,492658,0.97996538897619,2,4,61265,1477,59788,0.9758916183791725,27.288881777777778,3845.415648,12.281370716389981,137,5.900000000000009E-4
2,test_20231101_140335,1254659.png,342646,51312,291334,0.850247777589699,2,3,80080,7252,72828,0.9094405594405595,24.177809777777778,4265.942901333333,11.830653226475647,137,5.900000000000009E-4
3,test_20231101_140335,10188041.png,221231,6617,214614,0.9700900868323156,2,4,41731,938,40793,0.9775227049435671,12.795395555555556,1592.7295573333333,16.10938321243044,137,5.900000000000009E-4
4,test_20231101_140335,10287332.png,216980,7742,209238,0.9643192921006545,2,4,22337,1063,21274,0.9524107982271567,11.905411555555556,1593.1080746666667,16.108351220163833,137,5.900000000000009E-4
5,test_20231101_140335,11610969.png,368720,10847,357873,0.9705820134519418,1,3,84111,1608,82503,0.9808824053928737,37.68496,6816.026848,9.79549068440944,137,5.900000000000009E-4
6,test_20231101_140335,10350842.png,212614,2427,210187,0.9885849473694113,1,3,42529,356,42173,0.9916292412236356,25.651312,3921.524976,12.196253755127639,137,5.900000000000009E-4
7,test_20231101_140335,10863862.png,317432,4807,312625,0.9848565992086494,1,4,66058,706,65352,0.9893124224166642,40.71794311111111,7913.072912,9.14735193480679,137,5.900000000000009E-4
8,test_20231101_140335,11382381.png,312486,327,312159,0.9989535531191798,1,3,46745,44,46701,0.9990587228580596,23.441726222222222,2963.055792,13.413405318888326,137,5.900000000000009E-4
9,test_20231101_140335,11079715.png,443815,89569,354246,0.798183927988013,3,4,124136,12624,111512,0.8983050847457628,19.33347911111111,2752.297077333333,13.73385051913707,137,5.900000000000009E-4
10,test_20231101_140335,11551286.png,271883,24,271859,0.9999117267353972,0,3,40092,1,40091,0.9999750573680535,24.866876444444443,3470.407338666667,12.72699907819776,137,5.900000000000009E-4
1,test_20231101_140336,10404007.png,502730,10072,492658,0.97996538897619,2,12,61265,1477,59788,0.9758916183791725,27.288881777777778,3845.415648,12.281370716389981,137,6.000000000000009E-4
2,test_20231101_140336,1254659.png,342646,51312,291334,0.850247777589699,3,4,80080,7252,72828,0.9094405594405595,24.177809777777778,4265.942901333333,11.830653226475647,137,6.000000000000009E-4
3,test_20231101_140336,10188041.png,221231,6617,214614,0.9700900868323156,1,3,41731,938,40793,0.9775227049435671,12.795395555555556,1592.7295573333333,16.10938321243044,137,6.000000000000009E-4
4,test_20231101_140336,10287332.png,216980,7742,209238,0.9643192921006545,3,3,22337,1063,21274,0.9524107982271567,11.905411555555556,1593.1080746666667,16.108351220163833,137,6.000000000000009E-4
5,test_20231101_140336,11610969.png,368720,10847,357873,0.9705820134519418,2,3,84111,1608,82503,0.9808824053928737,37.68496,6816.026848,9.79549068440944,137,6.000000000000009E-4
6,test_20231101_140336,10350842.png,212614,2427,210187,0.9885849473694113,1,4,42529,356,42173,0.9916292412236356,25.651312,3921.524976,12.196253755127639,137,6.000000000000009E-4
7,test_20231101_140336,10863862.png,317432,4807,312625,0.9848565992086494,2,3,66058,706,65352,0.9893124224166642,40.71794311111111,7913.072912,9.14735193480679,137,6.000000000000009E-4
8,test_20231101_140336,11382381.png,312486,327,312159,0.9989535531191798,1,4,46745,44,46701,0.9990587228580596,23.441726222222222,2963.055792,13.413405318888326,137,6.000000000000009E-4
9,test_20231101_140336,11079715.png,443815,89569,354246,0.798183927988013,3,4,124136,12624,111512,0.8983050847457628,19.33347911111111,2752.297077333333,13.73385051913707,137,6.000000000000009E-4
10,test_20231101_140336,11551286.png,271883,24,271859,0.9999117267353972,1,4,40092,1,40091,0.9999750573680535,24.866876444444443,3470.407338666667,12.72699907819776,137,6.000000000000009E-4
1,test_20231101_140336,10404007.png,502730,10072,492658,0.97996538897619,2,3,61265,1477,59788,0.9758916183791725,27.288881777777778,3845.415648,12.281370716389981,137,6.10000000000001E-4
2,test_20231101_140336,1254659.png,342646,51312,291334,0.850247777589699,4,4,80080,7252,72828,0.9094405594405595,24.177809777777778,4265.942901333333,11.830653226475647,137,6.10000000000001E-4
3,test_20231101_140336,10188041.png,221231,6617,214614,0.9700900868323156,2,3,41731,938,40793,0.9775227049435671,12.795395555555556,1592.7295573333333,16.10938321243044,137,6.10000000000001E-4
4,test_20231101_140336,10287332.png,216980,7742,209238,0.9643192921006545,2,3,22337,1063,21274,0.9524107982271567,11.905411555555556,1593.1080746666667,16.108351220163833,137,6.10000000000001E-4
5,test_20231101_140336,11610969.png,368720,10847,357873,0.9705820134519418,2,4,84111,1608,82503,0.9808824053928737,37.68496,6816.026848,9.79549068440944,137,6.10000000000001E-4
6,test_20231101_140336,10350842.png,212614,2427,210187,0.9885849473694113,2,4,42529,356,42173,0.9916292412236356,25.651312,3921.524976,12.196253755127639,137,6.10000000000001E-4
7,test_20231101_140336,10863862.png,317432,4807,312625,0.9848565992086494,2,3,66058,706,65352,0.9893124224166642,40.71794311111111,7913.072912,9.14735193480679,137,6.10000000000001E-4
8,test_20231101_140336,11382381.png,312486,327,312159,0.9989535531191798,2,3,46745,44,46701,0.9990587228580596,23.441726222222222,2963.055792,13.413405318888326,137,6.10000000000001E-4
9,test_20231101_140336,11079715.png,443815,89569,354246,0.798183927988013,3,4,124136,12624,111512,0.8983050847457628,19.33347911111111,2752.297077333333,13.73385051913707,137,6.10000000000001E-4
10,test_20231101_140336,11551286.png,271883,24,271859,0.9999117267353972,1,3,40092,1,40091,0.9999750573680535,24.866876444444443,3470.407338666667,12.72699907819776,137,6.10000000000001E-4
1,test_20231101_140337,10404007.png,502730,10072,492658,0.97996538897619,2,4,61265,1477,59788,0.9758916183791725,27.288881777777778,3845.415648,12.281370716389981,137,6.20000000000001E-4
2,test_20231101_140337,1254659.png,342646,51312,291334,0.850247777589699,2,3,80080,7252,72828,0.9094405594405595,24.177809777777778,4265.942901333333,11.830653226475647,137,6.20000000000001E-4
3,test_20231101_140337,10188041.png,221231,6617,214614,0.9700900868323156,2,4,41731,938,40793,0.9775227049435671,12.795395555555556,1592.7295573333333,16.10938321243044,137,6.20000000000001E-4
4,test_20231101_140337,10287332.png,216980,7742,209238,0.9643192921006545,1,4,22337,1063,21274,0.9524107982271567,11.905411555555556,1593.1080746666667,16.108351220163833,137,6.20000000000001E-4
5,test_20231101_140337,11610969.png,368720,10847,357873,0.9705820134519418,2,4,84111,1608,82503,0.9808824053928737,37.68496,6816.026848,9.79549068440944,137,6.20000000000001E-4
6,test_20231101_140337,10350842.png,212614,2427,210187,0.9885849473694113,2,3,42529,356,42173,0.9916292412236356,25.651312,3921.524976,12.196253755127639,137,6.20000000000001E-4
7,test_20231101_140337,10863862.png,317432,4807,312625,0.9848565992086494,2,3,66058,706,65352,0.9893124224166642,40.71794311111111,7913.072912,9.14735193480679,137,6.20000000000001E-4
8,test_20231101_140337,11382381.png,312486,327,312159,0.9989535531191798,1,4,46745,44,46701,0.9990587228580596,23.441726222222222,2963.055792,13.413405318888326,137,6.20000000000001E-4
9,test_20231101_140337,11079715.png,443815,89569,354246,0.798183927988013,4,4,124136,12624,111512,0.8983050847457628,19.33347911111111,2752.297077333333,13.73385051913707,137,6.20000000000001E-4
10,test_20231101_140337,11551286.png,271883,24,271859,0.9999117267353972,0,3,40092,1,40091,0.9999750573680535,24.866876444444443,3470.407338666667,12.72699907819776,137,6.20000000000001E-4
1,test_20231101_140338,10404007.png,502730,10072,492658,0.97996538897619,3,3,61265,1477,59788,0.9758916183791725,27.288881777777778,3845.415648,12.281370716389981,137,6.30000000000001E-4
2,test_20231101_140338,1254659.png,342646,51312,291334,0.850247777589699,3,4,80080,7252,72828,0.9094405594405595,24.177809777777778,4265.942901333333,11.830653226475647,137,6.30000000000001E-4
3,test_20231101_140338,10188041.png,221231,6617,214614,0.9700900868323156,2,4,41731,938,40793,0.9775227049435671,12.795395555555556,1592.7295573333333,16.10938321243044,137,6.30000000000001E-4
4,test_20231101_140338,10287332.png,216980,7742,209238,0.9643192921006545,2,4,22337,1063,21274,0.9524107982271567,11.905411555555556,1593.1080746666667,16.108351220163833,137,6.30000000000001E-4
5,test_20231101_140338,11610969.png,368720,10847,357873,0.9705820134519418,1,3,84111,1608,82503,0.9808824053928737,37.68496,6816.026848,9.79549068440944,137,6.30000000000001E-4
6,test_20231101_140338,10350842.png,212614,2427,210187,0.9885849473694113,2,4,42529,356,42173,0.9916292412236356,25.651312,3921.524976,12.196253755127639,137,6.30000000000001E-4
7,test_20231101_140338,10863862.png,317432,4807,312625,0.9848565992086494,1,4,66058,706,65352,0.9893124224166642,40.71794311111111,7913.072912,9.14735193480679,137,6.30000000000001E-4
8,test_20231101_140338,11382381.png,312486,327,312159,0.9989535531191798,2,3,46745,44,46701,0.9990587228580596,23.441726222222222,2963.055792,13.413405318888326,137,6.30000000000001E-4
9,test_20231101_140338,11079715.png,443815,89569,354246,0.798183927988013,3,4,124136,12624,111512,0.8983050847457628,19.33347911111111,2752.297077333333,13.73385051913707,137,6.30000000000001E-4
10,test_20231101_140338,11551286.png,271883,24,271859,0.9999117267353972,1,4,40092,1,40091,0.9999750573680535,24.866876444444443,3470.407338666667,12.72699907819776,137,6.30000000000001E-4
1,test_20231101_140338,10404007.png,502730,10072,492658,0.97996538897619,2,3,61265,1477,59788,0.9758916183791725,27.288881777777778,3845.415648,12.281370716389981,137,6.40000000000001E-4
2,test_20231101_140338,1254659.png,342646,51312,291334,0.850247777589699,3,4,80080,7252,72828,0.9094405594405595,24.177809777777778,4265.942901333333,11.830653226475647,137,6.40000000000001E-4
3,test_20231101_140338,10188041.png,221231,6617,214614,0.9700900868323156,2,4,41731,938,40793,0.9775227049435671,12.795395555555556,1592.7295573333333,16.10938321243044,137,6.40000000000001E-4
4,test_20231101_140338,10287332.png,216980,7742,209238,0.9643192921006545,2,4,22337,1063,21274,0.9524107982271567,11.905411555555556,1593.1080746666667,16.108351220163833,137,6.40000000000001E-4
5,test_20231101_140338,11610969.png,368720,10847,357873,0.9705820134519418,2,4,84111,1608,82503,0.9808824053928737,37.68496,6816.026848,9.79549068440944,137,6.40000000000001E-4
6,test_20231101_140338,10350842.png,212614,2104,210510,0.9901041323713397,1,4,42529,308,42221,0.9927578828564039,26.522588444444445,4134.640533333333,11.966426030073682,137,6.40000000000001E-4
7,test_20231101_140338,10863862.png,317432,4807,312625,0.9848565992086494,1,3,66058,706,65352,0.9893124224166642,40.71794311111111,7913.072912,9.14735193480679,137,6.40000000000001E-4
8,test_20231101_140338,11382381.png,312486,327,312159,0.9989535531191798,1,4,46745,44,46701,0.9990587228580596,23.441726222222222,2963.055792,13.413405318888326,137,6.40000000000001E-4
9,test_20231101_140338,11079715.png,443815,89569,354246,0.798183927988013,3,4,124136,12624,111512,0.8983050847457628,19.33347911111111,2752.297077333333,13.73385051913707,137,6.40000000000001E-4
10,test_20231101_140338,11551286.png,271883,24,271859,0.9999117267353972,1,4,40092,1,40091,0.9999750573680535,24.866876444444443,3470.407338666667,12.72699907819776,137,6.40000000000001E-4
1,test_20231101_140339,10404007.png,502730,10072,492658,0.97996538897619,2,3,61265,1477,59788,0.9758916183791725,27.288881777777778,3845.415648,12.281370716389981,137,6.500000000000011E-4
2,test_20231101_140339,1254659.png,342646,51312,291334,0.850247777589699,2,4,80080,7252,72828,0.9094405594405595,24.177809777777778,4265.942901333333,11.830653226475647,137,6.500000000000011E-4
3,test_20231101_140339,10188041.png,221231,6617,214614,0.9700900868323156,1,3,41731,938,40793,0.9775227049435671,12.795395555555556,1592.7295573333333,16.10938321243044,137,6.500000000000011E-4
4,test_20231101_140339,10287332.png,216980,7742,209238,0.9643192921006545,1,3,22337,1063,21274,0.9524107982271567,11.905411555555556,1593.1080746666667,16.108351220163833,137,6.500000000000011E-4
5,test_20231101_140339,11610969.png,368720,10847,357873,0.9705820134519418,2,4,84111,1608,82503,0.9808824053928737,37.68496,6816.026848,9.79549068440944,137,6.500000000000011E-4
6,test_20231101_140339,10350842.png,212614,2104,210510,0.9901041323713397,1,3,42529,308,42221,0.9927578828564039,26.522588444444445,4134.640533333333,11.966426030073682,137,6.500000000000011E-4
7,test_20231101_140339,10863862.png,317432,4807,312625,0.9848565992086494,1,4,66058,706,65352,0.9893124224166642,40.71794311111111,7913.072912,9.14735193480679,137,6.500000000000011E-4
8,test_20231101_140339,11382381.png,312486,327,312159,0.9989535531191798,2,3,46745,44,46701,0.9990587228580596,23.441726222222222,2963.055792,13.413405318888326,137,6.500000000000011E-4
9,test_20231101_140339,11079715.png,443815,89569,354246,0.798183927988013,3,3,124136,12624,111512,0.8983050847457628,19.33347911111111,2752.297077333333,13.73385051913707,137,6.500000000000011E-4
10,test_20231101_140339,11551286.png,271883,24,271859,0.9999117267353972,0,3,40092,1,40091,0.9999750573680535,24.866876444444443,3470.407338666667,12.72699907819776,137,6.500000000000011E-4
1,test_20231101_140340,10404007.png,502730,10072,492658,0.97996538897619,1,3,61265,1477,59788,0.9758916183791725,27.288881777777778,3845.415648,12.281370716389981,137,6.600000000000011E-4
2,test_20231101_140340,1254659.png,342646,51312,291334,0.850247777589699,2,4,80080,7252,72828,0.9094405594405595,24.177809777777778,4265.942901333333,11.830653226475647,137,6.600000000000011E-4
3,test_20231101_140340,10188041.png,221231,6617,214614,0.9700900868323156,2,3,41731,938,40793,0.9775227049435671,12.795395555555556,1592.7295573333333,16.10938321243044,137,6.600000000000011E-4
4,test_20231101_140340,10287332.png,216980,7742,209238,0.9643192921006545,2,4,22337,1063,21274,0.9524107982271567,11.905411555555556,1593.1080746666667,16.108351220163833,137,6.600000000000011E-4
5,test_20231101_140340,11610969.png,368720,10847,357873,0.9705820134519418,2,3,84111,1608,82503,0.9808824053928737,37.68496,6816.026848,9.79549068440944,137,6.600000000000011E-4
6,test_20231101_140340,10350842.png,212614,2104,210510,0.9901041323713397,1,3,42529,308,42221,0.9927578828564039,26.522588444444445,4134.640533333333,11.966426030073682,137,6.600000000000011E-4
7,test_20231101_140340,10863862.png,317432,4807,312625,0.9848565992086494,2,4,66058,706,65352,0.9893124224166642,40.71794311111111,7913.072912,9.14735193480679,137,6.600000000000011E-4
8,test_20231101_140340,11382381.png,312486,327,312159,0.9989535531191798,1,4,46745,44,46701,0.9990587228580596,23.441726222222222,2963.055792,13.413405318888326,137,6.600000000000011E-4
9,test_20231101_140340,11079715.png,443815,89569,354246,0.798183927988013,3,4,124136,12624,111512,0.8983050847457628,19.33347911111111,2752.297077333333,13.73385051913707,137,6.600000000000011E-4
10,test_20231101_140340,11551286.png,271883,24,271859,0.9999117267353972,0,3,40092,1,40091,0.9999750573680535,24.866876444444443,3470.407338666667,12.72699907819776,137,6.600000000000011E-4
1,test_20231101_140340,10404007.png,502730,10072,492658,0.97996538897619,2,4,61265,1477,59788,0.9758916183791725,27.288881777777778,3845.415648,12.281370716389981,137,6.700000000000011E-4
2,test_20231101_140340,1254659.png,342646,51312,291334,0.850247777589699,3,4,80080,7252,72828,0.9094405594405595,24.177809777777778,4265.942901333333,11.830653226475647,137,6.700000000000011E-4
3,test_20231101_140340,10188041.png,221231,6617,214614,0.9700900868323156,2,4,41731,938,40793,0.9775227049435671,12.795395555555556,1592.7295573333333,16.10938321243044,137,6.700000000000011E-4
4,test_20231101_140340,10287332.png,216980,7742,209238,0.9643192921006545,1,3,22337,1063,21274,0.9524107982271567,11.905411555555556,1593.1080746666667,16.108351220163833,137,6.700000000000011E-4
5,test_20231101_140340,11610969.png,368720,10847,357873,0.9705820134519418,2,4,84111,1608,82503,0.9808824053928737,37.68496,6816.026848,9.79549068440944,137,6.700000000000011E-4
6,test_20231101_140340,10350842.png,212614,2104,210510,0.9901041323713397,1,3,42529,308,42221,0.9927578828564039,26.522588444444445,4134.640533333333,11.966426030073682,137,6.700000000000011E-4
7,test_20231101_140340,10863862.png,317432,4807,312625,0.9848565992086494,1,3,66058,706,65352,0.9893124224166642,40.71794311111111,7913.072912,9.14735193480679,137,6.700000000000011E-4
8,test_20231101_140340,11382381.png,312486,327,312159,0.9989535531191798,1,3,46745,44,46701,0.9990587228580596,23.441726222222222,2963.055792,13.413405318888326,137,6.700000000000011E-4
9,test_20231101_140340,11079715.png,443815,89569,354246,0.798183927988013,3,4,124136,12624,111512,0.8983050847457628,19.33347911111111,2752.297077333333,13.73385051913707,137,6.700000000000011E-4
10,test_20231101_140340,11551286.png,271883,24,271859,0.9999117267353972,0,4,40092,1,40091,0.9999750573680535,24.866876444444443,3470.407338666667,12.72699907819776,137,6.700000000000011E-4
1,test_20231101_140341,10404007.png,502730,10072,492658,0.97996538897619,2,3,61265,1477,59788,0.9758916183791725,27.288881777777778,3845.415648,12.281370716389981,137,6.800000000000011E-4
2,test_20231101_140341,1254659.png,342646,51312,291334,0.850247777589699,3,4,80080,7252,72828,0.9094405594405595,24.177809777777778,4265.942901333333,11.830653226475647,137,6.800000000000011E-4
3,test_20231101_140341,10188041.png,221231,6617,214614,0.9700900868323156,2,3,41731,938,40793,0.9775227049435671,12.795395555555556,1592.7295573333333,16.10938321243044,137,6.800000000000011E-4
4,test_20231101_140341,10287332.png,216980,7742,209238,0.9643192921006545,1,3,22337,1063,21274,0.9524107982271567,11.905411555555556,1593.1080746666667,16.108351220163833,137,6.800000000000011E-4
5,test_20231101_140341,11610969.png,368720,10847,357873,0.9705820134519418,2,4,84111,1608,82503,0.9808824053928737,37.68496,6816.026848,9.79549068440944,137,6.800000000000011E-4
6,test_20231101_140341,10350842.png,212614,2104,210510,0.9901041323713397,1,4,42529,308,42221,0.9927578828564039,26.522588444444445,4134.640533333333,11.966426030073682,137,6.800000000000011E-4
7,test_20231101_140341,10863862.png,317432,4807,312625,0.9848565992086494,2,4,66058,706,65352,0.9893124224166642,40.71794311111111,7913.072912,9.14735193480679,137,6.800000000000011E-4
8,test_20231101_140341,11382381.png,312486,327,312159,0.9989535531191798,2,3,46745,44,46701,0.9990587228580596,23.441726222222222,2963.055792,13.413405318888326,137,6.800000000000011E-4
9,test_20231101_140341,11079715.png,443815,89569,354246,0.798183927988013,4,4,124136,12624,111512,0.8983050847457628,19.33347911111111,2752.297077333333,13.73385051913707,137,6.800000000000011E-4
10,test_20231101_140341,11551286.png,271883,24,271859,0.9999117267353972,0,4,40092,1,40091,0.9999750573680535,24.866876444444443,3470.407338666667,12.72699907819776,137,6.800000000000011E-4
1,test_20231101_140342,10404007.png,502730,10072,492658,0.97996538897619,2,3,61265,1477,59788,0.9758916183791725,27.288881777777778,3845.415648,12.281370716389981,137,6.900000000000012E-4
2,test_20231101_140342,1254659.png,342646,51312,291334,0.850247777589699,2,4,80080,7252,72828,0.9094405594405595,24.177809777777778,4265.942901333333,11.830653226475647,137,6.900000000000012E-4
3,test_20231101_140342,10188041.png,221231,6617,214614,0.9700900868323156,2,4,41731,938,40793,0.9775227049435671,12.795395555555556,1592.7295573333333,16.10938321243044,137,6.900000000000012E-4
4,test_20231101_140342,10287332.png,216980,7742,209238,0.9643192921006545,2,4,22337,1063,21274,0.9524107982271567,11.905411555555556,1593.1080746666667,16.108351220163833,137,6.900000000000012E-4
5,test_20231101_140342,11610969.png,368720,10847,357873,0.9705820134519418,2,3,84111,1608,82503,0.9808824053928737,37.68496,6816.026848,9.79549068440944,137,6.900000000000012E-4
6,test_20231101_140342,10350842.png,212614,2104,210510,0.9901041323713397,2,3,42529,308,42221,0.9927578828564039,26.522588444444445,4134.640533333333,11.966426030073682,137,6.900000000000012E-4
7,test_20231101_140342,10863862.png,317432,4807,312625,0.9848565992086494,2,4,66058,706,65352,0.9893124224166642,40.71794311111111,7913.072912,9.14735193480679,137,6.900000000000012E-4
8,test_20231101_140342,11382381.png,312486,327,312159,0.9989535531191798,2,4,46745,44,46701,0.9990587228580596,23.441726222222222,2963.055792,13.413405318888326,137,6.900000000000012E-4
9,test_20231101_140342,11079715.png,443815,89569,354246,0.798183927988013,3,4,124136,12624,111512,0.8983050847457628,19.33347911111111,2752.297077333333,13.73385051913707,137,6.900000000000012E-4
10,test_20231101_140342,11551286.png,271883,24,271859,0.9999117267353972,0,4,40092,1,40091,0.9999750573680535,24.866876444444443,3470.407338666667,12.72699907819776,137,6.900000000000012E-4
1,test_20231101_140343,10404007.png,502730,10072,492658,0.97996538897619,2,4,61265,1477,59788,0.9758916183791725,27.288881777777778,3845.415648,12.281370716389981,137,7.000000000000012E-4
2,test_20231101_140343,1254659.png,342646,51312,291334,0.850247777589699,3,4,80080,7252,72828,0.9094405594405595,24.177809777777778,4265.942901333333,11.830653226475647,137,7.000000000000012E-4
3,test_20231101_140343,10188041.png,221231,6617,214614,0.9700900868323156,1,3,41731,938,40793,0.9775227049435671,12.795395555555556,1592.7295573333333,16.10938321243044,137,7.000000000000012E-4
4,test_20231101_140343,10287332.png,216980,7742,209238,0.9643192921006545,1,3,22337,1063,21274,0.9524107982271567,11.905411555555556,1593.1080746666667,16.108351220163833,137,7.000000000000012E-4
5,test_20231101_140343,11610969.png,368720,10847,357873,0.9705820134519418,1,3,84111,1608,82503,0.9808824053928737,37.68496,6816.026848,9.79549068440944,137,7.000000000000012E-4
6,test_20231101_140343,10350842.png,212614,2104,210510,0.9901041323713397,1,3,42529,308,42221,0.9927578828564039,26.522588444444445,4134.640533333333,11.966426030073682,137,7.000000000000012E-4
7,test_20231101_140343,10863862.png,317432,4807,312625,0.9848565992086494,1,4,66058,706,65352,0.9893124224166642,40.71794311111111,7913.072912,9.14735193480679,137,7.000000000000012E-4
8,test_20231101_140343,11382381.png,312486,327,312159,0.9989535531191798,2,4,46745,44,46701,0.9990587228580596,23.441726222222222,2963.055792,13.413405318888326,137,7.000000000000012E-4
9,test_20231101_140343,11079715.png,443815,89569,354246,0.798183927988013,3,4,124136,12624,111512,0.8983050847457628,19.33347911111111,2752.297077333333,13.73385051913707,137,7.000000000000012E-4
10,test_20231101_140343,11551286.png,271883,24,271859,0.9999117267353972,0,4,40092,1,40091,0.9999750573680535,24.866876444444443,3470.407338666667,12.72699907819776,137,7.000000000000012E-4
1,test_20231101_140343,10404007.png,502730,10072,492658,0.97996538897619,2,4,61265,1477,59788,0.9758916183791725,27.288881777777778,3845.415648,12.281370716389981,137,7.100000000000012E-4
2,test_20231101_140343,1254659.png,342646,51312,291334,0.850247777589699,3,4,80080,7252,72828,0.9094405594405595,24.177809777777778,4265.942901333333,11.830653226475647,137,7.100000000000012E-4
3,test_20231101_140343,10188041.png,221231,6617,214614,0.9700900868323156,1,3,41731,938,40793,0.9775227049435671,12.795395555555556,1592.7295573333333,16.10938321243044,137,7.100000000000012E-4
4,test_20231101_140343,10287332.png,216980,7742,209238,0.9643192921006545,2,4,22337,1063,21274,0.9524107982271567,11.905411555555556,1593.1080746666667,16.108351220163833,137,7.100000000000012E-4
5,test_20231101_140343,11610969.png,368720,10847,357873,0.9705820134519418,2,4,84111,1608,82503,0.9808824053928737,37.68496,6816.026848,9.79549068440944,137,7.100000000000012E-4
6,test_20231101_140343,10350842.png,212614,2104,210510,0.9901041323713397,1,4,42529,308,42221,0.9927578828564039,26.522588444444445,4134.640533333333,11.966426030073682,137,7.100000000000012E-4
7,test_20231101_140343,10863862.png,317432,4807,312625,0.9848565992086494,1,4,66058,706,65352,0.9893124224166642,40.71794311111111,7913.072912,9.14735193480679,137,7.100000000000012E-4
8,test_20231101_140343,11382381.png,312486,327,312159,0.9989535531191798,1,4,46745,44,46701,0.9990587228580596,23.441726222222222,2963.055792,13.413405318888326,137,7.100000000000012E-4
9,test_20231101_140343,11079715.png,443815,89569,354246,0.798183927988013,3,4,124136,12624,111512,0.8983050847457628,19.33347911111111,2752.297077333333,13.73385051913707,137,7.100000000000012E-4
10,test_20231101_140343,11551286.png,271883,24,271859,0.9999117267353972,0,3,40092,1,40091,0.9999750573680535,24.866876444444443,3470.407338666667,12.72699907819776,137,7.100000000000012E-4
1,test_20231101_140344,10404007.png,502730,10072,492658,0.97996538897619,2,4,61265,1477,59788,0.9758916183791725,27.288881777777778,3845.415648,12.281370716389981,137,7.200000000000012E-4
2,test_20231101_140344,1254659.png,342646,51312,291334,0.850247777589699,3,4,80080,7252,72828,0.9094405594405595,24.177809777777778,4265.942901333333,11.830653226475647,137,7.200000000000012E-4
3,test_20231101_140344,10188041.png,221231,6617,214614,0.9700900868323156,3,4,41731,938,40793,0.9775227049435671,12.795395555555556,1592.7295573333333,16.10938321243044,137,7.200000000000012E-4
4,test_20231101_140344,10287332.png,216980,7742,209238,0.9643192921006545,1,3,22337,1063,21274,0.9524107982271567,11.905411555555556,1593.1080746666667,16.108351220163833,137,7.200000000000012E-4
5,test_20231101_140344,11610969.png,368720,10847,357873,0.9705820134519418,2,3,84111,1608,82503,0.9808824053928737,37.68496,6816.026848,9.79549068440944,137,7.200000000000012E-4
6,test_20231101_140344,10350842.png,212614,2104,210510,0.9901041323713397,1,3,42529,308,42221,0.9927578828564039,26.522588444444445,4134.640533333333,11.966426030073682,137,7.200000000000012E-4
7,test_20231101_140344,10863862.png,317432,4807,312625,0.9848565992086494,2,3,66058,706,65352,0.9893124224166642,40.71794311111111,7913.072912,9.14735193480679,137,7.200000000000012E-4
8,test_20231101_140344,11382381.png,312486,327,312159,0.9989535531191798,2,3,46745,44,46701,0.9990587228580596,23.441726222222222,2963.055792,13.413405318888326,137,7.200000000000012E-4
9,test_20231101_140344,11079715.png,443815,89569,354246,0.798183927988013,3,4,124136,12624,111512,0.8983050847457628,19.33347911111111,2752.297077333333,13.73385051913707,137,7.200000000000012E-4
10,test_20231101_140344,11551286.png,271883,24,271859,0.9999117267353972,1,4,40092,1,40091,0.9999750573680535,24.866876444444443,3470.407338666667,12.72699907819776,137,7.200000000000012E-4
1,test_20231101_140345,10404007.png,502730,10072,492658,0.97996538897619,2,4,61265,1477,59788,0.9758916183791725,27.288881777777778,3845.415648,12.281370716389981,137,7.300000000000013E-4
2,test_20231101_140345,1254659.png,342646,51312,291334,0.850247777589699,2,4,80080,7252,72828,0.9094405594405595,24.177809777777778,4265.942901333333,11.830653226475647,137,7.300000000000013E-4
3,test_20231101_140345,10188041.png,221231,6617,214614,0.9700900868323156,2,3,41731,938,40793,0.9775227049435671,12.795395555555556,1592.7295573333333,16.10938321243044,137,7.300000000000013E-4
4,test_20231101_140345,10287332.png,216980,7742,209238,0.9643192921006545,2,3,22337,1063,21274,0.9524107982271567,11.905411555555556,1593.1080746666667,16.108351220163833,137,7.300000000000013E-4
5,test_20231101_140345,11610969.png,368720,10847,357873,0.9705820134519418,1,3,84111,1608,82503,0.9808824053928737,37.68496,6816.026848,9.79549068440944,137,7.300000000000013E-4
6,test_20231101_140345,10350842.png,212614,2104,210510,0.9901041323713397,1,4,42529,308,42221,0.9927578828564039,26.522588444444445,4134.640533333333,11.966426030073682,137,7.300000000000013E-4
7,test_20231101_140345,10863862.png,317432,4807,312625,0.9848565992086494,2,4,66058,706,65352,0.9893124224166642,40.71794311111111,7913.072912,9.14735193480679,137,7.300000000000013E-4
8,test_20231101_140345,11382381.png,312486,327,312159,0.9989535531191798,1,4,46745,44,46701,0.9990587228580596,23.441726222222222,2963.055792,13.413405318888326,137,7.300000000000013E-4
9,test_20231101_140345,11079715.png,443815,89569,354246,0.798183927988013,3,4,124136,12624,111512,0.8983050847457628,19.33347911111111,2752.297077333333,13.73385051913707,137,7.300000000000013E-4
10,test_20231101_140345,11551286.png,271883,24,271859,0.9999117267353972,0,3,40092,1,40091,0.9999750573680535,24.866876444444443,3470.407338666667,12.72699907819776,137,7.300000000000013E-4
1,test_20231101_140345,10404007.png,502730,10072,492658,0.97996538897619,1,3,61265,1477,59788,0.9758916183791725,27.288881777777778,3845.415648,12.281370716389981,137,7.400000000000013E-4
2,test_20231101_140345,1254659.png,342646,51312,291334,0.850247777589699,2,3,80080,7252,72828,0.9094405594405595,24.177809777777778,4265.942901333333,11.830653226475647,137,7.400000000000013E-4
3,test_20231101_140345,10188041.png,221231,6617,214614,0.9700900868323156,2,4,41731,938,40793,0.9775227049435671,12.795395555555556,1592.7295573333333,16.10938321243044,137,7.400000000000013E-4
4,test_20231101_140345,10287332.png,216980,7742,209238,0.9643192921006545,1,3,22337,1063,21274,0.9524107982271567,11.905411555555556,1593.1080746666667,16.108351220163833,137,7.400000000000013E-4
5,test_20231101_140345,11610969.png,368720,10847,357873,0.9705820134519418,2,5,84111,1608,82503,0.9808824053928737,37.68496,6816.026848,9.79549068440944,137,7.400000000000013E-4
6,test_20231101_140345,10350842.png,212614,2104,210510,0.9901041323713397,1,3,42529,308,42221,0.9927578828564039,26.522588444444445,4134.640533333333,11.966426030073682,137,7.400000000000013E-4
7,test_20231101_140345,10863862.png,317432,4807,312625,0.9848565992086494,2,3,66058,706,65352,0.9893124224166642,40.71794311111111,7913.072912,9.14735193480679,137,7.400000000000013E-4
8,test_20231101_140345,11382381.png,312486,327,312159,0.9989535531191798,1,4,46745,44,46701,0.9990587228580596,23.441726222222222,2963.055792,13.413405318888326,137,7.400000000000013E-4
9,test_20231101_140345,11079715.png,443815,89569,354246,0.798183927988013,3,4,124136,12624,111512,0.8983050847457628,19.33347911111111,2752.297077333333,13.73385051913707,137,7.400000000000013E-4
10,test_20231101_140345,11551286.png,271883,24,271859,0.9999117267353972,1,3,40092,1,40091,0.9999750573680535,24.866876444444443,3470.407338666667,12.72699907819776,137,7.400000000000013E-4
1,test_20231101_140346,10404007.png,502730,10072,492658,0.97996538897619,2,3,61265,1477,59788,0.9758916183791725,27.288881777777778,3845.415648,12.281370716389981,137,7.500000000000013E-4
2,test_20231101_140346,1254659.png,342646,51312,291334,0.850247777589699,3,4,80080,7252,72828,0.9094405594405595,24.177809777777778,4265.942901333333,11.830653226475647,137,7.500000000000013E-4
3,test_20231101_140346,10188041.png,221231,6617,214614,0.9700900868323156,5,5,41731,938,40793,0.9775227049435671,12.795395555555556,1592.7295573333333,16.10938321243044,137,7.500000000000013E-4
4,test_20231101_140346,10287332.png,216980,7742,209238,0.9643192921006545,1,3,22337,1063,21274,0.9524107982271567,11.905411555555556,1593.1080746666667,16.108351220163833,137,7.500000000000013E-4
5,test_20231101_140346,11610969.png,368720,10847,357873,0.9705820134519418,2,3,84111,1608,82503,0.9808824053928737,37.68496,6816.026848,9.79549068440944,137,7.500000000000013E-4
6,test_20231101_140346,10350842.png,212614,2104,210510,0.9901041323713397,1,4,42529,308,42221,0.9927578828564039,26.522588444444445,4134.640533333333,11.966426030073682,137,7.500000000000013E-4
7,test_20231101_140346,10863862.png,317432,4807,312625,0.9848565992086494,2,3,66058,706,65352,0.9893124224166642,40.71794311111111,7913.072912,9.14735193480679,137,7.500000000000013E-4
8,test_20231101_140346,11382381.png,312486,327,312159,0.9989535531191798,1,4,46745,44,46701,0.9990587228580596,23.441726222222222,2963.055792,13.413405318888326,137,7.500000000000013E-4
9,test_20231101_140346,11079715.png,443815,89569,354246,0.798183927988013,3,4,124136,12624,111512,0.8983050847457628,19.33347911111111,2752.297077333333,13.73385051913707,137,7.500000000000013E-4
10,test_20231101_140346,11551286.png,271883,24,271859,0.9999117267353972,0,3,40092,1,40091,0.9999750573680535,24.866876444444443,3470.407338666667,12.72699907819776,137,7.500000000000013E-4
1,test_20231101_140347,10404007.png,502730,10072,492658,0.97996538897619,2,4,61265,1477,59788,0.9758916183791725,27.288881777777778,3845.415648,12.281370716389981,137,7.600000000000013E-4
2,test_20231101_140347,1254659.png,342646,51312,291334,0.850247777589699,3,4,80080,7252,72828,0.9094405594405595,24.177809777777778,4265.942901333333,11.830653226475647,137,7.600000000000013E-4
3,test_20231101_140347,10188041.png,221231,6617,214614,0.9700900868323156,2,4,41731,938,40793,0.9775227049435671,12.795395555555556,1592.7295573333333,16.10938321243044,137,7.600000000000013E-4
4,test_20231101_140347,10287332.png,216980,7602,209378,0.964964512858328,2,4,22337,1042,21295,0.9533509423825939,11.973063111111111,1604.10704,16.07847016040524,137,7.600000000000013E-4
5,test_20231101_140347,11610969.png,368720,10707,358013,0.9709617053590801,2,4,84111,1587,82524,0.9811320754716981,37.77502577777778,6841.876416,9.779051355575955,137,7.600000000000013E-4
6,test_20231101_140347,10350842.png,212614,2104,210510,0.9901041323713397,1,4,42529,308,42221,0.9927578828564039,26.522588444444445,4134.640533333333,11.966426030073682,137,7.600000000000013E-4
7,test_20231101_140347,10863862.png,317432,4787,312645,0.9849196048287507,1,4,66058,703,65355,0.9893578370522874,40.80527466666667,7941.242928,9.131918792813298,137,7.600000000000013E-4
8,test_20231101_140347,11382381.png,312486,327,312159,0.9989535531191798,1,3,46745,44,46701,0.9990587228580596,23.441726222222222,2963.055792,13.413405318888326,137,7.600000000000013E-4
9,test_20231101_140347,11079715.png,443815,89569,354246,0.798183927988013,3,4,124136,12624,111512,0.8983050847457628,19.33347911111111,2752.297077333333,13.73385051913707,137,7.600000000000013E-4
10,test_20231101_140347,11551286.png,271883,24,271859,0.9999117267353972,0,3,40092,1,40091,0.9999750573680535,24.866876444444443,3470.407338666667,12.72699907819776,137,7.600000000000013E-4
1,test_20231101_140347,10404007.png,502730,10072,492658,0.97996538897619,2,3,61265,1477,59788,0.9758916183791725,27.288881777777778,3845.415648,12.281370716389981,137,7.700000000000014E-4
2,test_20231101_140347,1254659.png,342646,51312,291334,0.850247777589699,2,3,80080,7252,72828,0.9094405594405595,24.177809777777778,4265.942901333333,11.830653226475647,137,7.700000000000014E-4
3,test_20231101_140347,10188041.png,221231,6617,214614,0.9700900868323156,2,3,41731,938,40793,0.9775227049435671,12.795395555555556,1592.7295573333333,16.10938321243044,137,7.700000000000014E-4
4,test_20231101_140347,10287332.png,216980,7602,209378,0.964964512858328,2,4,22337,1042,21295,0.9533509423825939,11.973063111111111,1604.10704,16.07847016040524,137,7.700000000000014E-4
5,test_20231101_140347,11610969.png,368720,10707,358013,0.9709617053590801,1,3,84111,1587,82524,0.9811320754716981,37.77502577777778,6841.876416,9.779051355575955,137,7.700000000000014E-4
6,test_20231101_140347,10350842.png,212614,2104,210510,0.9901041323713397,1,5,42529,308,42221,0.9927578828564039,26.522588444444445,4134.640533333333,11.966426030073682,137,7.700000000000014E-4
7,test_20231101_140347,10863862.png,317432,4787,312645,0.9849196048287507,1,3,66058,703,65355,0.9893578370522874,40.80527466666667,7941.242928,9.131918792813298,137,7.700000000000014E-4
8,test_20231101_140347,11382381.png,312486,327,312159,0.9989535531191798,2,3,46745,44,46701,0.9990587228580596,23.441726222222222,2963.055792,13.413405318888326,137,7.700000000000014E-4
9,test_20231101_140347,11079715.png,443815,89569,354246,0.798183927988013,3,4,124136,12624,111512,0.8983050847457628,19.33347911111111,2752.297077333333,13.73385051913707,137,7.700000000000014E-4
10,test_20231101_140347,11551286.png,271883,24,271859,0.9999117267353972,1,3,40092,1,40091,0.9999750573680535,24.866876444444443,3470.407338666667,12.72699907819776,137,7.700000000000014E-4
1,test_20231101_140348,10404007.png,502730,10072,492658,0.97996538897619,3,3,61265,1477,59788,0.9758916183791725,27.288881777777778,3845.415648,12.281370716389981,137,7.800000000000014E-4
2,test_20231101_140348,1254659.png,342646,51312,291334,0.850247777589699,3,4,80080,7252,72828,0.9094405594405595,24.177809777777778,4265.942901333333,11.830653226475647,137,7.800000000000014E-4
3,test_20231101_140348,10188041.png,221231,6617,214614,0.9700900868323156,2,4,41731,938,40793,0.9775227049435671,12.795395555555556,1592.7295573333333,16.10938321243044,137,7.800000000000014E-4
4,test_20231101_140348,10287332.png,216980,7602,209378,0.964964512858328,2,4,22337,1042,21295,0.9533509423825939,11.973063111111111,1604.10704,16.07847016040524,137,7.800000000000014E-4
5,test_20231101_140348,11610969.png,368720,10707,358013,0.9709617053590801,2,3,84111,1587,82524,0.9811320754716981,37.77502577777778,6841.876416,9.779051355575955,137,7.800000000000014E-4
6,test_20231101_140348,10350842.png,212614,2104,210510,0.9901041323713397,2,3,42529,308,42221,0.9927578828564039,26.522588444444445,4134.640533333333,11.966426030073682,137,7.800000000000014E-4
7,test_20231101_140348,10863862.png,317432,4787,312645,0.9849196048287507,1,3,66058,703,65355,0.9893578370522874,40.80527466666667,7941.242928,9.131918792813298,137,7.800000000000014E-4
8,test_20231101_140348,11382381.png,312486,327,312159,0.9989535531191798,1,4,46745,44,46701,0.9990587228580596,23.441726222222222,2963.055792,13.413405318888326,137,7.800000000000014E-4
9,test_20231101_140348,11079715.png,443815,89569,354246,0.798183927988013,4,4,124136,12624,111512,0.8983050847457628,19.33347911111111,2752.297077333333,13.73385051913707,137,7.800000000000014E-4
10,test_20231101_140348,11551286.png,271883,24,271859,0.9999117267353972,1,4,40092,1,40091,0.9999750573680535,24.866876444444443,3470.407338666667,12.72699907819776,137,7.800000000000014E-4
1,test_20231101_140349,10404007.png,502730,10072,492658,0.97996538897619,2,4,61265,1477,59788,0.9758916183791725,27.288881777777778,3845.415648,12.281370716389981,137,7.900000000000014E-4
2,test_20231101_140349,1254659.png,342646,51312,291334,0.850247777589699,3,4,80080,7252,72828,0.9094405594405595,24.177809777777778,4265.942901333333,11.830653226475647,137,7.900000000000014E-4
3,test_20231101_140349,10188041.png,221231,6617,214614,0.9700900868323156,2,4,41731,938,40793,0.9775227049435671,12.795395555555556,1592.7295573333333,16.10938321243044,137,7.900000000000014E-4
4,test_20231101_140349,10287332.png,216980,7602,209378,0.964964512858328,1,4,22337,1042,21295,0.9533509423825939,11.973063111111111,1604.10704,16.07847016040524,137,7.900000000000014E-4
5,test_20231101_140349,11610969.png,368720,10707,358013,0.9709617053590801,2,4,84111,1587,82524,0.9811320754716981,37.77502577777778,6841.876416,9.779051355575955,137,7.900000000000014E-4
6,test_20231101_140349,10350842.png,212614,2104,210510,0.9901041323713397,2,3,42529,308,42221,0.9927578828564039,26.522588444444445,4134.640533333333,11.966426030073682,137,7.900000000000014E-4
7,test_20231101_140349,10863862.png,317432,4787,312645,0.9849196048287507,1,3,66058,703,65355,0.9893578370522874,40.80527466666667,7941.242928,9.131918792813298,137,7.900000000000014E-4
8,test_20231101_140349,11382381.png,312486,327,312159,0.9989535531191798,2,3,46745,44,46701,0.9990587228580596,23.441726222222222,2963.055792,13.413405318888326,137,7.900000000000014E-4
9,test_20231101_140349,11079715.png,443815,89569,354246,0.798183927988013,3,4,124136,12624,111512,0.8983050847457628,19.33347911111111,2752.297077333333,13.73385051913707,137,7.900000000000014E-4
10,test_20231101_140349,11551286.png,271883,24,271859,0.9999117267353972,1,4,40092,1,40091,0.9999750573680535,24.866876444444443,3470.407338666667,12.72699907819776,137,7.900000000000014E-4
1,test_20231101_140349,10404007.png,502730,10072,492658,0.97996538897619,1,3,61265,1477,59788,0.9758916183791725,27.288881777777778,3845.415648,12.281370716389981,137,8.000000000000014E-4
2,test_20231101_140349,1254659.png,342646,51312,291334,0.850247777589699,3,4,80080,7252,72828,0.9094405594405595,24.177809777777778,4265.942901333333,11.830653226475647,137,8.000000000000014E-4
3,test_20231101_140349,10188041.png,221231,6617,214614,0.9700900868323156,2,4,41731,938,40793,0.9775227049435671,12.795395555555556,1592.7295573333333,16.10938321243044,137,8.000000000000014E-4
4,test_20231101_140349,10287332.png,216980,7602,209378,0.964964512858328,1,3,22337,1042,21295,0.9533509423825939,11.973063111111111,1604.10704,16.07847016040524,137,8.000000000000014E-4
5,test_20231101_140349,11610969.png,368720,10707,358013,0.9709617053590801,2,4,84111,1587,82524,0.9811320754716981,37.77502577777778,6841.876416,9.779051355575955,137,8.000000000000014E-4
6,test_20231101_140349,10350842.png,212614,2104,210510,0.9901041323713397,3,3,42529,308,42221,0.9927578828564039,26.522588444444445,4134.640533333333,11.966426030073682,137,8.000000000000014E-4
7,test_20231101_140349,10863862.png,317432,4787,312645,0.9849196048287507,2,4,66058,703,65355,0.9893578370522874,40.80527466666667,7941.242928,9.131918792813298,137,8.000000000000014E-4
8,test_20231101_140349,11382381.png,312486,327,312159,0.9989535531191798,1,3,46745,44,46701,0.9990587228580596,23.441726222222222,2963.055792,13.413405318888326,137,8.000000000000014E-4
9,test_20231101_140349,11079715.png,443815,89569,354246,0.798183927988013,3,4,124136,12624,111512,0.8983050847457628,19.33347911111111,2752.297077333333,13.73385051913707,137,8.000000000000014E-4
10,test_20231101_140349,11551286.png,271883,24,271859,0.9999117267353972,0,3,40092,1,40091,0.9999750573680535,24.866876444444443,3470.407338666667,12.72699907819776,137,8.000000000000014E-4
1,test_20231101_140350,10404007.png,502730,10072,492658,0.97996538897619,1,3,61265,1477,59788,0.9758916183791725,27.288881777777778,3845.415648,12.281370716389981,137,8.100000000000015E-4
2,test_20231101_140350,1254659.png,342646,51312,291334,0.850247777589699,2,4,80080,7252,72828,0.9094405594405595,24.177809777777778,4265.942901333333,11.830653226475647,137,8.100000000000015E-4
3,test_20231101_140350,10188041.png,221231,6617,214614,0.9700900868323156,1,3,41731,938,40793,0.9775227049435671,12.795395555555556,1592.7295573333333,16.10938321243044,137,8.100000000000015E-4
4,test_20231101_140350,10287332.png,216980,7602,209378,0.964964512858328,1,4,22337,1042,21295,0.9533509423825939,11.973063111111111,1604.10704,16.07847016040524,137,8.100000000000015E-4
5,test_20231101_140350,11610969.png,368720,10707,358013,0.9709617053590801,2,3,84111,1587,82524,0.9811320754716981,37.77502577777778,6841.876416,9.779051355575955,137,8.100000000000015E-4
6,test_20231101_140350,10350842.png,212614,2104,210510,0.9901041323713397,2,3,42529,308,42221,0.9927578828564039,26.522588444444445,4134.640533333333,11.966426030073682,137,8.100000000000015E-4
7,test_20231101_140350,10863862.png,317432,4787,312645,0.9849196048287507,2,3,66058,703,65355,0.9893578370522874,40.80527466666667,7941.242928,9.131918792813298,137,8.100000000000015E-4
8,test_20231101_140350,11382381.png,312486,327,312159,0.9989535531191798,1,4,46745,44,46701,0.9990587228580596,23.441726222222222,2963.055792,13.413405318888326,137,8.100000000000015E-4
9,test_20231101_140350,11079715.png,443815,89569,354246,0.798183927988013,3,4,124136,12624,111512,0.8983050847457628,19.33347911111111,2752.297077333333,13.73385051913707,137,8.100000000000015E-4
10,test_20231101_140350,11551286.png,271883,24,271859,0.9999117267353972,1,3,40092,1,40091,0.9999750573680535,24.866876444444443,3470.407338666667,12.72699907819776,137,8.100000000000015E-4
1,test_20231101_140351,10404007.png,502730,10072,492658,0.97996538897619,2,4,61265,1477,59788,0.9758916183791725,27.288881777777778,3845.415648,12.281370716389981,137,8.200000000000015E-4
2,test_20231101_140351,1254659.png,342646,51312,291334,0.850247777589699,2,4,80080,7252,72828,0.9094405594405595,24.177809777777778,4265.942901333333,11.830653226475647,137,8.200000000000015E-4
3,test_20231101_140351,10188041.png,221231,6617,214614,0.9700900868323156,2,3,41731,938,40793,0.9775227049435671,12.795395555555556,1592.7295573333333,16.10938321243044,137,8.200000000000015E-4
4,test_20231101_140351,10287332.png,216980,7602,209378,0.964964512858328,1,4,22337,1042,21295,0.9533509423825939,11.973063111111111,1604.10704,16.07847016040524,137,8.200000000000015E-4
5,test_20231101_140351,11610969.png,368720,10707,358013,0.9709617053590801,2,3,84111,1587,82524,0.9811320754716981,37.77502577777778,6841.876416,9.779051355575955,137,8.200000000000015E-4
6,test_20231101_140351,10350842.png,212614,2104,210510,0.9901041323713397,2,4,42529,308,42221,0.9927578828564039,26.522588444444445,4134.640533333333,11.966426030073682,137,8.200000000000015E-4
7,test_20231101_140351,10863862.png,317432,4787,312645,0.9849196048287507,1,3,66058,703,65355,0.9893578370522874,40.80527466666667,7941.242928,9.131918792813298,137,8.200000000000015E-4
8,test_20231101_140351,11382381.png,312486,327,312159,0.9989535531191798,2,3,46745,44,46701,0.9990587228580596,23.441726222222222,2963.055792,13.413405318888326,137,8.200000000000015E-4
9,test_20231101_140351,11079715.png,443815,89569,354246,0.798183927988013,3,4,124136,12624,111512,0.8983050847457628,19.33347911111111,2752.297077333333,13.73385051913707,137,8.200000000000015E-4
10,test_20231101_140351,11551286.png,271883,24,271859,0.9999117267353972,1,3,40092,1,40091,0.9999750573680535,24.866876444444443,3470.407338666667,12.72699907819776,137,8.200000000000015E-4
1,test_20231101_140351,10404007.png,502730,10072,492658,0.97996538897619,2,3,61265,1477,59788,0.9758916183791725,27.288881777777778,3845.415648,12.281370716389981,137,8.300000000000015E-4
2,test_20231101_140351,1254659.png,342646,51312,291334,0.850247777589699,2,3,80080,7252,72828,0.9094405594405595,24.177809777777778,4265.942901333333,11.830653226475647,137,8.300000000000015E-4
3,test_20231101_140351,10188041.png,221231,6617,214614,0.9700900868323156,2,3,41731,938,40793,0.9775227049435671,12.795395555555556,1592.7295573333333,16.10938321243044,137,8.300000000000015E-4
4,test_20231101_140351,10287332.png,216980,7602,209378,0.964964512858328,2,4,22337,1042,21295,0.9533509423825939,11.973063111111111,1604.10704,16.07847016040524,137,8.300000000000015E-4
5,test_20231101_140351,11610969.png,368720,10707,358013,0.9709617053590801,1,4,84111,1587,82524,0.9811320754716981,37.77502577777778,6841.876416,9.779051355575955,137,8.300000000000015E-4
6,test_20231101_140351,10350842.png,212614,2104,210510,0.9901041323713397,1,4,42529,308,42221,0.9927578828564039,26.522588444444445,4134.640533333333,11.966426030073682,137,8.300000000000015E-4
7,test_20231101_140351,10863862.png,317432,4787,312645,0.9849196048287507,1,6,66058,703,65355,0.9893578370522874,40.80527466666667,7941.242928,9.131918792813298,137,8.300000000000015E-4
8,test_20231101_140351,11382381.png,312486,327,312159,0.9989535531191798,1,3,46745,44,46701,0.9990587228580596,23.441726222222222,2963.055792,13.413405318888326,137,8.300000000000015E-4
9,test_20231101_140351,11079715.png,443815,89569,354246,0.798183927988013,3,4,124136,12624,111512,0.8983050847457628,19.33347911111111,2752.297077333333,13.73385051913707,137,8.300000000000015E-4
10,test_20231101_140351,11551286.png,271883,24,271859,0.9999117267353972,1,4,40092,1,40091,0.9999750573680535,24.866876444444443,3470.407338666667,12.72699907819776,137,8.300000000000015E-4
1,test_20231101_140352,10404007.png,502730,10072,492658,0.97996538897619,2,4,61265,1477,59788,0.9758916183791725,27.288881777777778,3845.415648,12.281370716389981,137,8.400000000000016E-4
2,test_20231101_140352,1254659.png,342646,51312,291334,0.850247777589699,3,4,80080,7252,72828,0.9094405594405595,24.177809777777778,4265.942901333333,11.830653226475647,137,8.400000000000016E-4
3,test_20231101_140352,10188041.png,221231,6617,214614,0.9700900868323156,1,3,41731,938,40793,0.9775227049435671,12.795395555555556,1592.7295573333333,16.10938321243044,137,8.400000000000016E-4
4,test_20231101_140352,10287332.png,216980,7602,209378,0.964964512858328,1,3,22337,1042,21295,0.9533509423825939,11.973063111111111,1604.10704,16.07847016040524,137,8.400000000000016E-4
5,test_20231101_140352,11610969.png,368720,10707,358013,0.9709617053590801,2,4,84111,1587,82524,0.9811320754716981,37.77502577777778,6841.876416,9.779051355575955,137,8.400000000000016E-4
6,test_20231101_140352,10350842.png,212614,2104,210510,0.9901041323713397,1,3,42529,308,42221,0.9927578828564039,26.522588444444445,4134.640533333333,11.966426030073682,137,8.400000000000016E-4
7,test_20231101_140352,10863862.png,317432,4787,312645,0.9849196048287507,2,3,66058,703,65355,0.9893578370522874,40.80527466666667,7941.242928,9.131918792813298,137,8.400000000000016E-4
8,test_20231101_140352,11382381.png,312486,327,312159,0.9989535531191798,2,3,46745,44,46701,0.9990587228580596,23.441726222222222,2963.055792,13.413405318888326,137,8.400000000000016E-4
9,test_20231101_140352,11079715.png,443815,89569,354246,0.798183927988013,3,4,124136,12624,111512,0.8983050847457628,19.33347911111111,2752.297077333333,13.73385051913707,137,8.400000000000016E-4
10,test_20231101_140352,11551286.png,271883,24,271859,0.9999117267353972,0,3,40092,1,40091,0.9999750573680535,24.866876444444443,3470.407338666667,12.72699907819776,137,8.400000000000016E-4
1,test_20231101_140353,10404007.png,502730,10072,492658,0.97996538897619,2,4,61265,1477,59788,0.9758916183791725,27.288881777777778,3845.415648,12.281370716389981,137,8.500000000000016E-4
2,test_20231101_140353,1254659.png,342646,51312,291334,0.850247777589699,3,4,80080,7252,72828,0.9094405594405595,24.177809777777778,4265.942901333333,11.830653226475647,137,8.500000000000016E-4
3,test_20231101_140353,10188041.png,221231,6617,214614,0.9700900868323156,2,4,41731,938,40793,0.9775227049435671,12.795395555555556,1592.7295573333333,16.10938321243044,137,8.500000000000016E-4
4,test_20231101_140353,10287332.png,216980,7602,209378,0.964964512858328,1,3,22337,1042,21295,0.9533509423825939,11.973063111111111,1604.10704,16.07847016040524,137,8.500000000000016E-4
5,test_20231101_140353,11610969.png,368720,10707,358013,0.9709617053590801,1,3,84111,1587,82524,0.9811320754716981,37.77502577777778,6841.876416,9.779051355575955,137,8.500000000000016E-4
6,test_20231101_140353,10350842.png,212614,2104,210510,0.9901041323713397,1,3,42529,308,42221,0.9927578828564039,26.522588444444445,4134.640533333333,11.966426030073682,137,8.500000000000016E-4
7,test_20231101_140353,10863862.png,317432,4787,312645,0.9849196048287507,1,3,66058,703,65355,0.9893578370522874,40.80527466666667,7941.242928,9.131918792813298,137,8.500000000000016E-4
8,test_20231101_140353,11382381.png,312486,327,312159,0.9989535531191798,1,3,46745,44,46701,0.9990587228580596,23.441726222222222,2963.055792,13.413405318888326,137,8.500000000000016E-4
9,test_20231101_140353,11079715.png,443815,89569,354246,0.798183927988013,3,4,124136,12624,111512,0.8983050847457628,19.33347911111111,2752.297077333333,13.73385051913707,137,8.500000000000016E-4
10,test_20231101_140353,11551286.png,271883,24,271859,0.9999117267353972,1,4,40092,1,40091,0.9999750573680535,24.866876444444443,3470.407338666667,12.72699907819776,137,8.500000000000016E-4
1,test_20231101_140353,10404007.png,502730,10072,492658,0.97996538897619,2,4,61265,1477,59788,0.9758916183791725,27.288881777777778,3845.415648,12.281370716389981,137,8.600000000000016E-4
2,test_20231101_140353,1254659.png,342646,51312,291334,0.850247777589699,3,4,80080,7252,72828,0.9094405594405595,24.177809777777778,4265.942901333333,11.830653226475647,137,8.600000000000016E-4
3,test_20231101_140353,10188041.png,221231,6617,214614,0.9700900868323156,2,8,41731,938,40793,0.9775227049435671,12.795395555555556,1592.7295573333333,16.10938321243044,137,8.600000000000016E-4
4,test_20231101_140353,10287332.png,216980,7602,209378,0.964964512858328,1,3,22337,1042,21295,0.9533509423825939,11.973063111111111,1604.10704,16.07847016040524,137,8.600000000000016E-4
5,test_20231101_140353,11610969.png,368720,10707,358013,0.9709617053590801,2,4,84111,1587,82524,0.9811320754716981,37.77502577777778,6841.876416,9.779051355575955,137,8.600000000000016E-4
6,test_20231101_140353,10350842.png,212614,2104,210510,0.9901041323713397,1,4,42529,308,42221,0.9927578828564039,26.522588444444445,4134.640533333333,11.966426030073682,137,8.600000000000016E-4
7,test_20231101_140353,10863862.png,317432,4787,312645,0.9849196048287507,1,4,66058,703,65355,0.9893578370522874,40.80527466666667,7941.242928,9.131918792813298,137,8.600000000000016E-4
8,test_20231101_140353,11382381.png,312486,327,312159,0.9989535531191798,2,3,46745,44,46701,0.9990587228580596,23.441726222222222,2963.055792,13.413405318888326,137,8.600000000000016E-4
9,test_20231101_140353,11079715.png,443815,89569,354246,0.798183927988013,3,4,124136,12624,111512,0.8983050847457628,19.33347911111111,2752.297077333333,13.73385051913707,137,8.600000000000016E-4
10,test_20231101_140353,11551286.png,271883,24,271859,0.9999117267353972,0,4,40092,1,40091,0.9999750573680535,24.866876444444443,3470.407338666667,12.72699907819776,137,8.600000000000016E-4
1,test_20231101_140354,10404007.png,502730,10072,492658,0.97996538897619,1,3,61265,1477,59788,0.9758916183791725,27.288881777777778,3845.415648,12.281370716389981,137,8.700000000000016E-4
2,test_20231101_140354,1254659.png,342646,51312,291334,0.850247777589699,3,4,80080,7252,72828,0.9094405594405595,24.177809777777778,4265.942901333333,11.830653226475647,137,8.700000000000016E-4
3,test_20231101_140354,10188041.png,221231,6617,214614,0.9700900868323156,2,3,41731,938,40793,0.9775227049435671,12.795395555555556,1592.7295573333333,16.10938321243044,137,8.700000000000016E-4
4,test_20231101_140354,10287332.png,216980,7602,209378,0.964964512858328,2,3,22337,1042,21295,0.9533509423825939,11.973063111111111,1604.10704,16.07847016040524,137,8.700000000000016E-4
5,test_20231101_140354,11610969.png,368720,10707,358013,0.9709617053590801,2,4,84111,1587,82524,0.9811320754716981,37.77502577777778,6841.876416,9.779051355575955,137,8.700000000000016E-4
6,test_20231101_140354,10350842.png,212614,2104,210510,0.9901041323713397,1,4,42529,308,42221,0.9927578828564039,26.522588444444445,4134.640533333333,11.966426030073682,137,8.700000000000016E-4
7,test_20231101_140354,10863862.png,317432,4787,312645,0.9849196048287507,1,4,66058,703,65355,0.9893578370522874,40.80527466666667,7941.242928,9.131918792813298,137,8.700000000000016E-4
8,test_20231101_140354,11382381.png,312486,327,312159,0.9989535531191798,1,4,46745,44,46701,0.9990587228580596,23.441726222222222,2963.055792,13.413405318888326,137,8.700000000000016E-4
9,test_20231101_140354,11079715.png,443815,89569,354246,0.798183927988013,7,4,124136,12624,111512,0.8983050847457628,19.33347911111111,2752.297077333333,13.73385051913707,137,8.700000000000016E-4
10,test_20231101_140354,11551286.png,271883,24,271859,0.9999117267353972,1,4,40092,1,40091,0.9999750573680535,24.866876444444443,3470.407338666667,12.72699907819776,137,8.700000000000016E-4
1,test_20231101_140355,10404007.png,502730,10072,492658,0.97996538897619,3,3,61265,1477,59788,0.9758916183791725,27.288881777777778,3845.415648,12.281370716389981,137,8.800000000000017E-4
2,test_20231101_140355,1254659.png,342646,51312,291334,0.850247777589699,3,4,80080,7252,72828,0.9094405594405595,24.177809777777778,4265.942901333333,11.830653226475647,137,8.800000000000017E-4
3,test_20231101_140355,10188041.png,221231,6617,214614,0.9700900868323156,2,4,41731,938,40793,0.9775227049435671,12.795395555555556,1592.7295573333333,16.10938321243044,137,8.800000000000017E-4
4,test_20231101_140355,10287332.png,216980,7602,209378,0.964964512858328,1,3,22337,1042,21295,0.9533509423825939,11.973063111111111,1604.10704,16.07847016040524,137,8.800000000000017E-4
5,test_20231101_140355,11610969.png,368720,10707,358013,0.9709617053590801,2,4,84111,1587,82524,0.9811320754716981,37.77502577777778,6841.876416,9.779051355575955,137,8.800000000000017E-4
6,test_20231101_140355,10350842.png,212614,2104,210510,0.9901041323713397,2,4,42529,308,42221,0.9927578828564039,26.522588444444445,4134.640533333333,11.966426030073682,137,8.800000000000017E-4
7,test_20231101_140355,10863862.png,317432,4787,312645,0.9849196048287507,2,4,66058,703,65355,0.9893578370522874,40.80527466666667,7941.242928,9.131918792813298,137,8.800000000000017E-4
8,test_20231101_140355,11382381.png,312486,327,312159,0.9989535531191798,1,3,46745,44,46701,0.9990587228580596,23.441726222222222,2963.055792,13.413405318888326,137,8.800000000000017E-4
9,test_20231101_140355,11079715.png,443815,89569,354246,0.798183927988013,3,4,124136,12624,111512,0.8983050847457628,19.33347911111111,2752.297077333333,13.73385051913707,137,8.800000000000017E-4
10,test_20231101_140355,11551286.png,271883,24,271859,0.9999117267353972,0,3,40092,1,40091,0.9999750573680535,24.866876444444443,3470.407338666667,12.72699907819776,137,8.800000000000017E-4
1,test_20231101_140355,10404007.png,502730,10072,492658,0.97996538897619,2,4,61265,1477,59788,0.9758916183791725,27.288881777777778,3845.415648,12.281370716389981,137,8.900000000000017E-4
2,test_20231101_140355,1254659.png,342646,51312,291334,0.850247777589699,3,4,80080,7252,72828,0.9094405594405595,24.177809777777778,4265.942901333333,11.830653226475647,137,8.900000000000017E-4
3,test_20231101_140355,10188041.png,221231,6617,214614,0.9700900868323156,2,3,41731,938,40793,0.9775227049435671,12.795395555555556,1592.7295573333333,16.10938321243044,137,8.900000000000017E-4
4,test_20231101_140355,10287332.png,216980,7602,209378,0.964964512858328,2,3,22337,1042,21295,0.9533509423825939,11.973063111111111,1604.10704,16.07847016040524,137,8.900000000000017E-4
5,test_20231101_140355,11610969.png,368720,10707,358013,0.9709617053590801,1,3,84111,1587,82524,0.9811320754716981,37.77502577777778,6841.876416,9.779051355575955,137,8.900000000000017E-4
6,test_20231101_140355,10350842.png,212614,2104,210510,0.9901041323713397,1,4,42529,308,42221,0.9927578828564039,26.522588444444445,4134.640533333333,11.966426030073682,137,8.900000000000017E-4
7,test_20231101_140355,10863862.png,317432,4787,312645,0.9849196048287507,1,4,66058,703,65355,0.9893578370522874,40.80527466666667,7941.242928,9.131918792813298,137,8.900000000000017E-4
8,test_20231101_140355,11382381.png,312486,327,312159,0.9989535531191798,1,4,46745,44,46701,0.9990587228580596,23.441726222222222,2963.055792,13.413405318888326,137,8.900000000000017E-4
9,test_20231101_140355,11079715.png,443815,89569,354246,0.798183927988013,3,4,124136,12624,111512,0.8983050847457628,19.33347911111111,2752.297077333333,13.73385051913707,137,8.900000000000017E-4
10,test_20231101_140355,11551286.png,271883,24,271859,0.9999117267353972,1,3,40092,1,40091,0.9999750573680535,24.866876444444443,3470.407338666667,12.72699907819776,137,8.900000000000017E-4
1,test_20231101_140356,10404007.png,502730,10072,492658,0.97996538897619,2,4,61265,1477,59788,0.9758916183791725,27.288881777777778,3845.415648,12.281370716389981,137,9.000000000000017E-4
2,test_20231101_140356,1254659.png,342646,51312,291334,0.850247777589699,3,4,80080,7252,72828,0.9094405594405595,24.177809777777778,4265.942901333333,11.830653226475647,137,9.000000000000017E-4
3,test_20231101_140356,10188041.png,221231,6617,214614,0.9700900868323156,2,4,41731,938,40793,0.9775227049435671,12.795395555555556,1592.7295573333333,16.10938321243044,137,9.000000000000017E-4
4,test_20231101_140356,10287332.png,216980,7602,209378,0.964964512858328,1,4,22337,1042,21295,0.9533509423825939,11.973063111111111,1604.10704,16.07847016040524,137,9.000000000000017E-4
5,test_20231101_140356,11610969.png,368720,10707,358013,0.9709617053590801,2,4,84111,1587,82524,0.9811320754716981,37.77502577777778,6841.876416,9.779051355575955,137,9.000000000000017E-4
6,test_20231101_140356,10350842.png,212614,2104,210510,0.9901041323713397,1,4,42529,308,42221,0.9927578828564039,26.522588444444445,4134.640533333333,11.966426030073682,137,9.000000000000017E-4
7,test_20231101_140356,10863862.png,317432,4787,312645,0.9849196048287507,2,3,66058,703,65355,0.9893578370522874,40.80527466666667,7941.242928,9.131918792813298,137,9.000000000000017E-4
8,test_20231101_140356,11382381.png,312486,327,312159,0.9989535531191798,1,3,46745,44,46701,0.9990587228580596,23.441726222222222,2963.055792,13.413405318888326,137,9.000000000000017E-4
9,test_20231101_140356,11079715.png,443815,89569,354246,0.798183927988013,3,4,124136,12624,111512,0.8983050847457628,19.33347911111111,2752.297077333333,13.73385051913707,137,9.000000000000017E-4
10,test_20231101_140356,11551286.png,271883,24,271859,0.9999117267353972,1,3,40092,1,40091,0.9999750573680535,24.866876444444443,3470.407338666667,12.72699907819776,137,9.000000000000017E-4
1,test_20231101_140357,10404007.png,502730,10072,492658,0.97996538897619,1,3,61265,1477,59788,0.9758916183791725,27.288881777777778,3845.415648,12.281370716389981,137,9.100000000000017E-4
2,test_20231101_140357,1254659.png,342646,51312,291334,0.850247777589699,2,3,80080,7252,72828,0.9094405594405595,24.177809777777778,4265.942901333333,11.830653226475647,137,9.100000000000017E-4
3,test_20231101_140357,10188041.png,221231,6617,214614,0.9700900868323156,1,3,41731,938,40793,0.9775227049435671,12.795395555555556,1592.7295573333333,16.10938321243044,137,9.100000000000017E-4
4,test_20231101_140357,10287332.png,216980,7602,209378,0.964964512858328,2,4,22337,1042,21295,0.9533509423825939,11.973063111111111,1604.10704,16.07847016040524,137,9.100000000000017E-4
5,test_20231101_140357,11610969.png,368720,10707,358013,0.9709617053590801,3,3,84111,1587,82524,0.9811320754716981,37.77502577777778,6841.876416,9.779051355575955,137,9.100000000000017E-4
6,test_20231101_140357,10350842.png,212614,24,212590,0.9998871193806617,1,3,42529,1,42528,0.9999764866326507,55.22670577777778,11938.01408,7.361482740939017,137,9.100000000000017E-4
7,test_20231101_140357,10863862.png,317432,4787,312645,0.9849196048287507,1,4,66058,703,65355,0.9893578370522874,40.80527466666667,7941.242928,9.131918792813298,137,9.100000000000017E-4
8,test_20231101_140357,11382381.png,312486,327,312159,0.9989535531191798,1,4,46745,44,46701,0.9990587228580596,23.441726222222222,2963.055792,13.413405318888326,137,9.100000000000017E-4
9,test_20231101_140357,11079715.png,443815,89569,354246,0.798183927988013,4,5,124136,12624,111512,0.8983050847457628,19.33347911111111,2752.297077333333,13.73385051913707,137,9.100000000000017E-4
10,test_20231101_140357,11551286.png,271883,24,271859,0.9999117267353972,1,3,40092,1,40091,0.9999750573680535,24.866876444444443,3470.407338666667,12.72699907819776,137,9.100000000000017E-4
1,test_20231101_140357,10404007.png,502730,10072,492658,0.97996538897619,3,6,61265,1477,59788,0.9758916183791725,27.288881777777778,3845.415648,12.281370716389981,137,9.200000000000018E-4
2,test_20231101_140357,1254659.png,342646,51312,291334,0.850247777589699,2,3,80080,7252,72828,0.9094405594405595,24.177809777777778,4265.942901333333,11.830653226475647,137,9.200000000000018E-4
3,test_20231101_140357,10188041.png,221231,6617,214614,0.9700900868323156,2,3,41731,938,40793,0.9775227049435671,12.795395555555556,1592.7295573333333,16.10938321243044,137,9.200000000000018E-4
4,test_20231101_140357,10287332.png,216980,7602,209378,0.964964512858328,2,4,22337,1042,21295,0.9533509423825939,11.973063111111111,1604.10704,16.07847016040524,137,9.200000000000018E-4
5,test_20231101_140357,11610969.png,368720,10707,358013,0.9709617053590801,2,4,84111,1587,82524,0.9811320754716981,37.77502577777778,6841.876416,9.779051355575955,137,9.200000000000018E-4
6,test_20231101_140357,10350842.png,212614,24,212590,0.9998871193806617,0,3,42529,1,42528,0.9999764866326507,55.22670577777778,11938.01408,7.361482740939017,137,9.200000000000018E-4
7,test_20231101_140357,10863862.png,317432,4787,312645,0.9849196048287507,2,4,66058,703,65355,0.9893578370522874,40.80527466666667,7941.242928,9.131918792813298,137,9.200000000000018E-4
8,test_20231101_140357,11382381.png,312486,327,312159,0.9989535531191798,1,4,46745,44,46701,0.9990587228580596,23.441726222222222,2963.055792,13.413405318888326,137,9.200000000000018E-4
9,test_20231101_140357,11079715.png,443815,89569,354246,0.798183927988013,3,4,124136,12624,111512,0.8983050847457628,19.33347911111111,2752.297077333333,13.73385051913707,137,9.200000000000018E-4
10,test_20231101_140357,11551286.png,271883,24,271859,0.9999117267353972,1,4,40092,1,40091,0.9999750573680535,24.866876444444443,3470.407338666667,12.72699907819776,137,9.200000000000018E-4
1,test_20231101_140358,10404007.png,502730,10072,492658,0.97996538897619,2,4,61265,1477,59788,0.9758916183791725,27.288881777777778,3845.415648,12.281370716389981,137,9.300000000000018E-4
2,test_20231101_140358,1254659.png,342646,51312,291334,0.850247777589699,3,4,80080,7252,72828,0.9094405594405595,24.177809777777778,4265.942901333333,11.830653226475647,137,9.300000000000018E-4
3,test_20231101_140358,10188041.png,221231,6617,214614,0.9700900868323156,2,4,41731,938,40793,0.9775227049435671,12.795395555555556,1592.7295573333333,16.10938321243044,137,9.300000000000018E-4
4,test_20231101_140358,10287332.png,216980,7602,209378,0.964964512858328,2,3,22337,1042,21295,0.9533509423825939,11.973063111111111,1604.10704,16.07847016040524,137,9.300000000000018E-4
5,test_20231101_140358,11610969.png,368720,10707,358013,0.9709617053590801,1,3,84111,1587,82524,0.9811320754716981,37.77502577777778,6841.876416,9.779051355575955,137,9.300000000000018E-4
6,test_20231101_140358,10350842.png,212614,24,212590,0.9998871193806617,1,4,42529,1,42528,0.9999764866326507,55.22670577777778,11938.01408,7.361482740939017,137,9.300000000000018E-4
7,test_20231101_140358,10863862.png,317432,4787,312645,0.9849196048287507,2,3,66058,703,65355,0.9893578370522874,40.80527466666667,7941.242928,9.131918792813298,137,9.300000000000018E-4
8,test_20231101_140358,11382381.png,312486,327,312159,0.9989535531191798,1,3,46745,44,46701,0.9990587228580596,23.441726222222222,2963.055792,13.413405318888326,137,9.300000000000018E-4
9,test_20231101_140358,11079715.png,443815,89569,354246,0.798183927988013,3,4,124136,12624,111512,0.8983050847457628,19.33347911111111,2752.297077333333,13.73385051913707,137,9.300000000000018E-4
10,test_20231101_140358,11551286.png,271883,24,271859,0.9999117267353972,0,4,40092,1,40091,0.9999750573680535,24.866876444444443,3470.407338666667,12.72699907819776,137,9.300000000000018E-4
1,test_20231101_140359,10404007.png,502730,10072,492658,0.97996538897619,1,3,61265,1477,59788,0.9758916183791725,27.288881777777778,3845.415648,12.281370716389981,137,9.400000000000018E-4
2,test_20231101_140359,1254659.png,342646,51312,291334,0.850247777589699,3,4,80080,7252,72828,0.9094405594405595,24.177809777777778,4265.942901333333,11.830653226475647,137,9.400000000000018E-4
3,test_20231101_140359,10188041.png,221231,6617,214614,0.9700900868323156,2,4,41731,938,40793,0.9775227049435671,12.795395555555556,1592.7295573333333,16.10938321243044,137,9.400000000000018E-4
4,test_20231101_140359,10287332.png,216980,7602,209378,0.964964512858328,1,4,22337,1042,21295,0.9533509423825939,11.973063111111111,1604.10704,16.07847016040524,137,9.400000000000018E-4
5,test_20231101_140359,11610969.png,368720,10707,358013,0.9709617053590801,2,3,84111,1587,82524,0.9811320754716981,37.77502577777778,6841.876416,9.779051355575955,137,9.400000000000018E-4
6,test_20231101_140359,10350842.png,212614,24,212590,0.9998871193806617,1,3,42529,1,42528,0.9999764866326507,55.22670577777778,11938.01408,7.361482740939017,137,9.400000000000018E-4
7,test_20231101_140359,10863862.png,317432,4787,312645,0.9849196048287507,1,4,66058,703,65355,0.9893578370522874,40.80527466666667,7941.242928,9.131918792813298,137,9.400000000000018E-4
8,test_20231101_140359,11382381.png,312486,327,312159,0.9989535531191798,1,4,46745,44,46701,0.9990587228580596,23.441726222222222,2963.055792,13.413405318888326,137,9.400000000000018E-4
9,test_20231101_140359,11079715.png,443815,89569,354246,0.798183927988013,5,4,124136,12624,111512,0.8983050847457628,19.33347911111111,2752.297077333333,13.73385051913707,137,9.400000000000018E-4
10,test_20231101_140359,11551286.png,271883,24,271859,0.9999117267353972,1,4,40092,1,40091,0.9999750573680535,24.866876444444443,3470.407338666667,12.72699907819776,137,9.400000000000018E-4
1,test_20231101_140359,10404007.png,502730,10072,492658,0.97996538897619,2,4,61265,1477,59788,0.9758916183791725,27.288881777777778,3845.415648,12.281370716389981,137,9.500000000000018E-4
2,test_20231101_140359,1254659.png,342646,51312,291334,0.850247777589699,2,4,80080,7252,72828,0.9094405594405595,24.177809777777778,4265.942901333333,11.830653226475647,137,9.500000000000018E-4
3,test_20231101_140359,10188041.png,221231,6617,214614,0.9700900868323156,2,3,41731,938,40793,0.9775227049435671,12.795395555555556,1592.7295573333333,16.10938321243044,137,9.500000000000018E-4
4,test_20231101_140359,10287332.png,216980,7602,209378,0.964964512858328,1,3,22337,1042,21295,0.9533509423825939,11.973063111111111,1604.10704,16.07847016040524,137,9.500000000000018E-4
5,test_20231101_140359,11610969.png,368720,10707,358013,0.9709617053590801,2,3,84111,1587,82524,0.9811320754716981,37.77502577777778,6841.876416,9.779051355575955,137,9.500000000000018E-4
6,test_20231101_140359,10350842.png,212614,24,212590,0.9998871193806617,0,3,42529,1,42528,0.9999764866326507,55.22670577777778,11938.01408,7.361482740939017,137,9.500000000000018E-4
7,test_20231101_140359,10863862.png,317432,4787,312645,0.9849196048287507,1,3,66058,703,65355,0.9893578370522874,40.80527466666667,7941.242928,9.131918792813298,137,9.500000000000018E-4
8,test_20231101_140359,11382381.png,312486,327,312159,0.9989535531191798,2,4,46745,44,46701,0.9990587228580596,23.441726222222222,2963.055792,13.413405318888326,137,9.500000000000018E-4
9,test_20231101_140359,11079715.png,443815,89569,354246,0.798183927988013,3,4,124136,12624,111512,0.8983050847457628,19.33347911111111,2752.297077333333,13.73385051913707,137,9.500000000000018E-4
10,test_20231101_140359,11551286.png,271883,24,271859,0.9999117267353972,0,3,40092,1,40091,0.9999750573680535,24.866876444444443,3470.407338666667,12.72699907819776,137,9.500000000000018E-4
1,test_20231101_140400,10404007.png,502730,10072,492658,0.97996538897619,2,4,61265,1477,59788,0.9758916183791725,27.288881777777778,3845.415648,12.281370716389981,137,9.600000000000019E-4
2,test_20231101_140400,1254659.png,342646,51312,291334,0.850247777589699,2,3,80080,7252,72828,0.9094405594405595,24.177809777777778,4265.942901333333,11.830653226475647,137,9.600000000000019E-4
3,test_20231101_140400,10188041.png,221231,6617,214614,0.9700900868323156,2,3,41731,938,40793,0.9775227049435671,12.795395555555556,1592.7295573333333,16.10938321243044,137,9.600000000000019E-4
4,test_20231101_140400,10287332.png,216980,7602,209378,0.964964512858328,2,3,22337,1042,21295,0.9533509423825939,11.973063111111111,1604.10704,16.07847016040524,137,9.600000000000019E-4
5,test_20231101_140400,11610969.png,368720,10707,358013,0.9709617053590801,1,3,84111,1587,82524,0.9811320754716981,37.77502577777778,6841.876416,9.779051355575955,137,9.600000000000019E-4
6,test_20231101_140400,10350842.png,212614,24,212590,0.9998871193806617,1,3,42529,1,42528,0.9999764866326507,55.22670577777778,11938.01408,7.361482740939017,137,9.600000000000019E-4
7,test_20231101_140400,10863862.png,317432,4787,312645,0.9849196048287507,1,4,66058,703,65355,0.9893578370522874,40.80527466666667,7941.242928,9.131918792813298,137,9.600000000000019E-4
8,test_20231101_140400,11382381.png,312486,327,312159,0.9989535531191798,1,4,46745,44,46701,0.9990587228580596,23.441726222222222,2963.055792,13.413405318888326,137,9.600000000000019E-4
9,test_20231101_140400,11079715.png,443815,89569,354246,0.798183927988013,3,4,124136,12624,111512,0.8983050847457628,19.33347911111111,2752.297077333333,13.73385051913707,137,9.600000000000019E-4
10,test_20231101_140400,11551286.png,271883,24,271859,0.9999117267353972,1,4,40092,1,40091,0.9999750573680535,24.866876444444443,3470.407338666667,12.72699907819776,137,9.600000000000019E-4
1,test_20231101_140401,10404007.png,502730,10072,492658,0.97996538897619,2,4,61265,1477,59788,0.9758916183791725,27.288881777777778,3845.415648,12.281370716389981,137,9.700000000000019E-4
2,test_20231101_140401,1254659.png,342646,51312,291334,0.850247777589699,3,4,80080,7252,72828,0.9094405594405595,24.177809777777778,4265.942901333333,11.830653226475647,137,9.700000000000019E-4
3,test_20231101_140401,10188041.png,221231,6617,214614,0.9700900868323156,2,4,41731,938,40793,0.9775227049435671,12.795395555555556,1592.7295573333333,16.10938321243044,137,9.700000000000019E-4
4,test_20231101_140401,10287332.png,216980,7602,209378,0.964964512858328,1,3,22337,1042,21295,0.9533509423825939,11.973063111111111,1604.10704,16.07847016040524,137,9.700000000000019E-4
5,test_20231101_140401,11610969.png,368720,10707,358013,0.9709617053590801,2,3,84111,1587,82524,0.9811320754716981,37.77502577777778,6841.876416,9.779051355575955,137,9.700000000000019E-4
6,test_20231101_140401,10350842.png,212614,24,212590,0.9998871193806617,1,4,42529,1,42528,0.9999764866326507,55.22670577777778,11938.01408,7.361482740939017,137,9.700000000000019E-4
7,test_20231101_140401,10863862.png,317432,4787,312645,0.9849196048287507,1,3,66058,703,65355,0.9893578370522874,40.80527466666667,7941.242928,9.131918792813298,137,9.700000000000019E-4
8,test_20231101_140401,11382381.png,312486,327,312159,0.9989535531191798,1,4,46745,44,46701,0.9990587228580596,23.441726222222222,2963.055792,13.413405318888326,137,9.700000000000019E-4
9,test_20231101_140401,11079715.png,443815,89569,354246,0.798183927988013,3,5,124136,12624,111512,0.8983050847457628,19.33347911111111,2752.297077333333,13.73385051913707,137,9.700000000000019E-4
10,test_20231101_140401,11551286.png,271883,24,271859,0.9999117267353972,1,4,40092,1,40091,0.9999750573680535,24.866876444444443,3470.407338666667,12.72699907819776,137,9.700000000000019E-4
1,test_20231101_140401,10404007.png,502730,9612,493118,0.9808803930539256,1,3,61265,1408,59857,0.9770178731739166,27.34860088888889,3862.6357653333334,12.261966034256012,137,9.80000000000002E-4
2,test_20231101_140401,1254659.png,342646,51012,291634,0.8511233167759145,3,4,80080,7218,72862,0.9098651348651349,24.432970666666666,4323.198058666667,11.772752285459923,137,9.80000000000002E-4
3,test_20231101_140401,10188041.png,221231,6457,214774,0.9708133127816626,2,4,41731,922,40809,0.9779061129615874,12.882986666666667,1611.935968,16.057325748235225,137,9.80000000000002E-4
4,test_20231101_140401,10287332.png,216980,7522,209458,0.9653332104341414,2,5,22337,1030,21307,0.9538881676142723,11.998624,1608.2770133333333,16.06719506131691,137,9.80000000000002E-4
5,test_20231101_140401,11610969.png,368720,10587,358133,0.9712871555651985,2,4,84111,1569,82542,0.9813460783964048,37.81828977777778,6850.609088,9.773511745145148,137,9.80000000000002E-4
6,test_20231101_140401,10350842.png,212614,24,212590,0.9998871193806617,1,4,42529,1,42528,0.9999764866326507,55.22670577777778,11938.01408,7.361482740939017,137,9.80000000000002E-4
7,test_20231101_140401,10863862.png,317432,4487,312945,0.9858646891302704,1,4,66058,658,65400,0.9900390565866359,40.936076444444446,7975.233114666667,9.113369746015444,137,9.80000000000002E-4
8,test_20231101_140401,11382381.png,312486,327,312159,0.9989535531191798,1,3,46745,44,46701,0.9990587228580596,23.441726222222222,2963.055792,13.413405318888326,137,9.80000000000002E-4
9,test_20231101_140401,11079715.png,443815,89467,354348,0.7984137534783637,3,4,124136,12613,111523,0.8983936972352903,19.377994666666666,2758.831882666667,13.72355124562246,137,9.80000000000002E-4
10,test_20231101_140401,11551286.png,271883,24,271859,0.9999117267353972,0,3,40092,1,40091,0.9999750573680535,24.866876444444443,3470.407338666667,12.72699907819776,137,9.80000000000002E-4
1,test_20231101_140402,10404007.png,502730,9612,493118,0.9808803930539256,2,4,61265,1408,59857,0.9770178731739166,27.34860088888889,3862.6357653333334,12.261966034256012,137,9.90000000000002E-4
2,test_20231101_140402,1254659.png,342646,51012,291634,0.8511233167759145,2,4,80080,7218,72862,0.9098651348651349,24.432970666666666,4323.198058666667,11.772752285459923,137,9.90000000000002E-4
3,test_20231101_140402,10188041.png,221231,6457,214774,0.9708133127816626,2,3,41731,922,40809,0.9779061129615874,12.882986666666667,1611.935968,16.057325748235225,137,9.90000000000002E-4
4,test_20231101_140402,10287332.png,216980,7522,209458,0.9653332104341414,2,4,22337,1030,21307,0.9538881676142723,11.998624,1608.2770133333333,16.06719506131691,137,9.90000000000002E-4
5,test_20231101_140402,11610969.png,368720,10587,358133,0.9712871555651985,3,9,84111,1569,82542,0.9813460783964048,37.81828977777778,6850.609088,9.773511745145148,137,9.90000000000002E-4
6,test_20231101_140402,10350842.png,212614,24,212590,0.9998871193806617,0,3,42529,1,42528,0.9999764866326507,55.22670577777778,11938.01408,7.361482740939017,137,9.90000000000002E-4
7,test_20231101_140402,10863862.png,317432,4487,312945,0.9858646891302704,1,4,66058,658,65400,0.9900390565866359,40.936076444444446,7975.233114666667,9.113369746015444,137,9.90000000000002E-4
8,test_20231101_140402,11382381.png,312486,327,312159,0.9989535531191798,1,4,46745,44,46701,0.9990587228580596,23.441726222222222,2963.055792,13.413405318888326,137,9.90000000000002E-4
9,test_20231101_140402,11079715.png,443815,89467,354348,0.7984137534783637,3,4,124136,12613,111523,0.8983936972352903,19.377994666666666,2758.831882666667,13.72355124562246,137,9.90000000000002E-4
10,test_20231101_140402,11551286.png,271883,24,271859,0.9999117267353972,0,3,40092,1,40091,0.9999750573680535,24.866876444444443,3470.407338666667,12.72699907819776,137,9.90000000000002E-4
1,test_20231101_140403,10404007.png,502730,10152,492578,0.979806257832236,2,3,61265,1487,59778,0.9757283930466009,27.01291911111111,3795.8411466666666,12.337723316568209,138,0.0
2,test_20231101_140403,1254659.png,342646,49362,293284,0.8559387823000998,3,4,80080,6980,73100,0.9128371628371629,24.506750222222223,4370.97864,11.725016766735676,138,0.0
3,test_20231101_140403,10188041.png,221231,6657,214574,0.9699092803449788,2,3,41731,941,40790,0.9774508159401883,12.455249777777778,1550.4268693333333,16.22629074650589,138,0.0
4,test_20231101_140403,10287332.png,216980,7762,209218,0.9642271177067011,1,3,22337,1063,21274,0.9524107982271567,11.820373333333333,1579.3860693333334,16.145920577837142,138,0.0
5,test_20231101_140403,11610969.png,368720,10444,358276,0.9716749837274897,2,3,84111,1548,82563,0.9815957484752291,36.36040533333333,6523.733706666667,9.985841356740382,138,0.0
6,test_20231101_140403,10350842.png,212614,3129,209485,0.985283189253765,2,4,42529,460,42069,0.9891838510193045,22.869468444444443,3257.64368,13.001767812860322,138,0.0
7,test_20231101_140403,10863862.png,317432,5067,312365,0.9840375261473323,1,3,66058,745,65313,0.988722032153562,40.05574933333333,7748.352741333333,9.23870977250431,138,0.0
8,test_20231101_140403,11382381.png,312486,547,311939,0.9982495215785667,1,4,46745,76,46669,0.9983741576639212,21.96234488888889,2754.930384,13.729697319910494,138,0.0
9,test_20231101_140403,11079715.png,443815,87337,356478,0.8032130504827462,3,4,124136,12328,111808,0.9006895662821421,19.342218666666668,2788.1580266666665,13.677629758879972,138,0.0
10,test_20231101_140403,11551286.png,271883,417,271466,0.9984662520275266,1,4,40092,59,40033,0.9985283847151551,17.548085333333333,1812.6782826666667,15.547596292824664,138,0.0
1,test_20231101_140403,10404007.png,502730,10152,492578,0.979806257832236,2,3,61265,1487,59778,0.9757283930466009,27.01291911111111,3795.8411466666666,12.337723316568209,138,1.0E-5
2,test_20231101_140403,1254659.png,342646,49362,293284,0.8559387823000998,2,3,80080,6980,73100,0.9128371628371629,24.506750222222223,4370.97864,11.725016766735676,138,1.0E-5
3,test_20231101_140403,10188041.png,221231,6657,214574,0.9699092803449788,1,3,41731,941,40790,0.9774508159401883,12.455249777777778,1550.4268693333333,16.22629074650589,138,1.0E-5
4,test_20231101_140403,10287332.png,216980,7762,209218,0.9642271177067011,2,3,22337,1063,21274,0.9524107982271567,11.820373333333333,1579.3860693333334,16.145920577837142,138,1.0E-5
5,test_20231101_140403,11610969.png,368720,10444,358276,0.9716749837274897,2,4,84111,1548,82563,0.9815957484752291,36.36040533333333,6523.733706666667,9.985841356740382,138,1.0E-5
6,test_20231101_140403,10350842.png,212614,3129,209485,0.985283189253765,1,4,42529,460,42069,0.9891838510193045,22.869468444444443,3257.64368,13.001767812860322,138,1.0E-5
7,test_20231101_140403,10863862.png,317432,5067,312365,0.9840375261473323,1,3,66058,745,65313,0.988722032153562,40.05574933333333,7748.352741333333,9.23870977250431,138,1.0E-5
8,test_20231101_140403,11382381.png,312486,547,311939,0.9982495215785667,2,3,46745,76,46669,0.9983741576639212,21.96234488888889,2754.930384,13.729697319910494,138,1.0E-5
9,test_20231101_140403,11079715.png,443815,87337,356478,0.8032130504827462,3,4,124136,12328,111808,0.9006895662821421,19.342218666666668,2788.1580266666665,13.677629758879972,138,1.0E-5
10,test_20231101_140403,11551286.png,271883,417,271466,0.9984662520275266,1,3,40092,59,40033,0.9985283847151551,17.548085333333333,1812.6782826666667,15.547596292824664,138,1.0E-5
1,test_20231101_140404,10404007.png,502730,10152,492578,0.979806257832236,2,4,61265,1487,59778,0.9757283930466009,27.01291911111111,3795.8411466666666,12.337723316568209,138,2.0E-5
2,test_20231101_140404,1254659.png,342646,49362,293284,0.8559387823000998,3,4,80080,6980,73100,0.9128371628371629,24.506750222222223,4370.97864,11.725016766735676,138,2.0E-5
3,test_20231101_140404,10188041.png,221231,6657,214574,0.9699092803449788,1,3,41731,941,40790,0.9774508159401883,12.455249777777778,1550.4268693333333,16.22629074650589,138,2.0E-5
4,test_20231101_140404,10287332.png,216980,7762,209218,0.9642271177067011,2,4,22337,1063,21274,0.9524107982271567,11.820373333333333,1579.3860693333334,16.145920577837142,138,2.0E-5
5,test_20231101_140404,11610969.png,368720,10444,358276,0.9716749837274897,2,3,84111,1548,82563,0.9815957484752291,36.36040533333333,6523.733706666667,9.985841356740382,138,2.0E-5
6,test_20231101_140404,10350842.png,212614,3129,209485,0.985283189253765,1,3,42529,460,42069,0.9891838510193045,22.869468444444443,3257.64368,13.001767812860322,138,2.0E-5
7,test_20231101_140404,10863862.png,317432,5067,312365,0.9840375261473323,1,4,66058,745,65313,0.988722032153562,40.05574933333333,7748.352741333333,9.23870977250431,138,2.0E-5
8,test_20231101_140404,11382381.png,312486,537,311949,0.9982815230122309,1,3,46745,75,46670,0.9983955503262381,22.692161777777777,2853.4911946666666,13.577038241313751,138,2.0E-5
9,test_20231101_140404,11079715.png,443815,87337,356478,0.8032130504827462,3,4,124136,12328,111808,0.9006895662821421,19.342218666666668,2788.1580266666665,13.677629758879972,138,2.0E-5
10,test_20231101_140404,11551286.png,271883,417,271466,0.9984662520275266,2,3,40092,59,40033,0.9985283847151551,17.548085333333333,1812.6782826666667,15.547596292824664,138,2.0E-5
1,test_20231101_140405,10404007.png,502730,10152,492578,0.979806257832236,2,3,61265,1487,59778,0.9757283930466009,27.01291911111111,3795.8411466666666,12.337723316568209,138,3.0000000000000004E-5
2,test_20231101_140405,1254659.png,342646,49362,293284,0.8559387823000998,3,4,80080,6980,73100,0.9128371628371629,24.506750222222223,4370.97864,11.725016766735676,138,3.0000000000000004E-5
3,test_20231101_140405,10188041.png,221231,6657,214574,0.9699092803449788,2,4,41731,941,40790,0.9774508159401883,12.455249777777778,1550.4268693333333,16.22629074650589,138,3.0000000000000004E-5
4,test_20231101_140405,10287332.png,216980,7762,209218,0.9642271177067011,2,4,22337,1063,21274,0.9524107982271567,11.820373333333333,1579.3860693333334,16.145920577837142,138,3.0000000000000004E-5
5,test_20231101_140405,11610969.png,368720,10444,358276,0.9716749837274897,2,4,84111,1548,82563,0.9815957484752291,36.36040533333333,6523.733706666667,9.985841356740382,138,3.0000000000000004E-5
6,test_20231101_140405,10350842.png,212614,3129,209485,0.985283189253765,1,4,42529,460,42069,0.9891838510193045,22.869468444444443,3257.64368,13.001767812860322,138,3.0000000000000004E-5
7,test_20231101_140405,10863862.png,317432,5067,312365,0.9840375261473323,1,4,66058,745,65313,0.988722032153562,40.05574933333333,7748.352741333333,9.23870977250431,138,3.0000000000000004E-5
8,test_20231101_140405,11382381.png,312486,537,311949,0.9982815230122309,1,3,46745,75,46670,0.9983955503262381,22.692161777777777,2853.4911946666666,13.577038241313751,138,3.0000000000000004E-5
9,test_20231101_140405,11079715.png,443815,87337,356478,0.8032130504827462,3,4,124136,12328,111808,0.9006895662821421,19.342218666666668,2788.1580266666665,13.677629758879972,138,3.0000000000000004E-5
10,test_20231101_140405,11551286.png,271883,417,271466,0.9984662520275266,1,3,40092,59,40033,0.9985283847151551,17.548085333333333,1812.6782826666667,15.547596292824664,138,3.0000000000000004E-5
1,test_20231101_140405,10404007.png,502730,10152,492578,0.979806257832236,2,4,61265,1487,59778,0.9757283930466009,27.01291911111111,3795.8411466666666,12.337723316568209,138,4.0E-5
2,test_20231101_140405,1254659.png,342646,49362,293284,0.8559387823000998,2,3,80080,6980,73100,0.9128371628371629,24.506750222222223,4370.97864,11.725016766735676,138,4.0E-5
3,test_20231101_140405,10188041.png,221231,6657,214574,0.9699092803449788,2,4,41731,941,40790,0.9774508159401883,12.455249777777778,1550.4268693333333,16.22629074650589,138,4.0E-5
4,test_20231101_140405,10287332.png,216980,7762,209218,0.9642271177067011,1,3,22337,1063,21274,0.9524107982271567,11.820373333333333,1579.3860693333334,16.145920577837142,138,4.0E-5
5,test_20231101_140405,11610969.png,368720,10444,358276,0.9716749837274897,2,4,84111,1548,82563,0.9815957484752291,36.36040533333333,6523.733706666667,9.985841356740382,138,4.0E-5
6,test_20231101_140405,10350842.png,212614,3129,209485,0.985283189253765,2,4,42529,460,42069,0.9891838510193045,22.869468444444443,3257.64368,13.001767812860322,138,4.0E-5
7,test_20231101_140405,10863862.png,317432,5067,312365,0.9840375261473323,1,3,66058,745,65313,0.988722032153562,40.05574933333333,7748.352741333333,9.23870977250431,138,4.0E-5
8,test_20231101_140405,11382381.png,312486,537,311949,0.9982815230122309,1,3,46745,75,46670,0.9983955503262381,22.692161777777777,2853.4911946666666,13.577038241313751,138,4.0E-5
9,test_20231101_140405,11079715.png,443815,87337,356478,0.8032130504827462,3,3,124136,12328,111808,0.9006895662821421,19.342218666666668,2788.1580266666665,13.677629758879972,138,4.0E-5
10,test_20231101_140405,11551286.png,271883,417,271466,0.9984662520275266,1,3,40092,59,40033,0.9985283847151551,17.548085333333333,1812.6782826666667,15.547596292824664,138,4.0E-5
1,test_20231101_140406,10404007.png,502730,10152,492578,0.979806257832236,2,3,61265,1487,59778,0.9757283930466009,27.01291911111111,3795.8411466666666,12.337723316568209,138,5.0E-5
2,test_20231101_140406,1254659.png,342646,49362,293284,0.8559387823000998,3,4,80080,6980,73100,0.9128371628371629,24.506750222222223,4370.97864,11.725016766735676,138,5.0E-5
3,test_20231101_140406,10188041.png,221231,6657,214574,0.9699092803449788,1,3,41731,941,40790,0.9774508159401883,12.455249777777778,1550.4268693333333,16.22629074650589,138,5.0E-5
4,test_20231101_140406,10287332.png,216980,7762,209218,0.9642271177067011,2,3,22337,1063,21274,0.9524107982271567,11.820373333333333,1579.3860693333334,16.145920577837142,138,5.0E-5
5,test_20231101_140406,11610969.png,368720,10444,358276,0.9716749837274897,2,3,84111,1548,82563,0.9815957484752291,36.36040533333333,6523.733706666667,9.985841356740382,138,5.0E-5
6,test_20231101_140406,10350842.png,212614,3129,209485,0.985283189253765,1,4,42529,460,42069,0.9891838510193045,22.869468444444443,3257.64368,13.001767812860322,138,5.0E-5
7,test_20231101_140406,10863862.png,317432,5067,312365,0.9840375261473323,2,3,66058,745,65313,0.988722032153562,40.05574933333333,7748.352741333333,9.23870977250431,138,5.0E-5
8,test_20231101_140406,11382381.png,312486,537,311949,0.9982815230122309,2,3,46745,75,46670,0.9983955503262381,22.692161777777777,2853.4911946666666,13.577038241313751,138,5.0E-5
9,test_20231101_140406,11079715.png,443815,87337,356478,0.8032130504827462,3,4,124136,12328,111808,0.9006895662821421,19.342218666666668,2788.1580266666665,13.677629758879972,138,5.0E-5
10,test_20231101_140406,11551286.png,271883,417,271466,0.9984662520275266,1,3,40092,59,40033,0.9985283847151551,17.548085333333333,1812.6782826666667,15.547596292824664,138,5.0E-5
1,test_20231101_140407,10404007.png,502730,10152,492578,0.979806257832236,2,3,61265,1487,59778,0.9757283930466009,27.01291911111111,3795.8411466666666,12.337723316568209,138,6.0E-5
2,test_20231101_140407,1254659.png,342646,49362,293284,0.8559387823000998,2,3,80080,6980,73100,0.9128371628371629,24.506750222222223,4370.97864,11.725016766735676,138,6.0E-5
3,test_20231101_140407,10188041.png,221231,6657,214574,0.9699092803449788,2,4,41731,941,40790,0.9774508159401883,12.455249777777778,1550.4268693333333,16.22629074650589,138,6.0E-5
4,test_20231101_140407,10287332.png,216980,7762,209218,0.9642271177067011,2,4,22337,1063,21274,0.9524107982271567,11.820373333333333,1579.3860693333334,16.145920577837142,138,6.0E-5
5,test_20231101_140407,11610969.png,368720,10444,358276,0.9716749837274897,1,6,84111,1548,82563,0.9815957484752291,36.36040533333333,6523.733706666667,9.985841356740382,138,6.0E-5
6,test_20231101_140407,10350842.png,212614,3129,209485,0.985283189253765,2,4,42529,460,42069,0.9891838510193045,22.869468444444443,3257.64368,13.001767812860322,138,6.0E-5
7,test_20231101_140407,10863862.png,317432,5067,312365,0.9840375261473323,1,4,66058,745,65313,0.988722032153562,40.05574933333333,7748.352741333333,9.23870977250431,138,6.0E-5
8,test_20231101_140407,11382381.png,312486,537,311949,0.9982815230122309,2,4,46745,75,46670,0.9983955503262381,22.692161777777777,2853.4911946666666,13.577038241313751,138,6.0E-5
9,test_20231101_140407,11079715.png,443815,87337,356478,0.8032130504827462,2,4,124136,12328,111808,0.9006895662821421,19.342218666666668,2788.1580266666665,13.677629758879972,138,6.0E-5
10,test_20231101_140407,11551286.png,271883,417,271466,0.9984662520275266,2,3,40092,59,40033,0.9985283847151551,17.548085333333333,1812.6782826666667,15.547596292824664,138,6.0E-5
1,test_20231101_140408,10404007.png,502730,10152,492578,0.979806257832236,2,4,61265,1487,59778,0.9757283930466009,27.01291911111111,3795.8411466666666,12.337723316568209,138,7.000000000000001E-5
2,test_20231101_140408,1254659.png,342646,49362,293284,0.8559387823000998,3,4,80080,6980,73100,0.9128371628371629,24.506750222222223,4370.97864,11.725016766735676,138,7.000000000000001E-5
3,test_20231101_140408,10188041.png,221231,6657,214574,0.9699092803449788,2,4,41731,941,40790,0.9774508159401883,12.455249777777778,1550.4268693333333,16.22629074650589,138,7.000000000000001E-5
4,test_20231101_140408,10287332.png,216980,7762,209218,0.9642271177067011,1,4,22337,1063,21274,0.9524107982271567,11.820373333333333,1579.3860693333334,16.145920577837142,138,7.000000000000001E-5
5,test_20231101_140408,11610969.png,368720,10082,358638,0.972656758515947,1,3,84111,1494,82617,0.982237757249349,37.79739555555555,6855.232688,9.770581601815733,138,7.000000000000001E-5
6,test_20231101_140408,10350842.png,212614,3129,209485,0.985283189253765,2,3,42529,460,42069,0.9891838510193045,22.869468444444443,3257.64368,13.001767812860322,138,7.000000000000001E-5
7,test_20231101_140408,10863862.png,317432,5067,312365,0.9840375261473323,1,4,66058,745,65313,0.988722032153562,40.05574933333333,7748.352741333333,9.23870977250431,138,7.000000000000001E-5
8,test_20231101_140408,11382381.png,312486,537,311949,0.9982815230122309,1,4,46745,75,46670,0.9983955503262381,22.692161777777777,2853.4911946666666,13.577038241313751,138,7.000000000000001E-5
9,test_20231101_140408,11079715.png,443815,87337,356478,0.8032130504827462,3,4,124136,12328,111808,0.9006895662821421,19.342218666666668,2788.1580266666665,13.677629758879972,138,7.000000000000001E-5
10,test_20231101_140408,11551286.png,271883,277,271606,0.9989811794043761,1,4,40092,38,40054,0.9990521799860321,17.87441777777778,1863.783136,15.426849830633177,138,7.000000000000001E-5
1,test_20231101_140408,10404007.png,502730,10152,492578,0.979806257832236,2,3,61265,1487,59778,0.9757283930466009,27.01291911111111,3795.8411466666666,12.337723316568209,138,8.0E-5
2,test_20231101_140408,1254659.png,342646,49362,293284,0.8559387823000998,3,4,80080,6980,73100,0.9128371628371629,24.506750222222223,4370.97864,11.725016766735676,138,8.0E-5
3,test_20231101_140408,10188041.png,221231,6657,214574,0.9699092803449788,2,4,41731,941,40790,0.9774508159401883,12.455249777777778,1550.4268693333333,16.22629074650589,138,8.0E-5
4,test_20231101_140408,10287332.png,216980,7762,209218,0.9642271177067011,1,4,22337,1063,21274,0.9524107982271567,11.820373333333333,1579.3860693333334,16.145920577837142,138,8.0E-5
5,test_20231101_140408,11610969.png,368720,10082,358638,0.972656758515947,1,3,84111,1494,82617,0.982237757249349,37.79739555555555,6855.232688,9.770581601815733,138,8.0E-5
6,test_20231101_140408,10350842.png,212614,3129,209485,0.985283189253765,1,7,42529,460,42069,0.9891838510193045,22.869468444444443,3257.64368,13.001767812860322,138,8.0E-5
7,test_20231101_140408,10863862.png,317432,5067,312365,0.9840375261473323,1,4,66058,745,65313,0.988722032153562,40.05574933333333,7748.352741333333,9.23870977250431,138,8.0E-5
8,test_20231101_140408,11382381.png,312486,427,312059,0.9986335387825375,1,3,46745,59,46686,0.9987378329233073,22.94864,2893.62336,13.516383590740695,138,8.0E-5
9,test_20231101_140408,11079715.png,443815,87337,356478,0.8032130504827462,3,4,124136,12328,111808,0.9006895662821421,19.342218666666668,2788.1580266666665,13.677629758879972,138,8.0E-5
10,test_20231101_140408,11551286.png,271883,277,271606,0.9989811794043761,1,4,40092,38,40054,0.9990521799860321,17.87441777777778,1863.783136,15.426849830633177,138,8.0E-5
1,test_20231101_140409,10404007.png,502730,10152,492578,0.979806257832236,2,3,61265,1487,59778,0.9757283930466009,27.01291911111111,3795.8411466666666,12.337723316568209,138,9.0E-5
2,test_20231101_140409,1254659.png,342646,49362,293284,0.8559387823000998,3,4,80080,6980,73100,0.9128371628371629,24.506750222222223,4370.97864,11.725016766735676,138,9.0E-5
3,test_20231101_140409,10188041.png,221231,6657,214574,0.9699092803449788,2,3,41731,941,40790,0.9774508159401883,12.455249777777778,1550.4268693333333,16.22629074650589,138,9.0E-5
4,test_20231101_140409,10287332.png,216980,7762,209218,0.9642271177067011,2,4,22337,1063,21274,0.9524107982271567,11.820373333333333,1579.3860693333334,16.145920577837142,138,9.0E-5
5,test_20231101_140409,11610969.png,368720,10082,358638,0.972656758515947,2,4,84111,1494,82617,0.982237757249349,37.79739555555555,6855.232688,9.770581601815733,138,9.0E-5
6,test_20231101_140409,10350842.png,212614,3129,209485,0.985283189253765,1,8,42529,460,42069,0.9891838510193045,22.869468444444443,3257.64368,13.001767812860322,138,9.0E-5
7,test_20231101_140409,10863862.png,317432,5067,312365,0.9840375261473323,2,3,66058,745,65313,0.988722032153562,40.05574933333333,7748.352741333333,9.23870977250431,138,9.0E-5
8,test_20231101_140409,11382381.png,312486,427,312059,0.9986335387825375,1,4,46745,59,46686,0.9987378329233073,22.94864,2893.62336,13.516383590740695,138,9.0E-5
9,test_20231101_140409,11079715.png,443815,87337,356478,0.8032130504827462,3,4,124136,12328,111808,0.9006895662821421,19.342218666666668,2788.1580266666665,13.677629758879972,138,9.0E-5
10,test_20231101_140409,11551286.png,271883,277,271606,0.9989811794043761,1,4,40092,38,40054,0.9990521799860321,17.87441777777778,1863.783136,15.426849830633177,138,9.0E-5
1,test_20231101_140410,10404007.png,502730,10152,492578,0.979806257832236,2,3,61265,1487,59778,0.9757283930466009,27.01291911111111,3795.8411466666666,12.337723316568209,138,1.0E-4
2,test_20231101_140410,1254659.png,342646,49362,293284,0.8559387823000998,3,4,80080,6980,73100,0.9128371628371629,24.506750222222223,4370.97864,11.725016766735676,138,1.0E-4
3,test_20231101_140410,10188041.png,221231,6657,214574,0.9699092803449788,2,4,41731,941,40790,0.9774508159401883,12.455249777777778,1550.4268693333333,16.22629074650589,138,1.0E-4
4,test_20231101_140410,10287332.png,216980,7762,209218,0.9642271177067011,2,4,22337,1063,21274,0.9524107982271567,11.820373333333333,1579.3860693333334,16.145920577837142,138,1.0E-4
5,test_20231101_140410,11610969.png,368720,10082,358638,0.972656758515947,1,3,84111,1494,82617,0.982237757249349,37.79739555555555,6855.232688,9.770581601815733,138,1.0E-4
6,test_20231101_140410,10350842.png,212614,3129,209485,0.985283189253765,1,4,42529,460,42069,0.9891838510193045,22.869468444444443,3257.64368,13.001767812860322,138,1.0E-4
7,test_20231101_140410,10863862.png,317432,5067,312365,0.9840375261473323,2,3,66058,745,65313,0.988722032153562,40.05574933333333,7748.352741333333,9.23870977250431,138,1.0E-4
8,test_20231101_140410,11382381.png,312486,427,312059,0.9986335387825375,2,3,46745,59,46686,0.9987378329233073,22.94864,2893.62336,13.516383590740695,138,1.0E-4
9,test_20231101_140410,11079715.png,443815,87337,356478,0.8032130504827462,3,4,124136,12328,111808,0.9006895662821421,19.342218666666668,2788.1580266666665,13.677629758879972,138,1.0E-4
10,test_20231101_140410,11551286.png,271883,277,271606,0.9989811794043761,1,3,40092,38,40054,0.9990521799860321,17.87441777777778,1863.783136,15.426849830633177,138,1.0E-4
1,test_20231101_140410,10404007.png,502730,10152,492578,0.979806257832236,2,4,61265,1487,59778,0.9757283930466009,27.01291911111111,3795.8411466666666,12.337723316568209,138,1.1E-4
2,test_20231101_140410,1254659.png,342646,49362,293284,0.8559387823000998,2,4,80080,6980,73100,0.9128371628371629,24.506750222222223,4370.97864,11.725016766735676,138,1.1E-4
3,test_20231101_140410,10188041.png,221231,6657,214574,0.9699092803449788,2,4,41731,941,40790,0.9774508159401883,12.455249777777778,1550.4268693333333,16.22629074650589,138,1.1E-4
4,test_20231101_140410,10287332.png,216980,7762,209218,0.9642271177067011,2,3,22337,1063,21274,0.9524107982271567,11.820373333333333,1579.3860693333334,16.145920577837142,138,1.1E-4
5,test_20231101_140410,11610969.png,368720,10082,358638,0.972656758515947,2,3,84111,1494,82617,0.982237757249349,37.79739555555555,6855.232688,9.770581601815733,138,1.1E-4
6,test_20231101_140410,10350842.png,212614,3129,209485,0.985283189253765,2,4,42529,460,42069,0.9891838510193045,22.869468444444443,3257.64368,13.001767812860322,138,1.1E-4
7,test_20231101_140410,10863862.png,317432,5067,312365,0.9840375261473323,1,4,66058,745,65313,0.988722032153562,40.05574933333333,7748.352741333333,9.23870977250431,138,1.1E-4
8,test_20231101_140410,11382381.png,312486,427,312059,0.9986335387825375,2,3,46745,59,46686,0.9987378329233073,22.94864,2893.62336,13.516383590740695,138,1.1E-4
9,test_20231101_140410,11079715.png,443815,87337,356478,0.8032130504827462,3,5,124136,12328,111808,0.9006895662821421,19.342218666666668,2788.1580266666665,13.677629758879972,138,1.1E-4
10,test_20231101_140410,11551286.png,271883,277,271606,0.9989811794043761,1,3,40092,38,40054,0.9990521799860321,17.87441777777778,1863.783136,15.426849830633177,138,1.1E-4
1,test_20231101_140411,10404007.png,502730,10152,492578,0.979806257832236,2,3,61265,1487,59778,0.9757283930466009,27.01291911111111,3795.8411466666666,12.337723316568209,138,1.2E-4
2,test_20231101_140411,1254659.png,342646,49362,293284,0.8559387823000998,3,4,80080,6980,73100,0.9128371628371629,24.506750222222223,4370.97864,11.725016766735676,138,1.2E-4
3,test_20231101_140411,10188041.png,221231,6657,214574,0.9699092803449788,1,3,41731,941,40790,0.9774508159401883,12.455249777777778,1550.4268693333333,16.22629074650589,138,1.2E-4
4,test_20231101_140411,10287332.png,216980,7762,209218,0.9642271177067011,2,4,22337,1063,21274,0.9524107982271567,11.820373333333333,1579.3860693333334,16.145920577837142,138,1.2E-4
5,test_20231101_140411,11610969.png,368720,10082,358638,0.972656758515947,2,4,84111,1494,82617,0.982237757249349,37.79739555555555,6855.232688,9.770581601815733,138,1.2E-4
6,test_20231101_140411,10350842.png,212614,3129,209485,0.985283189253765,1,4,42529,460,42069,0.9891838510193045,22.869468444444443,3257.64368,13.001767812860322,138,1.2E-4
7,test_20231101_140411,10863862.png,317432,5067,312365,0.9840375261473323,1,3,66058,745,65313,0.988722032153562,40.05574933333333,7748.352741333333,9.23870977250431,138,1.2E-4
8,test_20231101_140411,11382381.png,312486,427,312059,0.9986335387825375,2,3,46745,59,46686,0.9987378329233073,22.94864,2893.62336,13.516383590740695,138,1.2E-4
9,test_20231101_140411,11079715.png,443815,87337,356478,0.8032130504827462,3,4,124136,12328,111808,0.9006895662821421,19.342218666666668,2788.1580266666665,13.677629758879972,138,1.2E-4
10,test_20231101_140411,11551286.png,271883,277,271606,0.9989811794043761,1,3,40092,38,40054,0.9990521799860321,17.87441777777778,1863.783136,15.426849830633177,138,1.2E-4
1,test_20231101_140412,10404007.png,502730,10152,492578,0.979806257832236,2,3,61265,1487,59778,0.9757283930466009,27.01291911111111,3795.8411466666666,12.337723316568209,138,1.3000000000000002E-4
2,test_20231101_140412,1254659.png,342646,49362,293284,0.8559387823000998,3,4,80080,6980,73100,0.9128371628371629,24.506750222222223,4370.97864,11.725016766735676,138,1.3000000000000002E-4
3,test_20231101_140412,10188041.png,221231,6657,214574,0.9699092803449788,2,3,41731,941,40790,0.9774508159401883,12.455249777777778,1550.4268693333333,16.22629074650589,138,1.3000000000000002E-4
4,test_20231101_140412,10287332.png,216980,7762,209218,0.9642271177067011,2,3,22337,1063,21274,0.9524107982271567,11.820373333333333,1579.3860693333334,16.145920577837142,138,1.3000000000000002E-4
5,test_20231101_140412,11610969.png,368720,10082,358638,0.972656758515947,2,4,84111,1494,82617,0.982237757249349,37.79739555555555,6855.232688,9.770581601815733,138,1.3000000000000002E-4
6,test_20231101_140412,10350842.png,212614,3129,209485,0.985283189253765,1,4,42529,460,42069,0.9891838510193045,22.869468444444443,3257.64368,13.001767812860322,138,1.3000000000000002E-4
7,test_20231101_140412,10863862.png,317432,5067,312365,0.9840375261473323,2,4,66058,745,65313,0.988722032153562,40.05574933333333,7748.352741333333,9.23870977250431,138,1.3000000000000002E-4
8,test_20231101_140412,11382381.png,312486,427,312059,0.9986335387825375,1,4,46745,59,46686,0.9987378329233073,22.94864,2893.62336,13.516383590740695,138,1.3000000000000002E-4
9,test_20231101_140412,11079715.png,443815,87337,356478,0.8032130504827462,3,4,124136,12328,111808,0.9006895662821421,19.342218666666668,2788.1580266666665,13.677629758879972,138,1.3000000000000002E-4
10,test_20231101_140412,11551286.png,271883,277,271606,0.9989811794043761,1,3,40092,38,40054,0.9990521799860321,17.87441777777778,1863.783136,15.426849830633177,138,1.3000000000000002E-4
1,test_20231101_140412,10404007.png,502730,10152,492578,0.979806257832236,3,4,61265,1487,59778,0.9757283930466009,27.01291911111111,3795.8411466666666,12.337723316568209,138,1.4000000000000001E-4
2,test_20231101_140412,1254659.png,342646,49362,293284,0.8559387823000998,3,4,80080,6980,73100,0.9128371628371629,24.506750222222223,4370.97864,11.725016766735676,138,1.4000000000000001E-4
3,test_20231101_140412,10188041.png,221231,6657,214574,0.9699092803449788,2,4,41731,941,40790,0.9774508159401883,12.455249777777778,1550.4268693333333,16.22629074650589,138,1.4000000000000001E-4
4,test_20231101_140412,10287332.png,216980,7762,209218,0.9642271177067011,2,4,22337,1063,21274,0.9524107982271567,11.820373333333333,1579.3860693333334,16.145920577837142,138,1.4000000000000001E-4
5,test_20231101_140412,11610969.png,368720,10082,358638,0.972656758515947,2,6,84111,1494,82617,0.982237757249349,37.79739555555555,6855.232688,9.770581601815733,138,1.4000000000000001E-4
6,test_20231101_140412,10350842.png,212614,3129,209485,0.985283189253765,1,4,42529,460,42069,0.9891838510193045,22.869468444444443,3257.64368,13.001767812860322,138,1.4000000000000001E-4
7,test_20231101_140412,10863862.png,317432,5067,312365,0.9840375261473323,1,3,66058,745,65313,0.988722032153562,40.05574933333333,7748.352741333333,9.23870977250431,138,1.4000000000000001E-4
8,test_20231101_140412,11382381.png,312486,427,312059,0.9986335387825375,2,3,46745,59,46686,0.9987378329233073,22.94864,2893.62336,13.516383590740695,138,1.4000000000000001E-4
9,test_20231101_140412,11079715.png,443815,87337,356478,0.8032130504827462,3,4,124136,12328,111808,0.9006895662821421,19.342218666666668,2788.1580266666665,13.677629758879972,138,1.4000000000000001E-4
10,test_20231101_140412,11551286.png,271883,277,271606,0.9989811794043761,1,3,40092,38,40054,0.9990521799860321,17.87441777777778,1863.783136,15.426849830633177,138,1.4000000000000001E-4
1,test_20231101_140413,10404007.png,502730,10152,492578,0.979806257832236,2,4,61265,1487,59778,0.9757283930466009,27.01291911111111,3795.8411466666666,12.337723316568209,138,1.5000000000000001E-4
2,test_20231101_140413,1254659.png,342646,49362,293284,0.8559387823000998,3,4,80080,6980,73100,0.9128371628371629,24.506750222222223,4370.97864,11.725016766735676,138,1.5000000000000001E-4
3,test_20231101_140413,10188041.png,221231,6657,214574,0.9699092803449788,2,4,41731,941,40790,0.9774508159401883,12.455249777777778,1550.4268693333333,16.22629074650589,138,1.5000000000000001E-4
4,test_20231101_140413,10287332.png,216980,7762,209218,0.9642271177067011,2,4,22337,1063,21274,0.9524107982271567,11.820373333333333,1579.3860693333334,16.145920577837142,138,1.5000000000000001E-4
5,test_20231101_140413,11610969.png,368720,10082,358638,0.972656758515947,2,4,84111,1494,82617,0.982237757249349,37.79739555555555,6855.232688,9.770581601815733,138,1.5000000000000001E-4
6,test_20231101_140413,10350842.png,212614,3129,209485,0.985283189253765,2,4,42529,460,42069,0.9891838510193045,22.869468444444443,3257.64368,13.001767812860322,138,1.5000000000000001E-4
7,test_20231101_140413,10863862.png,317432,5067,312365,0.9840375261473323,1,4,66058,745,65313,0.988722032153562,40.05574933333333,7748.352741333333,9.23870977250431,138,1.5000000000000001E-4
8,test_20231101_140413,11382381.png,312486,427,312059,0.9986335387825375,1,4,46745,59,46686,0.9987378329233073,22.94864,2893.62336,13.516383590740695,138,1.5000000000000001E-4
9,test_20231101_140413,11079715.png,443815,87337,356478,0.8032130504827462,3,4,124136,12328,111808,0.9006895662821421,19.342218666666668,2788.1580266666665,13.677629758879972,138,1.5000000000000001E-4
10,test_20231101_140413,11551286.png,271883,277,271606,0.9989811794043761,1,3,40092,38,40054,0.9990521799860321,17.87441777777778,1863.783136,15.426849830633177,138,1.5000000000000001E-4
1,test_20231101_140414,10404007.png,502730,10152,492578,0.979806257832236,2,4,61265,1487,59778,0.9757283930466009,27.01291911111111,3795.8411466666666,12.337723316568209,138,1.6E-4
2,test_20231101_140414,1254659.png,342646,49362,293284,0.8559387823000998,2,4,80080,6980,73100,0.9128371628371629,24.506750222222223,4370.97864,11.725016766735676,138,1.6E-4
3,test_20231101_140414,10188041.png,221231,6657,214574,0.9699092803449788,2,4,41731,941,40790,0.9774508159401883,12.455249777777778,1550.4268693333333,16.22629074650589,138,1.6E-4
4,test_20231101_140414,10287332.png,216980,7592,209388,0.9650106000553046,2,4,22337,1042,21295,0.9533509423825939,11.946716444444444,1605.0623253333333,16.075884599383468,138,1.6E-4
5,test_20231101_140414,11610969.png,368720,10082,358638,0.972656758515947,2,3,84111,1494,82617,0.982237757249349,37.79739555555555,6855.232688,9.770581601815733,138,1.6E-4
6,test_20231101_140414,10350842.png,212614,3129,209485,0.985283189253765,1,4,42529,460,42069,0.9891838510193045,22.869468444444443,3257.64368,13.001767812860322,138,1.6E-4
7,test_20231101_140414,10863862.png,317432,5067,312365,0.9840375261473323,1,4,66058,745,65313,0.988722032153562,40.05574933333333,7748.352741333333,9.23870977250431,138,1.6E-4
8,test_20231101_140414,11382381.png,312486,427,312059,0.9986335387825375,1,4,46745,59,46686,0.9987378329233073,22.94864,2893.62336,13.516383590740695,138,1.6E-4
9,test_20231101_140414,11079715.png,443815,87337,356478,0.8032130504827462,4,4,124136,12328,111808,0.9006895662821421,19.342218666666668,2788.1580266666665,13.677629758879972,138,1.6E-4
10,test_20231101_140414,11551286.png,271883,124,271759,0.999543921466219,1,3,40092,16,40076,0.9996009178888556,18.13910577777778,1903.2464906666667,15.335853231830718,138,1.6E-4
1,test_20231101_140414,10404007.png,502730,10152,492578,0.979806257832236,2,4,61265,1487,59778,0.9757283930466009,27.01291911111111,3795.8411466666666,12.337723316568209,138,1.7E-4
2,test_20231101_140414,1254659.png,342646,49362,293284,0.8559387823000998,3,4,80080,6980,73100,0.9128371628371629,24.506750222222223,4370.97864,11.725016766735676,138,1.7E-4
3,test_20231101_140414,10188041.png,221231,6657,214574,0.9699092803449788,2,4,41731,941,40790,0.9774508159401883,12.455249777777778,1550.4268693333333,16.22629074650589,138,1.7E-4
4,test_20231101_140414,10287332.png,216980,7592,209388,0.9650106000553046,2,3,22337,1042,21295,0.9533509423825939,11.946716444444444,1605.0623253333333,16.075884599383468,138,1.7E-4
5,test_20231101_140414,11610969.png,368720,10082,358638,0.972656758515947,1,3,84111,1494,82617,0.982237757249349,37.79739555555555,6855.232688,9.770581601815733,138,1.7E-4
6,test_20231101_140414,10350842.png,212614,3129,209485,0.985283189253765,2,4,42529,460,42069,0.9891838510193045,22.869468444444443,3257.64368,13.001767812860322,138,1.7E-4
7,test_20231101_140414,10863862.png,317432,5067,312365,0.9840375261473323,2,4,66058,745,65313,0.988722032153562,40.05574933333333,7748.352741333333,9.23870977250431,138,1.7E-4
8,test_20231101_140414,11382381.png,312486,427,312059,0.9986335387825375,2,3,46745,59,46686,0.9987378329233073,22.94864,2893.62336,13.516383590740695,138,1.7E-4
9,test_20231101_140414,11079715.png,443815,87337,356478,0.8032130504827462,3,4,124136,12328,111808,0.9006895662821421,19.342218666666668,2788.1580266666665,13.677629758879972,138,1.7E-4
10,test_20231101_140414,11551286.png,271883,124,271759,0.999543921466219,1,4,40092,16,40076,0.9996009178888556,18.13910577777778,1903.2464906666667,15.335853231830718,138,1.7E-4
1,test_20231101_140415,10404007.png,502730,10152,492578,0.979806257832236,2,4,61265,1487,59778,0.9757283930466009,27.01291911111111,3795.8411466666666,12.337723316568209,138,1.8E-4
2,test_20231101_140415,1254659.png,342646,49362,293284,0.8559387823000998,2,4,80080,6980,73100,0.9128371628371629,24.506750222222223,4370.97864,11.725016766735676,138,1.8E-4
3,test_20231101_140415,10188041.png,221231,6657,214574,0.9699092803449788,2,4,41731,941,40790,0.9774508159401883,12.455249777777778,1550.4268693333333,16.22629074650589,138,1.8E-4
4,test_20231101_140415,10287332.png,216980,7592,209388,0.9650106000553046,1,4,22337,1042,21295,0.9533509423825939,11.946716444444444,1605.0623253333333,16.075884599383468,138,1.8E-4
5,test_20231101_140415,11610969.png,368720,10082,358638,0.972656758515947,1,3,84111,1494,82617,0.982237757249349,37.79739555555555,6855.232688,9.770581601815733,138,1.8E-4
6,test_20231101_140415,10350842.png,212614,3129,209485,0.985283189253765,1,4,42529,460,42069,0.9891838510193045,22.869468444444443,3257.64368,13.001767812860322,138,1.8E-4
7,test_20231101_140415,10863862.png,317432,5067,312365,0.9840375261473323,1,4,66058,745,65313,0.988722032153562,40.05574933333333,7748.352741333333,9.23870977250431,138,1.8E-4
8,test_20231101_140415,11382381.png,312486,427,312059,0.9986335387825375,1,3,46745,59,46686,0.9987378329233073,22.94864,2893.62336,13.516383590740695,138,1.8E-4
9,test_20231101_140415,11079715.png,443815,87337,356478,0.8032130504827462,3,4,124136,12328,111808,0.9006895662821421,19.342218666666668,2788.1580266666665,13.677629758879972,138,1.8E-4
10,test_20231101_140415,11551286.png,271883,124,271759,0.999543921466219,1,3,40092,16,40076,0.9996009178888556,18.13910577777778,1903.2464906666667,15.335853231830718,138,1.8E-4
1,test_20231101_140416,10404007.png,502730,10152,492578,0.979806257832236,2,3,61265,1487,59778,0.9757283930466009,27.01291911111111,3795.8411466666666,12.337723316568209,138,1.9E-4
2,test_20231101_140416,1254659.png,342646,49362,293284,0.8559387823000998,3,4,80080,6980,73100,0.9128371628371629,24.506750222222223,4370.97864,11.725016766735676,138,1.9E-4
3,test_20231101_140416,10188041.png,221231,6657,214574,0.9699092803449788,2,4,41731,941,40790,0.9774508159401883,12.455249777777778,1550.4268693333333,16.22629074650589,138,1.9E-4
4,test_20231101_140416,10287332.png,216980,7592,209388,0.9650106000553046,1,3,22337,1042,21295,0.9533509423825939,11.946716444444444,1605.0623253333333,16.075884599383468,138,1.9E-4
5,test_20231101_140416,11610969.png,368720,10082,358638,0.972656758515947,2,4,84111,1494,82617,0.982237757249349,37.79739555555555,6855.232688,9.770581601815733,138,1.9E-4
6,test_20231101_140416,10350842.png,212614,3129,209485,0.985283189253765,1,3,42529,460,42069,0.9891838510193045,22.869468444444443,3257.64368,13.001767812860322,138,1.9E-4
7,test_20231101_140416,10863862.png,317432,5067,312365,0.9840375261473323,1,3,66058,745,65313,0.988722032153562,40.05574933333333,7748.352741333333,9.23870977250431,138,1.9E-4
8,test_20231101_140416,11382381.png,312486,427,312059,0.9986335387825375,1,4,46745,59,46686,0.9987378329233073,22.94864,2893.62336,13.516383590740695,138,1.9E-4
9,test_20231101_140416,11079715.png,443815,87337,356478,0.8032130504827462,3,4,124136,12328,111808,0.9006895662821421,19.342218666666668,2788.1580266666665,13.677629758879972,138,1.9E-4
10,test_20231101_140416,11551286.png,271883,124,271759,0.999543921466219,2,3,40092,16,40076,0.9996009178888556,18.13910577777778,1903.2464906666667,15.335853231830718,138,1.9E-4
1,test_20231101_140416,10404007.png,502730,10152,492578,0.979806257832236,2,4,61265,1487,59778,0.9757283930466009,27.01291911111111,3795.8411466666666,12.337723316568209,138,2.0E-4
2,test_20231101_140416,1254659.png,342646,49362,293284,0.8559387823000998,2,3,80080,6980,73100,0.9128371628371629,24.506750222222223,4370.97864,11.725016766735676,138,2.0E-4
3,test_20231101_140416,10188041.png,221231,6657,214574,0.9699092803449788,2,3,41731,941,40790,0.9774508159401883,12.455249777777778,1550.4268693333333,16.22629074650589,138,2.0E-4
4,test_20231101_140416,10287332.png,216980,7592,209388,0.9650106000553046,2,4,22337,1042,21295,0.9533509423825939,11.946716444444444,1605.0623253333333,16.075884599383468,138,2.0E-4
5,test_20231101_140416,11610969.png,368720,10082,358638,0.972656758515947,2,3,84111,1494,82617,0.982237757249349,37.79739555555555,6855.232688,9.770581601815733,138,2.0E-4
6,test_20231101_140416,10350842.png,212614,3129,209485,0.985283189253765,7,7,42529,460,42069,0.9891838510193045,22.869468444444443,3257.64368,13.001767812860322,138,2.0E-4
7,test_20231101_140416,10863862.png,317432,5067,312365,0.9840375261473323,2,3,66058,745,65313,0.988722032153562,40.05574933333333,7748.352741333333,9.23870977250431,138,2.0E-4
8,test_20231101_140416,11382381.png,312486,427,312059,0.9986335387825375,2,4,46745,59,46686,0.9987378329233073,22.94864,2893.62336,13.516383590740695,138,2.0E-4
9,test_20231101_140416,11079715.png,443815,87337,356478,0.8032130504827462,3,4,124136,12328,111808,0.9006895662821421,19.342218666666668,2788.1580266666665,13.677629758879972,138,2.0E-4
10,test_20231101_140416,11551286.png,271883,124,271759,0.999543921466219,2,3,40092,16,40076,0.9996009178888556,18.13910577777778,1903.2464906666667,15.335853231830718,138,2.0E-4
1,test_20231101_140417,10404007.png,502730,10152,492578,0.979806257832236,2,4,61265,1487,59778,0.9757283930466009,27.01291911111111,3795.8411466666666,12.337723316568209,138,2.1E-4
2,test_20231101_140417,1254659.png,342646,49362,293284,0.8559387823000998,3,4,80080,6980,73100,0.9128371628371629,24.506750222222223,4370.97864,11.725016766735676,138,2.1E-4
3,test_20231101_140417,10188041.png,221231,6657,214574,0.9699092803449788,2,4,41731,941,40790,0.9774508159401883,12.455249777777778,1550.4268693333333,16.22629074650589,138,2.1E-4
4,test_20231101_140417,10287332.png,216980,7592,209388,0.9650106000553046,2,9,22337,1042,21295,0.9533509423825939,11.946716444444444,1605.0623253333333,16.075884599383468,138,2.1E-4
5,test_20231101_140417,11610969.png,368720,10082,358638,0.972656758515947,2,3,84111,1494,82617,0.982237757249349,37.79739555555555,6855.232688,9.770581601815733,138,2.1E-4
6,test_20231101_140417,10350842.png,212614,3129,209485,0.985283189253765,1,3,42529,460,42069,0.9891838510193045,22.869468444444443,3257.64368,13.001767812860322,138,2.1E-4
7,test_20231101_140417,10863862.png,317432,5067,312365,0.9840375261473323,1,3,66058,745,65313,0.988722032153562,40.05574933333333,7748.352741333333,9.23870977250431,138,2.1E-4
8,test_20231101_140417,11382381.png,312486,427,312059,0.9986335387825375,1,3,46745,59,46686,0.9987378329233073,22.94864,2893.62336,13.516383590740695,138,2.1E-4
9,test_20231101_140417,11079715.png,443815,87337,356478,0.8032130504827462,4,4,124136,12328,111808,0.9006895662821421,19.342218666666668,2788.1580266666665,13.677629758879972,138,2.1E-4
10,test_20231101_140417,11551286.png,271883,124,271759,0.999543921466219,1,4,40092,16,40076,0.9996009178888556,18.13910577777778,1903.2464906666667,15.335853231830718,138,2.1E-4
1,test_20231101_140418,10404007.png,502730,10152,492578,0.979806257832236,2,4,61265,1487,59778,0.9757283930466009,27.01291911111111,3795.8411466666666,12.337723316568209,138,2.2E-4
2,test_20231101_140418,1254659.png,342646,49362,293284,0.8559387823000998,3,3,80080,6980,73100,0.9128371628371629,24.506750222222223,4370.97864,11.725016766735676,138,2.2E-4
3,test_20231101_140418,10188041.png,221231,6657,214574,0.9699092803449788,1,3,41731,941,40790,0.9774508159401883,12.455249777777778,1550.4268693333333,16.22629074650589,138,2.2E-4
4,test_20231101_140418,10287332.png,216980,7592,209388,0.9650106000553046,2,3,22337,1042,21295,0.9533509423825939,11.946716444444444,1605.0623253333333,16.075884599383468,138,2.2E-4
5,test_20231101_140418,11610969.png,368720,10082,358638,0.972656758515947,2,4,84111,1494,82617,0.982237757249349,37.79739555555555,6855.232688,9.770581601815733,138,2.2E-4
6,test_20231101_140418,10350842.png,212614,3129,209485,0.985283189253765,2,3,42529,460,42069,0.9891838510193045,22.869468444444443,3257.64368,13.001767812860322,138,2.2E-4
7,test_20231101_140418,10863862.png,317432,5067,312365,0.9840375261473323,1,4,66058,745,65313,0.988722032153562,40.05574933333333,7748.352741333333,9.23870977250431,138,2.2E-4
8,test_20231101_140418,11382381.png,312486,427,312059,0.9986335387825375,1,3,46745,59,46686,0.9987378329233073,22.94864,2893.62336,13.516383590740695,138,2.2E-4
9,test_20231101_140418,11079715.png,443815,87337,356478,0.8032130504827462,3,4,124136,12328,111808,0.9006895662821421,19.342218666666668,2788.1580266666665,13.677629758879972,138,2.2E-4
10,test_20231101_140418,11551286.png,271883,124,271759,0.999543921466219,1,3,40092,16,40076,0.9996009178888556,18.13910577777778,1903.2464906666667,15.335853231830718,138,2.2E-4
1,test_20231101_140418,10404007.png,502730,10152,492578,0.979806257832236,2,3,61265,1487,59778,0.9757283930466009,27.01291911111111,3795.8411466666666,12.337723316568209,138,2.3E-4
2,test_20231101_140418,1254659.png,342646,49362,293284,0.8559387823000998,2,3,80080,6980,73100,0.9128371628371629,24.506750222222223,4370.97864,11.725016766735676,138,2.3E-4
3,test_20231101_140418,10188041.png,221231,6657,214574,0.9699092803449788,2,3,41731,941,40790,0.9774508159401883,12.455249777777778,1550.4268693333333,16.22629074650589,138,2.3E-4
4,test_20231101_140418,10287332.png,216980,7592,209388,0.9650106000553046,1,4,22337,1042,21295,0.9533509423825939,11.946716444444444,1605.0623253333333,16.075884599383468,138,2.3E-4
5,test_20231101_140418,11610969.png,368720,10082,358638,0.972656758515947,1,3,84111,1494,82617,0.982237757249349,37.79739555555555,6855.232688,9.770581601815733,138,2.3E-4
6,test_20231101_140418,10350842.png,212614,3129,209485,0.985283189253765,1,3,42529,460,42069,0.9891838510193045,22.869468444444443,3257.64368,13.001767812860322,138,2.3E-4
7,test_20231101_140418,10863862.png,317432,5067,312365,0.9840375261473323,2,4,66058,745,65313,0.988722032153562,40.05574933333333,7748.352741333333,9.23870977250431,138,2.3E-4
8,test_20231101_140418,11382381.png,312486,427,312059,0.9986335387825375,2,4,46745,59,46686,0.9987378329233073,22.94864,2893.62336,13.516383590740695,138,2.3E-4
9,test_20231101_140418,11079715.png,443815,87337,356478,0.8032130504827462,3,4,124136,12328,111808,0.9006895662821421,19.342218666666668,2788.1580266666665,13.677629758879972,138,2.3E-4
10,test_20231101_140418,11551286.png,271883,124,271759,0.999543921466219,1,5,40092,16,40076,0.9996009178888556,18.13910577777778,1903.2464906666667,15.335853231830718,138,2.3E-4
1,test_20231101_140419,10404007.png,502730,10152,492578,0.979806257832236,3,4,61265,1487,59778,0.9757283930466009,27.01291911111111,3795.8411466666666,12.337723316568209,138,2.4E-4
2,test_20231101_140419,1254659.png,342646,49362,293284,0.8559387823000998,3,4,80080,6980,73100,0.9128371628371629,24.506750222222223,4370.97864,11.725016766735676,138,2.4E-4
3,test_20231101_140419,10188041.png,221231,6657,214574,0.9699092803449788,3,4,41731,941,40790,0.9774508159401883,12.455249777777778,1550.4268693333333,16.22629074650589,138,2.4E-4
4,test_20231101_140419,10287332.png,216980,7592,209388,0.9650106000553046,3,4,22337,1042,21295,0.9533509423825939,11.946716444444444,1605.0623253333333,16.075884599383468,138,2.4E-4
5,test_20231101_140419,11610969.png,368720,10082,358638,0.972656758515947,2,4,84111,1494,82617,0.982237757249349,37.79739555555555,6855.232688,9.770581601815733,138,2.4E-4
6,test_20231101_140419,10350842.png,212614,3129,209485,0.985283189253765,2,4,42529,460,42069,0.9891838510193045,22.869468444444443,3257.64368,13.001767812860322,138,2.4E-4
7,test_20231101_140419,10863862.png,317432,5067,312365,0.9840375261473323,1,3,66058,745,65313,0.988722032153562,40.05574933333333,7748.352741333333,9.23870977250431,138,2.4E-4
8,test_20231101_140419,11382381.png,312486,427,312059,0.9986335387825375,1,4,46745,59,46686,0.9987378329233073,22.94864,2893.62336,13.516383590740695,138,2.4E-4
9,test_20231101_140419,11079715.png,443815,87337,356478,0.8032130504827462,5,4,124136,12328,111808,0.9006895662821421,19.342218666666668,2788.1580266666665,13.677629758879972,138,2.4E-4
10,test_20231101_140419,11551286.png,271883,124,271759,0.999543921466219,2,4,40092,16,40076,0.9996009178888556,18.13910577777778,1903.2464906666667,15.335853231830718,138,2.4E-4
1,test_20231101_140420,10404007.png,502730,10152,492578,0.979806257832236,3,3,61265,1487,59778,0.9757283930466009,27.01291911111111,3795.8411466666666,12.337723316568209,138,2.5E-4
2,test_20231101_140420,1254659.png,342646,49362,293284,0.8559387823000998,3,4,80080,6980,73100,0.9128371628371629,24.506750222222223,4370.97864,11.725016766735676,138,2.5E-4
3,test_20231101_140420,10188041.png,221231,6657,214574,0.9699092803449788,2,3,41731,941,40790,0.9774508159401883,12.455249777777778,1550.4268693333333,16.22629074650589,138,2.5E-4
4,test_20231101_140420,10287332.png,216980,7592,209388,0.9650106000553046,2,4,22337,1042,21295,0.9533509423825939,11.946716444444444,1605.0623253333333,16.075884599383468,138,2.5E-4
5,test_20231101_140420,11610969.png,368720,10082,358638,0.972656758515947,2,4,84111,1494,82617,0.982237757249349,37.79739555555555,6855.232688,9.770581601815733,138,2.5E-4
6,test_20231101_140420,10350842.png,212614,3129,209485,0.985283189253765,2,4,42529,460,42069,0.9891838510193045,22.869468444444443,3257.64368,13.001767812860322,138,2.5E-4
7,test_20231101_140420,10863862.png,317432,5067,312365,0.9840375261473323,1,3,66058,745,65313,0.988722032153562,40.05574933333333,7748.352741333333,9.23870977250431,138,2.5E-4
8,test_20231101_140420,11382381.png,312486,427,312059,0.9986335387825375,1,3,46745,59,46686,0.9987378329233073,22.94864,2893.62336,13.516383590740695,138,2.5E-4
9,test_20231101_140420,11079715.png,443815,87337,356478,0.8032130504827462,3,4,124136,12328,111808,0.9006895662821421,19.342218666666668,2788.1580266666665,13.677629758879972,138,2.5E-4
10,test_20231101_140420,11551286.png,271883,124,271759,0.999543921466219,1,3,40092,16,40076,0.9996009178888556,18.13910577777778,1903.2464906666667,15.335853231830718,138,2.5E-4
1,test_20231101_140420,10404007.png,502730,10052,492678,0.9800051717621785,2,4,61265,1473,59792,0.9759569085122011,27.024965333333334,3798.832986666667,12.334301603807027,138,2.6000000000000003E-4
2,test_20231101_140420,1254659.png,342646,49322,293324,0.8560555208582619,3,4,80080,6976,73104,0.9128871128871129,24.514750222222222,4371.7237706666665,11.724276478155753,138,2.6000000000000003E-4
3,test_20231101_140420,10188041.png,221231,6497,214734,0.9706325062943258,1,3,41731,918,40813,0.9780019649660924,12.782318222222223,1597.6760213333334,16.095916437197868,138,2.6000000000000003E-4
4,test_20231101_140420,10287332.png,216980,7592,209388,0.9650106000553046,1,3,22337,1042,21295,0.9533509423825939,11.946716444444444,1605.0623253333333,16.075884599383468,138,2.6000000000000003E-4
5,test_20231101_140420,11610969.png,368720,9862,358858,0.9732534172271643,2,4,84111,1461,82650,0.9826300959446446,37.92520711111111,6884.959098666666,9.751789962715012,138,2.6000000000000003E-4
6,test_20231101_140420,10350842.png,212614,3067,209547,0.985574797520389,1,3,42529,451,42078,0.9893954713254485,22.92494577777778,3262.384842666667,12.995451702003729,138,2.6000000000000003E-4
7,test_20231101_140420,10863862.png,317432,4987,312445,0.9842895486277375,1,4,66058,733,65325,0.988903690696055,40.24951288888889,7797.499461333334,9.211250074406486,138,2.6000000000000003E-4
8,test_20231101_140420,11382381.png,312486,327,312159,0.9989535531191798,1,3,46745,44,46701,0.9990587228580596,23.441726222222222,2963.055792,13.413405318888326,138,2.6000000000000003E-4
9,test_20231101_140420,11079715.png,443815,87337,356478,0.8032130504827462,3,4,124136,12328,111808,0.9006895662821421,19.342218666666668,2788.1580266666665,13.677629758879972,138,2.6000000000000003E-4
10,test_20231101_140420,11551286.png,271883,124,271759,0.999543921466219,1,3,40092,16,40076,0.9996009178888556,18.13910577777778,1903.2464906666667,15.335853231830718,138,2.6000000000000003E-4
1,test_20231101_140421,10404007.png,502730,10052,492678,0.9800051717621785,2,4,61265,1473,59792,0.9759569085122011,27.024965333333334,3798.832986666667,12.334301603807027,138,2.7000000000000006E-4
2,test_20231101_140421,1254659.png,342646,49322,293324,0.8560555208582619,3,4,80080,6976,73104,0.9128871128871129,24.514750222222222,4371.7237706666665,11.724276478155753,138,2.7000000000000006E-4
3,test_20231101_140421,10188041.png,221231,6497,214734,0.9706325062943258,2,4,41731,918,40813,0.9780019649660924,12.782318222222223,1597.6760213333334,16.095916437197868,138,2.7000000000000006E-4
4,test_20231101_140421,10287332.png,216980,7592,209388,0.9650106000553046,1,4,22337,1042,21295,0.9533509423825939,11.946716444444444,1605.0623253333333,16.075884599383468,138,2.7000000000000006E-4
5,test_20231101_140421,11610969.png,368720,9862,358858,0.9732534172271643,1,3,84111,1461,82650,0.9826300959446446,37.92520711111111,6884.959098666666,9.751789962715012,138,2.7000000000000006E-4
6,test_20231101_140421,10350842.png,212614,3067,209547,0.985574797520389,2,3,42529,451,42078,0.9893954713254485,22.92494577777778,3262.384842666667,12.995451702003729,138,2.7000000000000006E-4
7,test_20231101_140421,10863862.png,317432,4987,312445,0.9842895486277375,2,4,66058,733,65325,0.988903690696055,40.24951288888889,7797.499461333334,9.211250074406486,138,2.7000000000000006E-4
8,test_20231101_140421,11382381.png,312486,327,312159,0.9989535531191798,2,4,46745,44,46701,0.9990587228580596,23.441726222222222,2963.055792,13.413405318888326,138,2.7000000000000006E-4
9,test_20231101_140421,11079715.png,443815,87337,356478,0.8032130504827462,3,4,124136,12328,111808,0.9006895662821421,19.342218666666668,2788.1580266666665,13.677629758879972,138,2.7000000000000006E-4
10,test_20231101_140421,11551286.png,271883,124,271759,0.999543921466219,1,3,40092,16,40076,0.9996009178888556,18.13910577777778,1903.2464906666667,15.335853231830718,138,2.7000000000000006E-4
1,test_20231101_140422,10404007.png,502730,10052,492678,0.9800051717621785,2,4,61265,1473,59792,0.9759569085122011,27.024965333333334,3798.832986666667,12.334301603807027,138,2.800000000000001E-4
2,test_20231101_140422,1254659.png,342646,49322,293324,0.8560555208582619,2,4,80080,6976,73104,0.9128871128871129,24.514750222222222,4371.7237706666665,11.724276478155753,138,2.800000000000001E-4
3,test_20231101_140422,10188041.png,221231,6497,214734,0.9706325062943258,2,4,41731,918,40813,0.9780019649660924,12.782318222222223,1597.6760213333334,16.095916437197868,138,2.800000000000001E-4
4,test_20231101_140422,10287332.png,216980,7592,209388,0.9650106000553046,1,4,22337,1042,21295,0.9533509423825939,11.946716444444444,1605.0623253333333,16.075884599383468,138,2.800000000000001E-4
5,test_20231101_140422,11610969.png,368720,9862,358858,0.9732534172271643,2,4,84111,1461,82650,0.9826300959446446,37.92520711111111,6884.959098666666,9.751789962715012,138,2.800000000000001E-4
6,test_20231101_140422,10350842.png,212614,3067,209547,0.985574797520389,2,3,42529,451,42078,0.9893954713254485,22.92494577777778,3262.384842666667,12.995451702003729,138,2.800000000000001E-4
7,test_20231101_140422,10863862.png,317432,4987,312445,0.9842895486277375,1,3,66058,733,65325,0.988903690696055,40.24951288888889,7797.499461333334,9.211250074406486,138,2.800000000000001E-4
8,test_20231101_140422,11382381.png,312486,327,312159,0.9989535531191798,2,4,46745,44,46701,0.9990587228580596,23.441726222222222,2963.055792,13.413405318888326,138,2.800000000000001E-4
9,test_20231101_140422,11079715.png,443815,87337,356478,0.8032130504827462,3,4,124136,12328,111808,0.9006895662821421,19.342218666666668,2788.1580266666665,13.677629758879972,138,2.800000000000001E-4
10,test_20231101_140422,11551286.png,271883,124,271759,0.999543921466219,1,12,40092,16,40076,0.9996009178888556,18.13910577777778,1903.2464906666667,15.335853231830718,138,2.800000000000001E-4
1,test_20231101_140422,10404007.png,502730,10052,492678,0.9800051717621785,2,4,61265,1473,59792,0.9759569085122011,27.024965333333334,3798.832986666667,12.334301603807027,138,2.900000000000001E-4
2,test_20231101_140422,1254659.png,342646,49322,293324,0.8560555208582619,2,3,80080,6976,73104,0.9128871128871129,24.514750222222222,4371.7237706666665,11.724276478155753,138,2.900000000000001E-4
3,test_20231101_140422,10188041.png,221231,6497,214734,0.9706325062943258,2,4,41731,918,40813,0.9780019649660924,12.782318222222223,1597.6760213333334,16.095916437197868,138,2.900000000000001E-4
4,test_20231101_140422,10287332.png,216980,7592,209388,0.9650106000553046,2,4,22337,1042,21295,0.9533509423825939,11.946716444444444,1605.0623253333333,16.075884599383468,138,2.900000000000001E-4
5,test_20231101_140422,11610969.png,368720,9862,358858,0.9732534172271643,2,4,84111,1461,82650,0.9826300959446446,37.92520711111111,6884.959098666666,9.751789962715012,138,2.900000000000001E-4
6,test_20231101_140422,10350842.png,212614,3067,209547,0.985574797520389,1,3,42529,451,42078,0.9893954713254485,22.92494577777778,3262.384842666667,12.995451702003729,138,2.900000000000001E-4
7,test_20231101_140422,10863862.png,317432,4987,312445,0.9842895486277375,1,3,66058,733,65325,0.988903690696055,40.24951288888889,7797.499461333334,9.211250074406486,138,2.900000000000001E-4
8,test_20231101_140422,11382381.png,312486,327,312159,0.9989535531191798,2,4,46745,44,46701,0.9990587228580596,23.441726222222222,2963.055792,13.413405318888326,138,2.900000000000001E-4
9,test_20231101_140422,11079715.png,443815,87337,356478,0.8032130504827462,4,4,124136,12328,111808,0.9006895662821421,19.342218666666668,2788.1580266666665,13.677629758879972,138,2.900000000000001E-4
10,test_20231101_140422,11551286.png,271883,124,271759,0.999543921466219,1,3,40092,16,40076,0.9996009178888556,18.13910577777778,1903.2464906666667,15.335853231830718,138,2.900000000000001E-4
1,test_20231101_140423,10404007.png,502730,10052,492678,0.9800051717621785,2,3,61265,1473,59792,0.9759569085122011,27.024965333333334,3798.832986666667,12.334301603807027,138,3.0000000000000014E-4
2,test_20231101_140423,1254659.png,342646,49322,293324,0.8560555208582619,2,3,80080,6976,73104,0.9128871128871129,24.514750222222222,4371.7237706666665,11.724276478155753,138,3.0000000000000014E-4
3,test_20231101_140423,10188041.png,221231,6497,214734,0.9706325062943258,2,3,41731,918,40813,0.9780019649660924,12.782318222222223,1597.6760213333334,16.095916437197868,138,3.0000000000000014E-4
4,test_20231101_140423,10287332.png,216980,7592,209388,0.9650106000553046,2,4,22337,1042,21295,0.9533509423825939,11.946716444444444,1605.0623253333333,16.075884599383468,138,3.0000000000000014E-4
5,test_20231101_140423,11610969.png,368720,9862,358858,0.9732534172271643,1,3,84111,1461,82650,0.9826300959446446,37.92520711111111,6884.959098666666,9.751789962715012,138,3.0000000000000014E-4
6,test_20231101_140423,10350842.png,212614,3067,209547,0.985574797520389,2,4,42529,451,42078,0.9893954713254485,22.92494577777778,3262.384842666667,12.995451702003729,138,3.0000000000000014E-4
7,test_20231101_140423,10863862.png,317432,4987,312445,0.9842895486277375,2,4,66058,733,65325,0.988903690696055,40.24951288888889,7797.499461333334,9.211250074406486,138,3.0000000000000014E-4
8,test_20231101_140423,11382381.png,312486,327,312159,0.9989535531191798,1,4,46745,44,46701,0.9990587228580596,23.441726222222222,2963.055792,13.413405318888326,138,3.0000000000000014E-4
9,test_20231101_140423,11079715.png,443815,87337,356478,0.8032130504827462,3,4,124136,12328,111808,0.9006895662821421,19.342218666666668,2788.1580266666665,13.677629758879972,138,3.0000000000000014E-4
10,test_20231101_140423,11551286.png,271883,124,271759,0.999543921466219,1,3,40092,16,40076,0.9996009178888556,18.13910577777778,1903.2464906666667,15.335853231830718,138,3.0000000000000014E-4
1,test_20231101_140424,10404007.png,502730,10052,492678,0.9800051717621785,2,4,61265,1473,59792,0.9759569085122011,27.024965333333334,3798.832986666667,12.334301603807027,138,3.1000000000000016E-4
2,test_20231101_140424,1254659.png,342646,49322,293324,0.8560555208582619,2,4,80080,6976,73104,0.9128871128871129,24.514750222222222,4371.7237706666665,11.724276478155753,138,3.1000000000000016E-4
3,test_20231101_140424,10188041.png,221231,6497,214734,0.9706325062943258,2,3,41731,918,40813,0.9780019649660924,12.782318222222223,1597.6760213333334,16.095916437197868,138,3.1000000000000016E-4
4,test_20231101_140424,10287332.png,216980,7592,209388,0.9650106000553046,1,3,22337,1042,21295,0.9533509423825939,11.946716444444444,1605.0623253333333,16.075884599383468,138,3.1000000000000016E-4
5,test_20231101_140424,11610969.png,368720,9862,358858,0.9732534172271643,2,4,84111,1461,82650,0.9826300959446446,37.92520711111111,6884.959098666666,9.751789962715012,138,3.1000000000000016E-4
6,test_20231101_140424,10350842.png,212614,3067,209547,0.985574797520389,1,8,42529,451,42078,0.9893954713254485,22.92494577777778,3262.384842666667,12.995451702003729,138,3.1000000000000016E-4
7,test_20231101_140424,10863862.png,317432,4987,312445,0.9842895486277375,1,3,66058,733,65325,0.988903690696055,40.24951288888889,7797.499461333334,9.211250074406486,138,3.1000000000000016E-4
8,test_20231101_140424,11382381.png,312486,327,312159,0.9989535531191798,1,4,46745,44,46701,0.9990587228580596,23.441726222222222,2963.055792,13.413405318888326,138,3.1000000000000016E-4
9,test_20231101_140424,11079715.png,443815,87337,356478,0.8032130504827462,3,4,124136,12328,111808,0.9006895662821421,19.342218666666668,2788.1580266666665,13.677629758879972,138,3.1000000000000016E-4
10,test_20231101_140424,11551286.png,271883,124,271759,0.999543921466219,1,3,40092,16,40076,0.9996009178888556,18.13910577777778,1903.2464906666667,15.335853231830718,138,3.1000000000000016E-4
1,test_20231101_140424,10404007.png,502730,9932,492798,0.9802438684781095,2,3,61265,1455,59810,0.97625071411083,27.039667555555557,3802.491781333333,12.330120768214908,138,3.200000000000002E-4
2,test_20231101_140424,1254659.png,342646,49322,293324,0.8560555208582619,3,3,80080,6976,73104,0.9128871128871129,24.514750222222222,4371.7237706666665,11.724276478155753,138,3.200000000000002E-4
3,test_20231101_140424,10188041.png,221231,6497,214734,0.9706325062943258,2,3,41731,918,40813,0.9780019649660924,12.782318222222223,1597.6760213333334,16.095916437197868,138,3.200000000000002E-4
4,test_20231101_140424,10287332.png,216980,7592,209388,0.9650106000553046,1,4,22337,1042,21295,0.9533509423825939,11.946716444444444,1605.0623253333333,16.075884599383468,138,3.200000000000002E-4
5,test_20231101_140424,11610969.png,368720,9862,358858,0.9732534172271643,1,3,84111,1461,82650,0.9826300959446446,37.92520711111111,6884.959098666666,9.751789962715012,138,3.200000000000002E-4
6,test_20231101_140424,10350842.png,212614,3067,209547,0.985574797520389,1,3,42529,451,42078,0.9893954713254485,22.92494577777778,3262.384842666667,12.995451702003729,138,3.200000000000002E-4
7,test_20231101_140424,10863862.png,317432,4987,312445,0.9842895486277375,2,3,66058,733,65325,0.988903690696055,40.24951288888889,7797.499461333334,9.211250074406486,138,3.200000000000002E-4
8,test_20231101_140424,11382381.png,312486,327,312159,0.9989535531191798,2,3,46745,44,46701,0.9990587228580596,23.441726222222222,2963.055792,13.413405318888326,138,3.200000000000002E-4
9,test_20231101_140424,11079715.png,443815,87337,356478,0.8032130504827462,3,4,124136,12328,111808,0.9006895662821421,19.342218666666668,2788.1580266666665,13.677629758879972,138,3.200000000000002E-4
10,test_20231101_140424,11551286.png,271883,124,271759,0.999543921466219,1,4,40092,16,40076,0.9996009178888556,18.13910577777778,1903.2464906666667,15.335853231830718,138,3.200000000000002E-4
1,test_20231101_140425,10404007.png,502730,9932,492798,0.9802438684781095,2,3,61265,1455,59810,0.97625071411083,27.039667555555557,3802.491781333333,12.330120768214908,138,3.300000000000002E-4
2,test_20231101_140425,1254659.png,342646,49322,293324,0.8560555208582619,3,4,80080,6976,73104,0.9128871128871129,24.514750222222222,4371.7237706666665,11.724276478155753,138,3.300000000000002E-4
3,test_20231101_140425,10188041.png,221231,6497,214734,0.9706325062943258,2,4,41731,918,40813,0.9780019649660924,12.782318222222223,1597.6760213333334,16.095916437197868,138,3.300000000000002E-4
4,test_20231101_140425,10287332.png,216980,7592,209388,0.9650106000553046,2,4,22337,1042,21295,0.9533509423825939,11.946716444444444,1605.0623253333333,16.075884599383468,138,3.300000000000002E-4
5,test_20231101_140425,11610969.png,368720,9862,358858,0.9732534172271643,2,4,84111,1461,82650,0.9826300959446446,37.92520711111111,6884.959098666666,9.751789962715012,138,3.300000000000002E-4
6,test_20231101_140425,10350842.png,212614,3067,209547,0.985574797520389,1,4,42529,451,42078,0.9893954713254485,22.92494577777778,3262.384842666667,12.995451702003729,138,3.300000000000002E-4
7,test_20231101_140425,10863862.png,317432,4987,312445,0.9842895486277375,2,4,66058,733,65325,0.988903690696055,40.24951288888889,7797.499461333334,9.211250074406486,138,3.300000000000002E-4
8,test_20231101_140425,11382381.png,312486,327,312159,0.9989535531191798,1,3,46745,44,46701,0.9990587228580596,23.441726222222222,2963.055792,13.413405318888326,138,3.300000000000002E-4
9,test_20231101_140425,11079715.png,443815,87337,356478,0.8032130504827462,3,4,124136,12328,111808,0.9006895662821421,19.342218666666668,2788.1580266666665,13.677629758879972,138,3.300000000000002E-4
10,test_20231101_140425,11551286.png,271883,124,271759,0.999543921466219,2,4,40092,16,40076,0.9996009178888556,18.13910577777778,1903.2464906666667,15.335853231830718,138,3.300000000000002E-4
1,test_20231101_140426,10404007.png,502730,9932,492798,0.9802438684781095,2,4,61265,1455,59810,0.97625071411083,27.039667555555557,3802.491781333333,12.330120768214908,138,3.4000000000000024E-4
2,test_20231101_140426,1254659.png,342646,49322,293324,0.8560555208582619,2,4,80080,6976,73104,0.9128871128871129,24.514750222222222,4371.7237706666665,11.724276478155753,138,3.4000000000000024E-4
3,test_20231101_140426,10188041.png,221231,6497,214734,0.9706325062943258,2,3,41731,918,40813,0.9780019649660924,12.782318222222223,1597.6760213333334,16.095916437197868,138,3.4000000000000024E-4
4,test_20231101_140426,10287332.png,216980,7592,209388,0.9650106000553046,1,3,22337,1042,21295,0.9533509423825939,11.946716444444444,1605.0623253333333,16.075884599383468,138,3.4000000000000024E-4
5,test_20231101_140426,11610969.png,368720,9862,358858,0.9732534172271643,2,4,84111,1461,82650,0.9826300959446446,37.92520711111111,6884.959098666666,9.751789962715012,138,3.4000000000000024E-4
6,test_20231101_140426,10350842.png,212614,3067,209547,0.985574797520389,1,3,42529,451,42078,0.9893954713254485,22.92494577777778,3262.384842666667,12.995451702003729,138,3.4000000000000024E-4
7,test_20231101_140426,10863862.png,317432,4987,312445,0.9842895486277375,1,4,66058,733,65325,0.988903690696055,40.24951288888889,7797.499461333334,9.211250074406486,138,3.4000000000000024E-4
8,test_20231101_140426,11382381.png,312486,327,312159,0.9989535531191798,1,4,46745,44,46701,0.9990587228580596,23.441726222222222,2963.055792,13.413405318888326,138,3.4000000000000024E-4
9,test_20231101_140426,11079715.png,443815,87337,356478,0.8032130504827462,3,3,124136,12328,111808,0.9006895662821421,19.342218666666668,2788.1580266666665,13.677629758879972,138,3.4000000000000024E-4
10,test_20231101_140426,11551286.png,271883,124,271759,0.999543921466219,1,4,40092,16,40076,0.9996009178888556,18.13910577777778,1903.2464906666667,15.335853231830718,138,3.4000000000000024E-4
1,test_20231101_140426,10404007.png,502730,9932,492798,0.9802438684781095,2,3,61265,1455,59810,0.97625071411083,27.039667555555557,3802.491781333333,12.330120768214908,138,3.5000000000000027E-4
2,test_20231101_140426,1254659.png,342646,49322,293324,0.8560555208582619,3,4,80080,6976,73104,0.9128871128871129,24.514750222222222,4371.7237706666665,11.724276478155753,138,3.5000000000000027E-4
3,test_20231101_140426,10188041.png,221231,6497,214734,0.9706325062943258,2,3,41731,918,40813,0.9780019649660924,12.782318222222223,1597.6760213333334,16.095916437197868,138,3.5000000000000027E-4
4,test_20231101_140426,10287332.png,216980,7592,209388,0.9650106000553046,2,4,22337,1042,21295,0.9533509423825939,11.946716444444444,1605.0623253333333,16.075884599383468,138,3.5000000000000027E-4
5,test_20231101_140426,11610969.png,368720,9862,358858,0.9732534172271643,2,5,84111,1461,82650,0.9826300959446446,37.92520711111111,6884.959098666666,9.751789962715012,138,3.5000000000000027E-4
6,test_20231101_140426,10350842.png,212614,3067,209547,0.985574797520389,1,4,42529,451,42078,0.9893954713254485,22.92494577777778,3262.384842666667,12.995451702003729,138,3.5000000000000027E-4
7,test_20231101_140426,10863862.png,317432,4987,312445,0.9842895486277375,2,3,66058,733,65325,0.988903690696055,40.24951288888889,7797.499461333334,9.211250074406486,138,3.5000000000000027E-4
8,test_20231101_140426,11382381.png,312486,327,312159,0.9989535531191798,1,4,46745,44,46701,0.9990587228580596,23.441726222222222,2963.055792,13.413405318888326,138,3.5000000000000027E-4
9,test_20231101_140426,11079715.png,443815,87337,356478,0.8032130504827462,3,3,124136,12328,111808,0.9006895662821421,19.342218666666668,2788.1580266666665,13.677629758879972,138,3.5000000000000027E-4
10,test_20231101_140426,11551286.png,271883,124,271759,0.999543921466219,1,3,40092,16,40076,0.9996009178888556,18.13910577777778,1903.2464906666667,15.335853231830718,138,3.5000000000000027E-4
1,test_20231101_140427,10404007.png,502730,9932,492798,0.9802438684781095,2,4,61265,1455,59810,0.97625071411083,27.039667555555557,3802.491781333333,12.330120768214908,138,3.600000000000003E-4
2,test_20231101_140427,1254659.png,342646,49322,293324,0.8560555208582619,3,4,80080,6976,73104,0.9128871128871129,24.514750222222222,4371.7237706666665,11.724276478155753,138,3.600000000000003E-4
3,test_20231101_140427,10188041.png,221231,6497,214734,0.9706325062943258,2,4,41731,918,40813,0.9780019649660924,12.782318222222223,1597.6760213333334,16.095916437197868,138,3.600000000000003E-4
4,test_20231101_140427,10287332.png,216980,7592,209388,0.9650106000553046,2,4,22337,1042,21295,0.9533509423825939,11.946716444444444,1605.0623253333333,16.075884599383468,138,3.600000000000003E-4
5,test_20231101_140427,11610969.png,368720,9862,358858,0.9732534172271643,1,3,84111,1461,82650,0.9826300959446446,37.92520711111111,6884.959098666666,9.751789962715012,138,3.600000000000003E-4
6,test_20231101_140427,10350842.png,212614,3067,209547,0.985574797520389,1,4,42529,451,42078,0.9893954713254485,22.92494577777778,3262.384842666667,12.995451702003729,138,3.600000000000003E-4
7,test_20231101_140427,10863862.png,317432,4987,312445,0.9842895486277375,2,4,66058,733,65325,0.988903690696055,40.24951288888889,7797.499461333334,9.211250074406486,138,3.600000000000003E-4
8,test_20231101_140427,11382381.png,312486,327,312159,0.9989535531191798,2,3,46745,44,46701,0.9990587228580596,23.441726222222222,2963.055792,13.413405318888326,138,3.600000000000003E-4
9,test_20231101_140427,11079715.png,443815,87337,356478,0.8032130504827462,3,4,124136,12328,111808,0.9006895662821421,19.342218666666668,2788.1580266666665,13.677629758879972,138,3.600000000000003E-4
10,test_20231101_140427,11551286.png,271883,124,271759,0.999543921466219,1,3,40092,16,40076,0.9996009178888556,18.13910577777778,1903.2464906666667,15.335853231830718,138,3.600000000000003E-4
1,test_20231101_140428,10404007.png,502730,9932,492798,0.9802438684781095,2,3,61265,1455,59810,0.97625071411083,27.039667555555557,3802.491781333333,12.330120768214908,138,3.700000000000003E-4
2,test_20231101_140428,1254659.png,342646,49322,293324,0.8560555208582619,2,4,80080,6976,73104,0.9128871128871129,24.514750222222222,4371.7237706666665,11.724276478155753,138,3.700000000000003E-4
3,test_20231101_140428,10188041.png,221231,6497,214734,0.9706325062943258,1,3,41731,918,40813,0.9780019649660924,12.782318222222223,1597.6760213333334,16.095916437197868,138,3.700000000000003E-4
4,test_20231101_140428,10287332.png,216980,7592,209388,0.9650106000553046,2,4,22337,1042,21295,0.9533509423825939,11.946716444444444,1605.0623253333333,16.075884599383468,138,3.700000000000003E-4
5,test_20231101_140428,11610969.png,368720,9862,358858,0.9732534172271643,2,4,84111,1461,82650,0.9826300959446446,37.92520711111111,6884.959098666666,9.751789962715012,138,3.700000000000003E-4
6,test_20231101_140428,10350842.png,212614,3067,209547,0.985574797520389,2,4,42529,451,42078,0.9893954713254485,22.92494577777778,3262.384842666667,12.995451702003729,138,3.700000000000003E-4
7,test_20231101_140428,10863862.png,317432,4987,312445,0.9842895486277375,2,4,66058,733,65325,0.988903690696055,40.24951288888889,7797.499461333334,9.211250074406486,138,3.700000000000003E-4
8,test_20231101_140428,11382381.png,312486,327,312159,0.9989535531191798,1,3,46745,44,46701,0.9990587228580596,23.441726222222222,2963.055792,13.413405318888326,138,3.700000000000003E-4
9,test_20231101_140428,11079715.png,443815,87337,356478,0.8032130504827462,3,4,124136,12328,111808,0.9006895662821421,19.342218666666668,2788.1580266666665,13.677629758879972,138,3.700000000000003E-4
10,test_20231101_140428,11551286.png,271883,124,271759,0.999543921466219,1,3,40092,16,40076,0.9996009178888556,18.13910577777778,1903.2464906666667,15.335853231830718,138,3.700000000000003E-4
1,test_20231101_140428,10404007.png,502730,9932,492798,0.9802438684781095,2,4,61265,1455,59810,0.97625071411083,27.039667555555557,3802.491781333333,12.330120768214908,138,3.8000000000000035E-4
2,test_20231101_140428,1254659.png,342646,49322,293324,0.8560555208582619,2,4,80080,6976,73104,0.9128871128871129,24.514750222222222,4371.7237706666665,11.724276478155753,138,3.8000000000000035E-4
3,test_20231101_140428,10188041.png,221231,6497,214734,0.9706325062943258,2,4,41731,918,40813,0.9780019649660924,12.782318222222223,1597.6760213333334,16.095916437197868,138,3.8000000000000035E-4
4,test_20231101_140428,10287332.png,216980,7592,209388,0.9650106000553046,1,3,22337,1042,21295,0.9533509423825939,11.946716444444444,1605.0623253333333,16.075884599383468,138,3.8000000000000035E-4
5,test_20231101_140428,11610969.png,368720,9862,358858,0.9732534172271643,1,3,84111,1461,82650,0.9826300959446446,37.92520711111111,6884.959098666666,9.751789962715012,138,3.8000000000000035E-4
6,test_20231101_140428,10350842.png,212614,3067,209547,0.985574797520389,3,3,42529,451,42078,0.9893954713254485,22.92494577777778,3262.384842666667,12.995451702003729,138,3.8000000000000035E-4
7,test_20231101_140428,10863862.png,317432,4987,312445,0.9842895486277375,1,3,66058,733,65325,0.988903690696055,40.24951288888889,7797.499461333334,9.211250074406486,138,3.8000000000000035E-4
8,test_20231101_140428,11382381.png,312486,327,312159,0.9989535531191798,1,3,46745,44,46701,0.9990587228580596,23.441726222222222,2963.055792,13.413405318888326,138,3.8000000000000035E-4
9,test_20231101_140428,11079715.png,443815,87337,356478,0.8032130504827462,3,4,124136,12328,111808,0.9006895662821421,19.342218666666668,2788.1580266666665,13.677629758879972,138,3.8000000000000035E-4
10,test_20231101_140428,11551286.png,271883,124,271759,0.999543921466219,1,4,40092,16,40076,0.9996009178888556,18.13910577777778,1903.2464906666667,15.335853231830718,138,3.8000000000000035E-4
1,test_20231101_140429,10404007.png,502730,9932,492798,0.9802438684781095,2,4,61265,1455,59810,0.97625071411083,27.039667555555557,3802.491781333333,12.330120768214908,138,3.9000000000000037E-4
2,test_20231101_140429,1254659.png,342646,49322,293324,0.8560555208582619,3,4,80080,6976,73104,0.9128871128871129,24.514750222222222,4371.7237706666665,11.724276478155753,138,3.9000000000000037E-4
3,test_20231101_140429,10188041.png,221231,6497,214734,0.9706325062943258,2,4,41731,918,40813,0.9780019649660924,12.782318222222223,1597.6760213333334,16.095916437197868,138,3.9000000000000037E-4
4,test_20231101_140429,10287332.png,216980,7592,209388,0.9650106000553046,2,4,22337,1042,21295,0.9533509423825939,11.946716444444444,1605.0623253333333,16.075884599383468,138,3.9000000000000037E-4
5,test_20231101_140429,11610969.png,368720,9862,358858,0.9732534172271643,2,3,84111,1461,82650,0.9826300959446446,37.92520711111111,6884.959098666666,9.751789962715012,138,3.9000000000000037E-4
6,test_20231101_140429,10350842.png,212614,3067,209547,0.985574797520389,1,4,42529,451,42078,0.9893954713254485,22.92494577777778,3262.384842666667,12.995451702003729,138,3.9000000000000037E-4
7,test_20231101_140429,10863862.png,317432,4767,312665,0.984982610448852,1,4,66058,700,65358,0.9894032516879107,40.721374222222224,7914.353488,9.146649171037602,138,3.9000000000000037E-4
8,test_20231101_140429,11382381.png,312486,327,312159,0.9989535531191798,1,3,46745,44,46701,0.9990587228580596,23.441726222222222,2963.055792,13.413405318888326,138,3.9000000000000037E-4
9,test_20231101_140429,11079715.png,443815,87337,356478,0.8032130504827462,3,4,124136,12328,111808,0.9006895662821421,19.342218666666668,2788.1580266666665,13.677629758879972,138,3.9000000000000037E-4
10,test_20231101_140429,11551286.png,271883,124,271759,0.999543921466219,1,4,40092,16,40076,0.9996009178888556,18.13910577777778,1903.2464906666667,15.335853231830718,138,3.9000000000000037E-4
1,test_20231101_140430,10404007.png,502730,9932,492798,0.9802438684781095,3,3,61265,1455,59810,0.97625071411083,27.039667555555557,3802.491781333333,12.330120768214908,138,4.000000000000004E-4
2,test_20231101_140430,1254659.png,342646,49322,293324,0.8560555208582619,3,3,80080,6976,73104,0.9128871128871129,24.514750222222222,4371.7237706666665,11.724276478155753,138,4.000000000000004E-4
3,test_20231101_140430,10188041.png,221231,6497,214734,0.9706325062943258,2,3,41731,918,40813,0.9780019649660924,12.782318222222223,1597.6760213333334,16.095916437197868,138,4.000000000000004E-4
4,test_20231101_140430,10287332.png,216980,7592,209388,0.9650106000553046,1,3,22337,1042,21295,0.9533509423825939,11.946716444444444,1605.0623253333333,16.075884599383468,138,4.000000000000004E-4
5,test_20231101_140430,11610969.png,368720,9862,358858,0.9732534172271643,1,3,84111,1461,82650,0.9826300959446446,37.92520711111111,6884.959098666666,9.751789962715012,138,4.000000000000004E-4
6,test_20231101_140430,10350842.png,212614,3067,209547,0.985574797520389,2,3,42529,451,42078,0.9893954713254485,22.92494577777778,3262.384842666667,12.995451702003729,138,4.000000000000004E-4
7,test_20231101_140430,10863862.png,317432,4767,312665,0.984982610448852,1,3,66058,700,65358,0.9894032516879107,40.721374222222224,7914.353488,9.146649171037602,138,4.000000000000004E-4
8,test_20231101_140430,11382381.png,312486,327,312159,0.9989535531191798,1,3,46745,44,46701,0.9990587228580596,23.441726222222222,2963.055792,13.413405318888326,138,4.000000000000004E-4
9,test_20231101_140430,11079715.png,443815,87337,356478,0.8032130504827462,3,4,124136,12328,111808,0.9006895662821421,19.342218666666668,2788.1580266666665,13.677629758879972,138,4.000000000000004E-4
10,test_20231101_140430,11551286.png,271883,124,271759,0.999543921466219,1,4,40092,16,40076,0.9996009178888556,18.13910577777778,1903.2464906666667,15.335853231830718,138,4.000000000000004E-4
1,test_20231101_140431,10404007.png,502730,9932,492798,0.9802438684781095,2,4,61265,1455,59810,0.97625071411083,27.039667555555557,3802.491781333333,12.330120768214908,138,4.100000000000004E-4
2,test_20231101_140431,1254659.png,342646,49322,293324,0.8560555208582619,2,4,80080,6976,73104,0.9128871128871129,24.514750222222222,4371.7237706666665,11.724276478155753,138,4.100000000000004E-4
3,test_20231101_140431,10188041.png,221231,6497,214734,0.9706325062943258,2,4,41731,918,40813,0.9780019649660924,12.782318222222223,1597.6760213333334,16.095916437197868,138,4.100000000000004E-4
4,test_20231101_140431,10287332.png,216980,7592,209388,0.9650106000553046,2,4,22337,1042,21295,0.9533509423825939,11.946716444444444,1605.0623253333333,16.075884599383468,138,4.100000000000004E-4
5,test_20231101_140431,11610969.png,368720,9862,358858,0.9732534172271643,1,4,84111,1461,82650,0.9826300959446446,37.92520711111111,6884.959098666666,9.751789962715012,138,4.100000000000004E-4
6,test_20231101_140431,10350842.png,212614,3067,209547,0.985574797520389,1,4,42529,451,42078,0.9893954713254485,22.92494577777778,3262.384842666667,12.995451702003729,138,4.100000000000004E-4
7,test_20231101_140431,10863862.png,317432,4767,312665,0.984982610448852,1,4,66058,700,65358,0.9894032516879107,40.721374222222224,7914.353488,9.146649171037602,138,4.100000000000004E-4
8,test_20231101_140431,11382381.png,312486,327,312159,0.9989535531191798,1,4,46745,44,46701,0.9990587228580596,23.441726222222222,2963.055792,13.413405318888326,138,4.100000000000004E-4
9,test_20231101_140431,11079715.png,443815,87337,356478,0.8032130504827462,3,4,124136,12328,111808,0.9006895662821421,19.342218666666668,2788.1580266666665,13.677629758879972,138,4.100000000000004E-4
10,test_20231101_140431,11551286.png,271883,124,271759,0.999543921466219,1,4,40092,16,40076,0.9996009178888556,18.13910577777778,1903.2464906666667,15.335853231830718,138,4.100000000000004E-4
1,test_20231101_140431,10404007.png,502730,9932,492798,0.9802438684781095,2,4,61265,1455,59810,0.97625071411083,27.039667555555557,3802.491781333333,12.330120768214908,138,4.2000000000000045E-4
2,test_20231101_140431,1254659.png,342646,49322,293324,0.8560555208582619,3,4,80080,6976,73104,0.9128871128871129,24.514750222222222,4371.7237706666665,11.724276478155753,138,4.2000000000000045E-4
3,test_20231101_140431,10188041.png,221231,6497,214734,0.9706325062943258,1,3,41731,918,40813,0.9780019649660924,12.782318222222223,1597.6760213333334,16.095916437197868,138,4.2000000000000045E-4
4,test_20231101_140431,10287332.png,216980,7592,209388,0.9650106000553046,2,4,22337,1042,21295,0.9533509423825939,11.946716444444444,1605.0623253333333,16.075884599383468,138,4.2000000000000045E-4
5,test_20231101_140431,11610969.png,368720,9862,358858,0.9732534172271643,2,3,84111,1461,82650,0.9826300959446446,37.92520711111111,6884.959098666666,9.751789962715012,138,4.2000000000000045E-4
6,test_20231101_140431,10350842.png,212614,3067,209547,0.985574797520389,1,3,42529,451,42078,0.9893954713254485,22.92494577777778,3262.384842666667,12.995451702003729,138,4.2000000000000045E-4
7,test_20231101_140431,10863862.png,317432,4767,312665,0.984982610448852,2,3,66058,700,65358,0.9894032516879107,40.721374222222224,7914.353488,9.146649171037602,138,4.2000000000000045E-4
8,test_20231101_140431,11382381.png,312486,327,312159,0.9989535531191798,1,3,46745,44,46701,0.9990587228580596,23.441726222222222,2963.055792,13.413405318888326,138,4.2000000000000045E-4
9,test_20231101_140431,11079715.png,443815,87337,356478,0.8032130504827462,3,3,124136,12328,111808,0.9006895662821421,19.342218666666668,2788.1580266666665,13.677629758879972,138,4.2000000000000045E-4
10,test_20231101_140431,11551286.png,271883,124,271759,0.999543921466219,1,4,40092,16,40076,0.9996009178888556,18.13910577777778,1903.2464906666667,15.335853231830718,138,4.2000000000000045E-4
1,test_20231101_140432,10404007.png,502730,9932,492798,0.9802438684781095,2,3,61265,1455,59810,0.97625071411083,27.039667555555557,3802.491781333333,12.330120768214908,138,4.300000000000005E-4
2,test_20231101_140432,1254659.png,342646,49322,293324,0.8560555208582619,3,4,80080,6976,73104,0.9128871128871129,24.514750222222222,4371.7237706666665,11.724276478155753,138,4.300000000000005E-4
3,test_20231101_140432,10188041.png,221231,6497,214734,0.9706325062943258,2,4,41731,918,40813,0.9780019649660924,12.782318222222223,1597.6760213333334,16.095916437197868,138,4.300000000000005E-4
4,test_20231101_140432,10287332.png,216980,7592,209388,0.9650106000553046,1,3,22337,1042,21295,0.9533509423825939,11.946716444444444,1605.0623253333333,16.075884599383468,138,4.300000000000005E-4
5,test_20231101_140432,11610969.png,368720,9862,358858,0.9732534172271643,2,4,84111,1461,82650,0.9826300959446446,37.92520711111111,6884.959098666666,9.751789962715012,138,4.300000000000005E-4
6,test_20231101_140432,10350842.png,212614,3067,209547,0.985574797520389,1,4,42529,451,42078,0.9893954713254485,22.92494577777778,3262.384842666667,12.995451702003729,138,4.300000000000005E-4
7,test_20231101_140432,10863862.png,317432,4767,312665,0.984982610448852,2,4,66058,700,65358,0.9894032516879107,40.721374222222224,7914.353488,9.146649171037602,138,4.300000000000005E-4
8,test_20231101_140432,11382381.png,312486,327,312159,0.9989535531191798,2,3,46745,44,46701,0.9990587228580596,23.441726222222222,2963.055792,13.413405318888326,138,4.300000000000005E-4
9,test_20231101_140432,11079715.png,443815,87337,356478,0.8032130504827462,3,4,124136,12328,111808,0.9006895662821421,19.342218666666668,2788.1580266666665,13.677629758879972,138,4.300000000000005E-4
10,test_20231101_140432,11551286.png,271883,124,271759,0.999543921466219,1,4,40092,16,40076,0.9996009178888556,18.13910577777778,1903.2464906666667,15.335853231830718,138,4.300000000000005E-4
1,test_20231101_140433,10404007.png,502730,9932,492798,0.9802438684781095,2,4,61265,1455,59810,0.97625071411083,27.039667555555557,3802.491781333333,12.330120768214908,138,4.400000000000005E-4
2,test_20231101_140433,1254659.png,342646,49322,293324,0.8560555208582619,2,3,80080,6976,73104,0.9128871128871129,24.514750222222222,4371.7237706666665,11.724276478155753,138,4.400000000000005E-4
3,test_20231101_140433,10188041.png,221231,6497,214734,0.9706325062943258,2,3,41731,918,40813,0.9780019649660924,12.782318222222223,1597.6760213333334,16.095916437197868,138,4.400000000000005E-4
4,test_20231101_140433,10287332.png,216980,7592,209388,0.9650106000553046,1,4,22337,1042,21295,0.9533509423825939,11.946716444444444,1605.0623253333333,16.075884599383468,138,4.400000000000005E-4
5,test_20231101_140433,11610969.png,368720,9862,358858,0.9732534172271643,2,5,84111,1461,82650,0.9826300959446446,37.92520711111111,6884.959098666666,9.751789962715012,138,4.400000000000005E-4
6,test_20231101_140433,10350842.png,212614,3067,209547,0.985574797520389,1,4,42529,451,42078,0.9893954713254485,22.92494577777778,3262.384842666667,12.995451702003729,138,4.400000000000005E-4
7,test_20231101_140433,10863862.png,317432,4767,312665,0.984982610448852,2,3,66058,700,65358,0.9894032516879107,40.721374222222224,7914.353488,9.146649171037602,138,4.400000000000005E-4
8,test_20231101_140433,11382381.png,312486,327,312159,0.9989535531191798,1,4,46745,44,46701,0.9990587228580596,23.441726222222222,2963.055792,13.413405318888326,138,4.400000000000005E-4
9,test_20231101_140433,11079715.png,443815,87337,356478,0.8032130504827462,2,4,124136,12328,111808,0.9006895662821421,19.342218666666668,2788.1580266666665,13.677629758879972,138,4.400000000000005E-4
10,test_20231101_140433,11551286.png,271883,124,271759,0.999543921466219,1,3,40092,16,40076,0.9996009178888556,18.13910577777778,1903.2464906666667,15.335853231830718,138,4.400000000000005E-4
1,test_20231101_140433,10404007.png,502730,9932,492798,0.9802438684781095,2,4,61265,1455,59810,0.97625071411083,27.039667555555557,3802.491781333333,12.330120768214908,138,4.5000000000000053E-4
2,test_20231101_140433,1254659.png,342646,49322,293324,0.8560555208582619,3,4,80080,6976,73104,0.9128871128871129,24.514750222222222,4371.7237706666665,11.724276478155753,138,4.5000000000000053E-4
3,test_20231101_140433,10188041.png,221231,6497,214734,0.9706325062943258,2,4,41731,918,40813,0.9780019649660924,12.782318222222223,1597.6760213333334,16.095916437197868,138,4.5000000000000053E-4
4,test_20231101_140433,10287332.png,216980,7592,209388,0.9650106000553046,1,4,22337,1042,21295,0.9533509423825939,11.946716444444444,1605.0623253333333,16.075884599383468,138,4.5000000000000053E-4
5,test_20231101_140433,11610969.png,368720,9862,358858,0.9732534172271643,2,3,84111,1461,82650,0.9826300959446446,37.92520711111111,6884.959098666666,9.751789962715012,138,4.5000000000000053E-4
6,test_20231101_140433,10350842.png,212614,2407,210207,0.9886790145521932,1,11,42529,353,42176,0.9916997813256837,25.652378666666667,3921.7766666666666,12.195975025906971,138,4.5000000000000053E-4
7,test_20231101_140433,10863862.png,317432,4767,312665,0.984982610448852,2,3,66058,700,65358,0.9894032516879107,40.721374222222224,7914.353488,9.146649171037602,138,4.5000000000000053E-4
8,test_20231101_140433,11382381.png,312486,327,312159,0.9989535531191798,1,4,46745,44,46701,0.9990587228580596,23.441726222222222,2963.055792,13.413405318888326,138,4.5000000000000053E-4
9,test_20231101_140433,11079715.png,443815,87337,356478,0.8032130504827462,3,4,124136,12328,111808,0.9006895662821421,19.342218666666668,2788.1580266666665,13.677629758879972,138,4.5000000000000053E-4
10,test_20231101_140433,11551286.png,271883,124,271759,0.999543921466219,2,3,40092,16,40076,0.9996009178888556,18.13910577777778,1903.2464906666667,15.335853231830718,138,4.5000000000000053E-4
1,test_20231101_140434,10404007.png,502730,9932,492798,0.9802438684781095,2,3,61265,1455,59810,0.97625071411083,27.039667555555557,3802.491781333333,12.330120768214908,138,4.6000000000000056E-4
2,test_20231101_140434,1254659.png,342646,49322,293324,0.8560555208582619,3,4,80080,6976,73104,0.9128871128871129,24.514750222222222,4371.7237706666665,11.724276478155753,138,4.6000000000000056E-4
3,test_20231101_140434,10188041.png,221231,6497,214734,0.9706325062943258,2,3,41731,918,40813,0.9780019649660924,12.782318222222223,1597.6760213333334,16.095916437197868,138,4.6000000000000056E-4
4,test_20231101_140434,10287332.png,216980,7592,209388,0.9650106000553046,2,4,22337,1042,21295,0.9533509423825939,11.946716444444444,1605.0623253333333,16.075884599383468,138,4.6000000000000056E-4
5,test_20231101_140434,11610969.png,368720,9862,358858,0.9732534172271643,2,3,84111,1461,82650,0.9826300959446446,37.92520711111111,6884.959098666666,9.751789962715012,138,4.6000000000000056E-4
6,test_20231101_140434,10350842.png,212614,2407,210207,0.9886790145521932,1,4,42529,353,42176,0.9916997813256837,25.652378666666667,3921.7766666666666,12.195975025906971,138,4.6000000000000056E-4
7,test_20231101_140434,10863862.png,317432,4767,312665,0.984982610448852,1,4,66058,700,65358,0.9894032516879107,40.721374222222224,7914.353488,9.146649171037602,138,4.6000000000000056E-4
8,test_20231101_140434,11382381.png,312486,327,312159,0.9989535531191798,1,4,46745,44,46701,0.9990587228580596,23.441726222222222,2963.055792,13.413405318888326,138,4.6000000000000056E-4
9,test_20231101_140434,11079715.png,443815,87337,356478,0.8032130504827462,3,4,124136,12328,111808,0.9006895662821421,19.342218666666668,2788.1580266666665,13.677629758879972,138,4.6000000000000056E-4
10,test_20231101_140434,11551286.png,271883,124,271759,0.999543921466219,1,4,40092,16,40076,0.9996009178888556,18.13910577777778,1903.2464906666667,15.335853231830718,138,4.6000000000000056E-4
1,test_20231101_140435,10404007.png,502730,9612,493118,0.9808803930539256,2,4,61265,1408,59857,0.9770178731739166,27.373710222222222,3874.3319466666667,12.248835332226523,138,4.700000000000006E-4
2,test_20231101_140435,1254659.png,342646,49322,293324,0.8560555208582619,3,4,80080,6976,73104,0.9128871128871129,24.514750222222222,4371.7237706666665,11.724276478155753,138,4.700000000000006E-4
3,test_20231101_140435,10188041.png,221231,6497,214734,0.9706325062943258,2,3,41731,918,40813,0.9780019649660924,12.782318222222223,1597.6760213333334,16.095916437197868,138,4.700000000000006E-4
4,test_20231101_140435,10287332.png,216980,7592,209388,0.9650106000553046,2,4,22337,1042,21295,0.9533509423825939,11.946716444444444,1605.0623253333333,16.075884599383468,138,4.700000000000006E-4
5,test_20231101_140435,11610969.png,368720,9862,358858,0.9732534172271643,1,3,84111,1461,82650,0.9826300959446446,37.92520711111111,6884.959098666666,9.751789962715012,138,4.700000000000006E-4
6,test_20231101_140435,10350842.png,212614,2407,210207,0.9886790145521932,2,3,42529,353,42176,0.9916997813256837,25.652378666666667,3921.7766666666666,12.195975025906971,138,4.700000000000006E-4
7,test_20231101_140435,10863862.png,317432,4767,312665,0.984982610448852,1,12,66058,700,65358,0.9894032516879107,40.721374222222224,7914.353488,9.146649171037602,138,4.700000000000006E-4
8,test_20231101_140435,11382381.png,312486,327,312159,0.9989535531191798,2,4,46745,44,46701,0.9990587228580596,23.441726222222222,2963.055792,13.413405318888326,138,4.700000000000006E-4
9,test_20231101_140435,11079715.png,443815,87337,356478,0.8032130504827462,3,4,124136,12328,111808,0.9006895662821421,19.342218666666668,2788.1580266666665,13.677629758879972,138,4.700000000000006E-4
10,test_20231101_140435,11551286.png,271883,124,271759,0.999543921466219,2,3,40092,16,40076,0.9996009178888556,18.13910577777778,1903.2464906666667,15.335853231830718,138,4.700000000000006E-4
1,test_20231101_140435,10404007.png,502730,9612,493118,0.9808803930539256,2,3,61265,1408,59857,0.9770178731739166,27.373710222222222,3874.3319466666667,12.248835332226523,138,4.800000000000006E-4
2,test_20231101_140435,1254659.png,342646,49322,293324,0.8560555208582619,2,11,80080,6976,73104,0.9128871128871129,24.514750222222222,4371.7237706666665,11.724276478155753,138,4.800000000000006E-4
3,test_20231101_140435,10188041.png,221231,6497,214734,0.9706325062943258,1,3,41731,918,40813,0.9780019649660924,12.782318222222223,1597.6760213333334,16.095916437197868,138,4.800000000000006E-4
4,test_20231101_140435,10287332.png,216980,7592,209388,0.9650106000553046,2,3,22337,1042,21295,0.9533509423825939,11.946716444444444,1605.0623253333333,16.075884599383468,138,4.800000000000006E-4
5,test_20231101_140435,11610969.png,368720,9862,358858,0.9732534172271643,2,4,84111,1461,82650,0.9826300959446446,37.92520711111111,6884.959098666666,9.751789962715012,138,4.800000000000006E-4
6,test_20231101_140435,10350842.png,212614,2407,210207,0.9886790145521932,1,3,42529,353,42176,0.9916997813256837,25.652378666666667,3921.7766666666666,12.195975025906971,138,4.800000000000006E-4
7,test_20231101_140435,10863862.png,317432,4767,312665,0.984982610448852,2,3,66058,700,65358,0.9894032516879107,40.721374222222224,7914.353488,9.146649171037602,138,4.800000000000006E-4
8,test_20231101_140435,11382381.png,312486,327,312159,0.9989535531191798,2,3,46745,44,46701,0.9990587228580596,23.441726222222222,2963.055792,13.413405318888326,138,4.800000000000006E-4
9,test_20231101_140435,11079715.png,443815,87337,356478,0.8032130504827462,3,4,124136,12328,111808,0.9006895662821421,19.342218666666668,2788.1580266666665,13.677629758879972,138,4.800000000000006E-4
10,test_20231101_140435,11551286.png,271883,24,271859,0.9999117267353972,1,4,40092,1,40091,0.9999750573680535,24.866876444444443,3470.407338666667,12.72699907819776,138,4.800000000000006E-4
1,test_20231101_140436,10404007.png,502730,9612,493118,0.9808803930539256,2,4,61265,1408,59857,0.9770178731739166,27.373710222222222,3874.3319466666667,12.248835332226523,138,4.900000000000006E-4
2,test_20231101_140436,1254659.png,342646,49322,293324,0.8560555208582619,3,4,80080,6976,73104,0.9128871128871129,24.514750222222222,4371.7237706666665,11.724276478155753,138,4.900000000000006E-4
3,test_20231101_140436,10188041.png,221231,6497,214734,0.9706325062943258,2,4,41731,918,40813,0.9780019649660924,12.782318222222223,1597.6760213333334,16.095916437197868,138,4.900000000000006E-4
4,test_20231101_140436,10287332.png,216980,7592,209388,0.9650106000553046,2,3,22337,1042,21295,0.9533509423825939,11.946716444444444,1605.0623253333333,16.075884599383468,138,4.900000000000006E-4
5,test_20231101_140436,11610969.png,368720,9862,358858,0.9732534172271643,2,4,84111,1461,82650,0.9826300959446446,37.92520711111111,6884.959098666666,9.751789962715012,138,4.900000000000006E-4
6,test_20231101_140436,10350842.png,212614,2407,210207,0.9886790145521932,2,3,42529,353,42176,0.9916997813256837,25.652378666666667,3921.7766666666666,12.195975025906971,138,4.900000000000006E-4
7,test_20231101_140436,10863862.png,317432,4767,312665,0.984982610448852,2,4,66058,700,65358,0.9894032516879107,40.721374222222224,7914.353488,9.146649171037602,138,4.900000000000006E-4
8,test_20231101_140436,11382381.png,312486,327,312159,0.9989535531191798,1,4,46745,44,46701,0.9990587228580596,23.441726222222222,2963.055792,13.413405318888326,138,4.900000000000006E-4
9,test_20231101_140436,11079715.png,443815,87337,356478,0.8032130504827462,2,4,124136,12328,111808,0.9006895662821421,19.342218666666668,2788.1580266666665,13.677629758879972,138,4.900000000000006E-4
10,test_20231101_140436,11551286.png,271883,24,271859,0.9999117267353972,0,3,40092,1,40091,0.9999750573680535,24.866876444444443,3470.407338666667,12.72699907819776,138,4.900000000000006E-4
1,test_20231101_140437,10404007.png,502730,9612,493118,0.9808803930539256,2,3,61265,1408,59857,0.9770178731739166,27.373710222222222,3874.3319466666667,12.248835332226523,138,5.000000000000007E-4
2,test_20231101_140437,1254659.png,342646,49322,293324,0.8560555208582619,2,4,80080,6976,73104,0.9128871128871129,24.514750222222222,4371.7237706666665,11.724276478155753,138,5.000000000000007E-4
3,test_20231101_140437,10188041.png,221231,6497,214734,0.9706325062943258,3,4,41731,918,40813,0.9780019649660924,12.782318222222223,1597.6760213333334,16.095916437197868,138,5.000000000000007E-4
4,test_20231101_140437,10287332.png,216980,7592,209388,0.9650106000553046,2,4,22337,1042,21295,0.9533509423825939,11.946716444444444,1605.0623253333333,16.075884599383468,138,5.000000000000007E-4
5,test_20231101_140437,11610969.png,368720,9862,358858,0.9732534172271643,2,4,84111,1461,82650,0.9826300959446446,37.92520711111111,6884.959098666666,9.751789962715012,138,5.000000000000007E-4
6,test_20231101_140437,10350842.png,212614,2407,210207,0.9886790145521932,1,3,42529,353,42176,0.9916997813256837,25.652378666666667,3921.7766666666666,12.195975025906971,138,5.000000000000007E-4
7,test_20231101_140437,10863862.png,317432,4767,312665,0.984982610448852,2,3,66058,700,65358,0.9894032516879107,40.721374222222224,7914.353488,9.146649171037602,138,5.000000000000007E-4
8,test_20231101_140437,11382381.png,312486,327,312159,0.9989535531191798,1,4,46745,44,46701,0.9990587228580596,23.441726222222222,2963.055792,13.413405318888326,138,5.000000000000007E-4
9,test_20231101_140437,11079715.png,443815,87337,356478,0.8032130504827462,3,7,124136,12328,111808,0.9006895662821421,19.342218666666668,2788.1580266666665,13.677629758879972,138,5.000000000000007E-4
10,test_20231101_140437,11551286.png,271883,24,271859,0.9999117267353972,1,4,40092,1,40091,0.9999750573680535,24.866876444444443,3470.407338666667,12.72699907819776,138,5.000000000000007E-4
1,test_20231101_140437,10404007.png,502730,9489,493241,0.9811250571877549,1,3,61265,1391,59874,0.9772953562392883,27.381216,3876.645088,12.246243182766502,138,5.100000000000007E-4
2,test_20231101_140437,1254659.png,342646,49322,293324,0.8560555208582619,2,3,80080,6976,73104,0.9128871128871129,24.514750222222222,4371.7237706666665,11.724276478155753,138,5.100000000000007E-4
3,test_20231101_140437,10188041.png,221231,6497,214734,0.9706325062943258,2,4,41731,918,40813,0.9780019649660924,12.782318222222223,1597.6760213333334,16.095916437197868,138,5.100000000000007E-4
4,test_20231101_140437,10287332.png,216980,7592,209388,0.9650106000553046,2,4,22337,1042,21295,0.9533509423825939,11.946716444444444,1605.0623253333333,16.075884599383468,138,5.100000000000007E-4
5,test_20231101_140437,11610969.png,368720,9862,358858,0.9732534172271643,2,3,84111,1461,82650,0.9826300959446446,37.92520711111111,6884.959098666666,9.751789962715012,138,5.100000000000007E-4
6,test_20231101_140437,10350842.png,212614,2407,210207,0.9886790145521932,1,4,42529,353,42176,0.9916997813256837,25.652378666666667,3921.7766666666666,12.195975025906971,138,5.100000000000007E-4
7,test_20231101_140437,10863862.png,317432,4767,312665,0.984982610448852,1,4,66058,700,65358,0.9894032516879107,40.721374222222224,7914.353488,9.146649171037602,138,5.100000000000007E-4
8,test_20231101_140437,11382381.png,312486,327,312159,0.9989535531191798,1,4,46745,44,46701,0.9990587228580596,23.441726222222222,2963.055792,13.413405318888326,138,5.100000000000007E-4
9,test_20231101_140437,11079715.png,443815,87157,356658,0.8036186248774827,3,5,124136,12301,111835,0.9009070696655281,19.579482666666667,2830.1671626666666,13.612682731599836,138,5.100000000000007E-4
10,test_20231101_140437,11551286.png,271883,24,271859,0.9999117267353972,0,3,40092,1,40091,0.9999750573680535,24.866876444444443,3470.407338666667,12.72699907819776,138,5.100000000000007E-4
1,test_20231101_140438,10404007.png,502730,9489,493241,0.9811250571877549,1,3,61265,1391,59874,0.9772953562392883,27.381216,3876.645088,12.246243182766502,138,5.200000000000007E-4
2,test_20231101_140438,1254659.png,342646,49322,293324,0.8560555208582619,2,4,80080,6976,73104,0.9128871128871129,24.514750222222222,4371.7237706666665,11.724276478155753,138,5.200000000000007E-4
3,test_20231101_140438,10188041.png,221231,6497,214734,0.9706325062943258,2,4,41731,918,40813,0.9780019649660924,12.782318222222223,1597.6760213333334,16.095916437197868,138,5.200000000000007E-4
4,test_20231101_140438,10287332.png,216980,7592,209388,0.9650106000553046,2,4,22337,1042,21295,0.9533509423825939,11.946716444444444,1605.0623253333333,16.075884599383468,138,5.200000000000007E-4
5,test_20231101_140438,11610969.png,368720,9862,358858,0.9732534172271643,1,3,84111,1461,82650,0.9826300959446446,37.92520711111111,6884.959098666666,9.751789962715012,138,5.200000000000007E-4
6,test_20231101_140438,10350842.png,212614,2407,210207,0.9886790145521932,1,4,42529,353,42176,0.9916997813256837,25.652378666666667,3921.7766666666666,12.195975025906971,138,5.200000000000007E-4
7,test_20231101_140438,10863862.png,317432,4767,312665,0.984982610448852,1,3,66058,700,65358,0.9894032516879107,40.721374222222224,7914.353488,9.146649171037602,138,5.200000000000007E-4
8,test_20231101_140438,11382381.png,312486,327,312159,0.9989535531191798,2,3,46745,44,46701,0.9990587228580596,23.441726222222222,2963.055792,13.413405318888326,138,5.200000000000007E-4
9,test_20231101_140438,11079715.png,443815,87157,356658,0.8036186248774827,3,4,124136,12301,111835,0.9009070696655281,19.579482666666667,2830.1671626666666,13.612682731599836,138,5.200000000000007E-4
10,test_20231101_140438,11551286.png,271883,24,271859,0.9999117267353972,1,4,40092,1,40091,0.9999750573680535,24.866876444444443,3470.407338666667,12.72699907819776,138,5.200000000000007E-4
1,test_20231101_140439,10404007.png,502730,9489,493241,0.9811250571877549,2,4,61265,1391,59874,0.9772953562392883,27.381216,3876.645088,12.246243182766502,138,5.300000000000007E-4
2,test_20231101_140439,1254659.png,342646,49322,293324,0.8560555208582619,3,4,80080,6976,73104,0.9128871128871129,24.514750222222222,4371.7237706666665,11.724276478155753,138,5.300000000000007E-4
3,test_20231101_140439,10188041.png,221231,6497,214734,0.9706325062943258,2,4,41731,918,40813,0.9780019649660924,12.782318222222223,1597.6760213333334,16.095916437197868,138,5.300000000000007E-4
4,test_20231101_140439,10287332.png,216980,7592,209388,0.9650106000553046,2,4,22337,1042,21295,0.9533509423825939,11.946716444444444,1605.0623253333333,16.075884599383468,138,5.300000000000007E-4
5,test_20231101_140439,11610969.png,368720,9862,358858,0.9732534172271643,1,4,84111,1461,82650,0.9826300959446446,37.92520711111111,6884.959098666666,9.751789962715012,138,5.300000000000007E-4
6,test_20231101_140439,10350842.png,212614,2407,210207,0.9886790145521932,1,4,42529,353,42176,0.9916997813256837,25.652378666666667,3921.7766666666666,12.195975025906971,138,5.300000000000007E-4
7,test_20231101_140439,10863862.png,317432,4767,312665,0.984982610448852,1,4,66058,700,65358,0.9894032516879107,40.721374222222224,7914.353488,9.146649171037602,138,5.300000000000007E-4
8,test_20231101_140439,11382381.png,312486,327,312159,0.9989535531191798,1,8,46745,44,46701,0.9990587228580596,23.441726222222222,2963.055792,13.413405318888326,138,5.300000000000007E-4
9,test_20231101_140439,11079715.png,443815,87157,356658,0.8036186248774827,3,5,124136,12301,111835,0.9009070696655281,19.579482666666667,2830.1671626666666,13.612682731599836,138,5.300000000000007E-4
10,test_20231101_140439,11551286.png,271883,24,271859,0.9999117267353972,1,3,40092,1,40091,0.9999750573680535,24.866876444444443,3470.407338666667,12.72699907819776,138,5.300000000000007E-4
1,test_20231101_140439,10404007.png,502730,9489,493241,0.9811250571877549,2,3,61265,1391,59874,0.9772953562392883,27.381216,3876.645088,12.246243182766502,138,5.400000000000008E-4
2,test_20231101_140439,1254659.png,342646,49322,293324,0.8560555208582619,3,4,80080,6976,73104,0.9128871128871129,24.514750222222222,4371.7237706666665,11.724276478155753,138,5.400000000000008E-4
3,test_20231101_140439,10188041.png,221231,6497,214734,0.9706325062943258,2,4,41731,918,40813,0.9780019649660924,12.782318222222223,1597.6760213333334,16.095916437197868,138,5.400000000000008E-4
4,test_20231101_140439,10287332.png,216980,7592,209388,0.9650106000553046,2,4,22337,1042,21295,0.9533509423825939,11.946716444444444,1605.0623253333333,16.075884599383468,138,5.400000000000008E-4
5,test_20231101_140439,11610969.png,368720,9862,358858,0.9732534172271643,1,3,84111,1461,82650,0.9826300959446446,37.92520711111111,6884.959098666666,9.751789962715012,138,5.400000000000008E-4
6,test_20231101_140439,10350842.png,212614,2407,210207,0.9886790145521932,1,3,42529,353,42176,0.9916997813256837,25.652378666666667,3921.7766666666666,12.195975025906971,138,5.400000000000008E-4
7,test_20231101_140439,10863862.png,317432,4767,312665,0.984982610448852,2,3,66058,700,65358,0.9894032516879107,40.721374222222224,7914.353488,9.146649171037602,138,5.400000000000008E-4
8,test_20231101_140439,11382381.png,312486,327,312159,0.9989535531191798,2,3,46745,44,46701,0.9990587228580596,23.441726222222222,2963.055792,13.413405318888326,138,5.400000000000008E-4
9,test_20231101_140439,11079715.png,443815,87157,356658,0.8036186248774827,3,4,124136,12301,111835,0.9009070696655281,19.579482666666667,2830.1671626666666,13.612682731599836,138,5.400000000000008E-4
10,test_20231101_140439,11551286.png,271883,24,271859,0.9999117267353972,1,3,40092,1,40091,0.9999750573680535,24.866876444444443,3470.407338666667,12.72699907819776,138,5.400000000000008E-4
1,test_20231101_140440,10404007.png,502730,9489,493241,0.9811250571877549,2,4,61265,1391,59874,0.9772953562392883,27.381216,3876.645088,12.246243182766502,138,5.500000000000008E-4
2,test_20231101_140440,1254659.png,342646,49322,293324,0.8560555208582619,2,4,80080,6976,73104,0.9128871128871129,24.514750222222222,4371.7237706666665,11.724276478155753,138,5.500000000000008E-4
3,test_20231101_140440,10188041.png,221231,6497,214734,0.9706325062943258,1,3,41731,918,40813,0.9780019649660924,12.782318222222223,1597.6760213333334,16.095916437197868,138,5.500000000000008E-4
4,test_20231101_140440,10287332.png,216980,7592,209388,0.9650106000553046,2,3,22337,1042,21295,0.9533509423825939,11.946716444444444,1605.0623253333333,16.075884599383468,138,5.500000000000008E-4
5,test_20231101_140440,11610969.png,368720,9862,358858,0.9732534172271643,2,3,84111,1461,82650,0.9826300959446446,37.92520711111111,6884.959098666666,9.751789962715012,138,5.500000000000008E-4
6,test_20231101_140440,10350842.png,212614,2407,210207,0.9886790145521932,1,3,42529,353,42176,0.9916997813256837,25.652378666666667,3921.7766666666666,12.195975025906971,138,5.500000000000008E-4
7,test_20231101_140440,10863862.png,317432,4767,312665,0.984982610448852,2,3,66058,700,65358,0.9894032516879107,40.721374222222224,7914.353488,9.146649171037602,138,5.500000000000008E-4
8,test_20231101_140440,11382381.png,312486,327,312159,0.9989535531191798,1,4,46745,44,46701,0.9990587228580596,23.441726222222222,2963.055792,13.413405318888326,138,5.500000000000008E-4
9,test_20231101_140440,11079715.png,443815,87157,356658,0.8036186248774827,4,4,124136,12301,111835,0.9009070696655281,19.579482666666667,2830.1671626666666,13.612682731599836,138,5.500000000000008E-4
10,test_20231101_140440,11551286.png,271883,24,271859,0.9999117267353972,1,4,40092,1,40091,0.9999750573680535,24.866876444444443,3470.407338666667,12.72699907819776,138,5.500000000000008E-4
1,test_20231101_140441,10404007.png,502730,9489,493241,0.9811250571877549,1,4,61265,1391,59874,0.9772953562392883,27.381216,3876.645088,12.246243182766502,138,5.600000000000008E-4
2,test_20231101_140441,1254659.png,342646,49322,293324,0.8560555208582619,2,4,80080,6976,73104,0.9128871128871129,24.514750222222222,4371.7237706666665,11.724276478155753,138,5.600000000000008E-4
3,test_20231101_140441,10188041.png,221231,6497,214734,0.9706325062943258,2,3,41731,918,40813,0.9780019649660924,12.782318222222223,1597.6760213333334,16.095916437197868,138,5.600000000000008E-4
4,test_20231101_140441,10287332.png,216980,7592,209388,0.9650106000553046,1,3,22337,1042,21295,0.9533509423825939,11.946716444444444,1605.0623253333333,16.075884599383468,138,5.600000000000008E-4
5,test_20231101_140441,11610969.png,368720,9862,358858,0.9732534172271643,2,4,84111,1461,82650,0.9826300959446446,37.92520711111111,6884.959098666666,9.751789962715012,138,5.600000000000008E-4
6,test_20231101_140441,10350842.png,212614,2407,210207,0.9886790145521932,1,4,42529,353,42176,0.9916997813256837,25.652378666666667,3921.7766666666666,12.195975025906971,138,5.600000000000008E-4
7,test_20231101_140441,10863862.png,317432,4767,312665,0.984982610448852,1,4,66058,700,65358,0.9894032516879107,40.721374222222224,7914.353488,9.146649171037602,138,5.600000000000008E-4
8,test_20231101_140441,11382381.png,312486,327,312159,0.9989535531191798,1,4,46745,44,46701,0.9990587228580596,23.441726222222222,2963.055792,13.413405318888326,138,5.600000000000008E-4
9,test_20231101_140441,11079715.png,443815,87157,356658,0.8036186248774827,4,4,124136,12301,111835,0.9009070696655281,19.579482666666667,2830.1671626666666,13.612682731599836,138,5.600000000000008E-4
10,test_20231101_140441,11551286.png,271883,24,271859,0.9999117267353972,0,3,40092,1,40091,0.9999750573680535,24.866876444444443,3470.407338666667,12.72699907819776,138,5.600000000000008E-4
1,test_20231101_140441,10404007.png,502730,9489,493241,0.9811250571877549,1,3,61265,1391,59874,0.9772953562392883,27.381216,3876.645088,12.246243182766502,138,5.700000000000008E-4
2,test_20231101_140441,1254659.png,342646,49322,293324,0.8560555208582619,3,4,80080,6976,73104,0.9128871128871129,24.514750222222222,4371.7237706666665,11.724276478155753,138,5.700000000000008E-4
3,test_20231101_140441,10188041.png,221231,6497,214734,0.9706325062943258,2,4,41731,918,40813,0.9780019649660924,12.782318222222223,1597.6760213333334,16.095916437197868,138,5.700000000000008E-4
4,test_20231101_140441,10287332.png,216980,7592,209388,0.9650106000553046,2,4,22337,1042,21295,0.9533509423825939,11.946716444444444,1605.0623253333333,16.075884599383468,138,5.700000000000008E-4
5,test_20231101_140441,11610969.png,368720,9862,358858,0.9732534172271643,2,3,84111,1461,82650,0.9826300959446446,37.92520711111111,6884.959098666666,9.751789962715012,138,5.700000000000008E-4
6,test_20231101_140441,10350842.png,212614,2407,210207,0.9886790145521932,1,4,42529,353,42176,0.9916997813256837,25.652378666666667,3921.7766666666666,12.195975025906971,138,5.700000000000008E-4
7,test_20231101_140441,10863862.png,317432,4767,312665,0.984982610448852,1,4,66058,700,65358,0.9894032516879107,40.721374222222224,7914.353488,9.146649171037602,138,5.700000000000008E-4
8,test_20231101_140441,11382381.png,312486,327,312159,0.9989535531191798,1,4,46745,44,46701,0.9990587228580596,23.441726222222222,2963.055792,13.413405318888326,138,5.700000000000008E-4
9,test_20231101_140441,11079715.png,443815,87157,356658,0.8036186248774827,3,4,124136,12301,111835,0.9009070696655281,19.579482666666667,2830.1671626666666,13.612682731599836,138,5.700000000000008E-4
10,test_20231101_140441,11551286.png,271883,24,271859,0.9999117267353972,0,3,40092,1,40091,0.9999750573680535,24.866876444444443,3470.407338666667,12.72699907819776,138,5.700000000000008E-4
1,test_20231101_140442,10404007.png,502730,9489,493241,0.9811250571877549,2,14,61265,1391,59874,0.9772953562392883,27.381216,3876.645088,12.246243182766502,138,5.800000000000009E-4
2,test_20231101_140442,1254659.png,342646,49322,293324,0.8560555208582619,3,4,80080,6976,73104,0.9128871128871129,24.514750222222222,4371.7237706666665,11.724276478155753,138,5.800000000000009E-4
3,test_20231101_140442,10188041.png,221231,6414,214817,0.9710076797555496,2,4,41731,908,40823,0.978241594977355,12.821219555555556,1601.7605226666667,16.084827751239075,138,5.800000000000009E-4
4,test_20231101_140442,10287332.png,216980,7592,209388,0.9650106000553046,3,4,22337,1042,21295,0.9533509423825939,11.946716444444444,1605.0623253333333,16.075884599383468,138,5.800000000000009E-4
5,test_20231101_140442,11610969.png,368720,9862,358858,0.9732534172271643,1,3,84111,1461,82650,0.9826300959446446,37.92520711111111,6884.959098666666,9.751789962715012,138,5.800000000000009E-4
6,test_20231101_140442,10350842.png,212614,2084,210530,0.9901981995541216,1,3,42529,305,42224,0.9928284229584519,26.52365511111111,4134.892224,11.96616166721082,138,5.800000000000009E-4
7,test_20231101_140442,10863862.png,317432,4767,312665,0.984982610448852,1,4,66058,700,65358,0.9894032516879107,40.721374222222224,7914.353488,9.146649171037602,138,5.800000000000009E-4
8,test_20231101_140442,11382381.png,312486,327,312159,0.9989535531191798,1,4,46745,44,46701,0.9990587228580596,23.441726222222222,2963.055792,13.413405318888326,138,5.800000000000009E-4
9,test_20231101_140442,11079715.png,443815,87157,356658,0.8036186248774827,3,4,124136,12301,111835,0.9009070696655281,19.579482666666667,2830.1671626666666,13.612682731599836,138,5.800000000000009E-4
10,test_20231101_140442,11551286.png,271883,24,271859,0.9999117267353972,1,3,40092,1,40091,0.9999750573680535,24.866876444444443,3470.407338666667,12.72699907819776,138,5.800000000000009E-4
1,test_20231101_140443,10404007.png,502730,9489,493241,0.9811250571877549,2,3,61265,1391,59874,0.9772953562392883,27.381216,3876.645088,12.246243182766502,138,5.900000000000009E-4
2,test_20231101_140443,1254659.png,342646,49322,293324,0.8560555208582619,2,3,80080,6976,73104,0.9128871128871129,24.514750222222222,4371.7237706666665,11.724276478155753,138,5.900000000000009E-4
3,test_20231101_140443,10188041.png,221231,6414,214817,0.9710076797555496,2,3,41731,908,40823,0.978241594977355,12.821219555555556,1601.7605226666667,16.084827751239075,138,5.900000000000009E-4
4,test_20231101_140443,10287332.png,216980,7592,209388,0.9650106000553046,2,4,22337,1042,21295,0.9533509423825939,11.946716444444444,1605.0623253333333,16.075884599383468,138,5.900000000000009E-4
5,test_20231101_140443,11610969.png,368720,9862,358858,0.9732534172271643,1,3,84111,1461,82650,0.9826300959446446,37.92520711111111,6884.959098666666,9.751789962715012,138,5.900000000000009E-4
6,test_20231101_140443,10350842.png,212614,2084,210530,0.9901981995541216,1,4,42529,305,42224,0.9928284229584519,26.52365511111111,4134.892224,11.96616166721082,138,5.900000000000009E-4
7,test_20231101_140443,10863862.png,317432,4767,312665,0.984982610448852,2,4,66058,700,65358,0.9894032516879107,40.721374222222224,7914.353488,9.146649171037602,138,5.900000000000009E-4
8,test_20231101_140443,11382381.png,312486,327,312159,0.9989535531191798,1,3,46745,44,46701,0.9990587228580596,23.441726222222222,2963.055792,13.413405318888326,138,5.900000000000009E-4
9,test_20231101_140443,11079715.png,443815,87157,356658,0.8036186248774827,3,4,124136,12301,111835,0.9009070696655281,19.579482666666667,2830.1671626666666,13.612682731599836,138,5.900000000000009E-4
10,test_20231101_140443,11551286.png,271883,24,271859,0.9999117267353972,0,3,40092,1,40091,0.9999750573680535,24.866876444444443,3470.407338666667,12.72699907819776,138,5.900000000000009E-4
1,test_20231101_140443,10404007.png,502730,9489,493241,0.9811250571877549,2,4,61265,1391,59874,0.9772953562392883,27.381216,3876.645088,12.246243182766502,138,6.000000000000009E-4
2,test_20231101_140443,1254659.png,342646,49322,293324,0.8560555208582619,3,4,80080,6976,73104,0.9128871128871129,24.514750222222222,4371.7237706666665,11.724276478155753,138,6.000000000000009E-4
3,test_20231101_140443,10188041.png,221231,6414,214817,0.9710076797555496,2,4,41731,908,40823,0.978241594977355,12.821219555555556,1601.7605226666667,16.084827751239075,138,6.000000000000009E-4
4,test_20231101_140443,10287332.png,216980,7592,209388,0.9650106000553046,1,4,22337,1042,21295,0.9533509423825939,11.946716444444444,1605.0623253333333,16.075884599383468,138,6.000000000000009E-4
5,test_20231101_140443,11610969.png,368720,9862,358858,0.9732534172271643,2,4,84111,1461,82650,0.9826300959446446,37.92520711111111,6884.959098666666,9.751789962715012,138,6.000000000000009E-4
6,test_20231101_140443,10350842.png,212614,2084,210530,0.9901981995541216,1,4,42529,305,42224,0.9928284229584519,26.52365511111111,4134.892224,11.96616166721082,138,6.000000000000009E-4
7,test_20231101_140443,10863862.png,317432,4767,312665,0.984982610448852,2,3,66058,700,65358,0.9894032516879107,40.721374222222224,7914.353488,9.146649171037602,138,6.000000000000009E-4
8,test_20231101_140443,11382381.png,312486,327,312159,0.9989535531191798,2,3,46745,44,46701,0.9990587228580596,23.441726222222222,2963.055792,13.413405318888326,138,6.000000000000009E-4
9,test_20231101_140443,11079715.png,443815,87157,356658,0.8036186248774827,3,4,124136,12301,111835,0.9009070696655281,19.579482666666667,2830.1671626666666,13.612682731599836,138,6.000000000000009E-4
10,test_20231101_140443,11551286.png,271883,24,271859,0.9999117267353972,0,3,40092,1,40091,0.9999750573680535,24.866876444444443,3470.407338666667,12.72699907819776,138,6.000000000000009E-4
1,test_20231101_140444,10404007.png,502730,9489,493241,0.9811250571877549,2,13,61265,1391,59874,0.9772953562392883,27.381216,3876.645088,12.246243182766502,138,6.10000000000001E-4
2,test_20231101_140444,1254659.png,342646,49322,293324,0.8560555208582619,3,3,80080,6976,73104,0.9128871128871129,24.514750222222222,4371.7237706666665,11.724276478155753,138,6.10000000000001E-4
3,test_20231101_140444,10188041.png,221231,6414,214817,0.9710076797555496,2,4,41731,908,40823,0.978241594977355,12.821219555555556,1601.7605226666667,16.084827751239075,138,6.10000000000001E-4
4,test_20231101_140444,10287332.png,216980,7592,209388,0.9650106000553046,2,4,22337,1042,21295,0.9533509423825939,11.946716444444444,1605.0623253333333,16.075884599383468,138,6.10000000000001E-4
5,test_20231101_140444,11610969.png,368720,9862,358858,0.9732534172271643,1,4,84111,1461,82650,0.9826300959446446,37.92520711111111,6884.959098666666,9.751789962715012,138,6.10000000000001E-4
6,test_20231101_140444,10350842.png,212614,2084,210530,0.9901981995541216,1,13,42529,305,42224,0.9928284229584519,26.52365511111111,4134.892224,11.96616166721082,138,6.10000000000001E-4
7,test_20231101_140444,10863862.png,317432,4767,312665,0.984982610448852,1,4,66058,700,65358,0.9894032516879107,40.721374222222224,7914.353488,9.146649171037602,138,6.10000000000001E-4
8,test_20231101_140444,11382381.png,312486,327,312159,0.9989535531191798,1,3,46745,44,46701,0.9990587228580596,23.441726222222222,2963.055792,13.413405318888326,138,6.10000000000001E-4
9,test_20231101_140444,11079715.png,443815,87157,356658,0.8036186248774827,4,5,124136,12301,111835,0.9009070696655281,19.579482666666667,2830.1671626666666,13.612682731599836,138,6.10000000000001E-4
10,test_20231101_140444,11551286.png,271883,24,271859,0.9999117267353972,1,4,40092,1,40091,0.9999750573680535,24.866876444444443,3470.407338666667,12.72699907819776,138,6.10000000000001E-4
1,test_20231101_140445,10404007.png,502730,9489,493241,0.9811250571877549,1,3,61265,1391,59874,0.9772953562392883,27.381216,3876.645088,12.246243182766502,138,6.20000000000001E-4
2,test_20231101_140445,1254659.png,342646,49322,293324,0.8560555208582619,2,3,80080,6976,73104,0.9128871128871129,24.514750222222222,4371.7237706666665,11.724276478155753,138,6.20000000000001E-4
3,test_20231101_140445,10188041.png,221231,6414,214817,0.9710076797555496,2,3,41731,908,40823,0.978241594977355,12.821219555555556,1601.7605226666667,16.084827751239075,138,6.20000000000001E-4
4,test_20231101_140445,10287332.png,216980,7592,209388,0.9650106000553046,2,3,22337,1042,21295,0.9533509423825939,11.946716444444444,1605.0623253333333,16.075884599383468,138,6.20000000000001E-4
5,test_20231101_140445,11610969.png,368720,9862,358858,0.9732534172271643,1,3,84111,1461,82650,0.9826300959446446,37.92520711111111,6884.959098666666,9.751789962715012,138,6.20000000000001E-4
6,test_20231101_140445,10350842.png,212614,2084,210530,0.9901981995541216,1,3,42529,305,42224,0.9928284229584519,26.52365511111111,4134.892224,11.96616166721082,138,6.20000000000001E-4
7,test_20231101_140445,10863862.png,317432,4767,312665,0.984982610448852,2,4,66058,700,65358,0.9894032516879107,40.721374222222224,7914.353488,9.146649171037602,138,6.20000000000001E-4
8,test_20231101_140445,11382381.png,312486,327,312159,0.9989535531191798,1,4,46745,44,46701,0.9990587228580596,23.441726222222222,2963.055792,13.413405318888326,138,6.20000000000001E-4
9,test_20231101_140445,11079715.png,443815,87157,356658,0.8036186248774827,3,4,124136,12301,111835,0.9009070696655281,19.579482666666667,2830.1671626666666,13.612682731599836,138,6.20000000000001E-4
10,test_20231101_140445,11551286.png,271883,24,271859,0.9999117267353972,0,4,40092,1,40091,0.9999750573680535,24.866876444444443,3470.407338666667,12.72699907819776,138,6.20000000000001E-4
1,test_20231101_140445,10404007.png,502730,9489,493241,0.9811250571877549,2,4,61265,1391,59874,0.9772953562392883,27.381216,3876.645088,12.246243182766502,138,6.30000000000001E-4
2,test_20231101_140445,1254659.png,342646,49322,293324,0.8560555208582619,3,4,80080,6976,73104,0.9128871128871129,24.514750222222222,4371.7237706666665,11.724276478155753,138,6.30000000000001E-4
3,test_20231101_140445,10188041.png,221231,6414,214817,0.9710076797555496,2,4,41731,908,40823,0.978241594977355,12.821219555555556,1601.7605226666667,16.084827751239075,138,6.30000000000001E-4
4,test_20231101_140445,10287332.png,216980,7592,209388,0.9650106000553046,2,4,22337,1042,21295,0.9533509423825939,11.946716444444444,1605.0623253333333,16.075884599383468,138,6.30000000000001E-4
5,test_20231101_140445,11610969.png,368720,9862,358858,0.9732534172271643,1,4,84111,1461,82650,0.9826300959446446,37.92520711111111,6884.959098666666,9.751789962715012,138,6.30000000000001E-4
6,test_20231101_140445,10350842.png,212614,2084,210530,0.9901981995541216,1,3,42529,305,42224,0.9928284229584519,26.52365511111111,4134.892224,11.96616166721082,138,6.30000000000001E-4
7,test_20231101_140445,10863862.png,317432,4767,312665,0.984982610448852,2,4,66058,700,65358,0.9894032516879107,40.721374222222224,7914.353488,9.146649171037602,138,6.30000000000001E-4
8,test_20231101_140445,11382381.png,312486,327,312159,0.9989535531191798,2,3,46745,44,46701,0.9990587228580596,23.441726222222222,2963.055792,13.413405318888326,138,6.30000000000001E-4
9,test_20231101_140445,11079715.png,443815,87157,356658,0.8036186248774827,4,4,124136,12301,111835,0.9009070696655281,19.579482666666667,2830.1671626666666,13.612682731599836,138,6.30000000000001E-4
10,test_20231101_140445,11551286.png,271883,24,271859,0.9999117267353972,0,3,40092,1,40091,0.9999750573680535,24.866876444444443,3470.407338666667,12.72699907819776,138,6.30000000000001E-4
1,test_20231101_140446,10404007.png,502730,9489,493241,0.9811250571877549,2,3,61265,1391,59874,0.9772953562392883,27.381216,3876.645088,12.246243182766502,138,6.40000000000001E-4
2,test_20231101_140446,1254659.png,342646,49322,293324,0.8560555208582619,3,14,80080,6976,73104,0.9128871128871129,24.514750222222222,4371.7237706666665,11.724276478155753,138,6.40000000000001E-4
3,test_20231101_140446,10188041.png,221231,6414,214817,0.9710076797555496,2,4,41731,908,40823,0.978241594977355,12.821219555555556,1601.7605226666667,16.084827751239075,138,6.40000000000001E-4
4,test_20231101_140446,10287332.png,216980,7592,209388,0.9650106000553046,2,4,22337,1042,21295,0.9533509423825939,11.946716444444444,1605.0623253333333,16.075884599383468,138,6.40000000000001E-4
5,test_20231101_140446,11610969.png,368720,9862,358858,0.9732534172271643,2,4,84111,1461,82650,0.9826300959446446,37.92520711111111,6884.959098666666,9.751789962715012,138,6.40000000000001E-4
6,test_20231101_140446,10350842.png,212614,2084,210530,0.9901981995541216,1,4,42529,305,42224,0.9928284229584519,26.52365511111111,4134.892224,11.96616166721082,138,6.40000000000001E-4
7,test_20231101_140446,10863862.png,317432,4767,312665,0.984982610448852,2,12,66058,700,65358,0.9894032516879107,40.721374222222224,7914.353488,9.146649171037602,138,6.40000000000001E-4
8,test_20231101_140446,11382381.png,312486,327,312159,0.9989535531191798,2,4,46745,44,46701,0.9990587228580596,23.441726222222222,2963.055792,13.413405318888326,138,6.40000000000001E-4
9,test_20231101_140446,11079715.png,443815,87157,356658,0.8036186248774827,4,4,124136,12301,111835,0.9009070696655281,19.579482666666667,2830.1671626666666,13.612682731599836,138,6.40000000000001E-4
10,test_20231101_140446,11551286.png,271883,24,271859,0.9999117267353972,0,3,40092,1,40091,0.9999750573680535,24.866876444444443,3470.407338666667,12.72699907819776,138,6.40000000000001E-4
1,test_20231101_140447,10404007.png,502730,9489,493241,0.9811250571877549,2,4,61265,1391,59874,0.9772953562392883,27.381216,3876.645088,12.246243182766502,138,6.500000000000011E-4
2,test_20231101_140447,1254659.png,342646,49322,293324,0.8560555208582619,3,4,80080,6976,73104,0.9128871128871129,24.514750222222222,4371.7237706666665,11.724276478155753,138,6.500000000000011E-4
3,test_20231101_140447,10188041.png,221231,6414,214817,0.9710076797555496,2,4,41731,908,40823,0.978241594977355,12.821219555555556,1601.7605226666667,16.084827751239075,138,6.500000000000011E-4
4,test_20231101_140447,10287332.png,216980,7592,209388,0.9650106000553046,2,4,22337,1042,21295,0.9533509423825939,11.946716444444444,1605.0623253333333,16.075884599383468,138,6.500000000000011E-4
5,test_20231101_140447,11610969.png,368720,9862,358858,0.9732534172271643,2,4,84111,1461,82650,0.9826300959446446,37.92520711111111,6884.959098666666,9.751789962715012,138,6.500000000000011E-4
6,test_20231101_140447,10350842.png,212614,2084,210530,0.9901981995541216,1,4,42529,305,42224,0.9928284229584519,26.52365511111111,4134.892224,11.96616166721082,138,6.500000000000011E-4
7,test_20231101_140447,10863862.png,317432,4767,312665,0.984982610448852,1,3,66058,700,65358,0.9894032516879107,40.721374222222224,7914.353488,9.146649171037602,138,6.500000000000011E-4
8,test_20231101_140447,11382381.png,312486,327,312159,0.9989535531191798,1,3,46745,44,46701,0.9990587228580596,23.441726222222222,2963.055792,13.413405318888326,138,6.500000000000011E-4
9,test_20231101_140447,11079715.png,443815,87157,356658,0.8036186248774827,3,4,124136,12301,111835,0.9009070696655281,19.579482666666667,2830.1671626666666,13.612682731599836,138,6.500000000000011E-4
10,test_20231101_140447,11551286.png,271883,24,271859,0.9999117267353972,0,3,40092,1,40091,0.9999750573680535,24.866876444444443,3470.407338666667,12.72699907819776,138,6.500000000000011E-4
1,test_20231101_140448,10404007.png,502730,9489,493241,0.9811250571877549,2,3,61265,1391,59874,0.9772953562392883,27.381216,3876.645088,12.246243182766502,138,6.600000000000011E-4
2,test_20231101_140448,1254659.png,342646,49322,293324,0.8560555208582619,3,4,80080,6976,73104,0.9128871128871129,24.514750222222222,4371.7237706666665,11.724276478155753,138,6.600000000000011E-4
3,test_20231101_140448,10188041.png,221231,6414,214817,0.9710076797555496,2,3,41731,908,40823,0.978241594977355,12.821219555555556,1601.7605226666667,16.084827751239075,138,6.600000000000011E-4
4,test_20231101_140448,10287332.png,216980,7592,209388,0.9650106000553046,1,3,22337,1042,21295,0.9533509423825939,11.946716444444444,1605.0623253333333,16.075884599383468,138,6.600000000000011E-4
5,test_20231101_140448,11610969.png,368720,9862,358858,0.9732534172271643,1,3,84111,1461,82650,0.9826300959446446,37.92520711111111,6884.959098666666,9.751789962715012,138,6.600000000000011E-4
6,test_20231101_140448,10350842.png,212614,2084,210530,0.9901981995541216,1,4,42529,305,42224,0.9928284229584519,26.52365511111111,4134.892224,11.96616166721082,138,6.600000000000011E-4
7,test_20231101_140448,10863862.png,317432,4767,312665,0.984982610448852,1,3,66058,700,65358,0.9894032516879107,40.721374222222224,7914.353488,9.146649171037602,138,6.600000000000011E-4
8,test_20231101_140448,11382381.png,312486,327,312159,0.9989535531191798,1,4,46745,44,46701,0.9990587228580596,23.441726222222222,2963.055792,13.413405318888326,138,6.600000000000011E-4
9,test_20231101_140448,11079715.png,443815,87157,356658,0.8036186248774827,3,4,124136,12301,111835,0.9009070696655281,19.579482666666667,2830.1671626666666,13.612682731599836,138,6.600000000000011E-4
10,test_20231101_140448,11551286.png,271883,24,271859,0.9999117267353972,1,4,40092,1,40091,0.9999750573680535,24.866876444444443,3470.407338666667,12.72699907819776,138,6.600000000000011E-4
1,test_20231101_140448,10404007.png,502730,9489,493241,0.9811250571877549,2,3,61265,1391,59874,0.9772953562392883,27.381216,3876.645088,12.246243182766502,138,6.700000000000011E-4
2,test_20231101_140448,1254659.png,342646,49322,293324,0.8560555208582619,2,4,80080,6976,73104,0.9128871128871129,24.514750222222222,4371.7237706666665,11.724276478155753,138,6.700000000000011E-4
3,test_20231101_140448,10188041.png,221231,6414,214817,0.9710076797555496,3,3,41731,908,40823,0.978241594977355,12.821219555555556,1601.7605226666667,16.084827751239075,138,6.700000000000011E-4
4,test_20231101_140448,10287332.png,216980,7592,209388,0.9650106000553046,1,3,22337,1042,21295,0.9533509423825939,11.946716444444444,1605.0623253333333,16.075884599383468,138,6.700000000000011E-4
5,test_20231101_140448,11610969.png,368720,9862,358858,0.9732534172271643,1,3,84111,1461,82650,0.9826300959446446,37.92520711111111,6884.959098666666,9.751789962715012,138,6.700000000000011E-4
6,test_20231101_140448,10350842.png,212614,2084,210530,0.9901981995541216,2,3,42529,305,42224,0.9928284229584519,26.52365511111111,4134.892224,11.96616166721082,138,6.700000000000011E-4
7,test_20231101_140448,10863862.png,317432,4767,312665,0.984982610448852,1,4,66058,700,65358,0.9894032516879107,40.721374222222224,7914.353488,9.146649171037602,138,6.700000000000011E-4
8,test_20231101_140448,11382381.png,312486,327,312159,0.9989535531191798,1,3,46745,44,46701,0.9990587228580596,23.441726222222222,2963.055792,13.413405318888326,138,6.700000000000011E-4
9,test_20231101_140448,11079715.png,443815,87157,356658,0.8036186248774827,3,4,124136,12301,111835,0.9009070696655281,19.579482666666667,2830.1671626666666,13.612682731599836,138,6.700000000000011E-4
10,test_20231101_140448,11551286.png,271883,24,271859,0.9999117267353972,1,4,40092,1,40091,0.9999750573680535,24.866876444444443,3470.407338666667,12.72699907819776,138,6.700000000000011E-4
1,test_20231101_140449,10404007.png,502730,9489,493241,0.9811250571877549,1,3,61265,1391,59874,0.9772953562392883,27.381216,3876.645088,12.246243182766502,138,6.800000000000011E-4
2,test_20231101_140449,1254659.png,342646,49322,293324,0.8560555208582619,3,4,80080,6976,73104,0.9128871128871129,24.514750222222222,4371.7237706666665,11.724276478155753,138,6.800000000000011E-4
3,test_20231101_140449,10188041.png,221231,6414,214817,0.9710076797555496,2,3,41731,908,40823,0.978241594977355,12.821219555555556,1601.7605226666667,16.084827751239075,138,6.800000000000011E-4
4,test_20231101_140449,10287332.png,216980,7592,209388,0.9650106000553046,1,5,22337,1042,21295,0.9533509423825939,11.946716444444444,1605.0623253333333,16.075884599383468,138,6.800000000000011E-4
5,test_20231101_140449,11610969.png,368720,9862,358858,0.9732534172271643,1,7,84111,1461,82650,0.9826300959446446,37.92520711111111,6884.959098666666,9.751789962715012,138,6.800000000000011E-4
6,test_20231101_140449,10350842.png,212614,2084,210530,0.9901981995541216,2,3,42529,305,42224,0.9928284229584519,26.52365511111111,4134.892224,11.96616166721082,138,6.800000000000011E-4
7,test_20231101_140449,10863862.png,317432,4767,312665,0.984982610448852,2,3,66058,700,65358,0.9894032516879107,40.721374222222224,7914.353488,9.146649171037602,138,6.800000000000011E-4
8,test_20231101_140449,11382381.png,312486,327,312159,0.9989535531191798,1,6,46745,44,46701,0.9990587228580596,23.441726222222222,2963.055792,13.413405318888326,138,6.800000000000011E-4
9,test_20231101_140449,11079715.png,443815,87157,356658,0.8036186248774827,3,4,124136,12301,111835,0.9009070696655281,19.579482666666667,2830.1671626666666,13.612682731599836,138,6.800000000000011E-4
10,test_20231101_140449,11551286.png,271883,24,271859,0.9999117267353972,0,4,40092,1,40091,0.9999750573680535,24.866876444444443,3470.407338666667,12.72699907819776,138,6.800000000000011E-4
1,test_20231101_140450,10404007.png,502730,9489,493241,0.9811250571877549,2,4,61265,1391,59874,0.9772953562392883,27.381216,3876.645088,12.246243182766502,138,6.900000000000012E-4
2,test_20231101_140450,1254659.png,342646,49322,293324,0.8560555208582619,3,4,80080,6976,73104,0.9128871128871129,24.514750222222222,4371.7237706666665,11.724276478155753,138,6.900000000000012E-4
3,test_20231101_140450,10188041.png,221231,6414,214817,0.9710076797555496,2,4,41731,908,40823,0.978241594977355,12.821219555555556,1601.7605226666667,16.084827751239075,138,6.900000000000012E-4
4,test_20231101_140450,10287332.png,216980,7592,209388,0.9650106000553046,2,4,22337,1042,21295,0.9533509423825939,11.946716444444444,1605.0623253333333,16.075884599383468,138,6.900000000000012E-4
5,test_20231101_140450,11610969.png,368720,9862,358858,0.9732534172271643,2,4,84111,1461,82650,0.9826300959446446,37.92520711111111,6884.959098666666,9.751789962715012,138,6.900000000000012E-4
6,test_20231101_140450,10350842.png,212614,2084,210530,0.9901981995541216,1,4,42529,305,42224,0.9928284229584519,26.52365511111111,4134.892224,11.96616166721082,138,6.900000000000012E-4
7,test_20231101_140450,10863862.png,317432,4767,312665,0.984982610448852,1,4,66058,700,65358,0.9894032516879107,40.721374222222224,7914.353488,9.146649171037602,138,6.900000000000012E-4
8,test_20231101_140450,11382381.png,312486,327,312159,0.9989535531191798,1,4,46745,44,46701,0.9990587228580596,23.441726222222222,2963.055792,13.413405318888326,138,6.900000000000012E-4
9,test_20231101_140450,11079715.png,443815,87157,356658,0.8036186248774827,3,4,124136,12301,111835,0.9009070696655281,19.579482666666667,2830.1671626666666,13.612682731599836,138,6.900000000000012E-4
10,test_20231101_140450,11551286.png,271883,24,271859,0.9999117267353972,1,3,40092,1,40091,0.9999750573680535,24.866876444444443,3470.407338666667,12.72699907819776,138,6.900000000000012E-4
1,test_20231101_140450,10404007.png,502730,9489,493241,0.9811250571877549,2,4,61265,1391,59874,0.9772953562392883,27.381216,3876.645088,12.246243182766502,138,7.000000000000012E-4
2,test_20231101_140450,1254659.png,342646,49322,293324,0.8560555208582619,3,4,80080,6976,73104,0.9128871128871129,24.514750222222222,4371.7237706666665,11.724276478155753,138,7.000000000000012E-4
3,test_20231101_140450,10188041.png,221231,6414,214817,0.9710076797555496,2,4,41731,908,40823,0.978241594977355,12.821219555555556,1601.7605226666667,16.084827751239075,138,7.000000000000012E-4
4,test_20231101_140450,10287332.png,216980,7592,209388,0.9650106000553046,1,3,22337,1042,21295,0.9533509423825939,11.946716444444444,1605.0623253333333,16.075884599383468,138,7.000000000000012E-4
5,test_20231101_140450,11610969.png,368720,9862,358858,0.9732534172271643,2,3,84111,1461,82650,0.9826300959446446,37.92520711111111,6884.959098666666,9.751789962715012,138,7.000000000000012E-4
6,test_20231101_140450,10350842.png,212614,2084,210530,0.9901981995541216,1,5,42529,305,42224,0.9928284229584519,26.52365511111111,4134.892224,11.96616166721082,138,7.000000000000012E-4
7,test_20231101_140450,10863862.png,317432,4767,312665,0.984982610448852,1,3,66058,700,65358,0.9894032516879107,40.721374222222224,7914.353488,9.146649171037602,138,7.000000000000012E-4
8,test_20231101_140450,11382381.png,312486,327,312159,0.9989535531191798,1,3,46745,44,46701,0.9990587228580596,23.441726222222222,2963.055792,13.413405318888326,138,7.000000000000012E-4
9,test_20231101_140450,11079715.png,443815,87157,356658,0.8036186248774827,3,4,124136,12301,111835,0.9009070696655281,19.579482666666667,2830.1671626666666,13.612682731599836,138,7.000000000000012E-4
10,test_20231101_140450,11551286.png,271883,24,271859,0.9999117267353972,1,4,40092,1,40091,0.9999750573680535,24.866876444444443,3470.407338666667,12.72699907819776,138,7.000000000000012E-4
1,test_20231101_140451,10404007.png,502730,9489,493241,0.9811250571877549,2,4,61265,1391,59874,0.9772953562392883,27.381216,3876.645088,12.246243182766502,138,7.100000000000012E-4
2,test_20231101_140451,1254659.png,342646,49322,293324,0.8560555208582619,3,4,80080,6976,73104,0.9128871128871129,24.514750222222222,4371.7237706666665,11.724276478155753,138,7.100000000000012E-4
3,test_20231101_140451,10188041.png,221231,6414,214817,0.9710076797555496,2,4,41731,908,40823,0.978241594977355,12.821219555555556,1601.7605226666667,16.084827751239075,138,7.100000000000012E-4
4,test_20231101_140451,10287332.png,216980,7592,209388,0.9650106000553046,1,3,22337,1042,21295,0.9533509423825939,11.946716444444444,1605.0623253333333,16.075884599383468,138,7.100000000000012E-4
5,test_20231101_140451,11610969.png,368720,9862,358858,0.9732534172271643,2,4,84111,1461,82650,0.9826300959446446,37.92520711111111,6884.959098666666,9.751789962715012,138,7.100000000000012E-4
6,test_20231101_140451,10350842.png,212614,2084,210530,0.9901981995541216,1,4,42529,305,42224,0.9928284229584519,26.52365511111111,4134.892224,11.96616166721082,138,7.100000000000012E-4
7,test_20231101_140451,10863862.png,317432,4767,312665,0.984982610448852,2,6,66058,700,65358,0.9894032516879107,40.721374222222224,7914.353488,9.146649171037602,138,7.100000000000012E-4
8,test_20231101_140451,11382381.png,312486,327,312159,0.9989535531191798,1,3,46745,44,46701,0.9990587228580596,23.441726222222222,2963.055792,13.413405318888326,138,7.100000000000012E-4
9,test_20231101_140451,11079715.png,443815,87157,356658,0.8036186248774827,3,4,124136,12301,111835,0.9009070696655281,19.579482666666667,2830.1671626666666,13.612682731599836,138,7.100000000000012E-4
10,test_20231101_140451,11551286.png,271883,24,271859,0.9999117267353972,1,4,40092,1,40091,0.9999750573680535,24.866876444444443,3470.407338666667,12.72699907819776,138,7.100000000000012E-4
1,test_20231101_140452,10404007.png,502730,9489,493241,0.9811250571877549,2,4,61265,1391,59874,0.9772953562392883,27.381216,3876.645088,12.246243182766502,138,7.200000000000012E-4
2,test_20231101_140452,1254659.png,342646,49322,293324,0.8560555208582619,2,4,80080,6976,73104,0.9128871128871129,24.514750222222222,4371.7237706666665,11.724276478155753,138,7.200000000000012E-4
3,test_20231101_140452,10188041.png,221231,6414,214817,0.9710076797555496,2,4,41731,908,40823,0.978241594977355,12.821219555555556,1601.7605226666667,16.084827751239075,138,7.200000000000012E-4
4,test_20231101_140452,10287332.png,216980,7592,209388,0.9650106000553046,2,3,22337,1042,21295,0.9533509423825939,11.946716444444444,1605.0623253333333,16.075884599383468,138,7.200000000000012E-4
5,test_20231101_140452,11610969.png,368720,9862,358858,0.9732534172271643,2,4,84111,1461,82650,0.9826300959446446,37.92520711111111,6884.959098666666,9.751789962715012,138,7.200000000000012E-4
6,test_20231101_140452,10350842.png,212614,2084,210530,0.9901981995541216,2,4,42529,305,42224,0.9928284229584519,26.52365511111111,4134.892224,11.96616166721082,138,7.200000000000012E-4
7,test_20231101_140452,10863862.png,317432,4767,312665,0.984982610448852,1,3,66058,700,65358,0.9894032516879107,40.721374222222224,7914.353488,9.146649171037602,138,7.200000000000012E-4
8,test_20231101_140452,11382381.png,312486,327,312159,0.9989535531191798,1,4,46745,44,46701,0.9990587228580596,23.441726222222222,2963.055792,13.413405318888326,138,7.200000000000012E-4
9,test_20231101_140452,11079715.png,443815,87157,356658,0.8036186248774827,3,4,124136,12301,111835,0.9009070696655281,19.579482666666667,2830.1671626666666,13.612682731599836,138,7.200000000000012E-4
10,test_20231101_140452,11551286.png,271883,24,271859,0.9999117267353972,1,4,40092,1,40091,0.9999750573680535,24.866876444444443,3470.407338666667,12.72699907819776,138,7.200000000000012E-4
1,test_20231101_140452,10404007.png,502730,9489,493241,0.9811250571877549,2,4,61265,1391,59874,0.9772953562392883,27.381216,3876.645088,12.246243182766502,138,7.300000000000013E-4
2,test_20231101_140452,1254659.png,342646,49322,293324,0.8560555208582619,3,4,80080,6976,73104,0.9128871128871129,24.514750222222222,4371.7237706666665,11.724276478155753,138,7.300000000000013E-4
3,test_20231101_140452,10188041.png,221231,6414,214817,0.9710076797555496,2,4,41731,908,40823,0.978241594977355,12.821219555555556,1601.7605226666667,16.084827751239075,138,7.300000000000013E-4
4,test_20231101_140452,10287332.png,216980,7592,209388,0.9650106000553046,2,3,22337,1042,21295,0.9533509423825939,11.946716444444444,1605.0623253333333,16.075884599383468,138,7.300000000000013E-4
5,test_20231101_140452,11610969.png,368720,9862,358858,0.9732534172271643,2,3,84111,1461,82650,0.9826300959446446,37.92520711111111,6884.959098666666,9.751789962715012,138,7.300000000000013E-4
6,test_20231101_140452,10350842.png,212614,2084,210530,0.9901981995541216,1,4,42529,305,42224,0.9928284229584519,26.52365511111111,4134.892224,11.96616166721082,138,7.300000000000013E-4
7,test_20231101_140452,10863862.png,317432,4767,312665,0.984982610448852,2,3,66058,700,65358,0.9894032516879107,40.721374222222224,7914.353488,9.146649171037602,138,7.300000000000013E-4
8,test_20231101_140452,11382381.png,312486,327,312159,0.9989535531191798,1,4,46745,44,46701,0.9990587228580596,23.441726222222222,2963.055792,13.413405318888326,138,7.300000000000013E-4
9,test_20231101_140452,11079715.png,443815,87157,356658,0.8036186248774827,3,4,124136,12301,111835,0.9009070696655281,19.579482666666667,2830.1671626666666,13.612682731599836,138,7.300000000000013E-4
10,test_20231101_140452,11551286.png,271883,24,271859,0.9999117267353972,0,3,40092,1,40091,0.9999750573680535,24.866876444444443,3470.407338666667,12.72699907819776,138,7.300000000000013E-4
1,test_20231101_140453,10404007.png,502730,9489,493241,0.9811250571877549,1,3,61265,1391,59874,0.9772953562392883,27.381216,3876.645088,12.246243182766502,138,7.400000000000013E-4
2,test_20231101_140453,1254659.png,342646,49322,293324,0.8560555208582619,3,4,80080,6976,73104,0.9128871128871129,24.514750222222222,4371.7237706666665,11.724276478155753,138,7.400000000000013E-4
3,test_20231101_140453,10188041.png,221231,6414,214817,0.9710076797555496,1,3,41731,908,40823,0.978241594977355,12.821219555555556,1601.7605226666667,16.084827751239075,138,7.400000000000013E-4
4,test_20231101_140453,10287332.png,216980,7592,209388,0.9650106000553046,2,4,22337,1042,21295,0.9533509423825939,11.946716444444444,1605.0623253333333,16.075884599383468,138,7.400000000000013E-4
5,test_20231101_140453,11610969.png,368720,9862,358858,0.9732534172271643,1,3,84111,1461,82650,0.9826300959446446,37.92520711111111,6884.959098666666,9.751789962715012,138,7.400000000000013E-4
6,test_20231101_140453,10350842.png,212614,2084,210530,0.9901981995541216,1,3,42529,305,42224,0.9928284229584519,26.52365511111111,4134.892224,11.96616166721082,138,7.400000000000013E-4
7,test_20231101_140453,10863862.png,317432,4767,312665,0.984982610448852,2,4,66058,700,65358,0.9894032516879107,40.721374222222224,7914.353488,9.146649171037602,138,7.400000000000013E-4
8,test_20231101_140453,11382381.png,312486,327,312159,0.9989535531191798,2,3,46745,44,46701,0.9990587228580596,23.441726222222222,2963.055792,13.413405318888326,138,7.400000000000013E-4
9,test_20231101_140453,11079715.png,443815,87157,356658,0.8036186248774827,3,4,124136,12301,111835,0.9009070696655281,19.579482666666667,2830.1671626666666,13.612682731599836,138,7.400000000000013E-4
10,test_20231101_140453,11551286.png,271883,24,271859,0.9999117267353972,0,4,40092,1,40091,0.9999750573680535,24.866876444444443,3470.407338666667,12.72699907819776,138,7.400000000000013E-4
1,test_20231101_140454,10404007.png,502730,9489,493241,0.9811250571877549,2,4,61265,1391,59874,0.9772953562392883,27.381216,3876.645088,12.246243182766502,138,7.500000000000013E-4
2,test_20231101_140454,1254659.png,342646,49322,293324,0.8560555208582619,2,3,80080,6976,73104,0.9128871128871129,24.514750222222222,4371.7237706666665,11.724276478155753,138,7.500000000000013E-4
3,test_20231101_140454,10188041.png,221231,6414,214817,0.9710076797555496,2,4,41731,908,40823,0.978241594977355,12.821219555555556,1601.7605226666667,16.084827751239075,138,7.500000000000013E-4
4,test_20231101_140454,10287332.png,216980,7592,209388,0.9650106000553046,7,4,22337,1042,21295,0.9533509423825939,11.946716444444444,1605.0623253333333,16.075884599383468,138,7.500000000000013E-4
5,test_20231101_140454,11610969.png,368720,9862,358858,0.9732534172271643,2,3,84111,1461,82650,0.9826300959446446,37.92520711111111,6884.959098666666,9.751789962715012,138,7.500000000000013E-4
6,test_20231101_140454,10350842.png,212614,2084,210530,0.9901981995541216,2,3,42529,305,42224,0.9928284229584519,26.52365511111111,4134.892224,11.96616166721082,138,7.500000000000013E-4
7,test_20231101_140454,10863862.png,317432,4767,312665,0.984982610448852,1,4,66058,700,65358,0.9894032516879107,40.721374222222224,7914.353488,9.146649171037602,138,7.500000000000013E-4
8,test_20231101_140454,11382381.png,312486,327,312159,0.9989535531191798,1,3,46745,44,46701,0.9990587228580596,23.441726222222222,2963.055792,13.413405318888326,138,7.500000000000013E-4
9,test_20231101_140454,11079715.png,443815,87157,356658,0.8036186248774827,3,4,124136,12301,111835,0.9009070696655281,19.579482666666667,2830.1671626666666,13.612682731599836,138,7.500000000000013E-4
10,test_20231101_140454,11551286.png,271883,24,271859,0.9999117267353972,0,3,40092,1,40091,0.9999750573680535,24.866876444444443,3470.407338666667,12.72699907819776,138,7.500000000000013E-4
1,test_20231101_140454,10404007.png,502730,9369,493361,0.9813637539036859,2,3,61265,1373,59892,0.9775891618379172,27.395573333333335,3880.67536,12.241730477485373,138,7.600000000000013E-4
2,test_20231101_140454,1254659.png,342646,49322,293324,0.8560555208582619,3,4,80080,6976,73104,0.9128871128871129,24.514750222222222,4371.7237706666665,11.724276478155753,138,7.600000000000013E-4
3,test_20231101_140454,10188041.png,221231,6414,214817,0.9710076797555496,1,3,41731,908,40823,0.978241594977355,12.821219555555556,1601.7605226666667,16.084827751239075,138,7.600000000000013E-4
4,test_20231101_140454,10287332.png,216980,7449,209531,0.9656696469720711,1,4,22337,1021,21316,0.9542910865380311,12.014368,1616.0612906666668,16.04622533084319,138,7.600000000000013E-4
5,test_20231101_140454,11610969.png,368720,9862,358858,0.9732534172271643,2,3,84111,1461,82650,0.9826300959446446,37.92520711111111,6884.959098666666,9.751789962715012,138,7.600000000000013E-4
6,test_20231101_140454,10350842.png,212614,2084,210530,0.9901981995541216,2,4,42529,305,42224,0.9928284229584519,26.52365511111111,4134.892224,11.96616166721082,138,7.600000000000013E-4
7,test_20231101_140454,10863862.png,317432,4747,312685,0.9850456160689534,1,3,66058,697,65361,0.9894486663235339,40.808705777777774,7942.523504,9.131218521761033,138,7.600000000000013E-4
8,test_20231101_140454,11382381.png,312486,327,312159,0.9989535531191798,1,4,46745,44,46701,0.9990587228580596,23.441726222222222,2963.055792,13.413405318888326,138,7.600000000000013E-4
9,test_20231101_140454,11079715.png,443815,87157,356658,0.8036186248774827,4,4,124136,12301,111835,0.9009070696655281,19.579482666666667,2830.1671626666666,13.612682731599836,138,7.600000000000013E-4
10,test_20231101_140454,11551286.png,271883,24,271859,0.9999117267353972,1,4,40092,1,40091,0.9999750573680535,24.866876444444443,3470.407338666667,12.72699907819776,138,7.600000000000013E-4
1,test_20231101_140455,10404007.png,502730,9369,493361,0.9813637539036859,2,4,61265,1373,59892,0.9775891618379172,27.395573333333335,3880.67536,12.241730477485373,138,7.700000000000014E-4
2,test_20231101_140455,1254659.png,342646,49322,293324,0.8560555208582619,2,3,80080,6976,73104,0.9128871128871129,24.514750222222222,4371.7237706666665,11.724276478155753,138,7.700000000000014E-4
3,test_20231101_140455,10188041.png,221231,6414,214817,0.9710076797555496,1,3,41731,908,40823,0.978241594977355,12.821219555555556,1601.7605226666667,16.084827751239075,138,7.700000000000014E-4
4,test_20231101_140455,10287332.png,216980,7449,209531,0.9656696469720711,2,4,22337,1021,21316,0.9542910865380311,12.014368,1616.0612906666668,16.04622533084319,138,7.700000000000014E-4
5,test_20231101_140455,11610969.png,368720,9862,358858,0.9732534172271643,2,3,84111,1461,82650,0.9826300959446446,37.92520711111111,6884.959098666666,9.751789962715012,138,7.700000000000014E-4
6,test_20231101_140455,10350842.png,212614,2084,210530,0.9901981995541216,1,4,42529,305,42224,0.9928284229584519,26.52365511111111,4134.892224,11.96616166721082,138,7.700000000000014E-4
7,test_20231101_140455,10863862.png,317432,4747,312685,0.9850456160689534,2,8,66058,697,65361,0.9894486663235339,40.808705777777774,7942.523504,9.131218521761033,138,7.700000000000014E-4
8,test_20231101_140455,11382381.png,312486,327,312159,0.9989535531191798,2,3,46745,44,46701,0.9990587228580596,23.441726222222222,2963.055792,13.413405318888326,138,7.700000000000014E-4
9,test_20231101_140455,11079715.png,443815,87157,356658,0.8036186248774827,3,10,124136,12301,111835,0.9009070696655281,19.579482666666667,2830.1671626666666,13.612682731599836,138,7.700000000000014E-4
10,test_20231101_140455,11551286.png,271883,24,271859,0.9999117267353972,0,3,40092,1,40091,0.9999750573680535,24.866876444444443,3470.407338666667,12.72699907819776,138,7.700000000000014E-4
1,test_20231101_140456,10404007.png,502730,9369,493361,0.9813637539036859,2,3,61265,1373,59892,0.9775891618379172,27.395573333333335,3880.67536,12.241730477485373,138,7.800000000000014E-4
2,test_20231101_140456,1254659.png,342646,49322,293324,0.8560555208582619,3,4,80080,6976,73104,0.9128871128871129,24.514750222222222,4371.7237706666665,11.724276478155753,138,7.800000000000014E-4
3,test_20231101_140456,10188041.png,221231,6414,214817,0.9710076797555496,2,4,41731,908,40823,0.978241594977355,12.821219555555556,1601.7605226666667,16.084827751239075,138,7.800000000000014E-4
4,test_20231101_140456,10287332.png,216980,7449,209531,0.9656696469720711,1,3,22337,1021,21316,0.9542910865380311,12.014368,1616.0612906666668,16.04622533084319,138,7.800000000000014E-4
5,test_20231101_140456,11610969.png,368720,9862,358858,0.9732534172271643,2,3,84111,1461,82650,0.9826300959446446,37.92520711111111,6884.959098666666,9.751789962715012,138,7.800000000000014E-4
6,test_20231101_140456,10350842.png,212614,2084,210530,0.9901981995541216,2,3,42529,305,42224,0.9928284229584519,26.52365511111111,4134.892224,11.96616166721082,138,7.800000000000014E-4
7,test_20231101_140456,10863862.png,317432,4747,312685,0.9850456160689534,2,3,66058,697,65361,0.9894486663235339,40.808705777777774,7942.523504,9.131218521761033,138,7.800000000000014E-4
8,test_20231101_140456,11382381.png,312486,327,312159,0.9989535531191798,1,3,46745,44,46701,0.9990587228580596,23.441726222222222,2963.055792,13.413405318888326,138,7.800000000000014E-4
9,test_20231101_140456,11079715.png,443815,87157,356658,0.8036186248774827,3,4,124136,12301,111835,0.9009070696655281,19.579482666666667,2830.1671626666666,13.612682731599836,138,7.800000000000014E-4
10,test_20231101_140456,11551286.png,271883,24,271859,0.9999117267353972,0,3,40092,1,40091,0.9999750573680535,24.866876444444443,3470.407338666667,12.72699907819776,138,7.800000000000014E-4
1,test_20231101_140456,10404007.png,502730,9369,493361,0.9813637539036859,2,4,61265,1373,59892,0.9775891618379172,27.395573333333335,3880.67536,12.241730477485373,138,7.900000000000014E-4
2,test_20231101_140456,1254659.png,342646,49322,293324,0.8560555208582619,3,4,80080,6976,73104,0.9128871128871129,24.514750222222222,4371.7237706666665,11.724276478155753,138,7.900000000000014E-4
3,test_20231101_140456,10188041.png,221231,6414,214817,0.9710076797555496,2,4,41731,908,40823,0.978241594977355,12.821219555555556,1601.7605226666667,16.084827751239075,138,7.900000000000014E-4
4,test_20231101_140456,10287332.png,216980,7449,209531,0.9656696469720711,2,4,22337,1021,21316,0.9542910865380311,12.014368,1616.0612906666668,16.04622533084319,138,7.900000000000014E-4
5,test_20231101_140456,11610969.png,368720,9862,358858,0.9732534172271643,2,3,84111,1461,82650,0.9826300959446446,37.92520711111111,6884.959098666666,9.751789962715012,138,7.900000000000014E-4
6,test_20231101_140456,10350842.png,212614,2084,210530,0.9901981995541216,1,4,42529,305,42224,0.9928284229584519,26.52365511111111,4134.892224,11.96616166721082,138,7.900000000000014E-4
7,test_20231101_140456,10863862.png,317432,4747,312685,0.9850456160689534,1,3,66058,697,65361,0.9894486663235339,40.808705777777774,7942.523504,9.131218521761033,138,7.900000000000014E-4
8,test_20231101_140456,11382381.png,312486,327,312159,0.9989535531191798,2,3,46745,44,46701,0.9990587228580596,23.441726222222222,2963.055792,13.413405318888326,138,7.900000000000014E-4
9,test_20231101_140456,11079715.png,443815,87157,356658,0.8036186248774827,3,4,124136,12301,111835,0.9009070696655281,19.579482666666667,2830.1671626666666,13.612682731599836,138,7.900000000000014E-4
10,test_20231101_140456,11551286.png,271883,24,271859,0.9999117267353972,1,4,40092,1,40091,0.9999750573680535,24.866876444444443,3470.407338666667,12.72699907819776,138,7.900000000000014E-4
1,test_20231101_140457,10404007.png,502730,9369,493361,0.9813637539036859,2,4,61265,1373,59892,0.9775891618379172,27.395573333333335,3880.67536,12.241730477485373,138,8.000000000000014E-4
2,test_20231101_140457,1254659.png,342646,49322,293324,0.8560555208582619,3,4,80080,6976,73104,0.9128871128871129,24.514750222222222,4371.7237706666665,11.724276478155753,138,8.000000000000014E-4
3,test_20231101_140457,10188041.png,221231,6414,214817,0.9710076797555496,2,3,41731,908,40823,0.978241594977355,12.821219555555556,1601.7605226666667,16.084827751239075,138,8.000000000000014E-4
4,test_20231101_140457,10287332.png,216980,7449,209531,0.9656696469720711,2,4,22337,1021,21316,0.9542910865380311,12.014368,1616.0612906666668,16.04622533084319,138,8.000000000000014E-4
5,test_20231101_140457,11610969.png,368720,9862,358858,0.9732534172271643,2,4,84111,1461,82650,0.9826300959446446,37.92520711111111,6884.959098666666,9.751789962715012,138,8.000000000000014E-4
6,test_20231101_140457,10350842.png,212614,2084,210530,0.9901981995541216,2,3,42529,305,42224,0.9928284229584519,26.52365511111111,4134.892224,11.96616166721082,138,8.000000000000014E-4
7,test_20231101_140457,10863862.png,317432,4747,312685,0.9850456160689534,2,4,66058,697,65361,0.9894486663235339,40.808705777777774,7942.523504,9.131218521761033,138,8.000000000000014E-4
8,test_20231101_140457,11382381.png,312486,327,312159,0.9989535531191798,1,4,46745,44,46701,0.9990587228580596,23.441726222222222,2963.055792,13.413405318888326,138,8.000000000000014E-4
9,test_20231101_140457,11079715.png,443815,87157,356658,0.8036186248774827,4,4,124136,12301,111835,0.9009070696655281,19.579482666666667,2830.1671626666666,13.612682731599836,138,8.000000000000014E-4
10,test_20231101_140457,11551286.png,271883,24,271859,0.9999117267353972,0,3,40092,1,40091,0.9999750573680535,24.866876444444443,3470.407338666667,12.72699907819776,138,8.000000000000014E-4
1,test_20231101_140458,10404007.png,502730,9369,493361,0.9813637539036859,1,3,61265,1373,59892,0.9775891618379172,27.395573333333335,3880.67536,12.241730477485373,138,8.100000000000015E-4
2,test_20231101_140458,1254659.png,342646,49322,293324,0.8560555208582619,3,4,80080,6976,73104,0.9128871128871129,24.514750222222222,4371.7237706666665,11.724276478155753,138,8.100000000000015E-4
3,test_20231101_140458,10188041.png,221231,6414,214817,0.9710076797555496,2,4,41731,908,40823,0.978241594977355,12.821219555555556,1601.7605226666667,16.084827751239075,138,8.100000000000015E-4
4,test_20231101_140458,10287332.png,216980,7449,209531,0.9656696469720711,2,3,22337,1021,21316,0.9542910865380311,12.014368,1616.0612906666668,16.04622533084319,138,8.100000000000015E-4
5,test_20231101_140458,11610969.png,368720,9862,358858,0.9732534172271643,2,4,84111,1461,82650,0.9826300959446446,37.92520711111111,6884.959098666666,9.751789962715012,138,8.100000000000015E-4
6,test_20231101_140458,10350842.png,212614,2084,210530,0.9901981995541216,1,4,42529,305,42224,0.9928284229584519,26.52365511111111,4134.892224,11.96616166721082,138,8.100000000000015E-4
7,test_20231101_140458,10863862.png,317432,4747,312685,0.9850456160689534,1,3,66058,697,65361,0.9894486663235339,40.808705777777774,7942.523504,9.131218521761033,138,8.100000000000015E-4
8,test_20231101_140458,11382381.png,312486,327,312159,0.9989535531191798,1,3,46745,44,46701,0.9990587228580596,23.441726222222222,2963.055792,13.413405318888326,138,8.100000000000015E-4
9,test_20231101_140458,11079715.png,443815,87157,356658,0.8036186248774827,3,4,124136,12301,111835,0.9009070696655281,19.579482666666667,2830.1671626666666,13.612682731599836,138,8.100000000000015E-4
10,test_20231101_140458,11551286.png,271883,24,271859,0.9999117267353972,0,4,40092,1,40091,0.9999750573680535,24.866876444444443,3470.407338666667,12.72699907819776,138,8.100000000000015E-4
1,test_20231101_140458,10404007.png,502730,9369,493361,0.9813637539036859,1,16,61265,1373,59892,0.9775891618379172,27.395573333333335,3880.67536,12.241730477485373,138,8.200000000000015E-4
2,test_20231101_140458,1254659.png,342646,49322,293324,0.8560555208582619,3,4,80080,6976,73104,0.9128871128871129,24.514750222222222,4371.7237706666665,11.724276478155753,138,8.200000000000015E-4
3,test_20231101_140458,10188041.png,221231,6414,214817,0.9710076797555496,2,4,41731,908,40823,0.978241594977355,12.821219555555556,1601.7605226666667,16.084827751239075,138,8.200000000000015E-4
4,test_20231101_140458,10287332.png,216980,7449,209531,0.9656696469720711,1,3,22337,1021,21316,0.9542910865380311,12.014368,1616.0612906666668,16.04622533084319,138,8.200000000000015E-4
5,test_20231101_140458,11610969.png,368720,9862,358858,0.9732534172271643,2,3,84111,1461,82650,0.9826300959446446,37.92520711111111,6884.959098666666,9.751789962715012,138,8.200000000000015E-4
6,test_20231101_140458,10350842.png,212614,24,212590,0.9998871193806617,1,12,42529,1,42528,0.9999764866326507,55.22670577777778,11938.01408,7.361482740939017,138,8.200000000000015E-4
7,test_20231101_140458,10863862.png,317432,4747,312685,0.9850456160689534,1,4,66058,697,65361,0.9894486663235339,40.808705777777774,7942.523504,9.131218521761033,138,8.200000000000015E-4
8,test_20231101_140458,11382381.png,312486,327,312159,0.9989535531191798,1,3,46745,44,46701,0.9990587228580596,23.441726222222222,2963.055792,13.413405318888326,138,8.200000000000015E-4
9,test_20231101_140458,11079715.png,443815,87157,356658,0.8036186248774827,3,4,124136,12301,111835,0.9009070696655281,19.579482666666667,2830.1671626666666,13.612682731599836,138,8.200000000000015E-4
10,test_20231101_140458,11551286.png,271883,24,271859,0.9999117267353972,1,3,40092,1,40091,0.9999750573680535,24.866876444444443,3470.407338666667,12.72699907819776,138,8.200000000000015E-4
1,test_20231101_140459,10404007.png,502730,9369,493361,0.9813637539036859,2,3,61265,1373,59892,0.9775891618379172,27.395573333333335,3880.67536,12.241730477485373,138,8.300000000000015E-4
2,test_20231101_140459,1254659.png,342646,49322,293324,0.8560555208582619,3,4,80080,6976,73104,0.9128871128871129,24.514750222222222,4371.7237706666665,11.724276478155753,138,8.300000000000015E-4
3,test_20231101_140459,10188041.png,221231,6414,214817,0.9710076797555496,2,4,41731,908,40823,0.978241594977355,12.821219555555556,1601.7605226666667,16.084827751239075,138,8.300000000000015E-4
4,test_20231101_140459,10287332.png,216980,7449,209531,0.9656696469720711,2,4,22337,1021,21316,0.9542910865380311,12.014368,1616.0612906666668,16.04622533084319,138,8.300000000000015E-4
5,test_20231101_140459,11610969.png,368720,9862,358858,0.9732534172271643,2,4,84111,1461,82650,0.9826300959446446,37.92520711111111,6884.959098666666,9.751789962715012,138,8.300000000000015E-4
6,test_20231101_140459,10350842.png,212614,24,212590,0.9998871193806617,1,4,42529,1,42528,0.9999764866326507,55.22670577777778,11938.01408,7.361482740939017,138,8.300000000000015E-4
7,test_20231101_140459,10863862.png,317432,4747,312685,0.9850456160689534,2,3,66058,697,65361,0.9894486663235339,40.808705777777774,7942.523504,9.131218521761033,138,8.300000000000015E-4
8,test_20231101_140459,11382381.png,312486,327,312159,0.9989535531191798,1,4,46745,44,46701,0.9990587228580596,23.441726222222222,2963.055792,13.413405318888326,138,8.300000000000015E-4
9,test_20231101_140459,11079715.png,443815,87157,356658,0.8036186248774827,3,4,124136,12301,111835,0.9009070696655281,19.579482666666667,2830.1671626666666,13.612682731599836,138,8.300000000000015E-4
10,test_20231101_140459,11551286.png,271883,24,271859,0.9999117267353972,0,3,40092,1,40091,0.9999750573680535,24.866876444444443,3470.407338666667,12.72699907819776,138,8.300000000000015E-4
1,test_20231101_140500,10404007.png,502730,9369,493361,0.9813637539036859,2,4,61265,1373,59892,0.9775891618379172,27.395573333333335,3880.67536,12.241730477485373,138,8.400000000000016E-4
2,test_20231101_140500,1254659.png,342646,49322,293324,0.8560555208582619,3,3,80080,6976,73104,0.9128871128871129,24.514750222222222,4371.7237706666665,11.724276478155753,138,8.400000000000016E-4
3,test_20231101_140500,10188041.png,221231,6414,214817,0.9710076797555496,2,3,41731,908,40823,0.978241594977355,12.821219555555556,1601.7605226666667,16.084827751239075,138,8.400000000000016E-4
4,test_20231101_140500,10287332.png,216980,7449,209531,0.9656696469720711,2,4,22337,1021,21316,0.9542910865380311,12.014368,1616.0612906666668,16.04622533084319,138,8.400000000000016E-4
5,test_20231101_140500,11610969.png,368720,9862,358858,0.9732534172271643,2,3,84111,1461,82650,0.9826300959446446,37.92520711111111,6884.959098666666,9.751789962715012,138,8.400000000000016E-4
6,test_20231101_140500,10350842.png,212614,24,212590,0.9998871193806617,0,3,42529,1,42528,0.9999764866326507,55.22670577777778,11938.01408,7.361482740939017,138,8.400000000000016E-4
7,test_20231101_140500,10863862.png,317432,4387,313045,0.986179717230777,2,4,66058,645,65413,0.9902358533410034,43.449589333333336,8728.729269333333,8.721293372637557,138,8.400000000000016E-4
8,test_20231101_140500,11382381.png,312486,327,312159,0.9989535531191798,1,4,46745,44,46701,0.9990587228580596,23.441726222222222,2963.055792,13.413405318888326,138,8.400000000000016E-4
9,test_20231101_140500,11079715.png,443815,87157,356658,0.8036186248774827,3,4,124136,12301,111835,0.9009070696655281,19.579482666666667,2830.1671626666666,13.612682731599836,138,8.400000000000016E-4
10,test_20231101_140500,11551286.png,271883,24,271859,0.9999117267353972,1,4,40092,1,40091,0.9999750573680535,24.866876444444443,3470.407338666667,12.72699907819776,138,8.400000000000016E-4
1,test_20231101_140500,10404007.png,502730,9369,493361,0.9813637539036859,2,4,61265,1373,59892,0.9775891618379172,27.395573333333335,3880.67536,12.241730477485373,138,8.500000000000016E-4
2,test_20231101_140500,1254659.png,342646,49322,293324,0.8560555208582619,3,13,80080,6976,73104,0.9128871128871129,24.514750222222222,4371.7237706666665,11.724276478155753,138,8.500000000000016E-4
3,test_20231101_140500,10188041.png,221231,6414,214817,0.9710076797555496,2,3,41731,908,40823,0.978241594977355,12.821219555555556,1601.7605226666667,16.084827751239075,138,8.500000000000016E-4
4,test_20231101_140500,10287332.png,216980,7449,209531,0.9656696469720711,4,3,22337,1021,21316,0.9542910865380311,12.014368,1616.0612906666668,16.04622533084319,138,8.500000000000016E-4
5,test_20231101_140500,11610969.png,368720,9862,358858,0.9732534172271643,1,4,84111,1461,82650,0.9826300959446446,37.92520711111111,6884.959098666666,9.751789962715012,138,8.500000000000016E-4
6,test_20231101_140500,10350842.png,212614,24,212590,0.9998871193806617,0,3,42529,1,42528,0.9999764866326507,55.22670577777778,11938.01408,7.361482740939017,138,8.500000000000016E-4
7,test_20231101_140500,10863862.png,317432,4387,313045,0.986179717230777,1,3,66058,645,65413,0.9902358533410034,43.449589333333336,8728.729269333333,8.721293372637557,138,8.500000000000016E-4
8,test_20231101_140500,11382381.png,312486,327,312159,0.9989535531191798,1,3,46745,44,46701,0.9990587228580596,23.441726222222222,2963.055792,13.413405318888326,138,8.500000000000016E-4
9,test_20231101_140500,11079715.png,443815,87157,356658,0.8036186248774827,3,4,124136,12301,111835,0.9009070696655281,19.579482666666667,2830.1671626666666,13.612682731599836,138,8.500000000000016E-4
10,test_20231101_140500,11551286.png,271883,24,271859,0.9999117267353972,1,4,40092,1,40091,0.9999750573680535,24.866876444444443,3470.407338666667,12.72699907819776,138,8.500000000000016E-4
1,test_20231101_140501,10404007.png,502730,9369,493361,0.9813637539036859,2,4,61265,1373,59892,0.9775891618379172,27.395573333333335,3880.67536,12.241730477485373,138,8.600000000000016E-4
2,test_20231101_140501,1254659.png,342646,49322,293324,0.8560555208582619,3,4,80080,6976,73104,0.9128871128871129,24.514750222222222,4371.7237706666665,11.724276478155753,138,8.600000000000016E-4
3,test_20231101_140501,10188041.png,221231,6414,214817,0.9710076797555496,2,3,41731,908,40823,0.978241594977355,12.821219555555556,1601.7605226666667,16.084827751239075,138,8.600000000000016E-4
4,test_20231101_140501,10287332.png,216980,7449,209531,0.9656696469720711,1,3,22337,1021,21316,0.9542910865380311,12.014368,1616.0612906666668,16.04622533084319,138,8.600000000000016E-4
5,test_20231101_140501,11610969.png,368720,9862,358858,0.9732534172271643,2,4,84111,1461,82650,0.9826300959446446,37.92520711111111,6884.959098666666,9.751789962715012,138,8.600000000000016E-4
6,test_20231101_140501,10350842.png,212614,24,212590,0.9998871193806617,1,3,42529,1,42528,0.9999764866326507,55.22670577777778,11938.01408,7.361482740939017,138,8.600000000000016E-4
7,test_20231101_140501,10863862.png,317432,4387,313045,0.986179717230777,2,3,66058,645,65413,0.9902358533410034,43.449589333333336,8728.729269333333,8.721293372637557,138,8.600000000000016E-4
8,test_20231101_140501,11382381.png,312486,327,312159,0.9989535531191798,1,4,46745,44,46701,0.9990587228580596,23.441726222222222,2963.055792,13.413405318888326,138,8.600000000000016E-4
9,test_20231101_140501,11079715.png,443815,87157,356658,0.8036186248774827,3,4,124136,12301,111835,0.9009070696655281,19.579482666666667,2830.1671626666666,13.612682731599836,138,8.600000000000016E-4
10,test_20231101_140501,11551286.png,271883,24,271859,0.9999117267353972,0,4,40092,1,40091,0.9999750573680535,24.866876444444443,3470.407338666667,12.72699907819776,138,8.600000000000016E-4
1,test_20231101_140502,10404007.png,502730,9369,493361,0.9813637539036859,2,3,61265,1373,59892,0.9775891618379172,27.395573333333335,3880.67536,12.241730477485373,138,8.700000000000016E-4
2,test_20231101_140502,1254659.png,342646,49322,293324,0.8560555208582619,3,4,80080,6976,73104,0.9128871128871129,24.514750222222222,4371.7237706666665,11.724276478155753,138,8.700000000000016E-4
3,test_20231101_140502,10188041.png,221231,6414,214817,0.9710076797555496,2,3,41731,908,40823,0.978241594977355,12.821219555555556,1601.7605226666667,16.084827751239075,138,8.700000000000016E-4
4,test_20231101_140502,10287332.png,216980,7449,209531,0.9656696469720711,2,4,22337,1021,21316,0.9542910865380311,12.014368,1616.0612906666668,16.04622533084319,138,8.700000000000016E-4
5,test_20231101_140502,11610969.png,368720,9862,358858,0.9732534172271643,2,4,84111,1461,82650,0.9826300959446446,37.92520711111111,6884.959098666666,9.751789962715012,138,8.700000000000016E-4
6,test_20231101_140502,10350842.png,212614,24,212590,0.9998871193806617,1,3,42529,1,42528,0.9999764866326507,55.22670577777778,11938.01408,7.361482740939017,138,8.700000000000016E-4
7,test_20231101_140502,10863862.png,317432,4387,313045,0.986179717230777,1,4,66058,645,65413,0.9902358533410034,43.449589333333336,8728.729269333333,8.721293372637557,138,8.700000000000016E-4
8,test_20231101_140502,11382381.png,312486,327,312159,0.9989535531191798,2,4,46745,44,46701,0.9990587228580596,23.441726222222222,2963.055792,13.413405318888326,138,8.700000000000016E-4
9,test_20231101_140502,11079715.png,443815,87157,356658,0.8036186248774827,3,4,124136,12301,111835,0.9009070696655281,19.579482666666667,2830.1671626666666,13.612682731599836,138,8.700000000000016E-4
10,test_20231101_140502,11551286.png,271883,24,271859,0.9999117267353972,1,4,40092,1,40091,0.9999750573680535,24.866876444444443,3470.407338666667,12.72699907819776,138,8.700000000000016E-4
1,test_20231101_140502,10404007.png,502730,9369,493361,0.9813637539036859,2,3,61265,1373,59892,0.9775891618379172,27.395573333333335,3880.67536,12.241730477485373,138,8.800000000000017E-4
2,test_20231101_140502,1254659.png,342646,49322,293324,0.8560555208582619,2,3,80080,6976,73104,0.9128871128871129,24.514750222222222,4371.7237706666665,11.724276478155753,138,8.800000000000017E-4
3,test_20231101_140502,10188041.png,221231,6414,214817,0.9710076797555496,2,4,41731,908,40823,0.978241594977355,12.821219555555556,1601.7605226666667,16.084827751239075,138,8.800000000000017E-4
4,test_20231101_140502,10287332.png,216980,7449,209531,0.9656696469720711,1,4,22337,1021,21316,0.9542910865380311,12.014368,1616.0612906666668,16.04622533084319,138,8.800000000000017E-4
5,test_20231101_140502,11610969.png,368720,9862,358858,0.9732534172271643,2,4,84111,1461,82650,0.9826300959446446,37.92520711111111,6884.959098666666,9.751789962715012,138,8.800000000000017E-4
6,test_20231101_140502,10350842.png,212614,24,212590,0.9998871193806617,1,3,42529,1,42528,0.9999764866326507,55.22670577777778,11938.01408,7.361482740939017,138,8.800000000000017E-4
7,test_20231101_140502,10863862.png,317432,4387,313045,0.986179717230777,1,4,66058,645,65413,0.9902358533410034,43.449589333333336,8728.729269333333,8.721293372637557,138,8.800000000000017E-4
8,test_20231101_140502,11382381.png,312486,327,312159,0.9989535531191798,2,4,46745,44,46701,0.9990587228580596,23.441726222222222,2963.055792,13.413405318888326,138,8.800000000000017E-4
9,test_20231101_140502,11079715.png,443815,87157,356658,0.8036186248774827,3,4,124136,12301,111835,0.9009070696655281,19.579482666666667,2830.1671626666666,13.612682731599836,138,8.800000000000017E-4
10,test_20231101_140502,11551286.png,271883,24,271859,0.9999117267353972,1,3,40092,1,40091,0.9999750573680535,24.866876444444443,3470.407338666667,12.72699907819776,138,8.800000000000017E-4
1,test_20231101_140503,10404007.png,502730,9369,493361,0.9813637539036859,2,4,61265,1373,59892,0.9775891618379172,27.395573333333335,3880.67536,12.241730477485373,138,8.900000000000017E-4
2,test_20231101_140503,1254659.png,342646,49322,293324,0.8560555208582619,3,4,80080,6976,73104,0.9128871128871129,24.514750222222222,4371.7237706666665,11.724276478155753,138,8.900000000000017E-4
3,test_20231101_140503,10188041.png,221231,6414,214817,0.9710076797555496,2,3,41731,908,40823,0.978241594977355,12.821219555555556,1601.7605226666667,16.084827751239075,138,8.900000000000017E-4
4,test_20231101_140503,10287332.png,216980,7449,209531,0.9656696469720711,2,3,22337,1021,21316,0.9542910865380311,12.014368,1616.0612906666668,16.04622533084319,138,8.900000000000017E-4
5,test_20231101_140503,11610969.png,368720,9862,358858,0.9732534172271643,1,4,84111,1461,82650,0.9826300959446446,37.92520711111111,6884.959098666666,9.751789962715012,138,8.900000000000017E-4
6,test_20231101_140503,10350842.png,212614,24,212590,0.9998871193806617,1,5,42529,1,42528,0.9999764866326507,55.22670577777778,11938.01408,7.361482740939017,138,8.900000000000017E-4
7,test_20231101_140503,10863862.png,317432,4387,313045,0.986179717230777,2,6,66058,645,65413,0.9902358533410034,43.449589333333336,8728.729269333333,8.721293372637557,138,8.900000000000017E-4
8,test_20231101_140503,11382381.png,312486,327,312159,0.9989535531191798,2,4,46745,44,46701,0.9990587228580596,23.441726222222222,2963.055792,13.413405318888326,138,8.900000000000017E-4
9,test_20231101_140503,11079715.png,443815,87157,356658,0.8036186248774827,3,4,124136,12301,111835,0.9009070696655281,19.579482666666667,2830.1671626666666,13.612682731599836,138,8.900000000000017E-4
10,test_20231101_140503,11551286.png,271883,24,271859,0.9999117267353972,1,3,40092,1,40091,0.9999750573680535,24.866876444444443,3470.407338666667,12.72699907819776,138,8.900000000000017E-4
1,test_20231101_140504,10404007.png,502730,9369,493361,0.9813637539036859,2,3,61265,1373,59892,0.9775891618379172,27.395573333333335,3880.67536,12.241730477485373,138,9.000000000000017E-4
2,test_20231101_140504,1254659.png,342646,49322,293324,0.8560555208582619,2,3,80080,6976,73104,0.9128871128871129,24.514750222222222,4371.7237706666665,11.724276478155753,138,9.000000000000017E-4
3,test_20231101_140504,10188041.png,221231,6414,214817,0.9710076797555496,1,3,41731,908,40823,0.978241594977355,12.821219555555556,1601.7605226666667,16.084827751239075,138,9.000000000000017E-4
4,test_20231101_140504,10287332.png,216980,7449,209531,0.9656696469720711,2,4,22337,1021,21316,0.9542910865380311,12.014368,1616.0612906666668,16.04622533084319,138,9.000000000000017E-4
5,test_20231101_140504,11610969.png,368720,9862,358858,0.9732534172271643,2,4,84111,1461,82650,0.9826300959446446,37.92520711111111,6884.959098666666,9.751789962715012,138,9.000000000000017E-4
6,test_20231101_140504,10350842.png,212614,24,212590,0.9998871193806617,1,4,42529,1,42528,0.9999764866326507,55.22670577777778,11938.01408,7.361482740939017,138,9.000000000000017E-4
7,test_20231101_140504,10863862.png,317432,4387,313045,0.986179717230777,1,3,66058,645,65413,0.9902358533410034,43.449589333333336,8728.729269333333,8.721293372637557,138,9.000000000000017E-4
8,test_20231101_140504,11382381.png,312486,327,312159,0.9989535531191798,1,4,46745,44,46701,0.9990587228580596,23.441726222222222,2963.055792,13.413405318888326,138,9.000000000000017E-4
9,test_20231101_140504,11079715.png,443815,87157,356658,0.8036186248774827,4,4,124136,12301,111835,0.9009070696655281,19.579482666666667,2830.1671626666666,13.612682731599836,138,9.000000000000017E-4
10,test_20231101_140504,11551286.png,271883,24,271859,0.9999117267353972,1,4,40092,1,40091,0.9999750573680535,24.866876444444443,3470.407338666667,12.72699907819776,138,9.000000000000017E-4
1,test_20231101_140504,10404007.png,502730,9369,493361,0.9813637539036859,1,3,61265,1373,59892,0.9775891618379172,27.395573333333335,3880.67536,12.241730477485373,138,9.100000000000017E-4
2,test_20231101_140504,1254659.png,342646,49322,293324,0.8560555208582619,2,3,80080,6976,73104,0.9128871128871129,24.514750222222222,4371.7237706666665,11.724276478155753,138,9.100000000000017E-4
3,test_20231101_140504,10188041.png,221231,6414,214817,0.9710076797555496,2,3,41731,908,40823,0.978241594977355,12.821219555555556,1601.7605226666667,16.084827751239075,138,9.100000000000017E-4
4,test_20231101_140504,10287332.png,216980,7449,209531,0.9656696469720711,1,8,22337,1021,21316,0.9542910865380311,12.014368,1616.0612906666668,16.04622533084319,138,9.100000000000017E-4
5,test_20231101_140504,11610969.png,368720,9862,358858,0.9732534172271643,2,4,84111,1461,82650,0.9826300959446446,37.92520711111111,6884.959098666666,9.751789962715012,138,9.100000000000017E-4
6,test_20231101_140504,10350842.png,212614,24,212590,0.9998871193806617,1,4,42529,1,42528,0.9999764866326507,55.22670577777778,11938.01408,7.361482740939017,138,9.100000000000017E-4
7,test_20231101_140504,10863862.png,317432,4387,313045,0.986179717230777,1,4,66058,645,65413,0.9902358533410034,43.449589333333336,8728.729269333333,8.721293372637557,138,9.100000000000017E-4
8,test_20231101_140504,11382381.png,312486,327,312159,0.9989535531191798,1,4,46745,44,46701,0.9990587228580596,23.441726222222222,2963.055792,13.413405318888326,138,9.100000000000017E-4
9,test_20231101_140504,11079715.png,443815,87157,356658,0.8036186248774827,3,4,124136,12301,111835,0.9009070696655281,19.579482666666667,2830.1671626666666,13.612682731599836,138,9.100000000000017E-4
10,test_20231101_140504,11551286.png,271883,24,271859,0.9999117267353972,1,4,40092,1,40091,0.9999750573680535,24.866876444444443,3470.407338666667,12.72699907819776,138,9.100000000000017E-4
1,test_20231101_140505,10404007.png,502730,9369,493361,0.9813637539036859,2,4,61265,1373,59892,0.9775891618379172,27.395573333333335,3880.67536,12.241730477485373,138,9.200000000000018E-4
2,test_20231101_140505,1254659.png,342646,49322,293324,0.8560555208582619,2,3,80080,6976,73104,0.9128871128871129,24.514750222222222,4371.7237706666665,11.724276478155753,138,9.200000000000018E-4
3,test_20231101_140505,10188041.png,221231,6414,214817,0.9710076797555496,2,3,41731,908,40823,0.978241594977355,12.821219555555556,1601.7605226666667,16.084827751239075,138,9.200000000000018E-4
4,test_20231101_140505,10287332.png,216980,7449,209531,0.9656696469720711,1,3,22337,1021,21316,0.9542910865380311,12.014368,1616.0612906666668,16.04622533084319,138,9.200000000000018E-4
5,test_20231101_140505,11610969.png,368720,9862,358858,0.9732534172271643,2,3,84111,1461,82650,0.9826300959446446,37.92520711111111,6884.959098666666,9.751789962715012,138,9.200000000000018E-4
6,test_20231101_140505,10350842.png,212614,24,212590,0.9998871193806617,1,3,42529,1,42528,0.9999764866326507,55.22670577777778,11938.01408,7.361482740939017,138,9.200000000000018E-4
7,test_20231101_140505,10863862.png,317432,4387,313045,0.986179717230777,2,4,66058,645,65413,0.9902358533410034,43.449589333333336,8728.729269333333,8.721293372637557,138,9.200000000000018E-4
8,test_20231101_140505,11382381.png,312486,327,312159,0.9989535531191798,1,3,46745,44,46701,0.9990587228580596,23.441726222222222,2963.055792,13.413405318888326,138,9.200000000000018E-4
9,test_20231101_140505,11079715.png,443815,87157,356658,0.8036186248774827,3,5,124136,12301,111835,0.9009070696655281,19.579482666666667,2830.1671626666666,13.612682731599836,138,9.200000000000018E-4
10,test_20231101_140505,11551286.png,271883,24,271859,0.9999117267353972,1,3,40092,1,40091,0.9999750573680535,24.866876444444443,3470.407338666667,12.72699907819776,138,9.200000000000018E-4
1,test_20231101_140506,10404007.png,502730,9369,493361,0.9813637539036859,2,4,61265,1373,59892,0.9775891618379172,27.395573333333335,3880.67536,12.241730477485373,138,9.300000000000018E-4
2,test_20231101_140506,1254659.png,342646,49322,293324,0.8560555208582619,2,4,80080,6976,73104,0.9128871128871129,24.514750222222222,4371.7237706666665,11.724276478155753,138,9.300000000000018E-4
3,test_20231101_140506,10188041.png,221231,6414,214817,0.9710076797555496,2,4,41731,908,40823,0.978241594977355,12.821219555555556,1601.7605226666667,16.084827751239075,138,9.300000000000018E-4
4,test_20231101_140506,10287332.png,216980,7449,209531,0.9656696469720711,1,4,22337,1021,21316,0.9542910865380311,12.014368,1616.0612906666668,16.04622533084319,138,9.300000000000018E-4
5,test_20231101_140506,11610969.png,368720,9862,358858,0.9732534172271643,2,13,84111,1461,82650,0.9826300959446446,37.92520711111111,6884.959098666666,9.751789962715012,138,9.300000000000018E-4
6,test_20231101_140506,10350842.png,212614,24,212590,0.9998871193806617,0,3,42529,1,42528,0.9999764866326507,55.22670577777778,11938.01408,7.361482740939017,138,9.300000000000018E-4
7,test_20231101_140506,10863862.png,317432,4387,313045,0.986179717230777,2,3,66058,645,65413,0.9902358533410034,43.449589333333336,8728.729269333333,8.721293372637557,138,9.300000000000018E-4
8,test_20231101_140506,11382381.png,312486,327,312159,0.9989535531191798,1,3,46745,44,46701,0.9990587228580596,23.441726222222222,2963.055792,13.413405318888326,138,9.300000000000018E-4
9,test_20231101_140506,11079715.png,443815,87157,356658,0.8036186248774827,3,4,124136,12301,111835,0.9009070696655281,19.579482666666667,2830.1671626666666,13.612682731599836,138,9.300000000000018E-4
10,test_20231101_140506,11551286.png,271883,24,271859,0.9999117267353972,0,3,40092,1,40091,0.9999750573680535,24.866876444444443,3470.407338666667,12.72699907819776,138,9.300000000000018E-4
1,test_20231101_140506,10404007.png,502730,9369,493361,0.9813637539036859,1,3,61265,1373,59892,0.9775891618379172,27.395573333333335,3880.67536,12.241730477485373,138,9.400000000000018E-4
2,test_20231101_140506,1254659.png,342646,49322,293324,0.8560555208582619,3,4,80080,6976,73104,0.9128871128871129,24.514750222222222,4371.7237706666665,11.724276478155753,138,9.400000000000018E-4
3,test_20231101_140506,10188041.png,221231,6414,214817,0.9710076797555496,2,3,41731,908,40823,0.978241594977355,12.821219555555556,1601.7605226666667,16.084827751239075,138,9.400000000000018E-4
4,test_20231101_140506,10287332.png,216980,7449,209531,0.9656696469720711,1,3,22337,1021,21316,0.9542910865380311,12.014368,1616.0612906666668,16.04622533084319,138,9.400000000000018E-4
5,test_20231101_140506,11610969.png,368720,9862,358858,0.9732534172271643,1,3,84111,1461,82650,0.9826300959446446,37.92520711111111,6884.959098666666,9.751789962715012,138,9.400000000000018E-4
6,test_20231101_140506,10350842.png,212614,24,212590,0.9998871193806617,0,3,42529,1,42528,0.9999764866326507,55.22670577777778,11938.01408,7.361482740939017,138,9.400000000000018E-4
7,test_20231101_140506,10863862.png,317432,4387,313045,0.986179717230777,1,4,66058,645,65413,0.9902358533410034,43.449589333333336,8728.729269333333,8.721293372637557,138,9.400000000000018E-4
8,test_20231101_140506,11382381.png,312486,327,312159,0.9989535531191798,2,3,46745,44,46701,0.9990587228580596,23.441726222222222,2963.055792,13.413405318888326,138,9.400000000000018E-4
9,test_20231101_140506,11079715.png,443815,87157,356658,0.8036186248774827,3,4,124136,12301,111835,0.9009070696655281,19.579482666666667,2830.1671626666666,13.612682731599836,138,9.400000000000018E-4
10,test_20231101_140506,11551286.png,271883,24,271859,0.9999117267353972,1,3,40092,1,40091,0.9999750573680535,24.866876444444443,3470.407338666667,12.72699907819776,138,9.400000000000018E-4
1,test_20231101_140507,10404007.png,502730,9369,493361,0.9813637539036859,2,4,61265,1373,59892,0.9775891618379172,27.395573333333335,3880.67536,12.241730477485373,138,9.500000000000018E-4
2,test_20231101_140507,1254659.png,342646,49322,293324,0.8560555208582619,2,4,80080,6976,73104,0.9128871128871129,24.514750222222222,4371.7237706666665,11.724276478155753,138,9.500000000000018E-4
3,test_20231101_140507,10188041.png,221231,6414,214817,0.9710076797555496,2,3,41731,908,40823,0.978241594977355,12.821219555555556,1601.7605226666667,16.084827751239075,138,9.500000000000018E-4
4,test_20231101_140507,10287332.png,216980,7449,209531,0.9656696469720711,2,3,22337,1021,21316,0.9542910865380311,12.014368,1616.0612906666668,16.04622533084319,138,9.500000000000018E-4
5,test_20231101_140507,11610969.png,368720,9862,358858,0.9732534172271643,1,3,84111,1461,82650,0.9826300959446446,37.92520711111111,6884.959098666666,9.751789962715012,138,9.500000000000018E-4
6,test_20231101_140507,10350842.png,212614,24,212590,0.9998871193806617,0,4,42529,1,42528,0.9999764866326507,55.22670577777778,11938.01408,7.361482740939017,138,9.500000000000018E-4
7,test_20231101_140507,10863862.png,317432,4387,313045,0.986179717230777,2,4,66058,645,65413,0.9902358533410034,43.449589333333336,8728.729269333333,8.721293372637557,138,9.500000000000018E-4
8,test_20231101_140507,11382381.png,312486,327,312159,0.9989535531191798,1,3,46745,44,46701,0.9990587228580596,23.441726222222222,2963.055792,13.413405318888326,138,9.500000000000018E-4
9,test_20231101_140507,11079715.png,443815,87157,356658,0.8036186248774827,3,4,124136,12301,111835,0.9009070696655281,19.579482666666667,2830.1671626666666,13.612682731599836,138,9.500000000000018E-4
10,test_20231101_140507,11551286.png,271883,24,271859,0.9999117267353972,1,3,40092,1,40091,0.9999750573680535,24.866876444444443,3470.407338666667,12.72699907819776,138,9.500000000000018E-4
1,test_20231101_140508,10404007.png,502730,9369,493361,0.9813637539036859,2,3,61265,1373,59892,0.9775891618379172,27.395573333333335,3880.67536,12.241730477485373,138,9.600000000000019E-4
2,test_20231101_140508,1254659.png,342646,49322,293324,0.8560555208582619,3,4,80080,6976,73104,0.9128871128871129,24.514750222222222,4371.7237706666665,11.724276478155753,138,9.600000000000019E-4
3,test_20231101_140508,10188041.png,221231,6414,214817,0.9710076797555496,2,4,41731,908,40823,0.978241594977355,12.821219555555556,1601.7605226666667,16.084827751239075,138,9.600000000000019E-4
4,test_20231101_140508,10287332.png,216980,7449,209531,0.9656696469720711,1,3,22337,1021,21316,0.9542910865380311,12.014368,1616.0612906666668,16.04622533084319,138,9.600000000000019E-4
5,test_20231101_140508,11610969.png,368720,9862,358858,0.9732534172271643,2,4,84111,1461,82650,0.9826300959446446,37.92520711111111,6884.959098666666,9.751789962715012,138,9.600000000000019E-4
6,test_20231101_140508,10350842.png,212614,24,212590,0.9998871193806617,1,4,42529,1,42528,0.9999764866326507,55.22670577777778,11938.01408,7.361482740939017,138,9.600000000000019E-4
7,test_20231101_140508,10863862.png,317432,4387,313045,0.986179717230777,1,3,66058,645,65413,0.9902358533410034,43.449589333333336,8728.729269333333,8.721293372637557,138,9.600000000000019E-4
8,test_20231101_140508,11382381.png,312486,327,312159,0.9989535531191798,2,3,46745,44,46701,0.9990587228580596,23.441726222222222,2963.055792,13.413405318888326,138,9.600000000000019E-4
9,test_20231101_140508,11079715.png,443815,87157,356658,0.8036186248774827,4,4,124136,12301,111835,0.9009070696655281,19.579482666666667,2830.1671626666666,13.612682731599836,138,9.600000000000019E-4
10,test_20231101_140508,11551286.png,271883,24,271859,0.9999117267353972,1,4,40092,1,40091,0.9999750573680535,24.866876444444443,3470.407338666667,12.72699907819776,138,9.600000000000019E-4
1,test_20231101_140509,10404007.png,502730,9369,493361,0.9813637539036859,2,3,61265,1373,59892,0.9775891618379172,27.395573333333335,3880.67536,12.241730477485373,138,9.700000000000019E-4
2,test_20231101_140509,1254659.png,342646,49322,293324,0.8560555208582619,3,4,80080,6976,73104,0.9128871128871129,24.514750222222222,4371.7237706666665,11.724276478155753,138,9.700000000000019E-4
3,test_20231101_140509,10188041.png,221231,6414,214817,0.9710076797555496,2,4,41731,908,40823,0.978241594977355,12.821219555555556,1601.7605226666667,16.084827751239075,138,9.700000000000019E-4
4,test_20231101_140509,10287332.png,216980,7449,209531,0.9656696469720711,1,4,22337,1021,21316,0.9542910865380311,12.014368,1616.0612906666668,16.04622533084319,138,9.700000000000019E-4
5,test_20231101_140509,11610969.png,368720,9862,358858,0.9732534172271643,2,4,84111,1461,82650,0.9826300959446446,37.92520711111111,6884.959098666666,9.751789962715012,138,9.700000000000019E-4
6,test_20231101_140509,10350842.png,212614,24,212590,0.9998871193806617,1,4,42529,1,42528,0.9999764866326507,55.22670577777778,11938.01408,7.361482740939017,138,9.700000000000019E-4
7,test_20231101_140509,10863862.png,317432,4387,313045,0.986179717230777,1,3,66058,645,65413,0.9902358533410034,43.449589333333336,8728.729269333333,8.721293372637557,138,9.700000000000019E-4
8,test_20231101_140509,11382381.png,312486,327,312159,0.9989535531191798,2,3,46745,44,46701,0.9990587228580596,23.441726222222222,2963.055792,13.413405318888326,138,9.700000000000019E-4
9,test_20231101_140509,11079715.png,443815,87157,356658,0.8036186248774827,3,4,124136,12301,111835,0.9009070696655281,19.579482666666667,2830.1671626666666,13.612682731599836,138,9.700000000000019E-4
10,test_20231101_140509,11551286.png,271883,24,271859,0.9999117267353972,1,4,40092,1,40091,0.9999750573680535,24.866876444444443,3470.407338666667,12.72699907819776,138,9.700000000000019E-4
1,test_20231101_140509,10404007.png,502730,8927,493803,0.9822429534740318,2,3,61265,1307,59958,0.9786664490328899,27.460956444444445,3899.7816213333335,12.22040072637636,138,9.80000000000002E-4
2,test_20231101_140509,1254659.png,342646,49002,293644,0.8569894293235585,3,4,80080,6939,73141,0.9133491508491508,24.784147555555556,4432.534106666667,11.664282748509862,138,9.80000000000002E-4
3,test_20231101_140509,10188041.png,221231,6254,214977,0.9717309057048967,1,3,41731,892,40839,0.9786250029953751,12.908810666666668,1620.9669333333334,16.033062052527956,138,9.80000000000002E-4
4,test_20231101_140509,10287332.png,216980,7369,209611,0.9660383445478846,2,4,22337,1009,21328,0.9548283117697094,12.03992888888889,1620.231264,16.03503352800095,138,9.80000000000002E-4
5,test_20231101_140509,11610969.png,368720,9662,359058,0.9737958342373617,2,9,84111,1431,82680,0.9829867674858223,37.997552,6903.423194666667,9.740158634791708,138,9.80000000000002E-4
6,test_20231101_140509,10350842.png,212614,24,212590,0.9998871193806617,1,3,42529,1,42528,0.9999764866326507,55.22670577777778,11938.01408,7.361482740939017,138,9.80000000000002E-4
7,test_20231101_140509,10863862.png,317432,4144,313288,0.9869452355150079,1,3,66058,609,65449,0.9907808289684823,43.57643022222222,8762.226154666667,8.704659026607377,138,9.80000000000002E-4
8,test_20231101_140509,11382381.png,312486,327,312159,0.9989535531191798,1,4,46745,44,46701,0.9990587228580596,23.441726222222222,2963.055792,13.413405318888326,138,9.80000000000002E-4
9,test_20231101_140509,11079715.png,443815,87077,356738,0.8037988801640323,3,4,124136,12293,111843,0.9009715151124573,19.616147555555557,2835.0415946666667,13.605209257865361,138,9.80000000000002E-4
10,test_20231101_140509,11551286.png,271883,24,271859,0.9999117267353972,1,3,40092,1,40091,0.9999750573680535,24.866876444444443,3470.407338666667,12.72699907819776,138,9.80000000000002E-4
1,test_20231101_140510,10404007.png,502730,8927,493803,0.9822429534740318,2,4,61265,1307,59958,0.9786664490328899,27.460956444444445,3899.7816213333335,12.22040072637636,138,9.90000000000002E-4
2,test_20231101_140510,1254659.png,342646,49002,293644,0.8569894293235585,3,4,80080,6939,73141,0.9133491508491508,24.784147555555556,4432.534106666667,11.664282748509862,138,9.90000000000002E-4
3,test_20231101_140510,10188041.png,221231,6254,214977,0.9717309057048967,1,3,41731,892,40839,0.9786250029953751,12.908810666666668,1620.9669333333334,16.033062052527956,138,9.90000000000002E-4
4,test_20231101_140510,10287332.png,216980,7369,209611,0.9660383445478846,1,3,22337,1009,21328,0.9548283117697094,12.03992888888889,1620.231264,16.03503352800095,138,9.90000000000002E-4
5,test_20231101_140510,11610969.png,368720,9662,359058,0.9737958342373617,2,4,84111,1431,82680,0.9829867674858223,37.997552,6903.423194666667,9.740158634791708,138,9.90000000000002E-4
6,test_20231101_140510,10350842.png,212614,24,212590,0.9998871193806617,0,4,42529,1,42528,0.9999764866326507,55.22670577777778,11938.01408,7.361482740939017,138,9.90000000000002E-4
7,test_20231101_140510,10863862.png,317432,4144,313288,0.9869452355150079,1,3,66058,609,65449,0.9907808289684823,43.57643022222222,8762.226154666667,8.704659026607377,138,9.90000000000002E-4
8,test_20231101_140510,11382381.png,312486,327,312159,0.9989535531191798,1,4,46745,44,46701,0.9990587228580596,23.441726222222222,2963.055792,13.413405318888326,138,9.90000000000002E-4
9,test_20231101_140510,11079715.png,443815,87077,356738,0.8037988801640323,4,4,124136,12293,111843,0.9009715151124573,19.616147555555557,2835.0415946666667,13.605209257865361,138,9.90000000000002E-4
10,test_20231101_140510,11551286.png,271883,24,271859,0.9999117267353972,1,3,40092,1,40091,0.9999750573680535,24.866876444444443,3470.407338666667,12.72699907819776,138,9.90000000000002E-4
1,test_20231101_140511,10404007.png,502730,9509,493221,0.9810852744017664,2,4,61265,1394,59871,0.9772463886395168,27.07272,3817.9584053333333,12.312491681964882,139,0.0
2,test_20231101_140511,1254659.png,342646,48017,294629,0.8598641163182994,2,3,80080,6797,73283,0.9151223776223776,24.664812444444443,4427.052730666666,11.669656659726009,139,0.0
3,test_20231101_140511,10188041.png,221231,6557,214674,0.9703612965633207,2,3,41731,927,40804,0.977786297955956,12.47773511111111,1554.953632,16.21362917773078,139,0.0
4,test_20231101_140511,10287332.png,216980,7622,209358,0.9648723384643746,2,4,22337,1044,21293,0.9532614048439808,11.831968,1583.5284053333332,16.134545027154715,139,0.0
5,test_20231101_140511,11610969.png,368720,9037,359683,0.9754908873942287,2,4,84111,1338,82773,0.9840924492634733,36.94512711111111,6680.453418666667,9.882744207662947,139,0.0
6,test_20231101_140511,10350842.png,212614,3109,209505,0.9853772564365469,2,4,42529,457,42072,0.9892543911213525,22.877592888888888,3259.5520426666667,12.999224414028802,139,0.0
7,test_20231101_140511,10863862.png,317432,4747,312685,0.9850456160689534,2,4,66058,697,65361,0.9894486663235339,40.23792177777778,7793.163312,9.21366583543488,139,0.0
8,test_20231101_140511,11382381.png,312486,547,311939,0.9982495215785667,1,4,46745,76,46669,0.9983741576639212,21.96234488888889,2754.930384,13.729697319910494,139,0.0
9,test_20231101_140511,11079715.png,443815,84717,359098,0.8091164111172449,4,4,124136,11969,112167,0.9035815557130888,19.73027377777778,2901.3324213333335,13.504828697488506,139,0.0
10,test_20231101_140511,11551286.png,271883,397,271486,0.9985398130813622,1,13,40092,56,40036,0.9986032126109947,17.788083555555556,1857.6711626666668,15.441115214355744,139,0.0
1,test_20231101_140511,10404007.png,502730,9509,493221,0.9810852744017664,2,4,61265,1394,59871,0.9772463886395168,27.07272,3817.9584053333333,12.312491681964882,139,1.0E-5
2,test_20231101_140511,1254659.png,342646,48017,294629,0.8598641163182994,3,4,80080,6797,73283,0.9151223776223776,24.664812444444443,4427.052730666666,11.669656659726009,139,1.0E-5
3,test_20231101_140511,10188041.png,221231,6557,214674,0.9703612965633207,2,4,41731,927,40804,0.977786297955956,12.47773511111111,1554.953632,16.21362917773078,139,1.0E-5
4,test_20231101_140511,10287332.png,216980,7622,209358,0.9648723384643746,1,3,22337,1044,21293,0.9532614048439808,11.831968,1583.5284053333332,16.134545027154715,139,1.0E-5
5,test_20231101_140511,11610969.png,368720,9037,359683,0.9754908873942287,2,3,84111,1338,82773,0.9840924492634733,36.94512711111111,6680.453418666667,9.882744207662947,139,1.0E-5
6,test_20231101_140511,10350842.png,212614,3109,209505,0.9853772564365469,1,4,42529,457,42072,0.9892543911213525,22.877592888888888,3259.5520426666667,12.999224414028802,139,1.0E-5
7,test_20231101_140511,10863862.png,317432,4747,312685,0.9850456160689534,2,4,66058,697,65361,0.9894486663235339,40.23792177777778,7793.163312,9.21366583543488,139,1.0E-5
8,test_20231101_140511,11382381.png,312486,547,311939,0.9982495215785667,1,3,46745,76,46669,0.9983741576639212,21.96234488888889,2754.930384,13.729697319910494,139,1.0E-5
9,test_20231101_140511,11079715.png,443815,84717,359098,0.8091164111172449,3,4,124136,11969,112167,0.9035815557130888,19.73027377777778,2901.3324213333335,13.504828697488506,139,1.0E-5
10,test_20231101_140511,11551286.png,271883,397,271486,0.9985398130813622,1,4,40092,56,40036,0.9986032126109947,17.788083555555556,1857.6711626666668,15.441115214355744,139,1.0E-5
1,test_20231101_140512,10404007.png,502730,9509,493221,0.9810852744017664,2,4,61265,1394,59871,0.9772463886395168,27.07272,3817.9584053333333,12.312491681964882,139,2.0E-5
2,test_20231101_140512,1254659.png,342646,48017,294629,0.8598641163182994,3,4,80080,6797,73283,0.9151223776223776,24.664812444444443,4427.052730666666,11.669656659726009,139,2.0E-5
3,test_20231101_140512,10188041.png,221231,6557,214674,0.9703612965633207,2,4,41731,927,40804,0.977786297955956,12.47773511111111,1554.953632,16.21362917773078,139,2.0E-5
4,test_20231101_140512,10287332.png,216980,7622,209358,0.9648723384643746,1,3,22337,1044,21293,0.9532614048439808,11.831968,1583.5284053333332,16.134545027154715,139,2.0E-5
5,test_20231101_140512,11610969.png,368720,9037,359683,0.9754908873942287,2,4,84111,1338,82773,0.9840924492634733,36.94512711111111,6680.453418666667,9.882744207662947,139,2.0E-5
6,test_20231101_140512,10350842.png,212614,3109,209505,0.9853772564365469,1,3,42529,457,42072,0.9892543911213525,22.877592888888888,3259.5520426666667,12.999224414028802,139,2.0E-5
7,test_20231101_140512,10863862.png,317432,4747,312685,0.9850456160689534,1,3,66058,697,65361,0.9894486663235339,40.23792177777778,7793.163312,9.21366583543488,139,2.0E-5
8,test_20231101_140512,11382381.png,312486,537,311949,0.9982815230122309,1,3,46745,75,46670,0.9983955503262381,22.692161777777777,2853.4911946666666,13.577038241313751,139,2.0E-5
9,test_20231101_140512,11079715.png,443815,84717,359098,0.8091164111172449,3,4,124136,11969,112167,0.9035815557130888,19.73027377777778,2901.3324213333335,13.504828697488506,139,2.0E-5
10,test_20231101_140512,11551286.png,271883,397,271486,0.9985398130813622,2,3,40092,56,40036,0.9986032126109947,17.788083555555556,1857.6711626666668,15.441115214355744,139,2.0E-5
1,test_20231101_140513,10404007.png,502730,9509,493221,0.9810852744017664,2,3,61265,1394,59871,0.9772463886395168,27.07272,3817.9584053333333,12.312491681964882,139,3.0000000000000004E-5
2,test_20231101_140513,1254659.png,342646,48017,294629,0.8598641163182994,3,4,80080,6797,73283,0.9151223776223776,24.664812444444443,4427.052730666666,11.669656659726009,139,3.0000000000000004E-5
3,test_20231101_140513,10188041.png,221231,6557,214674,0.9703612965633207,2,7,41731,927,40804,0.977786297955956,12.47773511111111,1554.953632,16.21362917773078,139,3.0000000000000004E-5
4,test_20231101_140513,10287332.png,216980,7622,209358,0.9648723384643746,2,4,22337,1044,21293,0.9532614048439808,11.831968,1583.5284053333332,16.134545027154715,139,3.0000000000000004E-5
5,test_20231101_140513,11610969.png,368720,9037,359683,0.9754908873942287,2,3,84111,1338,82773,0.9840924492634733,36.94512711111111,6680.453418666667,9.882744207662947,139,3.0000000000000004E-5
6,test_20231101_140513,10350842.png,212614,3109,209505,0.9853772564365469,1,4,42529,457,42072,0.9892543911213525,22.877592888888888,3259.5520426666667,12.999224414028802,139,3.0000000000000004E-5
7,test_20231101_140513,10863862.png,317432,4747,312685,0.9850456160689534,1,3,66058,697,65361,0.9894486663235339,40.23792177777778,7793.163312,9.21366583543488,139,3.0000000000000004E-5
8,test_20231101_140513,11382381.png,312486,537,311949,0.9982815230122309,1,3,46745,75,46670,0.9983955503262381,22.692161777777777,2853.4911946666666,13.577038241313751,139,3.0000000000000004E-5
9,test_20231101_140513,11079715.png,443815,84717,359098,0.8091164111172449,3,4,124136,11969,112167,0.9035815557130888,19.73027377777778,2901.3324213333335,13.504828697488506,139,3.0000000000000004E-5
10,test_20231101_140513,11551286.png,271883,397,271486,0.9985398130813622,1,4,40092,56,40036,0.9986032126109947,17.788083555555556,1857.6711626666668,15.441115214355744,139,3.0000000000000004E-5
1,test_20231101_140513,10404007.png,502730,9509,493221,0.9810852744017664,1,3,61265,1394,59871,0.9772463886395168,27.07272,3817.9584053333333,12.312491681964882,139,4.0E-5
2,test_20231101_140513,1254659.png,342646,48017,294629,0.8598641163182994,3,4,80080,6797,73283,0.9151223776223776,24.664812444444443,4427.052730666666,11.669656659726009,139,4.0E-5
3,test_20231101_140513,10188041.png,221231,6557,214674,0.9703612965633207,2,4,41731,927,40804,0.977786297955956,12.47773511111111,1554.953632,16.21362917773078,139,4.0E-5
4,test_20231101_140513,10287332.png,216980,7622,209358,0.9648723384643746,1,4,22337,1044,21293,0.9532614048439808,11.831968,1583.5284053333332,16.134545027154715,139,4.0E-5
5,test_20231101_140513,11610969.png,368720,9037,359683,0.9754908873942287,1,3,84111,1338,82773,0.9840924492634733,36.94512711111111,6680.453418666667,9.882744207662947,139,4.0E-5
6,test_20231101_140513,10350842.png,212614,3109,209505,0.9853772564365469,1,4,42529,457,42072,0.9892543911213525,22.877592888888888,3259.5520426666667,12.999224414028802,139,4.0E-5
7,test_20231101_140513,10863862.png,317432,4747,312685,0.9850456160689534,1,4,66058,697,65361,0.9894486663235339,40.23792177777778,7793.163312,9.21366583543488,139,4.0E-5
8,test_20231101_140513,11382381.png,312486,537,311949,0.9982815230122309,1,3,46745,75,46670,0.9983955503262381,22.692161777777777,2853.4911946666666,13.577038241313751,139,4.0E-5
9,test_20231101_140513,11079715.png,443815,84717,359098,0.8091164111172449,3,4,124136,11969,112167,0.9035815557130888,19.73027377777778,2901.3324213333335,13.504828697488506,139,4.0E-5
10,test_20231101_140513,11551286.png,271883,397,271486,0.9985398130813622,2,3,40092,56,40036,0.9986032126109947,17.788083555555556,1857.6711626666668,15.441115214355744,139,4.0E-5
1,test_20231101_140514,10404007.png,502730,9509,493221,0.9810852744017664,2,4,61265,1394,59871,0.9772463886395168,27.07272,3817.9584053333333,12.312491681964882,139,5.0E-5
2,test_20231101_140514,1254659.png,342646,48017,294629,0.8598641163182994,3,4,80080,6797,73283,0.9151223776223776,24.664812444444443,4427.052730666666,11.669656659726009,139,5.0E-5
3,test_20231101_140514,10188041.png,221231,6557,214674,0.9703612965633207,2,4,41731,927,40804,0.977786297955956,12.47773511111111,1554.953632,16.21362917773078,139,5.0E-5
4,test_20231101_140514,10287332.png,216980,7622,209358,0.9648723384643746,1,3,22337,1044,21293,0.9532614048439808,11.831968,1583.5284053333332,16.134545027154715,139,5.0E-5
5,test_20231101_140514,11610969.png,368720,9037,359683,0.9754908873942287,3,4,84111,1338,82773,0.9840924492634733,36.94512711111111,6680.453418666667,9.882744207662947,139,5.0E-5
6,test_20231101_140514,10350842.png,212614,3109,209505,0.9853772564365469,2,4,42529,457,42072,0.9892543911213525,22.877592888888888,3259.5520426666667,12.999224414028802,139,5.0E-5
7,test_20231101_140514,10863862.png,317432,4747,312685,0.9850456160689534,2,4,66058,697,65361,0.9894486663235339,40.23792177777778,7793.163312,9.21366583543488,139,5.0E-5
8,test_20231101_140514,11382381.png,312486,537,311949,0.9982815230122309,2,3,46745,75,46670,0.9983955503262381,22.692161777777777,2853.4911946666666,13.577038241313751,139,5.0E-5
9,test_20231101_140514,11079715.png,443815,84717,359098,0.8091164111172449,3,3,124136,11969,112167,0.9035815557130888,19.73027377777778,2901.3324213333335,13.504828697488506,139,5.0E-5
10,test_20231101_140514,11551286.png,271883,397,271486,0.9985398130813622,2,3,40092,56,40036,0.9986032126109947,17.788083555555556,1857.6711626666668,15.441115214355744,139,5.0E-5
1,test_20231101_140515,10404007.png,502730,9509,493221,0.9810852744017664,1,3,61265,1394,59871,0.9772463886395168,27.07272,3817.9584053333333,12.312491681964882,139,6.0E-5
2,test_20231101_140515,1254659.png,342646,48017,294629,0.8598641163182994,2,4,80080,6797,73283,0.9151223776223776,24.664812444444443,4427.052730666666,11.669656659726009,139,6.0E-5
3,test_20231101_140515,10188041.png,221231,6557,214674,0.9703612965633207,2,3,41731,927,40804,0.977786297955956,12.47773511111111,1554.953632,16.21362917773078,139,6.0E-5
4,test_20231101_140515,10287332.png,216980,7622,209358,0.9648723384643746,2,4,22337,1044,21293,0.9532614048439808,11.831968,1583.5284053333332,16.134545027154715,139,6.0E-5
5,test_20231101_140515,11610969.png,368720,9037,359683,0.9754908873942287,1,4,84111,1338,82773,0.9840924492634733,36.94512711111111,6680.453418666667,9.882744207662947,139,6.0E-5
6,test_20231101_140515,10350842.png,212614,3109,209505,0.9853772564365469,2,4,42529,457,42072,0.9892543911213525,22.877592888888888,3259.5520426666667,12.999224414028802,139,6.0E-5
7,test_20231101_140515,10863862.png,317432,4747,312685,0.9850456160689534,2,4,66058,697,65361,0.9894486663235339,40.23792177777778,7793.163312,9.21366583543488,139,6.0E-5
8,test_20231101_140515,11382381.png,312486,537,311949,0.9982815230122309,1,4,46745,75,46670,0.9983955503262381,22.692161777777777,2853.4911946666666,13.577038241313751,139,6.0E-5
9,test_20231101_140515,11079715.png,443815,84717,359098,0.8091164111172449,3,4,124136,11969,112167,0.9035815557130888,19.73027377777778,2901.3324213333335,13.504828697488506,139,6.0E-5
10,test_20231101_140515,11551286.png,271883,397,271486,0.9985398130813622,1,3,40092,56,40036,0.9986032126109947,17.788083555555556,1857.6711626666668,15.441115214355744,139,6.0E-5
1,test_20231101_140515,10404007.png,502730,9509,493221,0.9810852744017664,2,4,61265,1394,59871,0.9772463886395168,27.07272,3817.9584053333333,12.312491681964882,139,7.000000000000001E-5
2,test_20231101_140515,1254659.png,342646,48017,294629,0.8598641163182994,3,4,80080,6797,73283,0.9151223776223776,24.664812444444443,4427.052730666666,11.669656659726009,139,7.000000000000001E-5
3,test_20231101_140515,10188041.png,221231,6557,214674,0.9703612965633207,2,3,41731,927,40804,0.977786297955956,12.47773511111111,1554.953632,16.21362917773078,139,7.000000000000001E-5
4,test_20231101_140515,10287332.png,216980,7622,209358,0.9648723384643746,1,3,22337,1044,21293,0.9532614048439808,11.831968,1583.5284053333332,16.134545027154715,139,7.000000000000001E-5
5,test_20231101_140515,11610969.png,368720,8677,360043,0.9764672380125841,2,4,84111,1284,82827,0.9847344580375932,38.38211733333333,7011.9524,9.672414016046677,139,7.000000000000001E-5
6,test_20231101_140515,10350842.png,212614,3109,209505,0.9853772564365469,1,3,42529,457,42072,0.9892543911213525,22.877592888888888,3259.5520426666667,12.999224414028802,139,7.000000000000001E-5
7,test_20231101_140515,10863862.png,317432,4747,312685,0.9850456160689534,2,4,66058,697,65361,0.9894486663235339,40.23792177777778,7793.163312,9.21366583543488,139,7.000000000000001E-5
8,test_20231101_140515,11382381.png,312486,537,311949,0.9982815230122309,1,3,46745,75,46670,0.9983955503262381,22.692161777777777,2853.4911946666666,13.577038241313751,139,7.000000000000001E-5
9,test_20231101_140515,11079715.png,443815,84717,359098,0.8091164111172449,3,4,124136,11969,112167,0.9035815557130888,19.73027377777778,2901.3324213333335,13.504828697488506,139,7.000000000000001E-5
10,test_20231101_140515,11551286.png,271883,277,271606,0.9989811794043761,1,4,40092,38,40054,0.9990521799860321,17.87441777777778,1863.783136,15.426849830633177,139,7.000000000000001E-5
1,test_20231101_140516,10404007.png,502730,9509,493221,0.9810852744017664,2,4,61265,1394,59871,0.9772463886395168,27.07272,3817.9584053333333,12.312491681964882,139,8.0E-5
2,test_20231101_140516,1254659.png,342646,48017,294629,0.8598641163182994,3,4,80080,6797,73283,0.9151223776223776,24.664812444444443,4427.052730666666,11.669656659726009,139,8.0E-5
3,test_20231101_140516,10188041.png,221231,6557,214674,0.9703612965633207,2,4,41731,927,40804,0.977786297955956,12.47773511111111,1554.953632,16.21362917773078,139,8.0E-5
4,test_20231101_140516,10287332.png,216980,7622,209358,0.9648723384643746,2,4,22337,1044,21293,0.9532614048439808,11.831968,1583.5284053333332,16.134545027154715,139,8.0E-5
5,test_20231101_140516,11610969.png,368720,8677,360043,0.9764672380125841,2,4,84111,1284,82827,0.9847344580375932,38.38211733333333,7011.9524,9.672414016046677,139,8.0E-5
6,test_20231101_140516,10350842.png,212614,3109,209505,0.9853772564365469,1,3,42529,457,42072,0.9892543911213525,22.877592888888888,3259.5520426666667,12.999224414028802,139,8.0E-5
7,test_20231101_140516,10863862.png,317432,4747,312685,0.9850456160689534,1,3,66058,697,65361,0.9894486663235339,40.23792177777778,7793.163312,9.21366583543488,139,8.0E-5
8,test_20231101_140516,11382381.png,312486,427,312059,0.9986335387825375,1,4,46745,59,46686,0.9987378329233073,22.94864,2893.62336,13.516383590740695,139,8.0E-5
9,test_20231101_140516,11079715.png,443815,84717,359098,0.8091164111172449,2,4,124136,11969,112167,0.9035815557130888,19.73027377777778,2901.3324213333335,13.504828697488506,139,8.0E-5
10,test_20231101_140516,11551286.png,271883,277,271606,0.9989811794043761,1,4,40092,38,40054,0.9990521799860321,17.87441777777778,1863.783136,15.426849830633177,139,8.0E-5
1,test_20231101_140517,10404007.png,502730,9509,493221,0.9810852744017664,2,3,61265,1394,59871,0.9772463886395168,27.07272,3817.9584053333333,12.312491681964882,139,9.0E-5
2,test_20231101_140517,1254659.png,342646,48017,294629,0.8598641163182994,2,4,80080,6797,73283,0.9151223776223776,24.664812444444443,4427.052730666666,11.669656659726009,139,9.0E-5
3,test_20231101_140517,10188041.png,221231,6557,214674,0.9703612965633207,2,4,41731,927,40804,0.977786297955956,12.47773511111111,1554.953632,16.21362917773078,139,9.0E-5
4,test_20231101_140517,10287332.png,216980,7622,209358,0.9648723384643746,2,3,22337,1044,21293,0.9532614048439808,11.831968,1583.5284053333332,16.134545027154715,139,9.0E-5
5,test_20231101_140517,11610969.png,368720,8677,360043,0.9764672380125841,2,4,84111,1284,82827,0.9847344580375932,38.38211733333333,7011.9524,9.672414016046677,139,9.0E-5
6,test_20231101_140517,10350842.png,212614,3109,209505,0.9853772564365469,2,3,42529,457,42072,0.9892543911213525,22.877592888888888,3259.5520426666667,12.999224414028802,139,9.0E-5
7,test_20231101_140517,10863862.png,317432,4747,312685,0.9850456160689534,1,3,66058,697,65361,0.9894486663235339,40.23792177777778,7793.163312,9.21366583543488,139,9.0E-5
8,test_20231101_140517,11382381.png,312486,427,312059,0.9986335387825375,2,3,46745,59,46686,0.9987378329233073,22.94864,2893.62336,13.516383590740695,139,9.0E-5
9,test_20231101_140517,11079715.png,443815,84717,359098,0.8091164111172449,3,4,124136,11969,112167,0.9035815557130888,19.73027377777778,2901.3324213333335,13.504828697488506,139,9.0E-5
10,test_20231101_140517,11551286.png,271883,277,271606,0.9989811794043761,1,4,40092,38,40054,0.9990521799860321,17.87441777777778,1863.783136,15.426849830633177,139,9.0E-5
1,test_20231101_140517,10404007.png,502730,9509,493221,0.9810852744017664,2,3,61265,1394,59871,0.9772463886395168,27.07272,3817.9584053333333,12.312491681964882,139,1.0E-4
2,test_20231101_140517,1254659.png,342646,48017,294629,0.8598641163182994,3,4,80080,6797,73283,0.9151223776223776,24.664812444444443,4427.052730666666,11.669656659726009,139,1.0E-4
3,test_20231101_140517,10188041.png,221231,6557,214674,0.9703612965633207,1,3,41731,927,40804,0.977786297955956,12.47773511111111,1554.953632,16.21362917773078,139,1.0E-4
4,test_20231101_140517,10287332.png,216980,7622,209358,0.9648723384643746,2,4,22337,1044,21293,0.9532614048439808,11.831968,1583.5284053333332,16.134545027154715,139,1.0E-4
5,test_20231101_140517,11610969.png,368720,8677,360043,0.9764672380125841,1,4,84111,1284,82827,0.9847344580375932,38.38211733333333,7011.9524,9.672414016046677,139,1.0E-4
6,test_20231101_140517,10350842.png,212614,3109,209505,0.9853772564365469,1,4,42529,457,42072,0.9892543911213525,22.877592888888888,3259.5520426666667,12.999224414028802,139,1.0E-4
7,test_20231101_140517,10863862.png,317432,4747,312685,0.9850456160689534,1,4,66058,697,65361,0.9894486663235339,40.23792177777778,7793.163312,9.21366583543488,139,1.0E-4
8,test_20231101_140517,11382381.png,312486,427,312059,0.9986335387825375,2,3,46745,59,46686,0.9987378329233073,22.94864,2893.62336,13.516383590740695,139,1.0E-4
9,test_20231101_140517,11079715.png,443815,84717,359098,0.8091164111172449,3,4,124136,11969,112167,0.9035815557130888,19.73027377777778,2901.3324213333335,13.504828697488506,139,1.0E-4
10,test_20231101_140517,11551286.png,271883,277,271606,0.9989811794043761,1,3,40092,38,40054,0.9990521799860321,17.87441777777778,1863.783136,15.426849830633177,139,1.0E-4
1,test_20231101_140518,10404007.png,502730,9509,493221,0.9810852744017664,2,4,61265,1394,59871,0.9772463886395168,27.07272,3817.9584053333333,12.312491681964882,139,1.1E-4
2,test_20231101_140518,1254659.png,342646,48017,294629,0.8598641163182994,2,4,80080,6797,73283,0.9151223776223776,24.664812444444443,4427.052730666666,11.669656659726009,139,1.1E-4
3,test_20231101_140518,10188041.png,221231,6557,214674,0.9703612965633207,2,4,41731,927,40804,0.977786297955956,12.47773511111111,1554.953632,16.21362917773078,139,1.1E-4
4,test_20231101_140518,10287332.png,216980,7622,209358,0.9648723384643746,1,4,22337,1044,21293,0.9532614048439808,11.831968,1583.5284053333332,16.134545027154715,139,1.1E-4
5,test_20231101_140518,11610969.png,368720,8677,360043,0.9764672380125841,1,3,84111,1284,82827,0.9847344580375932,38.38211733333333,7011.9524,9.672414016046677,139,1.1E-4
6,test_20231101_140518,10350842.png,212614,3109,209505,0.9853772564365469,2,4,42529,457,42072,0.9892543911213525,22.877592888888888,3259.5520426666667,12.999224414028802,139,1.1E-4
7,test_20231101_140518,10863862.png,317432,4747,312685,0.9850456160689534,2,4,66058,697,65361,0.9894486663235339,40.23792177777778,7793.163312,9.21366583543488,139,1.1E-4
8,test_20231101_140518,11382381.png,312486,427,312059,0.9986335387825375,1,3,46745,59,46686,0.9987378329233073,22.94864,2893.62336,13.516383590740695,139,1.1E-4
9,test_20231101_140518,11079715.png,443815,84717,359098,0.8091164111172449,3,4,124136,11969,112167,0.9035815557130888,19.73027377777778,2901.3324213333335,13.504828697488506,139,1.1E-4
10,test_20231101_140518,11551286.png,271883,277,271606,0.9989811794043761,1,4,40092,38,40054,0.9990521799860321,17.87441777777778,1863.783136,15.426849830633177,139,1.1E-4
1,test_20231101_140519,10404007.png,502730,9509,493221,0.9810852744017664,1,3,61265,1394,59871,0.9772463886395168,27.07272,3817.9584053333333,12.312491681964882,139,1.2E-4
2,test_20231101_140519,1254659.png,342646,48017,294629,0.8598641163182994,3,4,80080,6797,73283,0.9151223776223776,24.664812444444443,4427.052730666666,11.669656659726009,139,1.2E-4
3,test_20231101_140519,10188041.png,221231,6557,214674,0.9703612965633207,2,4,41731,927,40804,0.977786297955956,12.47773511111111,1554.953632,16.21362917773078,139,1.2E-4
4,test_20231101_140519,10287332.png,216980,7622,209358,0.9648723384643746,1,4,22337,1044,21293,0.9532614048439808,11.831968,1583.5284053333332,16.134545027154715,139,1.2E-4
5,test_20231101_140519,11610969.png,368720,8677,360043,0.9764672380125841,2,3,84111,1284,82827,0.9847344580375932,38.38211733333333,7011.9524,9.672414016046677,139,1.2E-4
6,test_20231101_140519,10350842.png,212614,3109,209505,0.9853772564365469,2,4,42529,457,42072,0.9892543911213525,22.877592888888888,3259.5520426666667,12.999224414028802,139,1.2E-4
7,test_20231101_140519,10863862.png,317432,4747,312685,0.9850456160689534,1,4,66058,697,65361,0.9894486663235339,40.23792177777778,7793.163312,9.21366583543488,139,1.2E-4
8,test_20231101_140519,11382381.png,312486,427,312059,0.9986335387825375,1,3,46745,59,46686,0.9987378329233073,22.94864,2893.62336,13.516383590740695,139,1.2E-4
9,test_20231101_140519,11079715.png,443815,84717,359098,0.8091164111172449,3,4,124136,11969,112167,0.9035815557130888,19.73027377777778,2901.3324213333335,13.504828697488506,139,1.2E-4
10,test_20231101_140519,11551286.png,271883,277,271606,0.9989811794043761,2,5,40092,38,40054,0.9990521799860321,17.87441777777778,1863.783136,15.426849830633177,139,1.2E-4
1,test_20231101_140519,10404007.png,502730,9509,493221,0.9810852744017664,3,4,61265,1394,59871,0.9772463886395168,27.07272,3817.9584053333333,12.312491681964882,139,1.3000000000000002E-4
2,test_20231101_140519,1254659.png,342646,48017,294629,0.8598641163182994,3,4,80080,6797,73283,0.9151223776223776,24.664812444444443,4427.052730666666,11.669656659726009,139,1.3000000000000002E-4
3,test_20231101_140519,10188041.png,221231,6557,214674,0.9703612965633207,2,4,41731,927,40804,0.977786297955956,12.47773511111111,1554.953632,16.21362917773078,139,1.3000000000000002E-4
4,test_20231101_140519,10287332.png,216980,7622,209358,0.9648723384643746,1,4,22337,1044,21293,0.9532614048439808,11.831968,1583.5284053333332,16.134545027154715,139,1.3000000000000002E-4
5,test_20231101_140519,11610969.png,368720,8677,360043,0.9764672380125841,1,3,84111,1284,82827,0.9847344580375932,38.38211733333333,7011.9524,9.672414016046677,139,1.3000000000000002E-4
6,test_20231101_140519,10350842.png,212614,3109,209505,0.9853772564365469,1,4,42529,457,42072,0.9892543911213525,22.877592888888888,3259.5520426666667,12.999224414028802,139,1.3000000000000002E-4
7,test_20231101_140519,10863862.png,317432,4747,312685,0.9850456160689534,2,4,66058,697,65361,0.9894486663235339,40.23792177777778,7793.163312,9.21366583543488,139,1.3000000000000002E-4
8,test_20231101_140519,11382381.png,312486,427,312059,0.9986335387825375,2,3,46745,59,46686,0.9987378329233073,22.94864,2893.62336,13.516383590740695,139,1.3000000000000002E-4
9,test_20231101_140519,11079715.png,443815,84717,359098,0.8091164111172449,3,4,124136,11969,112167,0.9035815557130888,19.73027377777778,2901.3324213333335,13.504828697488506,139,1.3000000000000002E-4
10,test_20231101_140519,11551286.png,271883,277,271606,0.9989811794043761,2,3,40092,38,40054,0.9990521799860321,17.87441777777778,1863.783136,15.426849830633177,139,1.3000000000000002E-4
1,test_20231101_140520,10404007.png,502730,9509,493221,0.9810852744017664,2,4,61265,1394,59871,0.9772463886395168,27.07272,3817.9584053333333,12.312491681964882,139,1.4000000000000001E-4
2,test_20231101_140520,1254659.png,342646,48017,294629,0.8598641163182994,2,3,80080,6797,73283,0.9151223776223776,24.664812444444443,4427.052730666666,11.669656659726009,139,1.4000000000000001E-4
3,test_20231101_140520,10188041.png,221231,6557,214674,0.9703612965633207,2,4,41731,927,40804,0.977786297955956,12.47773511111111,1554.953632,16.21362917773078,139,1.4000000000000001E-4
4,test_20231101_140520,10287332.png,216980,7622,209358,0.9648723384643746,2,4,22337,1044,21293,0.9532614048439808,11.831968,1583.5284053333332,16.134545027154715,139,1.4000000000000001E-4
5,test_20231101_140520,11610969.png,368720,8677,360043,0.9764672380125841,2,4,84111,1284,82827,0.9847344580375932,38.38211733333333,7011.9524,9.672414016046677,139,1.4000000000000001E-4
6,test_20231101_140520,10350842.png,212614,3109,209505,0.9853772564365469,2,4,42529,457,42072,0.9892543911213525,22.877592888888888,3259.5520426666667,12.999224414028802,139,1.4000000000000001E-4
7,test_20231101_140520,10863862.png,317432,4747,312685,0.9850456160689534,1,4,66058,697,65361,0.9894486663235339,40.23792177777778,7793.163312,9.21366583543488,139,1.4000000000000001E-4
8,test_20231101_140520,11382381.png,312486,427,312059,0.9986335387825375,1,3,46745,59,46686,0.9987378329233073,22.94864,2893.62336,13.516383590740695,139,1.4000000000000001E-4
9,test_20231101_140520,11079715.png,443815,84717,359098,0.8091164111172449,3,4,124136,11969,112167,0.9035815557130888,19.73027377777778,2901.3324213333335,13.504828697488506,139,1.4000000000000001E-4
10,test_20231101_140520,11551286.png,271883,277,271606,0.9989811794043761,1,3,40092,38,40054,0.9990521799860321,17.87441777777778,1863.783136,15.426849830633177,139,1.4000000000000001E-4
1,test_20231101_140521,10404007.png,502730,9509,493221,0.9810852744017664,2,4,61265,1394,59871,0.9772463886395168,27.07272,3817.9584053333333,12.312491681964882,139,1.5000000000000001E-4
2,test_20231101_140521,1254659.png,342646,48017,294629,0.8598641163182994,3,3,80080,6797,73283,0.9151223776223776,24.664812444444443,4427.052730666666,11.669656659726009,139,1.5000000000000001E-4
3,test_20231101_140521,10188041.png,221231,6557,214674,0.9703612965633207,2,4,41731,927,40804,0.977786297955956,12.47773511111111,1554.953632,16.21362917773078,139,1.5000000000000001E-4
4,test_20231101_140521,10287332.png,216980,7622,209358,0.9648723384643746,1,3,22337,1044,21293,0.9532614048439808,11.831968,1583.5284053333332,16.134545027154715,139,1.5000000000000001E-4
5,test_20231101_140521,11610969.png,368720,8677,360043,0.9764672380125841,2,3,84111,1284,82827,0.9847344580375932,38.38211733333333,7011.9524,9.672414016046677,139,1.5000000000000001E-4
6,test_20231101_140521,10350842.png,212614,3109,209505,0.9853772564365469,1,10,42529,457,42072,0.9892543911213525,22.877592888888888,3259.5520426666667,12.999224414028802,139,1.5000000000000001E-4
7,test_20231101_140521,10863862.png,317432,4747,312685,0.9850456160689534,1,4,66058,697,65361,0.9894486663235339,40.23792177777778,7793.163312,9.21366583543488,139,1.5000000000000001E-4
8,test_20231101_140521,11382381.png,312486,427,312059,0.9986335387825375,1,4,46745,59,46686,0.9987378329233073,22.94864,2893.62336,13.516383590740695,139,1.5000000000000001E-4
9,test_20231101_140521,11079715.png,443815,84717,359098,0.8091164111172449,3,4,124136,11969,112167,0.9035815557130888,19.73027377777778,2901.3324213333335,13.504828697488506,139,1.5000000000000001E-4
10,test_20231101_140521,11551286.png,271883,277,271606,0.9989811794043761,2,10,40092,38,40054,0.9990521799860321,17.87441777777778,1863.783136,15.426849830633177,139,1.5000000000000001E-4
1,test_20231101_140521,10404007.png,502730,9509,493221,0.9810852744017664,2,4,61265,1394,59871,0.9772463886395168,27.07272,3817.9584053333333,12.312491681964882,139,1.6E-4
2,test_20231101_140521,1254659.png,342646,48017,294629,0.8598641163182994,2,3,80080,6797,73283,0.9151223776223776,24.664812444444443,4427.052730666666,11.669656659726009,139,1.6E-4
3,test_20231101_140521,10188041.png,221231,6557,214674,0.9703612965633207,2,4,41731,927,40804,0.977786297955956,12.47773511111111,1554.953632,16.21362917773078,139,1.6E-4
4,test_20231101_140521,10287332.png,216980,7449,209531,0.9656696469720711,1,4,22337,1023,21314,0.954201548999418,11.958311111111112,1609.2046613333334,16.064690789594813,139,1.6E-4
5,test_20231101_140521,11610969.png,368720,8677,360043,0.9764672380125841,2,4,84111,1284,82827,0.9847344580375932,38.38211733333333,7011.9524,9.672414016046677,139,1.6E-4
6,test_20231101_140521,10350842.png,212614,3109,209505,0.9853772564365469,2,4,42529,457,42072,0.9892543911213525,22.877592888888888,3259.5520426666667,12.999224414028802,139,1.6E-4
7,test_20231101_140521,10863862.png,317432,4747,312685,0.9850456160689534,2,4,66058,697,65361,0.9894486663235339,40.23792177777778,7793.163312,9.21366583543488,139,1.6E-4
8,test_20231101_140521,11382381.png,312486,427,312059,0.9986335387825375,1,3,46745,59,46686,0.9987378329233073,22.94864,2893.62336,13.516383590740695,139,1.6E-4
9,test_20231101_140521,11079715.png,443815,84717,359098,0.8091164111172449,3,4,124136,11969,112167,0.9035815557130888,19.73027377777778,2901.3324213333335,13.504828697488506,139,1.6E-4
10,test_20231101_140521,11551286.png,271883,124,271759,0.999543921466219,1,3,40092,16,40076,0.9996009178888556,18.13910577777778,1903.2464906666667,15.335853231830718,139,1.6E-4
1,test_20231101_140522,10404007.png,502730,9509,493221,0.9810852744017664,2,3,61265,1394,59871,0.9772463886395168,27.07272,3817.9584053333333,12.312491681964882,139,1.7E-4
2,test_20231101_140522,1254659.png,342646,48017,294629,0.8598641163182994,2,3,80080,6797,73283,0.9151223776223776,24.664812444444443,4427.052730666666,11.669656659726009,139,1.7E-4
3,test_20231101_140522,10188041.png,221231,6557,214674,0.9703612965633207,2,4,41731,927,40804,0.977786297955956,12.47773511111111,1554.953632,16.21362917773078,139,1.7E-4
4,test_20231101_140522,10287332.png,216980,7449,209531,0.9656696469720711,1,3,22337,1023,21314,0.954201548999418,11.958311111111112,1609.2046613333334,16.064690789594813,139,1.7E-4
5,test_20231101_140522,11610969.png,368720,8677,360043,0.9764672380125841,1,4,84111,1284,82827,0.9847344580375932,38.38211733333333,7011.9524,9.672414016046677,139,1.7E-4
6,test_20231101_140522,10350842.png,212614,3109,209505,0.9853772564365469,1,4,42529,457,42072,0.9892543911213525,22.877592888888888,3259.5520426666667,12.999224414028802,139,1.7E-4
7,test_20231101_140522,10863862.png,317432,4747,312685,0.9850456160689534,2,4,66058,697,65361,0.9894486663235339,40.23792177777778,7793.163312,9.21366583543488,139,1.7E-4
8,test_20231101_140522,11382381.png,312486,427,312059,0.9986335387825375,1,4,46745,59,46686,0.9987378329233073,22.94864,2893.62336,13.516383590740695,139,1.7E-4
9,test_20231101_140522,11079715.png,443815,84717,359098,0.8091164111172449,3,4,124136,11969,112167,0.9035815557130888,19.73027377777778,2901.3324213333335,13.504828697488506,139,1.7E-4
10,test_20231101_140522,11551286.png,271883,124,271759,0.999543921466219,1,4,40092,16,40076,0.9996009178888556,18.13910577777778,1903.2464906666667,15.335853231830718,139,1.7E-4
1,test_20231101_140523,10404007.png,502730,9509,493221,0.9810852744017664,2,4,61265,1394,59871,0.9772463886395168,27.07272,3817.9584053333333,12.312491681964882,139,1.8E-4
2,test_20231101_140523,1254659.png,342646,48017,294629,0.8598641163182994,3,4,80080,6797,73283,0.9151223776223776,24.664812444444443,4427.052730666666,11.669656659726009,139,1.8E-4
3,test_20231101_140523,10188041.png,221231,6557,214674,0.9703612965633207,2,4,41731,927,40804,0.977786297955956,12.47773511111111,1554.953632,16.21362917773078,139,1.8E-4
4,test_20231101_140523,10287332.png,216980,7449,209531,0.9656696469720711,1,3,22337,1023,21314,0.954201548999418,11.958311111111112,1609.2046613333334,16.064690789594813,139,1.8E-4
5,test_20231101_140523,11610969.png,368720,8677,360043,0.9764672380125841,2,4,84111,1284,82827,0.9847344580375932,38.38211733333333,7011.9524,9.672414016046677,139,1.8E-4
6,test_20231101_140523,10350842.png,212614,3109,209505,0.9853772564365469,2,4,42529,457,42072,0.9892543911213525,22.877592888888888,3259.5520426666667,12.999224414028802,139,1.8E-4
7,test_20231101_140523,10863862.png,317432,4747,312685,0.9850456160689534,2,4,66058,697,65361,0.9894486663235339,40.23792177777778,7793.163312,9.21366583543488,139,1.8E-4
8,test_20231101_140523,11382381.png,312486,427,312059,0.9986335387825375,1,4,46745,59,46686,0.9987378329233073,22.94864,2893.62336,13.516383590740695,139,1.8E-4
9,test_20231101_140523,11079715.png,443815,84717,359098,0.8091164111172449,3,5,124136,11969,112167,0.9035815557130888,19.73027377777778,2901.3324213333335,13.504828697488506,139,1.8E-4
10,test_20231101_140523,11551286.png,271883,124,271759,0.999543921466219,1,4,40092,16,40076,0.9996009178888556,18.13910577777778,1903.2464906666667,15.335853231830718,139,1.8E-4
1,test_20231101_140523,10404007.png,502730,9509,493221,0.9810852744017664,2,3,61265,1394,59871,0.9772463886395168,27.07272,3817.9584053333333,12.312491681964882,139,1.9E-4
2,test_20231101_140523,1254659.png,342646,48017,294629,0.8598641163182994,2,4,80080,6797,73283,0.9151223776223776,24.664812444444443,4427.052730666666,11.669656659726009,139,1.9E-4
3,test_20231101_140523,10188041.png,221231,6557,214674,0.9703612965633207,2,4,41731,927,40804,0.977786297955956,12.47773511111111,1554.953632,16.21362917773078,139,1.9E-4
4,test_20231101_140523,10287332.png,216980,7449,209531,0.9656696469720711,2,3,22337,1023,21314,0.954201548999418,11.958311111111112,1609.2046613333334,16.064690789594813,139,1.9E-4
5,test_20231101_140523,11610969.png,368720,8677,360043,0.9764672380125841,2,4,84111,1284,82827,0.9847344580375932,38.38211733333333,7011.9524,9.672414016046677,139,1.9E-4
6,test_20231101_140523,10350842.png,212614,3109,209505,0.9853772564365469,2,3,42529,457,42072,0.9892543911213525,22.877592888888888,3259.5520426666667,12.999224414028802,139,1.9E-4
7,test_20231101_140523,10863862.png,317432,4747,312685,0.9850456160689534,2,3,66058,697,65361,0.9894486663235339,40.23792177777778,7793.163312,9.21366583543488,139,1.9E-4
8,test_20231101_140523,11382381.png,312486,427,312059,0.9986335387825375,1,4,46745,59,46686,0.9987378329233073,22.94864,2893.62336,13.516383590740695,139,1.9E-4
9,test_20231101_140523,11079715.png,443815,84717,359098,0.8091164111172449,4,4,124136,11969,112167,0.9035815557130888,19.73027377777778,2901.3324213333335,13.504828697488506,139,1.9E-4
10,test_20231101_140523,11551286.png,271883,124,271759,0.999543921466219,2,3,40092,16,40076,0.9996009178888556,18.13910577777778,1903.2464906666667,15.335853231830718,139,1.9E-4
1,test_20231101_140524,10404007.png,502730,9509,493221,0.9810852744017664,2,3,61265,1394,59871,0.9772463886395168,27.07272,3817.9584053333333,12.312491681964882,139,2.0E-4
2,test_20231101_140524,1254659.png,342646,48017,294629,0.8598641163182994,3,4,80080,6797,73283,0.9151223776223776,24.664812444444443,4427.052730666666,11.669656659726009,139,2.0E-4
3,test_20231101_140524,10188041.png,221231,6557,214674,0.9703612965633207,2,3,41731,927,40804,0.977786297955956,12.47773511111111,1554.953632,16.21362917773078,139,2.0E-4
4,test_20231101_140524,10287332.png,216980,7449,209531,0.9656696469720711,2,4,22337,1023,21314,0.954201548999418,11.958311111111112,1609.2046613333334,16.064690789594813,139,2.0E-4
5,test_20231101_140524,11610969.png,368720,8677,360043,0.9764672380125841,2,4,84111,1284,82827,0.9847344580375932,38.38211733333333,7011.9524,9.672414016046677,139,2.0E-4
6,test_20231101_140524,10350842.png,212614,3109,209505,0.9853772564365469,1,3,42529,457,42072,0.9892543911213525,22.877592888888888,3259.5520426666667,12.999224414028802,139,2.0E-4
7,test_20231101_140524,10863862.png,317432,4747,312685,0.9850456160689534,1,3,66058,697,65361,0.9894486663235339,40.23792177777778,7793.163312,9.21366583543488,139,2.0E-4
8,test_20231101_140524,11382381.png,312486,427,312059,0.9986335387825375,2,3,46745,59,46686,0.9987378329233073,22.94864,2893.62336,13.516383590740695,139,2.0E-4
9,test_20231101_140524,11079715.png,443815,84717,359098,0.8091164111172449,3,4,124136,11969,112167,0.9035815557130888,19.73027377777778,2901.3324213333335,13.504828697488506,139,2.0E-4
10,test_20231101_140524,11551286.png,271883,124,271759,0.999543921466219,2,3,40092,16,40076,0.9996009178888556,18.13910577777778,1903.2464906666667,15.335853231830718,139,2.0E-4
1,test_20231101_140525,10404007.png,502730,9509,493221,0.9810852744017664,2,3,61265,1394,59871,0.9772463886395168,27.07272,3817.9584053333333,12.312491681964882,139,2.1E-4
2,test_20231101_140525,1254659.png,342646,48017,294629,0.8598641163182994,3,4,80080,6797,73283,0.9151223776223776,24.664812444444443,4427.052730666666,11.669656659726009,139,2.1E-4
3,test_20231101_140525,10188041.png,221231,6557,214674,0.9703612965633207,2,4,41731,927,40804,0.977786297955956,12.47773511111111,1554.953632,16.21362917773078,139,2.1E-4
4,test_20231101_140525,10287332.png,216980,7449,209531,0.9656696469720711,1,4,22337,1023,21314,0.954201548999418,11.958311111111112,1609.2046613333334,16.064690789594813,139,2.1E-4
5,test_20231101_140525,11610969.png,368720,8677,360043,0.9764672380125841,1,3,84111,1284,82827,0.9847344580375932,38.38211733333333,7011.9524,9.672414016046677,139,2.1E-4
6,test_20231101_140525,10350842.png,212614,3109,209505,0.9853772564365469,1,4,42529,457,42072,0.9892543911213525,22.877592888888888,3259.5520426666667,12.999224414028802,139,2.1E-4
7,test_20231101_140525,10863862.png,317432,4747,312685,0.9850456160689534,1,4,66058,697,65361,0.9894486663235339,40.23792177777778,7793.163312,9.21366583543488,139,2.1E-4
8,test_20231101_140525,11382381.png,312486,427,312059,0.9986335387825375,2,3,46745,59,46686,0.9987378329233073,22.94864,2893.62336,13.516383590740695,139,2.1E-4
9,test_20231101_140525,11079715.png,443815,84717,359098,0.8091164111172449,3,4,124136,11969,112167,0.9035815557130888,19.73027377777778,2901.3324213333335,13.504828697488506,139,2.1E-4
10,test_20231101_140525,11551286.png,271883,124,271759,0.999543921466219,1,3,40092,16,40076,0.9996009178888556,18.13910577777778,1903.2464906666667,15.335853231830718,139,2.1E-4
1,test_20231101_140525,10404007.png,502730,9509,493221,0.9810852744017664,2,4,61265,1394,59871,0.9772463886395168,27.07272,3817.9584053333333,12.312491681964882,139,2.2E-4
2,test_20231101_140525,1254659.png,342646,48017,294629,0.8598641163182994,3,4,80080,6797,73283,0.9151223776223776,24.664812444444443,4427.052730666666,11.669656659726009,139,2.2E-4
3,test_20231101_140525,10188041.png,221231,6557,214674,0.9703612965633207,2,4,41731,927,40804,0.977786297955956,12.47773511111111,1554.953632,16.21362917773078,139,2.2E-4
4,test_20231101_140525,10287332.png,216980,7449,209531,0.9656696469720711,2,3,22337,1023,21314,0.954201548999418,11.958311111111112,1609.2046613333334,16.064690789594813,139,2.2E-4
5,test_20231101_140525,11610969.png,368720,8677,360043,0.9764672380125841,2,4,84111,1284,82827,0.9847344580375932,38.38211733333333,7011.9524,9.672414016046677,139,2.2E-4
6,test_20231101_140525,10350842.png,212614,3109,209505,0.9853772564365469,2,3,42529,457,42072,0.9892543911213525,22.877592888888888,3259.5520426666667,12.999224414028802,139,2.2E-4
7,test_20231101_140525,10863862.png,317432,4747,312685,0.9850456160689534,2,3,66058,697,65361,0.9894486663235339,40.23792177777778,7793.163312,9.21366583543488,139,2.2E-4
8,test_20231101_140525,11382381.png,312486,427,312059,0.9986335387825375,2,4,46745,59,46686,0.9987378329233073,22.94864,2893.62336,13.516383590740695,139,2.2E-4
9,test_20231101_140525,11079715.png,443815,84717,359098,0.8091164111172449,4,4,124136,11969,112167,0.9035815557130888,19.73027377777778,2901.3324213333335,13.504828697488506,139,2.2E-4
10,test_20231101_140525,11551286.png,271883,124,271759,0.999543921466219,2,3,40092,16,40076,0.9996009178888556,18.13910577777778,1903.2464906666667,15.335853231830718,139,2.2E-4
1,test_20231101_140526,10404007.png,502730,9509,493221,0.9810852744017664,2,4,61265,1394,59871,0.9772463886395168,27.07272,3817.9584053333333,12.312491681964882,139,2.3E-4
2,test_20231101_140526,1254659.png,342646,48017,294629,0.8598641163182994,2,4,80080,6797,73283,0.9151223776223776,24.664812444444443,4427.052730666666,11.669656659726009,139,2.3E-4
3,test_20231101_140526,10188041.png,221231,6557,214674,0.9703612965633207,2,4,41731,927,40804,0.977786297955956,12.47773511111111,1554.953632,16.21362917773078,139,2.3E-4
4,test_20231101_140526,10287332.png,216980,7449,209531,0.9656696469720711,2,4,22337,1023,21314,0.954201548999418,11.958311111111112,1609.2046613333334,16.064690789594813,139,2.3E-4
5,test_20231101_140526,11610969.png,368720,8677,360043,0.9764672380125841,2,4,84111,1284,82827,0.9847344580375932,38.38211733333333,7011.9524,9.672414016046677,139,2.3E-4
6,test_20231101_140526,10350842.png,212614,3109,209505,0.9853772564365469,1,3,42529,457,42072,0.9892543911213525,22.877592888888888,3259.5520426666667,12.999224414028802,139,2.3E-4
7,test_20231101_140526,10863862.png,317432,4747,312685,0.9850456160689534,1,3,66058,697,65361,0.9894486663235339,40.23792177777778,7793.163312,9.21366583543488,139,2.3E-4
8,test_20231101_140526,11382381.png,312486,427,312059,0.9986335387825375,2,3,46745,59,46686,0.9987378329233073,22.94864,2893.62336,13.516383590740695,139,2.3E-4
9,test_20231101_140526,11079715.png,443815,84717,359098,0.8091164111172449,3,4,124136,11969,112167,0.9035815557130888,19.73027377777778,2901.3324213333335,13.504828697488506,139,2.3E-4
10,test_20231101_140526,11551286.png,271883,124,271759,0.999543921466219,1,4,40092,16,40076,0.9996009178888556,18.13910577777778,1903.2464906666667,15.335853231830718,139,2.3E-4
1,test_20231101_140527,10404007.png,502730,9509,493221,0.9810852744017664,2,3,61265,1394,59871,0.9772463886395168,27.07272,3817.9584053333333,12.312491681964882,139,2.4E-4
2,test_20231101_140527,1254659.png,342646,48017,294629,0.8598641163182994,3,4,80080,6797,73283,0.9151223776223776,24.664812444444443,4427.052730666666,11.669656659726009,139,2.4E-4
3,test_20231101_140527,10188041.png,221231,6557,214674,0.9703612965633207,2,4,41731,927,40804,0.977786297955956,12.47773511111111,1554.953632,16.21362917773078,139,2.4E-4
4,test_20231101_140527,10287332.png,216980,7449,209531,0.9656696469720711,2,4,22337,1023,21314,0.954201548999418,11.958311111111112,1609.2046613333334,16.064690789594813,139,2.4E-4
5,test_20231101_140527,11610969.png,368720,8677,360043,0.9764672380125841,2,3,84111,1284,82827,0.9847344580375932,38.38211733333333,7011.9524,9.672414016046677,139,2.4E-4
6,test_20231101_140527,10350842.png,212614,3109,209505,0.9853772564365469,1,4,42529,457,42072,0.9892543911213525,22.877592888888888,3259.5520426666667,12.999224414028802,139,2.4E-4
7,test_20231101_140527,10863862.png,317432,4747,312685,0.9850456160689534,1,3,66058,697,65361,0.9894486663235339,40.23792177777778,7793.163312,9.21366583543488,139,2.4E-4
8,test_20231101_140527,11382381.png,312486,427,312059,0.9986335387825375,2,3,46745,59,46686,0.9987378329233073,22.94864,2893.62336,13.516383590740695,139,2.4E-4
9,test_20231101_140527,11079715.png,443815,84717,359098,0.8091164111172449,3,4,124136,11969,112167,0.9035815557130888,19.73027377777778,2901.3324213333335,13.504828697488506,139,2.4E-4
10,test_20231101_140527,11551286.png,271883,124,271759,0.999543921466219,1,3,40092,16,40076,0.9996009178888556,18.13910577777778,1903.2464906666667,15.335853231830718,139,2.4E-4
1,test_20231101_140528,10404007.png,502730,9509,493221,0.9810852744017664,2,4,61265,1394,59871,0.9772463886395168,27.07272,3817.9584053333333,12.312491681964882,139,2.5E-4
2,test_20231101_140528,1254659.png,342646,48017,294629,0.8598641163182994,3,4,80080,6797,73283,0.9151223776223776,24.664812444444443,4427.052730666666,11.669656659726009,139,2.5E-4
3,test_20231101_140528,10188041.png,221231,6557,214674,0.9703612965633207,2,4,41731,927,40804,0.977786297955956,12.47773511111111,1554.953632,16.21362917773078,139,2.5E-4
4,test_20231101_140528,10287332.png,216980,7449,209531,0.9656696469720711,2,4,22337,1023,21314,0.954201548999418,11.958311111111112,1609.2046613333334,16.064690789594813,139,2.5E-4
5,test_20231101_140528,11610969.png,368720,8677,360043,0.9764672380125841,1,3,84111,1284,82827,0.9847344580375932,38.38211733333333,7011.9524,9.672414016046677,139,2.5E-4
6,test_20231101_140528,10350842.png,212614,3109,209505,0.9853772564365469,1,4,42529,457,42072,0.9892543911213525,22.877592888888888,3259.5520426666667,12.999224414028802,139,2.5E-4
7,test_20231101_140528,10863862.png,317432,4747,312685,0.9850456160689534,2,4,66058,697,65361,0.9894486663235339,40.23792177777778,7793.163312,9.21366583543488,139,2.5E-4
8,test_20231101_140528,11382381.png,312486,427,312059,0.9986335387825375,1,3,46745,59,46686,0.9987378329233073,22.94864,2893.62336,13.516383590740695,139,2.5E-4
9,test_20231101_140528,11079715.png,443815,84717,359098,0.8091164111172449,3,4,124136,11969,112167,0.9035815557130888,19.73027377777778,2901.3324213333335,13.504828697488506,139,2.5E-4
10,test_20231101_140528,11551286.png,271883,124,271759,0.999543921466219,1,3,40092,16,40076,0.9996009178888556,18.13910577777778,1903.2464906666667,15.335853231830718,139,2.5E-4
1,test_20231101_140528,10404007.png,502730,8627,494103,0.9828396952638593,2,4,61265,1265,60000,0.9793519954296906,27.603808,3950.469290666667,12.164316707501147,139,2.6000000000000003E-4
2,test_20231101_140528,1254659.png,342646,47977,294669,0.8599808548764614,2,3,80080,6793,73287,0.9151723276723277,24.672812444444446,4427.7978613333335,11.668925747026284,139,2.6000000000000003E-4
3,test_20231101_140528,10188041.png,221231,6394,214837,0.971098082999218,2,4,41731,904,40827,0.97833744698186,12.804803555555555,1602.202784,16.083628788333066,139,2.6000000000000003E-4
4,test_20231101_140528,10287332.png,216980,7027,209953,0.9676145266844871,1,4,22337,961,21376,0.956977212696423,12.978871111111111,1858.3797813333333,15.439458890558925,139,2.6000000000000003E-4
5,test_20231101_140528,11610969.png,368720,8597,360123,0.9766842048166631,1,4,84111,1272,82839,0.9848771266540642,38.41986311111111,7015.829242666667,9.670013506168356,139,2.6000000000000003E-4
6,test_20231101_140528,10350842.png,212614,3047,209567,0.985668864703171,2,3,42529,448,42081,0.9894660114274966,22.933070222222224,3264.2932053333334,12.992911998365441,139,2.6000000000000003E-4
7,test_20231101_140528,10863862.png,317432,4647,312785,0.9853606441694599,2,3,66058,682,65376,0.9896757395016501,40.51901688888889,7870.480048,9.170791385673855,139,2.6000000000000003E-4
8,test_20231101_140528,11382381.png,312486,327,312159,0.9989535531191798,2,3,46745,44,46701,0.9990587228580596,23.441726222222222,2963.055792,13.413405318888326,139,2.6000000000000003E-4
9,test_20231101_140528,11079715.png,443815,84717,359098,0.8091164111172449,3,4,124136,11969,112167,0.9035815557130888,19.73027377777778,2901.3324213333335,13.504828697488506,139,2.6000000000000003E-4
10,test_20231101_140528,11551286.png,271883,124,271759,0.999543921466219,1,4,40092,16,40076,0.9996009178888556,18.13910577777778,1903.2464906666667,15.335853231830718,139,2.6000000000000003E-4
1,test_20231101_140529,10404007.png,502730,8627,494103,0.9828396952638593,2,4,61265,1265,60000,0.9793519954296906,27.603808,3950.469290666667,12.164316707501147,139,2.7000000000000006E-4
2,test_20231101_140529,1254659.png,342646,47977,294669,0.8599808548764614,2,4,80080,6793,73287,0.9151723276723277,24.672812444444446,4427.7978613333335,11.668925747026284,139,2.7000000000000006E-4
3,test_20231101_140529,10188041.png,221231,6394,214837,0.971098082999218,2,3,41731,904,40827,0.97833744698186,12.804803555555555,1602.202784,16.083628788333066,139,2.7000000000000006E-4
4,test_20231101_140529,10287332.png,216980,7027,209953,0.9676145266844871,2,4,22337,961,21376,0.956977212696423,12.978871111111111,1858.3797813333333,15.439458890558925,139,2.7000000000000006E-4
5,test_20231101_140529,11610969.png,368720,8597,360123,0.9766842048166631,2,3,84111,1272,82839,0.9848771266540642,38.41986311111111,7015.829242666667,9.670013506168356,139,2.7000000000000006E-4
6,test_20231101_140529,10350842.png,212614,3047,209567,0.985668864703171,1,3,42529,448,42081,0.9894660114274966,22.933070222222224,3264.2932053333334,12.992911998365441,139,2.7000000000000006E-4
7,test_20231101_140529,10863862.png,317432,4647,312785,0.9853606441694599,2,3,66058,682,65376,0.9896757395016501,40.51901688888889,7870.480048,9.170791385673855,139,2.7000000000000006E-4
8,test_20231101_140529,11382381.png,312486,327,312159,0.9989535531191798,1,4,46745,44,46701,0.9990587228580596,23.441726222222222,2963.055792,13.413405318888326,139,2.7000000000000006E-4
9,test_20231101_140529,11079715.png,443815,84717,359098,0.8091164111172449,3,4,124136,11969,112167,0.9035815557130888,19.73027377777778,2901.3324213333335,13.504828697488506,139,2.7000000000000006E-4
10,test_20231101_140529,11551286.png,271883,124,271759,0.999543921466219,2,3,40092,16,40076,0.9996009178888556,18.13910577777778,1903.2464906666667,15.335853231830718,139,2.7000000000000006E-4
1,test_20231101_140530,10404007.png,502730,8627,494103,0.9828396952638593,1,3,61265,1265,60000,0.9793519954296906,27.603808,3950.469290666667,12.164316707501147,139,2.800000000000001E-4
2,test_20231101_140530,1254659.png,342646,47977,294669,0.8599808548764614,2,3,80080,6793,73287,0.9151723276723277,24.672812444444446,4427.7978613333335,11.668925747026284,139,2.800000000000001E-4
3,test_20231101_140530,10188041.png,221231,6394,214837,0.971098082999218,1,3,41731,904,40827,0.97833744698186,12.804803555555555,1602.202784,16.083628788333066,139,2.800000000000001E-4
4,test_20231101_140530,10287332.png,216980,7027,209953,0.9676145266844871,6,4,22337,961,21376,0.956977212696423,12.978871111111111,1858.3797813333333,15.439458890558925,139,2.800000000000001E-4
5,test_20231101_140530,11610969.png,368720,8597,360123,0.9766842048166631,2,4,84111,1272,82839,0.9848771266540642,38.41986311111111,7015.829242666667,9.670013506168356,139,2.800000000000001E-4
6,test_20231101_140530,10350842.png,212614,3047,209567,0.985668864703171,2,4,42529,448,42081,0.9894660114274966,22.933070222222224,3264.2932053333334,12.992911998365441,139,2.800000000000001E-4
7,test_20231101_140530,10863862.png,317432,4647,312785,0.9853606441694599,2,4,66058,682,65376,0.9896757395016501,40.51901688888889,7870.480048,9.170791385673855,139,2.800000000000001E-4
8,test_20231101_140530,11382381.png,312486,327,312159,0.9989535531191798,1,3,46745,44,46701,0.9990587228580596,23.441726222222222,2963.055792,13.413405318888326,139,2.800000000000001E-4
9,test_20231101_140530,11079715.png,443815,84717,359098,0.8091164111172449,3,4,124136,11969,112167,0.9035815557130888,19.73027377777778,2901.3324213333335,13.504828697488506,139,2.800000000000001E-4
10,test_20231101_140530,11551286.png,271883,124,271759,0.999543921466219,1,4,40092,16,40076,0.9996009178888556,18.13910577777778,1903.2464906666667,15.335853231830718,139,2.800000000000001E-4
1,test_20231101_140530,10404007.png,502730,8627,494103,0.9828396952638593,2,4,61265,1265,60000,0.9793519954296906,27.603808,3950.469290666667,12.164316707501147,139,2.900000000000001E-4
2,test_20231101_140530,1254659.png,342646,47977,294669,0.8599808548764614,3,4,80080,6793,73287,0.9151723276723277,24.672812444444446,4427.7978613333335,11.668925747026284,139,2.900000000000001E-4
3,test_20231101_140530,10188041.png,221231,6394,214837,0.971098082999218,2,4,41731,904,40827,0.97833744698186,12.804803555555555,1602.202784,16.083628788333066,139,2.900000000000001E-4
4,test_20231101_140530,10287332.png,216980,7027,209953,0.9676145266844871,2,4,22337,961,21376,0.956977212696423,12.978871111111111,1858.3797813333333,15.439458890558925,139,2.900000000000001E-4
5,test_20231101_140530,11610969.png,368720,8597,360123,0.9766842048166631,2,4,84111,1272,82839,0.9848771266540642,38.41986311111111,7015.829242666667,9.670013506168356,139,2.900000000000001E-4
6,test_20231101_140530,10350842.png,212614,3047,209567,0.985668864703171,1,4,42529,448,42081,0.9894660114274966,22.933070222222224,3264.2932053333334,12.992911998365441,139,2.900000000000001E-4
7,test_20231101_140530,10863862.png,317432,4647,312785,0.9853606441694599,1,3,66058,682,65376,0.9896757395016501,40.51901688888889,7870.480048,9.170791385673855,139,2.900000000000001E-4
8,test_20231101_140530,11382381.png,312486,327,312159,0.9989535531191798,1,3,46745,44,46701,0.9990587228580596,23.441726222222222,2963.055792,13.413405318888326,139,2.900000000000001E-4
9,test_20231101_140530,11079715.png,443815,84717,359098,0.8091164111172449,3,4,124136,11969,112167,0.9035815557130888,19.73027377777778,2901.3324213333335,13.504828697488506,139,2.900000000000001E-4
10,test_20231101_140530,11551286.png,271883,124,271759,0.999543921466219,2,4,40092,16,40076,0.9996009178888556,18.13910577777778,1903.2464906666667,15.335853231830718,139,2.900000000000001E-4
1,test_20231101_140531,10404007.png,502730,8627,494103,0.9828396952638593,2,4,61265,1265,60000,0.9793519954296906,27.603808,3950.469290666667,12.164316707501147,139,3.0000000000000014E-4
2,test_20231101_140531,1254659.png,342646,47977,294669,0.8599808548764614,3,4,80080,6793,73287,0.9151723276723277,24.672812444444446,4427.7978613333335,11.668925747026284,139,3.0000000000000014E-4
3,test_20231101_140531,10188041.png,221231,6394,214837,0.971098082999218,2,4,41731,904,40827,0.97833744698186,12.804803555555555,1602.202784,16.083628788333066,139,3.0000000000000014E-4
4,test_20231101_140531,10287332.png,216980,7027,209953,0.9676145266844871,2,3,22337,961,21376,0.956977212696423,12.978871111111111,1858.3797813333333,15.439458890558925,139,3.0000000000000014E-4
5,test_20231101_140531,11610969.png,368720,8597,360123,0.9766842048166631,1,4,84111,1272,82839,0.9848771266540642,38.41986311111111,7015.829242666667,9.670013506168356,139,3.0000000000000014E-4
6,test_20231101_140531,10350842.png,212614,3047,209567,0.985668864703171,2,3,42529,448,42081,0.9894660114274966,22.933070222222224,3264.2932053333334,12.992911998365441,139,3.0000000000000014E-4
7,test_20231101_140531,10863862.png,317432,4647,312785,0.9853606441694599,2,14,66058,682,65376,0.9896757395016501,40.51901688888889,7870.480048,9.170791385673855,139,3.0000000000000014E-4
8,test_20231101_140531,11382381.png,312486,327,312159,0.9989535531191798,1,3,46745,44,46701,0.9990587228580596,23.441726222222222,2963.055792,13.413405318888326,139,3.0000000000000014E-4
9,test_20231101_140531,11079715.png,443815,84717,359098,0.8091164111172449,3,4,124136,11969,112167,0.9035815557130888,19.73027377777778,2901.3324213333335,13.504828697488506,139,3.0000000000000014E-4
10,test_20231101_140531,11551286.png,271883,124,271759,0.999543921466219,1,3,40092,16,40076,0.9996009178888556,18.13910577777778,1903.2464906666667,15.335853231830718,139,3.0000000000000014E-4
1,test_20231101_140532,10404007.png,502730,8627,494103,0.9828396952638593,1,3,61265,1265,60000,0.9793519954296906,27.603808,3950.469290666667,12.164316707501147,139,3.1000000000000016E-4
2,test_20231101_140532,1254659.png,342646,47977,294669,0.8599808548764614,3,4,80080,6793,73287,0.9151723276723277,24.672812444444446,4427.7978613333335,11.668925747026284,139,3.1000000000000016E-4
3,test_20231101_140532,10188041.png,221231,6394,214837,0.971098082999218,2,4,41731,904,40827,0.97833744698186,12.804803555555555,1602.202784,16.083628788333066,139,3.1000000000000016E-4
4,test_20231101_140532,10287332.png,216980,7027,209953,0.9676145266844871,2,14,22337,961,21376,0.956977212696423,12.978871111111111,1858.3797813333333,15.439458890558925,139,3.1000000000000016E-4
5,test_20231101_140532,11610969.png,368720,8597,360123,0.9766842048166631,2,4,84111,1272,82839,0.9848771266540642,38.41986311111111,7015.829242666667,9.670013506168356,139,3.1000000000000016E-4
6,test_20231101_140532,10350842.png,212614,3047,209567,0.985668864703171,2,3,42529,448,42081,0.9894660114274966,22.933070222222224,3264.2932053333334,12.992911998365441,139,3.1000000000000016E-4
7,test_20231101_140532,10863862.png,317432,4647,312785,0.9853606441694599,2,4,66058,682,65376,0.9896757395016501,40.51901688888889,7870.480048,9.170791385673855,139,3.1000000000000016E-4
8,test_20231101_140532,11382381.png,312486,327,312159,0.9989535531191798,2,3,46745,44,46701,0.9990587228580596,23.441726222222222,2963.055792,13.413405318888326,139,3.1000000000000016E-4
9,test_20231101_140532,11079715.png,443815,84717,359098,0.8091164111172449,4,4,124136,11969,112167,0.9035815557130888,19.73027377777778,2901.3324213333335,13.504828697488506,139,3.1000000000000016E-4
10,test_20231101_140532,11551286.png,271883,124,271759,0.999543921466219,2,4,40092,16,40076,0.9996009178888556,18.13910577777778,1903.2464906666667,15.335853231830718,139,3.1000000000000016E-4
1,test_20231101_140532,10404007.png,502730,8627,494103,0.9828396952638593,2,4,61265,1265,60000,0.9793519954296906,27.603808,3950.469290666667,12.164316707501147,139,3.200000000000002E-4
2,test_20231101_140532,1254659.png,342646,47977,294669,0.8599808548764614,2,4,80080,6793,73287,0.9151723276723277,24.672812444444446,4427.7978613333335,11.668925747026284,139,3.200000000000002E-4
3,test_20231101_140532,10188041.png,221231,6394,214837,0.971098082999218,2,4,41731,904,40827,0.97833744698186,12.804803555555555,1602.202784,16.083628788333066,139,3.200000000000002E-4
4,test_20231101_140532,10287332.png,216980,7027,209953,0.9676145266844871,2,4,22337,961,21376,0.956977212696423,12.978871111111111,1858.3797813333333,15.439458890558925,139,3.200000000000002E-4
5,test_20231101_140532,11610969.png,368720,8597,360123,0.9766842048166631,2,4,84111,1272,82839,0.9848771266540642,38.41986311111111,7015.829242666667,9.670013506168356,139,3.200000000000002E-4
6,test_20231101_140532,10350842.png,212614,3047,209567,0.985668864703171,2,4,42529,448,42081,0.9894660114274966,22.933070222222224,3264.2932053333334,12.992911998365441,139,3.200000000000002E-4
7,test_20231101_140532,10863862.png,317432,4427,313005,0.9860537059905744,2,4,66058,649,65409,0.9901753004935057,40.99087822222222,7987.334074666666,9.106785114485769,139,3.200000000000002E-4
8,test_20231101_140532,11382381.png,312486,327,312159,0.9989535531191798,2,3,46745,44,46701,0.9990587228580596,23.441726222222222,2963.055792,13.413405318888326,139,3.200000000000002E-4
9,test_20231101_140532,11079715.png,443815,84717,359098,0.8091164111172449,3,4,124136,11969,112167,0.9035815557130888,19.73027377777778,2901.3324213333335,13.504828697488506,139,3.200000000000002E-4
10,test_20231101_140532,11551286.png,271883,124,271759,0.999543921466219,1,3,40092,16,40076,0.9996009178888556,18.13910577777778,1903.2464906666667,15.335853231830718,139,3.200000000000002E-4
1,test_20231101_140533,10404007.png,502730,8627,494103,0.9828396952638593,2,3,61265,1265,60000,0.9793519954296906,27.603808,3950.469290666667,12.164316707501147,139,3.300000000000002E-4
2,test_20231101_140533,1254659.png,342646,47977,294669,0.8599808548764614,2,4,80080,6793,73287,0.9151723276723277,24.672812444444446,4427.7978613333335,11.668925747026284,139,3.300000000000002E-4
3,test_20231101_140533,10188041.png,221231,6394,214837,0.971098082999218,2,3,41731,904,40827,0.97833744698186,12.804803555555555,1602.202784,16.083628788333066,139,3.300000000000002E-4
4,test_20231101_140533,10287332.png,216980,7027,209953,0.9676145266844871,1,3,22337,961,21376,0.956977212696423,12.978871111111111,1858.3797813333333,15.439458890558925,139,3.300000000000002E-4
5,test_20231101_140533,11610969.png,368720,8597,360123,0.9766842048166631,2,4,84111,1272,82839,0.9848771266540642,38.41986311111111,7015.829242666667,9.670013506168356,139,3.300000000000002E-4
6,test_20231101_140533,10350842.png,212614,3047,209567,0.985668864703171,2,4,42529,448,42081,0.9894660114274966,22.933070222222224,3264.2932053333334,12.992911998365441,139,3.300000000000002E-4
7,test_20231101_140533,10863862.png,317432,4427,313005,0.9860537059905744,2,4,66058,649,65409,0.9901753004935057,40.99087822222222,7987.334074666666,9.106785114485769,139,3.300000000000002E-4
8,test_20231101_140533,11382381.png,312486,327,312159,0.9989535531191798,1,4,46745,44,46701,0.9990587228580596,23.441726222222222,2963.055792,13.413405318888326,139,3.300000000000002E-4
9,test_20231101_140533,11079715.png,443815,84717,359098,0.8091164111172449,3,4,124136,11969,112167,0.9035815557130888,19.73027377777778,2901.3324213333335,13.504828697488506,139,3.300000000000002E-4
10,test_20231101_140533,11551286.png,271883,124,271759,0.999543921466219,1,3,40092,16,40076,0.9996009178888556,18.13910577777778,1903.2464906666667,15.335853231830718,139,3.300000000000002E-4
1,test_20231101_140534,10404007.png,502730,8627,494103,0.9828396952638593,2,4,61265,1265,60000,0.9793519954296906,27.603808,3950.469290666667,12.164316707501147,139,3.4000000000000024E-4
2,test_20231101_140534,1254659.png,342646,47977,294669,0.8599808548764614,3,4,80080,6793,73287,0.9151723276723277,24.672812444444446,4427.7978613333335,11.668925747026284,139,3.4000000000000024E-4
3,test_20231101_140534,10188041.png,221231,6394,214837,0.971098082999218,2,3,41731,904,40827,0.97833744698186,12.804803555555555,1602.202784,16.083628788333066,139,3.4000000000000024E-4
4,test_20231101_140534,10287332.png,216980,7027,209953,0.9676145266844871,2,3,22337,961,21376,0.956977212696423,12.978871111111111,1858.3797813333333,15.439458890558925,139,3.4000000000000024E-4
5,test_20231101_140534,11610969.png,368720,8597,360123,0.9766842048166631,1,3,84111,1272,82839,0.9848771266540642,38.41986311111111,7015.829242666667,9.670013506168356,139,3.4000000000000024E-4
6,test_20231101_140534,10350842.png,212614,3047,209567,0.985668864703171,1,4,42529,448,42081,0.9894660114274966,22.933070222222224,3264.2932053333334,12.992911998365441,139,3.4000000000000024E-4
7,test_20231101_140534,10863862.png,317432,4427,313005,0.9860537059905744,2,3,66058,649,65409,0.9901753004935057,40.99087822222222,7987.334074666666,9.106785114485769,139,3.4000000000000024E-4
8,test_20231101_140534,11382381.png,312486,327,312159,0.9989535531191798,1,3,46745,44,46701,0.9990587228580596,23.441726222222222,2963.055792,13.413405318888326,139,3.4000000000000024E-4
9,test_20231101_140534,11079715.png,443815,84717,359098,0.8091164111172449,3,4,124136,11969,112167,0.9035815557130888,19.73027377777778,2901.3324213333335,13.504828697488506,139,3.4000000000000024E-4
10,test_20231101_140534,11551286.png,271883,124,271759,0.999543921466219,1,3,40092,16,40076,0.9996009178888556,18.13910577777778,1903.2464906666667,15.335853231830718,139,3.4000000000000024E-4
1,test_20231101_140534,10404007.png,502730,8627,494103,0.9828396952638593,1,3,61265,1265,60000,0.9793519954296906,27.603808,3950.469290666667,12.164316707501147,139,3.5000000000000027E-4
2,test_20231101_140534,1254659.png,342646,47977,294669,0.8599808548764614,3,4,80080,6793,73287,0.9151723276723277,24.672812444444446,4427.7978613333335,11.668925747026284,139,3.5000000000000027E-4
3,test_20231101_140534,10188041.png,221231,6394,214837,0.971098082999218,2,4,41731,904,40827,0.97833744698186,12.804803555555555,1602.202784,16.083628788333066,139,3.5000000000000027E-4
4,test_20231101_140534,10287332.png,216980,7027,209953,0.9676145266844871,2,4,22337,961,21376,0.956977212696423,12.978871111111111,1858.3797813333333,15.439458890558925,139,3.5000000000000027E-4
5,test_20231101_140534,11610969.png,368720,8597,360123,0.9766842048166631,1,4,84111,1272,82839,0.9848771266540642,38.41986311111111,7015.829242666667,9.670013506168356,139,3.5000000000000027E-4
6,test_20231101_140534,10350842.png,212614,3047,209567,0.985668864703171,2,3,42529,448,42081,0.9894660114274966,22.933070222222224,3264.2932053333334,12.992911998365441,139,3.5000000000000027E-4
7,test_20231101_140534,10863862.png,317432,4427,313005,0.9860537059905744,1,4,66058,649,65409,0.9901753004935057,40.99087822222222,7987.334074666666,9.106785114485769,139,3.5000000000000027E-4
8,test_20231101_140534,11382381.png,312486,327,312159,0.9989535531191798,2,3,46745,44,46701,0.9990587228580596,23.441726222222222,2963.055792,13.413405318888326,139,3.5000000000000027E-4
9,test_20231101_140534,11079715.png,443815,84717,359098,0.8091164111172449,3,4,124136,11969,112167,0.9035815557130888,19.73027377777778,2901.3324213333335,13.504828697488506,139,3.5000000000000027E-4
10,test_20231101_140534,11551286.png,271883,124,271759,0.999543921466219,1,4,40092,16,40076,0.9996009178888556,18.13910577777778,1903.2464906666667,15.335853231830718,139,3.5000000000000027E-4
1,test_20231101_140535,10404007.png,502730,8627,494103,0.9828396952638593,2,3,61265,1265,60000,0.9793519954296906,27.603808,3950.469290666667,12.164316707501147,139,3.600000000000003E-4
2,test_20231101_140535,1254659.png,342646,47977,294669,0.8599808548764614,3,3,80080,6793,73287,0.9151723276723277,24.672812444444446,4427.7978613333335,11.668925747026284,139,3.600000000000003E-4
3,test_20231101_140535,10188041.png,221231,6394,214837,0.971098082999218,2,4,41731,904,40827,0.97833744698186,12.804803555555555,1602.202784,16.083628788333066,139,3.600000000000003E-4
4,test_20231101_140535,10287332.png,216980,7027,209953,0.9676145266844871,2,3,22337,961,21376,0.956977212696423,12.978871111111111,1858.3797813333333,15.439458890558925,139,3.600000000000003E-4
5,test_20231101_140535,11610969.png,368720,8597,360123,0.9766842048166631,2,4,84111,1272,82839,0.9848771266540642,38.41986311111111,7015.829242666667,9.670013506168356,139,3.600000000000003E-4
6,test_20231101_140535,10350842.png,212614,3047,209567,0.985668864703171,1,4,42529,448,42081,0.9894660114274966,22.933070222222224,3264.2932053333334,12.992911998365441,139,3.600000000000003E-4
7,test_20231101_140535,10863862.png,317432,4427,313005,0.9860537059905744,1,4,66058,649,65409,0.9901753004935057,40.99087822222222,7987.334074666666,9.106785114485769,139,3.600000000000003E-4
8,test_20231101_140535,11382381.png,312486,327,312159,0.9989535531191798,1,4,46745,44,46701,0.9990587228580596,23.441726222222222,2963.055792,13.413405318888326,139,3.600000000000003E-4
9,test_20231101_140535,11079715.png,443815,84717,359098,0.8091164111172449,4,4,124136,11969,112167,0.9035815557130888,19.73027377777778,2901.3324213333335,13.504828697488506,139,3.600000000000003E-4
10,test_20231101_140535,11551286.png,271883,124,271759,0.999543921466219,1,4,40092,16,40076,0.9996009178888556,18.13910577777778,1903.2464906666667,15.335853231830718,139,3.600000000000003E-4
1,test_20231101_140536,10404007.png,502730,8627,494103,0.9828396952638593,2,9,61265,1265,60000,0.9793519954296906,27.603808,3950.469290666667,12.164316707501147,139,3.700000000000003E-4
2,test_20231101_140536,1254659.png,342646,47977,294669,0.8599808548764614,3,4,80080,6793,73287,0.9151723276723277,24.672812444444446,4427.7978613333335,11.668925747026284,139,3.700000000000003E-4
3,test_20231101_140536,10188041.png,221231,6394,214837,0.971098082999218,2,8,41731,904,40827,0.97833744698186,12.804803555555555,1602.202784,16.083628788333066,139,3.700000000000003E-4
4,test_20231101_140536,10287332.png,216980,7027,209953,0.9676145266844871,2,4,22337,961,21376,0.956977212696423,12.978871111111111,1858.3797813333333,15.439458890558925,139,3.700000000000003E-4
5,test_20231101_140536,11610969.png,368720,8597,360123,0.9766842048166631,2,3,84111,1272,82839,0.9848771266540642,38.41986311111111,7015.829242666667,9.670013506168356,139,3.700000000000003E-4
6,test_20231101_140536,10350842.png,212614,3047,209567,0.985668864703171,2,3,42529,448,42081,0.9894660114274966,22.933070222222224,3264.2932053333334,12.992911998365441,139,3.700000000000003E-4
7,test_20231101_140536,10863862.png,317432,4427,313005,0.9860537059905744,2,4,66058,649,65409,0.9901753004935057,40.99087822222222,7987.334074666666,9.106785114485769,139,3.700000000000003E-4
8,test_20231101_140536,11382381.png,312486,327,312159,0.9989535531191798,1,4,46745,44,46701,0.9990587228580596,23.441726222222222,2963.055792,13.413405318888326,139,3.700000000000003E-4
9,test_20231101_140536,11079715.png,443815,84717,359098,0.8091164111172449,3,4,124136,11969,112167,0.9035815557130888,19.73027377777778,2901.3324213333335,13.504828697488506,139,3.700000000000003E-4
10,test_20231101_140536,11551286.png,271883,124,271759,0.999543921466219,2,3,40092,16,40076,0.9996009178888556,18.13910577777778,1903.2464906666667,15.335853231830718,139,3.700000000000003E-4
1,test_20231101_140536,10404007.png,502730,8627,494103,0.9828396952638593,2,3,61265,1265,60000,0.9793519954296906,27.603808,3950.469290666667,12.164316707501147,139,3.8000000000000035E-4
2,test_20231101_140536,1254659.png,342646,47977,294669,0.8599808548764614,3,4,80080,6793,73287,0.9151723276723277,24.672812444444446,4427.7978613333335,11.668925747026284,139,3.8000000000000035E-4
3,test_20231101_140536,10188041.png,221231,6394,214837,0.971098082999218,2,3,41731,904,40827,0.97833744698186,12.804803555555555,1602.202784,16.083628788333066,139,3.8000000000000035E-4
4,test_20231101_140536,10287332.png,216980,7027,209953,0.9676145266844871,2,3,22337,961,21376,0.956977212696423,12.978871111111111,1858.3797813333333,15.439458890558925,139,3.8000000000000035E-4
5,test_20231101_140536,11610969.png,368720,8597,360123,0.9766842048166631,2,4,84111,1272,82839,0.9848771266540642,38.41986311111111,7015.829242666667,9.670013506168356,139,3.8000000000000035E-4
6,test_20231101_140536,10350842.png,212614,3047,209567,0.985668864703171,1,4,42529,448,42081,0.9894660114274966,22.933070222222224,3264.2932053333334,12.992911998365441,139,3.8000000000000035E-4
7,test_20231101_140536,10863862.png,317432,4427,313005,0.9860537059905744,1,5,66058,649,65409,0.9901753004935057,40.99087822222222,7987.334074666666,9.106785114485769,139,3.8000000000000035E-4
8,test_20231101_140536,11382381.png,312486,327,312159,0.9989535531191798,1,4,46745,44,46701,0.9990587228580596,23.441726222222222,2963.055792,13.413405318888326,139,3.8000000000000035E-4
9,test_20231101_140536,11079715.png,443815,84717,359098,0.8091164111172449,3,4,124136,11969,112167,0.9035815557130888,19.73027377777778,2901.3324213333335,13.504828697488506,139,3.8000000000000035E-4
10,test_20231101_140536,11551286.png,271883,124,271759,0.999543921466219,1,3,40092,16,40076,0.9996009178888556,18.13910577777778,1903.2464906666667,15.335853231830718,139,3.8000000000000035E-4
1,test_20231101_140537,10404007.png,502730,8627,494103,0.9828396952638593,1,4,61265,1265,60000,0.9793519954296906,27.603808,3950.469290666667,12.164316707501147,139,3.9000000000000037E-4
2,test_20231101_140537,1254659.png,342646,47977,294669,0.8599808548764614,3,3,80080,6793,73287,0.9151723276723277,24.672812444444446,4427.7978613333335,11.668925747026284,139,3.9000000000000037E-4
3,test_20231101_140537,10188041.png,221231,6394,214837,0.971098082999218,1,3,41731,904,40827,0.97833744698186,12.804803555555555,1602.202784,16.083628788333066,139,3.9000000000000037E-4
4,test_20231101_140537,10287332.png,216980,7027,209953,0.9676145266844871,2,4,22337,961,21376,0.956977212696423,12.978871111111111,1858.3797813333333,15.439458890558925,139,3.9000000000000037E-4
5,test_20231101_140537,11610969.png,368720,8597,360123,0.9766842048166631,2,3,84111,1272,82839,0.9848771266540642,38.41986311111111,7015.829242666667,9.670013506168356,139,3.9000000000000037E-4
6,test_20231101_140537,10350842.png,212614,3047,209567,0.985668864703171,2,4,42529,448,42081,0.9894660114274966,22.933070222222224,3264.2932053333334,12.992911998365441,139,3.9000000000000037E-4
7,test_20231101_140537,10863862.png,317432,4427,313005,0.9860537059905744,1,4,66058,649,65409,0.9901753004935057,40.99087822222222,7987.334074666666,9.106785114485769,139,3.9000000000000037E-4
8,test_20231101_140537,11382381.png,312486,327,312159,0.9989535531191798,1,3,46745,44,46701,0.9990587228580596,23.441726222222222,2963.055792,13.413405318888326,139,3.9000000000000037E-4
9,test_20231101_140537,11079715.png,443815,84717,359098,0.8091164111172449,3,8,124136,11969,112167,0.9035815557130888,19.73027377777778,2901.3324213333335,13.504828697488506,139,3.9000000000000037E-4
10,test_20231101_140537,11551286.png,271883,124,271759,0.999543921466219,2,3,40092,16,40076,0.9996009178888556,18.13910577777778,1903.2464906666667,15.335853231830718,139,3.9000000000000037E-4
1,test_20231101_140538,10404007.png,502730,8627,494103,0.9828396952638593,1,3,61265,1265,60000,0.9793519954296906,27.603808,3950.469290666667,12.164316707501147,139,4.000000000000004E-4
2,test_20231101_140538,1254659.png,342646,47977,294669,0.8599808548764614,3,4,80080,6793,73287,0.9151723276723277,24.672812444444446,4427.7978613333335,11.668925747026284,139,4.000000000000004E-4
3,test_20231101_140538,10188041.png,221231,6394,214837,0.971098082999218,2,4,41731,904,40827,0.97833744698186,12.804803555555555,1602.202784,16.083628788333066,139,4.000000000000004E-4
4,test_20231101_140538,10287332.png,216980,7027,209953,0.9676145266844871,2,4,22337,961,21376,0.956977212696423,12.978871111111111,1858.3797813333333,15.439458890558925,139,4.000000000000004E-4
5,test_20231101_140538,11610969.png,368720,8597,360123,0.9766842048166631,4,4,84111,1272,82839,0.9848771266540642,38.41986311111111,7015.829242666667,9.670013506168356,139,4.000000000000004E-4
6,test_20231101_140538,10350842.png,212614,3047,209567,0.985668864703171,1,3,42529,448,42081,0.9894660114274966,22.933070222222224,3264.2932053333334,12.992911998365441,139,4.000000000000004E-4
7,test_20231101_140538,10863862.png,317432,4427,313005,0.9860537059905744,2,4,66058,649,65409,0.9901753004935057,40.99087822222222,7987.334074666666,9.106785114485769,139,4.000000000000004E-4
8,test_20231101_140538,11382381.png,312486,327,312159,0.9989535531191798,1,4,46745,44,46701,0.9990587228580596,23.441726222222222,2963.055792,13.413405318888326,139,4.000000000000004E-4
9,test_20231101_140538,11079715.png,443815,84717,359098,0.8091164111172449,3,4,124136,11969,112167,0.9035815557130888,19.73027377777778,2901.3324213333335,13.504828697488506,139,4.000000000000004E-4
10,test_20231101_140538,11551286.png,271883,124,271759,0.999543921466219,2,4,40092,16,40076,0.9996009178888556,18.13910577777778,1903.2464906666667,15.335853231830718,139,4.000000000000004E-4
1,test_20231101_140538,10404007.png,502730,8627,494103,0.9828396952638593,2,3,61265,1265,60000,0.9793519954296906,27.603808,3950.469290666667,12.164316707501147,139,4.100000000000004E-4
2,test_20231101_140538,1254659.png,342646,47977,294669,0.8599808548764614,3,4,80080,6793,73287,0.9151723276723277,24.672812444444446,4427.7978613333335,11.668925747026284,139,4.100000000000004E-4
3,test_20231101_140538,10188041.png,221231,6394,214837,0.971098082999218,2,3,41731,904,40827,0.97833744698186,12.804803555555555,1602.202784,16.083628788333066,139,4.100000000000004E-4
4,test_20231101_140538,10287332.png,216980,7027,209953,0.9676145266844871,2,4,22337,961,21376,0.956977212696423,12.978871111111111,1858.3797813333333,15.439458890558925,139,4.100000000000004E-4
5,test_20231101_140538,11610969.png,368720,8597,360123,0.9766842048166631,1,3,84111,1272,82839,0.9848771266540642,38.41986311111111,7015.829242666667,9.670013506168356,139,4.100000000000004E-4
6,test_20231101_140538,10350842.png,212614,3047,209567,0.985668864703171,2,4,42529,448,42081,0.9894660114274966,22.933070222222224,3264.2932053333334,12.992911998365441,139,4.100000000000004E-4
7,test_20231101_140538,10863862.png,317432,4427,313005,0.9860537059905744,2,4,66058,649,65409,0.9901753004935057,40.99087822222222,7987.334074666666,9.106785114485769,139,4.100000000000004E-4
8,test_20231101_140538,11382381.png,312486,327,312159,0.9989535531191798,1,4,46745,44,46701,0.9990587228580596,23.441726222222222,2963.055792,13.413405318888326,139,4.100000000000004E-4
9,test_20231101_140538,11079715.png,443815,84717,359098,0.8091164111172449,3,8,124136,11969,112167,0.9035815557130888,19.73027377777778,2901.3324213333335,13.504828697488506,139,4.100000000000004E-4
10,test_20231101_140538,11551286.png,271883,124,271759,0.999543921466219,1,4,40092,16,40076,0.9996009178888556,18.13910577777778,1903.2464906666667,15.335853231830718,139,4.100000000000004E-4
1,test_20231101_140539,10404007.png,502730,8627,494103,0.9828396952638593,2,4,61265,1265,60000,0.9793519954296906,27.603808,3950.469290666667,12.164316707501147,139,4.2000000000000045E-4
2,test_20231101_140539,1254659.png,342646,47977,294669,0.8599808548764614,3,4,80080,6793,73287,0.9151723276723277,24.672812444444446,4427.7978613333335,11.668925747026284,139,4.2000000000000045E-4
3,test_20231101_140539,10188041.png,221231,6394,214837,0.971098082999218,2,4,41731,904,40827,0.97833744698186,12.804803555555555,1602.202784,16.083628788333066,139,4.2000000000000045E-4
4,test_20231101_140539,10287332.png,216980,7027,209953,0.9676145266844871,1,4,22337,961,21376,0.956977212696423,12.978871111111111,1858.3797813333333,15.439458890558925,139,4.2000000000000045E-4
5,test_20231101_140539,11610969.png,368720,8597,360123,0.9766842048166631,2,4,84111,1272,82839,0.9848771266540642,38.41986311111111,7015.829242666667,9.670013506168356,139,4.2000000000000045E-4
6,test_20231101_140539,10350842.png,212614,3047,209567,0.985668864703171,1,3,42529,448,42081,0.9894660114274966,22.933070222222224,3264.2932053333334,12.992911998365441,139,4.2000000000000045E-4
7,test_20231101_140539,10863862.png,317432,4427,313005,0.9860537059905744,1,3,66058,649,65409,0.9901753004935057,40.99087822222222,7987.334074666666,9.106785114485769,139,4.2000000000000045E-4
8,test_20231101_140539,11382381.png,312486,327,312159,0.9989535531191798,1,3,46745,44,46701,0.9990587228580596,23.441726222222222,2963.055792,13.413405318888326,139,4.2000000000000045E-4
9,test_20231101_140539,11079715.png,443815,84717,359098,0.8091164111172449,3,4,124136,11969,112167,0.9035815557130888,19.73027377777778,2901.3324213333335,13.504828697488506,139,4.2000000000000045E-4
10,test_20231101_140539,11551286.png,271883,124,271759,0.999543921466219,1,4,40092,16,40076,0.9996009178888556,18.13910577777778,1903.2464906666667,15.335853231830718,139,4.2000000000000045E-4
1,test_20231101_140540,10404007.png,502730,8627,494103,0.9828396952638593,2,4,61265,1265,60000,0.9793519954296906,27.603808,3950.469290666667,12.164316707501147,139,4.300000000000005E-4
2,test_20231101_140540,1254659.png,342646,47977,294669,0.8599808548764614,2,4,80080,6793,73287,0.9151723276723277,24.672812444444446,4427.7978613333335,11.668925747026284,139,4.300000000000005E-4
3,test_20231101_140540,10188041.png,221231,6394,214837,0.971098082999218,1,3,41731,904,40827,0.97833744698186,12.804803555555555,1602.202784,16.083628788333066,139,4.300000000000005E-4
4,test_20231101_140540,10287332.png,216980,7027,209953,0.9676145266844871,1,3,22337,961,21376,0.956977212696423,12.978871111111111,1858.3797813333333,15.439458890558925,139,4.300000000000005E-4
5,test_20231101_140540,11610969.png,368720,8597,360123,0.9766842048166631,1,4,84111,1272,82839,0.9848771266540642,38.41986311111111,7015.829242666667,9.670013506168356,139,4.300000000000005E-4
6,test_20231101_140540,10350842.png,212614,3047,209567,0.985668864703171,2,4,42529,448,42081,0.9894660114274966,22.933070222222224,3264.2932053333334,12.992911998365441,139,4.300000000000005E-4
7,test_20231101_140540,10863862.png,317432,4427,313005,0.9860537059905744,1,4,66058,649,65409,0.9901753004935057,40.99087822222222,7987.334074666666,9.106785114485769,139,4.300000000000005E-4
8,test_20231101_140540,11382381.png,312486,327,312159,0.9989535531191798,2,3,46745,44,46701,0.9990587228580596,23.441726222222222,2963.055792,13.413405318888326,139,4.300000000000005E-4
9,test_20231101_140540,11079715.png,443815,84717,359098,0.8091164111172449,3,4,124136,11969,112167,0.9035815557130888,19.73027377777778,2901.3324213333335,13.504828697488506,139,4.300000000000005E-4
10,test_20231101_140540,11551286.png,271883,124,271759,0.999543921466219,2,4,40092,16,40076,0.9996009178888556,18.13910577777778,1903.2464906666667,15.335853231830718,139,4.300000000000005E-4
1,test_20231101_140540,10404007.png,502730,8627,494103,0.9828396952638593,2,4,61265,1265,60000,0.9793519954296906,27.603808,3950.469290666667,12.164316707501147,139,4.400000000000005E-4
2,test_20231101_140540,1254659.png,342646,47977,294669,0.8599808548764614,3,4,80080,6793,73287,0.9151723276723277,24.672812444444446,4427.7978613333335,11.668925747026284,139,4.400000000000005E-4
3,test_20231101_140540,10188041.png,221231,6394,214837,0.971098082999218,2,3,41731,904,40827,0.97833744698186,12.804803555555555,1602.202784,16.083628788333066,139,4.400000000000005E-4
4,test_20231101_140540,10287332.png,216980,7027,209953,0.9676145266844871,1,3,22337,961,21376,0.956977212696423,12.978871111111111,1858.3797813333333,15.439458890558925,139,4.400000000000005E-4
5,test_20231101_140540,11610969.png,368720,8597,360123,0.9766842048166631,2,4,84111,1272,82839,0.9848771266540642,38.41986311111111,7015.829242666667,9.670013506168356,139,4.400000000000005E-4
6,test_20231101_140540,10350842.png,212614,3047,209567,0.985668864703171,1,4,42529,448,42081,0.9894660114274966,22.933070222222224,3264.2932053333334,12.992911998365441,139,4.400000000000005E-4
7,test_20231101_140540,10863862.png,317432,4427,313005,0.9860537059905744,2,4,66058,649,65409,0.9901753004935057,40.99087822222222,7987.334074666666,9.106785114485769,139,4.400000000000005E-4
8,test_20231101_140540,11382381.png,312486,327,312159,0.9989535531191798,1,3,46745,44,46701,0.9990587228580596,23.441726222222222,2963.055792,13.413405318888326,139,4.400000000000005E-4
9,test_20231101_140540,11079715.png,443815,84717,359098,0.8091164111172449,3,4,124136,11969,112167,0.9035815557130888,19.73027377777778,2901.3324213333335,13.504828697488506,139,4.400000000000005E-4
10,test_20231101_140540,11551286.png,271883,124,271759,0.999543921466219,1,4,40092,16,40076,0.9996009178888556,18.13910577777778,1903.2464906666667,15.335853231830718,139,4.400000000000005E-4
1,test_20231101_140541,10404007.png,502730,8627,494103,0.9828396952638593,2,3,61265,1265,60000,0.9793519954296906,27.603808,3950.469290666667,12.164316707501147,139,4.5000000000000053E-4
2,test_20231101_140541,1254659.png,342646,47977,294669,0.8599808548764614,2,3,80080,6793,73287,0.9151723276723277,24.672812444444446,4427.7978613333335,11.668925747026284,139,4.5000000000000053E-4
3,test_20231101_140541,10188041.png,221231,6394,214837,0.971098082999218,2,3,41731,904,40827,0.97833744698186,12.804803555555555,1602.202784,16.083628788333066,139,4.5000000000000053E-4
4,test_20231101_140541,10287332.png,216980,7027,209953,0.9676145266844871,1,4,22337,961,21376,0.956977212696423,12.978871111111111,1858.3797813333333,15.439458890558925,139,4.5000000000000053E-4
5,test_20231101_140541,11610969.png,368720,8597,360123,0.9766842048166631,2,3,84111,1272,82839,0.9848771266540642,38.41986311111111,7015.829242666667,9.670013506168356,139,4.5000000000000053E-4
6,test_20231101_140541,10350842.png,212614,2387,210227,0.9887730817349751,1,4,42529,350,42179,0.9917703214277317,25.66050311111111,3923.685029333333,12.193862234017685,139,4.5000000000000053E-4
7,test_20231101_140541,10863862.png,317432,4427,313005,0.9860537059905744,1,4,66058,649,65409,0.9901753004935057,40.99087822222222,7987.334074666666,9.106785114485769,139,4.5000000000000053E-4
8,test_20231101_140541,11382381.png,312486,327,312159,0.9989535531191798,1,4,46745,44,46701,0.9990587228580596,23.441726222222222,2963.055792,13.413405318888326,139,4.5000000000000053E-4
9,test_20231101_140541,11079715.png,443815,84717,359098,0.8091164111172449,3,4,124136,11969,112167,0.9035815557130888,19.73027377777778,2901.3324213333335,13.504828697488506,139,4.5000000000000053E-4
10,test_20231101_140541,11551286.png,271883,124,271759,0.999543921466219,1,3,40092,16,40076,0.9996009178888556,18.13910577777778,1903.2464906666667,15.335853231830718,139,4.5000000000000053E-4
1,test_20231101_140542,10404007.png,502730,8627,494103,0.9828396952638593,2,4,61265,1265,60000,0.9793519954296906,27.603808,3950.469290666667,12.164316707501147,139,4.6000000000000056E-4
2,test_20231101_140542,1254659.png,342646,47977,294669,0.8599808548764614,2,4,80080,6793,73287,0.9151723276723277,24.672812444444446,4427.7978613333335,11.668925747026284,139,4.6000000000000056E-4
3,test_20231101_140542,10188041.png,221231,6394,214837,0.971098082999218,2,4,41731,904,40827,0.97833744698186,12.804803555555555,1602.202784,16.083628788333066,139,4.6000000000000056E-4
4,test_20231101_140542,10287332.png,216980,7027,209953,0.9676145266844871,2,4,22337,961,21376,0.956977212696423,12.978871111111111,1858.3797813333333,15.439458890558925,139,4.6000000000000056E-4
5,test_20231101_140542,11610969.png,368720,8597,360123,0.9766842048166631,1,3,84111,1272,82839,0.9848771266540642,38.41986311111111,7015.829242666667,9.670013506168356,139,4.6000000000000056E-4
6,test_20231101_140542,10350842.png,212614,2387,210227,0.9887730817349751,1,4,42529,350,42179,0.9917703214277317,25.66050311111111,3923.685029333333,12.193862234017685,139,4.6000000000000056E-4
7,test_20231101_140542,10863862.png,317432,4427,313005,0.9860537059905744,1,3,66058,649,65409,0.9901753004935057,40.99087822222222,7987.334074666666,9.106785114485769,139,4.6000000000000056E-4
8,test_20231101_140542,11382381.png,312486,327,312159,0.9989535531191798,1,4,46745,44,46701,0.9990587228580596,23.441726222222222,2963.055792,13.413405318888326,139,4.6000000000000056E-4
9,test_20231101_140542,11079715.png,443815,84717,359098,0.8091164111172449,3,4,124136,11969,112167,0.9035815557130888,19.73027377777778,2901.3324213333335,13.504828697488506,139,4.6000000000000056E-4
10,test_20231101_140542,11551286.png,271883,24,271859,0.9999117267353972,0,3,40092,1,40091,0.9999750573680535,24.866876444444443,3470.407338666667,12.72699907819776,139,4.6000000000000056E-4
1,test_20231101_140542,10404007.png,502730,8627,494103,0.9828396952638593,2,4,61265,1265,60000,0.9793519954296906,27.603808,3950.469290666667,12.164316707501147,139,4.700000000000006E-4
2,test_20231101_140542,1254659.png,342646,47977,294669,0.8599808548764614,3,4,80080,6793,73287,0.9151723276723277,24.672812444444446,4427.7978613333335,11.668925747026284,139,4.700000000000006E-4
3,test_20231101_140542,10188041.png,221231,6394,214837,0.971098082999218,2,4,41731,904,40827,0.97833744698186,12.804803555555555,1602.202784,16.083628788333066,139,4.700000000000006E-4
4,test_20231101_140542,10287332.png,216980,7027,209953,0.9676145266844871,2,4,22337,961,21376,0.956977212696423,12.978871111111111,1858.3797813333333,15.439458890558925,139,4.700000000000006E-4
5,test_20231101_140542,11610969.png,368720,8597,360123,0.9766842048166631,1,4,84111,1272,82839,0.9848771266540642,38.41986311111111,7015.829242666667,9.670013506168356,139,4.700000000000006E-4
6,test_20231101_140542,10350842.png,212614,2387,210227,0.9887730817349751,1,4,42529,350,42179,0.9917703214277317,25.66050311111111,3923.685029333333,12.193862234017685,139,4.700000000000006E-4
7,test_20231101_140542,10863862.png,317432,4427,313005,0.9860537059905744,1,4,66058,649,65409,0.9901753004935057,40.99087822222222,7987.334074666666,9.106785114485769,139,4.700000000000006E-4
8,test_20231101_140542,11382381.png,312486,327,312159,0.9989535531191798,1,5,46745,44,46701,0.9990587228580596,23.441726222222222,2963.055792,13.413405318888326,139,4.700000000000006E-4
9,test_20231101_140542,11079715.png,443815,84717,359098,0.8091164111172449,3,4,124136,11969,112167,0.9035815557130888,19.73027377777778,2901.3324213333335,13.504828697488506,139,4.700000000000006E-4
10,test_20231101_140542,11551286.png,271883,24,271859,0.9999117267353972,1,4,40092,1,40091,0.9999750573680535,24.866876444444443,3470.407338666667,12.72699907819776,139,4.700000000000006E-4
1,test_20231101_140543,10404007.png,502730,8627,494103,0.9828396952638593,1,3,61265,1265,60000,0.9793519954296906,27.603808,3950.469290666667,12.164316707501147,139,4.800000000000006E-4
2,test_20231101_140543,1254659.png,342646,47977,294669,0.8599808548764614,4,3,80080,6793,73287,0.9151723276723277,24.672812444444446,4427.7978613333335,11.668925747026284,139,4.800000000000006E-4
3,test_20231101_140543,10188041.png,221231,6394,214837,0.971098082999218,2,4,41731,904,40827,0.97833744698186,12.804803555555555,1602.202784,16.083628788333066,139,4.800000000000006E-4
4,test_20231101_140543,10287332.png,216980,7027,209953,0.9676145266844871,1,3,22337,961,21376,0.956977212696423,12.978871111111111,1858.3797813333333,15.439458890558925,139,4.800000000000006E-4
5,test_20231101_140543,11610969.png,368720,8597,360123,0.9766842048166631,2,4,84111,1272,82839,0.9848771266540642,38.41986311111111,7015.829242666667,9.670013506168356,139,4.800000000000006E-4
6,test_20231101_140543,10350842.png,212614,2387,210227,0.9887730817349751,2,3,42529,350,42179,0.9917703214277317,25.66050311111111,3923.685029333333,12.193862234017685,139,4.800000000000006E-4
7,test_20231101_140543,10863862.png,317432,4427,313005,0.9860537059905744,1,4,66058,649,65409,0.9901753004935057,40.99087822222222,7987.334074666666,9.106785114485769,139,4.800000000000006E-4
8,test_20231101_140543,11382381.png,312486,327,312159,0.9989535531191798,1,3,46745,44,46701,0.9990587228580596,23.441726222222222,2963.055792,13.413405318888326,139,4.800000000000006E-4
9,test_20231101_140543,11079715.png,443815,84717,359098,0.8091164111172449,3,4,124136,11969,112167,0.9035815557130888,19.73027377777778,2901.3324213333335,13.504828697488506,139,4.800000000000006E-4
10,test_20231101_140543,11551286.png,271883,24,271859,0.9999117267353972,1,3,40092,1,40091,0.9999750573680535,24.866876444444443,3470.407338666667,12.72699907819776,139,4.800000000000006E-4
1,test_20231101_140544,10404007.png,502730,8627,494103,0.9828396952638593,3,3,61265,1265,60000,0.9793519954296906,27.603808,3950.469290666667,12.164316707501147,139,4.900000000000006E-4
2,test_20231101_140544,1254659.png,342646,47977,294669,0.8599808548764614,3,4,80080,6793,73287,0.9151723276723277,24.672812444444446,4427.7978613333335,11.668925747026284,139,4.900000000000006E-4
3,test_20231101_140544,10188041.png,221231,6394,214837,0.971098082999218,2,4,41731,904,40827,0.97833744698186,12.804803555555555,1602.202784,16.083628788333066,139,4.900000000000006E-4
4,test_20231101_140544,10287332.png,216980,7027,209953,0.9676145266844871,1,4,22337,961,21376,0.956977212696423,12.978871111111111,1858.3797813333333,15.439458890558925,139,4.900000000000006E-4
5,test_20231101_140544,11610969.png,368720,8597,360123,0.9766842048166631,1,3,84111,1272,82839,0.9848771266540642,38.41986311111111,7015.829242666667,9.670013506168356,139,4.900000000000006E-4
6,test_20231101_140544,10350842.png,212614,2387,210227,0.9887730817349751,1,3,42529,350,42179,0.9917703214277317,25.66050311111111,3923.685029333333,12.193862234017685,139,4.900000000000006E-4
7,test_20231101_140544,10863862.png,317432,4427,313005,0.9860537059905744,1,3,66058,649,65409,0.9901753004935057,40.99087822222222,7987.334074666666,9.106785114485769,139,4.900000000000006E-4
8,test_20231101_140544,11382381.png,312486,327,312159,0.9989535531191798,1,4,46745,44,46701,0.9990587228580596,23.441726222222222,2963.055792,13.413405318888326,139,4.900000000000006E-4
9,test_20231101_140544,11079715.png,443815,84717,359098,0.8091164111172449,4,4,124136,11969,112167,0.9035815557130888,19.73027377777778,2901.3324213333335,13.504828697488506,139,4.900000000000006E-4
10,test_20231101_140544,11551286.png,271883,24,271859,0.9999117267353972,1,3,40092,1,40091,0.9999750573680535,24.866876444444443,3470.407338666667,12.72699907819776,139,4.900000000000006E-4
1,test_20231101_140545,10404007.png,502730,8627,494103,0.9828396952638593,3,4,61265,1265,60000,0.9793519954296906,27.603808,3950.469290666667,12.164316707501147,139,5.000000000000007E-4
2,test_20231101_140545,1254659.png,342646,47977,294669,0.8599808548764614,3,4,80080,6793,73287,0.9151723276723277,24.672812444444446,4427.7978613333335,11.668925747026284,139,5.000000000000007E-4
3,test_20231101_140545,10188041.png,221231,6394,214837,0.971098082999218,2,5,41731,904,40827,0.97833744698186,12.804803555555555,1602.202784,16.083628788333066,139,5.000000000000007E-4
4,test_20231101_140545,10287332.png,216980,7027,209953,0.9676145266844871,2,4,22337,961,21376,0.956977212696423,12.978871111111111,1858.3797813333333,15.439458890558925,139,5.000000000000007E-4
5,test_20231101_140545,11610969.png,368720,8597,360123,0.9766842048166631,1,3,84111,1272,82839,0.9848771266540642,38.41986311111111,7015.829242666667,9.670013506168356,139,5.000000000000007E-4
6,test_20231101_140545,10350842.png,212614,2387,210227,0.9887730817349751,2,4,42529,350,42179,0.9917703214277317,25.66050311111111,3923.685029333333,12.193862234017685,139,5.000000000000007E-4
7,test_20231101_140545,10863862.png,317432,4427,313005,0.9860537059905744,1,4,66058,649,65409,0.9901753004935057,40.99087822222222,7987.334074666666,9.106785114485769,139,5.000000000000007E-4
8,test_20231101_140545,11382381.png,312486,327,312159,0.9989535531191798,2,4,46745,44,46701,0.9990587228580596,23.441726222222222,2963.055792,13.413405318888326,139,5.000000000000007E-4
9,test_20231101_140545,11079715.png,443815,84717,359098,0.8091164111172449,3,4,124136,11969,112167,0.9035815557130888,19.73027377777778,2901.3324213333335,13.504828697488506,139,5.000000000000007E-4
10,test_20231101_140545,11551286.png,271883,24,271859,0.9999117267353972,0,3,40092,1,40091,0.9999750573680535,24.866876444444443,3470.407338666667,12.72699907819776,139,5.000000000000007E-4
1,test_20231101_140545,10404007.png,502730,8464,494266,0.9831639249696656,2,3,61265,1241,60024,0.9797437362278626,27.621063111111113,3955.2525333333333,12.159061434939156,139,5.100000000000007E-4
2,test_20231101_140545,1254659.png,342646,47977,294669,0.8599808548764614,3,4,80080,6793,73287,0.9151723276723277,24.672812444444446,4427.7978613333335,11.668925747026284,139,5.100000000000007E-4
3,test_20231101_140545,10188041.png,221231,6394,214837,0.971098082999218,2,3,41731,904,40827,0.97833744698186,12.804803555555555,1602.202784,16.083628788333066,139,5.100000000000007E-4
4,test_20231101_140545,10287332.png,216980,7027,209953,0.9676145266844871,1,4,22337,961,21376,0.956977212696423,12.978871111111111,1858.3797813333333,15.439458890558925,139,5.100000000000007E-4
5,test_20231101_140545,11610969.png,368720,8597,360123,0.9766842048166631,2,4,84111,1272,82839,0.9848771266540642,38.41986311111111,7015.829242666667,9.670013506168356,139,5.100000000000007E-4
6,test_20231101_140545,10350842.png,212614,2387,210227,0.9887730817349751,2,4,42529,350,42179,0.9917703214277317,25.66050311111111,3923.685029333333,12.193862234017685,139,5.100000000000007E-4
7,test_20231101_140545,10863862.png,317432,4427,313005,0.9860537059905744,1,3,66058,649,65409,0.9901753004935057,40.99087822222222,7987.334074666666,9.106785114485769,139,5.100000000000007E-4
8,test_20231101_140545,11382381.png,312486,327,312159,0.9989535531191798,1,4,46745,44,46701,0.9990587228580596,23.441726222222222,2963.055792,13.413405318888326,139,5.100000000000007E-4
9,test_20231101_140545,11079715.png,443815,84554,359261,0.8094836812635895,3,4,124136,11945,112191,0.9037748920538764,19.967164444444446,2943.194826666667,13.44261349415353,139,5.100000000000007E-4
10,test_20231101_140545,11551286.png,271883,24,271859,0.9999117267353972,1,3,40092,1,40091,0.9999750573680535,24.866876444444443,3470.407338666667,12.72699907819776,139,5.100000000000007E-4
1,test_20231101_140546,10404007.png,502730,8464,494266,0.9831639249696656,1,3,61265,1241,60024,0.9797437362278626,27.621063111111113,3955.2525333333333,12.159061434939156,139,5.200000000000007E-4
2,test_20231101_140546,1254659.png,342646,47977,294669,0.8599808548764614,3,4,80080,6793,73287,0.9151723276723277,24.672812444444446,4427.7978613333335,11.668925747026284,139,5.200000000000007E-4
3,test_20231101_140546,10188041.png,221231,6394,214837,0.971098082999218,2,4,41731,904,40827,0.97833744698186,12.804803555555555,1602.202784,16.083628788333066,139,5.200000000000007E-4
4,test_20231101_140546,10287332.png,216980,7027,209953,0.9676145266844871,1,3,22337,961,21376,0.956977212696423,12.978871111111111,1858.3797813333333,15.439458890558925,139,5.200000000000007E-4
5,test_20231101_140546,11610969.png,368720,8597,360123,0.9766842048166631,2,4,84111,1272,82839,0.9848771266540642,38.41986311111111,7015.829242666667,9.670013506168356,139,5.200000000000007E-4
6,test_20231101_140546,10350842.png,212614,2387,210227,0.9887730817349751,2,4,42529,350,42179,0.9917703214277317,25.66050311111111,3923.685029333333,12.193862234017685,139,5.200000000000007E-4
7,test_20231101_140546,10863862.png,317432,4062,313370,0.9872035585574234,2,3,66058,597,65461,0.9909624875109752,43.631761777777776,8773.53984,8.699055083450858,139,5.200000000000007E-4
8,test_20231101_140546,11382381.png,312486,327,312159,0.9989535531191798,2,4,46745,44,46701,0.9990587228580596,23.441726222222222,2963.055792,13.413405318888326,139,5.200000000000007E-4
9,test_20231101_140546,11079715.png,443815,84554,359261,0.8094836812635895,3,4,124136,11945,112191,0.9037748920538764,19.967164444444446,2943.194826666667,13.44261349415353,139,5.200000000000007E-4
10,test_20231101_140546,11551286.png,271883,24,271859,0.9999117267353972,0,3,40092,1,40091,0.9999750573680535,24.866876444444443,3470.407338666667,12.72699907819776,139,5.200000000000007E-4
1,test_20231101_140547,10404007.png,502730,8464,494266,0.9831639249696656,2,4,61265,1241,60024,0.9797437362278626,27.621063111111113,3955.2525333333333,12.159061434939156,139,5.300000000000007E-4
2,test_20231101_140547,1254659.png,342646,47977,294669,0.8599808548764614,2,3,80080,6793,73287,0.9151723276723277,24.672812444444446,4427.7978613333335,11.668925747026284,139,5.300000000000007E-4
3,test_20231101_140547,10188041.png,221231,6394,214837,0.971098082999218,2,3,41731,904,40827,0.97833744698186,12.804803555555555,1602.202784,16.083628788333066,139,5.300000000000007E-4
4,test_20231101_140547,10287332.png,216980,7027,209953,0.9676145266844871,1,3,22337,961,21376,0.956977212696423,12.978871111111111,1858.3797813333333,15.439458890558925,139,5.300000000000007E-4
5,test_20231101_140547,11610969.png,368720,8597,360123,0.9766842048166631,2,4,84111,1272,82839,0.9848771266540642,38.41986311111111,7015.829242666667,9.670013506168356,139,5.300000000000007E-4
6,test_20231101_140547,10350842.png,212614,2387,210227,0.9887730817349751,1,4,42529,350,42179,0.9917703214277317,25.66050311111111,3923.685029333333,12.193862234017685,139,5.300000000000007E-4
7,test_20231101_140547,10863862.png,317432,4062,313370,0.9872035585574234,1,4,66058,597,65461,0.9909624875109752,43.631761777777776,8773.53984,8.699055083450858,139,5.300000000000007E-4
8,test_20231101_140547,11382381.png,312486,327,312159,0.9989535531191798,1,3,46745,44,46701,0.9990587228580596,23.441726222222222,2963.055792,13.413405318888326,139,5.300000000000007E-4
9,test_20231101_140547,11079715.png,443815,84554,359261,0.8094836812635895,2,4,124136,11945,112191,0.9037748920538764,19.967164444444446,2943.194826666667,13.44261349415353,139,5.300000000000007E-4
10,test_20231101_140547,11551286.png,271883,24,271859,0.9999117267353972,1,4,40092,1,40091,0.9999750573680535,24.866876444444443,3470.407338666667,12.72699907819776,139,5.300000000000007E-4
1,test_20231101_140547,10404007.png,502730,8464,494266,0.9831639249696656,2,3,61265,1241,60024,0.9797437362278626,27.621063111111113,3955.2525333333333,12.159061434939156,139,5.400000000000008E-4
2,test_20231101_140547,1254659.png,342646,47977,294669,0.8599808548764614,3,4,80080,6793,73287,0.9151723276723277,24.672812444444446,4427.7978613333335,11.668925747026284,139,5.400000000000008E-4
3,test_20231101_140547,10188041.png,221231,6394,214837,0.971098082999218,2,4,41731,904,40827,0.97833744698186,12.804803555555555,1602.202784,16.083628788333066,139,5.400000000000008E-4
4,test_20231101_140547,10287332.png,216980,7027,209953,0.9676145266844871,2,4,22337,961,21376,0.956977212696423,12.978871111111111,1858.3797813333333,15.439458890558925,139,5.400000000000008E-4
5,test_20231101_140547,11610969.png,368720,8597,360123,0.9766842048166631,2,4,84111,1272,82839,0.9848771266540642,38.41986311111111,7015.829242666667,9.670013506168356,139,5.400000000000008E-4
6,test_20231101_140547,10350842.png,212614,2387,210227,0.9887730817349751,1,3,42529,350,42179,0.9917703214277317,25.66050311111111,3923.685029333333,12.193862234017685,139,5.400000000000008E-4
7,test_20231101_140547,10863862.png,317432,4062,313370,0.9872035585574234,1,3,66058,597,65461,0.9909624875109752,43.631761777777776,8773.53984,8.699055083450858,139,5.400000000000008E-4
8,test_20231101_140547,11382381.png,312486,327,312159,0.9989535531191798,1,4,46745,44,46701,0.9990587228580596,23.441726222222222,2963.055792,13.413405318888326,139,5.400000000000008E-4
9,test_20231101_140547,11079715.png,443815,84554,359261,0.8094836812635895,3,4,124136,11945,112191,0.9037748920538764,19.967164444444446,2943.194826666667,13.44261349415353,139,5.400000000000008E-4
10,test_20231101_140547,11551286.png,271883,24,271859,0.9999117267353972,1,4,40092,1,40091,0.9999750573680535,24.866876444444443,3470.407338666667,12.72699907819776,139,5.400000000000008E-4
1,test_20231101_140548,10404007.png,502730,8464,494266,0.9831639249696656,2,4,61265,1241,60024,0.9797437362278626,27.621063111111113,3955.2525333333333,12.159061434939156,139,5.500000000000008E-4
2,test_20231101_140548,1254659.png,342646,47977,294669,0.8599808548764614,3,4,80080,6793,73287,0.9151723276723277,24.672812444444446,4427.7978613333335,11.668925747026284,139,5.500000000000008E-4
3,test_20231101_140548,10188041.png,221231,6394,214837,0.971098082999218,2,3,41731,904,40827,0.97833744698186,12.804803555555555,1602.202784,16.083628788333066,139,5.500000000000008E-4
4,test_20231101_140548,10287332.png,216980,7027,209953,0.9676145266844871,2,4,22337,961,21376,0.956977212696423,12.978871111111111,1858.3797813333333,15.439458890558925,139,5.500000000000008E-4
5,test_20231101_140548,11610969.png,368720,8597,360123,0.9766842048166631,2,3,84111,1272,82839,0.9848771266540642,38.41986311111111,7015.829242666667,9.670013506168356,139,5.500000000000008E-4
6,test_20231101_140548,10350842.png,212614,2387,210227,0.9887730817349751,1,4,42529,350,42179,0.9917703214277317,25.66050311111111,3923.685029333333,12.193862234017685,139,5.500000000000008E-4
7,test_20231101_140548,10863862.png,317432,4062,313370,0.9872035585574234,1,3,66058,597,65461,0.9909624875109752,43.631761777777776,8773.53984,8.699055083450858,139,5.500000000000008E-4
8,test_20231101_140548,11382381.png,312486,327,312159,0.9989535531191798,2,4,46745,44,46701,0.9990587228580596,23.441726222222222,2963.055792,13.413405318888326,139,5.500000000000008E-4
9,test_20231101_140548,11079715.png,443815,84554,359261,0.8094836812635895,2,4,124136,11945,112191,0.9037748920538764,19.967164444444446,2943.194826666667,13.44261349415353,139,5.500000000000008E-4
10,test_20231101_140548,11551286.png,271883,24,271859,0.9999117267353972,0,3,40092,1,40091,0.9999750573680535,24.866876444444443,3470.407338666667,12.72699907819776,139,5.500000000000008E-4
1,test_20231101_140549,10404007.png,502730,8464,494266,0.9831639249696656,2,4,61265,1241,60024,0.9797437362278626,27.621063111111113,3955.2525333333333,12.159061434939156,139,5.600000000000008E-4
2,test_20231101_140549,1254659.png,342646,47977,294669,0.8599808548764614,2,3,80080,6793,73287,0.9151723276723277,24.672812444444446,4427.7978613333335,11.668925747026284,139,5.600000000000008E-4
3,test_20231101_140549,10188041.png,221231,6394,214837,0.971098082999218,1,3,41731,904,40827,0.97833744698186,12.804803555555555,1602.202784,16.083628788333066,139,5.600000000000008E-4
4,test_20231101_140549,10287332.png,216980,7027,209953,0.9676145266844871,2,3,22337,961,21376,0.956977212696423,12.978871111111111,1858.3797813333333,15.439458890558925,139,5.600000000000008E-4
5,test_20231101_140549,11610969.png,368720,8597,360123,0.9766842048166631,2,3,84111,1272,82839,0.9848771266540642,38.41986311111111,7015.829242666667,9.670013506168356,139,5.600000000000008E-4
6,test_20231101_140549,10350842.png,212614,2387,210227,0.9887730817349751,2,3,42529,350,42179,0.9917703214277317,25.66050311111111,3923.685029333333,12.193862234017685,139,5.600000000000008E-4
7,test_20231101_140549,10863862.png,317432,4062,313370,0.9872035585574234,2,3,66058,597,65461,0.9909624875109752,43.631761777777776,8773.53984,8.699055083450858,139,5.600000000000008E-4
8,test_20231101_140549,11382381.png,312486,327,312159,0.9989535531191798,2,4,46745,44,46701,0.9990587228580596,23.441726222222222,2963.055792,13.413405318888326,139,5.600000000000008E-4
9,test_20231101_140549,11079715.png,443815,84554,359261,0.8094836812635895,3,5,124136,11945,112191,0.9037748920538764,19.967164444444446,2943.194826666667,13.44261349415353,139,5.600000000000008E-4
10,test_20231101_140549,11551286.png,271883,24,271859,0.9999117267353972,0,3,40092,1,40091,0.9999750573680535,24.866876444444443,3470.407338666667,12.72699907819776,139,5.600000000000008E-4
1,test_20231101_140549,10404007.png,502730,8464,494266,0.9831639249696656,1,3,61265,1241,60024,0.9797437362278626,27.621063111111113,3955.2525333333333,12.159061434939156,139,5.700000000000008E-4
2,test_20231101_140549,1254659.png,342646,47977,294669,0.8599808548764614,3,4,80080,6793,73287,0.9151723276723277,24.672812444444446,4427.7978613333335,11.668925747026284,139,5.700000000000008E-4
3,test_20231101_140549,10188041.png,221231,6394,214837,0.971098082999218,2,4,41731,904,40827,0.97833744698186,12.804803555555555,1602.202784,16.083628788333066,139,5.700000000000008E-4
4,test_20231101_140549,10287332.png,216980,7027,209953,0.9676145266844871,2,4,22337,961,21376,0.956977212696423,12.978871111111111,1858.3797813333333,15.439458890558925,139,5.700000000000008E-4
5,test_20231101_140549,11610969.png,368720,8597,360123,0.9766842048166631,1,3,84111,1272,82839,0.9848771266540642,38.41986311111111,7015.829242666667,9.670013506168356,139,5.700000000000008E-4
6,test_20231101_140549,10350842.png,212614,2387,210227,0.9887730817349751,1,4,42529,350,42179,0.9917703214277317,25.66050311111111,3923.685029333333,12.193862234017685,139,5.700000000000008E-4
7,test_20231101_140549,10863862.png,317432,4062,313370,0.9872035585574234,1,3,66058,597,65461,0.9909624875109752,43.631761777777776,8773.53984,8.699055083450858,139,5.700000000000008E-4
8,test_20231101_140549,11382381.png,312486,327,312159,0.9989535531191798,2,3,46745,44,46701,0.9990587228580596,23.441726222222222,2963.055792,13.413405318888326,139,5.700000000000008E-4
9,test_20231101_140549,11079715.png,443815,84554,359261,0.8094836812635895,3,4,124136,11945,112191,0.9037748920538764,19.967164444444446,2943.194826666667,13.44261349415353,139,5.700000000000008E-4
10,test_20231101_140549,11551286.png,271883,24,271859,0.9999117267353972,1,3,40092,1,40091,0.9999750573680535,24.866876444444443,3470.407338666667,12.72699907819776,139,5.700000000000008E-4
1,test_20231101_140550,10404007.png,502730,8464,494266,0.9831639249696656,2,4,61265,1241,60024,0.9797437362278626,27.621063111111113,3955.2525333333333,12.159061434939156,139,5.800000000000009E-4
2,test_20231101_140550,1254659.png,342646,47977,294669,0.8599808548764614,2,10,80080,6793,73287,0.9151723276723277,24.672812444444446,4427.7978613333335,11.668925747026284,139,5.800000000000009E-4
3,test_20231101_140550,10188041.png,221231,6314,214917,0.9714596959738916,2,4,41731,894,40837,0.9785770769931226,12.843704888888889,1606.2872853333333,16.072571391798796,139,5.800000000000009E-4
4,test_20231101_140550,10287332.png,216980,7027,209953,0.9676145266844871,1,3,22337,961,21376,0.956977212696423,12.978871111111111,1858.3797813333333,15.439458890558925,139,5.800000000000009E-4
5,test_20231101_140550,11610969.png,368720,8597,360123,0.9766842048166631,2,4,84111,1272,82839,0.9848771266540642,38.41986311111111,7015.829242666667,9.670013506168356,139,5.800000000000009E-4
6,test_20231101_140550,10350842.png,212614,2062,210552,0.9903016734551817,2,4,42529,302,42227,0.9928989630604999,26.531779555555556,4136.800586666666,11.964157745137602,139,5.800000000000009E-4
7,test_20231101_140550,10863862.png,317432,4062,313370,0.9872035585574234,1,4,66058,597,65461,0.9909624875109752,43.631761777777776,8773.53984,8.699055083450858,139,5.800000000000009E-4
8,test_20231101_140550,11382381.png,312486,327,312159,0.9989535531191798,1,3,46745,44,46701,0.9990587228580596,23.441726222222222,2963.055792,13.413405318888326,139,5.800000000000009E-4
9,test_20231101_140550,11079715.png,443815,84554,359261,0.8094836812635895,3,8,124136,11945,112191,0.9037748920538764,19.967164444444446,2943.194826666667,13.44261349415353,139,5.800000000000009E-4
10,test_20231101_140550,11551286.png,271883,24,271859,0.9999117267353972,1,4,40092,1,40091,0.9999750573680535,24.866876444444443,3470.407338666667,12.72699907819776,139,5.800000000000009E-4
1,test_20231101_140551,10404007.png,502730,8464,494266,0.9831639249696656,2,3,61265,1241,60024,0.9797437362278626,27.621063111111113,3955.2525333333333,12.159061434939156,139,5.900000000000009E-4
2,test_20231101_140551,1254659.png,342646,47977,294669,0.8599808548764614,3,4,80080,6793,73287,0.9151723276723277,24.672812444444446,4427.7978613333335,11.668925747026284,139,5.900000000000009E-4
3,test_20231101_140551,10188041.png,221231,6314,214917,0.9714596959738916,2,3,41731,894,40837,0.9785770769931226,12.843704888888889,1606.2872853333333,16.072571391798796,139,5.900000000000009E-4
4,test_20231101_140551,10287332.png,216980,7027,209953,0.9676145266844871,1,3,22337,961,21376,0.956977212696423,12.978871111111111,1858.3797813333333,15.439458890558925,139,5.900000000000009E-4
5,test_20231101_140551,11610969.png,368720,8597,360123,0.9766842048166631,1,4,84111,1272,82839,0.9848771266540642,38.41986311111111,7015.829242666667,9.670013506168356,139,5.900000000000009E-4
6,test_20231101_140551,10350842.png,212614,2062,210552,0.9903016734551817,2,7,42529,302,42227,0.9928989630604999,26.531779555555556,4136.800586666666,11.964157745137602,139,5.900000000000009E-4
7,test_20231101_140551,10863862.png,317432,4062,313370,0.9872035585574234,1,4,66058,597,65461,0.9909624875109752,43.631761777777776,8773.53984,8.699055083450858,139,5.900000000000009E-4
8,test_20231101_140551,11382381.png,312486,327,312159,0.9989535531191798,1,3,46745,44,46701,0.9990587228580596,23.441726222222222,2963.055792,13.413405318888326,139,5.900000000000009E-4
9,test_20231101_140551,11079715.png,443815,84554,359261,0.8094836812635895,5,4,124136,11945,112191,0.9037748920538764,19.967164444444446,2943.194826666667,13.44261349415353,139,5.900000000000009E-4
10,test_20231101_140551,11551286.png,271883,24,271859,0.9999117267353972,1,4,40092,1,40091,0.9999750573680535,24.866876444444443,3470.407338666667,12.72699907819776,139,5.900000000000009E-4
1,test_20231101_140551,10404007.png,502730,8464,494266,0.9831639249696656,2,4,61265,1241,60024,0.9797437362278626,27.621063111111113,3955.2525333333333,12.159061434939156,139,6.000000000000009E-4
2,test_20231101_140551,1254659.png,342646,47977,294669,0.8599808548764614,2,3,80080,6793,73287,0.9151723276723277,24.672812444444446,4427.7978613333335,11.668925747026284,139,6.000000000000009E-4
3,test_20231101_140551,10188041.png,221231,6314,214917,0.9714596959738916,2,3,41731,894,40837,0.9785770769931226,12.843704888888889,1606.2872853333333,16.072571391798796,139,6.000000000000009E-4
4,test_20231101_140551,10287332.png,216980,7027,209953,0.9676145266844871,1,4,22337,961,21376,0.956977212696423,12.978871111111111,1858.3797813333333,15.439458890558925,139,6.000000000000009E-4
5,test_20231101_140551,11610969.png,368720,8597,360123,0.9766842048166631,1,4,84111,1272,82839,0.9848771266540642,38.41986311111111,7015.829242666667,9.670013506168356,139,6.000000000000009E-4
6,test_20231101_140551,10350842.png,212614,2062,210552,0.9903016734551817,2,3,42529,302,42227,0.9928989630604999,26.531779555555556,4136.800586666666,11.964157745137602,139,6.000000000000009E-4
7,test_20231101_140551,10863862.png,317432,4062,313370,0.9872035585574234,1,4,66058,597,65461,0.9909624875109752,43.631761777777776,8773.53984,8.699055083450858,139,6.000000000000009E-4
8,test_20231101_140551,11382381.png,312486,327,312159,0.9989535531191798,2,3,46745,44,46701,0.9990587228580596,23.441726222222222,2963.055792,13.413405318888326,139,6.000000000000009E-4
9,test_20231101_140551,11079715.png,443815,84554,359261,0.8094836812635895,3,5,124136,11945,112191,0.9037748920538764,19.967164444444446,2943.194826666667,13.44261349415353,139,6.000000000000009E-4
10,test_20231101_140551,11551286.png,271883,24,271859,0.9999117267353972,0,4,40092,1,40091,0.9999750573680535,24.866876444444443,3470.407338666667,12.72699907819776,139,6.000000000000009E-4
1,test_20231101_140552,10404007.png,502730,8464,494266,0.9831639249696656,2,4,61265,1241,60024,0.9797437362278626,27.621063111111113,3955.2525333333333,12.159061434939156,139,6.10000000000001E-4
2,test_20231101_140552,1254659.png,342646,47977,294669,0.8599808548764614,2,3,80080,6793,73287,0.9151723276723277,24.672812444444446,4427.7978613333335,11.668925747026284,139,6.10000000000001E-4
3,test_20231101_140552,10188041.png,221231,6314,214917,0.9714596959738916,1,3,41731,894,40837,0.9785770769931226,12.843704888888889,1606.2872853333333,16.072571391798796,139,6.10000000000001E-4
4,test_20231101_140552,10287332.png,216980,7027,209953,0.9676145266844871,1,4,22337,961,21376,0.956977212696423,12.978871111111111,1858.3797813333333,15.439458890558925,139,6.10000000000001E-4
5,test_20231101_140552,11610969.png,368720,8597,360123,0.9766842048166631,2,4,84111,1272,82839,0.9848771266540642,38.41986311111111,7015.829242666667,9.670013506168356,139,6.10000000000001E-4
6,test_20231101_140552,10350842.png,212614,2062,210552,0.9903016734551817,1,3,42529,302,42227,0.9928989630604999,26.531779555555556,4136.800586666666,11.964157745137602,139,6.10000000000001E-4
7,test_20231101_140552,10863862.png,317432,4062,313370,0.9872035585574234,2,3,66058,597,65461,0.9909624875109752,43.631761777777776,8773.53984,8.699055083450858,139,6.10000000000001E-4
8,test_20231101_140552,11382381.png,312486,327,312159,0.9989535531191798,1,4,46745,44,46701,0.9990587228580596,23.441726222222222,2963.055792,13.413405318888326,139,6.10000000000001E-4
9,test_20231101_140552,11079715.png,443815,84554,359261,0.8094836812635895,4,4,124136,11945,112191,0.9037748920538764,19.967164444444446,2943.194826666667,13.44261349415353,139,6.10000000000001E-4
10,test_20231101_140552,11551286.png,271883,24,271859,0.9999117267353972,1,4,40092,1,40091,0.9999750573680535,24.866876444444443,3470.407338666667,12.72699907819776,139,6.10000000000001E-4
1,test_20231101_140553,10404007.png,502730,8464,494266,0.9831639249696656,2,3,61265,1241,60024,0.9797437362278626,27.621063111111113,3955.2525333333333,12.159061434939156,139,6.20000000000001E-4
2,test_20231101_140553,1254659.png,342646,47977,294669,0.8599808548764614,4,4,80080,6793,73287,0.9151723276723277,24.672812444444446,4427.7978613333335,11.668925747026284,139,6.20000000000001E-4
3,test_20231101_140553,10188041.png,221231,6314,214917,0.9714596959738916,2,4,41731,894,40837,0.9785770769931226,12.843704888888889,1606.2872853333333,16.072571391798796,139,6.20000000000001E-4
4,test_20231101_140553,10287332.png,216980,7027,209953,0.9676145266844871,1,3,22337,961,21376,0.956977212696423,12.978871111111111,1858.3797813333333,15.439458890558925,139,6.20000000000001E-4
5,test_20231101_140553,11610969.png,368720,8597,360123,0.9766842048166631,2,3,84111,1272,82839,0.9848771266540642,38.41986311111111,7015.829242666667,9.670013506168356,139,6.20000000000001E-4
6,test_20231101_140553,10350842.png,212614,2062,210552,0.9903016734551817,1,9,42529,302,42227,0.9928989630604999,26.531779555555556,4136.800586666666,11.964157745137602,139,6.20000000000001E-4
7,test_20231101_140553,10863862.png,317432,4062,313370,0.9872035585574234,1,4,66058,597,65461,0.9909624875109752,43.631761777777776,8773.53984,8.699055083450858,139,6.20000000000001E-4
8,test_20231101_140553,11382381.png,312486,327,312159,0.9989535531191798,1,3,46745,44,46701,0.9990587228580596,23.441726222222222,2963.055792,13.413405318888326,139,6.20000000000001E-4
9,test_20231101_140553,11079715.png,443815,84554,359261,0.8094836812635895,2,4,124136,11945,112191,0.9037748920538764,19.967164444444446,2943.194826666667,13.44261349415353,139,6.20000000000001E-4
10,test_20231101_140553,11551286.png,271883,24,271859,0.9999117267353972,1,4,40092,1,40091,0.9999750573680535,24.866876444444443,3470.407338666667,12.72699907819776,139,6.20000000000001E-4
1,test_20231101_140553,10404007.png,502730,8464,494266,0.9831639249696656,2,4,61265,1241,60024,0.9797437362278626,27.621063111111113,3955.2525333333333,12.159061434939156,139,6.30000000000001E-4
2,test_20231101_140553,1254659.png,342646,47977,294669,0.8599808548764614,3,4,80080,6793,73287,0.9151723276723277,24.672812444444446,4427.7978613333335,11.668925747026284,139,6.30000000000001E-4
3,test_20231101_140553,10188041.png,221231,6314,214917,0.9714596959738916,2,3,41731,894,40837,0.9785770769931226,12.843704888888889,1606.2872853333333,16.072571391798796,139,6.30000000000001E-4
4,test_20231101_140553,10287332.png,216980,7027,209953,0.9676145266844871,2,10,22337,961,21376,0.956977212696423,12.978871111111111,1858.3797813333333,15.439458890558925,139,6.30000000000001E-4
5,test_20231101_140553,11610969.png,368720,8597,360123,0.9766842048166631,1,3,84111,1272,82839,0.9848771266540642,38.41986311111111,7015.829242666667,9.670013506168356,139,6.30000000000001E-4
6,test_20231101_140553,10350842.png,212614,2062,210552,0.9903016734551817,2,3,42529,302,42227,0.9928989630604999,26.531779555555556,4136.800586666666,11.964157745137602,139,6.30000000000001E-4
7,test_20231101_140553,10863862.png,317432,4062,313370,0.9872035585574234,2,3,66058,597,65461,0.9909624875109752,43.631761777777776,8773.53984,8.699055083450858,139,6.30000000000001E-4
8,test_20231101_140553,11382381.png,312486,327,312159,0.9989535531191798,1,4,46745,44,46701,0.9990587228580596,23.441726222222222,2963.055792,13.413405318888326,139,6.30000000000001E-4
9,test_20231101_140553,11079715.png,443815,84554,359261,0.8094836812635895,4,4,124136,11945,112191,0.9037748920538764,19.967164444444446,2943.194826666667,13.44261349415353,139,6.30000000000001E-4
10,test_20231101_140553,11551286.png,271883,24,271859,0.9999117267353972,0,3,40092,1,40091,0.9999750573680535,24.866876444444443,3470.407338666667,12.72699907819776,139,6.30000000000001E-4
1,test_20231101_140554,10404007.png,502730,8464,494266,0.9831639249696656,6,4,61265,1241,60024,0.9797437362278626,27.621063111111113,3955.2525333333333,12.159061434939156,139,6.40000000000001E-4
2,test_20231101_140554,1254659.png,342646,47977,294669,0.8599808548764614,3,4,80080,6793,73287,0.9151723276723277,24.672812444444446,4427.7978613333335,11.668925747026284,139,6.40000000000001E-4
3,test_20231101_140554,10188041.png,221231,6314,214917,0.9714596959738916,2,4,41731,894,40837,0.9785770769931226,12.843704888888889,1606.2872853333333,16.072571391798796,139,6.40000000000001E-4
4,test_20231101_140554,10287332.png,216980,7027,209953,0.9676145266844871,2,4,22337,961,21376,0.956977212696423,12.978871111111111,1858.3797813333333,15.439458890558925,139,6.40000000000001E-4
5,test_20231101_140554,11610969.png,368720,8597,360123,0.9766842048166631,1,4,84111,1272,82839,0.9848771266540642,38.41986311111111,7015.829242666667,9.670013506168356,139,6.40000000000001E-4
6,test_20231101_140554,10350842.png,212614,2062,210552,0.9903016734551817,1,4,42529,302,42227,0.9928989630604999,26.531779555555556,4136.800586666666,11.964157745137602,139,6.40000000000001E-4
7,test_20231101_140554,10863862.png,317432,4062,313370,0.9872035585574234,3,4,66058,597,65461,0.9909624875109752,43.631761777777776,8773.53984,8.699055083450858,139,6.40000000000001E-4
8,test_20231101_140554,11382381.png,312486,327,312159,0.9989535531191798,1,3,46745,44,46701,0.9990587228580596,23.441726222222222,2963.055792,13.413405318888326,139,6.40000000000001E-4
9,test_20231101_140554,11079715.png,443815,84554,359261,0.8094836812635895,3,4,124136,11945,112191,0.9037748920538764,19.967164444444446,2943.194826666667,13.44261349415353,139,6.40000000000001E-4
10,test_20231101_140554,11551286.png,271883,24,271859,0.9999117267353972,0,3,40092,1,40091,0.9999750573680535,24.866876444444443,3470.407338666667,12.72699907819776,139,6.40000000000001E-4
1,test_20231101_140555,10404007.png,502730,8464,494266,0.9831639249696656,2,4,61265,1241,60024,0.9797437362278626,27.621063111111113,3955.2525333333333,12.159061434939156,139,6.500000000000011E-4
2,test_20231101_140555,1254659.png,342646,47977,294669,0.8599808548764614,2,4,80080,6793,73287,0.9151723276723277,24.672812444444446,4427.7978613333335,11.668925747026284,139,6.500000000000011E-4
3,test_20231101_140555,10188041.png,221231,6314,214917,0.9714596959738916,2,4,41731,894,40837,0.9785770769931226,12.843704888888889,1606.2872853333333,16.072571391798796,139,6.500000000000011E-4
4,test_20231101_140555,10287332.png,216980,7027,209953,0.9676145266844871,2,4,22337,961,21376,0.956977212696423,12.978871111111111,1858.3797813333333,15.439458890558925,139,6.500000000000011E-4
5,test_20231101_140555,11610969.png,368720,8597,360123,0.9766842048166631,2,4,84111,1272,82839,0.9848771266540642,38.41986311111111,7015.829242666667,9.670013506168356,139,6.500000000000011E-4
6,test_20231101_140555,10350842.png,212614,2062,210552,0.9903016734551817,1,4,42529,302,42227,0.9928989630604999,26.531779555555556,4136.800586666666,11.964157745137602,139,6.500000000000011E-4
7,test_20231101_140555,10863862.png,317432,4062,313370,0.9872035585574234,2,4,66058,597,65461,0.9909624875109752,43.631761777777776,8773.53984,8.699055083450858,139,6.500000000000011E-4
8,test_20231101_140555,11382381.png,312486,327,312159,0.9989535531191798,1,4,46745,44,46701,0.9990587228580596,23.441726222222222,2963.055792,13.413405318888326,139,6.500000000000011E-4
9,test_20231101_140555,11079715.png,443815,84554,359261,0.8094836812635895,3,5,124136,11945,112191,0.9037748920538764,19.967164444444446,2943.194826666667,13.44261349415353,139,6.500000000000011E-4
10,test_20231101_140555,11551286.png,271883,24,271859,0.9999117267353972,1,3,40092,1,40091,0.9999750573680535,24.866876444444443,3470.407338666667,12.72699907819776,139,6.500000000000011E-4
1,test_20231101_140555,10404007.png,502730,8464,494266,0.9831639249696656,2,4,61265,1241,60024,0.9797437362278626,27.621063111111113,3955.2525333333333,12.159061434939156,139,6.600000000000011E-4
2,test_20231101_140555,1254659.png,342646,47977,294669,0.8599808548764614,2,3,80080,6793,73287,0.9151723276723277,24.672812444444446,4427.7978613333335,11.668925747026284,139,6.600000000000011E-4
3,test_20231101_140555,10188041.png,221231,6314,214917,0.9714596959738916,2,4,41731,894,40837,0.9785770769931226,12.843704888888889,1606.2872853333333,16.072571391798796,139,6.600000000000011E-4
4,test_20231101_140555,10287332.png,216980,7027,209953,0.9676145266844871,2,4,22337,961,21376,0.956977212696423,12.978871111111111,1858.3797813333333,15.439458890558925,139,6.600000000000011E-4
5,test_20231101_140555,11610969.png,368720,8597,360123,0.9766842048166631,1,3,84111,1272,82839,0.9848771266540642,38.41986311111111,7015.829242666667,9.670013506168356,139,6.600000000000011E-4
6,test_20231101_140555,10350842.png,212614,2062,210552,0.9903016734551817,1,3,42529,302,42227,0.9928989630604999,26.531779555555556,4136.800586666666,11.964157745137602,139,6.600000000000011E-4
7,test_20231101_140555,10863862.png,317432,4062,313370,0.9872035585574234,2,4,66058,597,65461,0.9909624875109752,43.631761777777776,8773.53984,8.699055083450858,139,6.600000000000011E-4
8,test_20231101_140555,11382381.png,312486,327,312159,0.9989535531191798,1,3,46745,44,46701,0.9990587228580596,23.441726222222222,2963.055792,13.413405318888326,139,6.600000000000011E-4
9,test_20231101_140555,11079715.png,443815,84554,359261,0.8094836812635895,3,4,124136,11945,112191,0.9037748920538764,19.967164444444446,2943.194826666667,13.44261349415353,139,6.600000000000011E-4
10,test_20231101_140555,11551286.png,271883,24,271859,0.9999117267353972,1,3,40092,1,40091,0.9999750573680535,24.866876444444443,3470.407338666667,12.72699907819776,139,6.600000000000011E-4
1,test_20231101_140556,10404007.png,502730,8464,494266,0.9831639249696656,2,3,61265,1241,60024,0.9797437362278626,27.621063111111113,3955.2525333333333,12.159061434939156,139,6.700000000000011E-4
2,test_20231101_140556,1254659.png,342646,47977,294669,0.8599808548764614,2,4,80080,6793,73287,0.9151723276723277,24.672812444444446,4427.7978613333335,11.668925747026284,139,6.700000000000011E-4
3,test_20231101_140556,10188041.png,221231,6314,214917,0.9714596959738916,2,3,41731,894,40837,0.9785770769931226,12.843704888888889,1606.2872853333333,16.072571391798796,139,6.700000000000011E-4
4,test_20231101_140556,10287332.png,216980,7027,209953,0.9676145266844871,2,3,22337,961,21376,0.956977212696423,12.978871111111111,1858.3797813333333,15.439458890558925,139,6.700000000000011E-4
5,test_20231101_140556,11610969.png,368720,8597,360123,0.9766842048166631,1,3,84111,1272,82839,0.9848771266540642,38.41986311111111,7015.829242666667,9.670013506168356,139,6.700000000000011E-4
6,test_20231101_140556,10350842.png,212614,2062,210552,0.9903016734551817,1,4,42529,302,42227,0.9928989630604999,26.531779555555556,4136.800586666666,11.964157745137602,139,6.700000000000011E-4
7,test_20231101_140556,10863862.png,317432,4062,313370,0.9872035585574234,1,4,66058,597,65461,0.9909624875109752,43.631761777777776,8773.53984,8.699055083450858,139,6.700000000000011E-4
8,test_20231101_140556,11382381.png,312486,327,312159,0.9989535531191798,1,4,46745,44,46701,0.9990587228580596,23.441726222222222,2963.055792,13.413405318888326,139,6.700000000000011E-4
9,test_20231101_140556,11079715.png,443815,84554,359261,0.8094836812635895,3,4,124136,11945,112191,0.9037748920538764,19.967164444444446,2943.194826666667,13.44261349415353,139,6.700000000000011E-4
10,test_20231101_140556,11551286.png,271883,24,271859,0.9999117267353972,0,3,40092,1,40091,0.9999750573680535,24.866876444444443,3470.407338666667,12.72699907819776,139,6.700000000000011E-4
1,test_20231101_140557,10404007.png,502730,8464,494266,0.9831639249696656,2,4,61265,1241,60024,0.9797437362278626,27.621063111111113,3955.2525333333333,12.159061434939156,139,6.800000000000011E-4
2,test_20231101_140557,1254659.png,342646,47977,294669,0.8599808548764614,3,4,80080,6793,73287,0.9151723276723277,24.672812444444446,4427.7978613333335,11.668925747026284,139,6.800000000000011E-4
3,test_20231101_140557,10188041.png,221231,6314,214917,0.9714596959738916,2,3,41731,894,40837,0.9785770769931226,12.843704888888889,1606.2872853333333,16.072571391798796,139,6.800000000000011E-4
4,test_20231101_140557,10287332.png,216980,7027,209953,0.9676145266844871,1,4,22337,961,21376,0.956977212696423,12.978871111111111,1858.3797813333333,15.439458890558925,139,6.800000000000011E-4
5,test_20231101_140557,11610969.png,368720,8597,360123,0.9766842048166631,1,3,84111,1272,82839,0.9848771266540642,38.41986311111111,7015.829242666667,9.670013506168356,139,6.800000000000011E-4
6,test_20231101_140557,10350842.png,212614,2062,210552,0.9903016734551817,2,4,42529,302,42227,0.9928989630604999,26.531779555555556,4136.800586666666,11.964157745137602,139,6.800000000000011E-4
7,test_20231101_140557,10863862.png,317432,4062,313370,0.9872035585574234,1,4,66058,597,65461,0.9909624875109752,43.631761777777776,8773.53984,8.699055083450858,139,6.800000000000011E-4
8,test_20231101_140557,11382381.png,312486,327,312159,0.9989535531191798,1,4,46745,44,46701,0.9990587228580596,23.441726222222222,2963.055792,13.413405318888326,139,6.800000000000011E-4
9,test_20231101_140557,11079715.png,443815,84554,359261,0.8094836812635895,3,4,124136,11945,112191,0.9037748920538764,19.967164444444446,2943.194826666667,13.44261349415353,139,6.800000000000011E-4
10,test_20231101_140557,11551286.png,271883,24,271859,0.9999117267353972,1,4,40092,1,40091,0.9999750573680535,24.866876444444443,3470.407338666667,12.72699907819776,139,6.800000000000011E-4
1,test_20231101_140557,10404007.png,502730,8464,494266,0.9831639249696656,2,4,61265,1241,60024,0.9797437362278626,27.621063111111113,3955.2525333333333,12.159061434939156,139,6.900000000000012E-4
2,test_20231101_140557,1254659.png,342646,47977,294669,0.8599808548764614,3,4,80080,6793,73287,0.9151723276723277,24.672812444444446,4427.7978613333335,11.668925747026284,139,6.900000000000012E-4
3,test_20231101_140557,10188041.png,221231,6314,214917,0.9714596959738916,2,3,41731,894,40837,0.9785770769931226,12.843704888888889,1606.2872853333333,16.072571391798796,139,6.900000000000012E-4
4,test_20231101_140557,10287332.png,216980,7027,209953,0.9676145266844871,2,4,22337,961,21376,0.956977212696423,12.978871111111111,1858.3797813333333,15.439458890558925,139,6.900000000000012E-4
5,test_20231101_140557,11610969.png,368720,8597,360123,0.9766842048166631,1,4,84111,1272,82839,0.9848771266540642,38.41986311111111,7015.829242666667,9.670013506168356,139,6.900000000000012E-4
6,test_20231101_140557,10350842.png,212614,2062,210552,0.9903016734551817,1,3,42529,302,42227,0.9928989630604999,26.531779555555556,4136.800586666666,11.964157745137602,139,6.900000000000012E-4
7,test_20231101_140557,10863862.png,317432,4062,313370,0.9872035585574234,1,4,66058,597,65461,0.9909624875109752,43.631761777777776,8773.53984,8.699055083450858,139,6.900000000000012E-4
8,test_20231101_140557,11382381.png,312486,327,312159,0.9989535531191798,2,3,46745,44,46701,0.9990587228580596,23.441726222222222,2963.055792,13.413405318888326,139,6.900000000000012E-4
9,test_20231101_140557,11079715.png,443815,84554,359261,0.8094836812635895,3,4,124136,11945,112191,0.9037748920538764,19.967164444444446,2943.194826666667,13.44261349415353,139,6.900000000000012E-4
10,test_20231101_140557,11551286.png,271883,24,271859,0.9999117267353972,2,4,40092,1,40091,0.9999750573680535,24.866876444444443,3470.407338666667,12.72699907819776,139,6.900000000000012E-4
1,test_20231101_140558,10404007.png,502730,8464,494266,0.9831639249696656,2,3,61265,1241,60024,0.9797437362278626,27.621063111111113,3955.2525333333333,12.159061434939156,139,7.000000000000012E-4
2,test_20231101_140558,1254659.png,342646,47977,294669,0.8599808548764614,2,4,80080,6793,73287,0.9151723276723277,24.672812444444446,4427.7978613333335,11.668925747026284,139,7.000000000000012E-4
3,test_20231101_140558,10188041.png,221231,6314,214917,0.9714596959738916,2,3,41731,894,40837,0.9785770769931226,12.843704888888889,1606.2872853333333,16.072571391798796,139,7.000000000000012E-4
4,test_20231101_140558,10287332.png,216980,7027,209953,0.9676145266844871,2,4,22337,961,21376,0.956977212696423,12.978871111111111,1858.3797813333333,15.439458890558925,139,7.000000000000012E-4
5,test_20231101_140558,11610969.png,368720,8597,360123,0.9766842048166631,2,4,84111,1272,82839,0.9848771266540642,38.41986311111111,7015.829242666667,9.670013506168356,139,7.000000000000012E-4
6,test_20231101_140558,10350842.png,212614,2062,210552,0.9903016734551817,1,4,42529,302,42227,0.9928989630604999,26.531779555555556,4136.800586666666,11.964157745137602,139,7.000000000000012E-4
7,test_20231101_140558,10863862.png,317432,4062,313370,0.9872035585574234,1,4,66058,597,65461,0.9909624875109752,43.631761777777776,8773.53984,8.699055083450858,139,7.000000000000012E-4
8,test_20231101_140558,11382381.png,312486,327,312159,0.9989535531191798,4,3,46745,44,46701,0.9990587228580596,23.441726222222222,2963.055792,13.413405318888326,139,7.000000000000012E-4
9,test_20231101_140558,11079715.png,443815,84554,359261,0.8094836812635895,3,4,124136,11945,112191,0.9037748920538764,19.967164444444446,2943.194826666667,13.44261349415353,139,7.000000000000012E-4
10,test_20231101_140558,11551286.png,271883,24,271859,0.9999117267353972,1,4,40092,1,40091,0.9999750573680535,24.866876444444443,3470.407338666667,12.72699907819776,139,7.000000000000012E-4
1,test_20231101_140559,10404007.png,502730,8464,494266,0.9831639249696656,2,3,61265,1241,60024,0.9797437362278626,27.621063111111113,3955.2525333333333,12.159061434939156,139,7.100000000000012E-4
2,test_20231101_140559,1254659.png,342646,47977,294669,0.8599808548764614,3,4,80080,6793,73287,0.9151723276723277,24.672812444444446,4427.7978613333335,11.668925747026284,139,7.100000000000012E-4
3,test_20231101_140559,10188041.png,221231,6314,214917,0.9714596959738916,2,3,41731,894,40837,0.9785770769931226,12.843704888888889,1606.2872853333333,16.072571391798796,139,7.100000000000012E-4
4,test_20231101_140559,10287332.png,216980,7027,209953,0.9676145266844871,2,4,22337,961,21376,0.956977212696423,12.978871111111111,1858.3797813333333,15.439458890558925,139,7.100000000000012E-4
5,test_20231101_140559,11610969.png,368720,8597,360123,0.9766842048166631,3,4,84111,1272,82839,0.9848771266540642,38.41986311111111,7015.829242666667,9.670013506168356,139,7.100000000000012E-4
6,test_20231101_140559,10350842.png,212614,2062,210552,0.9903016734551817,1,3,42529,302,42227,0.9928989630604999,26.531779555555556,4136.800586666666,11.964157745137602,139,7.100000000000012E-4
7,test_20231101_140559,10863862.png,317432,4062,313370,0.9872035585574234,2,4,66058,597,65461,0.9909624875109752,43.631761777777776,8773.53984,8.699055083450858,139,7.100000000000012E-4
8,test_20231101_140559,11382381.png,312486,327,312159,0.9989535531191798,2,4,46745,44,46701,0.9990587228580596,23.441726222222222,2963.055792,13.413405318888326,139,7.100000000000012E-4
9,test_20231101_140559,11079715.png,443815,84554,359261,0.8094836812635895,3,4,124136,11945,112191,0.9037748920538764,19.967164444444446,2943.194826666667,13.44261349415353,139,7.100000000000012E-4
10,test_20231101_140559,11551286.png,271883,24,271859,0.9999117267353972,0,3,40092,1,40091,0.9999750573680535,24.866876444444443,3470.407338666667,12.72699907819776,139,7.100000000000012E-4
1,test_20231101_140559,10404007.png,502730,8464,494266,0.9831639249696656,2,3,61265,1241,60024,0.9797437362278626,27.621063111111113,3955.2525333333333,12.159061434939156,139,7.200000000000012E-4
2,test_20231101_140559,1254659.png,342646,47977,294669,0.8599808548764614,3,4,80080,6793,73287,0.9151723276723277,24.672812444444446,4427.7978613333335,11.668925747026284,139,7.200000000000012E-4
3,test_20231101_140559,10188041.png,221231,6314,214917,0.9714596959738916,2,4,41731,894,40837,0.9785770769931226,12.843704888888889,1606.2872853333333,16.072571391798796,139,7.200000000000012E-4
4,test_20231101_140559,10287332.png,216980,7027,209953,0.9676145266844871,1,4,22337,961,21376,0.956977212696423,12.978871111111111,1858.3797813333333,15.439458890558925,139,7.200000000000012E-4
5,test_20231101_140559,11610969.png,368720,8597,360123,0.9766842048166631,1,3,84111,1272,82839,0.9848771266540642,38.41986311111111,7015.829242666667,9.670013506168356,139,7.200000000000012E-4
6,test_20231101_140559,10350842.png,212614,2062,210552,0.9903016734551817,1,3,42529,302,42227,0.9928989630604999,26.531779555555556,4136.800586666666,11.964157745137602,139,7.200000000000012E-4
7,test_20231101_140559,10863862.png,317432,4062,313370,0.9872035585574234,1,4,66058,597,65461,0.9909624875109752,43.631761777777776,8773.53984,8.699055083450858,139,7.200000000000012E-4
8,test_20231101_140559,11382381.png,312486,327,312159,0.9989535531191798,1,4,46745,44,46701,0.9990587228580596,23.441726222222222,2963.055792,13.413405318888326,139,7.200000000000012E-4
9,test_20231101_140559,11079715.png,443815,84554,359261,0.8094836812635895,3,4,124136,11945,112191,0.9037748920538764,19.967164444444446,2943.194826666667,13.44261349415353,139,7.200000000000012E-4
10,test_20231101_140559,11551286.png,271883,24,271859,0.9999117267353972,0,3,40092,1,40091,0.9999750573680535,24.866876444444443,3470.407338666667,12.72699907819776,139,7.200000000000012E-4
1,test_20231101_140600,10404007.png,502730,8464,494266,0.9831639249696656,2,4,61265,1241,60024,0.9797437362278626,27.621063111111113,3955.2525333333333,12.159061434939156,139,7.300000000000013E-4
2,test_20231101_140600,1254659.png,342646,47977,294669,0.8599808548764614,3,4,80080,6793,73287,0.9151723276723277,24.672812444444446,4427.7978613333335,11.668925747026284,139,7.300000000000013E-4
3,test_20231101_140600,10188041.png,221231,6314,214917,0.9714596959738916,2,3,41731,894,40837,0.9785770769931226,12.843704888888889,1606.2872853333333,16.072571391798796,139,7.300000000000013E-4
4,test_20231101_140600,10287332.png,216980,7027,209953,0.9676145266844871,1,3,22337,961,21376,0.956977212696423,12.978871111111111,1858.3797813333333,15.439458890558925,139,7.300000000000013E-4
5,test_20231101_140600,11610969.png,368720,8597,360123,0.9766842048166631,1,3,84111,1272,82839,0.9848771266540642,38.41986311111111,7015.829242666667,9.670013506168356,139,7.300000000000013E-4
6,test_20231101_140600,10350842.png,212614,2062,210552,0.9903016734551817,2,3,42529,302,42227,0.9928989630604999,26.531779555555556,4136.800586666666,11.964157745137602,139,7.300000000000013E-4
7,test_20231101_140600,10863862.png,317432,4062,313370,0.9872035585574234,1,4,66058,597,65461,0.9909624875109752,43.631761777777776,8773.53984,8.699055083450858,139,7.300000000000013E-4
8,test_20231101_140600,11382381.png,312486,327,312159,0.9989535531191798,1,3,46745,44,46701,0.9990587228580596,23.441726222222222,2963.055792,13.413405318888326,139,7.300000000000013E-4
9,test_20231101_140600,11079715.png,443815,84554,359261,0.8094836812635895,3,4,124136,11945,112191,0.9037748920538764,19.967164444444446,2943.194826666667,13.44261349415353,139,7.300000000000013E-4
10,test_20231101_140600,11551286.png,271883,24,271859,0.9999117267353972,1,3,40092,1,40091,0.9999750573680535,24.866876444444443,3470.407338666667,12.72699907819776,139,7.300000000000013E-4
1,test_20231101_140601,10404007.png,502730,8464,494266,0.9831639249696656,2,4,61265,1241,60024,0.9797437362278626,27.621063111111113,3955.2525333333333,12.159061434939156,139,7.400000000000013E-4
2,test_20231101_140601,1254659.png,342646,47977,294669,0.8599808548764614,3,4,80080,6793,73287,0.9151723276723277,24.672812444444446,4427.7978613333335,11.668925747026284,139,7.400000000000013E-4
3,test_20231101_140601,10188041.png,221231,6314,214917,0.9714596959738916,2,3,41731,894,40837,0.9785770769931226,12.843704888888889,1606.2872853333333,16.072571391798796,139,7.400000000000013E-4
4,test_20231101_140601,10287332.png,216980,7027,209953,0.9676145266844871,2,3,22337,961,21376,0.956977212696423,12.978871111111111,1858.3797813333333,15.439458890558925,139,7.400000000000013E-4
5,test_20231101_140601,11610969.png,368720,8597,360123,0.9766842048166631,1,4,84111,1272,82839,0.9848771266540642,38.41986311111111,7015.829242666667,9.670013506168356,139,7.400000000000013E-4
6,test_20231101_140601,10350842.png,212614,2062,210552,0.9903016734551817,2,3,42529,302,42227,0.9928989630604999,26.531779555555556,4136.800586666666,11.964157745137602,139,7.400000000000013E-4
7,test_20231101_140601,10863862.png,317432,4062,313370,0.9872035585574234,1,3,66058,597,65461,0.9909624875109752,43.631761777777776,8773.53984,8.699055083450858,139,7.400000000000013E-4
8,test_20231101_140601,11382381.png,312486,327,312159,0.9989535531191798,2,3,46745,44,46701,0.9990587228580596,23.441726222222222,2963.055792,13.413405318888326,139,7.400000000000013E-4
9,test_20231101_140601,11079715.png,443815,84554,359261,0.8094836812635895,3,4,124136,11945,112191,0.9037748920538764,19.967164444444446,2943.194826666667,13.44261349415353,139,7.400000000000013E-4
10,test_20231101_140601,11551286.png,271883,24,271859,0.9999117267353972,1,4,40092,1,40091,0.9999750573680535,24.866876444444443,3470.407338666667,12.72699907819776,139,7.400000000000013E-4
1,test_20231101_140601,10404007.png,502730,8464,494266,0.9831639249696656,1,3,61265,1241,60024,0.9797437362278626,27.621063111111113,3955.2525333333333,12.159061434939156,139,7.500000000000013E-4
2,test_20231101_140601,1254659.png,342646,47977,294669,0.8599808548764614,3,4,80080,6793,73287,0.9151723276723277,24.672812444444446,4427.7978613333335,11.668925747026284,139,7.500000000000013E-4
3,test_20231101_140601,10188041.png,221231,6314,214917,0.9714596959738916,2,3,41731,894,40837,0.9785770769931226,12.843704888888889,1606.2872853333333,16.072571391798796,139,7.500000000000013E-4
4,test_20231101_140601,10287332.png,216980,7027,209953,0.9676145266844871,1,3,22337,961,21376,0.956977212696423,12.978871111111111,1858.3797813333333,15.439458890558925,139,7.500000000000013E-4
5,test_20231101_140601,11610969.png,368720,8597,360123,0.9766842048166631,2,3,84111,1272,82839,0.9848771266540642,38.41986311111111,7015.829242666667,9.670013506168356,139,7.500000000000013E-4
6,test_20231101_140601,10350842.png,212614,24,212590,0.9998871193806617,1,3,42529,1,42528,0.9999764866326507,55.22670577777778,11938.01408,7.361482740939017,139,7.500000000000013E-4
7,test_20231101_140601,10863862.png,317432,4062,313370,0.9872035585574234,2,3,66058,597,65461,0.9909624875109752,43.631761777777776,8773.53984,8.699055083450858,139,7.500000000000013E-4
8,test_20231101_140601,11382381.png,312486,327,312159,0.9989535531191798,2,3,46745,44,46701,0.9990587228580596,23.441726222222222,2963.055792,13.413405318888326,139,7.500000000000013E-4
9,test_20231101_140601,11079715.png,443815,84554,359261,0.8094836812635895,3,4,124136,11945,112191,0.9037748920538764,19.967164444444446,2943.194826666667,13.44261349415353,139,7.500000000000013E-4
10,test_20231101_140601,11551286.png,271883,24,271859,0.9999117267353972,1,4,40092,1,40091,0.9999750573680535,24.866876444444443,3470.407338666667,12.72699907819776,139,7.500000000000013E-4
1,test_20231101_140602,10404007.png,502730,8142,494588,0.9838044278240805,2,4,61265,1195,60070,0.980494572757692,27.700810666666666,3978.1068586666665,12.134039160397823,139,7.600000000000013E-4
2,test_20231101_140602,1254659.png,342646,47977,294669,0.8599808548764614,3,4,80080,6793,73287,0.9151723276723277,24.672812444444446,4427.7978613333335,11.668925747026284,139,7.600000000000013E-4
3,test_20231101_140602,10188041.png,221231,6314,214917,0.9714596959738916,2,4,41731,894,40837,0.9785770769931226,12.843704888888889,1606.2872853333333,16.072571391798796,139,7.600000000000013E-4
4,test_20231101_140602,10287332.png,216980,6887,210093,0.9682597474421606,1,3,22337,940,21397,0.9579173568518602,13.046522666666666,1869.3787466666668,15.4138306006522,139,7.600000000000013E-4
5,test_20231101_140602,11610969.png,368720,8597,360123,0.9766842048166631,2,3,84111,1272,82839,0.9848771266540642,38.41986311111111,7015.829242666667,9.670013506168356,139,7.600000000000013E-4
6,test_20231101_140602,10350842.png,212614,24,212590,0.9998871193806617,0,3,42529,1,42528,0.9999764866326507,55.22670577777778,11938.01408,7.361482740939017,139,7.600000000000013E-4
7,test_20231101_140602,10863862.png,317432,3902,313530,0.9877076035182338,1,3,66058,574,65484,0.9913106663840867,44.32498488888889,8955.042634666666,8.610127030160378,139,7.600000000000013E-4
8,test_20231101_140602,11382381.png,312486,327,312159,0.9989535531191798,1,3,46745,44,46701,0.9990587228580596,23.441726222222222,2963.055792,13.413405318888326,139,7.600000000000013E-4
9,test_20231101_140602,11079715.png,443815,84554,359261,0.8094836812635895,3,4,124136,11945,112191,0.9037748920538764,19.967164444444446,2943.194826666667,13.44261349415353,139,7.600000000000013E-4
10,test_20231101_140602,11551286.png,271883,24,271859,0.9999117267353972,0,3,40092,1,40091,0.9999750573680535,24.866876444444443,3470.407338666667,12.72699907819776,139,7.600000000000013E-4
1,test_20231101_140603,10404007.png,502730,8142,494588,0.9838044278240805,2,3,61265,1195,60070,0.980494572757692,27.700810666666666,3978.1068586666665,12.134039160397823,139,7.700000000000014E-4
2,test_20231101_140603,1254659.png,342646,47977,294669,0.8599808548764614,4,4,80080,6793,73287,0.9151723276723277,24.672812444444446,4427.7978613333335,11.668925747026284,139,7.700000000000014E-4
3,test_20231101_140603,10188041.png,221231,6314,214917,0.9714596959738916,2,3,41731,894,40837,0.9785770769931226,12.843704888888889,1606.2872853333333,16.072571391798796,139,7.700000000000014E-4
4,test_20231101_140603,10287332.png,216980,6887,210093,0.9682597474421606,2,4,22337,940,21397,0.9579173568518602,13.046522666666666,1869.3787466666668,15.4138306006522,139,7.700000000000014E-4
5,test_20231101_140603,11610969.png,368720,8597,360123,0.9766842048166631,2,3,84111,1272,82839,0.9848771266540642,38.41986311111111,7015.829242666667,9.670013506168356,139,7.700000000000014E-4
6,test_20231101_140603,10350842.png,212614,24,212590,0.9998871193806617,1,4,42529,1,42528,0.9999764866326507,55.22670577777778,11938.01408,7.361482740939017,139,7.700000000000014E-4
7,test_20231101_140603,10863862.png,317432,3902,313530,0.9877076035182338,2,3,66058,574,65484,0.9913106663840867,44.32498488888889,8955.042634666666,8.610127030160378,139,7.700000000000014E-4
8,test_20231101_140603,11382381.png,312486,327,312159,0.9989535531191798,1,4,46745,44,46701,0.9990587228580596,23.441726222222222,2963.055792,13.413405318888326,139,7.700000000000014E-4
9,test_20231101_140603,11079715.png,443815,84554,359261,0.8094836812635895,3,4,124136,11945,112191,0.9037748920538764,19.967164444444446,2943.194826666667,13.44261349415353,139,7.700000000000014E-4
10,test_20231101_140603,11551286.png,271883,24,271859,0.9999117267353972,0,3,40092,1,40091,0.9999750573680535,24.866876444444443,3470.407338666667,12.72699907819776,139,7.700000000000014E-4
1,test_20231101_140603,10404007.png,502730,8142,494588,0.9838044278240805,2,4,61265,1195,60070,0.980494572757692,27.700810666666666,3978.1068586666665,12.134039160397823,139,7.800000000000014E-4
2,test_20231101_140603,1254659.png,342646,47977,294669,0.8599808548764614,2,9,80080,6793,73287,0.9151723276723277,24.672812444444446,4427.7978613333335,11.668925747026284,139,7.800000000000014E-4
3,test_20231101_140603,10188041.png,221231,6314,214917,0.9714596959738916,1,3,41731,894,40837,0.9785770769931226,12.843704888888889,1606.2872853333333,16.072571391798796,139,7.800000000000014E-4
4,test_20231101_140603,10287332.png,216980,6887,210093,0.9682597474421606,1,4,22337,940,21397,0.9579173568518602,13.046522666666666,1869.3787466666668,15.4138306006522,139,7.800000000000014E-4
5,test_20231101_140603,11610969.png,368720,8597,360123,0.9766842048166631,2,3,84111,1272,82839,0.9848771266540642,38.41986311111111,7015.829242666667,9.670013506168356,139,7.800000000000014E-4
6,test_20231101_140603,10350842.png,212614,24,212590,0.9998871193806617,1,3,42529,1,42528,0.9999764866326507,55.22670577777778,11938.01408,7.361482740939017,139,7.800000000000014E-4
7,test_20231101_140603,10863862.png,317432,3902,313530,0.9877076035182338,2,6,66058,574,65484,0.9913106663840867,44.32498488888889,8955.042634666666,8.610127030160378,139,7.800000000000014E-4
8,test_20231101_140603,11382381.png,312486,327,312159,0.9989535531191798,2,3,46745,44,46701,0.9990587228580596,23.441726222222222,2963.055792,13.413405318888326,139,7.800000000000014E-4
9,test_20231101_140603,11079715.png,443815,84554,359261,0.8094836812635895,3,4,124136,11945,112191,0.9037748920538764,19.967164444444446,2943.194826666667,13.44261349415353,139,7.800000000000014E-4
10,test_20231101_140603,11551286.png,271883,24,271859,0.9999117267353972,1,8,40092,1,40091,0.9999750573680535,24.866876444444443,3470.407338666667,12.72699907819776,139,7.800000000000014E-4
1,test_20231101_140604,10404007.png,502730,8142,494588,0.9838044278240805,1,3,61265,1195,60070,0.980494572757692,27.700810666666666,3978.1068586666665,12.134039160397823,139,7.900000000000014E-4
2,test_20231101_140604,1254659.png,342646,47977,294669,0.8599808548764614,3,4,80080,6793,73287,0.9151723276723277,24.672812444444446,4427.7978613333335,11.668925747026284,139,7.900000000000014E-4
3,test_20231101_140604,10188041.png,221231,6314,214917,0.9714596959738916,1,3,41731,894,40837,0.9785770769931226,12.843704888888889,1606.2872853333333,16.072571391798796,139,7.900000000000014E-4
4,test_20231101_140604,10287332.png,216980,6887,210093,0.9682597474421606,2,4,22337,940,21397,0.9579173568518602,13.046522666666666,1869.3787466666668,15.4138306006522,139,7.900000000000014E-4
5,test_20231101_140604,11610969.png,368720,8597,360123,0.9766842048166631,2,3,84111,1272,82839,0.9848771266540642,38.41986311111111,7015.829242666667,9.670013506168356,139,7.900000000000014E-4
6,test_20231101_140604,10350842.png,212614,24,212590,0.9998871193806617,1,5,42529,1,42528,0.9999764866326507,55.22670577777778,11938.01408,7.361482740939017,139,7.900000000000014E-4
7,test_20231101_140604,10863862.png,317432,3902,313530,0.9877076035182338,1,4,66058,574,65484,0.9913106663840867,44.32498488888889,8955.042634666666,8.610127030160378,139,7.900000000000014E-4
8,test_20231101_140604,11382381.png,312486,327,312159,0.9989535531191798,2,3,46745,44,46701,0.9990587228580596,23.441726222222222,2963.055792,13.413405318888326,139,7.900000000000014E-4
9,test_20231101_140604,11079715.png,443815,84554,359261,0.8094836812635895,3,7,124136,11945,112191,0.9037748920538764,19.967164444444446,2943.194826666667,13.44261349415353,139,7.900000000000014E-4
10,test_20231101_140604,11551286.png,271883,24,271859,0.9999117267353972,0,3,40092,1,40091,0.9999750573680535,24.866876444444443,3470.407338666667,12.72699907819776,139,7.900000000000014E-4
1,test_20231101_140605,10404007.png,502730,8142,494588,0.9838044278240805,2,4,61265,1195,60070,0.980494572757692,27.700810666666666,3978.1068586666665,12.134039160397823,139,8.000000000000014E-4
2,test_20231101_140605,1254659.png,342646,47977,294669,0.8599808548764614,3,8,80080,6793,73287,0.9151723276723277,24.672812444444446,4427.7978613333335,11.668925747026284,139,8.000000000000014E-4
3,test_20231101_140605,10188041.png,221231,6314,214917,0.9714596959738916,2,3,41731,894,40837,0.9785770769931226,12.843704888888889,1606.2872853333333,16.072571391798796,139,8.000000000000014E-4
4,test_20231101_140605,10287332.png,216980,6887,210093,0.9682597474421606,2,3,22337,940,21397,0.9579173568518602,13.046522666666666,1869.3787466666668,15.4138306006522,139,8.000000000000014E-4
5,test_20231101_140605,11610969.png,368720,8597,360123,0.9766842048166631,1,4,84111,1272,82839,0.9848771266540642,38.41986311111111,7015.829242666667,9.670013506168356,139,8.000000000000014E-4
6,test_20231101_140605,10350842.png,212614,24,212590,0.9998871193806617,1,3,42529,1,42528,0.9999764866326507,55.22670577777778,11938.01408,7.361482740939017,139,8.000000000000014E-4
7,test_20231101_140605,10863862.png,317432,3902,313530,0.9877076035182338,1,3,66058,574,65484,0.9913106663840867,44.32498488888889,8955.042634666666,8.610127030160378,139,8.000000000000014E-4
8,test_20231101_140605,11382381.png,312486,327,312159,0.9989535531191798,1,4,46745,44,46701,0.9990587228580596,23.441726222222222,2963.055792,13.413405318888326,139,8.000000000000014E-4
9,test_20231101_140605,11079715.png,443815,84554,359261,0.8094836812635895,3,5,124136,11945,112191,0.9037748920538764,19.967164444444446,2943.194826666667,13.44261349415353,139,8.000000000000014E-4
10,test_20231101_140605,11551286.png,271883,24,271859,0.9999117267353972,0,4,40092,1,40091,0.9999750573680535,24.866876444444443,3470.407338666667,12.72699907819776,139,8.000000000000014E-4
1,test_20231101_140605,10404007.png,502730,8142,494588,0.9838044278240805,2,4,61265,1195,60070,0.980494572757692,27.700810666666666,3978.1068586666665,12.134039160397823,139,8.100000000000015E-4
2,test_20231101_140605,1254659.png,342646,47977,294669,0.8599808548764614,3,4,80080,6793,73287,0.9151723276723277,24.672812444444446,4427.7978613333335,11.668925747026284,139,8.100000000000015E-4
3,test_20231101_140605,10188041.png,221231,6314,214917,0.9714596959738916,1,3,41731,894,40837,0.9785770769931226,12.843704888888889,1606.2872853333333,16.072571391798796,139,8.100000000000015E-4
4,test_20231101_140605,10287332.png,216980,6887,210093,0.9682597474421606,3,3,22337,940,21397,0.9579173568518602,13.046522666666666,1869.3787466666668,15.4138306006522,139,8.100000000000015E-4
5,test_20231101_140605,11610969.png,368720,8597,360123,0.9766842048166631,2,3,84111,1272,82839,0.9848771266540642,38.41986311111111,7015.829242666667,9.670013506168356,139,8.100000000000015E-4
6,test_20231101_140605,10350842.png,212614,24,212590,0.9998871193806617,0,4,42529,1,42528,0.9999764866326507,55.22670577777778,11938.01408,7.361482740939017,139,8.100000000000015E-4
7,test_20231101_140605,10863862.png,317432,3902,313530,0.9877076035182338,2,3,66058,574,65484,0.9913106663840867,44.32498488888889,8955.042634666666,8.610127030160378,139,8.100000000000015E-4
8,test_20231101_140605,11382381.png,312486,327,312159,0.9989535531191798,2,3,46745,44,46701,0.9990587228580596,23.441726222222222,2963.055792,13.413405318888326,139,8.100000000000015E-4
9,test_20231101_140605,11079715.png,443815,84554,359261,0.8094836812635895,3,11,124136,11945,112191,0.9037748920538764,19.967164444444446,2943.194826666667,13.44261349415353,139,8.100000000000015E-4
10,test_20231101_140605,11551286.png,271883,24,271859,0.9999117267353972,1,3,40092,1,40091,0.9999750573680535,24.866876444444443,3470.407338666667,12.72699907819776,139,8.100000000000015E-4
1,test_20231101_140606,10404007.png,502730,8142,494588,0.9838044278240805,2,3,61265,1195,60070,0.980494572757692,27.700810666666666,3978.1068586666665,12.134039160397823,139,8.200000000000015E-4
2,test_20231101_140606,1254659.png,342646,47977,294669,0.8599808548764614,3,4,80080,6793,73287,0.9151723276723277,24.672812444444446,4427.7978613333335,11.668925747026284,139,8.200000000000015E-4
3,test_20231101_140606,10188041.png,221231,6314,214917,0.9714596959738916,2,4,41731,894,40837,0.9785770769931226,12.843704888888889,1606.2872853333333,16.072571391798796,139,8.200000000000015E-4
4,test_20231101_140606,10287332.png,216980,6887,210093,0.9682597474421606,2,4,22337,940,21397,0.9579173568518602,13.046522666666666,1869.3787466666668,15.4138306006522,139,8.200000000000015E-4
5,test_20231101_140606,11610969.png,368720,8597,360123,0.9766842048166631,2,4,84111,1272,82839,0.9848771266540642,38.41986311111111,7015.829242666667,9.670013506168356,139,8.200000000000015E-4
6,test_20231101_140606,10350842.png,212614,24,212590,0.9998871193806617,1,4,42529,1,42528,0.9999764866326507,55.22670577777778,11938.01408,7.361482740939017,139,8.200000000000015E-4
7,test_20231101_140606,10863862.png,317432,3902,313530,0.9877076035182338,1,3,66058,574,65484,0.9913106663840867,44.32498488888889,8955.042634666666,8.610127030160378,139,8.200000000000015E-4
8,test_20231101_140606,11382381.png,312486,327,312159,0.9989535531191798,1,4,46745,44,46701,0.9990587228580596,23.441726222222222,2963.055792,13.413405318888326,139,8.200000000000015E-4
9,test_20231101_140606,11079715.png,443815,84554,359261,0.8094836812635895,4,4,124136,11945,112191,0.9037748920538764,19.967164444444446,2943.194826666667,13.44261349415353,139,8.200000000000015E-4
10,test_20231101_140606,11551286.png,271883,24,271859,0.9999117267353972,1,3,40092,1,40091,0.9999750573680535,24.866876444444443,3470.407338666667,12.72699907819776,139,8.200000000000015E-4
1,test_20231101_140607,10404007.png,502730,8142,494588,0.9838044278240805,2,3,61265,1195,60070,0.980494572757692,27.700810666666666,3978.1068586666665,12.134039160397823,139,8.300000000000015E-4
2,test_20231101_140607,1254659.png,342646,47977,294669,0.8599808548764614,3,4,80080,6793,73287,0.9151723276723277,24.672812444444446,4427.7978613333335,11.668925747026284,139,8.300000000000015E-4
3,test_20231101_140607,10188041.png,221231,6314,214917,0.9714596959738916,2,4,41731,894,40837,0.9785770769931226,12.843704888888889,1606.2872853333333,16.072571391798796,139,8.300000000000015E-4
4,test_20231101_140607,10287332.png,216980,6887,210093,0.9682597474421606,2,5,22337,940,21397,0.9579173568518602,13.046522666666666,1869.3787466666668,15.4138306006522,139,8.300000000000015E-4
5,test_20231101_140607,11610969.png,368720,8597,360123,0.9766842048166631,2,5,84111,1272,82839,0.9848771266540642,38.41986311111111,7015.829242666667,9.670013506168356,139,8.300000000000015E-4
6,test_20231101_140607,10350842.png,212614,24,212590,0.9998871193806617,0,4,42529,1,42528,0.9999764866326507,55.22670577777778,11938.01408,7.361482740939017,139,8.300000000000015E-4
7,test_20231101_140607,10863862.png,317432,3902,313530,0.9877076035182338,1,4,66058,574,65484,0.9913106663840867,44.32498488888889,8955.042634666666,8.610127030160378,139,8.300000000000015E-4
8,test_20231101_140607,11382381.png,312486,327,312159,0.9989535531191798,1,3,46745,44,46701,0.9990587228580596,23.441726222222222,2963.055792,13.413405318888326,139,8.300000000000015E-4
9,test_20231101_140607,11079715.png,443815,84554,359261,0.8094836812635895,3,4,124136,11945,112191,0.9037748920538764,19.967164444444446,2943.194826666667,13.44261349415353,139,8.300000000000015E-4
10,test_20231101_140607,11551286.png,271883,24,271859,0.9999117267353972,0,3,40092,1,40091,0.9999750573680535,24.866876444444443,3470.407338666667,12.72699907819776,139,8.300000000000015E-4
1,test_20231101_140608,10404007.png,502730,8142,494588,0.9838044278240805,2,4,61265,1195,60070,0.980494572757692,27.700810666666666,3978.1068586666665,12.134039160397823,139,8.400000000000016E-4
2,test_20231101_140608,1254659.png,342646,47977,294669,0.8599808548764614,3,3,80080,6793,73287,0.9151723276723277,24.672812444444446,4427.7978613333335,11.668925747026284,139,8.400000000000016E-4
3,test_20231101_140608,10188041.png,221231,6314,214917,0.9714596959738916,2,4,41731,894,40837,0.9785770769931226,12.843704888888889,1606.2872853333333,16.072571391798796,139,8.400000000000016E-4
4,test_20231101_140608,10287332.png,216980,6887,210093,0.9682597474421606,2,3,22337,940,21397,0.9579173568518602,13.046522666666666,1869.3787466666668,15.4138306006522,139,8.400000000000016E-4
5,test_20231101_140608,11610969.png,368720,8597,360123,0.9766842048166631,2,3,84111,1272,82839,0.9848771266540642,38.41986311111111,7015.829242666667,9.670013506168356,139,8.400000000000016E-4
6,test_20231101_140608,10350842.png,212614,24,212590,0.9998871193806617,1,3,42529,1,42528,0.9999764866326507,55.22670577777778,11938.01408,7.361482740939017,139,8.400000000000016E-4
7,test_20231101_140608,10863862.png,317432,3902,313530,0.9877076035182338,1,4,66058,574,65484,0.9913106663840867,44.32498488888889,8955.042634666666,8.610127030160378,139,8.400000000000016E-4
8,test_20231101_140608,11382381.png,312486,327,312159,0.9989535531191798,1,4,46745,44,46701,0.9990587228580596,23.441726222222222,2963.055792,13.413405318888326,139,8.400000000000016E-4
9,test_20231101_140608,11079715.png,443815,84554,359261,0.8094836812635895,3,5,124136,11945,112191,0.9037748920538764,19.967164444444446,2943.194826666667,13.44261349415353,139,8.400000000000016E-4
10,test_20231101_140608,11551286.png,271883,24,271859,0.9999117267353972,0,3,40092,1,40091,0.9999750573680535,24.866876444444443,3470.407338666667,12.72699907819776,139,8.400000000000016E-4
1,test_20231101_140608,10404007.png,502730,8142,494588,0.9838044278240805,2,4,61265,1195,60070,0.980494572757692,27.700810666666666,3978.1068586666665,12.134039160397823,139,8.500000000000016E-4
2,test_20231101_140608,1254659.png,342646,47977,294669,0.8599808548764614,3,4,80080,6793,73287,0.9151723276723277,24.672812444444446,4427.7978613333335,11.668925747026284,139,8.500000000000016E-4
3,test_20231101_140608,10188041.png,221231,6314,214917,0.9714596959738916,2,4,41731,894,40837,0.9785770769931226,12.843704888888889,1606.2872853333333,16.072571391798796,139,8.500000000000016E-4
4,test_20231101_140608,10287332.png,216980,6887,210093,0.9682597474421606,1,4,22337,940,21397,0.9579173568518602,13.046522666666666,1869.3787466666668,15.4138306006522,139,8.500000000000016E-4
5,test_20231101_140608,11610969.png,368720,8597,360123,0.9766842048166631,2,4,84111,1272,82839,0.9848771266540642,38.41986311111111,7015.829242666667,9.670013506168356,139,8.500000000000016E-4
6,test_20231101_140608,10350842.png,212614,24,212590,0.9998871193806617,0,4,42529,1,42528,0.9999764866326507,55.22670577777778,11938.01408,7.361482740939017,139,8.500000000000016E-4
7,test_20231101_140608,10863862.png,317432,3902,313530,0.9877076035182338,1,4,66058,574,65484,0.9913106663840867,44.32498488888889,8955.042634666666,8.610127030160378,139,8.500000000000016E-4
8,test_20231101_140608,11382381.png,312486,327,312159,0.9989535531191798,2,3,46745,44,46701,0.9990587228580596,23.441726222222222,2963.055792,13.413405318888326,139,8.500000000000016E-4
9,test_20231101_140608,11079715.png,443815,84554,359261,0.8094836812635895,3,4,124136,11945,112191,0.9037748920538764,19.967164444444446,2943.194826666667,13.44261349415353,139,8.500000000000016E-4
10,test_20231101_140608,11551286.png,271883,24,271859,0.9999117267353972,1,3,40092,1,40091,0.9999750573680535,24.866876444444443,3470.407338666667,12.72699907819776,139,8.500000000000016E-4
1,test_20231101_140609,10404007.png,502730,8142,494588,0.9838044278240805,2,3,61265,1195,60070,0.980494572757692,27.700810666666666,3978.1068586666665,12.134039160397823,139,8.600000000000016E-4
2,test_20231101_140609,1254659.png,342646,47977,294669,0.8599808548764614,2,3,80080,6793,73287,0.9151723276723277,24.672812444444446,4427.7978613333335,11.668925747026284,139,8.600000000000016E-4
3,test_20231101_140609,10188041.png,221231,6314,214917,0.9714596959738916,2,4,41731,894,40837,0.9785770769931226,12.843704888888889,1606.2872853333333,16.072571391798796,139,8.600000000000016E-4
4,test_20231101_140609,10287332.png,216980,6887,210093,0.9682597474421606,2,11,22337,940,21397,0.9579173568518602,13.046522666666666,1869.3787466666668,15.4138306006522,139,8.600000000000016E-4
5,test_20231101_140609,11610969.png,368720,8597,360123,0.9766842048166631,4,4,84111,1272,82839,0.9848771266540642,38.41986311111111,7015.829242666667,9.670013506168356,139,8.600000000000016E-4
6,test_20231101_140609,10350842.png,212614,24,212590,0.9998871193806617,0,3,42529,1,42528,0.9999764866326507,55.22670577777778,11938.01408,7.361482740939017,139,8.600000000000016E-4
7,test_20231101_140609,10863862.png,317432,3902,313530,0.9877076035182338,2,3,66058,574,65484,0.9913106663840867,44.32498488888889,8955.042634666666,8.610127030160378,139,8.600000000000016E-4
8,test_20231101_140609,11382381.png,312486,327,312159,0.9989535531191798,2,3,46745,44,46701,0.9990587228580596,23.441726222222222,2963.055792,13.413405318888326,139,8.600000000000016E-4
9,test_20231101_140609,11079715.png,443815,84554,359261,0.8094836812635895,3,4,124136,11945,112191,0.9037748920538764,19.967164444444446,2943.194826666667,13.44261349415353,139,8.600000000000016E-4
10,test_20231101_140609,11551286.png,271883,24,271859,0.9999117267353972,1,3,40092,1,40091,0.9999750573680535,24.866876444444443,3470.407338666667,12.72699907819776,139,8.600000000000016E-4
1,test_20231101_140610,10404007.png,502730,8142,494588,0.9838044278240805,1,4,61265,1195,60070,0.980494572757692,27.700810666666666,3978.1068586666665,12.134039160397823,139,8.700000000000016E-4
2,test_20231101_140610,1254659.png,342646,47977,294669,0.8599808548764614,3,4,80080,6793,73287,0.9151723276723277,24.672812444444446,4427.7978613333335,11.668925747026284,139,8.700000000000016E-4
3,test_20231101_140610,10188041.png,221231,6314,214917,0.9714596959738916,3,4,41731,894,40837,0.9785770769931226,12.843704888888889,1606.2872853333333,16.072571391798796,139,8.700000000000016E-4
4,test_20231101_140610,10287332.png,216980,6887,210093,0.9682597474421606,2,4,22337,940,21397,0.9579173568518602,13.046522666666666,1869.3787466666668,15.4138306006522,139,8.700000000000016E-4
5,test_20231101_140610,11610969.png,368720,8597,360123,0.9766842048166631,2,4,84111,1272,82839,0.9848771266540642,38.41986311111111,7015.829242666667,9.670013506168356,139,8.700000000000016E-4
6,test_20231101_140610,10350842.png,212614,24,212590,0.9998871193806617,0,4,42529,1,42528,0.9999764866326507,55.22670577777778,11938.01408,7.361482740939017,139,8.700000000000016E-4
7,test_20231101_140610,10863862.png,317432,3902,313530,0.9877076035182338,1,4,66058,574,65484,0.9913106663840867,44.32498488888889,8955.042634666666,8.610127030160378,139,8.700000000000016E-4
8,test_20231101_140610,11382381.png,312486,327,312159,0.9989535531191798,1,4,46745,44,46701,0.9990587228580596,23.441726222222222,2963.055792,13.413405318888326,139,8.700000000000016E-4
9,test_20231101_140610,11079715.png,443815,84554,359261,0.8094836812635895,3,4,124136,11945,112191,0.9037748920538764,19.967164444444446,2943.194826666667,13.44261349415353,139,8.700000000000016E-4
10,test_20231101_140610,11551286.png,271883,24,271859,0.9999117267353972,0,3,40092,1,40091,0.9999750573680535,24.866876444444443,3470.407338666667,12.72699907819776,139,8.700000000000016E-4
1,test_20231101_140610,10404007.png,502730,8142,494588,0.9838044278240805,2,4,61265,1195,60070,0.980494572757692,27.700810666666666,3978.1068586666665,12.134039160397823,139,8.800000000000017E-4
2,test_20231101_140610,1254659.png,342646,47977,294669,0.8599808548764614,2,4,80080,6793,73287,0.9151723276723277,24.672812444444446,4427.7978613333335,11.668925747026284,139,8.800000000000017E-4
3,test_20231101_140610,10188041.png,221231,6314,214917,0.9714596959738916,2,4,41731,894,40837,0.9785770769931226,12.843704888888889,1606.2872853333333,16.072571391798796,139,8.800000000000017E-4
4,test_20231101_140610,10287332.png,216980,6887,210093,0.9682597474421606,1,3,22337,940,21397,0.9579173568518602,13.046522666666666,1869.3787466666668,15.4138306006522,139,8.800000000000017E-4
5,test_20231101_140610,11610969.png,368720,8597,360123,0.9766842048166631,2,3,84111,1272,82839,0.9848771266540642,38.41986311111111,7015.829242666667,9.670013506168356,139,8.800000000000017E-4
6,test_20231101_140610,10350842.png,212614,24,212590,0.9998871193806617,0,4,42529,1,42528,0.9999764866326507,55.22670577777778,11938.01408,7.361482740939017,139,8.800000000000017E-4
7,test_20231101_140610,10863862.png,317432,3902,313530,0.9877076035182338,1,4,66058,574,65484,0.9913106663840867,44.32498488888889,8955.042634666666,8.610127030160378,139,8.800000000000017E-4
8,test_20231101_140610,11382381.png,312486,327,312159,0.9989535531191798,1,3,46745,44,46701,0.9990587228580596,23.441726222222222,2963.055792,13.413405318888326,139,8.800000000000017E-4
9,test_20231101_140610,11079715.png,443815,84554,359261,0.8094836812635895,3,4,124136,11945,112191,0.9037748920538764,19.967164444444446,2943.194826666667,13.44261349415353,139,8.800000000000017E-4
10,test_20231101_140610,11551286.png,271883,24,271859,0.9999117267353972,1,4,40092,1,40091,0.9999750573680535,24.866876444444443,3470.407338666667,12.72699907819776,139,8.800000000000017E-4
1,test_20231101_140611,10404007.png,502730,8142,494588,0.9838044278240805,2,3,61265,1195,60070,0.980494572757692,27.700810666666666,3978.1068586666665,12.134039160397823,139,8.900000000000017E-4
2,test_20231101_140611,1254659.png,342646,47977,294669,0.8599808548764614,2,4,80080,6793,73287,0.9151723276723277,24.672812444444446,4427.7978613333335,11.668925747026284,139,8.900000000000017E-4
3,test_20231101_140611,10188041.png,221231,6314,214917,0.9714596959738916,2,4,41731,894,40837,0.9785770769931226,12.843704888888889,1606.2872853333333,16.072571391798796,139,8.900000000000017E-4
4,test_20231101_140611,10287332.png,216980,6887,210093,0.9682597474421606,1,3,22337,940,21397,0.9579173568518602,13.046522666666666,1869.3787466666668,15.4138306006522,139,8.900000000000017E-4
5,test_20231101_140611,11610969.png,368720,8597,360123,0.9766842048166631,1,3,84111,1272,82839,0.9848771266540642,38.41986311111111,7015.829242666667,9.670013506168356,139,8.900000000000017E-4
6,test_20231101_140611,10350842.png,212614,24,212590,0.9998871193806617,1,4,42529,1,42528,0.9999764866326507,55.22670577777778,11938.01408,7.361482740939017,139,8.900000000000017E-4
7,test_20231101_140611,10863862.png,317432,3902,313530,0.9877076035182338,1,3,66058,574,65484,0.9913106663840867,44.32498488888889,8955.042634666666,8.610127030160378,139,8.900000000000017E-4
8,test_20231101_140611,11382381.png,312486,327,312159,0.9989535531191798,1,4,46745,44,46701,0.9990587228580596,23.441726222222222,2963.055792,13.413405318888326,139,8.900000000000017E-4
9,test_20231101_140611,11079715.png,443815,84554,359261,0.8094836812635895,3,4,124136,11945,112191,0.9037748920538764,19.967164444444446,2943.194826666667,13.44261349415353,139,8.900000000000017E-4
10,test_20231101_140611,11551286.png,271883,24,271859,0.9999117267353972,1,4,40092,1,40091,0.9999750573680535,24.866876444444443,3470.407338666667,12.72699907819776,139,8.900000000000017E-4
1,test_20231101_140612,10404007.png,502730,8142,494588,0.9838044278240805,2,3,61265,1195,60070,0.980494572757692,27.700810666666666,3978.1068586666665,12.134039160397823,139,9.000000000000017E-4
2,test_20231101_140612,1254659.png,342646,47977,294669,0.8599808548764614,3,4,80080,6793,73287,0.9151723276723277,24.672812444444446,4427.7978613333335,11.668925747026284,139,9.000000000000017E-4
3,test_20231101_140612,10188041.png,221231,6314,214917,0.9714596959738916,2,4,41731,894,40837,0.9785770769931226,12.843704888888889,1606.2872853333333,16.072571391798796,139,9.000000000000017E-4
4,test_20231101_140612,10287332.png,216980,6887,210093,0.9682597474421606,2,4,22337,940,21397,0.9579173568518602,13.046522666666666,1869.3787466666668,15.4138306006522,139,9.000000000000017E-4
5,test_20231101_140612,11610969.png,368720,8597,360123,0.9766842048166631,2,4,84111,1272,82839,0.9848771266540642,38.41986311111111,7015.829242666667,9.670013506168356,139,9.000000000000017E-4
6,test_20231101_140612,10350842.png,212614,24,212590,0.9998871193806617,1,4,42529,1,42528,0.9999764866326507,55.22670577777778,11938.01408,7.361482740939017,139,9.000000000000017E-4
7,test_20231101_140612,10863862.png,317432,3902,313530,0.9877076035182338,2,4,66058,574,65484,0.9913106663840867,44.32498488888889,8955.042634666666,8.610127030160378,139,9.000000000000017E-4
8,test_20231101_140612,11382381.png,312486,327,312159,0.9989535531191798,1,4,46745,44,46701,0.9990587228580596,23.441726222222222,2963.055792,13.413405318888326,139,9.000000000000017E-4
9,test_20231101_140612,11079715.png,443815,84554,359261,0.8094836812635895,3,4,124136,11945,112191,0.9037748920538764,19.967164444444446,2943.194826666667,13.44261349415353,139,9.000000000000017E-4
10,test_20231101_140612,11551286.png,271883,24,271859,0.9999117267353972,1,4,40092,1,40091,0.9999750573680535,24.866876444444443,3470.407338666667,12.72699907819776,139,9.000000000000017E-4
1,test_20231101_140612,10404007.png,502730,8142,494588,0.9838044278240805,2,13,61265,1195,60070,0.980494572757692,27.700810666666666,3978.1068586666665,12.134039160397823,139,9.100000000000017E-4
2,test_20231101_140612,1254659.png,342646,47977,294669,0.8599808548764614,3,4,80080,6793,73287,0.9151723276723277,24.672812444444446,4427.7978613333335,11.668925747026284,139,9.100000000000017E-4
3,test_20231101_140612,10188041.png,221231,6314,214917,0.9714596959738916,1,3,41731,894,40837,0.9785770769931226,12.843704888888889,1606.2872853333333,16.072571391798796,139,9.100000000000017E-4
4,test_20231101_140612,10287332.png,216980,6887,210093,0.9682597474421606,1,3,22337,940,21397,0.9579173568518602,13.046522666666666,1869.3787466666668,15.4138306006522,139,9.100000000000017E-4
5,test_20231101_140612,11610969.png,368720,8597,360123,0.9766842048166631,1,3,84111,1272,82839,0.9848771266540642,38.41986311111111,7015.829242666667,9.670013506168356,139,9.100000000000017E-4
6,test_20231101_140612,10350842.png,212614,24,212590,0.9998871193806617,1,4,42529,1,42528,0.9999764866326507,55.22670577777778,11938.01408,7.361482740939017,139,9.100000000000017E-4
7,test_20231101_140612,10863862.png,317432,3902,313530,0.9877076035182338,1,4,66058,574,65484,0.9913106663840867,44.32498488888889,8955.042634666666,8.610127030160378,139,9.100000000000017E-4
8,test_20231101_140612,11382381.png,312486,327,312159,0.9989535531191798,2,3,46745,44,46701,0.9990587228580596,23.441726222222222,2963.055792,13.413405318888326,139,9.100000000000017E-4
9,test_20231101_140612,11079715.png,443815,84554,359261,0.8094836812635895,3,4,124136,11945,112191,0.9037748920538764,19.967164444444446,2943.194826666667,13.44261349415353,139,9.100000000000017E-4
10,test_20231101_140612,11551286.png,271883,24,271859,0.9999117267353972,1,4,40092,1,40091,0.9999750573680535,24.866876444444443,3470.407338666667,12.72699907819776,139,9.100000000000017E-4
1,test_20231101_140613,10404007.png,502730,8142,494588,0.9838044278240805,2,4,61265,1195,60070,0.980494572757692,27.700810666666666,3978.1068586666665,12.134039160397823,139,9.200000000000018E-4
2,test_20231101_140613,1254659.png,342646,47977,294669,0.8599808548764614,3,4,80080,6793,73287,0.9151723276723277,24.672812444444446,4427.7978613333335,11.668925747026284,139,9.200000000000018E-4
3,test_20231101_140613,10188041.png,221231,6314,214917,0.9714596959738916,1,3,41731,894,40837,0.9785770769931226,12.843704888888889,1606.2872853333333,16.072571391798796,139,9.200000000000018E-4
4,test_20231101_140613,10287332.png,216980,6887,210093,0.9682597474421606,2,4,22337,940,21397,0.9579173568518602,13.046522666666666,1869.3787466666668,15.4138306006522,139,9.200000000000018E-4
5,test_20231101_140613,11610969.png,368720,8597,360123,0.9766842048166631,2,3,84111,1272,82839,0.9848771266540642,38.41986311111111,7015.829242666667,9.670013506168356,139,9.200000000000018E-4
6,test_20231101_140613,10350842.png,212614,24,212590,0.9998871193806617,0,3,42529,1,42528,0.9999764866326507,55.22670577777778,11938.01408,7.361482740939017,139,9.200000000000018E-4
7,test_20231101_140613,10863862.png,317432,3902,313530,0.9877076035182338,2,4,66058,574,65484,0.9913106663840867,44.32498488888889,8955.042634666666,8.610127030160378,139,9.200000000000018E-4
8,test_20231101_140613,11382381.png,312486,327,312159,0.9989535531191798,2,3,46745,44,46701,0.9990587228580596,23.441726222222222,2963.055792,13.413405318888326,139,9.200000000000018E-4
9,test_20231101_140613,11079715.png,443815,84554,359261,0.8094836812635895,3,4,124136,11945,112191,0.9037748920538764,19.967164444444446,2943.194826666667,13.44261349415353,139,9.200000000000018E-4
10,test_20231101_140613,11551286.png,271883,24,271859,0.9999117267353972,1,4,40092,1,40091,0.9999750573680535,24.866876444444443,3470.407338666667,12.72699907819776,139,9.200000000000018E-4
1,test_20231101_140614,10404007.png,502730,8142,494588,0.9838044278240805,2,4,61265,1195,60070,0.980494572757692,27.700810666666666,3978.1068586666665,12.134039160397823,139,9.300000000000018E-4
2,test_20231101_140614,1254659.png,342646,47977,294669,0.8599808548764614,3,4,80080,6793,73287,0.9151723276723277,24.672812444444446,4427.7978613333335,11.668925747026284,139,9.300000000000018E-4
3,test_20231101_140614,10188041.png,221231,6314,214917,0.9714596959738916,2,4,41731,894,40837,0.9785770769931226,12.843704888888889,1606.2872853333333,16.072571391798796,139,9.300000000000018E-4
4,test_20231101_140614,10287332.png,216980,6887,210093,0.9682597474421606,2,4,22337,940,21397,0.9579173568518602,13.046522666666666,1869.3787466666668,15.4138306006522,139,9.300000000000018E-4
5,test_20231101_140614,11610969.png,368720,8597,360123,0.9766842048166631,1,3,84111,1272,82839,0.9848771266540642,38.41986311111111,7015.829242666667,9.670013506168356,139,9.300000000000018E-4
6,test_20231101_140614,10350842.png,212614,24,212590,0.9998871193806617,0,3,42529,1,42528,0.9999764866326507,55.22670577777778,11938.01408,7.361482740939017,139,9.300000000000018E-4
7,test_20231101_140614,10863862.png,317432,3902,313530,0.9877076035182338,1,3,66058,574,65484,0.9913106663840867,44.32498488888889,8955.042634666666,8.610127030160378,139,9.300000000000018E-4
8,test_20231101_140614,11382381.png,312486,327,312159,0.9989535531191798,2,3,46745,44,46701,0.9990587228580596,23.441726222222222,2963.055792,13.413405318888326,139,9.300000000000018E-4
9,test_20231101_140614,11079715.png,443815,84554,359261,0.8094836812635895,3,5,124136,11945,112191,0.9037748920538764,19.967164444444446,2943.194826666667,13.44261349415353,139,9.300000000000018E-4
10,test_20231101_140614,11551286.png,271883,24,271859,0.9999117267353972,1,13,40092,1,40091,0.9999750573680535,24.866876444444443,3470.407338666667,12.72699907819776,139,9.300000000000018E-4
1,test_20231101_140614,10404007.png,502730,8142,494588,0.9838044278240805,2,3,61265,1195,60070,0.980494572757692,27.700810666666666,3978.1068586666665,12.134039160397823,139,9.400000000000018E-4
2,test_20231101_140614,1254659.png,342646,47977,294669,0.8599808548764614,3,4,80080,6793,73287,0.9151723276723277,24.672812444444446,4427.7978613333335,11.668925747026284,139,9.400000000000018E-4
3,test_20231101_140614,10188041.png,221231,6314,214917,0.9714596959738916,2,3,41731,894,40837,0.9785770769931226,12.843704888888889,1606.2872853333333,16.072571391798796,139,9.400000000000018E-4
4,test_20231101_140614,10287332.png,216980,6887,210093,0.9682597474421606,2,4,22337,940,21397,0.9579173568518602,13.046522666666666,1869.3787466666668,15.4138306006522,139,9.400000000000018E-4
5,test_20231101_140614,11610969.png,368720,8597,360123,0.9766842048166631,2,3,84111,1272,82839,0.9848771266540642,38.41986311111111,7015.829242666667,9.670013506168356,139,9.400000000000018E-4
6,test_20231101_140614,10350842.png,212614,24,212590,0.9998871193806617,1,3,42529,1,42528,0.9999764866326507,55.22670577777778,11938.01408,7.361482740939017,139,9.400000000000018E-4
7,test_20231101_140614,10863862.png,317432,3902,313530,0.9877076035182338,1,4,66058,574,65484,0.9913106663840867,44.32498488888889,8955.042634666666,8.610127030160378,139,9.400000000000018E-4
8,test_20231101_140614,11382381.png,312486,327,312159,0.9989535531191798,1,4,46745,44,46701,0.9990587228580596,23.441726222222222,2963.055792,13.413405318888326,139,9.400000000000018E-4
9,test_20231101_140614,11079715.png,443815,84554,359261,0.8094836812635895,3,4,124136,11945,112191,0.9037748920538764,19.967164444444446,2943.194826666667,13.44261349415353,139,9.400000000000018E-4
10,test_20231101_140614,11551286.png,271883,24,271859,0.9999117267353972,0,4,40092,1,40091,0.9999750573680535,24.866876444444443,3470.407338666667,12.72699907819776,139,9.400000000000018E-4
1,test_20231101_140615,10404007.png,502730,8142,494588,0.9838044278240805,1,3,61265,1195,60070,0.980494572757692,27.700810666666666,3978.1068586666665,12.134039160397823,139,9.500000000000018E-4
2,test_20231101_140615,1254659.png,342646,47977,294669,0.8599808548764614,2,4,80080,6793,73287,0.9151723276723277,24.672812444444446,4427.7978613333335,11.668925747026284,139,9.500000000000018E-4
3,test_20231101_140615,10188041.png,221231,6314,214917,0.9714596959738916,2,4,41731,894,40837,0.9785770769931226,12.843704888888889,1606.2872853333333,16.072571391798796,139,9.500000000000018E-4
4,test_20231101_140615,10287332.png,216980,6887,210093,0.9682597474421606,2,4,22337,940,21397,0.9579173568518602,13.046522666666666,1869.3787466666668,15.4138306006522,139,9.500000000000018E-4
5,test_20231101_140615,11610969.png,368720,8597,360123,0.9766842048166631,2,4,84111,1272,82839,0.9848771266540642,38.41986311111111,7015.829242666667,9.670013506168356,139,9.500000000000018E-4
6,test_20231101_140615,10350842.png,212614,24,212590,0.9998871193806617,1,4,42529,1,42528,0.9999764866326507,55.22670577777778,11938.01408,7.361482740939017,139,9.500000000000018E-4
7,test_20231101_140615,10863862.png,317432,3902,313530,0.9877076035182338,1,4,66058,574,65484,0.9913106663840867,44.32498488888889,8955.042634666666,8.610127030160378,139,9.500000000000018E-4
8,test_20231101_140615,11382381.png,312486,327,312159,0.9989535531191798,1,4,46745,44,46701,0.9990587228580596,23.441726222222222,2963.055792,13.413405318888326,139,9.500000000000018E-4
9,test_20231101_140615,11079715.png,443815,84554,359261,0.8094836812635895,3,4,124136,11945,112191,0.9037748920538764,19.967164444444446,2943.194826666667,13.44261349415353,139,9.500000000000018E-4
10,test_20231101_140615,11551286.png,271883,24,271859,0.9999117267353972,1,4,40092,1,40091,0.9999750573680535,24.866876444444443,3470.407338666667,12.72699907819776,139,9.500000000000018E-4
1,test_20231101_140616,10404007.png,502730,8142,494588,0.9838044278240805,2,4,61265,1195,60070,0.980494572757692,27.700810666666666,3978.1068586666665,12.134039160397823,139,9.600000000000019E-4
2,test_20231101_140616,1254659.png,342646,47977,294669,0.8599808548764614,2,4,80080,6793,73287,0.9151723276723277,24.672812444444446,4427.7978613333335,11.668925747026284,139,9.600000000000019E-4
3,test_20231101_140616,10188041.png,221231,6314,214917,0.9714596959738916,2,4,41731,894,40837,0.9785770769931226,12.843704888888889,1606.2872853333333,16.072571391798796,139,9.600000000000019E-4
4,test_20231101_140616,10287332.png,216980,6887,210093,0.9682597474421606,1,4,22337,940,21397,0.9579173568518602,13.046522666666666,1869.3787466666668,15.4138306006522,139,9.600000000000019E-4
5,test_20231101_140616,11610969.png,368720,8597,360123,0.9766842048166631,2,3,84111,1272,82839,0.9848771266540642,38.41986311111111,7015.829242666667,9.670013506168356,139,9.600000000000019E-4
6,test_20231101_140616,10350842.png,212614,24,212590,0.9998871193806617,1,4,42529,1,42528,0.9999764866326507,55.22670577777778,11938.01408,7.361482740939017,139,9.600000000000019E-4
7,test_20231101_140616,10863862.png,317432,3882,313550,0.9877706091383351,1,3,66058,571,65487,0.99135608101971,44.64552888888889,9007.583786666666,8.58472050337778,139,9.600000000000019E-4
8,test_20231101_140616,11382381.png,312486,327,312159,0.9989535531191798,1,3,46745,44,46701,0.9990587228580596,23.441726222222222,2963.055792,13.413405318888326,139,9.600000000000019E-4
9,test_20231101_140616,11079715.png,443815,84554,359261,0.8094836812635895,3,4,124136,11945,112191,0.9037748920538764,19.967164444444446,2943.194826666667,13.44261349415353,139,9.600000000000019E-4
10,test_20231101_140616,11551286.png,271883,24,271859,0.9999117267353972,1,4,40092,1,40091,0.9999750573680535,24.866876444444443,3470.407338666667,12.72699907819776,139,9.600000000000019E-4
1,test_20231101_140616,10404007.png,502730,8142,494588,0.9838044278240805,2,3,61265,1195,60070,0.980494572757692,27.700810666666666,3978.1068586666665,12.134039160397823,139,9.700000000000019E-4
2,test_20231101_140616,1254659.png,342646,47977,294669,0.8599808548764614,2,4,80080,6793,73287,0.9151723276723277,24.672812444444446,4427.7978613333335,11.668925747026284,139,9.700000000000019E-4
3,test_20231101_140616,10188041.png,221231,6314,214917,0.9714596959738916,2,4,41731,894,40837,0.9785770769931226,12.843704888888889,1606.2872853333333,16.072571391798796,139,9.700000000000019E-4
4,test_20231101_140616,10287332.png,216980,6887,210093,0.9682597474421606,2,3,22337,940,21397,0.9579173568518602,13.046522666666666,1869.3787466666668,15.4138306006522,139,9.700000000000019E-4
5,test_20231101_140616,11610969.png,368720,8597,360123,0.9766842048166631,2,4,84111,1272,82839,0.9848771266540642,38.41986311111111,7015.829242666667,9.670013506168356,139,9.700000000000019E-4
6,test_20231101_140616,10350842.png,212614,24,212590,0.9998871193806617,1,4,42529,1,42528,0.9999764866326507,55.22670577777778,11938.01408,7.361482740939017,139,9.700000000000019E-4
7,test_20231101_140616,10863862.png,317432,3882,313550,0.9877706091383351,1,4,66058,571,65487,0.99135608101971,44.64552888888889,9007.583786666666,8.58472050337778,139,9.700000000000019E-4
8,test_20231101_140616,11382381.png,312486,327,312159,0.9989535531191798,2,4,46745,44,46701,0.9990587228580596,23.441726222222222,2963.055792,13.413405318888326,139,9.700000000000019E-4
9,test_20231101_140616,11079715.png,443815,84554,359261,0.8094836812635895,3,4,124136,11945,112191,0.9037748920538764,19.967164444444446,2943.194826666667,13.44261349415353,139,9.700000000000019E-4
10,test_20231101_140616,11551286.png,271883,24,271859,0.9999117267353972,1,4,40092,1,40091,0.9999750573680535,24.866876444444443,3470.407338666667,12.72699907819776,139,9.700000000000019E-4
1,test_20231101_140617,10404007.png,502730,7642,495088,0.9847989974737931,1,4,61265,1121,60144,0.981702440218722,27.776576,3999.9172906666668,12.110293496845582,139,9.80000000000002E-4
2,test_20231101_140617,1254659.png,342646,47514,295132,0.8613321036871874,2,3,80080,6743,73337,0.9157967032967033,25.101029333333333,4552.587056,11.548221016060209,139,9.80000000000002E-4
3,test_20231101_140617,10188041.png,221231,6152,215079,0.9721919622476054,2,4,41731,878,40853,0.9789604850111427,12.931296,1625.493696,16.020950713161234,139,9.80000000000002E-4
4,test_20231101_140617,10287332.png,216980,6807,210173,0.968628445017974,1,4,22337,928,21409,0.9584545820835385,13.072083555555556,1873.54872,15.404153698421247,139,9.80000000000002E-4
5,test_20231101_140617,11610969.png,368720,8577,360143,0.9767384465176828,2,4,84111,1269,82842,0.9849127938081821,38.42181155555556,7016.133445333333,9.6698252024471,139,9.80000000000002E-4
6,test_20231101_140617,10350842.png,212614,24,212590,0.9998871193806617,0,4,42529,1,42528,0.9999764866326507,55.22670577777778,11938.01408,7.361482740939017,139,9.80000000000002E-4
7,test_20231101_140617,10863862.png,317432,3722,313710,0.9882746540991456,1,4,66058,547,65511,0.9917193981046959,44.826364444444444,9054.489877333333,8.562163733299148,139,9.80000000000002E-4
8,test_20231101_140617,11382381.png,312486,327,312159,0.9989535531191798,2,3,46745,44,46701,0.9990587228580596,23.441726222222222,2963.055792,13.413405318888326,139,9.80000000000002E-4
9,test_20231101_140617,11079715.png,443815,84514,359301,0.8095738089068644,3,4,124136,11939,112197,0.9038232261390733,19.99848888888889,2947.509973333333,13.436250775990686,139,9.80000000000002E-4
10,test_20231101_140617,11551286.png,271883,24,271859,0.9999117267353972,1,4,40092,1,40091,0.9999750573680535,24.866876444444443,3470.407338666667,12.72699907819776,139,9.80000000000002E-4
1,test_20231101_140618,10404007.png,502730,7642,495088,0.9847989974737931,2,4,61265,1121,60144,0.981702440218722,27.776576,3999.9172906666668,12.110293496845582,139,9.90000000000002E-4
2,test_20231101_140618,1254659.png,342646,47514,295132,0.8613321036871874,2,3,80080,6743,73337,0.9157967032967033,25.101029333333333,4552.587056,11.548221016060209,139,9.90000000000002E-4
3,test_20231101_140618,10188041.png,221231,6152,215079,0.9721919622476054,2,3,41731,878,40853,0.9789604850111427,12.931296,1625.493696,16.020950713161234,139,9.90000000000002E-4
4,test_20231101_140618,10287332.png,216980,6807,210173,0.968628445017974,2,4,22337,928,21409,0.9584545820835385,13.072083555555556,1873.54872,15.404153698421247,139,9.90000000000002E-4
5,test_20231101_140618,11610969.png,368720,8577,360143,0.9767384465176828,2,4,84111,1269,82842,0.9849127938081821,38.42181155555556,7016.133445333333,9.6698252024471,139,9.90000000000002E-4
6,test_20231101_140618,10350842.png,212614,24,212590,0.9998871193806617,0,4,42529,1,42528,0.9999764866326507,55.22670577777778,11938.01408,7.361482740939017,139,9.90000000000002E-4
7,test_20231101_140618,10863862.png,317432,3722,313710,0.9882746540991456,2,3,66058,547,65511,0.9917193981046959,44.826364444444444,9054.489877333333,8.562163733299148,139,9.90000000000002E-4
8,test_20231101_140618,11382381.png,312486,327,312159,0.9989535531191798,2,3,46745,44,46701,0.9990587228580596,23.441726222222222,2963.055792,13.413405318888326,139,9.90000000000002E-4
9,test_20231101_140618,11079715.png,443815,84514,359301,0.8095738089068644,3,4,124136,11939,112197,0.9038232261390733,19.99848888888889,2947.509973333333,13.436250775990686,139,9.90000000000002E-4
10,test_20231101_140618,11551286.png,271883,24,271859,0.9999117267353972,1,4,40092,1,40091,0.9999750573680535,24.866876444444443,3470.407338666667,12.72699907819776,139,9.90000000000002E-4
1,test_20231101_140618,10404007.png,502730,8927,493803,0.9822429534740318,2,4,61265,1305,59960,0.9786990940994043,27.10119111111111,3828.409856,12.300619352451037,140,0.0
2,test_20231101_140618,1254659.png,342646,28272,314374,0.9174891870910502,2,4,80080,4035,76045,0.9496128871128872,41.08502933333333,10586.020069333334,7.88347647861777,140,0.0
3,test_20231101_140618,10188041.png,221231,6234,214997,0.9718213089485651,2,4,41731,878,40853,0.9789604850111427,12.548995555555555,1575.652736,16.15619852953629,140,0.0
4,test_20231101_140618,10287332.png,216980,7299,209681,0.9663609549267214,1,4,22337,998,21339,0.9553207682320813,11.954016,1621.7246933333333,16.03103231285187,140,0.0
5,test_20231101_140618,11610969.png,368720,8737,359983,0.9763045129095248,2,3,84111,1293,82818,0.9846274565752399,37.23422577777778,6746.521237333333,9.840004690558345,140,0.0
6,test_20231101_140618,10350842.png,212614,2787,209827,0.9868917380793363,2,3,42529,410,42119,0.9903595193867714,23.029056,3287.3856106666667,12.962297110113326,140,0.0
7,test_20231101_140618,10863862.png,317432,4587,312845,0.9855496610297638,1,4,66058,673,65385,0.9898119834085198,40.39785066666666,7823.489466666667,9.196798586900687,140,0.0
8,test_20231101_140618,11382381.png,312486,547,311939,0.9982495215785667,2,4,46745,76,46669,0.9983741576639212,21.96234488888889,2754.930384,13.729697319910494,140,0.0
9,test_20231101_140618,11079715.png,443815,82967,360848,0.8130594955105168,3,4,124136,11738,112398,0.9054424179931688,19.892592,2949.074736,13.43394582205185,140,0.0
10,test_20231101_140618,11551286.png,271883,397,271486,0.9985398130813622,1,3,40092,56,40036,0.9986032126109947,17.788083555555556,1857.6711626666668,15.441115214355744,140,0.0
1,test_20231101_140619,10404007.png,502730,8927,493803,0.9822429534740318,2,3,61265,1305,59960,0.9786990940994043,27.10119111111111,3828.409856,12.300619352451037,140,1.0E-5
2,test_20231101_140619,1254659.png,342646,28272,314374,0.9174891870910502,1,3,80080,4035,76045,0.9496128871128872,41.08502933333333,10586.020069333334,7.88347647861777,140,1.0E-5
3,test_20231101_140619,10188041.png,221231,6234,214997,0.9718213089485651,2,3,41731,878,40853,0.9789604850111427,12.548995555555555,1575.652736,16.15619852953629,140,1.0E-5
4,test_20231101_140619,10287332.png,216980,7299,209681,0.9663609549267214,2,4,22337,998,21339,0.9553207682320813,11.954016,1621.7246933333333,16.03103231285187,140,1.0E-5
5,test_20231101_140619,11610969.png,368720,8737,359983,0.9763045129095248,1,3,84111,1293,82818,0.9846274565752399,37.23422577777778,6746.521237333333,9.840004690558345,140,1.0E-5
6,test_20231101_140619,10350842.png,212614,2787,209827,0.9868917380793363,2,3,42529,410,42119,0.9903595193867714,23.029056,3287.3856106666667,12.962297110113326,140,1.0E-5
7,test_20231101_140619,10863862.png,317432,4587,312845,0.9855496610297638,2,4,66058,673,65385,0.9898119834085198,40.39785066666666,7823.489466666667,9.196798586900687,140,1.0E-5
8,test_20231101_140619,11382381.png,312486,547,311939,0.9982495215785667,2,3,46745,76,46669,0.9983741576639212,21.96234488888889,2754.930384,13.729697319910494,140,1.0E-5
9,test_20231101_140619,11079715.png,443815,82967,360848,0.8130594955105168,2,4,124136,11738,112398,0.9054424179931688,19.892592,2949.074736,13.43394582205185,140,1.0E-5
10,test_20231101_140619,11551286.png,271883,397,271486,0.9985398130813622,2,3,40092,56,40036,0.9986032126109947,17.788083555555556,1857.6711626666668,15.441115214355744,140,1.0E-5
1,test_20231101_140620,10404007.png,502730,8927,493803,0.9822429534740318,2,3,61265,1305,59960,0.9786990940994043,27.10119111111111,3828.409856,12.300619352451037,140,2.0E-5
2,test_20231101_140620,1254659.png,342646,28272,314374,0.9174891870910502,2,4,80080,4035,76045,0.9496128871128872,41.08502933333333,10586.020069333334,7.88347647861777,140,2.0E-5
3,test_20231101_140620,10188041.png,221231,6234,214997,0.9718213089485651,2,4,41731,878,40853,0.9789604850111427,12.548995555555555,1575.652736,16.15619852953629,140,2.0E-5
4,test_20231101_140620,10287332.png,216980,7299,209681,0.9663609549267214,2,4,22337,998,21339,0.9553207682320813,11.954016,1621.7246933333333,16.03103231285187,140,2.0E-5
5,test_20231101_140620,11610969.png,368720,8737,359983,0.9763045129095248,2,3,84111,1293,82818,0.9846274565752399,37.23422577777778,6746.521237333333,9.840004690558345,140,2.0E-5
6,test_20231101_140620,10350842.png,212614,2787,209827,0.9868917380793363,1,4,42529,410,42119,0.9903595193867714,23.029056,3287.3856106666667,12.962297110113326,140,2.0E-5
7,test_20231101_140620,10863862.png,317432,4587,312845,0.9855496610297638,1,5,66058,673,65385,0.9898119834085198,40.39785066666666,7823.489466666667,9.196798586900687,140,2.0E-5
8,test_20231101_140620,11382381.png,312486,537,311949,0.9982815230122309,1,4,46745,75,46670,0.9983955503262381,22.692161777777777,2853.4911946666666,13.577038241313751,140,2.0E-5
9,test_20231101_140620,11079715.png,443815,82967,360848,0.8130594955105168,5,3,124136,11738,112398,0.9054424179931688,19.892592,2949.074736,13.43394582205185,140,2.0E-5
10,test_20231101_140620,11551286.png,271883,397,271486,0.9985398130813622,1,3,40092,56,40036,0.9986032126109947,17.788083555555556,1857.6711626666668,15.441115214355744,140,2.0E-5
1,test_20231101_140620,10404007.png,502730,8927,493803,0.9822429534740318,2,4,61265,1305,59960,0.9786990940994043,27.10119111111111,3828.409856,12.300619352451037,140,3.0000000000000004E-5
2,test_20231101_140620,1254659.png,342646,28272,314374,0.9174891870910502,2,3,80080,4035,76045,0.9496128871128872,41.08502933333333,10586.020069333334,7.88347647861777,140,3.0000000000000004E-5
3,test_20231101_140620,10188041.png,221231,6234,214997,0.9718213089485651,2,3,41731,878,40853,0.9789604850111427,12.548995555555555,1575.652736,16.15619852953629,140,3.0000000000000004E-5
4,test_20231101_140620,10287332.png,216980,7299,209681,0.9663609549267214,1,3,22337,998,21339,0.9553207682320813,11.954016,1621.7246933333333,16.03103231285187,140,3.0000000000000004E-5
5,test_20231101_140620,11610969.png,368720,8737,359983,0.9763045129095248,2,4,84111,1293,82818,0.9846274565752399,37.23422577777778,6746.521237333333,9.840004690558345,140,3.0000000000000004E-5
6,test_20231101_140620,10350842.png,212614,2787,209827,0.9868917380793363,1,4,42529,410,42119,0.9903595193867714,23.029056,3287.3856106666667,12.962297110113326,140,3.0000000000000004E-5
7,test_20231101_140620,10863862.png,317432,4587,312845,0.9855496610297638,1,4,66058,673,65385,0.9898119834085198,40.39785066666666,7823.489466666667,9.196798586900687,140,3.0000000000000004E-5
8,test_20231101_140620,11382381.png,312486,537,311949,0.9982815230122309,1,3,46745,75,46670,0.9983955503262381,22.692161777777777,2853.4911946666666,13.577038241313751,140,3.0000000000000004E-5
9,test_20231101_140620,11079715.png,443815,82967,360848,0.8130594955105168,3,4,124136,11738,112398,0.9054424179931688,19.892592,2949.074736,13.43394582205185,140,3.0000000000000004E-5
10,test_20231101_140620,11551286.png,271883,397,271486,0.9985398130813622,2,3,40092,56,40036,0.9986032126109947,17.788083555555556,1857.6711626666668,15.441115214355744,140,3.0000000000000004E-5
1,test_20231101_140621,10404007.png,502730,8927,493803,0.9822429534740318,2,4,61265,1305,59960,0.9786990940994043,27.10119111111111,3828.409856,12.300619352451037,140,4.0E-5
2,test_20231101_140621,1254659.png,342646,28272,314374,0.9174891870910502,2,4,80080,4035,76045,0.9496128871128872,41.08502933333333,10586.020069333334,7.88347647861777,140,4.0E-5
3,test_20231101_140621,10188041.png,221231,6234,214997,0.9718213089485651,2,4,41731,878,40853,0.9789604850111427,12.548995555555555,1575.652736,16.15619852953629,140,4.0E-5
4,test_20231101_140621,10287332.png,216980,7299,209681,0.9663609549267214,2,3,22337,998,21339,0.9553207682320813,11.954016,1621.7246933333333,16.03103231285187,140,4.0E-5
5,test_20231101_140621,11610969.png,368720,8737,359983,0.9763045129095248,2,3,84111,1293,82818,0.9846274565752399,37.23422577777778,6746.521237333333,9.840004690558345,140,4.0E-5
6,test_20231101_140621,10350842.png,212614,2787,209827,0.9868917380793363,2,3,42529,410,42119,0.9903595193867714,23.029056,3287.3856106666667,12.962297110113326,140,4.0E-5
7,test_20231101_140621,10863862.png,317432,4587,312845,0.9855496610297638,1,4,66058,673,65385,0.9898119834085198,40.39785066666666,7823.489466666667,9.196798586900687,140,4.0E-5
8,test_20231101_140621,11382381.png,312486,537,311949,0.9982815230122309,2,3,46745,75,46670,0.9983955503262381,22.692161777777777,2853.4911946666666,13.577038241313751,140,4.0E-5
9,test_20231101_140621,11079715.png,443815,82967,360848,0.8130594955105168,4,4,124136,11738,112398,0.9054424179931688,19.892592,2949.074736,13.43394582205185,140,4.0E-5
10,test_20231101_140621,11551286.png,271883,397,271486,0.9985398130813622,2,4,40092,56,40036,0.9986032126109947,17.788083555555556,1857.6711626666668,15.441115214355744,140,4.0E-5
1,test_20231101_140622,10404007.png,502730,8927,493803,0.9822429534740318,2,3,61265,1305,59960,0.9786990940994043,27.10119111111111,3828.409856,12.300619352451037,140,5.0E-5
2,test_20231101_140622,1254659.png,342646,28272,314374,0.9174891870910502,2,4,80080,4035,76045,0.9496128871128872,41.08502933333333,10586.020069333334,7.88347647861777,140,5.0E-5
3,test_20231101_140622,10188041.png,221231,6234,214997,0.9718213089485651,1,3,41731,878,40853,0.9789604850111427,12.548995555555555,1575.652736,16.15619852953629,140,5.0E-5
4,test_20231101_140622,10287332.png,216980,7299,209681,0.9663609549267214,1,3,22337,998,21339,0.9553207682320813,11.954016,1621.7246933333333,16.03103231285187,140,5.0E-5
5,test_20231101_140622,11610969.png,368720,8737,359983,0.9763045129095248,2,4,84111,1293,82818,0.9846274565752399,37.23422577777778,6746.521237333333,9.840004690558345,140,5.0E-5
6,test_20231101_140622,10350842.png,212614,2787,209827,0.9868917380793363,1,3,42529,410,42119,0.9903595193867714,23.029056,3287.3856106666667,12.962297110113326,140,5.0E-5
7,test_20231101_140622,10863862.png,317432,4587,312845,0.9855496610297638,2,3,66058,673,65385,0.9898119834085198,40.39785066666666,7823.489466666667,9.196798586900687,140,5.0E-5
8,test_20231101_140622,11382381.png,312486,537,311949,0.9982815230122309,1,4,46745,75,46670,0.9983955503262381,22.692161777777777,2853.4911946666666,13.577038241313751,140,5.0E-5
9,test_20231101_140622,11079715.png,443815,82967,360848,0.8130594955105168,3,4,124136,11738,112398,0.9054424179931688,19.892592,2949.074736,13.43394582205185,140,5.0E-5
10,test_20231101_140622,11551286.png,271883,397,271486,0.9985398130813622,2,10,40092,56,40036,0.9986032126109947,17.788083555555556,1857.6711626666668,15.441115214355744,140,5.0E-5
1,test_20231101_140622,10404007.png,502730,8927,493803,0.9822429534740318,2,4,61265,1305,59960,0.9786990940994043,27.10119111111111,3828.409856,12.300619352451037,140,6.0E-5
2,test_20231101_140622,1254659.png,342646,28272,314374,0.9174891870910502,2,4,80080,4035,76045,0.9496128871128872,41.08502933333333,10586.020069333334,7.88347647861777,140,6.0E-5
3,test_20231101_140622,10188041.png,221231,6234,214997,0.9718213089485651,1,3,41731,878,40853,0.9789604850111427,12.548995555555555,1575.652736,16.15619852953629,140,6.0E-5
4,test_20231101_140622,10287332.png,216980,7299,209681,0.9663609549267214,1,4,22337,998,21339,0.9553207682320813,11.954016,1621.7246933333333,16.03103231285187,140,6.0E-5
5,test_20231101_140622,11610969.png,368720,8737,359983,0.9763045129095248,2,4,84111,1293,82818,0.9846274565752399,37.23422577777778,6746.521237333333,9.840004690558345,140,6.0E-5
6,test_20231101_140622,10350842.png,212614,2787,209827,0.9868917380793363,1,4,42529,410,42119,0.9903595193867714,23.029056,3287.3856106666667,12.962297110113326,140,6.0E-5
7,test_20231101_140622,10863862.png,317432,4587,312845,0.9855496610297638,1,3,66058,673,65385,0.9898119834085198,40.39785066666666,7823.489466666667,9.196798586900687,140,6.0E-5
8,test_20231101_140622,11382381.png,312486,537,311949,0.9982815230122309,2,3,46745,75,46670,0.9983955503262381,22.692161777777777,2853.4911946666666,13.577038241313751,140,6.0E-5
9,test_20231101_140622,11079715.png,443815,82967,360848,0.8130594955105168,3,4,124136,11738,112398,0.9054424179931688,19.892592,2949.074736,13.43394582205185,140,6.0E-5
10,test_20231101_140622,11551286.png,271883,397,271486,0.9985398130813622,2,3,40092,56,40036,0.9986032126109947,17.788083555555556,1857.6711626666668,15.441115214355744,140,6.0E-5
1,test_20231101_140623,10404007.png,502730,8927,493803,0.9822429534740318,2,4,61265,1305,59960,0.9786990940994043,27.10119111111111,3828.409856,12.300619352451037,140,7.000000000000001E-5
2,test_20231101_140623,1254659.png,342646,28272,314374,0.9174891870910502,2,4,80080,4035,76045,0.9496128871128872,41.08502933333333,10586.020069333334,7.88347647861777,140,7.000000000000001E-5
3,test_20231101_140623,10188041.png,221231,6234,214997,0.9718213089485651,2,4,41731,878,40853,0.9789604850111427,12.548995555555555,1575.652736,16.15619852953629,140,7.000000000000001E-5
4,test_20231101_140623,10287332.png,216980,7299,209681,0.9663609549267214,2,4,22337,998,21339,0.9553207682320813,11.954016,1621.7246933333333,16.03103231285187,140,7.000000000000001E-5
5,test_20231101_140623,11610969.png,368720,8434,360286,0.9771262746799739,2,4,84111,1248,82863,0.9851624638870065,38.415077333333336,7023.129466666666,9.665496864512434,140,7.000000000000001E-5
6,test_20231101_140623,10350842.png,212614,2787,209827,0.9868917380793363,2,3,42529,410,42119,0.9903595193867714,23.029056,3287.3856106666667,12.962297110113326,140,7.000000000000001E-5
7,test_20231101_140623,10863862.png,317432,4587,312845,0.9855496610297638,1,4,66058,673,65385,0.9898119834085198,40.39785066666666,7823.489466666667,9.196798586900687,140,7.000000000000001E-5
8,test_20231101_140623,11382381.png,312486,537,311949,0.9982815230122309,2,3,46745,75,46670,0.9983955503262381,22.692161777777777,2853.4911946666666,13.577038241313751,140,7.000000000000001E-5
9,test_20231101_140623,11079715.png,443815,82967,360848,0.8130594955105168,3,4,124136,11738,112398,0.9054424179931688,19.892592,2949.074736,13.43394582205185,140,7.000000000000001E-5
10,test_20231101_140623,11551286.png,271883,277,271606,0.9989811794043761,1,4,40092,38,40054,0.9990521799860321,17.87441777777778,1863.783136,15.426849830633177,140,7.000000000000001E-5
1,test_20231101_140624,10404007.png,502730,8927,493803,0.9822429534740318,2,4,61265,1305,59960,0.9786990940994043,27.10119111111111,3828.409856,12.300619352451037,140,8.0E-5
2,test_20231101_140624,1254659.png,342646,28272,314374,0.9174891870910502,2,4,80080,4035,76045,0.9496128871128872,41.08502933333333,10586.020069333334,7.88347647861777,140,8.0E-5
3,test_20231101_140624,10188041.png,221231,6234,214997,0.9718213089485651,2,3,41731,878,40853,0.9789604850111427,12.548995555555555,1575.652736,16.15619852953629,140,8.0E-5
4,test_20231101_140624,10287332.png,216980,7299,209681,0.9663609549267214,2,4,22337,998,21339,0.9553207682320813,11.954016,1621.7246933333333,16.03103231285187,140,8.0E-5
5,test_20231101_140624,11610969.png,368720,8434,360286,0.9771262746799739,2,4,84111,1248,82863,0.9851624638870065,38.415077333333336,7023.129466666666,9.665496864512434,140,8.0E-5
6,test_20231101_140624,10350842.png,212614,2787,209827,0.9868917380793363,2,4,42529,410,42119,0.9903595193867714,23.029056,3287.3856106666667,12.962297110113326,140,8.0E-5
7,test_20231101_140624,10863862.png,317432,4587,312845,0.9855496610297638,1,4,66058,673,65385,0.9898119834085198,40.39785066666666,7823.489466666667,9.196798586900687,140,8.0E-5
8,test_20231101_140624,11382381.png,312486,427,312059,0.9986335387825375,1,8,46745,59,46686,0.9987378329233073,22.94864,2893.62336,13.516383590740695,140,8.0E-5
9,test_20231101_140624,11079715.png,443815,82967,360848,0.8130594955105168,3,4,124136,11738,112398,0.9054424179931688,19.892592,2949.074736,13.43394582205185,140,8.0E-5
10,test_20231101_140624,11551286.png,271883,277,271606,0.9989811794043761,2,3,40092,38,40054,0.9990521799860321,17.87441777777778,1863.783136,15.426849830633177,140,8.0E-5
1,test_20231101_140624,10404007.png,502730,8927,493803,0.9822429534740318,2,4,61265,1305,59960,0.9786990940994043,27.10119111111111,3828.409856,12.300619352451037,140,9.0E-5
2,test_20231101_140624,1254659.png,342646,28272,314374,0.9174891870910502,2,11,80080,4035,76045,0.9496128871128872,41.08502933333333,10586.020069333334,7.88347647861777,140,9.0E-5
3,test_20231101_140624,10188041.png,221231,6234,214997,0.9718213089485651,2,4,41731,878,40853,0.9789604850111427,12.548995555555555,1575.652736,16.15619852953629,140,9.0E-5
4,test_20231101_140624,10287332.png,216980,7299,209681,0.9663609549267214,1,3,22337,998,21339,0.9553207682320813,11.954016,1621.7246933333333,16.03103231285187,140,9.0E-5
5,test_20231101_140624,11610969.png,368720,8434,360286,0.9771262746799739,2,3,84111,1248,82863,0.9851624638870065,38.415077333333336,7023.129466666666,9.665496864512434,140,9.0E-5
6,test_20231101_140624,10350842.png,212614,2787,209827,0.9868917380793363,2,4,42529,410,42119,0.9903595193867714,23.029056,3287.3856106666667,12.962297110113326,140,9.0E-5
7,test_20231101_140624,10863862.png,317432,4587,312845,0.9855496610297638,2,4,66058,673,65385,0.9898119834085198,40.39785066666666,7823.489466666667,9.196798586900687,140,9.0E-5
8,test_20231101_140624,11382381.png,312486,427,312059,0.9986335387825375,1,3,46745,59,46686,0.9987378329233073,22.94864,2893.62336,13.516383590740695,140,9.0E-5
9,test_20231101_140624,11079715.png,443815,82967,360848,0.8130594955105168,3,4,124136,11738,112398,0.9054424179931688,19.892592,2949.074736,13.43394582205185,140,9.0E-5
10,test_20231101_140624,11551286.png,271883,277,271606,0.9989811794043761,1,10,40092,38,40054,0.9990521799860321,17.87441777777778,1863.783136,15.426849830633177,140,9.0E-5
1,test_20231101_140625,10404007.png,502730,8927,493803,0.9822429534740318,2,4,61265,1305,59960,0.9786990940994043,27.10119111111111,3828.409856,12.300619352451037,140,1.0E-4
2,test_20231101_140625,1254659.png,342646,28272,314374,0.9174891870910502,2,3,80080,4035,76045,0.9496128871128872,41.08502933333333,10586.020069333334,7.88347647861777,140,1.0E-4
3,test_20231101_140625,10188041.png,221231,6234,214997,0.9718213089485651,2,4,41731,878,40853,0.9789604850111427,12.548995555555555,1575.652736,16.15619852953629,140,1.0E-4
4,test_20231101_140625,10287332.png,216980,7299,209681,0.9663609549267214,1,4,22337,998,21339,0.9553207682320813,11.954016,1621.7246933333333,16.03103231285187,140,1.0E-4
5,test_20231101_140625,11610969.png,368720,8434,360286,0.9771262746799739,1,4,84111,1248,82863,0.9851624638870065,38.415077333333336,7023.129466666666,9.665496864512434,140,1.0E-4
6,test_20231101_140625,10350842.png,212614,2787,209827,0.9868917380793363,2,3,42529,410,42119,0.9903595193867714,23.029056,3287.3856106666667,12.962297110113326,140,1.0E-4
7,test_20231101_140625,10863862.png,317432,4587,312845,0.9855496610297638,2,4,66058,673,65385,0.9898119834085198,40.39785066666666,7823.489466666667,9.196798586900687,140,1.0E-4
8,test_20231101_140625,11382381.png,312486,427,312059,0.9986335387825375,1,3,46745,59,46686,0.9987378329233073,22.94864,2893.62336,13.516383590740695,140,1.0E-4
9,test_20231101_140625,11079715.png,443815,82967,360848,0.8130594955105168,2,4,124136,11738,112398,0.9054424179931688,19.892592,2949.074736,13.43394582205185,140,1.0E-4
10,test_20231101_140625,11551286.png,271883,277,271606,0.9989811794043761,1,4,40092,38,40054,0.9990521799860321,17.87441777777778,1863.783136,15.426849830633177,140,1.0E-4
1,test_20231101_140626,10404007.png,502730,8927,493803,0.9822429534740318,2,4,61265,1305,59960,0.9786990940994043,27.10119111111111,3828.409856,12.300619352451037,140,1.1E-4
2,test_20231101_140626,1254659.png,342646,28272,314374,0.9174891870910502,2,4,80080,4035,76045,0.9496128871128872,41.08502933333333,10586.020069333334,7.88347647861777,140,1.1E-4
3,test_20231101_140626,10188041.png,221231,6234,214997,0.9718213089485651,2,3,41731,878,40853,0.9789604850111427,12.548995555555555,1575.652736,16.15619852953629,140,1.1E-4
4,test_20231101_140626,10287332.png,216980,7299,209681,0.9663609549267214,1,4,22337,998,21339,0.9553207682320813,11.954016,1621.7246933333333,16.03103231285187,140,1.1E-4
5,test_20231101_140626,11610969.png,368720,8434,360286,0.9771262746799739,2,4,84111,1248,82863,0.9851624638870065,38.415077333333336,7023.129466666666,9.665496864512434,140,1.1E-4
6,test_20231101_140626,10350842.png,212614,2787,209827,0.9868917380793363,1,3,42529,410,42119,0.9903595193867714,23.029056,3287.3856106666667,12.962297110113326,140,1.1E-4
7,test_20231101_140626,10863862.png,317432,4587,312845,0.9855496610297638,1,3,66058,673,65385,0.9898119834085198,40.39785066666666,7823.489466666667,9.196798586900687,140,1.1E-4
8,test_20231101_140626,11382381.png,312486,427,312059,0.9986335387825375,1,3,46745,59,46686,0.9987378329233073,22.94864,2893.62336,13.516383590740695,140,1.1E-4
9,test_20231101_140626,11079715.png,443815,82967,360848,0.8130594955105168,3,4,124136,11738,112398,0.9054424179931688,19.892592,2949.074736,13.43394582205185,140,1.1E-4
10,test_20231101_140626,11551286.png,271883,277,271606,0.9989811794043761,1,3,40092,38,40054,0.9990521799860321,17.87441777777778,1863.783136,15.426849830633177,140,1.1E-4
1,test_20231101_140626,10404007.png,502730,8927,493803,0.9822429534740318,2,3,61265,1305,59960,0.9786990940994043,27.10119111111111,3828.409856,12.300619352451037,140,1.2E-4
2,test_20231101_140626,1254659.png,342646,28272,314374,0.9174891870910502,2,4,80080,4035,76045,0.9496128871128872,41.08502933333333,10586.020069333334,7.88347647861777,140,1.2E-4
3,test_20231101_140626,10188041.png,221231,6234,214997,0.9718213089485651,2,4,41731,878,40853,0.9789604850111427,12.548995555555555,1575.652736,16.15619852953629,140,1.2E-4
4,test_20231101_140626,10287332.png,216980,7299,209681,0.9663609549267214,2,4,22337,998,21339,0.9553207682320813,11.954016,1621.7246933333333,16.03103231285187,140,1.2E-4
5,test_20231101_140626,11610969.png,368720,8434,360286,0.9771262746799739,2,4,84111,1248,82863,0.9851624638870065,38.415077333333336,7023.129466666666,9.665496864512434,140,1.2E-4
6,test_20231101_140626,10350842.png,212614,2787,209827,0.9868917380793363,2,3,42529,410,42119,0.9903595193867714,23.029056,3287.3856106666667,12.962297110113326,140,1.2E-4
7,test_20231101_140626,10863862.png,317432,4587,312845,0.9855496610297638,1,4,66058,673,65385,0.9898119834085198,40.39785066666666,7823.489466666667,9.196798586900687,140,1.2E-4
8,test_20231101_140626,11382381.png,312486,427,312059,0.9986335387825375,1,3,46745,59,46686,0.9987378329233073,22.94864,2893.62336,13.516383590740695,140,1.2E-4
9,test_20231101_140626,11079715.png,443815,82967,360848,0.8130594955105168,4,5,124136,11738,112398,0.9054424179931688,19.892592,2949.074736,13.43394582205185,140,1.2E-4
10,test_20231101_140626,11551286.png,271883,277,271606,0.9989811794043761,1,4,40092,38,40054,0.9990521799860321,17.87441777777778,1863.783136,15.426849830633177,140,1.2E-4
1,test_20231101_140627,10404007.png,502730,8927,493803,0.9822429534740318,2,3,61265,1305,59960,0.9786990940994043,27.10119111111111,3828.409856,12.300619352451037,140,1.3000000000000002E-4
2,test_20231101_140627,1254659.png,342646,28272,314374,0.9174891870910502,2,3,80080,4035,76045,0.9496128871128872,41.08502933333333,10586.020069333334,7.88347647861777,140,1.3000000000000002E-4
3,test_20231101_140627,10188041.png,221231,6234,214997,0.9718213089485651,2,3,41731,878,40853,0.9789604850111427,12.548995555555555,1575.652736,16.15619852953629,140,1.3000000000000002E-4
4,test_20231101_140627,10287332.png,216980,7299,209681,0.9663609549267214,2,4,22337,998,21339,0.9553207682320813,11.954016,1621.7246933333333,16.03103231285187,140,1.3000000000000002E-4
5,test_20231101_140627,11610969.png,368720,8434,360286,0.9771262746799739,2,4,84111,1248,82863,0.9851624638870065,38.415077333333336,7023.129466666666,9.665496864512434,140,1.3000000000000002E-4
6,test_20231101_140627,10350842.png,212614,2787,209827,0.9868917380793363,2,3,42529,410,42119,0.9903595193867714,23.029056,3287.3856106666667,12.962297110113326,140,1.3000000000000002E-4
7,test_20231101_140627,10863862.png,317432,4587,312845,0.9855496610297638,2,3,66058,673,65385,0.9898119834085198,40.39785066666666,7823.489466666667,9.196798586900687,140,1.3000000000000002E-4
8,test_20231101_140627,11382381.png,312486,427,312059,0.9986335387825375,2,3,46745,59,46686,0.9987378329233073,22.94864,2893.62336,13.516383590740695,140,1.3000000000000002E-4
9,test_20231101_140627,11079715.png,443815,82967,360848,0.8130594955105168,3,4,124136,11738,112398,0.9054424179931688,19.892592,2949.074736,13.43394582205185,140,1.3000000000000002E-4
10,test_20231101_140627,11551286.png,271883,277,271606,0.9989811794043761,1,3,40092,38,40054,0.9990521799860321,17.87441777777778,1863.783136,15.426849830633177,140,1.3000000000000002E-4
1,test_20231101_140628,10404007.png,502730,8927,493803,0.9822429534740318,2,3,61265,1305,59960,0.9786990940994043,27.10119111111111,3828.409856,12.300619352451037,140,1.4000000000000001E-4
2,test_20231101_140628,1254659.png,342646,28272,314374,0.9174891870910502,2,3,80080,4035,76045,0.9496128871128872,41.08502933333333,10586.020069333334,7.88347647861777,140,1.4000000000000001E-4
3,test_20231101_140628,10188041.png,221231,6234,214997,0.9718213089485651,2,3,41731,878,40853,0.9789604850111427,12.548995555555555,1575.652736,16.15619852953629,140,1.4000000000000001E-4
4,test_20231101_140628,10287332.png,216980,7299,209681,0.9663609549267214,2,4,22337,998,21339,0.9553207682320813,11.954016,1621.7246933333333,16.03103231285187,140,1.4000000000000001E-4
5,test_20231101_140628,11610969.png,368720,8434,360286,0.9771262746799739,2,4,84111,1248,82863,0.9851624638870065,38.415077333333336,7023.129466666666,9.665496864512434,140,1.4000000000000001E-4
6,test_20231101_140628,10350842.png,212614,2787,209827,0.9868917380793363,2,3,42529,410,42119,0.9903595193867714,23.029056,3287.3856106666667,12.962297110113326,140,1.4000000000000001E-4
7,test_20231101_140628,10863862.png,317432,4587,312845,0.9855496610297638,1,4,66058,673,65385,0.9898119834085198,40.39785066666666,7823.489466666667,9.196798586900687,140,1.4000000000000001E-4
8,test_20231101_140628,11382381.png,312486,427,312059,0.9986335387825375,1,4,46745,59,46686,0.9987378329233073,22.94864,2893.62336,13.516383590740695,140,1.4000000000000001E-4
9,test_20231101_140628,11079715.png,443815,82967,360848,0.8130594955105168,3,4,124136,11738,112398,0.9054424179931688,19.892592,2949.074736,13.43394582205185,140,1.4000000000000001E-4
10,test_20231101_140628,11551286.png,271883,277,271606,0.9989811794043761,2,4,40092,38,40054,0.9990521799860321,17.87441777777778,1863.783136,15.426849830633177,140,1.4000000000000001E-4
1,test_20231101_140628,10404007.png,502730,8927,493803,0.9822429534740318,2,4,61265,1305,59960,0.9786990940994043,27.10119111111111,3828.409856,12.300619352451037,140,1.5000000000000001E-4
2,test_20231101_140628,1254659.png,342646,28272,314374,0.9174891870910502,2,4,80080,4035,76045,0.9496128871128872,41.08502933333333,10586.020069333334,7.88347647861777,140,1.5000000000000001E-4
3,test_20231101_140628,10188041.png,221231,6234,214997,0.9718213089485651,2,3,41731,878,40853,0.9789604850111427,12.548995555555555,1575.652736,16.15619852953629,140,1.5000000000000001E-4
4,test_20231101_140628,10287332.png,216980,7299,209681,0.9663609549267214,1,4,22337,998,21339,0.9553207682320813,11.954016,1621.7246933333333,16.03103231285187,140,1.5000000000000001E-4
5,test_20231101_140628,11610969.png,368720,8434,360286,0.9771262746799739,2,4,84111,1248,82863,0.9851624638870065,38.415077333333336,7023.129466666666,9.665496864512434,140,1.5000000000000001E-4
6,test_20231101_140628,10350842.png,212614,2787,209827,0.9868917380793363,1,4,42529,410,42119,0.9903595193867714,23.029056,3287.3856106666667,12.962297110113326,140,1.5000000000000001E-4
7,test_20231101_140628,10863862.png,317432,4587,312845,0.9855496610297638,1,4,66058,673,65385,0.9898119834085198,40.39785066666666,7823.489466666667,9.196798586900687,140,1.5000000000000001E-4
8,test_20231101_140628,11382381.png,312486,427,312059,0.9986335387825375,1,4,46745,59,46686,0.9987378329233073,22.94864,2893.62336,13.516383590740695,140,1.5000000000000001E-4
9,test_20231101_140628,11079715.png,443815,82967,360848,0.8130594955105168,3,4,124136,11738,112398,0.9054424179931688,19.892592,2949.074736,13.43394582205185,140,1.5000000000000001E-4
10,test_20231101_140628,11551286.png,271883,277,271606,0.9989811794043761,1,4,40092,38,40054,0.9990521799860321,17.87441777777778,1863.783136,15.426849830633177,140,1.5000000000000001E-4
1,test_20231101_140629,10404007.png,502730,8927,493803,0.9822429534740318,3,4,61265,1305,59960,0.9786990940994043,27.10119111111111,3828.409856,12.300619352451037,140,1.6E-4
2,test_20231101_140629,1254659.png,342646,28272,314374,0.9174891870910502,2,3,80080,4035,76045,0.9496128871128872,41.08502933333333,10586.020069333334,7.88347647861777,140,1.6E-4
3,test_20231101_140629,10188041.png,221231,6234,214997,0.9718213089485651,2,3,41731,878,40853,0.9789604850111427,12.548995555555555,1575.652736,16.15619852953629,140,1.6E-4
4,test_20231101_140629,10287332.png,216980,7127,209853,0.9671536547147203,1,4,22337,977,21360,0.9562609123875184,12.080359111111111,1647.4009493333333,15.962810489530913,140,1.6E-4
5,test_20231101_140629,11610969.png,368720,8434,360286,0.9771262746799739,2,3,84111,1248,82863,0.9851624638870065,38.415077333333336,7023.129466666666,9.665496864512434,140,1.6E-4
6,test_20231101_140629,10350842.png,212614,2787,209827,0.9868917380793363,1,4,42529,410,42119,0.9903595193867714,23.029056,3287.3856106666667,12.962297110113326,140,1.6E-4
7,test_20231101_140629,10863862.png,317432,4587,312845,0.9855496610297638,2,4,66058,673,65385,0.9898119834085198,40.39785066666666,7823.489466666667,9.196798586900687,140,1.6E-4
8,test_20231101_140629,11382381.png,312486,427,312059,0.9986335387825375,1,4,46745,59,46686,0.9987378329233073,22.94864,2893.62336,13.516383590740695,140,1.6E-4
9,test_20231101_140629,11079715.png,443815,82967,360848,0.8130594955105168,3,4,124136,11738,112398,0.9054424179931688,19.892592,2949.074736,13.43394582205185,140,1.6E-4
10,test_20231101_140629,11551286.png,271883,124,271759,0.999543921466219,2,3,40092,16,40076,0.9996009178888556,18.13910577777778,1903.2464906666667,15.335853231830718,140,1.6E-4
1,test_20231101_140630,10404007.png,502730,8927,493803,0.9822429534740318,2,3,61265,1305,59960,0.9786990940994043,27.10119111111111,3828.409856,12.300619352451037,140,1.7E-4
2,test_20231101_140630,1254659.png,342646,28272,314374,0.9174891870910502,2,4,80080,4035,76045,0.9496128871128872,41.08502933333333,10586.020069333334,7.88347647861777,140,1.7E-4
3,test_20231101_140630,10188041.png,221231,6234,214997,0.9718213089485651,2,4,41731,878,40853,0.9789604850111427,12.548995555555555,1575.652736,16.15619852953629,140,1.7E-4
4,test_20231101_140630,10287332.png,216980,7127,209853,0.9671536547147203,1,4,22337,977,21360,0.9562609123875184,12.080359111111111,1647.4009493333333,15.962810489530913,140,1.7E-4
5,test_20231101_140630,11610969.png,368720,8434,360286,0.9771262746799739,2,4,84111,1248,82863,0.9851624638870065,38.415077333333336,7023.129466666666,9.665496864512434,140,1.7E-4
6,test_20231101_140630,10350842.png,212614,2787,209827,0.9868917380793363,2,4,42529,410,42119,0.9903595193867714,23.029056,3287.3856106666667,12.962297110113326,140,1.7E-4
7,test_20231101_140630,10863862.png,317432,4587,312845,0.9855496610297638,2,4,66058,673,65385,0.9898119834085198,40.39785066666666,7823.489466666667,9.196798586900687,140,1.7E-4
8,test_20231101_140630,11382381.png,312486,427,312059,0.9986335387825375,1,4,46745,59,46686,0.9987378329233073,22.94864,2893.62336,13.516383590740695,140,1.7E-4
9,test_20231101_140630,11079715.png,443815,82967,360848,0.8130594955105168,3,4,124136,11738,112398,0.9054424179931688,19.892592,2949.074736,13.43394582205185,140,1.7E-4
10,test_20231101_140630,11551286.png,271883,124,271759,0.999543921466219,2,3,40092,16,40076,0.9996009178888556,18.13910577777778,1903.2464906666667,15.335853231830718,140,1.7E-4
1,test_20231101_140630,10404007.png,502730,8927,493803,0.9822429534740318,2,3,61265,1305,59960,0.9786990940994043,27.10119111111111,3828.409856,12.300619352451037,140,1.8E-4
2,test_20231101_140630,1254659.png,342646,28272,314374,0.9174891870910502,2,4,80080,4035,76045,0.9496128871128872,41.08502933333333,10586.020069333334,7.88347647861777,140,1.8E-4
3,test_20231101_140630,10188041.png,221231,6234,214997,0.9718213089485651,1,3,41731,878,40853,0.9789604850111427,12.548995555555555,1575.652736,16.15619852953629,140,1.8E-4
4,test_20231101_140630,10287332.png,216980,7127,209853,0.9671536547147203,3,3,22337,977,21360,0.9562609123875184,12.080359111111111,1647.4009493333333,15.962810489530913,140,1.8E-4
5,test_20231101_140630,11610969.png,368720,8434,360286,0.9771262746799739,1,4,84111,1248,82863,0.9851624638870065,38.415077333333336,7023.129466666666,9.665496864512434,140,1.8E-4
6,test_20231101_140630,10350842.png,212614,2787,209827,0.9868917380793363,2,3,42529,410,42119,0.9903595193867714,23.029056,3287.3856106666667,12.962297110113326,140,1.8E-4
7,test_20231101_140630,10863862.png,317432,4587,312845,0.9855496610297638,1,3,66058,673,65385,0.9898119834085198,40.39785066666666,7823.489466666667,9.196798586900687,140,1.8E-4
8,test_20231101_140630,11382381.png,312486,427,312059,0.9986335387825375,1,4,46745,59,46686,0.9987378329233073,22.94864,2893.62336,13.516383590740695,140,1.8E-4
9,test_20231101_140630,11079715.png,443815,82967,360848,0.8130594955105168,3,4,124136,11738,112398,0.9054424179931688,19.892592,2949.074736,13.43394582205185,140,1.8E-4
10,test_20231101_140630,11551286.png,271883,124,271759,0.999543921466219,1,3,40092,16,40076,0.9996009178888556,18.13910577777778,1903.2464906666667,15.335853231830718,140,1.8E-4
1,test_20231101_140631,10404007.png,502730,8927,493803,0.9822429534740318,2,3,61265,1305,59960,0.9786990940994043,27.10119111111111,3828.409856,12.300619352451037,140,1.9E-4
2,test_20231101_140631,1254659.png,342646,28272,314374,0.9174891870910502,2,4,80080,4035,76045,0.9496128871128872,41.08502933333333,10586.020069333334,7.88347647861777,140,1.9E-4
3,test_20231101_140631,10188041.png,221231,6234,214997,0.9718213089485651,2,4,41731,878,40853,0.9789604850111427,12.548995555555555,1575.652736,16.15619852953629,140,1.9E-4
4,test_20231101_140631,10287332.png,216980,7127,209853,0.9671536547147203,2,4,22337,977,21360,0.9562609123875184,12.080359111111111,1647.4009493333333,15.962810489530913,140,1.9E-4
5,test_20231101_140631,11610969.png,368720,8434,360286,0.9771262746799739,2,4,84111,1248,82863,0.9851624638870065,38.415077333333336,7023.129466666666,9.665496864512434,140,1.9E-4
6,test_20231101_140631,10350842.png,212614,2787,209827,0.9868917380793363,1,3,42529,410,42119,0.9903595193867714,23.029056,3287.3856106666667,12.962297110113326,140,1.9E-4
7,test_20231101_140631,10863862.png,317432,4587,312845,0.9855496610297638,1,4,66058,673,65385,0.9898119834085198,40.39785066666666,7823.489466666667,9.196798586900687,140,1.9E-4
8,test_20231101_140631,11382381.png,312486,427,312059,0.9986335387825375,2,3,46745,59,46686,0.9987378329233073,22.94864,2893.62336,13.516383590740695,140,1.9E-4
9,test_20231101_140631,11079715.png,443815,82967,360848,0.8130594955105168,3,4,124136,11738,112398,0.9054424179931688,19.892592,2949.074736,13.43394582205185,140,1.9E-4
10,test_20231101_140631,11551286.png,271883,124,271759,0.999543921466219,1,4,40092,16,40076,0.9996009178888556,18.13910577777778,1903.2464906666667,15.335853231830718,140,1.9E-4
1,test_20231101_140632,10404007.png,502730,8444,494286,0.9832037077556541,1,3,61265,1235,60030,0.9798416714274055,27.452346666666667,3904.2882933333335,12.215384823084065,140,2.0E-4
2,test_20231101_140632,1254659.png,342646,28272,314374,0.9174891870910502,2,3,80080,4035,76045,0.9496128871128872,41.08502933333333,10586.020069333334,7.88347647861777,140,2.0E-4
3,test_20231101_140632,10188041.png,221231,6234,214997,0.9718213089485651,2,4,41731,878,40853,0.9789604850111427,12.548995555555555,1575.652736,16.15619852953629,140,2.0E-4
4,test_20231101_140632,10287332.png,216980,7127,209853,0.9671536547147203,1,3,22337,977,21360,0.9562609123875184,12.080359111111111,1647.4009493333333,15.962810489530913,140,2.0E-4
5,test_20231101_140632,11610969.png,368720,8434,360286,0.9771262746799739,2,4,84111,1248,82863,0.9851624638870065,38.415077333333336,7023.129466666666,9.665496864512434,140,2.0E-4
6,test_20231101_140632,10350842.png,212614,2787,209827,0.9868917380793363,2,3,42529,410,42119,0.9903595193867714,23.029056,3287.3856106666667,12.962297110113326,140,2.0E-4
7,test_20231101_140632,10863862.png,317432,4587,312845,0.9855496610297638,2,4,66058,673,65385,0.9898119834085198,40.39785066666666,7823.489466666667,9.196798586900687,140,2.0E-4
8,test_20231101_140632,11382381.png,312486,427,312059,0.9986335387825375,1,4,46745,59,46686,0.9987378329233073,22.94864,2893.62336,13.516383590740695,140,2.0E-4
9,test_20231101_140632,11079715.png,443815,82967,360848,0.8130594955105168,3,4,124136,11738,112398,0.9054424179931688,19.892592,2949.074736,13.43394582205185,140,2.0E-4
10,test_20231101_140632,11551286.png,271883,124,271759,0.999543921466219,1,4,40092,16,40076,0.9996009178888556,18.13910577777778,1903.2464906666667,15.335853231830718,140,2.0E-4
1,test_20231101_140632,10404007.png,502730,8444,494286,0.9832037077556541,2,3,61265,1235,60030,0.9798416714274055,27.452346666666667,3904.2882933333335,12.215384823084065,140,2.1E-4
2,test_20231101_140632,1254659.png,342646,28272,314374,0.9174891870910502,2,4,80080,4035,76045,0.9496128871128872,41.08502933333333,10586.020069333334,7.88347647861777,140,2.1E-4
3,test_20231101_140632,10188041.png,221231,6234,214997,0.9718213089485651,2,3,41731,878,40853,0.9789604850111427,12.548995555555555,1575.652736,16.15619852953629,140,2.1E-4
4,test_20231101_140632,10287332.png,216980,7127,209853,0.9671536547147203,2,4,22337,977,21360,0.9562609123875184,12.080359111111111,1647.4009493333333,15.962810489530913,140,2.1E-4
5,test_20231101_140632,11610969.png,368720,8434,360286,0.9771262746799739,2,4,84111,1248,82863,0.9851624638870065,38.415077333333336,7023.129466666666,9.665496864512434,140,2.1E-4
6,test_20231101_140632,10350842.png,212614,2787,209827,0.9868917380793363,1,3,42529,410,42119,0.9903595193867714,23.029056,3287.3856106666667,12.962297110113326,140,2.1E-4
7,test_20231101_140632,10863862.png,317432,4587,312845,0.9855496610297638,1,3,66058,673,65385,0.9898119834085198,40.39785066666666,7823.489466666667,9.196798586900687,140,2.1E-4
8,test_20231101_140632,11382381.png,312486,427,312059,0.9986335387825375,1,3,46745,59,46686,0.9987378329233073,22.94864,2893.62336,13.516383590740695,140,2.1E-4
9,test_20231101_140632,11079715.png,443815,82967,360848,0.8130594955105168,4,4,124136,11738,112398,0.9054424179931688,19.892592,2949.074736,13.43394582205185,140,2.1E-4
10,test_20231101_140632,11551286.png,271883,124,271759,0.999543921466219,1,3,40092,16,40076,0.9996009178888556,18.13910577777778,1903.2464906666667,15.335853231830718,140,2.1E-4
1,test_20231101_140633,10404007.png,502730,8444,494286,0.9832037077556541,2,4,61265,1235,60030,0.9798416714274055,27.452346666666667,3904.2882933333335,12.215384823084065,140,2.2E-4
2,test_20231101_140633,1254659.png,342646,28272,314374,0.9174891870910502,2,4,80080,4035,76045,0.9496128871128872,41.08502933333333,10586.020069333334,7.88347647861777,140,2.2E-4
3,test_20231101_140633,10188041.png,221231,6234,214997,0.9718213089485651,2,3,41731,878,40853,0.9789604850111427,12.548995555555555,1575.652736,16.15619852953629,140,2.2E-4
4,test_20231101_140633,10287332.png,216980,7127,209853,0.9671536547147203,2,4,22337,977,21360,0.9562609123875184,12.080359111111111,1647.4009493333333,15.962810489530913,140,2.2E-4
5,test_20231101_140633,11610969.png,368720,8434,360286,0.9771262746799739,1,3,84111,1248,82863,0.9851624638870065,38.415077333333336,7023.129466666666,9.665496864512434,140,2.2E-4
6,test_20231101_140633,10350842.png,212614,2787,209827,0.9868917380793363,1,3,42529,410,42119,0.9903595193867714,23.029056,3287.3856106666667,12.962297110113326,140,2.2E-4
7,test_20231101_140633,10863862.png,317432,4587,312845,0.9855496610297638,2,3,66058,673,65385,0.9898119834085198,40.39785066666666,7823.489466666667,9.196798586900687,140,2.2E-4
8,test_20231101_140633,11382381.png,312486,427,312059,0.9986335387825375,1,3,46745,59,46686,0.9987378329233073,22.94864,2893.62336,13.516383590740695,140,2.2E-4
9,test_20231101_140633,11079715.png,443815,82967,360848,0.8130594955105168,3,4,124136,11738,112398,0.9054424179931688,19.892592,2949.074736,13.43394582205185,140,2.2E-4
10,test_20231101_140633,11551286.png,271883,124,271759,0.999543921466219,1,3,40092,16,40076,0.9996009178888556,18.13910577777778,1903.2464906666667,15.335853231830718,140,2.2E-4
1,test_20231101_140634,10404007.png,502730,8444,494286,0.9832037077556541,2,4,61265,1235,60030,0.9798416714274055,27.452346666666667,3904.2882933333335,12.215384823084065,140,2.3E-4
2,test_20231101_140634,1254659.png,342646,28272,314374,0.9174891870910502,2,3,80080,4035,76045,0.9496128871128872,41.08502933333333,10586.020069333334,7.88347647861777,140,2.3E-4
3,test_20231101_140634,10188041.png,221231,6234,214997,0.9718213089485651,2,3,41731,878,40853,0.9789604850111427,12.548995555555555,1575.652736,16.15619852953629,140,2.3E-4
4,test_20231101_140634,10287332.png,216980,7127,209853,0.9671536547147203,2,4,22337,977,21360,0.9562609123875184,12.080359111111111,1647.4009493333333,15.962810489530913,140,2.3E-4
5,test_20231101_140634,11610969.png,368720,8434,360286,0.9771262746799739,1,3,84111,1248,82863,0.9851624638870065,38.415077333333336,7023.129466666666,9.665496864512434,140,2.3E-4
6,test_20231101_140634,10350842.png,212614,2787,209827,0.9868917380793363,2,3,42529,410,42119,0.9903595193867714,23.029056,3287.3856106666667,12.962297110113326,140,2.3E-4
7,test_20231101_140634,10863862.png,317432,4587,312845,0.9855496610297638,2,4,66058,673,65385,0.9898119834085198,40.39785066666666,7823.489466666667,9.196798586900687,140,2.3E-4
8,test_20231101_140634,11382381.png,312486,427,312059,0.9986335387825375,2,4,46745,59,46686,0.9987378329233073,22.94864,2893.62336,13.516383590740695,140,2.3E-4
9,test_20231101_140634,11079715.png,443815,82967,360848,0.8130594955105168,4,4,124136,11738,112398,0.9054424179931688,19.892592,2949.074736,13.43394582205185,140,2.3E-4
10,test_20231101_140634,11551286.png,271883,124,271759,0.999543921466219,1,3,40092,16,40076,0.9996009178888556,18.13910577777778,1903.2464906666667,15.335853231830718,140,2.3E-4
1,test_20231101_140635,10404007.png,502730,8444,494286,0.9832037077556541,2,4,61265,1235,60030,0.9798416714274055,27.452346666666667,3904.2882933333335,12.215384823084065,140,2.4E-4
2,test_20231101_140635,1254659.png,342646,28272,314374,0.9174891870910502,2,4,80080,4035,76045,0.9496128871128872,41.08502933333333,10586.020069333334,7.88347647861777,140,2.4E-4
3,test_20231101_140635,10188041.png,221231,6234,214997,0.9718213089485651,2,4,41731,878,40853,0.9789604850111427,12.548995555555555,1575.652736,16.15619852953629,140,2.4E-4
4,test_20231101_140635,10287332.png,216980,7127,209853,0.9671536547147203,1,4,22337,977,21360,0.9562609123875184,12.080359111111111,1647.4009493333333,15.962810489530913,140,2.4E-4
5,test_20231101_140635,11610969.png,368720,8434,360286,0.9771262746799739,2,4,84111,1248,82863,0.9851624638870065,38.415077333333336,7023.129466666666,9.665496864512434,140,2.4E-4
6,test_20231101_140635,10350842.png,212614,2787,209827,0.9868917380793363,2,3,42529,410,42119,0.9903595193867714,23.029056,3287.3856106666667,12.962297110113326,140,2.4E-4
7,test_20231101_140635,10863862.png,317432,4587,312845,0.9855496610297638,1,3,66058,673,65385,0.9898119834085198,40.39785066666666,7823.489466666667,9.196798586900687,140,2.4E-4
8,test_20231101_140635,11382381.png,312486,427,312059,0.9986335387825375,2,4,46745,59,46686,0.9987378329233073,22.94864,2893.62336,13.516383590740695,140,2.4E-4
9,test_20231101_140635,11079715.png,443815,82967,360848,0.8130594955105168,4,4,124136,11738,112398,0.9054424179931688,19.892592,2949.074736,13.43394582205185,140,2.4E-4
10,test_20231101_140635,11551286.png,271883,124,271759,0.999543921466219,5,4,40092,16,40076,0.9996009178888556,18.13910577777778,1903.2464906666667,15.335853231830718,140,2.4E-4
1,test_20231101_140635,10404007.png,502730,8444,494286,0.9832037077556541,1,3,61265,1235,60030,0.9798416714274055,27.452346666666667,3904.2882933333335,12.215384823084065,140,2.5E-4
2,test_20231101_140635,1254659.png,342646,28272,314374,0.9174891870910502,2,4,80080,4035,76045,0.9496128871128872,41.08502933333333,10586.020069333334,7.88347647861777,140,2.5E-4
3,test_20231101_140635,10188041.png,221231,6234,214997,0.9718213089485651,1,3,41731,878,40853,0.9789604850111427,12.548995555555555,1575.652736,16.15619852953629,140,2.5E-4
4,test_20231101_140635,10287332.png,216980,7127,209853,0.9671536547147203,1,4,22337,977,21360,0.9562609123875184,12.080359111111111,1647.4009493333333,15.962810489530913,140,2.5E-4
5,test_20231101_140635,11610969.png,368720,8434,360286,0.9771262746799739,2,4,84111,1248,82863,0.9851624638870065,38.415077333333336,7023.129466666666,9.665496864512434,140,2.5E-4
6,test_20231101_140635,10350842.png,212614,2787,209827,0.9868917380793363,1,4,42529,410,42119,0.9903595193867714,23.029056,3287.3856106666667,12.962297110113326,140,2.5E-4
7,test_20231101_140635,10863862.png,317432,4587,312845,0.9855496610297638,2,3,66058,673,65385,0.9898119834085198,40.39785066666666,7823.489466666667,9.196798586900687,140,2.5E-4
8,test_20231101_140635,11382381.png,312486,427,312059,0.9986335387825375,1,3,46745,59,46686,0.9987378329233073,22.94864,2893.62336,13.516383590740695,140,2.5E-4
9,test_20231101_140635,11079715.png,443815,82967,360848,0.8130594955105168,3,4,124136,11738,112398,0.9054424179931688,19.892592,2949.074736,13.43394582205185,140,2.5E-4
10,test_20231101_140635,11551286.png,271883,124,271759,0.999543921466219,2,3,40092,16,40076,0.9996009178888556,18.13910577777778,1903.2464906666667,15.335853231830718,140,2.5E-4
1,test_20231101_140636,10404007.png,502730,8002,494728,0.984082907326,2,3,61265,1171,60094,0.9808863135558639,27.644737777777777,3964.361402666667,12.149071217071912,140,2.6000000000000003E-4
2,test_20231101_140636,1254659.png,342646,28232,314414,0.9176059256492123,2,4,80080,4031,76049,0.9496628371628372,41.093029333333334,10586.7652,7.883170797402147,140,2.6000000000000003E-4
3,test_20231101_140636,10188041.png,221231,6092,215139,0.9724631719786105,2,3,41731,859,40872,0.9794157820325418,12.86696888888889,1621.804128,16.03081959368511,140,2.6000000000000003E-4
4,test_20231101_140636,10287332.png,216980,6747,210233,0.9689049681998341,2,4,22337,921,21416,0.9587679634686842,13.06504,1886.4791733333334,15.374283459009131,140,2.6000000000000003E-4
5,test_20231101_140636,11610969.png,368720,8354,360366,0.9773432414840529,2,5,84111,1236,82875,0.9853051325034775,38.45282311111111,7027.006309333334,9.66310017390828,140,2.6000000000000003E-4
6,test_20231101_140636,10350842.png,212614,2747,209867,0.9870798724449001,1,4,42529,404,42125,0.9905005995908674,23.083228444444444,3291.8096213333333,12.956456506081246,140,2.6000000000000003E-4
7,test_20231101_140636,10863862.png,317432,4324,313108,0.9863781849340961,3,7,66058,634,65424,0.9904023736716219,41.03287288888889,7997.819173333333,9.101087801390861,140,2.6000000000000003E-4
8,test_20231101_140636,11382381.png,312486,327,312159,0.9989535531191798,1,3,46745,44,46701,0.9990587228580596,23.441726222222222,2963.055792,13.413405318888326,140,2.6000000000000003E-4
9,test_20231101_140636,11079715.png,443815,82967,360848,0.8130594955105168,3,4,124136,11738,112398,0.9054424179931688,19.892592,2949.074736,13.43394582205185,140,2.6000000000000003E-4
10,test_20231101_140636,11551286.png,271883,124,271759,0.999543921466219,1,3,40092,16,40076,0.9996009178888556,18.13910577777778,1903.2464906666667,15.335853231830718,140,2.6000000000000003E-4
1,test_20231101_140637,10404007.png,502730,8002,494728,0.984082907326,1,3,61265,1171,60094,0.9808863135558639,27.644737777777777,3964.361402666667,12.149071217071912,140,2.7000000000000006E-4
2,test_20231101_140637,1254659.png,342646,28232,314414,0.9176059256492123,2,3,80080,4031,76049,0.9496628371628372,41.093029333333334,10586.7652,7.883170797402147,140,2.7000000000000006E-4
3,test_20231101_140637,10188041.png,221231,6092,215139,0.9724631719786105,2,4,41731,859,40872,0.9794157820325418,12.86696888888889,1621.804128,16.03081959368511,140,2.7000000000000006E-4
4,test_20231101_140637,10287332.png,216980,6747,210233,0.9689049681998341,2,3,22337,921,21416,0.9587679634686842,13.06504,1886.4791733333334,15.374283459009131,140,2.7000000000000006E-4
5,test_20231101_140637,11610969.png,368720,8354,360366,0.9773432414840529,1,8,84111,1236,82875,0.9853051325034775,38.45282311111111,7027.006309333334,9.66310017390828,140,2.7000000000000006E-4
6,test_20231101_140637,10350842.png,212614,2747,209867,0.9870798724449001,1,4,42529,404,42125,0.9905005995908674,23.083228444444444,3291.8096213333333,12.956456506081246,140,2.7000000000000006E-4
7,test_20231101_140637,10863862.png,317432,4324,313108,0.9863781849340961,1,4,66058,634,65424,0.9904023736716219,41.03287288888889,7997.819173333333,9.101087801390861,140,2.7000000000000006E-4
8,test_20231101_140637,11382381.png,312486,327,312159,0.9989535531191798,2,4,46745,44,46701,0.9990587228580596,23.441726222222222,2963.055792,13.413405318888326,140,2.7000000000000006E-4
9,test_20231101_140637,11079715.png,443815,82967,360848,0.8130594955105168,2,4,124136,11738,112398,0.9054424179931688,19.892592,2949.074736,13.43394582205185,140,2.7000000000000006E-4
10,test_20231101_140637,11551286.png,271883,124,271759,0.999543921466219,2,3,40092,16,40076,0.9996009178888556,18.13910577777778,1903.2464906666667,15.335853231830718,140,2.7000000000000006E-4
1,test_20231101_140637,10404007.png,502730,8002,494728,0.984082907326,1,3,61265,1171,60094,0.9808863135558639,27.644737777777777,3964.361402666667,12.149071217071912,140,2.800000000000001E-4
2,test_20231101_140637,1254659.png,342646,28232,314414,0.9176059256492123,2,4,80080,4031,76049,0.9496628371628372,41.093029333333334,10586.7652,7.883170797402147,140,2.800000000000001E-4
3,test_20231101_140637,10188041.png,221231,6092,215139,0.9724631719786105,2,3,41731,859,40872,0.9794157820325418,12.86696888888889,1621.804128,16.03081959368511,140,2.800000000000001E-4
4,test_20231101_140637,10287332.png,216980,6747,210233,0.9689049681998341,2,3,22337,921,21416,0.9587679634686842,13.06504,1886.4791733333334,15.374283459009131,140,2.800000000000001E-4
5,test_20231101_140637,11610969.png,368720,8354,360366,0.9773432414840529,1,4,84111,1236,82875,0.9853051325034775,38.45282311111111,7027.006309333334,9.66310017390828,140,2.800000000000001E-4
6,test_20231101_140637,10350842.png,212614,2747,209867,0.9870798724449001,2,4,42529,404,42125,0.9905005995908674,23.083228444444444,3291.8096213333333,12.956456506081246,140,2.800000000000001E-4
7,test_20231101_140637,10863862.png,317432,4324,313108,0.9863781849340961,2,4,66058,634,65424,0.9904023736716219,41.03287288888889,7997.819173333333,9.101087801390861,140,2.800000000000001E-4
8,test_20231101_140637,11382381.png,312486,327,312159,0.9989535531191798,2,3,46745,44,46701,0.9990587228580596,23.441726222222222,2963.055792,13.413405318888326,140,2.800000000000001E-4
9,test_20231101_140637,11079715.png,443815,82967,360848,0.8130594955105168,3,4,124136,11738,112398,0.9054424179931688,19.892592,2949.074736,13.43394582205185,140,2.800000000000001E-4
10,test_20231101_140637,11551286.png,271883,124,271759,0.999543921466219,1,4,40092,16,40076,0.9996009178888556,18.13910577777778,1903.2464906666667,15.335853231830718,140,2.800000000000001E-4
1,test_20231101_140638,10404007.png,502730,8002,494728,0.984082907326,2,4,61265,1171,60094,0.9808863135558639,27.644737777777777,3964.361402666667,12.149071217071912,140,2.900000000000001E-4
2,test_20231101_140638,1254659.png,342646,28232,314414,0.9176059256492123,2,3,80080,4031,76049,0.9496628371628372,41.093029333333334,10586.7652,7.883170797402147,140,2.900000000000001E-4
3,test_20231101_140638,10188041.png,221231,6092,215139,0.9724631719786105,2,4,41731,859,40872,0.9794157820325418,12.86696888888889,1621.804128,16.03081959368511,140,2.900000000000001E-4
4,test_20231101_140638,10287332.png,216980,6747,210233,0.9689049681998341,2,4,22337,921,21416,0.9587679634686842,13.06504,1886.4791733333334,15.374283459009131,140,2.900000000000001E-4
5,test_20231101_140638,11610969.png,368720,8354,360366,0.9773432414840529,2,3,84111,1236,82875,0.9853051325034775,38.45282311111111,7027.006309333334,9.66310017390828,140,2.900000000000001E-4
6,test_20231101_140638,10350842.png,212614,2747,209867,0.9870798724449001,2,4,42529,404,42125,0.9905005995908674,23.083228444444444,3291.8096213333333,12.956456506081246,140,2.900000000000001E-4
7,test_20231101_140638,10863862.png,317432,4324,313108,0.9863781849340961,1,4,66058,634,65424,0.9904023736716219,41.03287288888889,7997.819173333333,9.101087801390861,140,2.900000000000001E-4
8,test_20231101_140638,11382381.png,312486,327,312159,0.9989535531191798,1,4,46745,44,46701,0.9990587228580596,23.441726222222222,2963.055792,13.413405318888326,140,2.900000000000001E-4
9,test_20231101_140638,11079715.png,443815,82967,360848,0.8130594955105168,3,4,124136,11738,112398,0.9054424179931688,19.892592,2949.074736,13.43394582205185,140,2.900000000000001E-4
10,test_20231101_140638,11551286.png,271883,124,271759,0.999543921466219,2,3,40092,16,40076,0.9996009178888556,18.13910577777778,1903.2464906666667,15.335853231830718,140,2.900000000000001E-4
1,test_20231101_140639,10404007.png,502730,8002,494728,0.984082907326,2,4,61265,1171,60094,0.9808863135558639,27.644737777777777,3964.361402666667,12.149071217071912,140,3.0000000000000014E-4
2,test_20231101_140639,1254659.png,342646,28232,314414,0.9176059256492123,2,4,80080,4031,76049,0.9496628371628372,41.093029333333334,10586.7652,7.883170797402147,140,3.0000000000000014E-4
3,test_20231101_140639,10188041.png,221231,6092,215139,0.9724631719786105,2,4,41731,859,40872,0.9794157820325418,12.86696888888889,1621.804128,16.03081959368511,140,3.0000000000000014E-4
4,test_20231101_140639,10287332.png,216980,6747,210233,0.9689049681998341,1,7,22337,921,21416,0.9587679634686842,13.06504,1886.4791733333334,15.374283459009131,140,3.0000000000000014E-4
5,test_20231101_140639,11610969.png,368720,8354,360366,0.9773432414840529,1,4,84111,1236,82875,0.9853051325034775,38.45282311111111,7027.006309333334,9.66310017390828,140,3.0000000000000014E-4
6,test_20231101_140639,10350842.png,212614,2747,209867,0.9870798724449001,1,3,42529,404,42125,0.9905005995908674,23.083228444444444,3291.8096213333333,12.956456506081246,140,3.0000000000000014E-4
7,test_20231101_140639,10863862.png,317432,4324,313108,0.9863781849340961,1,3,66058,634,65424,0.9904023736716219,41.03287288888889,7997.819173333333,9.101087801390861,140,3.0000000000000014E-4
8,test_20231101_140639,11382381.png,312486,327,312159,0.9989535531191798,2,3,46745,44,46701,0.9990587228580596,23.441726222222222,2963.055792,13.413405318888326,140,3.0000000000000014E-4
9,test_20231101_140639,11079715.png,443815,82967,360848,0.8130594955105168,3,4,124136,11738,112398,0.9054424179931688,19.892592,2949.074736,13.43394582205185,140,3.0000000000000014E-4
10,test_20231101_140639,11551286.png,271883,124,271759,0.999543921466219,1,4,40092,16,40076,0.9996009178888556,18.13910577777778,1903.2464906666667,15.335853231830718,140,3.0000000000000014E-4
1,test_20231101_140639,10404007.png,502730,8002,494728,0.984082907326,2,4,61265,1171,60094,0.9808863135558639,27.644737777777777,3964.361402666667,12.149071217071912,140,3.1000000000000016E-4
2,test_20231101_140639,1254659.png,342646,28232,314414,0.9176059256492123,2,4,80080,4031,76049,0.9496628371628372,41.093029333333334,10586.7652,7.883170797402147,140,3.1000000000000016E-4
3,test_20231101_140639,10188041.png,221231,6092,215139,0.9724631719786105,2,4,41731,859,40872,0.9794157820325418,12.86696888888889,1621.804128,16.03081959368511,140,3.1000000000000016E-4
4,test_20231101_140639,10287332.png,216980,6747,210233,0.9689049681998341,2,4,22337,921,21416,0.9587679634686842,13.06504,1886.4791733333334,15.374283459009131,140,3.1000000000000016E-4
5,test_20231101_140639,11610969.png,368720,8354,360366,0.9773432414840529,1,3,84111,1236,82875,0.9853051325034775,38.45282311111111,7027.006309333334,9.66310017390828,140,3.1000000000000016E-4
6,test_20231101_140639,10350842.png,212614,2747,209867,0.9870798724449001,1,4,42529,404,42125,0.9905005995908674,23.083228444444444,3291.8096213333333,12.956456506081246,140,3.1000000000000016E-4
7,test_20231101_140639,10863862.png,317432,4324,313108,0.9863781849340961,2,3,66058,634,65424,0.9904023736716219,41.03287288888889,7997.819173333333,9.101087801390861,140,3.1000000000000016E-4
8,test_20231101_140639,11382381.png,312486,327,312159,0.9989535531191798,1,3,46745,44,46701,0.9990587228580596,23.441726222222222,2963.055792,13.413405318888326,140,3.1000000000000016E-4
9,test_20231101_140639,11079715.png,443815,82967,360848,0.8130594955105168,3,4,124136,11738,112398,0.9054424179931688,19.892592,2949.074736,13.43394582205185,140,3.1000000000000016E-4
10,test_20231101_140639,11551286.png,271883,124,271759,0.999543921466219,1,3,40092,16,40076,0.9996009178888556,18.13910577777778,1903.2464906666667,15.335853231830718,140,3.1000000000000016E-4
1,test_20231101_140640,10404007.png,502730,8002,494728,0.984082907326,2,4,61265,1171,60094,0.9808863135558639,27.644737777777777,3964.361402666667,12.149071217071912,140,3.200000000000002E-4
2,test_20231101_140640,1254659.png,342646,28232,314414,0.9176059256492123,2,4,80080,4031,76049,0.9496628371628372,41.093029333333334,10586.7652,7.883170797402147,140,3.200000000000002E-4
3,test_20231101_140640,10188041.png,221231,6092,215139,0.9724631719786105,2,4,41731,859,40872,0.9794157820325418,12.86696888888889,1621.804128,16.03081959368511,140,3.200000000000002E-4
4,test_20231101_140640,10287332.png,216980,6747,210233,0.9689049681998341,1,4,22337,921,21416,0.9587679634686842,13.06504,1886.4791733333334,15.374283459009131,140,3.200000000000002E-4
5,test_20231101_140640,11610969.png,368720,8354,360366,0.9773432414840529,2,3,84111,1236,82875,0.9853051325034775,38.45282311111111,7027.006309333334,9.66310017390828,140,3.200000000000002E-4
6,test_20231101_140640,10350842.png,212614,2747,209867,0.9870798724449001,2,3,42529,404,42125,0.9905005995908674,23.083228444444444,3291.8096213333333,12.956456506081246,140,3.200000000000002E-4
7,test_20231101_140640,10863862.png,317432,3982,313450,0.9874555810378286,2,3,66058,585,65473,0.9911441460534681,43.673390222222224,8783.888586666666,8.693935422435349,140,3.200000000000002E-4
8,test_20231101_140640,11382381.png,312486,327,312159,0.9989535531191798,2,3,46745,44,46701,0.9990587228580596,23.441726222222222,2963.055792,13.413405318888326,140,3.200000000000002E-4
9,test_20231101_140640,11079715.png,443815,82967,360848,0.8130594955105168,3,4,124136,11738,112398,0.9054424179931688,19.892592,2949.074736,13.43394582205185,140,3.200000000000002E-4
10,test_20231101_140640,11551286.png,271883,124,271759,0.999543921466219,2,4,40092,16,40076,0.9996009178888556,18.13910577777778,1903.2464906666667,15.335853231830718,140,3.200000000000002E-4
1,test_20231101_140641,10404007.png,502730,8002,494728,0.984082907326,2,4,61265,1171,60094,0.9808863135558639,27.644737777777777,3964.361402666667,12.149071217071912,140,3.300000000000002E-4
2,test_20231101_140641,1254659.png,342646,28232,314414,0.9176059256492123,2,3,80080,4031,76049,0.9496628371628372,41.093029333333334,10586.7652,7.883170797402147,140,3.300000000000002E-4
3,test_20231101_140641,10188041.png,221231,6092,215139,0.9724631719786105,2,4,41731,859,40872,0.9794157820325418,12.86696888888889,1621.804128,16.03081959368511,140,3.300000000000002E-4
4,test_20231101_140641,10287332.png,216980,6747,210233,0.9689049681998341,2,3,22337,921,21416,0.9587679634686842,13.06504,1886.4791733333334,15.374283459009131,140,3.300000000000002E-4
5,test_20231101_140641,11610969.png,368720,8354,360366,0.9773432414840529,2,10,84111,1236,82875,0.9853051325034775,38.45282311111111,7027.006309333334,9.66310017390828,140,3.300000000000002E-4
6,test_20231101_140641,10350842.png,212614,2747,209867,0.9870798724449001,1,3,42529,404,42125,0.9905005995908674,23.083228444444444,3291.8096213333333,12.956456506081246,140,3.300000000000002E-4
7,test_20231101_140641,10863862.png,317432,3982,313450,0.9874555810378286,2,3,66058,585,65473,0.9911441460534681,43.673390222222224,8783.888586666666,8.693935422435349,140,3.300000000000002E-4
8,test_20231101_140641,11382381.png,312486,327,312159,0.9989535531191798,1,3,46745,44,46701,0.9990587228580596,23.441726222222222,2963.055792,13.413405318888326,140,3.300000000000002E-4
9,test_20231101_140641,11079715.png,443815,82967,360848,0.8130594955105168,2,4,124136,11738,112398,0.9054424179931688,19.892592,2949.074736,13.43394582205185,140,3.300000000000002E-4
10,test_20231101_140641,11551286.png,271883,124,271759,0.999543921466219,1,3,40092,16,40076,0.9996009178888556,18.13910577777778,1903.2464906666667,15.335853231830718,140,3.300000000000002E-4
1,test_20231101_140641,10404007.png,502730,8002,494728,0.984082907326,2,4,61265,1171,60094,0.9808863135558639,27.644737777777777,3964.361402666667,12.149071217071912,140,3.4000000000000024E-4
2,test_20231101_140641,1254659.png,342646,28232,314414,0.9176059256492123,2,4,80080,4031,76049,0.9496628371628372,41.093029333333334,10586.7652,7.883170797402147,140,3.4000000000000024E-4
3,test_20231101_140641,10188041.png,221231,6092,215139,0.9724631719786105,2,4,41731,859,40872,0.9794157820325418,12.86696888888889,1621.804128,16.03081959368511,140,3.4000000000000024E-4
4,test_20231101_140641,10287332.png,216980,6747,210233,0.9689049681998341,2,4,22337,921,21416,0.9587679634686842,13.06504,1886.4791733333334,15.374283459009131,140,3.4000000000000024E-4
5,test_20231101_140641,11610969.png,368720,8354,360366,0.9773432414840529,1,4,84111,1236,82875,0.9853051325034775,38.45282311111111,7027.006309333334,9.66310017390828,140,3.4000000000000024E-4
6,test_20231101_140641,10350842.png,212614,2747,209867,0.9870798724449001,1,3,42529,404,42125,0.9905005995908674,23.083228444444444,3291.8096213333333,12.956456506081246,140,3.4000000000000024E-4
7,test_20231101_140641,10863862.png,317432,3982,313450,0.9874555810378286,1,4,66058,585,65473,0.9911441460534681,43.673390222222224,8783.888586666666,8.693935422435349,140,3.4000000000000024E-4
8,test_20231101_140641,11382381.png,312486,327,312159,0.9989535531191798,1,4,46745,44,46701,0.9990587228580596,23.441726222222222,2963.055792,13.413405318888326,140,3.4000000000000024E-4
9,test_20231101_140641,11079715.png,443815,82967,360848,0.8130594955105168,3,4,124136,11738,112398,0.9054424179931688,19.892592,2949.074736,13.43394582205185,140,3.4000000000000024E-4
10,test_20231101_140641,11551286.png,271883,124,271759,0.999543921466219,1,3,40092,16,40076,0.9996009178888556,18.13910577777778,1903.2464906666667,15.335853231830718,140,3.4000000000000024E-4
1,test_20231101_140642,10404007.png,502730,8002,494728,0.984082907326,2,4,61265,1171,60094,0.9808863135558639,27.644737777777777,3964.361402666667,12.149071217071912,140,3.5000000000000027E-4
2,test_20231101_140642,1254659.png,342646,28232,314414,0.9176059256492123,2,3,80080,4031,76049,0.9496628371628372,41.093029333333334,10586.7652,7.883170797402147,140,3.5000000000000027E-4
3,test_20231101_140642,10188041.png,221231,6092,215139,0.9724631719786105,2,3,41731,859,40872,0.9794157820325418,12.86696888888889,1621.804128,16.03081959368511,140,3.5000000000000027E-4
4,test_20231101_140642,10287332.png,216980,6747,210233,0.9689049681998341,2,4,22337,921,21416,0.9587679634686842,13.06504,1886.4791733333334,15.374283459009131,140,3.5000000000000027E-4
5,test_20231101_140642,11610969.png,368720,8354,360366,0.9773432414840529,1,4,84111,1236,82875,0.9853051325034775,38.45282311111111,7027.006309333334,9.66310017390828,140,3.5000000000000027E-4
6,test_20231101_140642,10350842.png,212614,2747,209867,0.9870798724449001,2,4,42529,404,42125,0.9905005995908674,23.083228444444444,3291.8096213333333,12.956456506081246,140,3.5000000000000027E-4
7,test_20231101_140642,10863862.png,317432,3982,313450,0.9874555810378286,1,4,66058,585,65473,0.9911441460534681,43.673390222222224,8783.888586666666,8.693935422435349,140,3.5000000000000027E-4
8,test_20231101_140642,11382381.png,312486,327,312159,0.9989535531191798,1,3,46745,44,46701,0.9990587228580596,23.441726222222222,2963.055792,13.413405318888326,140,3.5000000000000027E-4
9,test_20231101_140642,11079715.png,443815,82967,360848,0.8130594955105168,3,4,124136,11738,112398,0.9054424179931688,19.892592,2949.074736,13.43394582205185,140,3.5000000000000027E-4
10,test_20231101_140642,11551286.png,271883,124,271759,0.999543921466219,2,4,40092,16,40076,0.9996009178888556,18.13910577777778,1903.2464906666667,15.335853231830718,140,3.5000000000000027E-4
1,test_20231101_140643,10404007.png,502730,8002,494728,0.984082907326,2,4,61265,1171,60094,0.9808863135558639,27.644737777777777,3964.361402666667,12.149071217071912,140,3.600000000000003E-4
2,test_20231101_140643,1254659.png,342646,28232,314414,0.9176059256492123,2,4,80080,4031,76049,0.9496628371628372,41.093029333333334,10586.7652,7.883170797402147,140,3.600000000000003E-4
3,test_20231101_140643,10188041.png,221231,6092,215139,0.9724631719786105,2,4,41731,859,40872,0.9794157820325418,12.86696888888889,1621.804128,16.03081959368511,140,3.600000000000003E-4
4,test_20231101_140643,10287332.png,216980,6747,210233,0.9689049681998341,2,3,22337,921,21416,0.9587679634686842,13.06504,1886.4791733333334,15.374283459009131,140,3.600000000000003E-4
5,test_20231101_140643,11610969.png,368720,8354,360366,0.9773432414840529,1,3,84111,1236,82875,0.9853051325034775,38.45282311111111,7027.006309333334,9.66310017390828,140,3.600000000000003E-4
6,test_20231101_140643,10350842.png,212614,2747,209867,0.9870798724449001,1,4,42529,404,42125,0.9905005995908674,23.083228444444444,3291.8096213333333,12.956456506081246,140,3.600000000000003E-4
7,test_20231101_140643,10863862.png,317432,3982,313450,0.9874555810378286,1,10,66058,585,65473,0.9911441460534681,43.673390222222224,8783.888586666666,8.693935422435349,140,3.600000000000003E-4
8,test_20231101_140643,11382381.png,312486,327,312159,0.9989535531191798,1,4,46745,44,46701,0.9990587228580596,23.441726222222222,2963.055792,13.413405318888326,140,3.600000000000003E-4
9,test_20231101_140643,11079715.png,443815,82967,360848,0.8130594955105168,3,4,124136,11738,112398,0.9054424179931688,19.892592,2949.074736,13.43394582205185,140,3.600000000000003E-4
10,test_20231101_140643,11551286.png,271883,124,271759,0.999543921466219,2,3,40092,16,40076,0.9996009178888556,18.13910577777778,1903.2464906666667,15.335853231830718,140,3.600000000000003E-4
1,test_20231101_140643,10404007.png,502730,8002,494728,0.984082907326,2,4,61265,1171,60094,0.9808863135558639,27.644737777777777,3964.361402666667,12.149071217071912,140,3.700000000000003E-4
2,test_20231101_140643,1254659.png,342646,28232,314414,0.9176059256492123,2,4,80080,4031,76049,0.9496628371628372,41.093029333333334,10586.7652,7.883170797402147,140,3.700000000000003E-4
3,test_20231101_140643,10188041.png,221231,6092,215139,0.9724631719786105,2,4,41731,859,40872,0.9794157820325418,12.86696888888889,1621.804128,16.03081959368511,140,3.700000000000003E-4
4,test_20231101_140643,10287332.png,216980,6747,210233,0.9689049681998341,2,4,22337,921,21416,0.9587679634686842,13.06504,1886.4791733333334,15.374283459009131,140,3.700000000000003E-4
5,test_20231101_140643,11610969.png,368720,8354,360366,0.9773432414840529,1,4,84111,1236,82875,0.9853051325034775,38.45282311111111,7027.006309333334,9.66310017390828,140,3.700000000000003E-4
6,test_20231101_140643,10350842.png,212614,2747,209867,0.9870798724449001,1,4,42529,404,42125,0.9905005995908674,23.083228444444444,3291.8096213333333,12.956456506081246,140,3.700000000000003E-4
7,test_20231101_140643,10863862.png,317432,3982,313450,0.9874555810378286,1,4,66058,585,65473,0.9911441460534681,43.673390222222224,8783.888586666666,8.693935422435349,140,3.700000000000003E-4
8,test_20231101_140643,11382381.png,312486,327,312159,0.9989535531191798,2,3,46745,44,46701,0.9990587228580596,23.441726222222222,2963.055792,13.413405318888326,140,3.700000000000003E-4
9,test_20231101_140643,11079715.png,443815,82967,360848,0.8130594955105168,2,4,124136,11738,112398,0.9054424179931688,19.892592,2949.074736,13.43394582205185,140,3.700000000000003E-4
10,test_20231101_140643,11551286.png,271883,124,271759,0.999543921466219,1,4,40092,16,40076,0.9996009178888556,18.13910577777778,1903.2464906666667,15.335853231830718,140,3.700000000000003E-4
1,test_20231101_140644,10404007.png,502730,8002,494728,0.984082907326,2,4,61265,1171,60094,0.9808863135558639,27.644737777777777,3964.361402666667,12.149071217071912,140,3.8000000000000035E-4
2,test_20231101_140644,1254659.png,342646,28232,314414,0.9176059256492123,2,3,80080,4031,76049,0.9496628371628372,41.093029333333334,10586.7652,7.883170797402147,140,3.8000000000000035E-4
3,test_20231101_140644,10188041.png,221231,6092,215139,0.9724631719786105,2,4,41731,859,40872,0.9794157820325418,12.86696888888889,1621.804128,16.03081959368511,140,3.8000000000000035E-4
4,test_20231101_140644,10287332.png,216980,6747,210233,0.9689049681998341,1,3,22337,921,21416,0.9587679634686842,13.06504,1886.4791733333334,15.374283459009131,140,3.8000000000000035E-4
5,test_20231101_140644,11610969.png,368720,8354,360366,0.9773432414840529,2,3,84111,1236,82875,0.9853051325034775,38.45282311111111,7027.006309333334,9.66310017390828,140,3.8000000000000035E-4
6,test_20231101_140644,10350842.png,212614,2747,209867,0.9870798724449001,1,4,42529,404,42125,0.9905005995908674,23.083228444444444,3291.8096213333333,12.956456506081246,140,3.8000000000000035E-4
7,test_20231101_140644,10863862.png,317432,3982,313450,0.9874555810378286,2,3,66058,585,65473,0.9911441460534681,43.673390222222224,8783.888586666666,8.693935422435349,140,3.8000000000000035E-4
8,test_20231101_140644,11382381.png,312486,327,312159,0.9989535531191798,2,3,46745,44,46701,0.9990587228580596,23.441726222222222,2963.055792,13.413405318888326,140,3.8000000000000035E-4
9,test_20231101_140644,11079715.png,443815,82967,360848,0.8130594955105168,3,4,124136,11738,112398,0.9054424179931688,19.892592,2949.074736,13.43394582205185,140,3.8000000000000035E-4
10,test_20231101_140644,11551286.png,271883,124,271759,0.999543921466219,2,3,40092,16,40076,0.9996009178888556,18.13910577777778,1903.2464906666667,15.335853231830718,140,3.8000000000000035E-4
1,test_20231101_140645,10404007.png,502730,8002,494728,0.984082907326,2,4,61265,1171,60094,0.9808863135558639,27.644737777777777,3964.361402666667,12.149071217071912,140,3.9000000000000037E-4
2,test_20231101_140645,1254659.png,342646,28232,314414,0.9176059256492123,2,4,80080,4031,76049,0.9496628371628372,41.093029333333334,10586.7652,7.883170797402147,140,3.9000000000000037E-4
3,test_20231101_140645,10188041.png,221231,6092,215139,0.9724631719786105,2,3,41731,859,40872,0.9794157820325418,12.86696888888889,1621.804128,16.03081959368511,140,3.9000000000000037E-4
4,test_20231101_140645,10287332.png,216980,6747,210233,0.9689049681998341,1,4,22337,921,21416,0.9587679634686842,13.06504,1886.4791733333334,15.374283459009131,140,3.9000000000000037E-4
5,test_20231101_140645,11610969.png,368720,8354,360366,0.9773432414840529,2,4,84111,1236,82875,0.9853051325034775,38.45282311111111,7027.006309333334,9.66310017390828,140,3.9000000000000037E-4
6,test_20231101_140645,10350842.png,212614,2747,209867,0.9870798724449001,1,3,42529,404,42125,0.9905005995908674,23.083228444444444,3291.8096213333333,12.956456506081246,140,3.9000000000000037E-4
7,test_20231101_140645,10863862.png,317432,3982,313450,0.9874555810378286,1,4,66058,585,65473,0.9911441460534681,43.673390222222224,8783.888586666666,8.693935422435349,140,3.9000000000000037E-4
8,test_20231101_140645,11382381.png,312486,327,312159,0.9989535531191798,1,4,46745,44,46701,0.9990587228580596,23.441726222222222,2963.055792,13.413405318888326,140,3.9000000000000037E-4
9,test_20231101_140645,11079715.png,443815,82967,360848,0.8130594955105168,3,4,124136,11738,112398,0.9054424179931688,19.892592,2949.074736,13.43394582205185,140,3.9000000000000037E-4
10,test_20231101_140645,11551286.png,271883,124,271759,0.999543921466219,1,3,40092,16,40076,0.9996009178888556,18.13910577777778,1903.2464906666667,15.335853231830718,140,3.9000000000000037E-4
1,test_20231101_140645,10404007.png,502730,8002,494728,0.984082907326,2,4,61265,1171,60094,0.9808863135558639,27.644737777777777,3964.361402666667,12.149071217071912,140,4.000000000000004E-4
2,test_20231101_140645,1254659.png,342646,28232,314414,0.9176059256492123,2,4,80080,4031,76049,0.9496628371628372,41.093029333333334,10586.7652,7.883170797402147,140,4.000000000000004E-4
3,test_20231101_140645,10188041.png,221231,6092,215139,0.9724631719786105,2,4,41731,859,40872,0.9794157820325418,12.86696888888889,1621.804128,16.03081959368511,140,4.000000000000004E-4
4,test_20231101_140645,10287332.png,216980,6747,210233,0.9689049681998341,2,3,22337,921,21416,0.9587679634686842,13.06504,1886.4791733333334,15.374283459009131,140,4.000000000000004E-4
5,test_20231101_140645,11610969.png,368720,8354,360366,0.9773432414840529,2,4,84111,1236,82875,0.9853051325034775,38.45282311111111,7027.006309333334,9.66310017390828,140,4.000000000000004E-4
6,test_20231101_140645,10350842.png,212614,2747,209867,0.9870798724449001,1,4,42529,404,42125,0.9905005995908674,23.083228444444444,3291.8096213333333,12.956456506081246,140,4.000000000000004E-4
7,test_20231101_140645,10863862.png,317432,3982,313450,0.9874555810378286,1,3,66058,585,65473,0.9911441460534681,43.673390222222224,8783.888586666666,8.693935422435349,140,4.000000000000004E-4
8,test_20231101_140645,11382381.png,312486,327,312159,0.9989535531191798,1,4,46745,44,46701,0.9990587228580596,23.441726222222222,2963.055792,13.413405318888326,140,4.000000000000004E-4
9,test_20231101_140645,11079715.png,443815,82967,360848,0.8130594955105168,3,4,124136,11738,112398,0.9054424179931688,19.892592,2949.074736,13.43394582205185,140,4.000000000000004E-4
10,test_20231101_140645,11551286.png,271883,124,271759,0.999543921466219,1,4,40092,16,40076,0.9996009178888556,18.13910577777778,1903.2464906666667,15.335853231830718,140,4.000000000000004E-4
1,test_20231101_140646,10404007.png,502730,8002,494728,0.984082907326,2,4,61265,1171,60094,0.9808863135558639,27.644737777777777,3964.361402666667,12.149071217071912,140,4.100000000000004E-4
2,test_20231101_140646,1254659.png,342646,28232,314414,0.9176059256492123,2,4,80080,4031,76049,0.9496628371628372,41.093029333333334,10586.7652,7.883170797402147,140,4.100000000000004E-4
3,test_20231101_140646,10188041.png,221231,6092,215139,0.9724631719786105,2,4,41731,859,40872,0.9794157820325418,12.86696888888889,1621.804128,16.03081959368511,140,4.100000000000004E-4
4,test_20231101_140646,10287332.png,216980,6747,210233,0.9689049681998341,1,4,22337,921,21416,0.9587679634686842,13.06504,1886.4791733333334,15.374283459009131,140,4.100000000000004E-4
5,test_20231101_140646,11610969.png,368720,8354,360366,0.9773432414840529,1,4,84111,1236,82875,0.9853051325034775,38.45282311111111,7027.006309333334,9.66310017390828,140,4.100000000000004E-4
6,test_20231101_140646,10350842.png,212614,2747,209867,0.9870798724449001,1,4,42529,404,42125,0.9905005995908674,23.083228444444444,3291.8096213333333,12.956456506081246,140,4.100000000000004E-4
7,test_20231101_140646,10863862.png,317432,3982,313450,0.9874555810378286,2,3,66058,585,65473,0.9911441460534681,43.673390222222224,8783.888586666666,8.693935422435349,140,4.100000000000004E-4
8,test_20231101_140646,11382381.png,312486,327,312159,0.9989535531191798,1,4,46745,44,46701,0.9990587228580596,23.441726222222222,2963.055792,13.413405318888326,140,4.100000000000004E-4
9,test_20231101_140646,11079715.png,443815,82967,360848,0.8130594955105168,2,4,124136,11738,112398,0.9054424179931688,19.892592,2949.074736,13.43394582205185,140,4.100000000000004E-4
10,test_20231101_140646,11551286.png,271883,124,271759,0.999543921466219,1,3,40092,16,40076,0.9996009178888556,18.13910577777778,1903.2464906666667,15.335853231830718,140,4.100000000000004E-4
1,test_20231101_140647,10404007.png,502730,8002,494728,0.984082907326,2,3,61265,1171,60094,0.9808863135558639,27.644737777777777,3964.361402666667,12.149071217071912,140,4.2000000000000045E-4
2,test_20231101_140647,1254659.png,342646,28232,314414,0.9176059256492123,2,4,80080,4031,76049,0.9496628371628372,41.093029333333334,10586.7652,7.883170797402147,140,4.2000000000000045E-4
3,test_20231101_140647,10188041.png,221231,6092,215139,0.9724631719786105,2,3,41731,859,40872,0.9794157820325418,12.86696888888889,1621.804128,16.03081959368511,140,4.2000000000000045E-4
4,test_20231101_140647,10287332.png,216980,6747,210233,0.9689049681998341,2,4,22337,921,21416,0.9587679634686842,13.06504,1886.4791733333334,15.374283459009131,140,4.2000000000000045E-4
5,test_20231101_140647,11610969.png,368720,8354,360366,0.9773432414840529,2,4,84111,1236,82875,0.9853051325034775,38.45282311111111,7027.006309333334,9.66310017390828,140,4.2000000000000045E-4
6,test_20231101_140647,10350842.png,212614,2747,209867,0.9870798724449001,2,3,42529,404,42125,0.9905005995908674,23.083228444444444,3291.8096213333333,12.956456506081246,140,4.2000000000000045E-4
7,test_20231101_140647,10863862.png,317432,3982,313450,0.9874555810378286,2,3,66058,585,65473,0.9911441460534681,43.673390222222224,8783.888586666666,8.693935422435349,140,4.2000000000000045E-4
8,test_20231101_140647,11382381.png,312486,327,312159,0.9989535531191798,1,5,46745,44,46701,0.9990587228580596,23.441726222222222,2963.055792,13.413405318888326,140,4.2000000000000045E-4
9,test_20231101_140647,11079715.png,443815,82967,360848,0.8130594955105168,2,4,124136,11738,112398,0.9054424179931688,19.892592,2949.074736,13.43394582205185,140,4.2000000000000045E-4
10,test_20231101_140647,11551286.png,271883,24,271859,0.9999117267353972,1,4,40092,1,40091,0.9999750573680535,24.866876444444443,3470.407338666667,12.72699907819776,140,4.2000000000000045E-4
1,test_20231101_140647,10404007.png,502730,8002,494728,0.984082907326,2,4,61265,1171,60094,0.9808863135558639,27.644737777777777,3964.361402666667,12.149071217071912,140,4.300000000000005E-4
2,test_20231101_140647,1254659.png,342646,28232,314414,0.9176059256492123,2,4,80080,4031,76049,0.9496628371628372,41.093029333333334,10586.7652,7.883170797402147,140,4.300000000000005E-4
3,test_20231101_140647,10188041.png,221231,6092,215139,0.9724631719786105,2,3,41731,859,40872,0.9794157820325418,12.86696888888889,1621.804128,16.03081959368511,140,4.300000000000005E-4
4,test_20231101_140647,10287332.png,216980,6747,210233,0.9689049681998341,2,4,22337,921,21416,0.9587679634686842,13.06504,1886.4791733333334,15.374283459009131,140,4.300000000000005E-4
5,test_20231101_140647,11610969.png,368720,8354,360366,0.9773432414840529,2,4,84111,1236,82875,0.9853051325034775,38.45282311111111,7027.006309333334,9.66310017390828,140,4.300000000000005E-4
6,test_20231101_140647,10350842.png,212614,2747,209867,0.9870798724449001,2,5,42529,404,42125,0.9905005995908674,23.083228444444444,3291.8096213333333,12.956456506081246,140,4.300000000000005E-4
7,test_20231101_140647,10863862.png,317432,3982,313450,0.9874555810378286,1,4,66058,585,65473,0.9911441460534681,43.673390222222224,8783.888586666666,8.693935422435349,140,4.300000000000005E-4
8,test_20231101_140647,11382381.png,312486,327,312159,0.9989535531191798,1,4,46745,44,46701,0.9990587228580596,23.441726222222222,2963.055792,13.413405318888326,140,4.300000000000005E-4
9,test_20231101_140647,11079715.png,443815,82967,360848,0.8130594955105168,3,5,124136,11738,112398,0.9054424179931688,19.892592,2949.074736,13.43394582205185,140,4.300000000000005E-4
10,test_20231101_140647,11551286.png,271883,24,271859,0.9999117267353972,1,3,40092,1,40091,0.9999750573680535,24.866876444444443,3470.407338666667,12.72699907819776,140,4.300000000000005E-4
1,test_20231101_140648,10404007.png,502730,8002,494728,0.984082907326,1,3,61265,1171,60094,0.9808863135558639,27.644737777777777,3964.361402666667,12.149071217071912,140,4.400000000000005E-4
2,test_20231101_140648,1254659.png,342646,28232,314414,0.9176059256492123,1,4,80080,4031,76049,0.9496628371628372,41.093029333333334,10586.7652,7.883170797402147,140,4.400000000000005E-4
3,test_20231101_140648,10188041.png,221231,6092,215139,0.9724631719786105,2,3,41731,859,40872,0.9794157820325418,12.86696888888889,1621.804128,16.03081959368511,140,4.400000000000005E-4
4,test_20231101_140648,10287332.png,216980,6747,210233,0.9689049681998341,2,3,22337,921,21416,0.9587679634686842,13.06504,1886.4791733333334,15.374283459009131,140,4.400000000000005E-4
5,test_20231101_140648,11610969.png,368720,8354,360366,0.9773432414840529,2,4,84111,1236,82875,0.9853051325034775,38.45282311111111,7027.006309333334,9.66310017390828,140,4.400000000000005E-4
6,test_20231101_140648,10350842.png,212614,2747,209867,0.9870798724449001,2,3,42529,404,42125,0.9905005995908674,23.083228444444444,3291.8096213333333,12.956456506081246,140,4.400000000000005E-4
7,test_20231101_140648,10863862.png,317432,3982,313450,0.9874555810378286,2,4,66058,585,65473,0.9911441460534681,43.673390222222224,8783.888586666666,8.693935422435349,140,4.400000000000005E-4
8,test_20231101_140648,11382381.png,312486,327,312159,0.9989535531191798,1,3,46745,44,46701,0.9990587228580596,23.441726222222222,2963.055792,13.413405318888326,140,4.400000000000005E-4
9,test_20231101_140648,11079715.png,443815,82967,360848,0.8130594955105168,3,3,124136,11738,112398,0.9054424179931688,19.892592,2949.074736,13.43394582205185,140,4.400000000000005E-4
10,test_20231101_140648,11551286.png,271883,24,271859,0.9999117267353972,0,3,40092,1,40091,0.9999750573680535,24.866876444444443,3470.407338666667,12.72699907819776,140,4.400000000000005E-4
1,test_20231101_140649,10404007.png,502730,8002,494728,0.984082907326,2,3,61265,1171,60094,0.9808863135558639,27.644737777777777,3964.361402666667,12.149071217071912,140,4.5000000000000053E-4
2,test_20231101_140649,1254659.png,342646,28232,314414,0.9176059256492123,2,3,80080,4031,76049,0.9496628371628372,41.093029333333334,10586.7652,7.883170797402147,140,4.5000000000000053E-4
3,test_20231101_140649,10188041.png,221231,6092,215139,0.9724631719786105,2,3,41731,859,40872,0.9794157820325418,12.86696888888889,1621.804128,16.03081959368511,140,4.5000000000000053E-4
4,test_20231101_140649,10287332.png,216980,6747,210233,0.9689049681998341,2,10,22337,921,21416,0.9587679634686842,13.06504,1886.4791733333334,15.374283459009131,140,4.5000000000000053E-4
5,test_20231101_140649,11610969.png,368720,8354,360366,0.9773432414840529,1,3,84111,1236,82875,0.9853051325034775,38.45282311111111,7027.006309333334,9.66310017390828,140,4.5000000000000053E-4
6,test_20231101_140649,10350842.png,212614,2244,210370,0.989445662091866,2,3,42529,330,42199,0.9922405887747184,25.686323555555557,3929.788144,12.187112228008296,140,4.5000000000000053E-4
7,test_20231101_140649,10863862.png,317432,3982,313450,0.9874555810378286,2,4,66058,585,65473,0.9911441460534681,43.673390222222224,8783.888586666666,8.693935422435349,140,4.5000000000000053E-4
8,test_20231101_140649,11382381.png,312486,327,312159,0.9989535531191798,1,4,46745,44,46701,0.9990587228580596,23.441726222222222,2963.055792,13.413405318888326,140,4.5000000000000053E-4
9,test_20231101_140649,11079715.png,443815,82967,360848,0.8130594955105168,3,4,124136,11738,112398,0.9054424179931688,19.892592,2949.074736,13.43394582205185,140,4.5000000000000053E-4
10,test_20231101_140649,11551286.png,271883,24,271859,0.9999117267353972,1,4,40092,1,40091,0.9999750573680535,24.866876444444443,3470.407338666667,12.72699907819776,140,4.5000000000000053E-4
1,test_20231101_140649,10404007.png,502730,8002,494728,0.984082907326,2,3,61265,1171,60094,0.9808863135558639,27.644737777777777,3964.361402666667,12.149071217071912,140,4.6000000000000056E-4
2,test_20231101_140649,1254659.png,342646,28232,314414,0.9176059256492123,2,4,80080,4031,76049,0.9496628371628372,41.093029333333334,10586.7652,7.883170797402147,140,4.6000000000000056E-4
3,test_20231101_140649,10188041.png,221231,6092,215139,0.9724631719786105,2,3,41731,859,40872,0.9794157820325418,12.86696888888889,1621.804128,16.03081959368511,140,4.6000000000000056E-4
4,test_20231101_140649,10287332.png,216980,6747,210233,0.9689049681998341,2,3,22337,921,21416,0.9587679634686842,13.06504,1886.4791733333334,15.374283459009131,140,4.6000000000000056E-4
5,test_20231101_140649,11610969.png,368720,8354,360366,0.9773432414840529,2,3,84111,1236,82875,0.9853051325034775,38.45282311111111,7027.006309333334,9.66310017390828,140,4.6000000000000056E-4
6,test_20231101_140649,10350842.png,212614,2244,210370,0.989445662091866,1,3,42529,330,42199,0.9922405887747184,25.686323555555557,3929.788144,12.187112228008296,140,4.6000000000000056E-4
7,test_20231101_140649,10863862.png,317432,3982,313450,0.9874555810378286,1,4,66058,585,65473,0.9911441460534681,43.673390222222224,8783.888586666666,8.693935422435349,140,4.6000000000000056E-4
8,test_20231101_140649,11382381.png,312486,327,312159,0.9989535531191798,2,3,46745,44,46701,0.9990587228580596,23.441726222222222,2963.055792,13.413405318888326,140,4.6000000000000056E-4
9,test_20231101_140649,11079715.png,443815,82967,360848,0.8130594955105168,3,4,124136,11738,112398,0.9054424179931688,19.892592,2949.074736,13.43394582205185,140,4.6000000000000056E-4
10,test_20231101_140649,11551286.png,271883,24,271859,0.9999117267353972,0,3,40092,1,40091,0.9999750573680535,24.866876444444443,3470.407338666667,12.72699907819776,140,4.6000000000000056E-4
1,test_20231101_140650,10404007.png,502730,8002,494728,0.984082907326,2,3,61265,1171,60094,0.9808863135558639,27.644737777777777,3964.361402666667,12.149071217071912,140,4.700000000000006E-4
2,test_20231101_140650,1254659.png,342646,28232,314414,0.9176059256492123,1,3,80080,4031,76049,0.9496628371628372,41.093029333333334,10586.7652,7.883170797402147,140,4.700000000000006E-4
3,test_20231101_140650,10188041.png,221231,6092,215139,0.9724631719786105,1,3,41731,859,40872,0.9794157820325418,12.86696888888889,1621.804128,16.03081959368511,140,4.700000000000006E-4
4,test_20231101_140650,10287332.png,216980,6747,210233,0.9689049681998341,1,3,22337,921,21416,0.9587679634686842,13.06504,1886.4791733333334,15.374283459009131,140,4.700000000000006E-4
5,test_20231101_140650,11610969.png,368720,8354,360366,0.9773432414840529,1,4,84111,1236,82875,0.9853051325034775,38.45282311111111,7027.006309333334,9.66310017390828,140,4.700000000000006E-4
6,test_20231101_140650,10350842.png,212614,2244,210370,0.989445662091866,2,4,42529,330,42199,0.9922405887747184,25.686323555555557,3929.788144,12.187112228008296,140,4.700000000000006E-4
7,test_20231101_140650,10863862.png,317432,3982,313450,0.9874555810378286,1,3,66058,585,65473,0.9911441460534681,43.673390222222224,8783.888586666666,8.693935422435349,140,4.700000000000006E-4
8,test_20231101_140650,11382381.png,312486,327,312159,0.9989535531191798,2,3,46745,44,46701,0.9990587228580596,23.441726222222222,2963.055792,13.413405318888326,140,4.700000000000006E-4
9,test_20231101_140650,11079715.png,443815,82967,360848,0.8130594955105168,3,4,124136,11738,112398,0.9054424179931688,19.892592,2949.074736,13.43394582205185,140,4.700000000000006E-4
10,test_20231101_140650,11551286.png,271883,24,271859,0.9999117267353972,1,4,40092,1,40091,0.9999750573680535,24.866876444444443,3470.407338666667,12.72699907819776,140,4.700000000000006E-4
1,test_20231101_140651,10404007.png,502730,8002,494728,0.984082907326,1,3,61265,1171,60094,0.9808863135558639,27.644737777777777,3964.361402666667,12.149071217071912,140,4.800000000000006E-4
2,test_20231101_140651,1254659.png,342646,28232,314414,0.9176059256492123,3,3,80080,4031,76049,0.9496628371628372,41.093029333333334,10586.7652,7.883170797402147,140,4.800000000000006E-4
3,test_20231101_140651,10188041.png,221231,6092,215139,0.9724631719786105,2,3,41731,859,40872,0.9794157820325418,12.86696888888889,1621.804128,16.03081959368511,140,4.800000000000006E-4
4,test_20231101_140651,10287332.png,216980,6747,210233,0.9689049681998341,1,3,22337,921,21416,0.9587679634686842,13.06504,1886.4791733333334,15.374283459009131,140,4.800000000000006E-4
5,test_20231101_140651,11610969.png,368720,8354,360366,0.9773432414840529,2,3,84111,1236,82875,0.9853051325034775,38.45282311111111,7027.006309333334,9.66310017390828,140,4.800000000000006E-4
6,test_20231101_140651,10350842.png,212614,2244,210370,0.989445662091866,1,4,42529,330,42199,0.9922405887747184,25.686323555555557,3929.788144,12.187112228008296,140,4.800000000000006E-4
7,test_20231101_140651,10863862.png,317432,3982,313450,0.9874555810378286,1,4,66058,585,65473,0.9911441460534681,43.673390222222224,8783.888586666666,8.693935422435349,140,4.800000000000006E-4
8,test_20231101_140651,11382381.png,312486,327,312159,0.9989535531191798,1,4,46745,44,46701,0.9990587228580596,23.441726222222222,2963.055792,13.413405318888326,140,4.800000000000006E-4
9,test_20231101_140651,11079715.png,443815,82967,360848,0.8130594955105168,10,4,124136,11738,112398,0.9054424179931688,19.892592,2949.074736,13.43394582205185,140,4.800000000000006E-4
10,test_20231101_140651,11551286.png,271883,24,271859,0.9999117267353972,0,3,40092,1,40091,0.9999750573680535,24.866876444444443,3470.407338666667,12.72699907819776,140,4.800000000000006E-4
1,test_20231101_140651,10404007.png,502730,8002,494728,0.984082907326,2,4,61265,1171,60094,0.9808863135558639,27.644737777777777,3964.361402666667,12.149071217071912,140,4.900000000000006E-4
2,test_20231101_140651,1254659.png,342646,28232,314414,0.9176059256492123,1,8,80080,4031,76049,0.9496628371628372,41.093029333333334,10586.7652,7.883170797402147,140,4.900000000000006E-4
3,test_20231101_140651,10188041.png,221231,6092,215139,0.9724631719786105,2,3,41731,859,40872,0.9794157820325418,12.86696888888889,1621.804128,16.03081959368511,140,4.900000000000006E-4
4,test_20231101_140651,10287332.png,216980,6747,210233,0.9689049681998341,2,4,22337,921,21416,0.9587679634686842,13.06504,1886.4791733333334,15.374283459009131,140,4.900000000000006E-4
5,test_20231101_140651,11610969.png,368720,8354,360366,0.9773432414840529,1,3,84111,1236,82875,0.9853051325034775,38.45282311111111,7027.006309333334,9.66310017390828,140,4.900000000000006E-4
6,test_20231101_140651,10350842.png,212614,2244,210370,0.989445662091866,2,4,42529,330,42199,0.9922405887747184,25.686323555555557,3929.788144,12.187112228008296,140,4.900000000000006E-4
7,test_20231101_140651,10863862.png,317432,3982,313450,0.9874555810378286,2,4,66058,585,65473,0.9911441460534681,43.673390222222224,8783.888586666666,8.693935422435349,140,4.900000000000006E-4
8,test_20231101_140651,11382381.png,312486,327,312159,0.9989535531191798,1,4,46745,44,46701,0.9990587228580596,23.441726222222222,2963.055792,13.413405318888326,140,4.900000000000006E-4
9,test_20231101_140651,11079715.png,443815,82967,360848,0.8130594955105168,3,4,124136,11738,112398,0.9054424179931688,19.892592,2949.074736,13.43394582205185,140,4.900000000000006E-4
10,test_20231101_140651,11551286.png,271883,24,271859,0.9999117267353972,1,3,40092,1,40091,0.9999750573680535,24.866876444444443,3470.407338666667,12.72699907819776,140,4.900000000000006E-4
1,test_20231101_140652,10404007.png,502730,8002,494728,0.984082907326,1,3,61265,1171,60094,0.9808863135558639,27.644737777777777,3964.361402666667,12.149071217071912,140,5.000000000000007E-4
2,test_20231101_140652,1254659.png,342646,28232,314414,0.9176059256492123,2,4,80080,4031,76049,0.9496628371628372,41.093029333333334,10586.7652,7.883170797402147,140,5.000000000000007E-4
3,test_20231101_140652,10188041.png,221231,6092,215139,0.9724631719786105,2,4,41731,859,40872,0.9794157820325418,12.86696888888889,1621.804128,16.03081959368511,140,5.000000000000007E-4
4,test_20231101_140652,10287332.png,216980,6747,210233,0.9689049681998341,2,4,22337,921,21416,0.9587679634686842,13.06504,1886.4791733333334,15.374283459009131,140,5.000000000000007E-4
5,test_20231101_140652,11610969.png,368720,8354,360366,0.9773432414840529,1,4,84111,1236,82875,0.9853051325034775,38.45282311111111,7027.006309333334,9.66310017390828,140,5.000000000000007E-4
6,test_20231101_140652,10350842.png,212614,2244,210370,0.989445662091866,1,4,42529,330,42199,0.9922405887747184,25.686323555555557,3929.788144,12.187112228008296,140,5.000000000000007E-4
7,test_20231101_140652,10863862.png,317432,3982,313450,0.9874555810378286,2,3,66058,585,65473,0.9911441460534681,43.673390222222224,8783.888586666666,8.693935422435349,140,5.000000000000007E-4
8,test_20231101_140652,11382381.png,312486,327,312159,0.9989535531191798,2,3,46745,44,46701,0.9990587228580596,23.441726222222222,2963.055792,13.413405318888326,140,5.000000000000007E-4
9,test_20231101_140652,11079715.png,443815,82967,360848,0.8130594955105168,4,4,124136,11738,112398,0.9054424179931688,19.892592,2949.074736,13.43394582205185,140,5.000000000000007E-4
10,test_20231101_140652,11551286.png,271883,24,271859,0.9999117267353972,0,7,40092,1,40091,0.9999750573680535,24.866876444444443,3470.407338666667,12.72699907819776,140,5.000000000000007E-4
1,test_20231101_140653,10404007.png,502730,7962,494768,0.9841624728979771,2,4,61265,1165,60100,0.9809842487554068,27.647635555555556,3965.1143733333333,12.148246418520811,140,5.100000000000007E-4
2,test_20231101_140653,1254659.png,342646,28232,314414,0.9176059256492123,2,4,80080,4031,76049,0.9496628371628372,41.093029333333334,10586.7652,7.883170797402147,140,5.100000000000007E-4
3,test_20231101_140653,10188041.png,221231,6092,215139,0.9724631719786105,2,4,41731,859,40872,0.9794157820325418,12.86696888888889,1621.804128,16.03081959368511,140,5.100000000000007E-4
4,test_20231101_140653,10287332.png,216980,6747,210233,0.9689049681998341,2,4,22337,921,21416,0.9587679634686842,13.06504,1886.4791733333334,15.374283459009131,140,5.100000000000007E-4
5,test_20231101_140653,11610969.png,368720,8354,360366,0.9773432414840529,2,3,84111,1236,82875,0.9853051325034775,38.45282311111111,7027.006309333334,9.66310017390828,140,5.100000000000007E-4
6,test_20231101_140653,10350842.png,212614,2244,210370,0.989445662091866,1,4,42529,330,42199,0.9922405887747184,25.686323555555557,3929.788144,12.187112228008296,140,5.100000000000007E-4
7,test_20231101_140653,10863862.png,317432,3982,313450,0.9874555810378286,1,3,66058,585,65473,0.9911441460534681,43.673390222222224,8783.888586666666,8.693935422435349,140,5.100000000000007E-4
8,test_20231101_140653,11382381.png,312486,327,312159,0.9989535531191798,1,7,46745,44,46701,0.9990587228580596,23.441726222222222,2963.055792,13.413405318888326,140,5.100000000000007E-4
9,test_20231101_140653,11079715.png,443815,82807,361008,0.8134200060836159,3,4,124136,11714,112422,0.9056357543339563,20.129482666666668,2990.9371413333333,13.372730750378414,140,5.100000000000007E-4
10,test_20231101_140653,11551286.png,271883,24,271859,0.9999117267353972,0,3,40092,1,40091,0.9999750573680535,24.866876444444443,3470.407338666667,12.72699907819776,140,5.100000000000007E-4
1,test_20231101_140653,10404007.png,502730,7962,494768,0.9841624728979771,2,4,61265,1165,60100,0.9809842487554068,27.647635555555556,3965.1143733333333,12.148246418520811,140,5.200000000000007E-4
2,test_20231101_140653,1254659.png,342646,28232,314414,0.9176059256492123,2,3,80080,4031,76049,0.9496628371628372,41.093029333333334,10586.7652,7.883170797402147,140,5.200000000000007E-4
3,test_20231101_140653,10188041.png,221231,6092,215139,0.9724631719786105,2,4,41731,859,40872,0.9794157820325418,12.86696888888889,1621.804128,16.03081959368511,140,5.200000000000007E-4
4,test_20231101_140653,10287332.png,216980,6747,210233,0.9689049681998341,2,3,22337,921,21416,0.9587679634686842,13.06504,1886.4791733333334,15.374283459009131,140,5.200000000000007E-4
5,test_20231101_140653,11610969.png,368720,8354,360366,0.9773432414840529,2,3,84111,1236,82875,0.9853051325034775,38.45282311111111,7027.006309333334,9.66310017390828,140,5.200000000000007E-4
6,test_20231101_140653,10350842.png,212614,1922,210692,0.9909601437346552,2,4,42529,282,42247,0.9933692304074867,26.5576,4142.903701333334,11.95775522299427,140,5.200000000000007E-4
7,test_20231101_140653,10863862.png,317432,3982,313450,0.9874555810378286,2,4,66058,585,65473,0.9911441460534681,43.673390222222224,8783.888586666666,8.693935422435349,140,5.200000000000007E-4
8,test_20231101_140653,11382381.png,312486,327,312159,0.9989535531191798,1,4,46745,44,46701,0.9990587228580596,23.441726222222222,2963.055792,13.413405318888326,140,5.200000000000007E-4
9,test_20231101_140653,11079715.png,443815,82807,361008,0.8134200060836159,3,4,124136,11714,112422,0.9056357543339563,20.129482666666668,2990.9371413333333,13.372730750378414,140,5.200000000000007E-4
10,test_20231101_140653,11551286.png,271883,24,271859,0.9999117267353972,0,9,40092,1,40091,0.9999750573680535,24.866876444444443,3470.407338666667,12.72699907819776,140,5.200000000000007E-4
1,test_20231101_140654,10404007.png,502730,7962,494768,0.9841624728979771,6,4,61265,1165,60100,0.9809842487554068,27.647635555555556,3965.1143733333333,12.148246418520811,140,5.300000000000007E-4
2,test_20231101_140654,1254659.png,342646,28232,314414,0.9176059256492123,2,3,80080,4031,76049,0.9496628371628372,41.093029333333334,10586.7652,7.883170797402147,140,5.300000000000007E-4
3,test_20231101_140654,10188041.png,221231,6092,215139,0.9724631719786105,2,10,41731,859,40872,0.9794157820325418,12.86696888888889,1621.804128,16.03081959368511,140,5.300000000000007E-4
4,test_20231101_140654,10287332.png,216980,6747,210233,0.9689049681998341,2,4,22337,921,21416,0.9587679634686842,13.06504,1886.4791733333334,15.374283459009131,140,5.300000000000007E-4
5,test_20231101_140654,11610969.png,368720,8354,360366,0.9773432414840529,2,3,84111,1236,82875,0.9853051325034775,38.45282311111111,7027.006309333334,9.66310017390828,140,5.300000000000007E-4
6,test_20231101_140654,10350842.png,212614,1922,210692,0.9909601437346552,1,4,42529,282,42247,0.9933692304074867,26.5576,4142.903701333334,11.95775522299427,140,5.300000000000007E-4
7,test_20231101_140654,10863862.png,317432,3982,313450,0.9874555810378286,1,4,66058,585,65473,0.9911441460534681,43.673390222222224,8783.888586666666,8.693935422435349,140,5.300000000000007E-4
8,test_20231101_140654,11382381.png,312486,327,312159,0.9989535531191798,1,3,46745,44,46701,0.9990587228580596,23.441726222222222,2963.055792,13.413405318888326,140,5.300000000000007E-4
9,test_20231101_140654,11079715.png,443815,82807,361008,0.8134200060836159,3,4,124136,11714,112422,0.9056357543339563,20.129482666666668,2990.9371413333333,13.372730750378414,140,5.300000000000007E-4
10,test_20231101_140654,11551286.png,271883,24,271859,0.9999117267353972,0,4,40092,1,40091,0.9999750573680535,24.866876444444443,3470.407338666667,12.72699907819776,140,5.300000000000007E-4
1,test_20231101_140655,10404007.png,502730,7962,494768,0.9841624728979771,2,4,61265,1165,60100,0.9809842487554068,27.647635555555556,3965.1143733333333,12.148246418520811,140,5.400000000000008E-4
2,test_20231101_140655,1254659.png,342646,28232,314414,0.9176059256492123,3,4,80080,4031,76049,0.9496628371628372,41.093029333333334,10586.7652,7.883170797402147,140,5.400000000000008E-4
3,test_20231101_140655,10188041.png,221231,6092,215139,0.9724631719786105,2,4,41731,859,40872,0.9794157820325418,12.86696888888889,1621.804128,16.03081959368511,140,5.400000000000008E-4
4,test_20231101_140655,10287332.png,216980,6747,210233,0.9689049681998341,1,3,22337,921,21416,0.9587679634686842,13.06504,1886.4791733333334,15.374283459009131,140,5.400000000000008E-4
5,test_20231101_140655,11610969.png,368720,8354,360366,0.9773432414840529,1,3,84111,1236,82875,0.9853051325034775,38.45282311111111,7027.006309333334,9.66310017390828,140,5.400000000000008E-4
6,test_20231101_140655,10350842.png,212614,1922,210692,0.9909601437346552,2,3,42529,282,42247,0.9933692304074867,26.5576,4142.903701333334,11.95775522299427,140,5.400000000000008E-4
7,test_20231101_140655,10863862.png,317432,3982,313450,0.9874555810378286,1,4,66058,585,65473,0.9911441460534681,43.673390222222224,8783.888586666666,8.693935422435349,140,5.400000000000008E-4
8,test_20231101_140655,11382381.png,312486,327,312159,0.9989535531191798,1,3,46745,44,46701,0.9990587228580596,23.441726222222222,2963.055792,13.413405318888326,140,5.400000000000008E-4
9,test_20231101_140655,11079715.png,443815,82807,361008,0.8134200060836159,3,4,124136,11714,112422,0.9056357543339563,20.129482666666668,2990.9371413333333,13.372730750378414,140,5.400000000000008E-4
10,test_20231101_140655,11551286.png,271883,24,271859,0.9999117267353972,1,3,40092,1,40091,0.9999750573680535,24.866876444444443,3470.407338666667,12.72699907819776,140,5.400000000000008E-4
1,test_20231101_140655,10404007.png,502730,7962,494768,0.9841624728979771,1,3,61265,1165,60100,0.9809842487554068,27.647635555555556,3965.1143733333333,12.148246418520811,140,5.500000000000008E-4
2,test_20231101_140655,1254659.png,342646,28232,314414,0.9176059256492123,2,4,80080,4031,76049,0.9496628371628372,41.093029333333334,10586.7652,7.883170797402147,140,5.500000000000008E-4
3,test_20231101_140655,10188041.png,221231,6092,215139,0.9724631719786105,1,3,41731,859,40872,0.9794157820325418,12.86696888888889,1621.804128,16.03081959368511,140,5.500000000000008E-4
4,test_20231101_140655,10287332.png,216980,6747,210233,0.9689049681998341,2,4,22337,921,21416,0.9587679634686842,13.06504,1886.4791733333334,15.374283459009131,140,5.500000000000008E-4
5,test_20231101_140655,11610969.png,368720,8354,360366,0.9773432414840529,2,3,84111,1236,82875,0.9853051325034775,38.45282311111111,7027.006309333334,9.66310017390828,140,5.500000000000008E-4
6,test_20231101_140655,10350842.png,212614,1922,210692,0.9909601437346552,1,4,42529,282,42247,0.9933692304074867,26.5576,4142.903701333334,11.95775522299427,140,5.500000000000008E-4
7,test_20231101_140655,10863862.png,317432,3982,313450,0.9874555810378286,1,3,66058,585,65473,0.9911441460534681,43.673390222222224,8783.888586666666,8.693935422435349,140,5.500000000000008E-4
8,test_20231101_140655,11382381.png,312486,327,312159,0.9989535531191798,1,3,46745,44,46701,0.9990587228580596,23.441726222222222,2963.055792,13.413405318888326,140,5.500000000000008E-4
9,test_20231101_140655,11079715.png,443815,82807,361008,0.8134200060836159,3,4,124136,11714,112422,0.9056357543339563,20.129482666666668,2990.9371413333333,13.372730750378414,140,5.500000000000008E-4
10,test_20231101_140655,11551286.png,271883,24,271859,0.9999117267353972,1,4,40092,1,40091,0.9999750573680535,24.866876444444443,3470.407338666667,12.72699907819776,140,5.500000000000008E-4
1,test_20231101_140656,10404007.png,502730,7962,494768,0.9841624728979771,2,3,61265,1165,60100,0.9809842487554068,27.647635555555556,3965.1143733333333,12.148246418520811,140,5.600000000000008E-4
2,test_20231101_140656,1254659.png,342646,28232,314414,0.9176059256492123,2,3,80080,4031,76049,0.9496628371628372,41.093029333333334,10586.7652,7.883170797402147,140,5.600000000000008E-4
3,test_20231101_140656,10188041.png,221231,6092,215139,0.9724631719786105,2,3,41731,859,40872,0.9794157820325418,12.86696888888889,1621.804128,16.03081959368511,140,5.600000000000008E-4
4,test_20231101_140656,10287332.png,216980,6747,210233,0.9689049681998341,1,3,22337,921,21416,0.9587679634686842,13.06504,1886.4791733333334,15.374283459009131,140,5.600000000000008E-4
5,test_20231101_140656,11610969.png,368720,8354,360366,0.9773432414840529,2,4,84111,1236,82875,0.9853051325034775,38.45282311111111,7027.006309333334,9.66310017390828,140,5.600000000000008E-4
6,test_20231101_140656,10350842.png,212614,1922,210692,0.9909601437346552,1,3,42529,282,42247,0.9933692304074867,26.5576,4142.903701333334,11.95775522299427,140,5.600000000000008E-4
7,test_20231101_140656,10863862.png,317432,3982,313450,0.9874555810378286,1,3,66058,585,65473,0.9911441460534681,43.673390222222224,8783.888586666666,8.693935422435349,140,5.600000000000008E-4
8,test_20231101_140656,11382381.png,312486,327,312159,0.9989535531191798,1,3,46745,44,46701,0.9990587228580596,23.441726222222222,2963.055792,13.413405318888326,140,5.600000000000008E-4
9,test_20231101_140656,11079715.png,443815,82807,361008,0.8134200060836159,3,4,124136,11714,112422,0.9056357543339563,20.129482666666668,2990.9371413333333,13.372730750378414,140,5.600000000000008E-4
10,test_20231101_140656,11551286.png,271883,24,271859,0.9999117267353972,0,3,40092,1,40091,0.9999750573680535,24.866876444444443,3470.407338666667,12.72699907819776,140,5.600000000000008E-4
1,test_20231101_140657,10404007.png,502730,7962,494768,0.9841624728979771,2,4,61265,1165,60100,0.9809842487554068,27.647635555555556,3965.1143733333333,12.148246418520811,140,5.700000000000008E-4
2,test_20231101_140657,1254659.png,342646,28232,314414,0.9176059256492123,2,4,80080,4031,76049,0.9496628371628372,41.093029333333334,10586.7652,7.883170797402147,140,5.700000000000008E-4
3,test_20231101_140657,10188041.png,221231,6092,215139,0.9724631719786105,2,4,41731,859,40872,0.9794157820325418,12.86696888888889,1621.804128,16.03081959368511,140,5.700000000000008E-4
4,test_20231101_140657,10287332.png,216980,6747,210233,0.9689049681998341,2,3,22337,921,21416,0.9587679634686842,13.06504,1886.4791733333334,15.374283459009131,140,5.700000000000008E-4
5,test_20231101_140657,11610969.png,368720,8354,360366,0.9773432414840529,1,4,84111,1236,82875,0.9853051325034775,38.45282311111111,7027.006309333334,9.66310017390828,140,5.700000000000008E-4
6,test_20231101_140657,10350842.png,212614,1922,210692,0.9909601437346552,2,3,42529,282,42247,0.9933692304074867,26.5576,4142.903701333334,11.95775522299427,140,5.700000000000008E-4
7,test_20231101_140657,10863862.png,317432,3982,313450,0.9874555810378286,1,3,66058,585,65473,0.9911441460534681,43.673390222222224,8783.888586666666,8.693935422435349,140,5.700000000000008E-4
8,test_20231101_140657,11382381.png,312486,327,312159,0.9989535531191798,1,3,46745,44,46701,0.9990587228580596,23.441726222222222,2963.055792,13.413405318888326,140,5.700000000000008E-4
9,test_20231101_140657,11079715.png,443815,82807,361008,0.8134200060836159,3,4,124136,11714,112422,0.9056357543339563,20.129482666666668,2990.9371413333333,13.372730750378414,140,5.700000000000008E-4
10,test_20231101_140657,11551286.png,271883,24,271859,0.9999117267353972,0,3,40092,1,40091,0.9999750573680535,24.866876444444443,3470.407338666667,12.72699907819776,140,5.700000000000008E-4
1,test_20231101_140657,10404007.png,502730,7962,494768,0.9841624728979771,2,4,61265,1165,60100,0.9809842487554068,27.647635555555556,3965.1143733333333,12.148246418520811,140,5.800000000000009E-4
2,test_20231101_140657,1254659.png,342646,28232,314414,0.9176059256492123,2,3,80080,4031,76049,0.9496628371628372,41.093029333333334,10586.7652,7.883170797402147,140,5.800000000000009E-4
3,test_20231101_140657,10188041.png,221231,6012,215219,0.9728247849532842,2,4,41731,849,40882,0.9796554120438044,12.905870222222223,1625.8886293333333,16.01989567040669,140,5.800000000000009E-4
4,test_20231101_140657,10287332.png,216980,6747,210233,0.9689049681998341,1,4,22337,921,21416,0.9587679634686842,13.06504,1886.4791733333334,15.374283459009131,140,5.800000000000009E-4
5,test_20231101_140657,11610969.png,368720,8354,360366,0.9773432414840529,2,4,84111,1236,82875,0.9853051325034775,38.45282311111111,7027.006309333334,9.66310017390828,140,5.800000000000009E-4
6,test_20231101_140657,10350842.png,212614,1922,210692,0.9909601437346552,1,4,42529,282,42247,0.9933692304074867,26.5576,4142.903701333334,11.95775522299427,140,5.800000000000009E-4
7,test_20231101_140657,10863862.png,317432,3982,313450,0.9874555810378286,1,4,66058,585,65473,0.9911441460534681,43.673390222222224,8783.888586666666,8.693935422435349,140,5.800000000000009E-4
8,test_20231101_140657,11382381.png,312486,327,312159,0.9989535531191798,2,3,46745,44,46701,0.9990587228580596,23.441726222222222,2963.055792,13.413405318888326,140,5.800000000000009E-4
9,test_20231101_140657,11079715.png,443815,82807,361008,0.8134200060836159,3,4,124136,11714,112422,0.9056357543339563,20.129482666666668,2990.9371413333333,13.372730750378414,140,5.800000000000009E-4
10,test_20231101_140657,11551286.png,271883,24,271859,0.9999117267353972,1,3,40092,1,40091,0.9999750573680535,24.866876444444443,3470.407338666667,12.72699907819776,140,5.800000000000009E-4
1,test_20231101_140658,10404007.png,502730,7962,494768,0.9841624728979771,1,4,61265,1165,60100,0.9809842487554068,27.647635555555556,3965.1143733333333,12.148246418520811,140,5.900000000000009E-4
2,test_20231101_140658,1254659.png,342646,28232,314414,0.9176059256492123,2,4,80080,4031,76049,0.9496628371628372,41.093029333333334,10586.7652,7.883170797402147,140,5.900000000000009E-4
3,test_20231101_140658,10188041.png,221231,6012,215219,0.9728247849532842,1,3,41731,849,40882,0.9796554120438044,12.905870222222223,1625.8886293333333,16.01989567040669,140,5.900000000000009E-4
4,test_20231101_140658,10287332.png,216980,6747,210233,0.9689049681998341,1,3,22337,921,21416,0.9587679634686842,13.06504,1886.4791733333334,15.374283459009131,140,5.900000000000009E-4
5,test_20231101_140658,11610969.png,368720,8354,360366,0.9773432414840529,2,4,84111,1236,82875,0.9853051325034775,38.45282311111111,7027.006309333334,9.66310017390828,140,5.900000000000009E-4
6,test_20231101_140658,10350842.png,212614,1922,210692,0.9909601437346552,1,4,42529,282,42247,0.9933692304074867,26.5576,4142.903701333334,11.95775522299427,140,5.900000000000009E-4
7,test_20231101_140658,10863862.png,317432,3982,313450,0.9874555810378286,1,4,66058,585,65473,0.9911441460534681,43.673390222222224,8783.888586666666,8.693935422435349,140,5.900000000000009E-4
8,test_20231101_140658,11382381.png,312486,327,312159,0.9989535531191798,2,4,46745,44,46701,0.9990587228580596,23.441726222222222,2963.055792,13.413405318888326,140,5.900000000000009E-4
9,test_20231101_140658,11079715.png,443815,82807,361008,0.8134200060836159,2,4,124136,11714,112422,0.9056357543339563,20.129482666666668,2990.9371413333333,13.372730750378414,140,5.900000000000009E-4
10,test_20231101_140658,11551286.png,271883,24,271859,0.9999117267353972,1,3,40092,1,40091,0.9999750573680535,24.866876444444443,3470.407338666667,12.72699907819776,140,5.900000000000009E-4
1,test_20231101_140659,10404007.png,502730,7962,494768,0.9841624728979771,1,3,61265,1165,60100,0.9809842487554068,27.647635555555556,3965.1143733333333,12.148246418520811,140,6.000000000000009E-4
2,test_20231101_140659,1254659.png,342646,28232,314414,0.9176059256492123,2,4,80080,4031,76049,0.9496628371628372,41.093029333333334,10586.7652,7.883170797402147,140,6.000000000000009E-4
3,test_20231101_140659,10188041.png,221231,6012,215219,0.9728247849532842,2,3,41731,849,40882,0.9796554120438044,12.905870222222223,1625.8886293333333,16.01989567040669,140,6.000000000000009E-4
4,test_20231101_140659,10287332.png,216980,6747,210233,0.9689049681998341,1,3,22337,921,21416,0.9587679634686842,13.06504,1886.4791733333334,15.374283459009131,140,6.000000000000009E-4
5,test_20231101_140659,11610969.png,368720,8354,360366,0.9773432414840529,2,3,84111,1236,82875,0.9853051325034775,38.45282311111111,7027.006309333334,9.66310017390828,140,6.000000000000009E-4
6,test_20231101_140659,10350842.png,212614,1922,210692,0.9909601437346552,1,3,42529,282,42247,0.9933692304074867,26.5576,4142.903701333334,11.95775522299427,140,6.000000000000009E-4
7,test_20231101_140659,10863862.png,317432,3982,313450,0.9874555810378286,2,4,66058,585,65473,0.9911441460534681,43.673390222222224,8783.888586666666,8.693935422435349,140,6.000000000000009E-4
8,test_20231101_140659,11382381.png,312486,327,312159,0.9989535531191798,1,3,46745,44,46701,0.9990587228580596,23.441726222222222,2963.055792,13.413405318888326,140,6.000000000000009E-4
9,test_20231101_140659,11079715.png,443815,82807,361008,0.8134200060836159,3,4,124136,11714,112422,0.9056357543339563,20.129482666666668,2990.9371413333333,13.372730750378414,140,6.000000000000009E-4
10,test_20231101_140659,11551286.png,271883,24,271859,0.9999117267353972,1,10,40092,1,40091,0.9999750573680535,24.866876444444443,3470.407338666667,12.72699907819776,140,6.000000000000009E-4
1,test_20231101_140659,10404007.png,502730,7962,494768,0.9841624728979771,1,4,61265,1165,60100,0.9809842487554068,27.647635555555556,3965.1143733333333,12.148246418520811,140,6.10000000000001E-4
2,test_20231101_140659,1254659.png,342646,28232,314414,0.9176059256492123,2,4,80080,4031,76049,0.9496628371628372,41.093029333333334,10586.7652,7.883170797402147,140,6.10000000000001E-4
3,test_20231101_140659,10188041.png,221231,6012,215219,0.9728247849532842,2,3,41731,849,40882,0.9796554120438044,12.905870222222223,1625.8886293333333,16.01989567040669,140,6.10000000000001E-4
4,test_20231101_140659,10287332.png,216980,6747,210233,0.9689049681998341,2,3,22337,921,21416,0.9587679634686842,13.06504,1886.4791733333334,15.374283459009131,140,6.10000000000001E-4
5,test_20231101_140659,11610969.png,368720,8354,360366,0.9773432414840529,2,4,84111,1236,82875,0.9853051325034775,38.45282311111111,7027.006309333334,9.66310017390828,140,6.10000000000001E-4
6,test_20231101_140659,10350842.png,212614,1922,210692,0.9909601437346552,1,3,42529,282,42247,0.9933692304074867,26.5576,4142.903701333334,11.95775522299427,140,6.10000000000001E-4
7,test_20231101_140659,10863862.png,317432,3982,313450,0.9874555810378286,2,4,66058,585,65473,0.9911441460534681,43.673390222222224,8783.888586666666,8.693935422435349,140,6.10000000000001E-4
8,test_20231101_140659,11382381.png,312486,327,312159,0.9989535531191798,1,4,46745,44,46701,0.9990587228580596,23.441726222222222,2963.055792,13.413405318888326,140,6.10000000000001E-4
9,test_20231101_140659,11079715.png,443815,82807,361008,0.8134200060836159,3,4,124136,11714,112422,0.9056357543339563,20.129482666666668,2990.9371413333333,13.372730750378414,140,6.10000000000001E-4
10,test_20231101_140659,11551286.png,271883,24,271859,0.9999117267353972,0,4,40092,1,40091,0.9999750573680535,24.866876444444443,3470.407338666667,12.72699907819776,140,6.10000000000001E-4
1,test_20231101_140700,10404007.png,502730,7962,494768,0.9841624728979771,2,4,61265,1165,60100,0.9809842487554068,27.647635555555556,3965.1143733333333,12.148246418520811,140,6.20000000000001E-4
2,test_20231101_140700,1254659.png,342646,28232,314414,0.9176059256492123,2,4,80080,4031,76049,0.9496628371628372,41.093029333333334,10586.7652,7.883170797402147,140,6.20000000000001E-4
3,test_20231101_140700,10188041.png,221231,6012,215219,0.9728247849532842,2,4,41731,849,40882,0.9796554120438044,12.905870222222223,1625.8886293333333,16.01989567040669,140,6.20000000000001E-4
4,test_20231101_140700,10287332.png,216980,6747,210233,0.9689049681998341,1,3,22337,921,21416,0.9587679634686842,13.06504,1886.4791733333334,15.374283459009131,140,6.20000000000001E-4
5,test_20231101_140700,11610969.png,368720,8354,360366,0.9773432414840529,2,4,84111,1236,82875,0.9853051325034775,38.45282311111111,7027.006309333334,9.66310017390828,140,6.20000000000001E-4
6,test_20231101_140700,10350842.png,212614,1922,210692,0.9909601437346552,1,4,42529,282,42247,0.9933692304074867,26.5576,4142.903701333334,11.95775522299427,140,6.20000000000001E-4
7,test_20231101_140700,10863862.png,317432,3982,313450,0.9874555810378286,1,4,66058,585,65473,0.9911441460534681,43.673390222222224,8783.888586666666,8.693935422435349,140,6.20000000000001E-4
8,test_20231101_140700,11382381.png,312486,327,312159,0.9989535531191798,2,4,46745,44,46701,0.9990587228580596,23.441726222222222,2963.055792,13.413405318888326,140,6.20000000000001E-4
9,test_20231101_140700,11079715.png,443815,82807,361008,0.8134200060836159,2,4,124136,11714,112422,0.9056357543339563,20.129482666666668,2990.9371413333333,13.372730750378414,140,6.20000000000001E-4
10,test_20231101_140700,11551286.png,271883,24,271859,0.9999117267353972,1,4,40092,1,40091,0.9999750573680535,24.866876444444443,3470.407338666667,12.72699907819776,140,6.20000000000001E-4
1,test_20231101_140701,10404007.png,502730,7962,494768,0.9841624728979771,2,4,61265,1165,60100,0.9809842487554068,27.647635555555556,3965.1143733333333,12.148246418520811,140,6.30000000000001E-4
2,test_20231101_140701,1254659.png,342646,28232,314414,0.9176059256492123,3,4,80080,4031,76049,0.9496628371628372,41.093029333333334,10586.7652,7.883170797402147,140,6.30000000000001E-4
3,test_20231101_140701,10188041.png,221231,6012,215219,0.9728247849532842,2,3,41731,849,40882,0.9796554120438044,12.905870222222223,1625.8886293333333,16.01989567040669,140,6.30000000000001E-4
4,test_20231101_140701,10287332.png,216980,6747,210233,0.9689049681998341,2,4,22337,921,21416,0.9587679634686842,13.06504,1886.4791733333334,15.374283459009131,140,6.30000000000001E-4
5,test_20231101_140701,11610969.png,368720,8354,360366,0.9773432414840529,1,3,84111,1236,82875,0.9853051325034775,38.45282311111111,7027.006309333334,9.66310017390828,140,6.30000000000001E-4
6,test_20231101_140701,10350842.png,212614,1922,210692,0.9909601437346552,1,3,42529,282,42247,0.9933692304074867,26.5576,4142.903701333334,11.95775522299427,140,6.30000000000001E-4
7,test_20231101_140701,10863862.png,317432,3982,313450,0.9874555810378286,2,3,66058,585,65473,0.9911441460534681,43.673390222222224,8783.888586666666,8.693935422435349,140,6.30000000000001E-4
8,test_20231101_140701,11382381.png,312486,327,312159,0.9989535531191798,1,4,46745,44,46701,0.9990587228580596,23.441726222222222,2963.055792,13.413405318888326,140,6.30000000000001E-4
9,test_20231101_140701,11079715.png,443815,82807,361008,0.8134200060836159,4,4,124136,11714,112422,0.9056357543339563,20.129482666666668,2990.9371413333333,13.372730750378414,140,6.30000000000001E-4
10,test_20231101_140701,11551286.png,271883,24,271859,0.9999117267353972,0,3,40092,1,40091,0.9999750573680535,24.866876444444443,3470.407338666667,12.72699907819776,140,6.30000000000001E-4
1,test_20231101_140701,10404007.png,502730,7962,494768,0.9841624728979771,2,4,61265,1165,60100,0.9809842487554068,27.647635555555556,3965.1143733333333,12.148246418520811,140,6.40000000000001E-4
2,test_20231101_140701,1254659.png,342646,28232,314414,0.9176059256492123,2,3,80080,4031,76049,0.9496628371628372,41.093029333333334,10586.7652,7.883170797402147,140,6.40000000000001E-4
3,test_20231101_140701,10188041.png,221231,6012,215219,0.9728247849532842,2,3,41731,849,40882,0.9796554120438044,12.905870222222223,1625.8886293333333,16.01989567040669,140,6.40000000000001E-4
4,test_20231101_140701,10287332.png,216980,6747,210233,0.9689049681998341,2,4,22337,921,21416,0.9587679634686842,13.06504,1886.4791733333334,15.374283459009131,140,6.40000000000001E-4
5,test_20231101_140701,11610969.png,368720,8354,360366,0.9773432414840529,3,3,84111,1236,82875,0.9853051325034775,38.45282311111111,7027.006309333334,9.66310017390828,140,6.40000000000001E-4
6,test_20231101_140701,10350842.png,212614,1922,210692,0.9909601437346552,2,3,42529,282,42247,0.9933692304074867,26.5576,4142.903701333334,11.95775522299427,140,6.40000000000001E-4
7,test_20231101_140701,10863862.png,317432,3982,313450,0.9874555810378286,3,4,66058,585,65473,0.9911441460534681,43.673390222222224,8783.888586666666,8.693935422435349,140,6.40000000000001E-4
8,test_20231101_140701,11382381.png,312486,327,312159,0.9989535531191798,2,3,46745,44,46701,0.9990587228580596,23.441726222222222,2963.055792,13.413405318888326,140,6.40000000000001E-4
9,test_20231101_140701,11079715.png,443815,82807,361008,0.8134200060836159,4,4,124136,11714,112422,0.9056357543339563,20.129482666666668,2990.9371413333333,13.372730750378414,140,6.40000000000001E-4
10,test_20231101_140701,11551286.png,271883,24,271859,0.9999117267353972,0,3,40092,1,40091,0.9999750573680535,24.866876444444443,3470.407338666667,12.72699907819776,140,6.40000000000001E-4
1,test_20231101_140702,10404007.png,502730,7962,494768,0.9841624728979771,2,4,61265,1165,60100,0.9809842487554068,27.647635555555556,3965.1143733333333,12.148246418520811,140,6.500000000000011E-4
2,test_20231101_140702,1254659.png,342646,28232,314414,0.9176059256492123,3,3,80080,4031,76049,0.9496628371628372,41.093029333333334,10586.7652,7.883170797402147,140,6.500000000000011E-4
3,test_20231101_140702,10188041.png,221231,6012,215219,0.9728247849532842,2,4,41731,849,40882,0.9796554120438044,12.905870222222223,1625.8886293333333,16.01989567040669,140,6.500000000000011E-4
4,test_20231101_140702,10287332.png,216980,6747,210233,0.9689049681998341,1,3,22337,921,21416,0.9587679634686842,13.06504,1886.4791733333334,15.374283459009131,140,6.500000000000011E-4
5,test_20231101_140702,11610969.png,368720,8354,360366,0.9773432414840529,2,4,84111,1236,82875,0.9853051325034775,38.45282311111111,7027.006309333334,9.66310017390828,140,6.500000000000011E-4
6,test_20231101_140702,10350842.png,212614,1922,210692,0.9909601437346552,1,3,42529,282,42247,0.9933692304074867,26.5576,4142.903701333334,11.95775522299427,140,6.500000000000011E-4
7,test_20231101_140702,10863862.png,317432,3982,313450,0.9874555810378286,1,3,66058,585,65473,0.9911441460534681,43.673390222222224,8783.888586666666,8.693935422435349,140,6.500000000000011E-4
8,test_20231101_140702,11382381.png,312486,327,312159,0.9989535531191798,1,4,46745,44,46701,0.9990587228580596,23.441726222222222,2963.055792,13.413405318888326,140,6.500000000000011E-4
9,test_20231101_140702,11079715.png,443815,82807,361008,0.8134200060836159,3,4,124136,11714,112422,0.9056357543339563,20.129482666666668,2990.9371413333333,13.372730750378414,140,6.500000000000011E-4
10,test_20231101_140702,11551286.png,271883,24,271859,0.9999117267353972,0,3,40092,1,40091,0.9999750573680535,24.866876444444443,3470.407338666667,12.72699907819776,140,6.500000000000011E-4
1,test_20231101_140703,10404007.png,502730,7962,494768,0.9841624728979771,2,4,61265,1165,60100,0.9809842487554068,27.647635555555556,3965.1143733333333,12.148246418520811,140,6.600000000000011E-4
2,test_20231101_140703,1254659.png,342646,28232,314414,0.9176059256492123,2,4,80080,4031,76049,0.9496628371628372,41.093029333333334,10586.7652,7.883170797402147,140,6.600000000000011E-4
3,test_20231101_140703,10188041.png,221231,6012,215219,0.9728247849532842,1,3,41731,849,40882,0.9796554120438044,12.905870222222223,1625.8886293333333,16.01989567040669,140,6.600000000000011E-4
4,test_20231101_140703,10287332.png,216980,6747,210233,0.9689049681998341,2,4,22337,921,21416,0.9587679634686842,13.06504,1886.4791733333334,15.374283459009131,140,6.600000000000011E-4
5,test_20231101_140703,11610969.png,368720,8354,360366,0.9773432414840529,1,4,84111,1236,82875,0.9853051325034775,38.45282311111111,7027.006309333334,9.66310017390828,140,6.600000000000011E-4
6,test_20231101_140703,10350842.png,212614,1922,210692,0.9909601437346552,2,3,42529,282,42247,0.9933692304074867,26.5576,4142.903701333334,11.95775522299427,140,6.600000000000011E-4
7,test_20231101_140703,10863862.png,317432,3982,313450,0.9874555810378286,1,3,66058,585,65473,0.9911441460534681,43.673390222222224,8783.888586666666,8.693935422435349,140,6.600000000000011E-4
8,test_20231101_140703,11382381.png,312486,327,312159,0.9989535531191798,1,3,46745,44,46701,0.9990587228580596,23.441726222222222,2963.055792,13.413405318888326,140,6.600000000000011E-4
9,test_20231101_140703,11079715.png,443815,82807,361008,0.8134200060836159,5,5,124136,11714,112422,0.9056357543339563,20.129482666666668,2990.9371413333333,13.372730750378414,140,6.600000000000011E-4
10,test_20231101_140703,11551286.png,271883,24,271859,0.9999117267353972,0,4,40092,1,40091,0.9999750573680535,24.866876444444443,3470.407338666667,12.72699907819776,140,6.600000000000011E-4
1,test_20231101_140704,10404007.png,502730,7962,494768,0.9841624728979771,2,4,61265,1165,60100,0.9809842487554068,27.647635555555556,3965.1143733333333,12.148246418520811,140,6.700000000000011E-4
2,test_20231101_140704,1254659.png,342646,28232,314414,0.9176059256492123,2,3,80080,4031,76049,0.9496628371628372,41.093029333333334,10586.7652,7.883170797402147,140,6.700000000000011E-4
3,test_20231101_140704,10188041.png,221231,6012,215219,0.9728247849532842,2,3,41731,849,40882,0.9796554120438044,12.905870222222223,1625.8886293333333,16.01989567040669,140,6.700000000000011E-4
4,test_20231101_140704,10287332.png,216980,6747,210233,0.9689049681998341,2,3,22337,921,21416,0.9587679634686842,13.06504,1886.4791733333334,15.374283459009131,140,6.700000000000011E-4
5,test_20231101_140704,11610969.png,368720,8354,360366,0.9773432414840529,2,3,84111,1236,82875,0.9853051325034775,38.45282311111111,7027.006309333334,9.66310017390828,140,6.700000000000011E-4
6,test_20231101_140704,10350842.png,212614,24,212590,0.9998871193806617,1,3,42529,1,42528,0.9999764866326507,55.22670577777778,11938.01408,7.361482740939017,140,6.700000000000011E-4
7,test_20231101_140704,10863862.png,317432,3982,313450,0.9874555810378286,1,7,66058,585,65473,0.9911441460534681,43.673390222222224,8783.888586666666,8.693935422435349,140,6.700000000000011E-4
8,test_20231101_140704,11382381.png,312486,327,312159,0.9989535531191798,2,3,46745,44,46701,0.9990587228580596,23.441726222222222,2963.055792,13.413405318888326,140,6.700000000000011E-4
9,test_20231101_140704,11079715.png,443815,82807,361008,0.8134200060836159,4,4,124136,11714,112422,0.9056357543339563,20.129482666666668,2990.9371413333333,13.372730750378414,140,6.700000000000011E-4
10,test_20231101_140704,11551286.png,271883,24,271859,0.9999117267353972,1,9,40092,1,40091,0.9999750573680535,24.866876444444443,3470.407338666667,12.72699907819776,140,6.700000000000011E-4
1,test_20231101_140704,10404007.png,502730,7962,494768,0.9841624728979771,2,3,61265,1165,60100,0.9809842487554068,27.647635555555556,3965.1143733333333,12.148246418520811,140,6.800000000000011E-4
2,test_20231101_140704,1254659.png,342646,28232,314414,0.9176059256492123,2,3,80080,4031,76049,0.9496628371628372,41.093029333333334,10586.7652,7.883170797402147,140,6.800000000000011E-4
3,test_20231101_140704,10188041.png,221231,6012,215219,0.9728247849532842,1,3,41731,849,40882,0.9796554120438044,12.905870222222223,1625.8886293333333,16.01989567040669,140,6.800000000000011E-4
4,test_20231101_140704,10287332.png,216980,6747,210233,0.9689049681998341,2,4,22337,921,21416,0.9587679634686842,13.06504,1886.4791733333334,15.374283459009131,140,6.800000000000011E-4
5,test_20231101_140704,11610969.png,368720,8354,360366,0.9773432414840529,2,4,84111,1236,82875,0.9853051325034775,38.45282311111111,7027.006309333334,9.66310017390828,140,6.800000000000011E-4
6,test_20231101_140704,10350842.png,212614,24,212590,0.9998871193806617,1,4,42529,1,42528,0.9999764866326507,55.22670577777778,11938.01408,7.361482740939017,140,6.800000000000011E-4
7,test_20231101_140704,10863862.png,317432,3982,313450,0.9874555810378286,2,3,66058,585,65473,0.9911441460534681,43.673390222222224,8783.888586666666,8.693935422435349,140,6.800000000000011E-4
8,test_20231101_140704,11382381.png,312486,327,312159,0.9989535531191798,1,4,46745,44,46701,0.9990587228580596,23.441726222222222,2963.055792,13.413405318888326,140,6.800000000000011E-4
9,test_20231101_140704,11079715.png,443815,82807,361008,0.8134200060836159,3,4,124136,11714,112422,0.9056357543339563,20.129482666666668,2990.9371413333333,13.372730750378414,140,6.800000000000011E-4
10,test_20231101_140704,11551286.png,271883,24,271859,0.9999117267353972,0,3,40092,1,40091,0.9999750573680535,24.866876444444443,3470.407338666667,12.72699907819776,140,6.800000000000011E-4
1,test_20231101_140705,10404007.png,502730,7962,494768,0.9841624728979771,2,3,61265,1165,60100,0.9809842487554068,27.647635555555556,3965.1143733333333,12.148246418520811,140,6.900000000000012E-4
2,test_20231101_140705,1254659.png,342646,28232,314414,0.9176059256492123,2,3,80080,4031,76049,0.9496628371628372,41.093029333333334,10586.7652,7.883170797402147,140,6.900000000000012E-4
3,test_20231101_140705,10188041.png,221231,6012,215219,0.9728247849532842,2,6,41731,849,40882,0.9796554120438044,12.905870222222223,1625.8886293333333,16.01989567040669,140,6.900000000000012E-4
4,test_20231101_140705,10287332.png,216980,6747,210233,0.9689049681998341,1,3,22337,921,21416,0.9587679634686842,13.06504,1886.4791733333334,15.374283459009131,140,6.900000000000012E-4
5,test_20231101_140705,11610969.png,368720,8354,360366,0.9773432414840529,2,4,84111,1236,82875,0.9853051325034775,38.45282311111111,7027.006309333334,9.66310017390828,140,6.900000000000012E-4
6,test_20231101_140705,10350842.png,212614,24,212590,0.9998871193806617,1,3,42529,1,42528,0.9999764866326507,55.22670577777778,11938.01408,7.361482740939017,140,6.900000000000012E-4
7,test_20231101_140705,10863862.png,317432,3982,313450,0.9874555810378286,1,4,66058,585,65473,0.9911441460534681,43.673390222222224,8783.888586666666,8.693935422435349,140,6.900000000000012E-4
8,test_20231101_140705,11382381.png,312486,327,312159,0.9989535531191798,2,3,46745,44,46701,0.9990587228580596,23.441726222222222,2963.055792,13.413405318888326,140,6.900000000000012E-4
9,test_20231101_140705,11079715.png,443815,82807,361008,0.8134200060836159,3,4,124136,11714,112422,0.9056357543339563,20.129482666666668,2990.9371413333333,13.372730750378414,140,6.900000000000012E-4
10,test_20231101_140705,11551286.png,271883,24,271859,0.9999117267353972,1,4,40092,1,40091,0.9999750573680535,24.866876444444443,3470.407338666667,12.72699907819776,140,6.900000000000012E-4
1,test_20231101_140706,10404007.png,502730,7962,494768,0.9841624728979771,2,3,61265,1165,60100,0.9809842487554068,27.647635555555556,3965.1143733333333,12.148246418520811,140,7.000000000000012E-4
2,test_20231101_140706,1254659.png,342646,28232,314414,0.9176059256492123,2,4,80080,4031,76049,0.9496628371628372,41.093029333333334,10586.7652,7.883170797402147,140,7.000000000000012E-4
3,test_20231101_140706,10188041.png,221231,6012,215219,0.9728247849532842,2,4,41731,849,40882,0.9796554120438044,12.905870222222223,1625.8886293333333,16.01989567040669,140,7.000000000000012E-4
4,test_20231101_140706,10287332.png,216980,6747,210233,0.9689049681998341,1,3,22337,921,21416,0.9587679634686842,13.06504,1886.4791733333334,15.374283459009131,140,7.000000000000012E-4
5,test_20231101_140706,11610969.png,368720,8354,360366,0.9773432414840529,2,3,84111,1236,82875,0.9853051325034775,38.45282311111111,7027.006309333334,9.66310017390828,140,7.000000000000012E-4
6,test_20231101_140706,10350842.png,212614,24,212590,0.9998871193806617,1,4,42529,1,42528,0.9999764866326507,55.22670577777778,11938.01408,7.361482740939017,140,7.000000000000012E-4
7,test_20231101_140706,10863862.png,317432,3982,313450,0.9874555810378286,2,4,66058,585,65473,0.9911441460534681,43.673390222222224,8783.888586666666,8.693935422435349,140,7.000000000000012E-4
8,test_20231101_140706,11382381.png,312486,327,312159,0.9989535531191798,1,4,46745,44,46701,0.9990587228580596,23.441726222222222,2963.055792,13.413405318888326,140,7.000000000000012E-4
9,test_20231101_140706,11079715.png,443815,82807,361008,0.8134200060836159,3,4,124136,11714,112422,0.9056357543339563,20.129482666666668,2990.9371413333333,13.372730750378414,140,7.000000000000012E-4
10,test_20231101_140706,11551286.png,271883,24,271859,0.9999117267353972,1,9,40092,1,40091,0.9999750573680535,24.866876444444443,3470.407338666667,12.72699907819776,140,7.000000000000012E-4
1,test_20231101_140706,10404007.png,502730,7962,494768,0.9841624728979771,1,3,61265,1165,60100,0.9809842487554068,27.647635555555556,3965.1143733333333,12.148246418520811,140,7.100000000000012E-4
2,test_20231101_140706,1254659.png,342646,28232,314414,0.9176059256492123,2,3,80080,4031,76049,0.9496628371628372,41.093029333333334,10586.7652,7.883170797402147,140,7.100000000000012E-4
3,test_20231101_140706,10188041.png,221231,6012,215219,0.9728247849532842,2,4,41731,849,40882,0.9796554120438044,12.905870222222223,1625.8886293333333,16.01989567040669,140,7.100000000000012E-4
4,test_20231101_140706,10287332.png,216980,6747,210233,0.9689049681998341,2,3,22337,921,21416,0.9587679634686842,13.06504,1886.4791733333334,15.374283459009131,140,7.100000000000012E-4
5,test_20231101_140706,11610969.png,368720,8354,360366,0.9773432414840529,2,4,84111,1236,82875,0.9853051325034775,38.45282311111111,7027.006309333334,9.66310017390828,140,7.100000000000012E-4
6,test_20231101_140706,10350842.png,212614,24,212590,0.9998871193806617,0,4,42529,1,42528,0.9999764866326507,55.22670577777778,11938.01408,7.361482740939017,140,7.100000000000012E-4
7,test_20231101_140706,10863862.png,317432,3982,313450,0.9874555810378286,2,3,66058,585,65473,0.9911441460534681,43.673390222222224,8783.888586666666,8.693935422435349,140,7.100000000000012E-4
8,test_20231101_140706,11382381.png,312486,327,312159,0.9989535531191798,1,3,46745,44,46701,0.9990587228580596,23.441726222222222,2963.055792,13.413405318888326,140,7.100000000000012E-4
9,test_20231101_140706,11079715.png,443815,82807,361008,0.8134200060836159,3,4,124136,11714,112422,0.9056357543339563,20.129482666666668,2990.9371413333333,13.372730750378414,140,7.100000000000012E-4
10,test_20231101_140706,11551286.png,271883,24,271859,0.9999117267353972,1,4,40092,1,40091,0.9999750573680535,24.866876444444443,3470.407338666667,12.72699907819776,140,7.100000000000012E-4
1,test_20231101_140707,10404007.png,502730,7962,494768,0.9841624728979771,2,4,61265,1165,60100,0.9809842487554068,27.647635555555556,3965.1143733333333,12.148246418520811,140,7.200000000000012E-4
2,test_20231101_140707,1254659.png,342646,28232,314414,0.9176059256492123,2,3,80080,4031,76049,0.9496628371628372,41.093029333333334,10586.7652,7.883170797402147,140,7.200000000000012E-4
3,test_20231101_140707,10188041.png,221231,6012,215219,0.9728247849532842,2,4,41731,849,40882,0.9796554120438044,12.905870222222223,1625.8886293333333,16.01989567040669,140,7.200000000000012E-4
4,test_20231101_140707,10287332.png,216980,6747,210233,0.9689049681998341,1,3,22337,921,21416,0.9587679634686842,13.06504,1886.4791733333334,15.374283459009131,140,7.200000000000012E-4
5,test_20231101_140707,11610969.png,368720,8354,360366,0.9773432414840529,1,4,84111,1236,82875,0.9853051325034775,38.45282311111111,7027.006309333334,9.66310017390828,140,7.200000000000012E-4
6,test_20231101_140707,10350842.png,212614,24,212590,0.9998871193806617,0,3,42529,1,42528,0.9999764866326507,55.22670577777778,11938.01408,7.361482740939017,140,7.200000000000012E-4
7,test_20231101_140707,10863862.png,317432,3982,313450,0.9874555810378286,1,4,66058,585,65473,0.9911441460534681,43.673390222222224,8783.888586666666,8.693935422435349,140,7.200000000000012E-4
8,test_20231101_140707,11382381.png,312486,327,312159,0.9989535531191798,1,4,46745,44,46701,0.9990587228580596,23.441726222222222,2963.055792,13.413405318888326,140,7.200000000000012E-4
9,test_20231101_140707,11079715.png,443815,82807,361008,0.8134200060836159,3,4,124136,11714,112422,0.9056357543339563,20.129482666666668,2990.9371413333333,13.372730750378414,140,7.200000000000012E-4
10,test_20231101_140707,11551286.png,271883,24,271859,0.9999117267353972,0,3,40092,1,40091,0.9999750573680535,24.866876444444443,3470.407338666667,12.72699907819776,140,7.200000000000012E-4
1,test_20231101_140708,10404007.png,502730,7962,494768,0.9841624728979771,1,3,61265,1165,60100,0.9809842487554068,27.647635555555556,3965.1143733333333,12.148246418520811,140,7.300000000000013E-4
2,test_20231101_140708,1254659.png,342646,28232,314414,0.9176059256492123,2,4,80080,4031,76049,0.9496628371628372,41.093029333333334,10586.7652,7.883170797402147,140,7.300000000000013E-4
3,test_20231101_140708,10188041.png,221231,6012,215219,0.9728247849532842,2,4,41731,849,40882,0.9796554120438044,12.905870222222223,1625.8886293333333,16.01989567040669,140,7.300000000000013E-4
4,test_20231101_140708,10287332.png,216980,6747,210233,0.9689049681998341,1,4,22337,921,21416,0.9587679634686842,13.06504,1886.4791733333334,15.374283459009131,140,7.300000000000013E-4
5,test_20231101_140708,11610969.png,368720,8354,360366,0.9773432414840529,2,3,84111,1236,82875,0.9853051325034775,38.45282311111111,7027.006309333334,9.66310017390828,140,7.300000000000013E-4
6,test_20231101_140708,10350842.png,212614,24,212590,0.9998871193806617,1,4,42529,1,42528,0.9999764866326507,55.22670577777778,11938.01408,7.361482740939017,140,7.300000000000013E-4
7,test_20231101_140708,10863862.png,317432,3982,313450,0.9874555810378286,1,4,66058,585,65473,0.9911441460534681,43.673390222222224,8783.888586666666,8.693935422435349,140,7.300000000000013E-4
8,test_20231101_140708,11382381.png,312486,327,312159,0.9989535531191798,1,4,46745,44,46701,0.9990587228580596,23.441726222222222,2963.055792,13.413405318888326,140,7.300000000000013E-4
9,test_20231101_140708,11079715.png,443815,82807,361008,0.8134200060836159,3,9,124136,11714,112422,0.9056357543339563,20.129482666666668,2990.9371413333333,13.372730750378414,140,7.300000000000013E-4
10,test_20231101_140708,11551286.png,271883,24,271859,0.9999117267353972,0,3,40092,1,40091,0.9999750573680535,24.866876444444443,3470.407338666667,12.72699907819776,140,7.300000000000013E-4
1,test_20231101_140708,10404007.png,502730,7962,494768,0.9841624728979771,2,3,61265,1165,60100,0.9809842487554068,27.647635555555556,3965.1143733333333,12.148246418520811,140,7.400000000000013E-4
2,test_20231101_140708,1254659.png,342646,28232,314414,0.9176059256492123,2,4,80080,4031,76049,0.9496628371628372,41.093029333333334,10586.7652,7.883170797402147,140,7.400000000000013E-4
3,test_20231101_140708,10188041.png,221231,6012,215219,0.9728247849532842,2,4,41731,849,40882,0.9796554120438044,12.905870222222223,1625.8886293333333,16.01989567040669,140,7.400000000000013E-4
4,test_20231101_140708,10287332.png,216980,6747,210233,0.9689049681998341,2,3,22337,921,21416,0.9587679634686842,13.06504,1886.4791733333334,15.374283459009131,140,7.400000000000013E-4
5,test_20231101_140708,11610969.png,368720,8354,360366,0.9773432414840529,2,4,84111,1236,82875,0.9853051325034775,38.45282311111111,7027.006309333334,9.66310017390828,140,7.400000000000013E-4
6,test_20231101_140708,10350842.png,212614,24,212590,0.9998871193806617,0,8,42529,1,42528,0.9999764866326507,55.22670577777778,11938.01408,7.361482740939017,140,7.400000000000013E-4
7,test_20231101_140708,10863862.png,317432,3982,313450,0.9874555810378286,2,3,66058,585,65473,0.9911441460534681,43.673390222222224,8783.888586666666,8.693935422435349,140,7.400000000000013E-4
8,test_20231101_140708,11382381.png,312486,327,312159,0.9989535531191798,1,3,46745,44,46701,0.9990587228580596,23.441726222222222,2963.055792,13.413405318888326,140,7.400000000000013E-4
9,test_20231101_140708,11079715.png,443815,82807,361008,0.8134200060836159,2,4,124136,11714,112422,0.9056357543339563,20.129482666666668,2990.9371413333333,13.372730750378414,140,7.400000000000013E-4
10,test_20231101_140708,11551286.png,271883,24,271859,0.9999117267353972,1,4,40092,1,40091,0.9999750573680535,24.866876444444443,3470.407338666667,12.72699907819776,140,7.400000000000013E-4
1,test_20231101_140709,10404007.png,502730,7962,494768,0.9841624728979771,2,3,61265,1165,60100,0.9809842487554068,27.647635555555556,3965.1143733333333,12.148246418520811,140,7.500000000000013E-4
2,test_20231101_140709,1254659.png,342646,28232,314414,0.9176059256492123,2,4,80080,4031,76049,0.9496628371628372,41.093029333333334,10586.7652,7.883170797402147,140,7.500000000000013E-4
3,test_20231101_140709,10188041.png,221231,6012,215219,0.9728247849532842,2,9,41731,849,40882,0.9796554120438044,12.905870222222223,1625.8886293333333,16.01989567040669,140,7.500000000000013E-4
4,test_20231101_140709,10287332.png,216980,6747,210233,0.9689049681998341,1,4,22337,921,21416,0.9587679634686842,13.06504,1886.4791733333334,15.374283459009131,140,7.500000000000013E-4
5,test_20231101_140709,11610969.png,368720,8354,360366,0.9773432414840529,2,4,84111,1236,82875,0.9853051325034775,38.45282311111111,7027.006309333334,9.66310017390828,140,7.500000000000013E-4
6,test_20231101_140709,10350842.png,212614,24,212590,0.9998871193806617,1,3,42529,1,42528,0.9999764866326507,55.22670577777778,11938.01408,7.361482740939017,140,7.500000000000013E-4
7,test_20231101_140709,10863862.png,317432,3982,313450,0.9874555810378286,1,3,66058,585,65473,0.9911441460534681,43.673390222222224,8783.888586666666,8.693935422435349,140,7.500000000000013E-4
8,test_20231101_140709,11382381.png,312486,327,312159,0.9989535531191798,2,4,46745,44,46701,0.9990587228580596,23.441726222222222,2963.055792,13.413405318888326,140,7.500000000000013E-4
9,test_20231101_140709,11079715.png,443815,82807,361008,0.8134200060836159,3,4,124136,11714,112422,0.9056357543339563,20.129482666666668,2990.9371413333333,13.372730750378414,140,7.500000000000013E-4
10,test_20231101_140709,11551286.png,271883,24,271859,0.9999117267353972,1,4,40092,1,40091,0.9999750573680535,24.866876444444443,3470.407338666667,12.72699907819776,140,7.500000000000013E-4
1,test_20231101_140710,10404007.png,502730,7259,495471,0.9855608378254729,2,4,61265,1063,60202,0.9826491471476373,27.769573333333334,3998.8683786666666,12.111432511478666,140,7.600000000000013E-4
2,test_20231101_140710,1254659.png,342646,28232,314414,0.9176059256492123,2,4,80080,4031,76049,0.9496628371628372,41.093029333333334,10586.7652,7.883170797402147,140,7.600000000000013E-4
3,test_20231101_140710,10188041.png,221231,6012,215219,0.9728247849532842,2,4,41731,849,40882,0.9796554120438044,12.905870222222223,1625.8886293333333,16.01989567040669,140,7.600000000000013E-4
4,test_20231101_140710,10287332.png,216980,6607,210373,0.9695501889575076,2,4,22337,900,21437,0.9597081076241214,13.132691555555555,1897.4781386666666,15.34903579889919,140,7.600000000000013E-4
5,test_20231101_140710,11610969.png,368720,8354,360366,0.9773432414840529,2,3,84111,1236,82875,0.9853051325034775,38.45282311111111,7027.006309333334,9.66310017390828,140,7.600000000000013E-4
6,test_20231101_140710,10350842.png,212614,24,212590,0.9998871193806617,0,4,42529,1,42528,0.9999764866326507,55.22670577777778,11938.01408,7.361482740939017,140,7.600000000000013E-4
7,test_20231101_140710,10863862.png,317432,3822,313610,0.9879596259986391,1,4,66058,562,65496,0.9914923249265797,44.36661333333333,8965.391381333333,8.605111075672285,140,7.600000000000013E-4
8,test_20231101_140710,11382381.png,312486,327,312159,0.9989535531191798,1,4,46745,44,46701,0.9990587228580596,23.441726222222222,2963.055792,13.413405318888326,140,7.600000000000013E-4
9,test_20231101_140710,11079715.png,443815,82807,361008,0.8134200060836159,3,4,124136,11714,112422,0.9056357543339563,20.129482666666668,2990.9371413333333,13.372730750378414,140,7.600000000000013E-4
10,test_20231101_140710,11551286.png,271883,24,271859,0.9999117267353972,1,13,40092,1,40091,0.9999750573680535,24.866876444444443,3470.407338666667,12.72699907819776,140,7.600000000000013E-4
1,test_20231101_140710,10404007.png,502730,7259,495471,0.9855608378254729,1,3,61265,1063,60202,0.9826491471476373,27.769573333333334,3998.8683786666666,12.111432511478666,140,7.700000000000014E-4
2,test_20231101_140710,1254659.png,342646,28232,314414,0.9176059256492123,2,3,80080,4031,76049,0.9496628371628372,41.093029333333334,10586.7652,7.883170797402147,140,7.700000000000014E-4
3,test_20231101_140710,10188041.png,221231,6012,215219,0.9728247849532842,2,4,41731,849,40882,0.9796554120438044,12.905870222222223,1625.8886293333333,16.01989567040669,140,7.700000000000014E-4
4,test_20231101_140710,10287332.png,216980,6607,210373,0.9695501889575076,2,11,22337,900,21437,0.9597081076241214,13.132691555555555,1897.4781386666666,15.34903579889919,140,7.700000000000014E-4
5,test_20231101_140710,11610969.png,368720,8354,360366,0.9773432414840529,2,4,84111,1236,82875,0.9853051325034775,38.45282311111111,7027.006309333334,9.66310017390828,140,7.700000000000014E-4
6,test_20231101_140710,10350842.png,212614,24,212590,0.9998871193806617,1,3,42529,1,42528,0.9999764866326507,55.22670577777778,11938.01408,7.361482740939017,140,7.700000000000014E-4
7,test_20231101_140710,10863862.png,317432,3802,313630,0.9880226316187404,1,3,66058,559,65499,0.9915377395622029,44.68715733333333,9017.932533333333,8.579733790114247,140,7.700000000000014E-4
8,test_20231101_140710,11382381.png,312486,327,312159,0.9989535531191798,1,4,46745,44,46701,0.9990587228580596,23.441726222222222,2963.055792,13.413405318888326,140,7.700000000000014E-4
9,test_20231101_140710,11079715.png,443815,82807,361008,0.8134200060836159,3,4,124136,11714,112422,0.9056357543339563,20.129482666666668,2990.9371413333333,13.372730750378414,140,7.700000000000014E-4
10,test_20231101_140710,11551286.png,271883,24,271859,0.9999117267353972,0,3,40092,1,40091,0.9999750573680535,24.866876444444443,3470.407338666667,12.72699907819776,140,7.700000000000014E-4
1,test_20231101_140711,10404007.png,502730,7259,495471,0.9855608378254729,2,4,61265,1063,60202,0.9826491471476373,27.769573333333334,3998.8683786666666,12.111432511478666,140,7.800000000000014E-4
2,test_20231101_140711,1254659.png,342646,28232,314414,0.9176059256492123,2,5,80080,4031,76049,0.9496628371628372,41.093029333333334,10586.7652,7.883170797402147,140,7.800000000000014E-4
3,test_20231101_140711,10188041.png,221231,6012,215219,0.9728247849532842,2,4,41731,849,40882,0.9796554120438044,12.905870222222223,1625.8886293333333,16.01989567040669,140,7.800000000000014E-4
4,test_20231101_140711,10287332.png,216980,6607,210373,0.9695501889575076,1,3,22337,900,21437,0.9597081076241214,13.132691555555555,1897.4781386666666,15.34903579889919,140,7.800000000000014E-4
5,test_20231101_140711,11610969.png,368720,8354,360366,0.9773432414840529,2,3,84111,1236,82875,0.9853051325034775,38.45282311111111,7027.006309333334,9.66310017390828,140,7.800000000000014E-4
6,test_20231101_140711,10350842.png,212614,24,212590,0.9998871193806617,0,4,42529,1,42528,0.9999764866326507,55.22670577777778,11938.01408,7.361482740939017,140,7.800000000000014E-4
7,test_20231101_140711,10863862.png,317432,3802,313630,0.9880226316187404,1,3,66058,559,65499,0.9915377395622029,44.68715733333333,9017.932533333333,8.579733790114247,140,7.800000000000014E-4
8,test_20231101_140711,11382381.png,312486,327,312159,0.9989535531191798,1,4,46745,44,46701,0.9990587228580596,23.441726222222222,2963.055792,13.413405318888326,140,7.800000000000014E-4
9,test_20231101_140711,11079715.png,443815,82807,361008,0.8134200060836159,3,4,124136,11714,112422,0.9056357543339563,20.129482666666668,2990.9371413333333,13.372730750378414,140,7.800000000000014E-4
10,test_20231101_140711,11551286.png,271883,24,271859,0.9999117267353972,1,4,40092,1,40091,0.9999750573680535,24.866876444444443,3470.407338666667,12.72699907819776,140,7.800000000000014E-4
1,test_20231101_140712,10404007.png,502730,7259,495471,0.9855608378254729,2,13,61265,1063,60202,0.9826491471476373,27.769573333333334,3998.8683786666666,12.111432511478666,140,7.900000000000014E-4
2,test_20231101_140712,1254659.png,342646,28232,314414,0.9176059256492123,2,3,80080,4031,76049,0.9496628371628372,41.093029333333334,10586.7652,7.883170797402147,140,7.900000000000014E-4
3,test_20231101_140712,10188041.png,221231,6012,215219,0.9728247849532842,2,4,41731,849,40882,0.9796554120438044,12.905870222222223,1625.8886293333333,16.01989567040669,140,7.900000000000014E-4
4,test_20231101_140712,10287332.png,216980,6607,210373,0.9695501889575076,1,3,22337,900,21437,0.9597081076241214,13.132691555555555,1897.4781386666666,15.34903579889919,140,7.900000000000014E-4
5,test_20231101_140712,11610969.png,368720,8354,360366,0.9773432414840529,2,12,84111,1236,82875,0.9853051325034775,38.45282311111111,7027.006309333334,9.66310017390828,140,7.900000000000014E-4
6,test_20231101_140712,10350842.png,212614,24,212590,0.9998871193806617,2,4,42529,1,42528,0.9999764866326507,55.22670577777778,11938.01408,7.361482740939017,140,7.900000000000014E-4
7,test_20231101_140712,10863862.png,317432,3802,313630,0.9880226316187404,1,4,66058,559,65499,0.9915377395622029,44.68715733333333,9017.932533333333,8.579733790114247,140,7.900000000000014E-4
8,test_20231101_140712,11382381.png,312486,327,312159,0.9989535531191798,1,4,46745,44,46701,0.9990587228580596,23.441726222222222,2963.055792,13.413405318888326,140,7.900000000000014E-4
9,test_20231101_140712,11079715.png,443815,82807,361008,0.8134200060836159,3,4,124136,11714,112422,0.9056357543339563,20.129482666666668,2990.9371413333333,13.372730750378414,140,7.900000000000014E-4
10,test_20231101_140712,11551286.png,271883,24,271859,0.9999117267353972,1,4,40092,1,40091,0.9999750573680535,24.866876444444443,3470.407338666667,12.72699907819776,140,7.900000000000014E-4
1,test_20231101_140712,10404007.png,502730,7259,495471,0.9855608378254729,2,4,61265,1063,60202,0.9826491471476373,27.769573333333334,3998.8683786666666,12.111432511478666,140,8.000000000000014E-4
2,test_20231101_140712,1254659.png,342646,28232,314414,0.9176059256492123,2,3,80080,4031,76049,0.9496628371628372,41.093029333333334,10586.7652,7.883170797402147,140,8.000000000000014E-4
3,test_20231101_140712,10188041.png,221231,6012,215219,0.9728247849532842,2,3,41731,849,40882,0.9796554120438044,12.905870222222223,1625.8886293333333,16.01989567040669,140,8.000000000000014E-4
4,test_20231101_140712,10287332.png,216980,6607,210373,0.9695501889575076,2,4,22337,900,21437,0.9597081076241214,13.132691555555555,1897.4781386666666,15.34903579889919,140,8.000000000000014E-4
5,test_20231101_140712,11610969.png,368720,8354,360366,0.9773432414840529,2,4,84111,1236,82875,0.9853051325034775,38.45282311111111,7027.006309333334,9.66310017390828,140,8.000000000000014E-4
6,test_20231101_140712,10350842.png,212614,24,212590,0.9998871193806617,0,4,42529,1,42528,0.9999764866326507,55.22670577777778,11938.01408,7.361482740939017,140,8.000000000000014E-4
7,test_20231101_140712,10863862.png,317432,3802,313630,0.9880226316187404,1,4,66058,559,65499,0.9915377395622029,44.68715733333333,9017.932533333333,8.579733790114247,140,8.000000000000014E-4
8,test_20231101_140712,11382381.png,312486,327,312159,0.9989535531191798,1,4,46745,44,46701,0.9990587228580596,23.441726222222222,2963.055792,13.413405318888326,140,8.000000000000014E-4
9,test_20231101_140712,11079715.png,443815,82807,361008,0.8134200060836159,3,5,124136,11714,112422,0.9056357543339563,20.129482666666668,2990.9371413333333,13.372730750378414,140,8.000000000000014E-4
10,test_20231101_140712,11551286.png,271883,24,271859,0.9999117267353972,1,4,40092,1,40091,0.9999750573680535,24.866876444444443,3470.407338666667,12.72699907819776,140,8.000000000000014E-4
1,test_20231101_140713,10404007.png,502730,7259,495471,0.9855608378254729,1,3,61265,1063,60202,0.9826491471476373,27.769573333333334,3998.8683786666666,12.111432511478666,140,8.100000000000015E-4
2,test_20231101_140713,1254659.png,342646,28232,314414,0.9176059256492123,2,3,80080,4031,76049,0.9496628371628372,41.093029333333334,10586.7652,7.883170797402147,140,8.100000000000015E-4
3,test_20231101_140713,10188041.png,221231,6012,215219,0.9728247849532842,2,4,41731,849,40882,0.9796554120438044,12.905870222222223,1625.8886293333333,16.01989567040669,140,8.100000000000015E-4
4,test_20231101_140713,10287332.png,216980,6607,210373,0.9695501889575076,2,4,22337,900,21437,0.9597081076241214,13.132691555555555,1897.4781386666666,15.34903579889919,140,8.100000000000015E-4
5,test_20231101_140713,11610969.png,368720,8354,360366,0.9773432414840529,2,4,84111,1236,82875,0.9853051325034775,38.45282311111111,7027.006309333334,9.66310017390828,140,8.100000000000015E-4
6,test_20231101_140713,10350842.png,212614,24,212590,0.9998871193806617,0,3,42529,1,42528,0.9999764866326507,55.22670577777778,11938.01408,7.361482740939017,140,8.100000000000015E-4
7,test_20231101_140713,10863862.png,317432,3802,313630,0.9880226316187404,1,4,66058,559,65499,0.9915377395622029,44.68715733333333,9017.932533333333,8.579733790114247,140,8.100000000000015E-4
8,test_20231101_140713,11382381.png,312486,327,312159,0.9989535531191798,2,3,46745,44,46701,0.9990587228580596,23.441726222222222,2963.055792,13.413405318888326,140,8.100000000000015E-4
9,test_20231101_140713,11079715.png,443815,82807,361008,0.8134200060836159,3,3,124136,11714,112422,0.9056357543339563,20.129482666666668,2990.9371413333333,13.372730750378414,140,8.100000000000015E-4
10,test_20231101_140713,11551286.png,271883,24,271859,0.9999117267353972,0,3,40092,1,40091,0.9999750573680535,24.866876444444443,3470.407338666667,12.72699907819776,140,8.100000000000015E-4
1,test_20231101_140714,10404007.png,502730,7259,495471,0.9855608378254729,1,3,61265,1063,60202,0.9826491471476373,27.769573333333334,3998.8683786666666,12.111432511478666,140,8.200000000000015E-4
2,test_20231101_140714,1254659.png,342646,28232,314414,0.9176059256492123,2,4,80080,4031,76049,0.9496628371628372,41.093029333333334,10586.7652,7.883170797402147,140,8.200000000000015E-4
3,test_20231101_140714,10188041.png,221231,6012,215219,0.9728247849532842,2,4,41731,849,40882,0.9796554120438044,12.905870222222223,1625.8886293333333,16.01989567040669,140,8.200000000000015E-4
4,test_20231101_140714,10287332.png,216980,6607,210373,0.9695501889575076,2,4,22337,900,21437,0.9597081076241214,13.132691555555555,1897.4781386666666,15.34903579889919,140,8.200000000000015E-4
5,test_20231101_140714,11610969.png,368720,8354,360366,0.9773432414840529,2,4,84111,1236,82875,0.9853051325034775,38.45282311111111,7027.006309333334,9.66310017390828,140,8.200000000000015E-4
6,test_20231101_140714,10350842.png,212614,24,212590,0.9998871193806617,1,4,42529,1,42528,0.9999764866326507,55.22670577777778,11938.01408,7.361482740939017,140,8.200000000000015E-4
7,test_20231101_140714,10863862.png,317432,3802,313630,0.9880226316187404,1,4,66058,559,65499,0.9915377395622029,44.68715733333333,9017.932533333333,8.579733790114247,140,8.200000000000015E-4
8,test_20231101_140714,11382381.png,312486,327,312159,0.9989535531191798,2,4,46745,44,46701,0.9990587228580596,23.441726222222222,2963.055792,13.413405318888326,140,8.200000000000015E-4
9,test_20231101_140714,11079715.png,443815,82807,361008,0.8134200060836159,5,5,124136,11714,112422,0.9056357543339563,20.129482666666668,2990.9371413333333,13.372730750378414,140,8.200000000000015E-4
10,test_20231101_140714,11551286.png,271883,24,271859,0.9999117267353972,1,4,40092,1,40091,0.9999750573680535,24.866876444444443,3470.407338666667,12.72699907819776,140,8.200000000000015E-4
1,test_20231101_140714,10404007.png,502730,7259,495471,0.9855608378254729,2,4,61265,1063,60202,0.9826491471476373,27.769573333333334,3998.8683786666666,12.111432511478666,140,8.300000000000015E-4
2,test_20231101_140714,1254659.png,342646,28232,314414,0.9176059256492123,2,4,80080,4031,76049,0.9496628371628372,41.093029333333334,10586.7652,7.883170797402147,140,8.300000000000015E-4
3,test_20231101_140714,10188041.png,221231,6012,215219,0.9728247849532842,2,4,41731,849,40882,0.9796554120438044,12.905870222222223,1625.8886293333333,16.01989567040669,140,8.300000000000015E-4
4,test_20231101_140714,10287332.png,216980,6607,210373,0.9695501889575076,2,4,22337,900,21437,0.9597081076241214,13.132691555555555,1897.4781386666666,15.34903579889919,140,8.300000000000015E-4
5,test_20231101_140714,11610969.png,368720,8354,360366,0.9773432414840529,2,4,84111,1236,82875,0.9853051325034775,38.45282311111111,7027.006309333334,9.66310017390828,140,8.300000000000015E-4
6,test_20231101_140714,10350842.png,212614,24,212590,0.9998871193806617,1,4,42529,1,42528,0.9999764866326507,55.22670577777778,11938.01408,7.361482740939017,140,8.300000000000015E-4
7,test_20231101_140714,10863862.png,317432,3802,313630,0.9880226316187404,2,3,66058,559,65499,0.9915377395622029,44.68715733333333,9017.932533333333,8.579733790114247,140,8.300000000000015E-4
8,test_20231101_140714,11382381.png,312486,327,312159,0.9989535531191798,1,4,46745,44,46701,0.9990587228580596,23.441726222222222,2963.055792,13.413405318888326,140,8.300000000000015E-4
9,test_20231101_140714,11079715.png,443815,82807,361008,0.8134200060836159,3,4,124136,11714,112422,0.9056357543339563,20.129482666666668,2990.9371413333333,13.372730750378414,140,8.300000000000015E-4
10,test_20231101_140714,11551286.png,271883,24,271859,0.9999117267353972,0,3,40092,1,40091,0.9999750573680535,24.866876444444443,3470.407338666667,12.72699907819776,140,8.300000000000015E-4
1,test_20231101_140715,10404007.png,502730,7077,495653,0.9859228611779683,2,4,61265,1036,60229,0.9830898555455807,28.146423111111112,4102.905872,11.999888072789918,140,8.400000000000016E-4
2,test_20231101_140715,1254659.png,342646,28232,314414,0.9176059256492123,2,4,80080,4031,76049,0.9496628371628372,41.093029333333334,10586.7652,7.883170797402147,140,8.400000000000016E-4
3,test_20231101_140715,10188041.png,221231,6012,215219,0.9728247849532842,2,4,41731,849,40882,0.9796554120438044,12.905870222222223,1625.8886293333333,16.01989567040669,140,8.400000000000016E-4
4,test_20231101_140715,10287332.png,216980,6607,210373,0.9695501889575076,1,4,22337,900,21437,0.9597081076241214,13.132691555555555,1897.4781386666666,15.34903579889919,140,8.400000000000016E-4
5,test_20231101_140715,11610969.png,368720,7692,361028,0.9791386417878065,2,3,84111,1137,82974,0.986482148589364,39.55259022222222,7308.623306666666,9.49244782354016,140,8.400000000000016E-4
6,test_20231101_140715,10350842.png,212614,24,212590,0.9998871193806617,1,3,42529,1,42528,0.9999764866326507,55.22670577777778,11938.01408,7.361482740939017,140,8.400000000000016E-4
7,test_20231101_140715,10863862.png,317432,3802,313630,0.9880226316187404,2,3,66058,559,65499,0.9915377395622029,44.68715733333333,9017.932533333333,8.579733790114247,140,8.400000000000016E-4
8,test_20231101_140715,11382381.png,312486,327,312159,0.9989535531191798,1,3,46745,44,46701,0.9990587228580596,23.441726222222222,2963.055792,13.413405318888326,140,8.400000000000016E-4
9,test_20231101_140715,11079715.png,443815,82807,361008,0.8134200060836159,3,4,124136,11714,112422,0.9056357543339563,20.129482666666668,2990.9371413333333,13.372730750378414,140,8.400000000000016E-4
10,test_20231101_140715,11551286.png,271883,24,271859,0.9999117267353972,1,4,40092,1,40091,0.9999750573680535,24.866876444444443,3470.407338666667,12.72699907819776,140,8.400000000000016E-4
1,test_20231101_140716,10404007.png,502730,7077,495653,0.9859228611779683,3,3,61265,1036,60229,0.9830898555455807,28.146423111111112,4102.905872,11.999888072789918,140,8.500000000000016E-4
2,test_20231101_140716,1254659.png,342646,28232,314414,0.9176059256492123,2,3,80080,4031,76049,0.9496628371628372,41.093029333333334,10586.7652,7.883170797402147,140,8.500000000000016E-4
3,test_20231101_140716,10188041.png,221231,6012,215219,0.9728247849532842,1,3,41731,849,40882,0.9796554120438044,12.905870222222223,1625.8886293333333,16.01989567040669,140,8.500000000000016E-4
4,test_20231101_140716,10287332.png,216980,6607,210373,0.9695501889575076,1,3,22337,900,21437,0.9597081076241214,13.132691555555555,1897.4781386666666,15.34903579889919,140,8.500000000000016E-4
5,test_20231101_140716,11610969.png,368720,7692,361028,0.9791386417878065,2,4,84111,1137,82974,0.986482148589364,39.55259022222222,7308.623306666666,9.49244782354016,140,8.500000000000016E-4
6,test_20231101_140716,10350842.png,212614,24,212590,0.9998871193806617,0,3,42529,1,42528,0.9999764866326507,55.22670577777778,11938.01408,7.361482740939017,140,8.500000000000016E-4
7,test_20231101_140716,10863862.png,317432,3802,313630,0.9880226316187404,1,4,66058,559,65499,0.9915377395622029,44.68715733333333,9017.932533333333,8.579733790114247,140,8.500000000000016E-4
8,test_20231101_140716,11382381.png,312486,327,312159,0.9989535531191798,2,3,46745,44,46701,0.9990587228580596,23.441726222222222,2963.055792,13.413405318888326,140,8.500000000000016E-4
9,test_20231101_140716,11079715.png,443815,82807,361008,0.8134200060836159,3,4,124136,11714,112422,0.9056357543339563,20.129482666666668,2990.9371413333333,13.372730750378414,140,8.500000000000016E-4
10,test_20231101_140716,11551286.png,271883,24,271859,0.9999117267353972,1,9,40092,1,40091,0.9999750573680535,24.866876444444443,3470.407338666667,12.72699907819776,140,8.500000000000016E-4
1,test_20231101_140716,10404007.png,502730,7077,495653,0.9859228611779683,1,3,61265,1036,60229,0.9830898555455807,28.146423111111112,4102.905872,11.999888072789918,140,8.600000000000016E-4
2,test_20231101_140716,1254659.png,342646,28232,314414,0.9176059256492123,2,4,80080,4031,76049,0.9496628371628372,41.093029333333334,10586.7652,7.883170797402147,140,8.600000000000016E-4
3,test_20231101_140716,10188041.png,221231,6012,215219,0.9728247849532842,2,4,41731,849,40882,0.9796554120438044,12.905870222222223,1625.8886293333333,16.01989567040669,140,8.600000000000016E-4
4,test_20231101_140716,10287332.png,216980,6607,210373,0.9695501889575076,1,4,22337,900,21437,0.9597081076241214,13.132691555555555,1897.4781386666666,15.34903579889919,140,8.600000000000016E-4
5,test_20231101_140716,11610969.png,368720,7692,361028,0.9791386417878065,1,4,84111,1137,82974,0.986482148589364,39.55259022222222,7308.623306666666,9.49244782354016,140,8.600000000000016E-4
6,test_20231101_140716,10350842.png,212614,24,212590,0.9998871193806617,0,4,42529,1,42528,0.9999764866326507,55.22670577777778,11938.01408,7.361482740939017,140,8.600000000000016E-4
7,test_20231101_140716,10863862.png,317432,3802,313630,0.9880226316187404,2,5,66058,559,65499,0.9915377395622029,44.68715733333333,9017.932533333333,8.579733790114247,140,8.600000000000016E-4
8,test_20231101_140716,11382381.png,312486,327,312159,0.9989535531191798,1,3,46745,44,46701,0.9990587228580596,23.441726222222222,2963.055792,13.413405318888326,140,8.600000000000016E-4
9,test_20231101_140716,11079715.png,443815,82807,361008,0.8134200060836159,3,4,124136,11714,112422,0.9056357543339563,20.129482666666668,2990.9371413333333,13.372730750378414,140,8.600000000000016E-4
10,test_20231101_140716,11551286.png,271883,24,271859,0.9999117267353972,0,4,40092,1,40091,0.9999750573680535,24.866876444444443,3470.407338666667,12.72699907819776,140,8.600000000000016E-4
1,test_20231101_140717,10404007.png,502730,7077,495653,0.9859228611779683,2,3,61265,1036,60229,0.9830898555455807,28.146423111111112,4102.905872,11.999888072789918,140,8.700000000000016E-4
2,test_20231101_140717,1254659.png,342646,28232,314414,0.9176059256492123,2,3,80080,4031,76049,0.9496628371628372,41.093029333333334,10586.7652,7.883170797402147,140,8.700000000000016E-4
3,test_20231101_140717,10188041.png,221231,6012,215219,0.9728247849532842,2,4,41731,849,40882,0.9796554120438044,12.905870222222223,1625.8886293333333,16.01989567040669,140,8.700000000000016E-4
4,test_20231101_140717,10287332.png,216980,6607,210373,0.9695501889575076,2,7,22337,900,21437,0.9597081076241214,13.132691555555555,1897.4781386666666,15.34903579889919,140,8.700000000000016E-4
5,test_20231101_140717,11610969.png,368720,7692,361028,0.9791386417878065,2,4,84111,1137,82974,0.986482148589364,39.55259022222222,7308.623306666666,9.49244782354016,140,8.700000000000016E-4
6,test_20231101_140717,10350842.png,212614,24,212590,0.9998871193806617,1,3,42529,1,42528,0.9999764866326507,55.22670577777778,11938.01408,7.361482740939017,140,8.700000000000016E-4
7,test_20231101_140717,10863862.png,317432,3802,313630,0.9880226316187404,2,3,66058,559,65499,0.9915377395622029,44.68715733333333,9017.932533333333,8.579733790114247,140,8.700000000000016E-4
8,test_20231101_140717,11382381.png,312486,327,312159,0.9989535531191798,1,4,46745,44,46701,0.9990587228580596,23.441726222222222,2963.055792,13.413405318888326,140,8.700000000000016E-4
9,test_20231101_140717,11079715.png,443815,82807,361008,0.8134200060836159,3,4,124136,11714,112422,0.9056357543339563,20.129482666666668,2990.9371413333333,13.372730750378414,140,8.700000000000016E-4
10,test_20231101_140717,11551286.png,271883,24,271859,0.9999117267353972,0,3,40092,1,40091,0.9999750573680535,24.866876444444443,3470.407338666667,12.72699907819776,140,8.700000000000016E-4
1,test_20231101_140718,10404007.png,502730,7077,495653,0.9859228611779683,2,4,61265,1036,60229,0.9830898555455807,28.146423111111112,4102.905872,11.999888072789918,140,8.800000000000017E-4
2,test_20231101_140718,1254659.png,342646,28232,314414,0.9176059256492123,3,4,80080,4031,76049,0.9496628371628372,41.093029333333334,10586.7652,7.883170797402147,140,8.800000000000017E-4
3,test_20231101_140718,10188041.png,221231,6012,215219,0.9728247849532842,2,4,41731,849,40882,0.9796554120438044,12.905870222222223,1625.8886293333333,16.01989567040669,140,8.800000000000017E-4
4,test_20231101_140718,10287332.png,216980,6607,210373,0.9695501889575076,2,4,22337,900,21437,0.9597081076241214,13.132691555555555,1897.4781386666666,15.34903579889919,140,8.800000000000017E-4
5,test_20231101_140718,11610969.png,368720,7692,361028,0.9791386417878065,1,3,84111,1137,82974,0.986482148589364,39.55259022222222,7308.623306666666,9.49244782354016,140,8.800000000000017E-4
6,test_20231101_140718,10350842.png,212614,24,212590,0.9998871193806617,1,4,42529,1,42528,0.9999764866326507,55.22670577777778,11938.01408,7.361482740939017,140,8.800000000000017E-4
7,test_20231101_140718,10863862.png,317432,3802,313630,0.9880226316187404,2,3,66058,559,65499,0.9915377395622029,44.68715733333333,9017.932533333333,8.579733790114247,140,8.800000000000017E-4
8,test_20231101_140718,11382381.png,312486,327,312159,0.9989535531191798,1,4,46745,44,46701,0.9990587228580596,23.441726222222222,2963.055792,13.413405318888326,140,8.800000000000017E-4
9,test_20231101_140718,11079715.png,443815,82807,361008,0.8134200060836159,3,4,124136,11714,112422,0.9056357543339563,20.129482666666668,2990.9371413333333,13.372730750378414,140,8.800000000000017E-4
10,test_20231101_140718,11551286.png,271883,24,271859,0.9999117267353972,0,3,40092,1,40091,0.9999750573680535,24.866876444444443,3470.407338666667,12.72699907819776,140,8.800000000000017E-4
1,test_20231101_140718,10404007.png,502730,7077,495653,0.9859228611779683,1,3,61265,1036,60229,0.9830898555455807,28.146423111111112,4102.905872,11.999888072789918,140,8.900000000000017E-4
2,test_20231101_140718,1254659.png,342646,28232,314414,0.9176059256492123,2,3,80080,4031,76049,0.9496628371628372,41.093029333333334,10586.7652,7.883170797402147,140,8.900000000000017E-4
3,test_20231101_140718,10188041.png,221231,6012,215219,0.9728247849532842,2,4,41731,849,40882,0.9796554120438044,12.905870222222223,1625.8886293333333,16.01989567040669,140,8.900000000000017E-4
4,test_20231101_140718,10287332.png,216980,6607,210373,0.9695501889575076,2,3,22337,900,21437,0.9597081076241214,13.132691555555555,1897.4781386666666,15.34903579889919,140,8.900000000000017E-4
5,test_20231101_140718,11610969.png,368720,7692,361028,0.9791386417878065,2,4,84111,1137,82974,0.986482148589364,39.55259022222222,7308.623306666666,9.49244782354016,140,8.900000000000017E-4
6,test_20231101_140718,10350842.png,212614,24,212590,0.9998871193806617,1,3,42529,1,42528,0.9999764866326507,55.22670577777778,11938.01408,7.361482740939017,140,8.900000000000017E-4
7,test_20231101_140718,10863862.png,317432,3802,313630,0.9880226316187404,1,3,66058,559,65499,0.9915377395622029,44.68715733333333,9017.932533333333,8.579733790114247,140,8.900000000000017E-4
8,test_20231101_140718,11382381.png,312486,327,312159,0.9989535531191798,1,4,46745,44,46701,0.9990587228580596,23.441726222222222,2963.055792,13.413405318888326,140,8.900000000000017E-4
9,test_20231101_140718,11079715.png,443815,82807,361008,0.8134200060836159,3,5,124136,11714,112422,0.9056357543339563,20.129482666666668,2990.9371413333333,13.372730750378414,140,8.900000000000017E-4
10,test_20231101_140718,11551286.png,271883,24,271859,0.9999117267353972,1,4,40092,1,40091,0.9999750573680535,24.866876444444443,3470.407338666667,12.72699907819776,140,8.900000000000017E-4
1,test_20231101_140719,10404007.png,502730,7077,495653,0.9859228611779683,2,3,61265,1036,60229,0.9830898555455807,28.146423111111112,4102.905872,11.999888072789918,140,9.000000000000017E-4
2,test_20231101_140719,1254659.png,342646,28232,314414,0.9176059256492123,2,4,80080,4031,76049,0.9496628371628372,41.093029333333334,10586.7652,7.883170797402147,140,9.000000000000017E-4
3,test_20231101_140719,10188041.png,221231,6012,215219,0.9728247849532842,2,4,41731,849,40882,0.9796554120438044,12.905870222222223,1625.8886293333333,16.01989567040669,140,9.000000000000017E-4
4,test_20231101_140719,10287332.png,216980,6607,210373,0.9695501889575076,2,4,22337,900,21437,0.9597081076241214,13.132691555555555,1897.4781386666666,15.34903579889919,140,9.000000000000017E-4
5,test_20231101_140719,11610969.png,368720,7692,361028,0.9791386417878065,1,3,84111,1137,82974,0.986482148589364,39.55259022222222,7308.623306666666,9.49244782354016,140,9.000000000000017E-4
6,test_20231101_140719,10350842.png,212614,24,212590,0.9998871193806617,1,3,42529,1,42528,0.9999764866326507,55.22670577777778,11938.01408,7.361482740939017,140,9.000000000000017E-4
7,test_20231101_140719,10863862.png,317432,3802,313630,0.9880226316187404,1,3,66058,559,65499,0.9915377395622029,44.68715733333333,9017.932533333333,8.579733790114247,140,9.000000000000017E-4
8,test_20231101_140719,11382381.png,312486,327,312159,0.9989535531191798,1,3,46745,44,46701,0.9990587228580596,23.441726222222222,2963.055792,13.413405318888326,140,9.000000000000017E-4
9,test_20231101_140719,11079715.png,443815,82807,361008,0.8134200060836159,3,3,124136,11714,112422,0.9056357543339563,20.129482666666668,2990.9371413333333,13.372730750378414,140,9.000000000000017E-4
10,test_20231101_140719,11551286.png,271883,24,271859,0.9999117267353972,1,4,40092,1,40091,0.9999750573680535,24.866876444444443,3470.407338666667,12.72699907819776,140,9.000000000000017E-4
1,test_20231101_140720,10404007.png,502730,7077,495653,0.9859228611779683,2,4,61265,1036,60229,0.9830898555455807,28.146423111111112,4102.905872,11.999888072789918,140,9.100000000000017E-4
2,test_20231101_140720,1254659.png,342646,28232,314414,0.9176059256492123,2,4,80080,4031,76049,0.9496628371628372,41.093029333333334,10586.7652,7.883170797402147,140,9.100000000000017E-4
3,test_20231101_140720,10188041.png,221231,6012,215219,0.9728247849532842,2,3,41731,849,40882,0.9796554120438044,12.905870222222223,1625.8886293333333,16.01989567040669,140,9.100000000000017E-4
4,test_20231101_140720,10287332.png,216980,6607,210373,0.9695501889575076,2,4,22337,900,21437,0.9597081076241214,13.132691555555555,1897.4781386666666,15.34903579889919,140,9.100000000000017E-4
5,test_20231101_140720,11610969.png,368720,7692,361028,0.9791386417878065,2,4,84111,1137,82974,0.986482148589364,39.55259022222222,7308.623306666666,9.49244782354016,140,9.100000000000017E-4
6,test_20231101_140720,10350842.png,212614,24,212590,0.9998871193806617,1,3,42529,1,42528,0.9999764866326507,55.22670577777778,11938.01408,7.361482740939017,140,9.100000000000017E-4
7,test_20231101_140720,10863862.png,317432,3802,313630,0.9880226316187404,1,3,66058,559,65499,0.9915377395622029,44.68715733333333,9017.932533333333,8.579733790114247,140,9.100000000000017E-4
8,test_20231101_140720,11382381.png,312486,327,312159,0.9989535531191798,1,4,46745,44,46701,0.9990587228580596,23.441726222222222,2963.055792,13.413405318888326,140,9.100000000000017E-4
9,test_20231101_140720,11079715.png,443815,82807,361008,0.8134200060836159,3,4,124136,11714,112422,0.9056357543339563,20.129482666666668,2990.9371413333333,13.372730750378414,140,9.100000000000017E-4
10,test_20231101_140720,11551286.png,271883,24,271859,0.9999117267353972,1,4,40092,1,40091,0.9999750573680535,24.866876444444443,3470.407338666667,12.72699907819776,140,9.100000000000017E-4
1,test_20231101_140720,10404007.png,502730,5782,496948,0.9884987965707238,1,4,61265,845,60420,0.9862074593976985,28.347203555555556,4162.107488,11.937670690282268,140,9.200000000000018E-4
2,test_20231101_140720,1254659.png,342646,28232,314414,0.9176059256492123,2,3,80080,4031,76049,0.9496628371628372,41.093029333333334,10586.7652,7.883170797402147,140,9.200000000000018E-4
3,test_20231101_140720,10188041.png,221231,6012,215219,0.9728247849532842,2,4,41731,849,40882,0.9796554120438044,12.905870222222223,1625.8886293333333,16.01989567040669,140,9.200000000000018E-4
4,test_20231101_140720,10287332.png,216980,6607,210373,0.9695501889575076,2,4,22337,900,21437,0.9597081076241214,13.132691555555555,1897.4781386666666,15.34903579889919,140,9.200000000000018E-4
5,test_20231101_140720,11610969.png,368720,7692,361028,0.9791386417878065,1,9,84111,1137,82974,0.986482148589364,39.55259022222222,7308.623306666666,9.49244782354016,140,9.200000000000018E-4
6,test_20231101_140720,10350842.png,212614,24,212590,0.9998871193806617,1,3,42529,1,42528,0.9999764866326507,55.22670577777778,11938.01408,7.361482740939017,140,9.200000000000018E-4
7,test_20231101_140720,10863862.png,317432,3802,313630,0.9880226316187404,1,3,66058,559,65499,0.9915377395622029,44.68715733333333,9017.932533333333,8.579733790114247,140,9.200000000000018E-4
8,test_20231101_140720,11382381.png,312486,327,312159,0.9989535531191798,5,4,46745,44,46701,0.9990587228580596,23.441726222222222,2963.055792,13.413405318888326,140,9.200000000000018E-4
9,test_20231101_140720,11079715.png,443815,82807,361008,0.8134200060836159,3,4,124136,11714,112422,0.9056357543339563,20.129482666666668,2990.9371413333333,13.372730750378414,140,9.200000000000018E-4
10,test_20231101_140720,11551286.png,271883,24,271859,0.9999117267353972,1,4,40092,1,40091,0.9999750573680535,24.866876444444443,3470.407338666667,12.72699907819776,140,9.200000000000018E-4
1,test_20231101_140721,10404007.png,502730,5782,496948,0.9884987965707238,2,3,61265,845,60420,0.9862074593976985,28.347203555555556,4162.107488,11.937670690282268,140,9.300000000000018E-4
2,test_20231101_140721,1254659.png,342646,28232,314414,0.9176059256492123,2,3,80080,4031,76049,0.9496628371628372,41.093029333333334,10586.7652,7.883170797402147,140,9.300000000000018E-4
3,test_20231101_140721,10188041.png,221231,6012,215219,0.9728247849532842,2,4,41731,849,40882,0.9796554120438044,12.905870222222223,1625.8886293333333,16.01989567040669,140,9.300000000000018E-4
4,test_20231101_140721,10287332.png,216980,6607,210373,0.9695501889575076,2,4,22337,900,21437,0.9597081076241214,13.132691555555555,1897.4781386666666,15.34903579889919,140,9.300000000000018E-4
5,test_20231101_140721,11610969.png,368720,6757,361963,0.9816744413104795,1,3,84111,998,83113,0.9881347267301542,40.764990222222224,7618.395909333333,9.312168227384356,140,9.300000000000018E-4
6,test_20231101_140721,10350842.png,212614,24,212590,0.9998871193806617,2,4,42529,1,42528,0.9999764866326507,55.22670577777778,11938.01408,7.361482740939017,140,9.300000000000018E-4
7,test_20231101_140721,10863862.png,317432,3802,313630,0.9880226316187404,2,3,66058,559,65499,0.9915377395622029,44.68715733333333,9017.932533333333,8.579733790114247,140,9.300000000000018E-4
8,test_20231101_140721,11382381.png,312486,327,312159,0.9989535531191798,1,3,46745,44,46701,0.9990587228580596,23.441726222222222,2963.055792,13.413405318888326,140,9.300000000000018E-4
9,test_20231101_140721,11079715.png,443815,82807,361008,0.8134200060836159,2,4,124136,11714,112422,0.9056357543339563,20.129482666666668,2990.9371413333333,13.372730750378414,140,9.300000000000018E-4
10,test_20231101_140721,11551286.png,271883,24,271859,0.9999117267353972,1,4,40092,1,40091,0.9999750573680535,24.866876444444443,3470.407338666667,12.72699907819776,140,9.300000000000018E-4
1,test_20231101_140722,10404007.png,502730,5782,496948,0.9884987965707238,2,4,61265,845,60420,0.9862074593976985,28.347203555555556,4162.107488,11.937670690282268,140,9.400000000000018E-4
2,test_20231101_140722,1254659.png,342646,28232,314414,0.9176059256492123,2,4,80080,4031,76049,0.9496628371628372,41.093029333333334,10586.7652,7.883170797402147,140,9.400000000000018E-4
3,test_20231101_140722,10188041.png,221231,6012,215219,0.9728247849532842,1,3,41731,849,40882,0.9796554120438044,12.905870222222223,1625.8886293333333,16.01989567040669,140,9.400000000000018E-4
4,test_20231101_140722,10287332.png,216980,6607,210373,0.9695501889575076,1,4,22337,900,21437,0.9597081076241214,13.132691555555555,1897.4781386666666,15.34903579889919,140,9.400000000000018E-4
5,test_20231101_140722,11610969.png,368720,6757,361963,0.9816744413104795,2,4,84111,998,83113,0.9881347267301542,40.764990222222224,7618.395909333333,9.312168227384356,140,9.400000000000018E-4
6,test_20231101_140722,10350842.png,212614,24,212590,0.9998871193806617,0,3,42529,1,42528,0.9999764866326507,55.22670577777778,11938.01408,7.361482740939017,140,9.400000000000018E-4
7,test_20231101_140722,10863862.png,317432,3802,313630,0.9880226316187404,1,4,66058,559,65499,0.9915377395622029,44.68715733333333,9017.932533333333,8.579733790114247,140,9.400000000000018E-4
8,test_20231101_140722,11382381.png,312486,327,312159,0.9989535531191798,1,3,46745,44,46701,0.9990587228580596,23.441726222222222,2963.055792,13.413405318888326,140,9.400000000000018E-4
9,test_20231101_140722,11079715.png,443815,82807,361008,0.8134200060836159,3,4,124136,11714,112422,0.9056357543339563,20.129482666666668,2990.9371413333333,13.372730750378414,140,9.400000000000018E-4
10,test_20231101_140722,11551286.png,271883,24,271859,0.9999117267353972,1,4,40092,1,40091,0.9999750573680535,24.866876444444443,3470.407338666667,12.72699907819776,140,9.400000000000018E-4
1,test_20231101_140722,10404007.png,502730,5782,496948,0.9884987965707238,1,3,61265,845,60420,0.9862074593976985,28.347203555555556,4162.107488,11.937670690282268,140,9.500000000000018E-4
2,test_20231101_140722,1254659.png,342646,28232,314414,0.9176059256492123,2,4,80080,4031,76049,0.9496628371628372,41.093029333333334,10586.7652,7.883170797402147,140,9.500000000000018E-4
3,test_20231101_140722,10188041.png,221231,6012,215219,0.9728247849532842,2,3,41731,849,40882,0.9796554120438044,12.905870222222223,1625.8886293333333,16.01989567040669,140,9.500000000000018E-4
4,test_20231101_140722,10287332.png,216980,6607,210373,0.9695501889575076,1,3,22337,900,21437,0.9597081076241214,13.132691555555555,1897.4781386666666,15.34903579889919,140,9.500000000000018E-4
5,test_20231101_140722,11610969.png,368720,6757,361963,0.9816744413104795,2,4,84111,998,83113,0.9881347267301542,40.764990222222224,7618.395909333333,9.312168227384356,140,9.500000000000018E-4
6,test_20231101_140722,10350842.png,212614,24,212590,0.9998871193806617,0,3,42529,1,42528,0.9999764866326507,55.22670577777778,11938.01408,7.361482740939017,140,9.500000000000018E-4
7,test_20231101_140722,10863862.png,317432,3802,313630,0.9880226316187404,1,3,66058,559,65499,0.9915377395622029,44.68715733333333,9017.932533333333,8.579733790114247,140,9.500000000000018E-4
8,test_20231101_140722,11382381.png,312486,327,312159,0.9989535531191798,1,4,46745,44,46701,0.9990587228580596,23.441726222222222,2963.055792,13.413405318888326,140,9.500000000000018E-4
9,test_20231101_140722,11079715.png,443815,82807,361008,0.8134200060836159,4,4,124136,11714,112422,0.9056357543339563,20.129482666666668,2990.9371413333333,13.372730750378414,140,9.500000000000018E-4
10,test_20231101_140722,11551286.png,271883,24,271859,0.9999117267353972,1,4,40092,1,40091,0.9999750573680535,24.866876444444443,3470.407338666667,12.72699907819776,140,9.500000000000018E-4
1,test_20231101_140723,10404007.png,502730,5782,496948,0.9884987965707238,2,3,61265,845,60420,0.9862074593976985,28.347203555555556,4162.107488,11.937670690282268,140,9.600000000000019E-4
2,test_20231101_140723,1254659.png,342646,28232,314414,0.9176059256492123,2,4,80080,4031,76049,0.9496628371628372,41.093029333333334,10586.7652,7.883170797402147,140,9.600000000000019E-4
3,test_20231101_140723,10188041.png,221231,6012,215219,0.9728247849532842,2,4,41731,849,40882,0.9796554120438044,12.905870222222223,1625.8886293333333,16.01989567040669,140,9.600000000000019E-4
4,test_20231101_140723,10287332.png,216980,6607,210373,0.9695501889575076,2,4,22337,900,21437,0.9597081076241214,13.132691555555555,1897.4781386666666,15.34903579889919,140,9.600000000000019E-4
5,test_20231101_140723,11610969.png,368720,6757,361963,0.9816744413104795,1,4,84111,998,83113,0.9881347267301542,40.764990222222224,7618.395909333333,9.312168227384356,140,9.600000000000019E-4
6,test_20231101_140723,10350842.png,212614,24,212590,0.9998871193806617,2,5,42529,1,42528,0.9999764866326507,55.22670577777778,11938.01408,7.361482740939017,140,9.600000000000019E-4
7,test_20231101_140723,10863862.png,317432,3802,313630,0.9880226316187404,2,4,66058,559,65499,0.9915377395622029,44.68715733333333,9017.932533333333,8.579733790114247,140,9.600000000000019E-4
8,test_20231101_140723,11382381.png,312486,327,312159,0.9989535531191798,1,3,46745,44,46701,0.9990587228580596,23.441726222222222,2963.055792,13.413405318888326,140,9.600000000000019E-4
9,test_20231101_140723,11079715.png,443815,82807,361008,0.8134200060836159,3,4,124136,11714,112422,0.9056357543339563,20.129482666666668,2990.9371413333333,13.372730750378414,140,9.600000000000019E-4
10,test_20231101_140723,11551286.png,271883,24,271859,0.9999117267353972,1,4,40092,1,40091,0.9999750573680535,24.866876444444443,3470.407338666667,12.72699907819776,140,9.600000000000019E-4
1,test_20231101_140724,10404007.png,502730,5782,496948,0.9884987965707238,1,4,61265,845,60420,0.9862074593976985,28.347203555555556,4162.107488,11.937670690282268,140,9.700000000000019E-4
2,test_20231101_140724,1254659.png,342646,28232,314414,0.9176059256492123,2,4,80080,4031,76049,0.9496628371628372,41.093029333333334,10586.7652,7.883170797402147,140,9.700000000000019E-4
3,test_20231101_140724,10188041.png,221231,6012,215219,0.9728247849532842,2,3,41731,849,40882,0.9796554120438044,12.905870222222223,1625.8886293333333,16.01989567040669,140,9.700000000000019E-4
4,test_20231101_140724,10287332.png,216980,6607,210373,0.9695501889575076,1,4,22337,900,21437,0.9597081076241214,13.132691555555555,1897.4781386666666,15.34903579889919,140,9.700000000000019E-4
5,test_20231101_140724,11610969.png,368720,6757,361963,0.9816744413104795,2,4,84111,998,83113,0.9881347267301542,40.764990222222224,7618.395909333333,9.312168227384356,140,9.700000000000019E-4
6,test_20231101_140724,10350842.png,212614,24,212590,0.9998871193806617,1,4,42529,1,42528,0.9999764866326507,55.22670577777778,11938.01408,7.361482740939017,140,9.700000000000019E-4
7,test_20231101_140724,10863862.png,317432,3802,313630,0.9880226316187404,1,3,66058,559,65499,0.9915377395622029,44.68715733333333,9017.932533333333,8.579733790114247,140,9.700000000000019E-4
8,test_20231101_140724,11382381.png,312486,327,312159,0.9989535531191798,2,3,46745,44,46701,0.9990587228580596,23.441726222222222,2963.055792,13.413405318888326,140,9.700000000000019E-4
9,test_20231101_140724,11079715.png,443815,82807,361008,0.8134200060836159,4,4,124136,11714,112422,0.9056357543339563,20.129482666666668,2990.9371413333333,13.372730750378414,140,9.700000000000019E-4
10,test_20231101_140724,11551286.png,271883,24,271859,0.9999117267353972,0,3,40092,1,40091,0.9999750573680535,24.866876444444443,3470.407338666667,12.72699907819776,140,9.700000000000019E-4
1,test_20231101_140724,10404007.png,502730,5642,497088,0.9887772760726433,2,4,61265,824,60441,0.9865502325960989,28.373376,4170.304,11.92912646251397,140,9.80000000000002E-4
2,test_20231101_140724,1254659.png,342646,28092,314554,0.9180145106027795,2,3,80080,4020,76060,0.9498001998001998,41.274213333333336,10624.02136,7.867914256774763,140,9.80000000000002E-4
3,test_20231101_140724,10188041.png,221231,5712,215519,0.9741808336083099,2,4,41731,813,40918,0.9805180800843498,13.05619911111111,1653.1740266666666,15.947617874883115,140,9.80000000000002E-4
4,test_20231101_140724,10287332.png,216980,6527,210453,0.969918886533321,1,3,22337,888,21449,0.9602453328557998,13.158252444444445,1901.648112,15.339502042892512,140,9.80000000000002E-4
5,test_20231101_140724,11610969.png,368720,6757,361963,0.9816744413104795,3,4,84111,998,83113,0.9881347267301542,40.764990222222224,7618.395909333333,9.312168227384356,140,9.80000000000002E-4
6,test_20231101_140724,10350842.png,212614,24,212590,0.9998871193806617,1,4,42529,1,42528,0.9999764866326507,55.22670577777778,11938.01408,7.361482740939017,140,9.80000000000002E-4
7,test_20231101_140724,10863862.png,317432,3462,313970,0.9890937271604627,1,4,66058,508,65550,0.992309788367798,44.97022577777778,9093.73648,8.543379958833672,140,9.80000000000002E-4
8,test_20231101_140724,11382381.png,312486,327,312159,0.9989535531191798,2,4,46745,44,46701,0.9990587228580596,23.441726222222222,2963.055792,13.413405318888326,140,9.80000000000002E-4
9,test_20231101_140724,11079715.png,443815,82767,361048,0.8135101337268907,4,5,124136,11708,112428,0.9056840884191532,20.16080711111111,2995.252288,13.366469522822351,140,9.80000000000002E-4
10,test_20231101_140724,11551286.png,271883,24,271859,0.9999117267353972,0,3,40092,1,40091,0.9999750573680535,24.866876444444443,3470.407338666667,12.72699907819776,140,9.80000000000002E-4
1,test_20231101_140725,10404007.png,502730,5642,497088,0.9887772760726433,2,4,61265,824,60441,0.9865502325960989,28.373376,4170.304,11.92912646251397,140,9.90000000000002E-4
2,test_20231101_140725,1254659.png,342646,28092,314554,0.9180145106027795,2,4,80080,4020,76060,0.9498001998001998,41.274213333333336,10624.02136,7.867914256774763,140,9.90000000000002E-4
3,test_20231101_140725,10188041.png,221231,5712,215519,0.9741808336083099,2,4,41731,813,40918,0.9805180800843498,13.05619911111111,1653.1740266666666,15.947617874883115,140,9.90000000000002E-4
4,test_20231101_140725,10287332.png,216980,6527,210453,0.969918886533321,1,3,22337,888,21449,0.9602453328557998,13.158252444444445,1901.648112,15.339502042892512,140,9.90000000000002E-4
5,test_20231101_140725,11610969.png,368720,6757,361963,0.9816744413104795,1,3,84111,998,83113,0.9881347267301542,40.764990222222224,7618.395909333333,9.312168227384356,140,9.90000000000002E-4
6,test_20231101_140725,10350842.png,212614,24,212590,0.9998871193806617,1,4,42529,1,42528,0.9999764866326507,55.22670577777778,11938.01408,7.361482740939017,140,9.90000000000002E-4
7,test_20231101_140725,10863862.png,317432,3462,313970,0.9890937271604627,1,3,66058,508,65550,0.992309788367798,44.97022577777778,9093.73648,8.543379958833672,140,9.90000000000002E-4
8,test_20231101_140725,11382381.png,312486,327,312159,0.9989535531191798,2,3,46745,44,46701,0.9990587228580596,23.441726222222222,2963.055792,13.413405318888326,140,9.90000000000002E-4
9,test_20231101_140725,11079715.png,443815,82767,361048,0.8135101337268907,2,4,124136,11708,112428,0.9056840884191532,20.16080711111111,2995.252288,13.366469522822351,140,9.90000000000002E-4
10,test_20231101_140725,11551286.png,271883,24,271859,0.9999117267353972,1,4,40092,1,40091,0.9999750573680535,24.866876444444443,3470.407338666667,12.72699907819776,140,9.90000000000002E-4
