SN,TestID,FileName,OriginalFileSize,CompressedBinSize,FileSizeDifference,CompressionRate,CompressionTime,DecompressionTime,UniquePixelCountBefore,UniquePixelCountAfter,UniquePixelCountReduction,UniquePixelCountReductionRate,MAE,MSE,PSNR,QuadtreeThreshold,AllowedExceedingThresholdFactor
1,test_20231101_174417,10404007.png,502730,25761,476969,0.948757782507509,19,12,61265,3726,57539,0.9391822410838162,25.164213333333333,3281.9456746666665,12.969489728734926,120,0.001
2,test_20231101_174417,1254659.png,342646,84144,258502,0.7544287690502735,4,25,80080,11662,68418,0.8543706293706294,20.031966222222223,2929.3778613333334,13.463049657968673,120,0.001
3,test_20231101_174417,10188041.png,221231,10496,210735,0.9525563777228327,3,5,41731,1483,40248,0.9644628693297549,10.761733333333334,1020.367216,18.04323864418027,120,0.001
4,test_20231101_174417,10287332.png,216980,13551,203429,0.9375472393769011,2,4,22337,1850,20487,0.9171777767829162,9.35664,750.804448,19.375535240148544,120,0.001
5,test_20231101_174417,11610969.png,368720,30684,338036,0.9167823822955088,3,4,84111,4481,79630,0.9467251607994198,20.176567111111112,2670.363557333333,13.865099683440906,120,0.001
6,test_20231101_174417,10350842.png,212614,7039,205575,0.9668930550198952,2,4,42529,1033,41496,0.9757106915281337,18.897082666666666,2271.0700746666666,14.568498261323061,120,0.001
7,test_20231101_174417,10863862.png,317432,14789,302643,0.953410494216084,3,4,66058,2114,63944,0.9679978200974901,23.30008,3113.238448,13.198679755902349,120,0.001
8,test_20231101_174417,11382381.png,312486,759,311727,0.9975710911848851,2,4,46745,101,46644,0.9978393411060006,21.620851555555557,2482.477712,14.181950028339719,120,0.001
9,test_20231101_174417,11079715.png,443815,132159,311656,0.7022205198111826,4,5,124136,18379,105757,0.8519446413610878,16.32134222222222,1955.1006453333334,15.219112418020991,120,0.001
10,test_20231101_174417,11551286.png,271883,479,271404,0.998238212760636,2,4,40092,70,40022,0.9982540157637434,17.985697777777776,1870.2736906666667,15.411751962304145,120,0.001
1,test_20231101_174418,10404007.png,502730,14789,487941,0.9705826189008017,2,4,61265,2153,59112,0.9648575858973313,26.675523555555557,3677.0935466666665,12.475756822407263,130,0.001
2,test_20231101_174418,1254659.png,342646,65001,277645,0.8102969245226852,3,4,80080,9147,70933,0.8857767232767233,21.97528888888889,3512.2054293333335,12.67500450952557,130,0.001
3,test_20231101_174418,10188041.png,221231,7974,213257,0.9639562267494157,1,4,41731,1142,40589,0.9726342527138099,12.194165333333334,1410.783392,16.63620022436401,130,0.001
4,test_20231101_174418,10287332.png,216980,11169,205811,0.9485252096967463,2,4,22337,1538,20799,0.9311456328065542,9.715194666666667,854.379088,18.814297509556095,130,0.001
5,test_20231101_174418,11610969.png,368720,20716,348004,0.9438164460837491,3,4,84111,3041,81070,0.9638453947759509,23.702741333333332,3441.175072,12.763735926731954,130,0.001
6,test_20231101_174418,10350842.png,212614,3019,209595,0.9858005587590657,1,3,42529,441,42088,0.9896306049989418,24.490901333333333,3586.0659306666666,12.584620909620183,130,0.001
7,test_20231101_174418,10863862.png,317432,6969,310463,0.9780456916756974,1,3,66058,1024,65034,0.9844984710406007,36.437904,6694.791408,9.873433107769149,130,0.001
8,test_20231101_174418,11382381.png,312486,359,312127,0.9988511485314542,1,4,46745,48,46697,0.9989731522087923,23.28773511111111,2886.24232,13.527475705549977,130,0.001
9,test_20231101_174418,11079715.png,443815,107529,336286,0.7577166161576332,3,4,124136,15092,109044,0.8784236643681124,18.001861333333334,2370.5821066666667,14.382253588780998,130,0.001
10,test_20231101_174418,11551286.png,271883,156,271727,0.9994262237800818,1,3,40092,22,40070,0.9994512620971765,18.120286222222223,1899.5769013333334,15.344234809036362,130,0.001
1,test_20231101_174419,10404007.png,502730,43559,459171,0.9133550812563404,3,10,61265,6190,55075,0.8989635191381702,24.104625777777777,2998.838688,13.361272558271775,110,0.001
2,test_20231101_174419,1254659.png,342646,103589,239057,0.6976792374637382,3,4,80080,14101,65979,0.8239135864135865,18.053664,2408.430272,14.31346283571825,110,0.001
3,test_20231101_174419,10188041.png,221231,13129,208102,0.9406547906938901,2,3,41731,1853,39878,0.9555965589130383,9.965080888888888,868.677536,18.742217700644726,110,0.001
4,test_20231101_174419,10287332.png,216980,15924,201056,0.9266107475343349,2,3,22337,2170,20167,0.902851770604826,9.076064,685.2587413333333,19.77225776651095,110,0.001
5,test_20231101_174419,11610969.png,368720,41939,326781,0.8862578650466478,3,4,84111,6076,78035,0.9277621238601372,17.722387555555557,2108.2881013333335,14.891504031557151,110,0.001
6,test_20231101_174419,10350842.png,212614,10274,202340,0.9516776882049159,1,3,42529,1505,41024,0.9646123821392462,16.577134222222224,1766.8085333333333,15.658908727206391,110,0.001
7,test_20231101_174419,10863862.png,317432,22786,294646,0.928217697018574,2,3,66058,3166,62892,0.9520724212056072,20.663123555555554,2482.51064,14.181892423174563,110,0.001
8,test_20231101_174419,11382381.png,312486,1464,311022,0.995314990111557,2,3,46745,199,46546,0.9957428601989518,19.922248888888888,2126.2597386666666,14.854640450929011,110,0.001
9,test_20231101_174419,11079715.png,443815,156014,287801,0.6484706465531809,4,4,124136,21524,102612,0.8266095250370561,14.752165333333334,1614.4291466666666,16.05061371215515,110,0.001
10,test_20231101_174419,11551286.png,271883,1504,270379,0.9944682087515586,2,3,40092,218,39874,0.994562506235658,16.194019555555556,1548.9073813333334,16.230549114614764,110,0.001
1,test_20231101_174420,10404007.png,502730,18024,484706,0.9641477532671613,2,4,61265,2618,58647,0.9572676079327511,25.992037333333332,3511.230128,12.676210665648235,128,3.0E-4
2,test_20231101_174420,1254659.png,342646,69524,273122,0.7970967120585094,3,4,80080,9762,70318,0.8780969030969031,21.44027911111111,3346.4703306666665,12.884933819048644,128,3.0E-4
3,test_20231101_174420,10188041.png,221231,9259,211972,0.9581478183437222,2,3,41731,1305,40426,0.9687282835302293,10.994965333333333,1087.4147413333333,17.76685144730885,128,3.0E-4
4,test_20231101_174420,10287332.png,216980,11934,205046,0.9449995391280303,1,3,22337,1637,20700,0.9267135246452075,9.578848,812.8562133333334,19.03066631114696,128,3.0E-4
5,test_20231101_174420,11610969.png,368720,23459,345261,0.9363771967888913,2,4,84111,3427,80684,0.9592562209461307,22.418577777777777,3189.8884373333335,13.093048664934157,128,3.0E-4
6,test_20231101_174420,10350842.png,212614,5554,207060,0.9738775433414545,2,3,42529,818,41711,0.9807660655082414,19.46256711111111,2410.5704426666666,14.30960533734045,128,3.0E-4
7,test_20231101_174420,10863862.png,317432,10546,306886,0.9667771365205776,2,7,66058,1536,64522,0.976747706560901,24.63304711111111,3467.3115253333335,12.730874976784207,128,3.0E-4
8,test_20231101_174420,11382381.png,312486,659,311827,0.9978911055215274,1,4,46745,89,46656,0.9980960530538026,21.842074666666665,2522.8946186666667,14.11181250456314,128,3.0E-4
9,test_20231101_174420,11079715.png,443815,113154,330661,0.7450424163221162,4,4,124136,15824,108312,0.872526905974093,17.42231111111111,2238.1416106666666,14.631927993255129,128,3.0E-4
10,test_20231101_174420,11551286.png,271883,256,271627,0.9990584185109036,1,12,40092,37,40055,0.9990771226179787,18.016108444444445,1877.54488,15.394900338849709,128,3.0E-4
1,test_20231101_174420,10404007.png,502730,18024,484706,0.9641477532671613,2,3,61265,2618,58647,0.9572676079327511,25.992037333333332,3511.230128,12.676210665648235,128,3.0E-4
2,test_20231101_174420,1254659.png,342646,69524,273122,0.7970967120585094,3,4,80080,9762,70318,0.8780969030969031,21.44027911111111,3346.4703306666665,12.884933819048644,128,3.0E-4
3,test_20231101_174420,10188041.png,221231,9259,211972,0.9581478183437222,2,9,41731,1305,40426,0.9687282835302293,10.994965333333333,1087.4147413333333,17.76685144730885,128,3.0E-4
4,test_20231101_174420,10287332.png,216980,11934,205046,0.9449995391280303,2,4,22337,1637,20700,0.9267135246452075,9.578848,812.8562133333334,19.03066631114696,128,3.0E-4
5,test_20231101_174420,11610969.png,368720,23459,345261,0.9363771967888913,2,4,84111,3427,80684,0.9592562209461307,22.418577777777777,3189.8884373333335,13.093048664934157,128,3.0E-4
6,test_20231101_174420,10350842.png,212614,5554,207060,0.9738775433414545,2,4,42529,818,41711,0.9807660655082414,19.46256711111111,2410.5704426666666,14.30960533734045,128,3.0E-4
7,test_20231101_174420,10863862.png,317432,10546,306886,0.9667771365205776,2,3,66058,1536,64522,0.976747706560901,24.63304711111111,3467.3115253333335,12.730874976784207,128,3.0E-4
8,test_20231101_174420,11382381.png,312486,659,311827,0.9978911055215274,2,4,46745,89,46656,0.9980960530538026,21.842074666666665,2522.8946186666667,14.11181250456314,128,3.0E-4
9,test_20231101_174420,11079715.png,443815,113154,330661,0.7450424163221162,3,4,124136,15824,108312,0.872526905974093,17.42231111111111,2238.1416106666666,14.631927993255129,128,3.0E-4
10,test_20231101_174420,11551286.png,271883,256,271627,0.9990584185109036,1,4,40092,37,40055,0.9990771226179787,18.016108444444445,1877.54488,15.394900338849709,128,3.0E-4
1,test_20231101_174421,10404007.png,502730,18524,484206,0.9631531836174487,2,4,61265,2687,58578,0.956141353138007,25.885536,3487.714848,12.705393906287338,128,2.0E-4
2,test_20231101_174421,1254659.png,342646,69584,273062,0.7969216042212662,2,4,80080,9768,70312,0.878021978021978,21.430725333333335,3345.388144,12.88633847428336,128,2.0E-4
3,test_20231101_174421,10188041.png,221231,9301,211930,0.9579579715320186,2,3,41731,1311,40420,0.9685845055234718,10.629137777777778,1035.1340373333333,17.980837715530228,128,2.0E-4
4,test_20231101_174421,10287332.png,216980,11934,205046,0.9449995391280303,2,3,22337,1637,20700,0.9267135246452075,9.578848,812.8562133333334,19.03066631114696,128,2.0E-4
5,test_20231101_174421,11610969.png,368720,24024,344696,0.9348448687350835,2,3,84111,3509,80602,0.9582813187335782,21.529770666666668,2995.306272,13.366391249809656,128,2.0E-4
6,test_20231101_174421,10350842.png,212614,5634,206980,0.9735012746103267,2,4,42529,830,41699,0.9804839051000493,19.393774222222223,2404.812736,14.319990975752292,128,2.0E-4
7,test_20231101_174421,10863862.png,317432,10669,306763,0.9663896519569546,1,3,66058,1554,64504,0.9764752187471616,24.58188977777778,3464.000261333333,12.735024447582767,128,2.0E-4
8,test_20231101_174421,11382381.png,312486,779,311707,0.9975070883175566,2,4,46745,107,46638,0.9977109851320997,21.347548444444445,2452.9523093333332,14.233912561978928,128,2.0E-4
9,test_20231101_174421,11079715.png,443815,113154,330661,0.7450424163221162,4,4,124136,15824,108312,0.872526905974093,17.42231111111111,2238.1416106666666,14.631927993255129,128,2.0E-4
10,test_20231101_174421,11551286.png,271883,589,271294,0.9978336269645399,1,3,40092,86,40006,0.997854933652599,17.58564977777778,1815.0887466666666,15.541824966498465,128,2.0E-4
1,test_20231101_174422,10404007.png,502730,13864,488866,0.9724225727527699,2,3,61265,2019,59246,0.9670448053537909,26.43332977777778,3634.1775893333333,12.526742149506438,133,3.0E-4
2,test_20231101_174422,1254659.png,342646,59434,283212,0.826544013354891,3,4,80080,8377,71703,0.8953921078921079,22.63763911111111,3744.3753706666666,12.397009809413873,133,3.0E-4
3,test_20231101_174422,10188041.png,221231,7674,213557,0.9653122754044415,5,3,41731,1091,40640,0.9738563657712492,12.255687111111111,1439.799552,16.54778326772516,133,3.0E-4
4,test_20231101_174422,10287332.png,216980,10244,206736,0.9527882754170891,2,4,22337,1412,20925,0.9367864977391771,10.08100088888889,982.629264,18.20690667012046,133,3.0E-4
5,test_20231101_174422,11610969.png,368720,18969,349751,0.9485544586678238,2,4,84111,2788,81323,0.9668533247732164,23.867306666666668,3517.9054613333333,12.667961966313278,133,3.0E-4
6,test_20231101_174422,10350842.png,212614,3924,208690,0.9815440187381828,2,4,42529,578,41951,0.9864092736720825,21.983740444444443,3072.926976,13.255281209164664,133,3.0E-4
7,test_20231101_174422,10863862.png,317432,6609,310823,0.9791797928375211,2,4,66058,973,65085,0.9852705198461957,35.89944888888889,6569.9042346666665,9.955213216976183,133,3.0E-4
8,test_20231101_174422,11382381.png,312486,539,311947,0.9982751227254981,1,4,46745,72,46673,0.9984597283131885,22.81680888888889,2740.878352,13.751906001286724,133,3.0E-4
9,test_20231101_174422,11079715.png,443815,98866,344949,0.7772360104998705,3,4,124136,13895,110241,0.8880663143648901,18.42161422222222,2518.297664,14.119732982444997,133,3.0E-4
10,test_20231101_174422,11551286.png,271883,156,271727,0.9994262237800818,1,3,40092,22,40070,0.9994512620971765,18.120286222222223,1899.5769013333334,15.344234809036362,133,3.0E-4
1,test_20231101_174422,10404007.png,502730,11674,491056,0.9767787878185109,2,3,61265,1709,59556,0.972104790663511,26.58351822222222,3681.7308106666665,12.470283289312524,136,0.0
2,test_20231101_174422,1254659.png,342646,52711,289935,0.8461648465179806,3,4,80080,7444,72636,0.907042957042957,23.99747911111111,4207.514922666666,11.890546959181364,136,0.0
3,test_20231101_174422,10188041.png,221231,7029,214202,0.9682277800127469,2,4,41731,998,40733,0.9760849248759915,12.408926222222222,1533.9216373333334,16.272771872673378,136,0.0
4,test_20231101_174422,10287332.png,216980,8246,208734,0.9619964973730297,2,5,22337,1132,21205,0.949321753145006,11.671928888888889,1532.94096,16.275549321974697,136,0.0
5,test_20231101_174422,11610969.png,368720,16024,352696,0.9565415491429812,2,5,84111,2360,81751,0.9719418387606853,24.42743111111111,3678.597184,12.473981268133281,136,0.0
6,test_20231101_174422,10350842.png,212614,3364,209250,0.9841778998560772,1,3,42529,496,42033,0.9883373697947283,21.076389333333335,2761.394149333333,13.719519605077451,136,0.0
7,test_20231101_174422,10863862.png,317432,5824,311608,0.9816527634264977,2,4,66058,856,65202,0.9870416906355022,36.069536,6613.262826666667,9.926645779336518,136,0.0
8,test_20231101_174422,11382381.png,312486,659,311827,0.9978911055215274,2,4,46745,93,46652,0.9980104824045353,20.769573333333334,2445.751248,14.246680770615956,136,0.0
9,test_20231101_174422,11079715.png,443815,92434,351381,0.7917285355384563,3,4,124136,13015,111121,0.8951553135270993,18.872316444444444,2645.8680106666666,13.905121852903795,136,0.0
10,test_20231101_174422,11551286.png,271883,509,271374,0.9981278711798826,1,3,40092,74,40018,0.9981542452359573,17.526147555555557,1807.59504,15.559792199013692,136,0.0
1,test_20231101_174423,10404007.png,502730,11974,490756,0.9761820460286834,2,4,61265,1754,59511,0.9713702766669388,26.782478222222224,3724.0032213333334,12.420703128854885,135,3.1E-4
2,test_20231101_174423,1254659.png,342646,55134,287512,0.8390934083573134,3,4,80080,7773,72307,0.9029345654345654,23.363356444444445,3981.192138666667,12.13067223035364,135,3.1E-4
3,test_20231101_174423,10188041.png,221231,7189,214042,0.9675045540633997,2,12,41731,1021,40710,0.9755337758500875,12.409082666666666,1482.392304,16.42117209237998,135,3.1E-4
4,test_20231101_174423,10287332.png,216980,9824,207156,0.9547239376901097,2,4,22337,1355,20982,0.9393383175896495,10.154837333333333,1008.1934186666666,18.095365027648654,135,3.1E-4
5,test_20231101_174423,11610969.png,368720,17249,351471,0.9532192449555218,2,3,84111,2540,81571,0.9698018095136189,24.103752888888888,3594.7265653333334,12.574144997187485,135,3.1E-4
6,test_20231101_174423,10350842.png,212614,3321,209293,0.9843801442990584,1,3,42529,490,42039,0.9884784499988243,22.883356444444445,3250.8236266666668,13.010869533660298,135,3.1E-4
7,test_20231101_174423,10863862.png,317432,5744,311688,0.9819047859069029,1,3,66058,845,65213,0.9872082109661207,36.77768711111111,6782.79896,9.81671415962192,135,3.1E-4
8,test_20231101_174423,11382381.png,312486,519,311967,0.9983391255928266,2,3,46745,69,46676,0.9985239063001391,22.832848,2745.811376,13.744096608790418,135,3.1E-4
9,test_20231101_174423,11079715.png,443815,94746,349069,0.7865191577571736,3,3,124136,13324,110812,0.8926661081394599,18.728499555555555,2605.7314826666666,13.97150700682634,135,3.1E-4
10,test_20231101_174423,11551286.png,271883,156,271727,0.9994262237800818,1,4,40092,22,40070,0.9994512620971765,18.120286222222223,1899.5769013333334,15.344234809036362,135,3.1E-4
1,test_20231101_174424,10404007.png,502730,12154,490576,0.9758240009547868,2,3,61265,1779,59486,0.9709622133355097,26.55992,3673.92888,12.479496158993475,135,2.5E-5
2,test_20231101_174424,1254659.png,342646,55194,287452,0.8389183005200702,2,4,80080,7779,72301,0.9028596403596404,23.353802666666667,3980.109952,12.131852910838479,135,2.5E-5
3,test_20231101_174424,10188041.png,221231,7351,213880,0.9667722877896859,2,3,41731,1044,40687,0.9749826268241835,12.082014222222222,1435.143152,16.561851378307132,135,2.5E-5
4,test_20231101_174424,10287332.png,216980,10014,206966,0.9538482809475528,2,4,22337,1379,20958,0.9382638671262927,10.026462222222221,981.878768,18.210224918577968,135,2.5E-5
5,test_20231101_174424,11610969.png,368720,17329,351391,0.9530022781514428,2,4,84111,2551,81560,0.9696710299485204,24.066007111111112,3590.849722666667,12.578831306185476,135,2.5E-5
6,test_20231101_174424,10350842.png,212614,3504,209110,0.9835194295766037,1,3,42529,517,42012,0.9878435890803922,21.05091377777778,2753.8514826666665,13.731398461516449,135,2.5E-5
7,test_20231101_174424,10863862.png,317432,6024,311408,0.9810227072254845,1,3,66058,886,65172,0.9865875442792698,36.04656,6605.741237333334,9.931588035317864,135,2.5E-5
8,test_20231101_174424,11382381.png,312486,769,311717,0.9975390897512209,2,4,46745,106,46639,0.9977323777944165,21.325146666666665,2490.063653333333,14.168699117890078,135,2.5E-5
9,test_20231101_174424,11079715.png,443815,94746,349069,0.7865191577571736,4,4,124136,13324,110812,0.8926661081394599,18.728499555555555,2605.7314826666666,13.97150700682634,135,2.5E-5
10,test_20231101_174424,11551286.png,271883,509,271374,0.9981278711798826,1,3,40092,74,40018,0.9981542452359573,17.526147555555557,1807.59504,15.559792199013692,135,2.5E-5
1,test_20231101_174425,10404007.png,502730,11674,491056,0.9767787878185109,2,3,61265,1709,59556,0.972104790663511,26.58351822222222,3681.7308106666665,12.470283289312524,136,3.0E-5
2,test_20231101_174425,1254659.png,342646,52711,289935,0.8461648465179806,2,4,80080,7444,72636,0.907042957042957,23.99747911111111,4207.514922666666,11.890546959181364,136,3.0E-5
3,test_20231101_174425,10188041.png,221231,7029,214202,0.9682277800127469,2,4,41731,998,40733,0.9760849248759915,12.408926222222222,1533.9216373333334,16.272771872673378,136,3.0E-5
4,test_20231101_174425,10287332.png,216980,8246,208734,0.9619964973730297,2,4,22337,1132,21205,0.949321753145006,11.671928888888889,1532.94096,16.275549321974697,136,3.0E-5
5,test_20231101_174425,11610969.png,368720,16024,352696,0.9565415491429812,2,4,84111,2360,81751,0.9719418387606853,24.42743111111111,3678.597184,12.473981268133281,136,3.0E-5
6,test_20231101_174425,10350842.png,212614,3364,209250,0.9841778998560772,1,4,42529,496,42033,0.9883373697947283,21.076389333333335,2761.394149333333,13.719519605077451,136,3.0E-5
7,test_20231101_174425,10863862.png,317432,5824,311608,0.9816527634264977,1,4,66058,856,65202,0.9870416906355022,36.069536,6613.262826666667,9.926645779336518,136,3.0E-5
8,test_20231101_174425,11382381.png,312486,649,311837,0.9979231069551916,1,3,46745,92,46653,0.9980318750668521,21.49939022222222,2544.312058666667,14.075099846126175,136,3.0E-5
9,test_20231101_174425,11079715.png,443815,92434,351381,0.7917285355384563,3,4,124136,13015,111121,0.8951553135270993,18.872316444444444,2645.8680106666666,13.905121852903795,136,3.0E-5
10,test_20231101_174425,11551286.png,271883,509,271374,0.9981278711798826,2,3,40092,74,40018,0.9981542452359573,17.526147555555557,1807.59504,15.559792199013692,136,3.0E-5
1,test_20231101_174425,10404007.png,502730,12154,490576,0.9758240009547868,2,4,61265,1779,59486,0.9709622133355097,26.55992,3673.92888,12.479496158993475,135,1.55E-4
2,test_20231101_174425,1254659.png,342646,55194,287452,0.8389183005200702,2,4,80080,7779,72301,0.9028596403596404,23.353802666666667,3980.109952,12.131852910838479,135,1.55E-4
3,test_20231101_174425,10188041.png,221231,7351,213880,0.9667722877896859,2,3,41731,1044,40687,0.9749826268241835,12.082014222222222,1435.143152,16.561851378307132,135,1.55E-4
4,test_20231101_174425,10287332.png,216980,10014,206966,0.9538482809475528,2,3,22337,1379,20958,0.9382638671262927,10.026462222222221,981.878768,18.210224918577968,135,1.55E-4
5,test_20231101_174425,11610969.png,368720,17329,351391,0.9530022781514428,3,4,84111,2551,81560,0.9696710299485204,24.066007111111112,3590.849722666667,12.578831306185476,135,1.55E-4
6,test_20231101_174425,10350842.png,212614,3384,209230,0.9840838326732952,2,4,42529,499,42030,0.9882668296926803,22.827879111111113,3246.082464,13.0172081235082,135,1.55E-4
7,test_20231101_174425,10863862.png,317432,6024,311408,0.9810227072254845,1,3,66058,886,65172,0.9865875442792698,36.04656,6605.741237333334,9.931588035317864,135,1.55E-4
8,test_20231101_174425,11382381.png,312486,639,311847,0.9979551083888558,1,4,46745,87,46658,0.9981388383784362,22.33832177777778,2675.8690666666666,13.85615501777858,135,1.55E-4
9,test_20231101_174425,11079715.png,443815,94746,349069,0.7865191577571736,3,4,124136,13324,110812,0.8926661081394599,18.728499555555555,2605.7314826666666,13.97150700682634,135,1.55E-4
10,test_20231101_174425,11551286.png,271883,369,271514,0.9986427985567321,1,4,40092,53,40039,0.9986780405068343,17.85248,1858.6998933333334,15.438710868521719,135,1.55E-4
